,time_between,service_time,arrival_time,start_time,end_time,wait_time,system_time,idle_time
0,0,1,0,0,1,0,1,0
1,2,1,2,2,3,0,1,1
2,6,3,8,8,11,0,3,5
3,2,2,10,11,13,1,3,0
4,4,3,14,14,17,0,3,1
5,2,2,16,17,19,1,3,0
6,5,1,21,21,22,0,1,2
7,4,3,25,25,28,0,3,3
8,6,2,31,31,33,0,2,3
9,1,1,32,33,34,1,2,0
10,1,1,33,34,35,1,2,0
11,6,1,39,39,40,0,1,4
12,6,3,45,45,48,0,3,5
13,5,1,50,50,51,0,1,2
14,4,1,54,54,55,0,1,3
15,2,2,56,56,58,0,2,1
16,2,1,58,58,59,0,1,0
17,2,1,60,60,61,0,1,1
18,6,2,66,66,68,0,2,5
19,5,2,71,71,73,0,2,3
20,4,1,75,75,76,0,1,2
21,3,2,78,78,80,0,2,2
22,6,1,84,84,85,0,1,4
23,5,3,89,89,92,0,3,4
24,3,2,92,92,94,0,2,0
25,4,1,96,96,97,0,1,2
26,3,2,99,99,101,0,2,2
27,4,1,103,103,104,0,1,2
28,5,3,108,108,111,0,3,4
29,1,2,109,111,113,2,4,0
30,1,3,110,113,116,3,6,0
31,3,1,113,116,117,3,4,0
32,3,3,116,117,120,1,4,0
33,3,1,119,120,121,1,2,0
34,2,1,121,121,122,0,1,0
35,2,1,123,123,124,0,1,1
36,3,2,126,126,128,0,2,2
37,3,2,129,129,131,0,2,1
38,6,2,135,135,137,0,2,4
39,1,1,136,137,138,1,2,0
40,5,3,141,141,144,0,3,3
41,4,2,145,145,147,0,2,1
42,1,2,146,147,149,1,3,0
43,5,3,151,151,154,0,3,2
44,6,1,157,157,158,0,1,3
45,3,2,160,160,162,0,2,2
46,2,3,162,162,165,0,3,0
47,2,2,164,165,167,1,3,0
48,4,2,168,168,170,0,2,1
49,4,1,172,172,173,0,1,2
50,6,3,178,178,181,0,3,5
51,5,3,183,183,186,0,3,2
52,6,3,189,189,192,0,3,3
53,5,3,194,194,197,0,3,2
54,5,3,199,199,202,0,3,2
55,6,3,205,205,208,0,3,3
56,1,2,206,208,210,2,4,0
57,6,2,212,212,214,0,2,2
58,1,2,213,214,216,1,3,0
59,5,1,218,218,219,0,1,2
60,5,1,223,223,224,0,1,4
61,4,1,227,227,228,0,1,3
62,2,3,229,229,232,0,3,1
63,2,2,231,232,234,1,3,0
64,3,1,234,234,235,0,1,0
65,5,3,239,239,242,0,3,4
66,5,3,244,244,247,0,3,2
67,6,1,250,250,251,0,1,3
68,1,1,251,251,252,0,1,0
69,3,1,254,254,255,0,1,2
70,2,2,256,256,258,0,2,1
71,5,1,261,261,262,0,1,3
72,5,3,266,266,269,0,3,4
73,3,1,269,269,270,0,1,0
74,6,2,275,275,277,0,2,5
75,1,2,276,277,279,1,3,0
76,1,3,277,279,282,2,5,0
77,3,2,280,282,284,2,4,0
78,5,2,285,285,287,0,2,1
79,5,2,290,290,292,0,2,3
80,2,3,292,292,295,0,3,0
81,6,1,298,298,299,0,1,3
82,1,3,299,299,302,0,3,0
83,5,1,304,304,305,0,1,2
84,4,3,308,308,311,0,3,3
85,1,2,309,311,313,2,4,0
86,1,2,310,313,315,3,5,0
87,4,3,314,315,318,1,4,0
88,4,2,318,318,320,0,2,0
89,2,1,320,320,321,0,1,0
90,2,1,322,322,323,0,1,1
91,1,2,323,323,325,0,2,0
92,6,1,329,329,330,0,1,4
93,5,1,334,334,335,0,1,4
94,1,1,335,335,336,0,1,0
95,6,1,341,341,342,0,1,5
96,1,3,342,342,345,0,3,0
97,4,3,346,346,349,0,3,1
98,5,2,351,351,353,0,2,2
99,4,2,355,355,357,0,2,2
100,6,3,361,361,364,0,3,4
101,6,1,367,367,368,0,1,3
102,2,3,369,369,372,0,3,1
103,3,1,372,372,373,0,1,0
104,4,3,376,376,379,0,3,3
105,2,3,378,379,382,1,4,0
106,1,3,379,382,385,3,6,0
107,3,2,382,385,387,3,5,0
108,5,1,387,387,388,0,1,0
109,1,3,388,388,391,0,3,0
110,2,3,390,391,394,1,4,0
111,6,2,396,396,398,0,2,2
112,6,3,402,402,405,0,3,4
113,3,3,405,405,408,0,3,0
114,6,1,411,411,412,0,1,3
115,4,1,415,415,416,0,1,3
116,4,1,419,419,420,0,1,3
117,5,3,424,424,427,0,3,4
118,1,3,425,427,430,2,5,0
119,1,1,426,430,431,4,5,0
120,4,2,430,431,433,1,3,0
121,1,2,431,433,435,2,4,0
122,6,1,437,437,438,0,1,2
123,6,1,443,443,444,0,1,5
124,2,1,445,445,446,0,1,1
125,1,2,446,446,448,0,2,0
126,6,3,452,452,455,0,3,4
127,4,3,456,456,459,0,3,1
128,6,3,462,462,465,0,3,3
129,4,3,466,466,469,0,3,1
130,5,3,471,471,474,0,3,2
131,2,3,473,474,477,1,4,0
132,5,1,478,478,479,0,1,1
133,2,1,480,480,481,0,1,1
134,4,1,484,484,485,0,1,3
135,6,2,490,490,492,0,2,5
136,4,1,494,494,495,0,1,2
137,3,3,497,497,500,0,3,2
138,2,2,499,500,502,1,3,0
139,1,1,500,502,503,2,3,0
140,1,1,501,503,504,2,3,0
141,6,3,507,507,510,0,3,3
142,5,3,512,512,515,0,3,2
143,4,2,516,516,518,0,2,1
144,4,2,520,520,522,0,2,2
145,4,3,524,524,527,0,3,2
146,3,2,527,527,529,0,2,0
147,5,1,532,532,533,0,1,3
148,6,1,538,538,539,0,1,5
149,6,3,544,544,547,0,3,5
150,1,1,545,547,548,2,3,0
151,3,3,548,548,551,0,3,0
152,4,3,552,552,555,0,3,1
153,3,1,555,555,556,0,1,0
154,2,1,557,557,558,0,1,1
155,4,2,561,561,563,0,2,3
156,1,1,562,563,564,1,2,0
157,4,1,566,566,567,0,1,2
158,4,1,570,570,571,0,1,3
159,4,2,574,574,576,0,2,3
160,2,3,576,576,579,0,3,0
161,5,2,581,581,583,0,2,2
162,3,1,584,584,585,0,1,1
163,3,3,587,587,590,0,3,2
164,4,2,591,591,593,0,2,1
165,2,1,593,593,594,0,1,0
166,2,3,595,595,598,0,3,1
167,2,3,597,598,601,1,4,0
168,1,1,598,601,602,3,4,0
169,1,2,599,602,604,3,5,0
170,4,3,603,604,607,1,4,0
171,6,1,609,609,610,0,1,2
172,6,3,615,615,618,0,3,5
173,2,2,617,618,620,1,3,0
174,1,2,618,620,622,2,4,0
175,2,1,620,622,623,2,3,0
176,6,1,626,626,627,0,1,3
177,6,1,632,632,633,0,1,5
178,1,1,633,633,634,0,1,0
179,6,1,639,639,640,0,1,5
180,6,2,645,645,647,0,2,5
181,4,2,649,649,651,0,2,2
182,5,2,654,654,656,0,2,3
183,6,3,660,660,663,0,3,4
184,2,2,662,663,665,1,3,0
185,3,2,665,665,667,0,2,0
186,2,1,667,667,668,0,1,0
187,4,3,671,671,674,0,3,3
188,6,2,677,677,679,0,2,3
189,3,3,680,680,683,0,3,1
190,4,3,684,684,687,0,3,1
191,6,3,690,690,693,0,3,3
192,5,3,695,695,698,0,3,2
193,6,2,701,701,703,0,2,3
194,4,1,705,705,706,0,1,2
195,1,3,706,706,709,0,3,0
196,1,2,707,709,711,2,4,0
197,5,2,712,712,714,0,2,1
198,5,3,717,717,720,0,3,3
199,4,3,721,721,724,0,3,1
200,6,1,727,727,728,0,1,3
201,6,1,733,733,734,0,1,5
202,5,2,738,738,740,0,2,4
203,4,2,742,742,744,0,2,2
204,1,1,743,744,745,1,2,0
205,3,3,746,746,749,0,3,1
206,5,3,751,751,754,0,3,2
207,2,3,753,754,757,1,4,0
208,5,2,758,758,760,0,2,1
209,5,3,763,763,766,0,3,3
210,6,3,769,769,772,0,3,3
211,4,1,773,773,774,0,1,1
212,1,2,774,774,776,0,2,0
213,4,3,778,778,781,0,3,2
214,6,2,784,784,786,0,2,3
215,5,3,789,789,792,0,3,3
216,6,1,795,795,796,0,1,3
217,3,1,798,798,799,0,1,2
218,6,1,804,804,805,0,1,5
219,2,2,806,806,808,0,2,1
220,4,2,810,810,812,0,2,2
221,4,3,814,814,817,0,3,2
222,5,2,819,819,821,0,2,2
223,3,3,822,822,825,0,3,1
224,6,3,828,828,831,0,3,3
225,1,2,829,831,833,2,4,0
226,4,3,833,833,836,0,3,0
227,6,3,839,839,842,0,3,3
228,4,1,843,843,844,0,1,1
229,2,3,845,845,848,0,3,1
230,6,2,851,851,853,0,2,3
231,1,2,852,853,855,1,3,0
232,3,2,855,855,857,0,2,0
233,1,1,856,857,858,1,2,0
234,6,1,862,862,863,0,1,4
235,2,2,864,864,866,0,2,1
236,1,1,865,866,867,1,2,0
237,5,2,870,870,872,0,2,3
238,2,2,872,872,874,0,2,0
239,2,2,874,874,876,0,2,0
240,1,1,875,876,877,1,2,0
241,6,1,881,881,882,0,1,4
242,6,1,887,887,888,0,1,5
243,2,1,889,889,890,0,1,1
244,4,3,893,893,896,0,3,3
245,1,1,894,896,897,2,3,0
246,4,3,898,898,901,0,3,1
247,4,3,902,902,905,0,3,1
248,4,3,906,906,909,0,3,1
249,6,2,912,912,914,0,2,3
250,2,3,914,914,917,0,3,0
251,3,1,917,917,918,0,1,0
252,2,3,919,919,922,0,3,1
253,5,3,924,924,927,0,3,2
254,1,3,925,927,930,2,5,0
255,6,3,931,931,934,0,3,1
256,3,2,934,934,936,0,2,0
257,3,3,937,937,940,0,3,1
258,1,2,938,940,942,2,4,0
259,5,2,943,943,945,0,2,1
260,4,1,947,947,948,0,1,2
261,3,3,950,950,953,0,3,2
262,5,3,955,955,958,0,3,2
263,2,2,957,958,960,1,3,0
264,6,1,963,963,964,0,1,3
265,3,3,966,966,969,0,3,2
266,1,3,967,969,972,2,5,0
267,2,1,969,972,973,3,4,0
268,5,1,974,974,975,0,1,1
269,6,2,980,980,982,0,2,5
270,6,2,986,986,988,0,2,4
271,2,2,988,988,990,0,2,0
272,3,2,991,991,993,0,2,1
273,5,2,996,996,998,0,2,3
274,3,3,999,999,1002,0,3,1
275,5,3,1004,1004,1007,0,3,2
276,2,1,1006,1007,1008,1,2,0
277,1,2,1007,1008,1010,1,3,0
278,4,2,1011,1011,1013,0,2,1
279,3,1,1014,1014,1015,0,1,1
280,4,1,1018,1018,1019,0,1,3
281,2,2,1020,1020,1022,0,2,1
282,5,3,1025,1025,1028,0,3,3
283,3,3,1028,1028,1031,0,3,0
284,1,3,1029,1031,1034,2,5,0
285,1,3,1030,1034,1037,4,7,0
286,4,2,1034,1037,1039,3,5,0
287,6,2,1040,1040,1042,0,2,1
288,6,3,1046,1046,1049,0,3,4
289,1,2,1047,1049,1051,2,4,0
290,2,3,1049,1051,1054,2,5,0
291,5,3,1054,1054,1057,0,3,0
292,2,1,1056,1057,1058,1,2,0
293,4,1,1060,1060,1061,0,1,2
294,3,2,1063,1063,1065,0,2,2
295,5,3,1068,1068,1071,0,3,3
296,2,2,1070,1071,1073,1,3,0
297,5,1,1075,1075,1076,0,1,2
298,1,3,1076,1076,1079,0,3,0
299,3,3,1079,1079,1082,0,3,0
300,4,2,1083,1083,1085,0,2,1
301,3,3,1086,1086,1089,0,3,1
302,3,1,1089,1089,1090,0,1,0
303,1,3,1090,1090,1093,0,3,0
304,3,3,1093,1093,1096,0,3,0
305,4,3,1097,1097,1100,0,3,1
306,5,2,1102,1102,1104,0,2,2
307,6,1,1108,1108,1109,0,1,4
308,4,3,1112,1112,1115,0,3,3
309,2,1,1114,1115,1116,1,2,0
310,3,2,1117,1117,1119,0,2,1
311,6,3,1123,1123,1126,0,3,4
312,3,1,1126,1126,1127,0,1,0
313,4,2,1130,1130,1132,0,2,3
314,2,3,1132,1132,1135,0,3,0
315,6,3,1138,1138,1141,0,3,3
316,1,3,1139,1141,1144,2,5,0
317,6,2,1145,1145,1147,0,2,1
318,2,3,1147,1147,1150,0,3,0
319,1,1,1148,1150,1151,2,3,0
320,1,1,1149,1151,1152,2,3,0
321,3,2,1152,1152,1154,0,2,0
322,3,3,1155,1155,1158,0,3,1
323,3,2,1158,1158,1160,0,2,0
324,3,1,1161,1161,1162,0,1,1
325,5,1,1166,1166,1167,0,1,4
326,5,2,1171,1171,1173,0,2,4
327,2,2,1173,1173,1175,0,2,0
328,4,1,1177,1177,1178,0,1,2
329,6,1,1183,1183,1184,0,1,5
330,2,2,1185,1185,1187,0,2,1
331,6,1,1191,1191,1192,0,1,4
332,1,3,1192,1192,1195,0,3,0
333,5,3,1197,1197,1200,0,3,2
334,2,2,1199,1200,1202,1,3,0
335,1,2,1200,1202,1204,2,4,0
336,3,2,1203,1204,1206,1,3,0
337,6,2,1209,1209,1211,0,2,3
338,5,3,1214,1214,1217,0,3,3
339,4,1,1218,1218,1219,0,1,1
340,4,2,1222,1222,1224,0,2,3
341,5,3,1227,1227,1230,0,3,3
342,5,3,1232,1232,1235,0,3,2
343,3,3,1235,1235,1238,0,3,0
344,2,2,1237,1238,1240,1,3,0
345,6,1,1243,1243,1244,0,1,3
346,4,3,1247,1247,1250,0,3,3
347,4,3,1251,1251,1254,0,3,1
348,4,2,1255,1255,1257,0,2,1
349,1,1,1256,1257,1258,1,2,0
350,2,3,1258,1258,1261,0,3,0
351,5,1,1263,1263,1264,0,1,2
352,6,3,1269,1269,1272,0,3,5
353,5,1,1274,1274,1275,0,1,2
354,4,2,1278,1278,1280,0,2,3
355,3,2,1281,1281,1283,0,2,1
356,4,1,1285,1285,1286,0,1,2
357,4,2,1289,1289,1291,0,2,3
358,1,3,1290,1291,1294,1,4,0
359,3,1,1293,1294,1295,1,2,0
360,1,2,1294,1295,1297,1,3,0
361,4,3,1298,1298,1301,0,3,1
362,4,3,1302,1302,1305,0,3,1
363,5,2,1307,1307,1309,0,2,2
364,6,2,1313,1313,1315,0,2,4
365,3,1,1316,1316,1317,0,1,1
366,4,1,1320,1320,1321,0,1,3
367,1,1,1321,1321,1322,0,1,0
368,3,2,1324,1324,1326,0,2,2
369,3,1,1327,1327,1328,0,1,1
370,4,3,1331,1331,1334,0,3,3
371,1,3,1332,1334,1337,2,5,0
372,4,1,1336,1337,1338,1,2,0
373,6,1,1342,1342,1343,0,1,4
374,4,2,1346,1346,1348,0,2,3
375,2,2,1348,1348,1350,0,2,0
376,3,2,1351,1351,1353,0,2,1
377,5,3,1356,1356,1359,0,3,3
378,6,2,1362,1362,1364,0,2,3
379,3,2,1365,1365,1367,0,2,1
380,5,3,1370,1370,1373,0,3,3
381,1,2,1371,1373,1375,2,4,0
382,5,2,1376,1376,1378,0,2,1
383,3,2,1379,1379,1381,0,2,1
384,4,2,1383,1383,1385,0,2,2
385,3,3,1386,1386,1389,0,3,1
386,4,3,1390,1390,1393,0,3,1
387,3,3,1393,1393,1396,0,3,0
388,4,2,1397,1397,1399,0,2,1
389,3,1,1400,1400,1401,0,1,1
390,4,1,1404,1404,1405,0,1,3
391,4,2,1408,1408,1410,0,2,3
392,5,1,1413,1413,1414,0,1,3
393,5,2,1418,1418,1420,0,2,4
394,3,1,1421,1421,1422,0,1,1
395,3,2,1424,1424,1426,0,2,2
396,1,2,1425,1426,1428,1,3,0
397,1,3,1426,1428,1431,2,5,0
398,4,3,1430,1431,1434,1,4,0
399,3,2,1433,1434,1436,1,3,0
400,6,2,1439,1439,1441,0,2,3
401,2,3,1441,1441,1444,0,3,0
402,3,1,1444,1444,1445,0,1,0
403,4,1,1448,1448,1449,0,1,3
404,5,2,1453,1453,1455,0,2,4
405,3,2,1456,1456,1458,0,2,1
406,5,1,1461,1461,1462,0,1,3
407,5,2,1466,1466,1468,0,2,4
408,2,3,1468,1468,1471,0,3,0
409,4,2,1472,1472,1474,0,2,1
410,2,3,1474,1474,1477,0,3,0
411,2,3,1476,1477,1480,1,4,0
412,6,2,1482,1482,1484,0,2,2
413,3,3,1485,1485,1488,0,3,1
414,1,3,1486,1488,1491,2,5,0
415,5,3,1491,1491,1494,0,3,0
416,6,2,1497,1497,1499,0,2,3
417,4,2,1501,1501,1503,0,2,2
418,1,3,1502,1503,1506,1,4,0
419,5,1,1507,1507,1508,0,1,1
420,3,2,1510,1510,1512,0,2,2
421,4,1,1514,1514,1515,0,1,2
422,3,2,1517,1517,1519,0,2,2
423,6,3,1523,1523,1526,0,3,4
424,4,3,1527,1527,1530,0,3,1
425,1,2,1528,1530,1532,2,4,0
426,4,3,1532,1532,1535,0,3,0
427,5,2,1537,1537,1539,0,2,2
428,6,2,1543,1543,1545,0,2,4
429,2,3,1545,1545,1548,0,3,0
430,4,3,1549,1549,1552,0,3,1
431,1,2,1550,1552,1554,2,4,0
432,1,1,1551,1554,1555,3,4,0
433,3,2,1554,1555,1557,1,3,0
434,4,2,1558,1558,1560,0,2,1
435,2,1,1560,1560,1561,0,1,0
436,5,3,1565,1565,1568,0,3,4
437,3,1,1568,1568,1569,0,1,0
438,3,1,1571,1571,1572,0,1,2
439,1,2,1572,1572,1574,0,2,0
440,6,3,1578,1578,1581,0,3,4
441,5,1,1583,1583,1584,0,1,2
442,5,2,1588,1588,1590,0,2,4
443,1,3,1589,1590,1593,1,4,0
444,2,3,1591,1593,1596,2,5,0
445,1,2,1592,1596,1598,4,6,0
446,3,3,1595,1598,1601,3,6,0
447,4,1,1599,1601,1602,2,3,0
448,3,3,1602,1602,1605,0,3,0
449,1,3,1603,1605,1608,2,5,0
450,1,2,1604,1608,1610,4,6,0
451,3,2,1607,1610,1612,3,5,0
452,3,2,1610,1612,1614,2,4,0
453,5,3,1615,1615,1618,0,3,1
454,5,3,1620,1620,1623,0,3,2
455,2,1,1622,1623,1624,1,2,0
456,6,1,1628,1628,1629,0,1,4
457,4,2,1632,1632,1634,0,2,3
458,1,2,1633,1634,1636,1,3,0
459,2,3,1635,1636,1639,1,4,0
460,2,3,1637,1639,1642,2,5,0
461,4,1,1641,1642,1643,1,2,0
462,2,2,1643,1643,1645,0,2,0
463,4,1,1647,1647,1648,0,1,2
464,4,3,1651,1651,1654,0,3,3
465,2,1,1653,1654,1655,1,2,0
466,6,1,1659,1659,1660,0,1,4
467,5,3,1664,1664,1667,0,3,4
468,5,1,1669,1669,1670,0,1,2
469,5,1,1674,1674,1675,0,1,4
470,3,3,1677,1677,1680,0,3,2
471,2,1,1679,1680,1681,1,2,0
472,6,2,1685,1685,1687,0,2,4
473,2,1,1687,1687,1688,0,1,0
474,4,1,1691,1691,1692,0,1,3
475,4,2,1695,1695,1697,0,2,3
476,6,2,1701,1701,1703,0,2,4
477,1,3,1702,1703,1706,1,4,0
478,1,3,1703,1706,1709,3,6,0
479,2,1,1705,1709,1710,4,5,0
480,3,3,1708,1710,1713,2,5,0
481,3,2,1711,1713,1715,2,4,0
482,4,1,1715,1715,1716,0,1,0
483,4,2,1719,1719,1721,0,2,3
484,2,3,1721,1721,1724,0,3,0
485,6,1,1727,1727,1728,0,1,3
486,3,2,1730,1730,1732,0,2,2
487,1,2,1731,1732,1734,1,3,0
488,4,2,1735,1735,1737,0,2,1
489,4,1,1739,1739,1740,0,1,2
490,6,2,1745,1745,1747,0,2,5
491,5,2,1750,1750,1752,0,2,3
492,5,2,1755,1755,1757,0,2,3
493,3,2,1758,1758,1760,0,2,1
494,1,3,1759,1760,1763,1,4,0
495,4,3,1763,1763,1766,0,3,0
496,4,1,1767,1767,1768,0,1,1
497,6,1,1773,1773,1774,0,1,5
498,1,2,1774,1774,1776,0,2,0
499,1,3,1775,1776,1779,1,4,0
500,6,3,1781,1781,1784,0,3,2
501,1,3,1782,1784,1787,2,5,0
502,6,1,1788,1788,1789,0,1,1
503,5,1,1793,1793,1794,0,1,4
504,4,2,1797,1797,1799,0,2,3
505,2,3,1799,1799,1802,0,3,0
506,5,2,1804,1804,1806,0,2,2
507,4,2,1808,1808,1810,0,2,2
508,6,3,1814,1814,1817,0,3,4
509,2,2,1816,1817,1819,1,3,0
510,1,1,1817,1819,1820,2,3,0
511,1,3,1818,1820,1823,2,5,0
512,3,2,1821,1823,1825,2,4,0
513,1,3,1822,1825,1828,3,6,0
514,3,3,1825,1828,1831,3,6,0
515,5,2,1830,1831,1833,1,3,0
516,2,2,1832,1833,1835,1,3,0
517,5,1,1837,1837,1838,0,1,2
518,2,3,1839,1839,1842,0,3,1
519,2,1,1841,1842,1843,1,2,0
520,3,3,1844,1844,1847,0,3,1
521,2,2,1846,1847,1849,1,3,0
522,6,1,1852,1852,1853,0,1,3
523,3,1,1855,1855,1856,0,1,2
524,2,2,1857,1857,1859,0,2,1
525,5,3,1862,1862,1865,0,3,3
526,5,2,1867,1867,1869,0,2,2
527,4,1,1871,1871,1872,0,1,2
528,6,1,1877,1877,1878,0,1,5
529,5,3,1882,1882,1885,0,3,4
530,2,2,1884,1885,1887,1,3,0
531,5,3,1889,1889,1892,0,3,2
532,5,3,1894,1894,1897,0,3,2
533,2,2,1896,1897,1899,1,3,0
534,5,3,1901,1901,1904,0,3,2
535,5,3,1906,1906,1909,0,3,2
536,2,3,1908,1909,1912,1,4,0
537,1,3,1909,1912,1915,3,6,0
538,5,1,1914,1915,1916,1,2,0
539,2,3,1916,1916,1919,0,3,0
540,5,3,1921,1921,1924,0,3,2
541,4,1,1925,1925,1926,0,1,1
542,6,1,1931,1931,1932,0,1,5
543,5,1,1936,1936,1937,0,1,4
544,4,2,1940,1940,1942,0,2,3
545,5,3,1945,1945,1948,0,3,3
546,5,1,1950,1950,1951,0,1,2
547,6,1,1956,1956,1957,0,1,5
548,2,3,1958,1958,1961,0,3,1
549,6,1,1964,1964,1965,0,1,3
550,6,3,1970,1970,1973,0,3,5
551,5,2,1975,1975,1977,0,2,2
552,2,3,1977,1977,1980,0,3,0
553,2,2,1979,1980,1982,1,3,0
554,6,3,1985,1985,1988,0,3,3
555,5,3,1990,1990,1993,0,3,2
556,5,1,1995,1995,1996,0,1,2
557,5,2,2000,2000,2002,0,2,4
558,5,2,2005,2005,2007,0,2,3
559,5,1,2010,2010,2011,0,1,3
560,6,1,2016,2016,2017,0,1,5
561,3,3,2019,2019,2022,0,3,2
562,3,2,2022,2022,2024,0,2,0
563,1,1,2023,2024,2025,1,2,0
564,4,1,2027,2027,2028,0,1,2
565,3,3,2030,2030,2033,0,3,2
566,1,3,2031,2033,2036,2,5,0
567,2,1,2033,2036,2037,3,4,0
568,1,1,2034,2037,2038,3,4,0
569,4,3,2038,2038,2041,0,3,0
570,6,2,2044,2044,2046,0,2,3
571,1,2,2045,2046,2048,1,3,0
572,1,2,2046,2048,2050,2,4,0
573,4,1,2050,2050,2051,0,1,0
574,5,1,2055,2055,2056,0,1,4
575,5,1,2060,2060,2061,0,1,4
576,6,3,2066,2066,2069,0,3,5
577,2,3,2068,2069,2072,1,4,0
578,6,2,2074,2074,2076,0,2,2
579,4,3,2078,2078,2081,0,3,2
580,4,2,2082,2082,2084,0,2,1
581,3,1,2085,2085,2086,0,1,1
582,4,2,2089,2089,2091,0,2,3
583,4,1,2093,2093,2094,0,1,2
584,4,2,2097,2097,2099,0,2,3
585,6,2,2103,2103,2105,0,2,4
586,2,1,2105,2105,2106,0,1,0
587,5,3,2110,2110,2113,0,3,4
588,6,2,2116,2116,2118,0,2,3
589,5,3,2121,2121,2124,0,3,3
590,3,2,2124,2124,2126,0,2,0
591,1,3,2125,2126,2129,1,4,0
592,4,1,2129,2129,2130,0,1,0
593,6,1,2135,2135,2136,0,1,5
594,6,2,2141,2141,2143,0,2,5
595,4,1,2145,2145,2146,0,1,2
596,2,3,2147,2147,2150,0,3,1
597,6,3,2153,2153,2156,0,3,3
598,6,3,2159,2159,2162,0,3,3
599,4,1,2163,2163,2164,0,1,1
600,3,2,2166,2166,2168,0,2,2
601,2,3,2168,2168,2171,0,3,0
602,6,2,2174,2174,2176,0,2,3
603,2,1,2176,2176,2177,0,1,0
604,3,2,2179,2179,2181,0,2,2
605,3,1,2182,2182,2183,0,1,1
606,1,1,2183,2183,2184,0,1,0
607,3,2,2186,2186,2188,0,2,2
608,5,1,2191,2191,2192,0,1,3
609,3,2,2194,2194,2196,0,2,2
610,6,2,2200,2200,2202,0,2,4
611,6,1,2206,2206,2207,0,1,4
612,4,3,2210,2210,2213,0,3,3
613,2,1,2212,2213,2214,1,2,0
614,1,1,2213,2214,2215,1,2,0
615,2,2,2215,2215,2217,0,2,0
616,2,3,2217,2217,2220,0,3,0
617,6,3,2223,2223,2226,0,3,3
618,6,1,2229,2229,2230,0,1,3
619,2,1,2231,2231,2232,0,1,1
620,3,1,2234,2234,2235,0,1,2
621,2,1,2236,2236,2237,0,1,1
622,1,2,2237,2237,2239,0,2,0
623,4,2,2241,2241,2243,0,2,2
624,3,1,2244,2244,2245,0,1,1
625,6,3,2250,2250,2253,0,3,5
626,5,2,2255,2255,2257,0,2,2
627,4,1,2259,2259,2260,0,1,2
628,4,1,2263,2263,2264,0,1,3
629,2,3,2265,2265,2268,0,3,1
630,1,3,2266,2268,2271,2,5,0
631,5,1,2271,2271,2272,0,1,0
632,4,3,2275,2275,2278,0,3,3
633,6,2,2281,2281,2283,0,2,3
634,4,3,2285,2285,2288,0,3,2
635,5,2,2290,2290,2292,0,2,2
636,4,1,2294,2294,2295,0,1,2
637,6,2,2300,2300,2302,0,2,5
638,6,3,2306,2306,2309,0,3,4
639,5,1,2311,2311,2312,0,1,2
640,5,1,2316,2316,2317,0,1,4
641,3,3,2319,2319,2322,0,3,2
642,2,3,2321,2322,2325,1,4,0
643,3,2,2324,2325,2327,1,3,0
644,1,1,2325,2327,2328,2,3,0
645,6,3,2331,2331,2334,0,3,3
646,5,3,2336,2336,2339,0,3,2
647,1,3,2337,2339,2342,2,5,0
648,5,1,2342,2342,2343,0,1,0
649,2,2,2344,2344,2346,0,2,1
650,3,1,2347,2347,2348,0,1,1
651,2,3,2349,2349,2352,0,3,1
652,6,3,2355,2355,2358,0,3,3
653,2,2,2357,2358,2360,1,3,0
654,4,2,2361,2361,2363,0,2,1
655,6,1,2367,2367,2368,0,1,4
656,4,3,2371,2371,2374,0,3,3
657,5,1,2376,2376,2377,0,1,2
658,2,2,2378,2378,2380,0,2,1
659,5,3,2383,2383,2386,0,3,3
660,2,2,2385,2386,2388,1,3,0
661,4,1,2389,2389,2390,0,1,1
662,1,3,2390,2390,2393,0,3,0
663,6,1,2396,2396,2397,0,1,3
664,6,1,2402,2402,2403,0,1,5
665,3,3,2405,2405,2408,0,3,2
666,6,1,2411,2411,2412,0,1,3
667,1,2,2412,2412,2414,0,2,0
668,4,1,2416,2416,2417,0,1,2
669,3,1,2419,2419,2420,0,1,2
670,2,1,2421,2421,2422,0,1,1
671,4,2,2425,2425,2427,0,2,3
672,3,3,2428,2428,2431,0,3,1
673,4,3,2432,2432,2435,0,3,1
674,2,3,2434,2435,2438,1,4,0
675,4,1,2438,2438,2439,0,1,0
676,1,3,2439,2439,2442,0,3,0
677,6,3,2445,2445,2448,0,3,3
678,6,2,2451,2451,2453,0,2,3
679,2,1,2453,2453,2454,0,1,0
680,5,3,2458,2458,2461,0,3,4
681,5,1,2463,2463,2464,0,1,2
682,6,1,2469,2469,2470,0,1,5
683,1,3,2470,2470,2473,0,3,0
684,1,3,2471,2473,2476,2,5,0
685,4,1,2475,2476,2477,1,2,0
686,1,3,2476,2477,2480,1,4,0
687,6,1,2482,2482,2483,0,1,2
688,6,1,2488,2488,2489,0,1,5
689,3,3,2491,2491,2494,0,3,2
690,4,1,2495,2495,2496,0,1,1
691,1,2,2496,2496,2498,0,2,0
692,6,3,2502,2502,2505,0,3,4
693,5,2,2507,2507,2509,0,2,2
694,3,3,2510,2510,2513,0,3,1
695,5,1,2515,2515,2516,0,1,2
696,1,2,2516,2516,2518,0,2,0
697,1,3,2517,2518,2521,1,4,0
698,2,2,2519,2521,2523,2,4,0
699,4,2,2523,2523,2525,0,2,0
700,5,3,2528,2528,2531,0,3,3
701,1,3,2529,2531,2534,2,5,0
702,4,1,2533,2534,2535,1,2,0
703,4,2,2537,2537,2539,0,2,2
704,3,2,2540,2540,2542,0,2,1
705,1,1,2541,2542,2543,1,2,0
706,4,3,2545,2545,2548,0,3,2
707,2,1,2547,2548,2549,1,2,0
708,6,3,2553,2553,2556,0,3,4
709,5,3,2558,2558,2561,0,3,2
710,6,2,2564,2564,2566,0,2,3
711,4,2,2568,2568,2570,0,2,2
712,2,3,2570,2570,2573,0,3,0
713,4,3,2574,2574,2577,0,3,1
714,2,2,2576,2577,2579,1,3,0
715,2,3,2578,2579,2582,1,4,0
716,4,1,2582,2582,2583,0,1,0
717,1,3,2583,2583,2586,0,3,0
718,2,2,2585,2586,2588,1,3,0
719,2,3,2587,2588,2591,1,4,0
720,6,1,2593,2593,2594,0,1,2
721,5,3,2598,2598,2601,0,3,4
722,5,3,2603,2603,2606,0,3,2
723,1,2,2604,2606,2608,2,4,0
724,6,1,2610,2610,2611,0,1,2
725,6,1,2616,2616,2617,0,1,5
726,2,1,2618,2618,2619,0,1,1
727,4,3,2622,2622,2625,0,3,3
728,6,1,2628,2628,2629,0,1,3
729,5,1,2633,2633,2634,0,1,4
730,6,1,2639,2639,2640,0,1,5
731,4,1,2643,2643,2644,0,1,3
732,1,2,2644,2644,2646,0,2,0
733,6,2,2650,2650,2652,0,2,4
734,3,1,2653,2653,2654,0,1,1
735,2,3,2655,2655,2658,0,3,1
736,2,2,2657,2658,2660,1,3,0
737,5,2,2662,2662,2664,0,2,2
738,3,1,2665,2665,2666,0,1,1
739,3,1,2668,2668,2669,0,1,2
740,4,1,2672,2672,2673,0,1,3
741,3,3,2675,2675,2678,0,3,2
742,5,2,2680,2680,2682,0,2,2
743,6,1,2686,2686,2687,0,1,4
744,5,3,2691,2691,2694,0,3,4
745,4,2,2695,2695,2697,0,2,1
746,6,3,2701,2701,2704,0,3,4
747,3,2,2704,2704,2706,0,2,0
748,5,3,2709,2709,2712,0,3,3
749,3,3,2712,2712,2715,0,3,0
750,1,2,2713,2715,2717,2,4,0
751,2,2,2715,2717,2719,2,4,0
752,6,3,2721,2721,2724,0,3,2
753,4,3,2725,2725,2728,0,3,1
754,1,1,2726,2728,2729,2,3,0
755,1,3,2727,2729,2732,2,5,0
756,4,1,2731,2732,2733,1,2,0
757,4,2,2735,2735,2737,0,2,2
758,1,1,2736,2737,2738,1,2,0
759,5,1,2741,2741,2742,0,1,3
760,5,3,2746,2746,2749,0,3,4
761,2,3,2748,2749,2752,1,4,0
762,6,3,2754,2754,2757,0,3,2
763,6,3,2760,2760,2763,0,3,3
764,1,2,2761,2763,2765,2,4,0
765,3,1,2764,2765,2766,1,2,0
766,3,2,2767,2767,2769,0,2,1
767,5,1,2772,2772,2773,0,1,3
768,6,3,2778,2778,2781,0,3,5
769,5,1,2783,2783,2784,0,1,2
770,4,3,2787,2787,2790,0,3,3
771,3,3,2790,2790,2793,0,3,0
772,3,3,2793,2793,2796,0,3,0
773,5,1,2798,2798,2799,0,1,2
774,4,1,2802,2802,2803,0,1,3
775,1,1,2803,2803,2804,0,1,0
776,5,1,2808,2808,2809,0,1,4
777,6,3,2814,2814,2817,0,3,5
778,4,3,2818,2818,2821,0,3,1
779,1,2,2819,2821,2823,2,4,0
780,2,3,2821,2823,2826,2,5,0
781,5,1,2826,2826,2827,0,1,0
782,5,1,2831,2831,2832,0,1,4
783,5,1,2836,2836,2837,0,1,4
784,2,1,2838,2838,2839,0,1,1
785,4,3,2842,2842,2845,0,3,3
786,3,2,2845,2845,2847,0,2,0
787,3,3,2848,2848,2851,0,3,1
788,5,3,2853,2853,2856,0,3,2
789,4,2,2857,2857,2859,0,2,1
790,1,3,2858,2859,2862,1,4,0
791,4,3,2862,2862,2865,0,3,0
792,1,1,2863,2865,2866,2,3,0
793,5,1,2868,2868,2869,0,1,2
794,6,1,2874,2874,2875,0,1,5
795,4,1,2878,2878,2879,0,1,3
796,5,3,2883,2883,2886,0,3,4
797,6,1,2889,2889,2890,0,1,3
798,1,2,2890,2890,2892,0,2,0
799,3,1,2893,2893,2894,0,1,1
800,3,1,2896,2896,2897,0,1,2
801,2,3,2898,2898,2901,0,3,1
802,6,3,2904,2904,2907,0,3,3
803,4,1,2908,2908,2909,0,1,1
804,6,3,2914,2914,2917,0,3,5
805,4,1,2918,2918,2919,0,1,1
806,1,2,2919,2919,2921,0,2,0
807,2,2,2921,2921,2923,0,2,0
808,3,3,2924,2924,2927,0,3,1
809,2,3,2926,2927,2930,1,4,0
810,6,1,2932,2932,2933,0,1,2
811,5,3,2937,2937,2940,0,3,4
812,2,3,2939,2940,2943,1,4,0
813,2,3,2941,2943,2946,2,5,0
814,1,3,2942,2946,2949,4,7,0
815,3,2,2945,2949,2951,4,6,0
816,3,3,2948,2951,2954,3,6,0
817,6,3,2954,2954,2957,0,3,0
818,6,2,2960,2960,2962,0,2,3
819,3,3,2963,2963,2966,0,3,1
820,1,1,2964,2966,2967,2,3,0
821,1,1,2965,2967,2968,2,3,0
822,6,3,2971,2971,2974,0,3,3
823,6,2,2977,2977,2979,0,2,3
824,6,2,2983,2983,2985,0,2,4
825,3,1,2986,2986,2987,0,1,1
826,5,2,2991,2991,2993,0,2,4
827,2,3,2993,2993,2996,0,3,0
828,2,3,2995,2996,2999,1,4,0
829,6,2,3001,3001,3003,0,2,2
830,3,1,3004,3004,3005,0,1,1
831,4,3,3008,3008,3011,0,3,3
832,4,1,3012,3012,3013,0,1,1
833,6,1,3018,3018,3019,0,1,5
834,2,3,3020,3020,3023,0,3,1
835,2,3,3022,3023,3026,1,4,0
836,6,2,3028,3028,3030,0,2,2
837,5,3,3033,3033,3036,0,3,3
838,1,3,3034,3036,3039,2,5,0
839,4,1,3038,3039,3040,1,2,0
840,6,2,3044,3044,3046,0,2,4
841,3,1,3047,3047,3048,0,1,1
842,6,1,3053,3053,3054,0,1,5
843,5,2,3058,3058,3060,0,2,4
844,5,3,3063,3063,3066,0,3,3
845,4,2,3067,3067,3069,0,2,1
846,6,1,3073,3073,3074,0,1,4
847,5,1,3078,3078,3079,0,1,4
848,4,1,3082,3082,3083,0,1,3
849,6,1,3088,3088,3089,0,1,5
850,6,3,3094,3094,3097,0,3,5
851,3,2,3097,3097,3099,0,2,0
852,2,3,3099,3099,3102,0,3,0
853,3,1,3102,3102,3103,0,1,0
854,1,2,3103,3103,3105,0,2,0
855,3,1,3106,3106,3107,0,1,1
856,5,2,3111,3111,3113,0,2,4
857,1,3,3112,3113,3116,1,4,0
858,1,2,3113,3116,3118,3,5,0
859,2,3,3115,3118,3121,3,6,0
860,4,1,3119,3121,3122,2,3,0
861,1,1,3120,3122,3123,2,3,0
862,3,1,3123,3123,3124,0,1,0
863,1,1,3124,3124,3125,0,1,0
864,1,1,3125,3125,3126,0,1,0
865,3,1,3128,3128,3129,0,1,2
866,5,2,3133,3133,3135,0,2,4
867,3,2,3136,3136,3138,0,2,1
868,6,1,3142,3142,3143,0,1,4
869,5,3,3147,3147,3150,0,3,4
870,3,2,3150,3150,3152,0,2,0
871,6,2,3156,3156,3158,0,2,4
872,6,2,3162,3162,3164,0,2,4
873,3,1,3165,3165,3166,0,1,1
874,6,2,3171,3171,3173,0,2,5
875,1,1,3172,3173,3174,1,2,0
876,6,2,3178,3178,3180,0,2,4
877,5,2,3183,3183,3185,0,2,3
878,1,3,3184,3185,3188,1,4,0
879,1,1,3185,3188,3189,3,4,0
880,4,3,3189,3189,3192,0,3,0
881,1,1,3190,3192,3193,2,3,0
882,6,3,3196,3196,3199,0,3,3
883,4,2,3200,3200,3202,0,2,1
884,6,2,3206,3206,3208,0,2,4
885,1,2,3207,3208,3210,1,3,0
886,3,1,3210,3210,3211,0,1,0
887,5,2,3215,3215,3217,0,2,4
888,3,2,3218,3218,3220,0,2,1
889,2,2,3220,3220,3222,0,2,0
890,5,1,3225,3225,3226,0,1,3
891,4,1,3229,3229,3230,0,1,3
892,2,1,3231,3231,3232,0,1,1
893,4,3,3235,3235,3238,0,3,3
894,2,1,3237,3238,3239,1,2,0
895,3,3,3240,3240,3243,0,3,1
896,1,1,3241,3243,3244,2,3,0
897,2,1,3243,3244,3245,1,2,0
898,4,2,3247,3247,3249,0,2,2
899,5,2,3252,3252,3254,0,2,3
900,6,3,3258,3258,3261,0,3,4
901,1,3,3259,3261,3264,2,5,0
902,5,2,3264,3264,3266,0,2,0
903,1,2,3265,3266,3268,1,3,0
904,3,3,3268,3268,3271,0,3,0
905,1,3,3269,3271,3274,2,5,0
906,3,3,3272,3274,3277,2,5,0
907,2,2,3274,3277,3279,3,5,0
908,4,2,3278,3279,3281,1,3,0
909,4,2,3282,3282,3284,0,2,1
910,1,2,3283,3284,3286,1,3,0
911,2,2,3285,3286,3288,1,3,0
912,1,2,3286,3288,3290,2,4,0
913,2,1,3288,3290,3291,2,3,0
914,4,3,3292,3292,3295,0,3,1
915,3,2,3295,3295,3297,0,2,0
916,1,2,3296,3297,3299,1,3,0
917,6,1,3302,3302,3303,0,1,3
918,4,3,3306,3306,3309,0,3,3
919,4,1,3310,3310,3311,0,1,1
920,4,3,3314,3314,3317,0,3,3
921,2,1,3316,3317,3318,1,2,0
922,2,3,3318,3318,3321,0,3,0
923,1,3,3319,3321,3324,2,5,0
924,6,2,3325,3325,3327,0,2,1
925,6,3,3331,3331,3334,0,3,4
926,6,1,3337,3337,3338,0,1,3
927,3,2,3340,3340,3342,0,2,2
928,5,3,3345,3345,3348,0,3,3
929,6,3,3351,3351,3354,0,3,3
930,3,2,3354,3354,3356,0,2,0
931,6,3,3360,3360,3363,0,3,4
932,5,2,3365,3365,3367,0,2,2
933,2,3,3367,3367,3370,0,3,0
934,1,1,3368,3370,3371,2,3,0
935,4,3,3372,3372,3375,0,3,1
936,4,3,3376,3376,3379,0,3,1
937,5,2,3381,3381,3383,0,2,2
938,5,3,3386,3386,3389,0,3,3
939,6,2,3392,3392,3394,0,2,3
940,3,3,3395,3395,3398,0,3,1
941,2,1,3397,3398,3399,1,2,0
942,2,1,3399,3399,3400,0,1,0
943,6,1,3405,3405,3406,0,1,5
944,6,1,3411,3411,3412,0,1,5
945,3,1,3414,3414,3415,0,1,2
946,5,2,3419,3419,3421,0,2,4
947,4,3,3423,3423,3426,0,3,2
948,1,3,3424,3426,3429,2,5,0
949,4,1,3428,3429,3430,1,2,0
950,4,1,3432,3432,3433,0,1,2
951,5,2,3437,3437,3439,0,2,4
952,4,1,3441,3441,3442,0,1,2
953,6,1,3447,3447,3448,0,1,5
954,5,3,3452,3452,3455,0,3,4
955,5,1,3457,3457,3458,0,1,2
956,5,2,3462,3462,3464,0,2,4
957,6,2,3468,3468,3470,0,2,4
958,2,1,3470,3470,3471,0,1,0
959,5,1,3475,3475,3476,0,1,4
960,3,1,3478,3478,3479,0,1,2
961,4,2,3482,3482,3484,0,2,3
962,6,2,3488,3488,3490,0,2,4
963,6,1,3494,3494,3495,0,1,4
964,5,1,3499,3499,3500,0,1,4
965,1,3,3500,3500,3503,0,3,0
966,3,2,3503,3503,3505,0,2,0
967,1,3,3504,3505,3508,1,4,0
968,6,1,3510,3510,3511,0,1,2
969,4,2,3514,3514,3516,0,2,3
970,6,2,3520,3520,3522,0,2,4
971,2,2,3522,3522,3524,0,2,0
972,1,3,3523,3524,3527,1,4,0
973,1,2,3524,3527,3529,3,5,0
974,3,3,3527,3529,3532,2,5,0
975,2,2,3529,3532,3534,3,5,0
976,6,1,3535,3535,3536,0,1,1
977,1,3,3536,3536,3539,0,3,0
978,2,2,3538,3539,3541,1,3,0
979,4,3,3542,3542,3545,0,3,1
980,2,3,3544,3545,3548,1,4,0
981,3,2,3547,3548,3550,1,3,0
982,6,2,3553,3553,3555,0,2,3
983,5,3,3558,3558,3561,0,3,3
984,6,1,3564,3564,3565,0,1,3
985,3,3,3567,3567,3570,0,3,2
986,2,3,3569,3570,3573,1,4,0
987,6,1,3575,3575,3576,0,1,2
988,4,3,3579,3579,3582,0,3,3
989,2,1,3581,3582,3583,1,2,0
990,2,3,3583,3583,3586,0,3,0
991,5,3,3588,3588,3591,0,3,2
992,4,2,3592,3592,3594,0,2,1
993,2,3,3594,3594,3597,0,3,0
994,2,3,3596,3597,3600,1,4,0
995,4,1,3600,3600,3601,0,1,0
996,4,1,3604,3604,3605,0,1,3
997,5,3,3609,3609,3612,0,3,4
998,3,1,3612,3612,3613,0,1,0
999,3,1,3615,3615,3616,0,1,2
1000,2,1,3617,3617,3618,0,1,1
1001,2,1,3619,3619,3620,0,1,1
1002,3,1,3622,3622,3623,0,1,2
1003,2,1,3624,3624,3625,0,1,1
1004,2,1,3626,3626,3627,0,1,1
1005,4,1,3630,3630,3631,0,1,3
1006,5,3,3635,3635,3638,0,3,4
1007,2,3,3637,3638,3641,1,4,0
1008,6,3,3643,3643,3646,0,3,2
1009,4,1,3647,3647,3648,0,1,1
1010,1,1,3648,3648,3649,0,1,0
1011,3,1,3651,3651,3652,0,1,2
1012,2,2,3653,3653,3655,0,2,1
1013,5,3,3658,3658,3661,0,3,3
1014,3,3,3661,3661,3664,0,3,0
1015,3,1,3664,3664,3665,0,1,0
1016,3,3,3667,3667,3670,0,3,2
1017,4,2,3671,3671,3673,0,2,1
1018,3,3,3674,3674,3677,0,3,1
1019,1,2,3675,3677,3679,2,4,0
1020,2,3,3677,3679,3682,2,5,0
1021,6,2,3683,3683,3685,0,2,1
1022,6,1,3689,3689,3690,0,1,4
1023,4,1,3693,3693,3694,0,1,3
1024,4,3,3697,3697,3700,0,3,3
1025,4,3,3701,3701,3704,0,3,1
1026,4,1,3705,3705,3706,0,1,1
1027,2,2,3707,3707,3709,0,2,1
1028,3,1,3710,3710,3711,0,1,1
1029,6,3,3716,3716,3719,0,3,5
1030,5,3,3721,3721,3724,0,3,2
1031,4,1,3725,3725,3726,0,1,1
1032,6,1,3731,3731,3732,0,1,5
1033,2,3,3733,3733,3736,0,3,1
1034,5,1,3738,3738,3739,0,1,2
1035,4,1,3742,3742,3743,0,1,3
1036,1,1,3743,3743,3744,0,1,0
1037,4,1,3747,3747,3748,0,1,3
1038,6,2,3753,3753,3755,0,2,5
1039,3,1,3756,3756,3757,0,1,1
1040,3,2,3759,3759,3761,0,2,2
1041,4,2,3763,3763,3765,0,2,2
1042,1,3,3764,3765,3768,1,4,0
1043,5,1,3769,3769,3770,0,1,1
1044,2,1,3771,3771,3772,0,1,1
1045,6,1,3777,3777,3778,0,1,5
1046,6,3,3783,3783,3786,0,3,5
1047,3,1,3786,3786,3787,0,1,0
1048,6,3,3792,3792,3795,0,3,5
1049,3,2,3795,3795,3797,0,2,0
1050,3,3,3798,3798,3801,0,3,1
1051,2,2,3800,3801,3803,1,3,0
1052,2,3,3802,3803,3806,1,4,0
1053,4,3,3806,3806,3809,0,3,0
1054,2,3,3808,3809,3812,1,4,0
1055,1,1,3809,3812,3813,3,4,0
1056,2,3,3811,3813,3816,2,5,0
1057,1,1,3812,3816,3817,4,5,0
1058,3,1,3815,3817,3818,2,3,0
1059,2,3,3817,3818,3821,1,4,0
1060,5,3,3822,3822,3825,0,3,1
1061,3,3,3825,3825,3828,0,3,0
1062,1,1,3826,3828,3829,2,3,0
1063,2,2,3828,3829,3831,1,3,0
1064,6,2,3834,3834,3836,0,2,3
1065,6,2,3840,3840,3842,0,2,4
1066,3,1,3843,3843,3844,0,1,1
1067,3,3,3846,3846,3849,0,3,2
1068,4,2,3850,3850,3852,0,2,1
1069,3,2,3853,3853,3855,0,2,1
1070,3,3,3856,3856,3859,0,3,1
1071,5,2,3861,3861,3863,0,2,2
1072,5,1,3866,3866,3867,0,1,3
1073,6,1,3872,3872,3873,0,1,5
1074,4,3,3876,3876,3879,0,3,3
1075,6,3,3882,3882,3885,0,3,3
1076,1,3,3883,3885,3888,2,5,0
1077,3,3,3886,3888,3891,2,5,0
1078,6,1,3892,3892,3893,0,1,1
1079,6,2,3898,3898,3900,0,2,5
1080,2,3,3900,3900,3903,0,3,0
1081,4,1,3904,3904,3905,0,1,1
1082,5,3,3909,3909,3912,0,3,4
1083,3,2,3912,3912,3914,0,2,0
1084,4,3,3916,3916,3919,0,3,2
1085,3,1,3919,3919,3920,0,1,0
1086,6,1,3925,3925,3926,0,1,5
1087,6,2,3931,3931,3933,0,2,5
1088,1,3,3932,3933,3936,1,4,0
1089,3,2,3935,3936,3938,1,3,0
1090,5,1,3940,3940,3941,0,1,2
1091,5,1,3945,3945,3946,0,1,4
1092,6,1,3951,3951,3952,0,1,5
1093,1,2,3952,3952,3954,0,2,0
1094,2,1,3954,3954,3955,0,1,0
1095,6,2,3960,3960,3962,0,2,5
1096,2,1,3962,3962,3963,0,1,0
1097,6,1,3968,3968,3969,0,1,5
1098,5,2,3973,3973,3975,0,2,4
1099,2,3,3975,3975,3978,0,3,0
1100,6,3,3981,3981,3984,0,3,3
1101,6,1,3987,3987,3988,0,1,3
1102,1,2,3988,3988,3990,0,2,0
1103,1,1,3989,3990,3991,1,2,0
1104,6,1,3995,3995,3996,0,1,4
1105,4,1,3999,3999,4000,0,1,3
1106,6,1,4005,4005,4006,0,1,5
1107,1,3,4006,4006,4009,0,3,0
1108,2,3,4008,4009,4012,1,4,0
1109,6,3,4014,4014,4017,0,3,2
1110,1,3,4015,4017,4020,2,5,0
1111,6,1,4021,4021,4022,0,1,1
1112,4,2,4025,4025,4027,0,2,3
1113,1,3,4026,4027,4030,1,4,0
1114,3,2,4029,4030,4032,1,3,0
1115,2,3,4031,4032,4035,1,4,0
1116,3,1,4034,4035,4036,1,2,0
1117,4,3,4038,4038,4041,0,3,2
1118,3,3,4041,4041,4044,0,3,0
1119,5,3,4046,4046,4049,0,3,2
1120,4,2,4050,4050,4052,0,2,1
1121,5,1,4055,4055,4056,0,1,3
1122,6,2,4061,4061,4063,0,2,5
1123,1,3,4062,4063,4066,1,4,0
1124,6,3,4068,4068,4071,0,3,2
1125,1,2,4069,4071,4073,2,4,0
1126,4,2,4073,4073,4075,0,2,0
1127,5,3,4078,4078,4081,0,3,3
1128,6,2,4084,4084,4086,0,2,3
1129,2,3,4086,4086,4089,0,3,0
1130,3,1,4089,4089,4090,0,1,0
1131,2,3,4091,4091,4094,0,3,1
1132,1,1,4092,4094,4095,2,3,0
1133,3,1,4095,4095,4096,0,1,0
1134,3,3,4098,4098,4101,0,3,2
1135,2,3,4100,4101,4104,1,4,0
1136,4,3,4104,4104,4107,0,3,0
1137,6,3,4110,4110,4113,0,3,3
1138,5,2,4115,4115,4117,0,2,2
1139,1,2,4116,4117,4119,1,3,0
1140,3,3,4119,4119,4122,0,3,0
1141,1,2,4120,4122,4124,2,4,0
1142,4,1,4124,4124,4125,0,1,0
1143,3,1,4127,4127,4128,0,1,2
1144,4,3,4131,4131,4134,0,3,3
1145,4,2,4135,4135,4137,0,2,1
1146,3,1,4138,4138,4139,0,1,1
1147,4,2,4142,4142,4144,0,2,3
1148,6,2,4148,4148,4150,0,2,4
1149,4,2,4152,4152,4154,0,2,2
1150,5,3,4157,4157,4160,0,3,3
1151,4,1,4161,4161,4162,0,1,1
1152,6,1,4167,4167,4168,0,1,5
1153,3,2,4170,4170,4172,0,2,2
1154,2,3,4172,4172,4175,0,3,0
1155,1,3,4173,4175,4178,2,5,0
1156,6,3,4179,4179,4182,0,3,1
1157,2,1,4181,4182,4183,1,2,0
1158,4,2,4185,4185,4187,0,2,2
1159,3,2,4188,4188,4190,0,2,1
1160,1,1,4189,4190,4191,1,2,0
1161,3,3,4192,4192,4195,0,3,1
1162,6,3,4198,4198,4201,0,3,3
1163,2,2,4200,4201,4203,1,3,0
1164,6,2,4206,4206,4208,0,2,3
1165,6,1,4212,4212,4213,0,1,4
1166,6,3,4218,4218,4221,0,3,5
1167,2,1,4220,4221,4222,1,2,0
1168,1,1,4221,4222,4223,1,2,0
1169,2,2,4223,4223,4225,0,2,0
1170,6,2,4229,4229,4231,0,2,4
1171,4,2,4233,4233,4235,0,2,2
1172,6,3,4239,4239,4242,0,3,4
1173,1,1,4240,4242,4243,2,3,0
1174,2,1,4242,4243,4244,1,2,0
1175,6,1,4248,4248,4249,0,1,4
1176,4,3,4252,4252,4255,0,3,3
1177,3,3,4255,4255,4258,0,3,0
1178,1,1,4256,4258,4259,2,3,0
1179,4,1,4260,4260,4261,0,1,1
1180,1,1,4261,4261,4262,0,1,0
1181,4,2,4265,4265,4267,0,2,3
1182,1,1,4266,4267,4268,1,2,0
1183,5,1,4271,4271,4272,0,1,3
1184,1,3,4272,4272,4275,0,3,0
1185,6,1,4278,4278,4279,0,1,3
1186,1,3,4279,4279,4282,0,3,0
1187,2,2,4281,4282,4284,1,3,0
1188,5,1,4286,4286,4287,0,1,2
1189,5,3,4291,4291,4294,0,3,4
1190,1,1,4292,4294,4295,2,3,0
1191,1,1,4293,4295,4296,2,3,0
1192,2,1,4295,4296,4297,1,2,0
1193,1,3,4296,4297,4300,1,4,0
1194,4,2,4300,4300,4302,0,2,0
1195,1,1,4301,4302,4303,1,2,0
1196,3,1,4304,4304,4305,0,1,1
1197,4,1,4308,4308,4309,0,1,3
1198,4,3,4312,4312,4315,0,3,3
1199,1,2,4313,4315,4317,2,4,0
1200,4,3,4317,4317,4320,0,3,0
1201,6,2,4323,4323,4325,0,2,3
1202,3,3,4326,4326,4329,0,3,1
1203,2,2,4328,4329,4331,1,3,0
1204,6,2,4334,4334,4336,0,2,3
1205,4,3,4338,4338,4341,0,3,2
1206,3,2,4341,4341,4343,0,2,0
1207,4,2,4345,4345,4347,0,2,2
1208,4,1,4349,4349,4350,0,1,2
1209,4,3,4353,4353,4356,0,3,3
1210,1,2,4354,4356,4358,2,4,0
1211,4,2,4358,4358,4360,0,2,0
1212,3,1,4361,4361,4362,0,1,1
1213,4,1,4365,4365,4366,0,1,3
1214,5,1,4370,4370,4371,0,1,4
1215,1,3,4371,4371,4374,0,3,0
1216,4,1,4375,4375,4376,0,1,1
1217,6,1,4381,4381,4382,0,1,5
1218,5,3,4386,4386,4389,0,3,4
1219,6,2,4392,4392,4394,0,2,3
1220,1,2,4393,4394,4396,1,3,0
1221,1,3,4394,4396,4399,2,5,0
1222,6,1,4400,4400,4401,0,1,1
1223,1,2,4401,4401,4403,0,2,0
1224,5,2,4406,4406,4408,0,2,3
1225,5,2,4411,4411,4413,0,2,3
1226,2,1,4413,4413,4414,0,1,0
1227,5,1,4418,4418,4419,0,1,4
1228,6,2,4424,4424,4426,0,2,5
1229,2,3,4426,4426,4429,0,3,0
1230,2,3,4428,4429,4432,1,4,0
1231,1,2,4429,4432,4434,3,5,0
1232,3,2,4432,4434,4436,2,4,0
1233,4,2,4436,4436,4438,0,2,0
1234,6,1,4442,4442,4443,0,1,4
1235,4,3,4446,4446,4449,0,3,3
1236,5,2,4451,4451,4453,0,2,2
1237,6,1,4457,4457,4458,0,1,4
1238,2,2,4459,4459,4461,0,2,1
1239,6,1,4465,4465,4466,0,1,4
1240,6,3,4471,4471,4474,0,3,5
1241,4,2,4475,4475,4477,0,2,1
1242,6,2,4481,4481,4483,0,2,4
1243,3,1,4484,4484,4485,0,1,1
1244,4,1,4488,4488,4489,0,1,3
1245,1,1,4489,4489,4490,0,1,0
1246,4,3,4493,4493,4496,0,3,3
1247,6,3,4499,4499,4502,0,3,3
1248,4,2,4503,4503,4505,0,2,1
1249,6,2,4509,4509,4511,0,2,4
1250,1,3,4510,4511,4514,1,4,0
1251,3,3,4513,4514,4517,1,4,0
1252,5,2,4518,4518,4520,0,2,1
1253,5,2,4523,4523,4525,0,2,3
1254,6,3,4529,4529,4532,0,3,4
1255,5,2,4534,4534,4536,0,2,2
1256,6,1,4540,4540,4541,0,1,4
1257,1,1,4541,4541,4542,0,1,0
1258,3,1,4544,4544,4545,0,1,2
1259,3,2,4547,4547,4549,0,2,2
1260,2,2,4549,4549,4551,0,2,0
1261,1,3,4550,4551,4554,1,4,0
1262,2,1,4552,4554,4555,2,3,0
1263,1,2,4553,4555,4557,2,4,0
1264,1,2,4554,4557,4559,3,5,0
1265,2,2,4556,4559,4561,3,5,0
1266,3,3,4559,4561,4564,2,5,0
1267,1,1,4560,4564,4565,4,5,0
1268,1,1,4561,4565,4566,4,5,0
1269,6,1,4567,4567,4568,0,1,1
1270,4,3,4571,4571,4574,0,3,3
1271,1,3,4572,4574,4577,2,5,0
1272,1,2,4573,4577,4579,4,6,0
1273,2,2,4575,4579,4581,4,6,0
1274,1,1,4576,4581,4582,5,6,0
1275,4,2,4580,4582,4584,2,4,0
1276,1,2,4581,4584,4586,3,5,0
1277,1,2,4582,4586,4588,4,6,0
1278,2,1,4584,4588,4589,4,5,0
1279,1,1,4585,4589,4590,4,5,0
1280,1,1,4586,4590,4591,4,5,0
1281,5,3,4591,4591,4594,0,3,0
1282,3,2,4594,4594,4596,0,2,0
1283,4,1,4598,4598,4599,0,1,2
1284,1,2,4599,4599,4601,0,2,0
1285,2,1,4601,4601,4602,0,1,0
1286,3,2,4604,4604,4606,0,2,2
1287,4,3,4608,4608,4611,0,3,2
1288,6,3,4614,4614,4617,0,3,3
1289,3,3,4617,4617,4620,0,3,0
1290,2,1,4619,4620,4621,1,2,0
1291,1,3,4620,4621,4624,1,4,0
1292,1,2,4621,4624,4626,3,5,0
1293,3,3,4624,4626,4629,2,5,0
1294,3,1,4627,4629,4630,2,3,0
1295,2,2,4629,4630,4632,1,3,0
1296,2,3,4631,4632,4635,1,4,0
1297,4,3,4635,4635,4638,0,3,0
1298,5,1,4640,4640,4641,0,1,2
1299,1,1,4641,4641,4642,0,1,0
1300,4,1,4645,4645,4646,0,1,3
1301,4,1,4649,4649,4650,0,1,3
1302,2,3,4651,4651,4654,0,3,1
1303,2,1,4653,4654,4655,1,2,0
1304,6,1,4659,4659,4660,0,1,4
1305,5,2,4664,4664,4666,0,2,4
1306,6,3,4670,4670,4673,0,3,4
1307,2,3,4672,4673,4676,1,4,0
1308,2,2,4674,4676,4678,2,4,0
1309,1,1,4675,4678,4679,3,4,0
1310,6,1,4681,4681,4682,0,1,2
1311,1,2,4682,4682,4684,0,2,0
1312,4,2,4686,4686,4688,0,2,2
1313,1,2,4687,4688,4690,1,3,0
1314,4,1,4691,4691,4692,0,1,1
1315,4,1,4695,4695,4696,0,1,3
1316,6,1,4701,4701,4702,0,1,5
1317,2,2,4703,4703,4705,0,2,1
1318,3,3,4706,4706,4709,0,3,1
1319,1,1,4707,4709,4710,2,3,0
1320,5,2,4712,4712,4714,0,2,2
1321,6,1,4718,4718,4719,0,1,4
1322,1,2,4719,4719,4721,0,2,0
1323,1,3,4720,4721,4724,1,4,0
1324,5,3,4725,4725,4728,0,3,1
1325,5,2,4730,4730,4732,0,2,2
1326,4,1,4734,4734,4735,0,1,2
1327,6,1,4740,4740,4741,0,1,5
1328,6,1,4746,4746,4747,0,1,5
1329,1,2,4747,4747,4749,0,2,0
1330,4,3,4751,4751,4754,0,3,2
1331,3,1,4754,4754,4755,0,1,0
1332,2,2,4756,4756,4758,0,2,1
1333,4,3,4760,4760,4763,0,3,2
1334,2,3,4762,4763,4766,1,4,0
1335,2,1,4764,4766,4767,2,3,0
1336,1,2,4765,4767,4769,2,4,0
1337,3,2,4768,4769,4771,1,3,0
1338,1,3,4769,4771,4774,2,5,0
1339,1,3,4770,4774,4777,4,7,0
1340,5,1,4775,4777,4778,2,3,0
1341,3,1,4778,4778,4779,0,1,0
1342,3,1,4781,4781,4782,0,1,2
1343,6,2,4787,4787,4789,0,2,5
1344,6,1,4793,4793,4794,0,1,4
1345,2,1,4795,4795,4796,0,1,1
1346,5,3,4800,4800,4803,0,3,4
1347,4,1,4804,4804,4805,0,1,1
1348,1,2,4805,4805,4807,0,2,0
1349,6,3,4811,4811,4814,0,3,4
1350,2,2,4813,4814,4816,1,3,0
1351,5,3,4818,4818,4821,0,3,2
1352,6,1,4824,4824,4825,0,1,3
1353,3,2,4827,4827,4829,0,2,2
1354,4,3,4831,4831,4834,0,3,2
1355,1,1,4832,4834,4835,2,3,0
1356,6,2,4838,4838,4840,0,2,3
1357,2,2,4840,4840,4842,0,2,0
1358,4,1,4844,4844,4845,0,1,2
1359,4,1,4848,4848,4849,0,1,3
1360,6,2,4854,4854,4856,0,2,5
1361,4,3,4858,4858,4861,0,3,2
1362,2,3,4860,4861,4864,1,4,0
1363,3,2,4863,4864,4866,1,3,0
1364,3,2,4866,4866,4868,0,2,0
1365,1,3,4867,4868,4871,1,4,0
1366,3,3,4870,4871,4874,1,4,0
1367,3,1,4873,4874,4875,1,2,0
1368,2,3,4875,4875,4878,0,3,0
1369,4,1,4879,4879,4880,0,1,1
1370,4,2,4883,4883,4885,0,2,3
1371,5,1,4888,4888,4889,0,1,3
1372,5,3,4893,4893,4896,0,3,4
1373,2,1,4895,4896,4897,1,2,0
1374,2,1,4897,4897,4898,0,1,0
1375,5,3,4902,4902,4905,0,3,4
1376,3,3,4905,4905,4908,0,3,0
1377,2,1,4907,4908,4909,1,2,0
1378,5,1,4912,4912,4913,0,1,3
1379,5,3,4917,4917,4920,0,3,4
1380,2,2,4919,4920,4922,1,3,0
1381,6,1,4925,4925,4926,0,1,3
1382,5,3,4930,4930,4933,0,3,4
1383,6,2,4936,4936,4938,0,2,3
1384,6,3,4942,4942,4945,0,3,4
1385,2,3,4944,4945,4948,1,4,0
1386,5,1,4949,4949,4950,0,1,1
1387,5,1,4954,4954,4955,0,1,4
1388,4,3,4958,4958,4961,0,3,3
1389,5,2,4963,4963,4965,0,2,2
1390,2,1,4965,4965,4966,0,1,0
1391,5,3,4970,4970,4973,0,3,4
1392,2,3,4972,4973,4976,1,4,0
1393,4,2,4976,4976,4978,0,2,0
1394,3,2,4979,4979,4981,0,2,1
1395,5,1,4984,4984,4985,0,1,3
1396,6,2,4990,4990,4992,0,2,5
1397,3,1,4993,4993,4994,0,1,1
1398,2,2,4995,4995,4997,0,2,1
1399,6,3,5001,5001,5004,0,3,4
1400,5,1,5006,5006,5007,0,1,2
1401,4,2,5010,5010,5012,0,2,3
1402,6,3,5016,5016,5019,0,3,4
1403,4,3,5020,5020,5023,0,3,1
1404,4,2,5024,5024,5026,0,2,1
1405,6,1,5030,5030,5031,0,1,4
1406,6,2,5036,5036,5038,0,2,5
1407,4,2,5040,5040,5042,0,2,2
1408,4,1,5044,5044,5045,0,1,2
1409,3,2,5047,5047,5049,0,2,2
1410,6,2,5053,5053,5055,0,2,4
1411,6,3,5059,5059,5062,0,3,4
1412,6,1,5065,5065,5066,0,1,3
1413,2,3,5067,5067,5070,0,3,1
1414,4,2,5071,5071,5073,0,2,1
1415,3,1,5074,5074,5075,0,1,1
1416,3,2,5077,5077,5079,0,2,2
1417,5,1,5082,5082,5083,0,1,3
1418,3,1,5085,5085,5086,0,1,2
1419,1,2,5086,5086,5088,0,2,0
1420,5,2,5091,5091,5093,0,2,3
1421,1,2,5092,5093,5095,1,3,0
1422,5,1,5097,5097,5098,0,1,2
1423,6,2,5103,5103,5105,0,2,5
1424,1,2,5104,5105,5107,1,3,0
1425,5,3,5109,5109,5112,0,3,2
1426,6,3,5115,5115,5118,0,3,3
1427,1,2,5116,5118,5120,2,4,0
1428,2,1,5118,5120,5121,2,3,0
1429,6,1,5124,5124,5125,0,1,3
1430,5,3,5129,5129,5132,0,3,4
1431,2,3,5131,5132,5135,1,4,0
1432,5,2,5136,5136,5138,0,2,1
1433,6,3,5142,5142,5145,0,3,4
1434,3,2,5145,5145,5147,0,2,0
1435,4,3,5149,5149,5152,0,3,2
1436,4,2,5153,5153,5155,0,2,1
1437,4,3,5157,5157,5160,0,3,2
1438,3,2,5160,5160,5162,0,2,0
1439,5,2,5165,5165,5167,0,2,3
1440,1,2,5166,5167,5169,1,3,0
1441,5,3,5171,5171,5174,0,3,2
1442,3,2,5174,5174,5176,0,2,0
1443,4,2,5178,5178,5180,0,2,2
1444,4,1,5182,5182,5183,0,1,2
1445,3,3,5185,5185,5188,0,3,2
1446,4,3,5189,5189,5192,0,3,1
1447,1,3,5190,5192,5195,2,5,0
1448,1,1,5191,5195,5196,4,5,0
1449,5,2,5196,5196,5198,0,2,0
1450,2,3,5198,5198,5201,0,3,0
1451,1,2,5199,5201,5203,2,4,0
1452,2,1,5201,5203,5204,2,3,0
1453,2,2,5203,5204,5206,1,3,0
1454,6,3,5209,5209,5212,0,3,3
1455,4,2,5213,5213,5215,0,2,1
1456,4,3,5217,5217,5220,0,3,2
1457,2,2,5219,5220,5222,1,3,0
1458,5,2,5224,5224,5226,0,2,2
1459,6,3,5230,5230,5233,0,3,4
1460,2,3,5232,5233,5236,1,4,0
1461,5,1,5237,5237,5238,0,1,1
1462,5,3,5242,5242,5245,0,3,4
1463,2,3,5244,5245,5248,1,4,0
1464,3,3,5247,5248,5251,1,4,0
1465,2,3,5249,5251,5254,2,5,0
1466,4,1,5253,5254,5255,1,2,0
1467,3,1,5256,5256,5257,0,1,1
1468,2,1,5258,5258,5259,0,1,1
1469,2,3,5260,5260,5263,0,3,1
1470,3,1,5263,5263,5264,0,1,0
1471,2,3,5265,5265,5268,0,3,1
1472,1,3,5266,5268,5271,2,5,0
1473,2,1,5268,5271,5272,3,4,0
1474,4,2,5272,5272,5274,0,2,0
1475,6,1,5278,5278,5279,0,1,4
1476,4,1,5282,5282,5283,0,1,3
1477,2,2,5284,5284,5286,0,2,1
1478,3,2,5287,5287,5289,0,2,1
1479,4,1,5291,5291,5292,0,1,2
1480,4,2,5295,5295,5297,0,2,3
1481,6,3,5301,5301,5304,0,3,4
1482,5,1,5306,5306,5307,0,1,2
1483,1,1,5307,5307,5308,0,1,0
1484,5,1,5312,5312,5313,0,1,4
1485,2,1,5314,5314,5315,0,1,1
1486,1,1,5315,5315,5316,0,1,0
1487,2,3,5317,5317,5320,0,3,1
1488,5,1,5322,5322,5323,0,1,2
1489,1,1,5323,5323,5324,0,1,0
1490,2,1,5325,5325,5326,0,1,1
1491,4,2,5329,5329,5331,0,2,3
1492,3,1,5332,5332,5333,0,1,1
1493,5,2,5337,5337,5339,0,2,4
1494,3,2,5340,5340,5342,0,2,1
1495,1,3,5341,5342,5345,1,4,0
1496,2,3,5343,5345,5348,2,5,0
1497,6,1,5349,5349,5350,0,1,1
1498,5,2,5354,5354,5356,0,2,4
1499,5,1,5359,5359,5360,0,1,3
1500,6,3,5365,5365,5368,0,3,5
1501,1,1,5366,5368,5369,2,3,0
1502,5,2,5371,5371,5373,0,2,2
1503,4,3,5375,5375,5378,0,3,2
1504,1,3,5376,5378,5381,2,5,0
1505,3,2,5379,5381,5383,2,4,0
1506,4,1,5383,5383,5384,0,1,0
1507,3,1,5386,5386,5387,0,1,2
1508,5,1,5391,5391,5392,0,1,4
1509,4,3,5395,5395,5398,0,3,3
1510,3,1,5398,5398,5399,0,1,0
1511,6,1,5404,5404,5405,0,1,5
1512,3,3,5407,5407,5410,0,3,2
1513,3,2,5410,5410,5412,0,2,0
1514,4,3,5414,5414,5417,0,3,2
1515,6,2,5420,5420,5422,0,2,3
1516,5,3,5425,5425,5428,0,3,3
1517,6,2,5431,5431,5433,0,2,3
1518,6,1,5437,5437,5438,0,1,4
1519,4,2,5441,5441,5443,0,2,3
1520,2,3,5443,5443,5446,0,3,0
1521,5,2,5448,5448,5450,0,2,2
1522,6,2,5454,5454,5456,0,2,4
1523,3,2,5457,5457,5459,0,2,1
1524,5,1,5462,5462,5463,0,1,3
1525,6,1,5468,5468,5469,0,1,5
1526,2,1,5470,5470,5471,0,1,1
1527,5,3,5475,5475,5478,0,3,4
1528,2,3,5477,5478,5481,1,4,0
1529,3,1,5480,5481,5482,1,2,0
1530,3,1,5483,5483,5484,0,1,1
1531,6,3,5489,5489,5492,0,3,5
1532,3,1,5492,5492,5493,0,1,0
1533,4,2,5496,5496,5498,0,2,3
1534,5,3,5501,5501,5504,0,3,3
1535,5,1,5506,5506,5507,0,1,2
1536,5,3,5511,5511,5514,0,3,4
1537,1,2,5512,5514,5516,2,4,0
1538,5,3,5517,5517,5520,0,3,1
1539,6,1,5523,5523,5524,0,1,3
1540,1,1,5524,5524,5525,0,1,0
1541,3,1,5527,5527,5528,0,1,2
1542,1,2,5528,5528,5530,0,2,0
1543,5,2,5533,5533,5535,0,2,3
1544,6,2,5539,5539,5541,0,2,4
1545,1,3,5540,5541,5544,1,4,0
1546,4,3,5544,5544,5547,0,3,0
1547,5,1,5549,5549,5550,0,1,2
1548,2,1,5551,5551,5552,0,1,1
1549,2,1,5553,5553,5554,0,1,1
1550,6,3,5559,5559,5562,0,3,5
1551,3,2,5562,5562,5564,0,2,0
1552,2,2,5564,5564,5566,0,2,0
1553,4,1,5568,5568,5569,0,1,2
1554,1,2,5569,5569,5571,0,2,0
1555,2,3,5571,5571,5574,0,3,0
1556,6,3,5577,5577,5580,0,3,3
1557,6,3,5583,5583,5586,0,3,3
1558,6,2,5589,5589,5591,0,2,3
1559,2,1,5591,5591,5592,0,1,0
1560,5,1,5596,5596,5597,0,1,4
1561,2,1,5598,5598,5599,0,1,1
1562,4,3,5602,5602,5605,0,3,3
1563,4,1,5606,5606,5607,0,1,1
1564,6,1,5612,5612,5613,0,1,5
1565,5,1,5617,5617,5618,0,1,4
1566,4,2,5621,5621,5623,0,2,3
1567,2,3,5623,5623,5626,0,3,0
1568,2,1,5625,5626,5627,1,2,0
1569,3,2,5628,5628,5630,0,2,1
1570,2,1,5630,5630,5631,0,1,0
1571,3,1,5633,5633,5634,0,1,2
1572,1,1,5634,5634,5635,0,1,0
1573,1,1,5635,5635,5636,0,1,0
1574,6,3,5641,5641,5644,0,3,5
1575,6,3,5647,5647,5650,0,3,3
1576,6,1,5653,5653,5654,0,1,3
1577,1,3,5654,5654,5657,0,3,0
1578,5,1,5659,5659,5660,0,1,2
1579,4,3,5663,5663,5666,0,3,3
1580,5,2,5668,5668,5670,0,2,2
1581,6,3,5674,5674,5677,0,3,4
1582,4,3,5678,5678,5681,0,3,1
1583,2,3,5680,5681,5684,1,4,0
1584,2,2,5682,5684,5686,2,4,0
1585,1,2,5683,5686,5688,3,5,0
1586,6,1,5689,5689,5690,0,1,1
1587,4,2,5693,5693,5695,0,2,3
1588,2,3,5695,5695,5698,0,3,0
1589,1,2,5696,5698,5700,2,4,0
1590,1,2,5697,5700,5702,3,5,0
1591,3,3,5700,5702,5705,2,5,0
1592,6,3,5706,5706,5709,0,3,1
1593,5,1,5711,5711,5712,0,1,2
1594,2,1,5713,5713,5714,0,1,1
1595,5,1,5718,5718,5719,0,1,4
1596,4,2,5722,5722,5724,0,2,3
1597,3,2,5725,5725,5727,0,2,1
1598,4,2,5729,5729,5731,0,2,2
1599,2,3,5731,5731,5734,0,3,0
1600,5,3,5736,5736,5739,0,3,2
1601,2,1,5738,5739,5740,1,2,0
1602,6,2,5744,5744,5746,0,2,4
1603,4,3,5748,5748,5751,0,3,2
1604,3,2,5751,5751,5753,0,2,0
1605,2,2,5753,5753,5755,0,2,0
1606,3,3,5756,5756,5759,0,3,1
1607,2,3,5758,5759,5762,1,4,0
1608,3,2,5761,5762,5764,1,3,0
1609,4,1,5765,5765,5766,0,1,1
1610,3,2,5768,5768,5770,0,2,2
1611,4,1,5772,5772,5773,0,1,2
1612,1,1,5773,5773,5774,0,1,0
1613,5,2,5778,5778,5780,0,2,4
1614,5,1,5783,5783,5784,0,1,3
1615,3,2,5786,5786,5788,0,2,2
1616,6,1,5792,5792,5793,0,1,4
1617,3,2,5795,5795,5797,0,2,2
1618,5,1,5800,5800,5801,0,1,3
1619,2,1,5802,5802,5803,0,1,1
1620,4,3,5806,5806,5809,0,3,3
1621,6,2,5812,5812,5814,0,2,3
1622,3,3,5815,5815,5818,0,3,1
1623,2,2,5817,5818,5820,1,3,0
1624,6,2,5823,5823,5825,0,2,3
1625,1,1,5824,5825,5826,1,2,0
1626,1,3,5825,5826,5829,1,4,0
1627,2,3,5827,5829,5832,2,5,0
1628,5,2,5832,5832,5834,0,2,0
1629,2,2,5834,5834,5836,0,2,0
1630,2,2,5836,5836,5838,0,2,0
1631,2,3,5838,5838,5841,0,3,0
1632,5,2,5843,5843,5845,0,2,2
1633,4,2,5847,5847,5849,0,2,2
1634,3,2,5850,5850,5852,0,2,1
1635,4,2,5854,5854,5856,0,2,2
1636,3,2,5857,5857,5859,0,2,1
1637,5,2,5862,5862,5864,0,2,3
1638,1,3,5863,5864,5867,1,4,0
1639,1,3,5864,5867,5870,3,6,0
1640,1,1,5865,5870,5871,5,6,0
1641,1,2,5866,5871,5873,5,7,0
1642,5,2,5871,5873,5875,2,4,0
1643,3,3,5874,5875,5878,1,4,0
1644,1,2,5875,5878,5880,3,5,0
1645,1,1,5876,5880,5881,4,5,0
1646,4,1,5880,5881,5882,1,2,0
1647,2,3,5882,5882,5885,0,3,0
1648,5,3,5887,5887,5890,0,3,2
1649,5,1,5892,5892,5893,0,1,2
1650,6,2,5898,5898,5900,0,2,5
1651,1,2,5899,5900,5902,1,3,0
1652,2,1,5901,5902,5903,1,2,0
1653,5,3,5906,5906,5909,0,3,3
1654,3,3,5909,5909,5912,0,3,0
1655,4,2,5913,5913,5915,0,2,1
1656,5,1,5918,5918,5919,0,1,3
1657,3,3,5921,5921,5924,0,3,2
1658,1,3,5922,5924,5927,2,5,0
1659,3,1,5925,5927,5928,2,3,0
1660,1,3,5926,5928,5931,2,5,0
1661,4,3,5930,5931,5934,1,4,0
1662,5,3,5935,5935,5938,0,3,1
1663,1,1,5936,5938,5939,2,3,0
1664,3,1,5939,5939,5940,0,1,0
1665,2,2,5941,5941,5943,0,2,1
1666,1,1,5942,5943,5944,1,2,0
1667,3,2,5945,5945,5947,0,2,1
1668,1,1,5946,5947,5948,1,2,0
1669,4,3,5950,5950,5953,0,3,2
1670,1,3,5951,5953,5956,2,5,0
1671,4,3,5955,5956,5959,1,4,0
1672,3,1,5958,5959,5960,1,2,0
1673,2,1,5960,5960,5961,0,1,0
1674,1,3,5961,5961,5964,0,3,0
1675,2,1,5963,5964,5965,1,2,0
1676,4,2,5967,5967,5969,0,2,2
1677,1,3,5968,5969,5972,1,4,0
1678,3,1,5971,5972,5973,1,2,0
1679,1,2,5972,5973,5975,1,3,0
1680,1,3,5973,5975,5978,2,5,0
1681,3,2,5976,5978,5980,2,4,0
1682,4,1,5980,5980,5981,0,1,0
1683,6,2,5986,5986,5988,0,2,5
1684,3,2,5989,5989,5991,0,2,1
1685,5,3,5994,5994,5997,0,3,3
1686,4,2,5998,5998,6000,0,2,1
1687,5,2,6003,6003,6005,0,2,3
1688,2,1,6005,6005,6006,0,1,0
1689,4,2,6009,6009,6011,0,2,3
1690,5,2,6014,6014,6016,0,2,3
1691,4,3,6018,6018,6021,0,3,2
1692,1,2,6019,6021,6023,2,4,0
1693,1,3,6020,6023,6026,3,6,0
1694,2,3,6022,6026,6029,4,7,0
1695,1,1,6023,6029,6030,6,7,0
1696,3,2,6026,6030,6032,4,6,0
1697,1,1,6027,6032,6033,5,6,0
1698,6,1,6033,6033,6034,0,1,0
1699,2,1,6035,6035,6036,0,1,1
1700,6,3,6041,6041,6044,0,3,5
1701,2,3,6043,6044,6047,1,4,0
1702,1,2,6044,6047,6049,3,5,0
1703,6,2,6050,6050,6052,0,2,1
1704,1,2,6051,6052,6054,1,3,0
1705,4,3,6055,6055,6058,0,3,1
1706,3,2,6058,6058,6060,0,2,0
1707,4,1,6062,6062,6063,0,1,2
1708,5,3,6067,6067,6070,0,3,4
1709,2,3,6069,6070,6073,1,4,0
1710,2,1,6071,6073,6074,2,3,0
1711,3,3,6074,6074,6077,0,3,0
1712,4,1,6078,6078,6079,0,1,1
1713,5,1,6083,6083,6084,0,1,4
1714,3,3,6086,6086,6089,0,3,2
1715,4,2,6090,6090,6092,0,2,1
1716,5,3,6095,6095,6098,0,3,3
1717,2,3,6097,6098,6101,1,4,0
1718,3,1,6100,6101,6102,1,2,0
1719,5,3,6105,6105,6108,0,3,3
1720,1,1,6106,6108,6109,2,3,0
1721,2,3,6108,6109,6112,1,4,0
1722,5,1,6113,6113,6114,0,1,1
1723,6,1,6119,6119,6120,0,1,5
1724,6,2,6125,6125,6127,0,2,5
1725,5,3,6130,6130,6133,0,3,3
1726,3,3,6133,6133,6136,0,3,0
1727,3,2,6136,6136,6138,0,2,0
1728,6,2,6142,6142,6144,0,2,4
1729,2,3,6144,6144,6147,0,3,0
1730,1,3,6145,6147,6150,2,5,0
1731,2,3,6147,6150,6153,3,6,0
1732,2,1,6149,6153,6154,4,5,0
1733,6,3,6155,6155,6158,0,3,1
1734,4,1,6159,6159,6160,0,1,1
1735,6,3,6165,6165,6168,0,3,5
1736,4,3,6169,6169,6172,0,3,1
1737,6,2,6175,6175,6177,0,2,3
1738,3,1,6178,6178,6179,0,1,1
1739,6,1,6184,6184,6185,0,1,5
1740,4,3,6188,6188,6191,0,3,3
1741,4,1,6192,6192,6193,0,1,1
1742,6,3,6198,6198,6201,0,3,5
1743,1,2,6199,6201,6203,2,4,0
1744,5,3,6204,6204,6207,0,3,1
1745,3,2,6207,6207,6209,0,2,0
1746,6,2,6213,6213,6215,0,2,4
1747,6,2,6219,6219,6221,0,2,4
1748,4,1,6223,6223,6224,0,1,2
1749,3,3,6226,6226,6229,0,3,2
1750,4,3,6230,6230,6233,0,3,1
1751,4,2,6234,6234,6236,0,2,1
1752,6,2,6240,6240,6242,0,2,4
1753,5,3,6245,6245,6248,0,3,3
1754,3,3,6248,6248,6251,0,3,0
1755,5,3,6253,6253,6256,0,3,2
1756,3,2,6256,6256,6258,0,2,0
1757,4,2,6260,6260,6262,0,2,2
1758,3,1,6263,6263,6264,0,1,1
1759,1,1,6264,6264,6265,0,1,0
1760,4,1,6268,6268,6269,0,1,3
1761,5,2,6273,6273,6275,0,2,4
1762,1,3,6274,6275,6278,1,4,0
1763,5,2,6279,6279,6281,0,2,1
1764,6,3,6285,6285,6288,0,3,4
1765,4,3,6289,6289,6292,0,3,1
1766,6,1,6295,6295,6296,0,1,3
1767,2,1,6297,6297,6298,0,1,1
1768,2,1,6299,6299,6300,0,1,1
1769,1,3,6300,6300,6303,0,3,0
1770,5,2,6305,6305,6307,0,2,2
1771,5,3,6310,6310,6313,0,3,3
1772,6,3,6316,6316,6319,0,3,3
1773,4,2,6320,6320,6322,0,2,1
1774,5,1,6325,6325,6326,0,1,3
1775,4,3,6329,6329,6332,0,3,3
1776,2,3,6331,6332,6335,1,4,0
1777,1,1,6332,6335,6336,3,4,0
1778,1,2,6333,6336,6338,3,5,0
1779,4,1,6337,6338,6339,1,2,0
1780,6,3,6343,6343,6346,0,3,4
1781,6,3,6349,6349,6352,0,3,3
1782,6,2,6355,6355,6357,0,2,3
1783,3,1,6358,6358,6359,0,1,1
1784,6,2,6364,6364,6366,0,2,5
1785,6,1,6370,6370,6371,0,1,4
1786,4,1,6374,6374,6375,0,1,3
1787,2,1,6376,6376,6377,0,1,1
1788,3,2,6379,6379,6381,0,2,2
1789,4,1,6383,6383,6384,0,1,2
1790,1,3,6384,6384,6387,0,3,0
1791,2,2,6386,6387,6389,1,3,0
1792,5,1,6391,6391,6392,0,1,2
1793,3,3,6394,6394,6397,0,3,2
1794,2,3,6396,6397,6400,1,4,0
1795,2,1,6398,6400,6401,2,3,0
1796,2,2,6400,6401,6403,1,3,0
1797,1,2,6401,6403,6405,2,4,0
1798,2,3,6403,6405,6408,2,5,0
1799,4,1,6407,6408,6409,1,2,0
1800,6,2,6413,6413,6415,0,2,4
1801,2,3,6415,6415,6418,0,3,0
1802,4,2,6419,6419,6421,0,2,1
1803,5,2,6424,6424,6426,0,2,3
1804,1,1,6425,6426,6427,1,2,0
1805,1,2,6426,6427,6429,1,3,0
1806,5,2,6431,6431,6433,0,2,2
1807,6,1,6437,6437,6438,0,1,4
1808,6,1,6443,6443,6444,0,1,5
1809,3,2,6446,6446,6448,0,2,2
1810,6,1,6452,6452,6453,0,1,4
1811,2,1,6454,6454,6455,0,1,1
1812,2,2,6456,6456,6458,0,2,1
1813,3,1,6459,6459,6460,0,1,1
1814,2,2,6461,6461,6463,0,2,1
1815,1,3,6462,6463,6466,1,4,0
1816,3,2,6465,6466,6468,1,3,0
1817,4,1,6469,6469,6470,0,1,1
1818,2,1,6471,6471,6472,0,1,1
1819,6,3,6477,6477,6480,0,3,5
1820,3,3,6480,6480,6483,0,3,0
1821,1,2,6481,6483,6485,2,4,0
1822,3,3,6484,6485,6488,1,4,0
1823,4,3,6488,6488,6491,0,3,0
1824,4,3,6492,6492,6495,0,3,1
1825,3,2,6495,6495,6497,0,2,0
1826,3,3,6498,6498,6501,0,3,1
1827,6,1,6504,6504,6505,0,1,3
1828,3,1,6507,6507,6508,0,1,2
1829,2,3,6509,6509,6512,0,3,1
1830,1,3,6510,6512,6515,2,5,0
1831,6,1,6516,6516,6517,0,1,1
1832,2,3,6518,6518,6521,0,3,1
1833,5,1,6523,6523,6524,0,1,2
1834,6,3,6529,6529,6532,0,3,5
1835,5,1,6534,6534,6535,0,1,2
1836,6,3,6540,6540,6543,0,3,5
1837,6,3,6546,6546,6549,0,3,3
1838,2,3,6548,6549,6552,1,4,0
1839,2,1,6550,6552,6553,2,3,0
1840,4,3,6554,6554,6557,0,3,1
1841,1,1,6555,6557,6558,2,3,0
1842,1,2,6556,6558,6560,2,4,0
1843,1,3,6557,6560,6563,3,6,0
1844,3,2,6560,6563,6565,3,5,0
1845,4,1,6564,6565,6566,1,2,0
1846,4,3,6568,6568,6571,0,3,2
1847,3,3,6571,6571,6574,0,3,0
1848,2,2,6573,6574,6576,1,3,0
1849,3,2,6576,6576,6578,0,2,0
1850,3,3,6579,6579,6582,0,3,1
1851,5,1,6584,6584,6585,0,1,2
1852,4,1,6588,6588,6589,0,1,3
1853,4,1,6592,6592,6593,0,1,3
1854,3,2,6595,6595,6597,0,2,2
1855,1,2,6596,6597,6599,1,3,0
1856,3,1,6599,6599,6600,0,1,0
1857,3,3,6602,6602,6605,0,3,2
1858,6,2,6608,6608,6610,0,2,3
1859,1,3,6609,6610,6613,1,4,0
1860,5,2,6614,6614,6616,0,2,1
1861,4,1,6618,6618,6619,0,1,2
1862,2,2,6620,6620,6622,0,2,1
1863,6,2,6626,6626,6628,0,2,4
1864,4,1,6630,6630,6631,0,1,2
1865,3,1,6633,6633,6634,0,1,2
1866,4,1,6637,6637,6638,0,1,3
1867,5,2,6642,6642,6644,0,2,4
1868,4,2,6646,6646,6648,0,2,2
1869,1,3,6647,6648,6651,1,4,0
1870,2,1,6649,6651,6652,2,3,0
1871,4,3,6653,6653,6656,0,3,1
1872,3,2,6656,6656,6658,0,2,0
1873,1,3,6657,6658,6661,1,4,0
1874,3,2,6660,6661,6663,1,3,0
1875,2,1,6662,6663,6664,1,2,0
1876,3,1,6665,6665,6666,0,1,1
1877,6,2,6671,6671,6673,0,2,5
1878,2,3,6673,6673,6676,0,3,0
1879,3,1,6676,6676,6677,0,1,0
1880,1,1,6677,6677,6678,0,1,0
1881,1,1,6678,6678,6679,0,1,0
1882,4,1,6682,6682,6683,0,1,3
1883,3,3,6685,6685,6688,0,3,2
1884,6,1,6691,6691,6692,0,1,3
1885,5,1,6696,6696,6697,0,1,4
1886,5,3,6701,6701,6704,0,3,4
1887,3,3,6704,6704,6707,0,3,0
1888,4,3,6708,6708,6711,0,3,1
1889,2,1,6710,6711,6712,1,2,0
1890,1,2,6711,6712,6714,1,3,0
1891,4,3,6715,6715,6718,0,3,1
1892,1,2,6716,6718,6720,2,4,0
1893,6,1,6722,6722,6723,0,1,2
1894,5,3,6727,6727,6730,0,3,4
1895,3,3,6730,6730,6733,0,3,0
1896,2,2,6732,6733,6735,1,3,0
1897,2,3,6734,6735,6738,1,4,0
1898,6,2,6740,6740,6742,0,2,2
1899,1,2,6741,6742,6744,1,3,0
1900,2,2,6743,6744,6746,1,3,0
1901,6,3,6749,6749,6752,0,3,3
1902,6,2,6755,6755,6757,0,2,3
1903,4,1,6759,6759,6760,0,1,2
1904,2,2,6761,6761,6763,0,2,1
1905,3,3,6764,6764,6767,0,3,1
1906,4,2,6768,6768,6770,0,2,1
1907,4,2,6772,6772,6774,0,2,2
1908,4,2,6776,6776,6778,0,2,2
1909,6,2,6782,6782,6784,0,2,4
1910,3,3,6785,6785,6788,0,3,1
1911,3,2,6788,6788,6790,0,2,0
1912,5,3,6793,6793,6796,0,3,3
1913,6,2,6799,6799,6801,0,2,3
1914,6,1,6805,6805,6806,0,1,4
1915,5,2,6810,6810,6812,0,2,4
1916,2,3,6812,6812,6815,0,3,0
1917,3,1,6815,6815,6816,0,1,0
1918,6,1,6821,6821,6822,0,1,5
1919,2,1,6823,6823,6824,0,1,1
1920,4,1,6827,6827,6828,0,1,3
1921,1,3,6828,6828,6831,0,3,0
1922,4,2,6832,6832,6834,0,2,1
1923,2,3,6834,6834,6837,0,3,0
1924,1,2,6835,6837,6839,2,4,0
1925,1,3,6836,6839,6842,3,6,0
1926,6,1,6842,6842,6843,0,1,0
1927,2,2,6844,6844,6846,0,2,1
1928,5,1,6849,6849,6850,0,1,3
1929,2,3,6851,6851,6854,0,3,1
1930,1,3,6852,6854,6857,2,5,0
1931,2,1,6854,6857,6858,3,4,0
1932,5,3,6859,6859,6862,0,3,1
1933,4,2,6863,6863,6865,0,2,1
1934,3,2,6866,6866,6868,0,2,1
1935,3,3,6869,6869,6872,0,3,1
1936,3,2,6872,6872,6874,0,2,0
1937,2,2,6874,6874,6876,0,2,0
1938,5,2,6879,6879,6881,0,2,3
1939,1,2,6880,6881,6883,1,3,0
1940,1,3,6881,6883,6886,2,5,0
1941,5,2,6886,6886,6888,0,2,0
1942,3,2,6889,6889,6891,0,2,1
1943,6,2,6895,6895,6897,0,2,4
1944,2,2,6897,6897,6899,0,2,0
1945,3,2,6900,6900,6902,0,2,1
1946,4,2,6904,6904,6906,0,2,2
1947,4,3,6908,6908,6911,0,3,2
1948,6,1,6914,6914,6915,0,1,3
1949,3,3,6917,6917,6920,0,3,2
1950,3,3,6920,6920,6923,0,3,0
1951,4,1,6924,6924,6925,0,1,1
1952,5,1,6929,6929,6930,0,1,4
1953,5,1,6934,6934,6935,0,1,4
1954,3,1,6937,6937,6938,0,1,2
1955,5,3,6942,6942,6945,0,3,4
1956,6,1,6948,6948,6949,0,1,3
1957,4,2,6952,6952,6954,0,2,3
1958,6,2,6958,6958,6960,0,2,4
1959,6,2,6964,6964,6966,0,2,4
1960,4,3,6968,6968,6971,0,3,2
1961,3,3,6971,6971,6974,0,3,0
1962,4,2,6975,6975,6977,0,2,1
1963,1,1,6976,6977,6978,1,2,0
1964,2,1,6978,6978,6979,0,1,0
1965,4,1,6982,6982,6983,0,1,3
1966,5,2,6987,6987,6989,0,2,4
1967,1,1,6988,6989,6990,1,2,0
1968,5,3,6993,6993,6996,0,3,3
1969,6,3,6999,6999,7002,0,3,3
1970,6,1,7005,7005,7006,0,1,3
1971,1,2,7006,7006,7008,0,2,0
1972,5,3,7011,7011,7014,0,3,3
1973,6,1,7017,7017,7018,0,1,3
1974,6,3,7023,7023,7026,0,3,5
1975,3,2,7026,7026,7028,0,2,0
1976,5,3,7031,7031,7034,0,3,3
1977,1,2,7032,7034,7036,2,4,0
1978,6,3,7038,7038,7041,0,3,2
1979,1,1,7039,7041,7042,2,3,0
1980,5,2,7044,7044,7046,0,2,2
1981,6,2,7050,7050,7052,0,2,4
1982,4,1,7054,7054,7055,0,1,2
1983,3,2,7057,7057,7059,0,2,2
1984,3,2,7060,7060,7062,0,2,1
1985,2,1,7062,7062,7063,0,1,0
1986,1,2,7063,7063,7065,0,2,0
1987,1,2,7064,7065,7067,1,3,0
1988,5,1,7069,7069,7070,0,1,2
1989,2,2,7071,7071,7073,0,2,1
1990,6,3,7077,7077,7080,0,3,4
1991,5,2,7082,7082,7084,0,2,2
1992,6,1,7088,7088,7089,0,1,4
1993,2,3,7090,7090,7093,0,3,1
1994,4,1,7094,7094,7095,0,1,1
1995,3,2,7097,7097,7099,0,2,2
1996,4,2,7101,7101,7103,0,2,2
1997,6,1,7107,7107,7108,0,1,4
1998,3,1,7110,7110,7111,0,1,2
1999,2,1,7112,7112,7113,0,1,1
2000,1,2,7113,7113,7115,0,2,0
2001,3,2,7116,7116,7118,0,2,1
2002,2,3,7118,7118,7121,0,3,0
2003,5,3,7123,7123,7126,0,3,2
2004,4,1,7127,7127,7128,0,1,1
2005,3,1,7130,7130,7131,0,1,2
2006,4,3,7134,7134,7137,0,3,3
2007,6,2,7140,7140,7142,0,2,3
2008,5,3,7145,7145,7148,0,3,3
2009,1,1,7146,7148,7149,2,3,0
2010,4,1,7150,7150,7151,0,1,1
2011,3,3,7153,7153,7156,0,3,2
2012,6,2,7159,7159,7161,0,2,3
2013,2,1,7161,7161,7162,0,1,0
2014,1,2,7162,7162,7164,0,2,0
2015,2,3,7164,7164,7167,0,3,0
2016,2,1,7166,7167,7168,1,2,0
2017,2,3,7168,7168,7171,0,3,0
2018,6,2,7174,7174,7176,0,2,3
2019,4,2,7178,7178,7180,0,2,2
2020,4,1,7182,7182,7183,0,1,2
2021,3,1,7185,7185,7186,0,1,2
2022,4,2,7189,7189,7191,0,2,3
2023,1,2,7190,7191,7193,1,3,0
2024,6,2,7196,7196,7198,0,2,3
2025,6,1,7202,7202,7203,0,1,4
2026,4,1,7206,7206,7207,0,1,3
2027,4,2,7210,7210,7212,0,2,3
2028,5,1,7215,7215,7216,0,1,3
2029,1,1,7216,7216,7217,0,1,0
2030,1,2,7217,7217,7219,0,2,0
2031,3,3,7220,7220,7223,0,3,1
2032,4,2,7224,7224,7226,0,2,1
2033,6,3,7230,7230,7233,0,3,4
2034,4,1,7234,7234,7235,0,1,1
2035,3,3,7237,7237,7240,0,3,2
2036,6,3,7243,7243,7246,0,3,3
2037,5,1,7248,7248,7249,0,1,2
2038,5,3,7253,7253,7256,0,3,4
2039,3,2,7256,7256,7258,0,2,0
2040,4,1,7260,7260,7261,0,1,2
2041,4,2,7264,7264,7266,0,2,3
2042,5,2,7269,7269,7271,0,2,3
2043,3,3,7272,7272,7275,0,3,1
2044,2,1,7274,7275,7276,1,2,0
2045,5,1,7279,7279,7280,0,1,3
2046,4,3,7283,7283,7286,0,3,3
2047,6,3,7289,7289,7292,0,3,3
2048,3,2,7292,7292,7294,0,2,0
2049,5,1,7297,7297,7298,0,1,3
2050,1,2,7298,7298,7300,0,2,0
2051,3,2,7301,7301,7303,0,2,1
2052,6,1,7307,7307,7308,0,1,4
2053,6,3,7313,7313,7316,0,3,5
2054,2,2,7315,7316,7318,1,3,0
2055,6,2,7321,7321,7323,0,2,3
2056,3,1,7324,7324,7325,0,1,1
2057,2,1,7326,7326,7327,0,1,1
2058,6,2,7332,7332,7334,0,2,5
2059,3,1,7335,7335,7336,0,1,1
2060,4,3,7339,7339,7342,0,3,3
2061,6,2,7345,7345,7347,0,2,3
2062,3,2,7348,7348,7350,0,2,1
2063,2,3,7350,7350,7353,0,3,0
2064,1,1,7351,7353,7354,2,3,0
2065,1,1,7352,7354,7355,2,3,0
2066,1,3,7353,7355,7358,2,5,0
2067,1,1,7354,7358,7359,4,5,0
2068,2,1,7356,7359,7360,3,4,0
2069,6,1,7362,7362,7363,0,1,2
2070,1,1,7363,7363,7364,0,1,0
2071,2,1,7365,7365,7366,0,1,1
2072,6,3,7371,7371,7374,0,3,5
2073,3,3,7374,7374,7377,0,3,0
2074,6,1,7380,7380,7381,0,1,3
2075,5,2,7385,7385,7387,0,2,4
2076,6,3,7391,7391,7394,0,3,4
2077,2,1,7393,7394,7395,1,2,0
2078,1,1,7394,7395,7396,1,2,0
2079,3,2,7397,7397,7399,0,2,1
2080,5,1,7402,7402,7403,0,1,3
2081,1,1,7403,7403,7404,0,1,0
2082,3,3,7406,7406,7409,0,3,2
2083,1,1,7407,7409,7410,2,3,0
2084,3,2,7410,7410,7412,0,2,0
2085,1,1,7411,7412,7413,1,2,0
2086,2,2,7413,7413,7415,0,2,0
2087,5,2,7418,7418,7420,0,2,3
2088,3,2,7421,7421,7423,0,2,1
2089,3,2,7424,7424,7426,0,2,1
2090,4,1,7428,7428,7429,0,1,2
2091,4,2,7432,7432,7434,0,2,3
2092,4,1,7436,7436,7437,0,1,2
2093,2,3,7438,7438,7441,0,3,1
2094,2,2,7440,7441,7443,1,3,0
2095,2,3,7442,7443,7446,1,4,0
2096,4,1,7446,7446,7447,0,1,0
2097,2,1,7448,7448,7449,0,1,1
2098,2,2,7450,7450,7452,0,2,1
2099,6,1,7456,7456,7457,0,1,4
2100,1,3,7457,7457,7460,0,3,0
2101,2,3,7459,7460,7463,1,4,0
2102,3,1,7462,7463,7464,1,2,0
2103,3,1,7465,7465,7466,0,1,1
2104,4,2,7469,7469,7471,0,2,3
2105,6,3,7475,7475,7478,0,3,4
2106,3,2,7478,7478,7480,0,2,0
2107,5,1,7483,7483,7484,0,1,3
2108,3,3,7486,7486,7489,0,3,2
2109,3,3,7489,7489,7492,0,3,0
2110,1,1,7490,7492,7493,2,3,0
2111,1,2,7491,7493,7495,2,4,0
2112,3,1,7494,7495,7496,1,2,0
2113,3,1,7497,7497,7498,0,1,1
2114,2,3,7499,7499,7502,0,3,1
2115,5,3,7504,7504,7507,0,3,2
2116,5,3,7509,7509,7512,0,3,2
2117,5,1,7514,7514,7515,0,1,2
2118,1,1,7515,7515,7516,0,1,0
2119,5,2,7520,7520,7522,0,2,4
2120,3,2,7523,7523,7525,0,2,1
2121,2,3,7525,7525,7528,0,3,0
2122,6,1,7531,7531,7532,0,1,3
2123,3,2,7534,7534,7536,0,2,2
2124,4,2,7538,7538,7540,0,2,2
2125,6,2,7544,7544,7546,0,2,4
2126,2,3,7546,7546,7549,0,3,0
2127,3,2,7549,7549,7551,0,2,0
2128,3,2,7552,7552,7554,0,2,1
2129,4,1,7556,7556,7557,0,1,2
2130,3,2,7559,7559,7561,0,2,2
2131,2,2,7561,7561,7563,0,2,0
2132,4,3,7565,7565,7568,0,3,2
2133,1,3,7566,7568,7571,2,5,0
2134,1,3,7567,7571,7574,4,7,0
2135,5,3,7572,7574,7577,2,5,0
2136,4,1,7576,7577,7578,1,2,0
2137,1,1,7577,7578,7579,1,2,0
2138,4,3,7581,7581,7584,0,3,2
2139,5,1,7586,7586,7587,0,1,2
2140,5,2,7591,7591,7593,0,2,4
2141,5,2,7596,7596,7598,0,2,3
2142,2,2,7598,7598,7600,0,2,0
2143,4,1,7602,7602,7603,0,1,2
2144,1,1,7603,7603,7604,0,1,0
2145,4,1,7607,7607,7608,0,1,3
2146,1,2,7608,7608,7610,0,2,0
2147,4,1,7612,7612,7613,0,1,2
2148,6,1,7618,7618,7619,0,1,5
2149,3,1,7621,7621,7622,0,1,2
2150,4,2,7625,7625,7627,0,2,3
2151,3,2,7628,7628,7630,0,2,1
2152,3,2,7631,7631,7633,0,2,1
2153,2,1,7633,7633,7634,0,1,0
2154,6,2,7639,7639,7641,0,2,5
2155,2,3,7641,7641,7644,0,3,0
2156,4,1,7645,7645,7646,0,1,1
2157,4,2,7649,7649,7651,0,2,3
2158,3,3,7652,7652,7655,0,3,1
2159,3,2,7655,7655,7657,0,2,0
2160,2,1,7657,7657,7658,0,1,0
2161,6,1,7663,7663,7664,0,1,5
2162,1,2,7664,7664,7666,0,2,0
2163,6,3,7670,7670,7673,0,3,4
2164,1,2,7671,7673,7675,2,4,0
2165,5,3,7676,7676,7679,0,3,1
2166,3,3,7679,7679,7682,0,3,0
2167,6,1,7685,7685,7686,0,1,3
2168,1,3,7686,7686,7689,0,3,0
2169,2,2,7688,7689,7691,1,3,0
2170,2,2,7690,7691,7693,1,3,0
2171,2,2,7692,7693,7695,1,3,0
2172,2,2,7694,7695,7697,1,3,0
2173,5,2,7699,7699,7701,0,2,2
2174,5,1,7704,7704,7705,0,1,3
2175,3,2,7707,7707,7709,0,2,2
2176,4,2,7711,7711,7713,0,2,2
2177,4,1,7715,7715,7716,0,1,2
2178,4,2,7719,7719,7721,0,2,3
2179,1,1,7720,7721,7722,1,2,0
2180,2,2,7722,7722,7724,0,2,0
2181,4,2,7726,7726,7728,0,2,2
2182,1,3,7727,7728,7731,1,4,0
2183,5,2,7732,7732,7734,0,2,1
2184,6,3,7738,7738,7741,0,3,4
2185,3,2,7741,7741,7743,0,2,0
2186,2,1,7743,7743,7744,0,1,0
2187,2,1,7745,7745,7746,0,1,1
2188,3,1,7748,7748,7749,0,1,2
2189,6,1,7754,7754,7755,0,1,5
2190,1,3,7755,7755,7758,0,3,0
2191,4,3,7759,7759,7762,0,3,1
2192,1,1,7760,7762,7763,2,3,0
2193,6,1,7766,7766,7767,0,1,3
2194,1,3,7767,7767,7770,0,3,0
2195,4,2,7771,7771,7773,0,2,1
2196,1,1,7772,7773,7774,1,2,0
2197,2,3,7774,7774,7777,0,3,0
2198,4,2,7778,7778,7780,0,2,1
2199,1,2,7779,7780,7782,1,3,0
2200,1,1,7780,7782,7783,2,3,0
2201,1,1,7781,7783,7784,2,3,0
2202,6,1,7787,7787,7788,0,1,3
2203,1,2,7788,7788,7790,0,2,0
2204,5,1,7793,7793,7794,0,1,3
2205,4,3,7797,7797,7800,0,3,3
2206,5,1,7802,7802,7803,0,1,2
2207,3,2,7805,7805,7807,0,2,2
2208,5,2,7810,7810,7812,0,2,3
2209,4,2,7814,7814,7816,0,2,2
2210,4,1,7818,7818,7819,0,1,2
2211,2,3,7820,7820,7823,0,3,1
2212,2,2,7822,7823,7825,1,3,0
2213,2,1,7824,7825,7826,1,2,0
2214,3,3,7827,7827,7830,0,3,1
2215,3,3,7830,7830,7833,0,3,0
2216,1,3,7831,7833,7836,2,5,0
2217,5,1,7836,7836,7837,0,1,0
2218,4,1,7840,7840,7841,0,1,3
2219,3,3,7843,7843,7846,0,3,2
2220,2,1,7845,7846,7847,1,2,0
2221,4,2,7849,7849,7851,0,2,2
2222,3,3,7852,7852,7855,0,3,1
2223,5,3,7857,7857,7860,0,3,2
2224,2,2,7859,7860,7862,1,3,0
2225,4,3,7863,7863,7866,0,3,1
2226,5,1,7868,7868,7869,0,1,2
2227,5,3,7873,7873,7876,0,3,4
2228,3,2,7876,7876,7878,0,2,0
2229,2,3,7878,7878,7881,0,3,0
2230,3,1,7881,7881,7882,0,1,0
2231,5,1,7886,7886,7887,0,1,4
2232,6,2,7892,7892,7894,0,2,5
2233,4,1,7896,7896,7897,0,1,2
2234,4,1,7900,7900,7901,0,1,3
2235,3,3,7903,7903,7906,0,3,2
2236,3,1,7906,7906,7907,0,1,0
2237,2,2,7908,7908,7910,0,2,1
2238,3,2,7911,7911,7913,0,2,1
2239,3,3,7914,7914,7917,0,3,1
2240,2,3,7916,7917,7920,1,4,0
2241,2,3,7918,7920,7923,2,5,0
2242,3,1,7921,7923,7924,2,3,0
2243,3,1,7924,7924,7925,0,1,0
2244,1,2,7925,7925,7927,0,2,0
2245,4,3,7929,7929,7932,0,3,2
2246,2,2,7931,7932,7934,1,3,0
2247,1,1,7932,7934,7935,2,3,0
2248,4,2,7936,7936,7938,0,2,1
2249,1,3,7937,7938,7941,1,4,0
2250,3,3,7940,7941,7944,1,4,0
2251,1,1,7941,7944,7945,3,4,0
2252,1,3,7942,7945,7948,3,6,0
2253,5,1,7947,7948,7949,1,2,0
2254,2,2,7949,7949,7951,0,2,0
2255,3,1,7952,7952,7953,0,1,1
2256,3,1,7955,7955,7956,0,1,2
2257,6,1,7961,7961,7962,0,1,5
2258,2,2,7963,7963,7965,0,2,1
2259,1,3,7964,7965,7968,1,4,0
2260,3,1,7967,7968,7969,1,2,0
2261,6,3,7973,7973,7976,0,3,4
2262,6,1,7979,7979,7980,0,1,3
2263,4,3,7983,7983,7986,0,3,3
2264,2,3,7985,7986,7989,1,4,0
2265,5,2,7990,7990,7992,0,2,1
2266,3,3,7993,7993,7996,0,3,1
2267,4,3,7997,7997,8000,0,3,1
2268,1,2,7998,8000,8002,2,4,0
2269,2,3,8000,8002,8005,2,5,0
2270,4,2,8004,8005,8007,1,3,0
2271,3,3,8007,8007,8010,0,3,0
2272,1,2,8008,8010,8012,2,4,0
2273,4,1,8012,8012,8013,0,1,0
2274,5,1,8017,8017,8018,0,1,4
2275,6,2,8023,8023,8025,0,2,5
2276,5,2,8028,8028,8030,0,2,3
2277,1,3,8029,8030,8033,1,4,0
2278,5,3,8034,8034,8037,0,3,1
2279,3,1,8037,8037,8038,0,1,0
2280,5,2,8042,8042,8044,0,2,4
2281,1,1,8043,8044,8045,1,2,0
2282,2,2,8045,8045,8047,0,2,0
2283,3,2,8048,8048,8050,0,2,1
2284,1,2,8049,8050,8052,1,3,0
2285,2,1,8051,8052,8053,1,2,0
2286,4,2,8055,8055,8057,0,2,2
2287,2,2,8057,8057,8059,0,2,0
2288,1,3,8058,8059,8062,1,4,0
2289,3,3,8061,8062,8065,1,4,0
2290,4,3,8065,8065,8068,0,3,0
2291,1,3,8066,8068,8071,2,5,0
2292,5,2,8071,8071,8073,0,2,0
2293,4,2,8075,8075,8077,0,2,2
2294,6,2,8081,8081,8083,0,2,4
2295,6,2,8087,8087,8089,0,2,4
2296,3,1,8090,8090,8091,0,1,1
2297,5,3,8095,8095,8098,0,3,4
2298,5,2,8100,8100,8102,0,2,2
2299,2,1,8102,8102,8103,0,1,0
2300,5,1,8107,8107,8108,0,1,4
2301,5,3,8112,8112,8115,0,3,4
2302,3,3,8115,8115,8118,0,3,0
2303,6,1,8121,8121,8122,0,1,3
2304,6,1,8127,8127,8128,0,1,5
2305,1,2,8128,8128,8130,0,2,0
2306,1,2,8129,8130,8132,1,3,0
2307,2,1,8131,8132,8133,1,2,0
2308,2,1,8133,8133,8134,0,1,0
2309,4,1,8137,8137,8138,0,1,3
2310,6,2,8143,8143,8145,0,2,5
2311,4,1,8147,8147,8148,0,1,2
2312,6,3,8153,8153,8156,0,3,5
2313,4,3,8157,8157,8160,0,3,1
2314,3,2,8160,8160,8162,0,2,0
2315,2,1,8162,8162,8163,0,1,0
2316,1,1,8163,8163,8164,0,1,0
2317,1,3,8164,8164,8167,0,3,0
2318,2,1,8166,8167,8168,1,2,0
2319,2,1,8168,8168,8169,0,1,0
2320,1,3,8169,8169,8172,0,3,0
2321,1,2,8170,8172,8174,2,4,0
2322,3,3,8173,8174,8177,1,4,0
2323,4,1,8177,8177,8178,0,1,0
2324,5,2,8182,8182,8184,0,2,4
2325,3,2,8185,8185,8187,0,2,1
2326,5,2,8190,8190,8192,0,2,3
2327,5,1,8195,8195,8196,0,1,3
2328,1,3,8196,8196,8199,0,3,0
2329,3,3,8199,8199,8202,0,3,0
2330,2,2,8201,8202,8204,1,3,0
2331,1,2,8202,8204,8206,2,4,0
2332,3,3,8205,8206,8209,1,4,0
2333,4,3,8209,8209,8212,0,3,0
2334,2,3,8211,8212,8215,1,4,0
2335,6,2,8217,8217,8219,0,2,2
2336,1,2,8218,8219,8221,1,3,0
2337,3,3,8221,8221,8224,0,3,0
2338,2,2,8223,8224,8226,1,3,0
2339,1,1,8224,8226,8227,2,3,0
2340,3,1,8227,8227,8228,0,1,0
2341,1,1,8228,8228,8229,0,1,0
2342,5,1,8233,8233,8234,0,1,4
2343,5,1,8238,8238,8239,0,1,4
2344,1,2,8239,8239,8241,0,2,0
2345,1,1,8240,8241,8242,1,2,0
2346,3,3,8243,8243,8246,0,3,1
2347,5,2,8248,8248,8250,0,2,2
2348,5,3,8253,8253,8256,0,3,3
2349,3,3,8256,8256,8259,0,3,0
2350,4,3,8260,8260,8263,0,3,1
2351,3,2,8263,8263,8265,0,2,0
2352,1,2,8264,8265,8267,1,3,0
2353,2,1,8266,8267,8268,1,2,0
2354,1,2,8267,8268,8270,1,3,0
2355,2,3,8269,8270,8273,1,4,0
2356,3,3,8272,8273,8276,1,4,0
2357,6,2,8278,8278,8280,0,2,2
2358,6,3,8284,8284,8287,0,3,4
2359,1,1,8285,8287,8288,2,3,0
2360,4,3,8289,8289,8292,0,3,1
2361,3,1,8292,8292,8293,0,1,0
2362,6,2,8298,8298,8300,0,2,5
2363,5,3,8303,8303,8306,0,3,3
2364,4,1,8307,8307,8308,0,1,1
2365,3,2,8310,8310,8312,0,2,2
2366,4,3,8314,8314,8317,0,3,2
2367,1,1,8315,8317,8318,2,3,0
2368,4,3,8319,8319,8322,0,3,1
2369,2,3,8321,8322,8325,1,4,0
2370,2,1,8323,8325,8326,2,3,0
2371,5,2,8328,8328,8330,0,2,2
2372,6,2,8334,8334,8336,0,2,4
2373,6,2,8340,8340,8342,0,2,4
2374,2,2,8342,8342,8344,0,2,0
2375,4,2,8346,8346,8348,0,2,2
2376,3,1,8349,8349,8350,0,1,1
2377,1,1,8350,8350,8351,0,1,0
2378,6,3,8356,8356,8359,0,3,5
2379,4,1,8360,8360,8361,0,1,1
2380,1,1,8361,8361,8362,0,1,0
2381,3,3,8364,8364,8367,0,3,2
2382,3,1,8367,8367,8368,0,1,0
2383,4,1,8371,8371,8372,0,1,3
2384,5,3,8376,8376,8379,0,3,4
2385,3,3,8379,8379,8382,0,3,0
2386,6,2,8385,8385,8387,0,2,3
2387,1,2,8386,8387,8389,1,3,0
2388,3,2,8389,8389,8391,0,2,0
2389,1,3,8390,8391,8394,1,4,0
2390,4,1,8394,8394,8395,0,1,0
2391,6,2,8400,8400,8402,0,2,5
2392,6,3,8406,8406,8409,0,3,4
2393,1,1,8407,8409,8410,2,3,0
2394,3,2,8410,8410,8412,0,2,0
2395,6,3,8416,8416,8419,0,3,4
2396,3,2,8419,8419,8421,0,2,0
2397,1,2,8420,8421,8423,1,3,0
2398,5,3,8425,8425,8428,0,3,2
2399,2,3,8427,8428,8431,1,4,0
2400,2,1,8429,8431,8432,2,3,0
2401,1,2,8430,8432,8434,2,4,0
2402,5,1,8435,8435,8436,0,1,1
2403,5,3,8440,8440,8443,0,3,4
2404,5,3,8445,8445,8448,0,3,2
2405,2,1,8447,8448,8449,1,2,0
2406,5,3,8452,8452,8455,0,3,3
2407,5,3,8457,8457,8460,0,3,2
2408,2,2,8459,8460,8462,1,3,0
2409,6,3,8465,8465,8468,0,3,3
2410,4,3,8469,8469,8472,0,3,1
2411,1,1,8470,8472,8473,2,3,0
2412,3,2,8473,8473,8475,0,2,0
2413,5,1,8478,8478,8479,0,1,3
2414,3,2,8481,8481,8483,0,2,2
2415,5,1,8486,8486,8487,0,1,3
2416,3,3,8489,8489,8492,0,3,2
2417,6,2,8495,8495,8497,0,2,3
2418,4,1,8499,8499,8500,0,1,2
2419,3,2,8502,8502,8504,0,2,2
2420,6,3,8508,8508,8511,0,3,4
2421,4,3,8512,8512,8515,0,3,1
2422,3,2,8515,8515,8517,0,2,0
2423,4,2,8519,8519,8521,0,2,2
2424,1,2,8520,8521,8523,1,3,0
2425,1,3,8521,8523,8526,2,5,0
2426,5,3,8526,8526,8529,0,3,0
2427,1,1,8527,8529,8530,2,3,0
2428,3,1,8530,8530,8531,0,1,0
2429,4,1,8534,8534,8535,0,1,3
2430,6,2,8540,8540,8542,0,2,5
2431,5,3,8545,8545,8548,0,3,3
2432,3,2,8548,8548,8550,0,2,0
2433,5,3,8553,8553,8556,0,3,3
2434,3,1,8556,8556,8557,0,1,0
2435,4,3,8560,8560,8563,0,3,3
2436,5,3,8565,8565,8568,0,3,2
2437,2,2,8567,8568,8570,1,3,0
2438,3,3,8570,8570,8573,0,3,0
2439,2,3,8572,8573,8576,1,4,0
2440,4,3,8576,8576,8579,0,3,0
2441,3,3,8579,8579,8582,0,3,0
2442,1,3,8580,8582,8585,2,5,0
2443,2,1,8582,8585,8586,3,4,0
2444,5,3,8587,8587,8590,0,3,1
2445,4,1,8591,8591,8592,0,1,1
2446,6,2,8597,8597,8599,0,2,5
2447,1,2,8598,8599,8601,1,3,0
2448,3,2,8601,8601,8603,0,2,0
2449,5,2,8606,8606,8608,0,2,3
2450,4,3,8610,8610,8613,0,3,2
2451,6,3,8616,8616,8619,0,3,3
2452,4,3,8620,8620,8623,0,3,1
2453,4,1,8624,8624,8625,0,1,1
2454,2,2,8626,8626,8628,0,2,1
2455,5,3,8631,8631,8634,0,3,3
2456,3,3,8634,8634,8637,0,3,0
2457,1,1,8635,8637,8638,2,3,0
2458,1,3,8636,8638,8641,2,5,0
2459,6,2,8642,8642,8644,0,2,1
2460,5,2,8647,8647,8649,0,2,3
2461,5,1,8652,8652,8653,0,1,3
2462,5,2,8657,8657,8659,0,2,4
2463,6,3,8663,8663,8666,0,3,4
2464,3,2,8666,8666,8668,0,2,0
2465,1,2,8667,8668,8670,1,3,0
2466,3,1,8670,8670,8671,0,1,0
2467,2,3,8672,8672,8675,0,3,1
2468,4,1,8676,8676,8677,0,1,1
2469,4,3,8680,8680,8683,0,3,3
2470,5,1,8685,8685,8686,0,1,2
2471,4,2,8689,8689,8691,0,2,3
2472,3,1,8692,8692,8693,0,1,1
2473,2,2,8694,8694,8696,0,2,1
2474,2,3,8696,8696,8699,0,3,0
2475,3,1,8699,8699,8700,0,1,0
2476,6,3,8705,8705,8708,0,3,5
2477,2,1,8707,8708,8709,1,2,0
2478,2,2,8709,8709,8711,0,2,0
2479,5,1,8714,8714,8715,0,1,3
2480,6,1,8720,8720,8721,0,1,5
2481,1,2,8721,8721,8723,0,2,0
2482,4,2,8725,8725,8727,0,2,2
2483,3,2,8728,8728,8730,0,2,1
2484,1,3,8729,8730,8733,1,4,0
2485,3,1,8732,8733,8734,1,2,0
2486,5,3,8737,8737,8740,0,3,3
2487,1,2,8738,8740,8742,2,4,0
2488,5,3,8743,8743,8746,0,3,1
2489,6,2,8749,8749,8751,0,2,3
2490,2,3,8751,8751,8754,0,3,0
2491,5,3,8756,8756,8759,0,3,2
2492,2,2,8758,8759,8761,1,3,0
2493,3,2,8761,8761,8763,0,2,0
2494,5,1,8766,8766,8767,0,1,3
2495,3,1,8769,8769,8770,0,1,2
2496,5,1,8774,8774,8775,0,1,4
2497,6,2,8780,8780,8782,0,2,5
2498,3,2,8783,8783,8785,0,2,1
2499,6,3,8789,8789,8792,0,3,4
2500,2,2,8791,8792,8794,1,3,0
2501,6,1,8797,8797,8798,0,1,3
2502,5,3,8802,8802,8805,0,3,4
2503,2,1,8804,8805,8806,1,2,0
2504,5,3,8809,8809,8812,0,3,3
2505,3,2,8812,8812,8814,0,2,0
2506,3,2,8815,8815,8817,0,2,1
2507,4,3,8819,8819,8822,0,3,2
2508,3,1,8822,8822,8823,0,1,0
2509,6,2,8828,8828,8830,0,2,5
2510,3,1,8831,8831,8832,0,1,1
2511,1,3,8832,8832,8835,0,3,0
2512,5,1,8837,8837,8838,0,1,2
2513,3,3,8840,8840,8843,0,3,2
2514,2,2,8842,8843,8845,1,3,0
2515,2,3,8844,8845,8848,1,4,0
2516,4,1,8848,8848,8849,0,1,0
2517,6,3,8854,8854,8857,0,3,5
2518,2,3,8856,8857,8860,1,4,0
2519,4,1,8860,8860,8861,0,1,0
2520,4,1,8864,8864,8865,0,1,3
2521,6,3,8870,8870,8873,0,3,5
2522,6,3,8876,8876,8879,0,3,3
2523,3,1,8879,8879,8880,0,1,0
2524,2,3,8881,8881,8884,0,3,1
2525,3,3,8884,8884,8887,0,3,0
2526,2,3,8886,8887,8890,1,4,0
2527,3,1,8889,8890,8891,1,2,0
2528,1,3,8890,8891,8894,1,4,0
2529,2,3,8892,8894,8897,2,5,0
2530,6,1,8898,8898,8899,0,1,1
2531,2,3,8900,8900,8903,0,3,1
2532,3,2,8903,8903,8905,0,2,0
2533,3,1,8906,8906,8907,0,1,1
2534,3,2,8909,8909,8911,0,2,2
2535,3,1,8912,8912,8913,0,1,1
2536,5,1,8917,8917,8918,0,1,4
2537,5,2,8922,8922,8924,0,2,4
2538,5,1,8927,8927,8928,0,1,3
2539,5,1,8932,8932,8933,0,1,4
2540,3,2,8935,8935,8937,0,2,2
2541,2,3,8937,8937,8940,0,3,0
2542,3,2,8940,8940,8942,0,2,0
2543,2,3,8942,8942,8945,0,3,0
2544,6,3,8948,8948,8951,0,3,3
2545,1,3,8949,8951,8954,2,5,0
2546,3,2,8952,8954,8956,2,4,0
2547,3,1,8955,8956,8957,1,2,0
2548,5,3,8960,8960,8963,0,3,3
2549,3,1,8963,8963,8964,0,1,0
2550,1,2,8964,8964,8966,0,2,0
2551,2,2,8966,8966,8968,0,2,0
2552,4,1,8970,8970,8971,0,1,2
2553,4,2,8974,8974,8976,0,2,3
2554,1,3,8975,8976,8979,1,4,0
2555,4,3,8979,8979,8982,0,3,0
2556,5,2,8984,8984,8986,0,2,2
2557,4,3,8988,8988,8991,0,3,2
2558,4,3,8992,8992,8995,0,3,1
2559,6,1,8998,8998,8999,0,1,3
2560,3,3,9001,9001,9004,0,3,2
2561,1,3,9002,9004,9007,2,5,0
2562,6,2,9008,9008,9010,0,2,1
2563,6,2,9014,9014,9016,0,2,4
2564,6,3,9020,9020,9023,0,3,4
2565,5,1,9025,9025,9026,0,1,2
2566,2,2,9027,9027,9029,0,2,1
2567,4,2,9031,9031,9033,0,2,2
2568,4,3,9035,9035,9038,0,3,2
2569,2,2,9037,9038,9040,1,3,0
2570,4,3,9041,9041,9044,0,3,1
2571,4,3,9045,9045,9048,0,3,1
2572,1,2,9046,9048,9050,2,4,0
2573,6,2,9052,9052,9054,0,2,2
2574,6,1,9058,9058,9059,0,1,4
2575,5,1,9063,9063,9064,0,1,4
2576,5,3,9068,9068,9071,0,3,4
2577,4,1,9072,9072,9073,0,1,1
2578,6,3,9078,9078,9081,0,3,5
2579,4,1,9082,9082,9083,0,1,1
2580,6,3,9088,9088,9091,0,3,5
2581,5,3,9093,9093,9096,0,3,2
2582,6,3,9099,9099,9102,0,3,3
2583,5,2,9104,9104,9106,0,2,2
2584,1,3,9105,9106,9109,1,4,0
2585,3,2,9108,9109,9111,1,3,0
2586,5,2,9113,9113,9115,0,2,2
2587,3,1,9116,9116,9117,0,1,1
2588,3,1,9119,9119,9120,0,1,2
2589,5,3,9124,9124,9127,0,3,4
2590,2,1,9126,9127,9128,1,2,0
2591,5,1,9131,9131,9132,0,1,3
2592,6,3,9137,9137,9140,0,3,5
2593,2,2,9139,9140,9142,1,3,0
2594,2,2,9141,9142,9144,1,3,0
2595,5,3,9146,9146,9149,0,3,2
2596,2,3,9148,9149,9152,1,4,0
2597,5,2,9153,9153,9155,0,2,1
2598,2,2,9155,9155,9157,0,2,0
2599,2,3,9157,9157,9160,0,3,0
2600,3,1,9160,9160,9161,0,1,0
2601,3,2,9163,9163,9165,0,2,2
2602,3,2,9166,9166,9168,0,2,1
2603,1,3,9167,9168,9171,1,4,0
2604,2,2,9169,9171,9173,2,4,0
2605,4,1,9173,9173,9174,0,1,0
2606,6,3,9179,9179,9182,0,3,5
2607,5,1,9184,9184,9185,0,1,2
2608,3,2,9187,9187,9189,0,2,2
2609,4,2,9191,9191,9193,0,2,2
2610,2,1,9193,9193,9194,0,1,0
2611,2,2,9195,9195,9197,0,2,1
2612,4,1,9199,9199,9200,0,1,2
2613,1,2,9200,9200,9202,0,2,0
2614,1,2,9201,9202,9204,1,3,0
2615,1,3,9202,9204,9207,2,5,0
2616,4,2,9206,9207,9209,1,3,0
2617,6,2,9212,9212,9214,0,2,3
2618,4,3,9216,9216,9219,0,3,2
2619,2,1,9218,9219,9220,1,2,0
2620,3,2,9221,9221,9223,0,2,1
2621,1,3,9222,9223,9226,1,4,0
2622,4,2,9226,9226,9228,0,2,0
2623,1,3,9227,9228,9231,1,4,0
2624,3,2,9230,9231,9233,1,3,0
2625,3,1,9233,9233,9234,0,1,0
2626,4,3,9237,9237,9240,0,3,3
2627,4,3,9241,9241,9244,0,3,1
2628,3,2,9244,9244,9246,0,2,0
2629,5,2,9249,9249,9251,0,2,3
2630,1,1,9250,9251,9252,1,2,0
2631,1,2,9251,9252,9254,1,3,0
2632,3,1,9254,9254,9255,0,1,0
2633,3,3,9257,9257,9260,0,3,2
2634,1,3,9258,9260,9263,2,5,0
2635,4,2,9262,9263,9265,1,3,0
2636,6,1,9268,9268,9269,0,1,3
2637,6,2,9274,9274,9276,0,2,5
2638,1,2,9275,9276,9278,1,3,0
2639,1,3,9276,9278,9281,2,5,0
2640,3,3,9279,9281,9284,2,5,0
2641,4,2,9283,9284,9286,1,3,0
2642,1,1,9284,9286,9287,2,3,0
2643,4,3,9288,9288,9291,0,3,1
2644,3,3,9291,9291,9294,0,3,0
2645,3,1,9294,9294,9295,0,1,0
2646,5,2,9299,9299,9301,0,2,4
2647,1,1,9300,9301,9302,1,2,0
2648,4,2,9304,9304,9306,0,2,2
2649,3,2,9307,9307,9309,0,2,1
2650,2,3,9309,9309,9312,0,3,0
2651,1,2,9310,9312,9314,2,4,0
2652,4,2,9314,9314,9316,0,2,0
2653,4,2,9318,9318,9320,0,2,2
2654,3,1,9321,9321,9322,0,1,1
2655,5,3,9326,9326,9329,0,3,4
2656,6,3,9332,9332,9335,0,3,3
2657,6,3,9338,9338,9341,0,3,3
2658,4,1,9342,9342,9343,0,1,1
2659,6,3,9348,9348,9351,0,3,5
2660,3,2,9351,9351,9353,0,2,0
2661,2,2,9353,9353,9355,0,2,0
2662,4,2,9357,9357,9359,0,2,2
2663,2,1,9359,9359,9360,0,1,0
2664,2,1,9361,9361,9362,0,1,1
2665,6,2,9367,9367,9369,0,2,5
2666,2,2,9369,9369,9371,0,2,0
2667,5,2,9374,9374,9376,0,2,3
2668,2,2,9376,9376,9378,0,2,0
2669,1,2,9377,9378,9380,1,3,0
2670,2,3,9379,9380,9383,1,4,0
2671,4,1,9383,9383,9384,0,1,0
2672,3,2,9386,9386,9388,0,2,2
2673,1,1,9387,9388,9389,1,2,0
2674,4,1,9391,9391,9392,0,1,2
2675,2,3,9393,9393,9396,0,3,1
2676,5,3,9398,9398,9401,0,3,2
2677,1,2,9399,9401,9403,2,4,0
2678,2,3,9401,9403,9406,2,5,0
2679,1,1,9402,9406,9407,4,5,0
2680,6,2,9408,9408,9410,0,2,1
2681,6,3,9414,9414,9417,0,3,4
2682,6,1,9420,9420,9421,0,1,3
2683,3,3,9423,9423,9426,0,3,2
2684,6,3,9429,9429,9432,0,3,3
2685,3,2,9432,9432,9434,0,2,0
2686,2,1,9434,9434,9435,0,1,0
2687,5,2,9439,9439,9441,0,2,4
2688,3,2,9442,9442,9444,0,2,1
2689,5,2,9447,9447,9449,0,2,3
2690,4,3,9451,9451,9454,0,3,2
2691,5,3,9456,9456,9459,0,3,2
2692,6,3,9462,9462,9465,0,3,3
2693,4,1,9466,9466,9467,0,1,1
2694,1,2,9467,9467,9469,0,2,0
2695,5,2,9472,9472,9474,0,2,3
2696,2,2,9474,9474,9476,0,2,0
2697,2,1,9476,9476,9477,0,1,0
2698,3,1,9479,9479,9480,0,1,2
2699,4,3,9483,9483,9486,0,3,3
2700,5,2,9488,9488,9490,0,2,2
2701,5,2,9493,9493,9495,0,2,3
2702,6,3,9499,9499,9502,0,3,4
2703,2,3,9501,9502,9505,1,4,0
2704,2,3,9503,9505,9508,2,5,0
2705,3,1,9506,9508,9509,2,3,0
2706,6,1,9512,9512,9513,0,1,3
2707,6,2,9518,9518,9520,0,2,5
2708,6,1,9524,9524,9525,0,1,4
2709,3,1,9527,9527,9528,0,1,2
2710,5,1,9532,9532,9533,0,1,4
2711,6,1,9538,9538,9539,0,1,5
2712,1,2,9539,9539,9541,0,2,0
2713,5,1,9544,9544,9545,0,1,3
2714,5,2,9549,9549,9551,0,2,4
2715,1,3,9550,9551,9554,1,4,0
2716,1,1,9551,9554,9555,3,4,0
2717,5,2,9556,9556,9558,0,2,1
2718,6,1,9562,9562,9563,0,1,4
2719,2,2,9564,9564,9566,0,2,1
2720,1,1,9565,9566,9567,1,2,0
2721,1,2,9566,9567,9569,1,3,0
2722,5,3,9571,9571,9574,0,3,2
2723,5,1,9576,9576,9577,0,1,2
2724,5,3,9581,9581,9584,0,3,4
2725,4,2,9585,9585,9587,0,2,1
2726,5,3,9590,9590,9593,0,3,3
2727,3,2,9593,9593,9595,0,2,0
2728,5,2,9598,9598,9600,0,2,3
2729,3,2,9601,9601,9603,0,2,1
2730,5,3,9606,9606,9609,0,3,3
2731,1,1,9607,9609,9610,2,3,0
2732,6,2,9613,9613,9615,0,2,3
2733,6,3,9619,9619,9622,0,3,4
2734,6,3,9625,9625,9628,0,3,3
2735,5,2,9630,9630,9632,0,2,2
2736,2,1,9632,9632,9633,0,1,0
2737,6,3,9638,9638,9641,0,3,5
2738,1,1,9639,9641,9642,2,3,0
2739,5,1,9644,9644,9645,0,1,2
2740,4,3,9648,9648,9651,0,3,3
2741,5,1,9653,9653,9654,0,1,2
2742,5,1,9658,9658,9659,0,1,4
2743,2,2,9660,9660,9662,0,2,1
2744,3,1,9663,9663,9664,0,1,1
2745,3,2,9666,9666,9668,0,2,2
2746,4,1,9670,9670,9671,0,1,2
2747,1,3,9671,9671,9674,0,3,0
2748,2,3,9673,9674,9677,1,4,0
2749,4,2,9677,9677,9679,0,2,0
2750,3,2,9680,9680,9682,0,2,1
2751,2,3,9682,9682,9685,0,3,0
2752,4,3,9686,9686,9689,0,3,1
2753,1,1,9687,9689,9690,2,3,0
2754,6,1,9693,9693,9694,0,1,3
2755,2,3,9695,9695,9698,0,3,1
2756,6,3,9701,9701,9704,0,3,3
2757,3,2,9704,9704,9706,0,2,0
2758,1,2,9705,9706,9708,1,3,0
2759,1,2,9706,9708,9710,2,4,0
2760,5,2,9711,9711,9713,0,2,1
2761,5,2,9716,9716,9718,0,2,3
2762,4,3,9720,9720,9723,0,3,2
2763,5,3,9725,9725,9728,0,3,2
2764,5,3,9730,9730,9733,0,3,2
2765,4,2,9734,9734,9736,0,2,1
2766,3,1,9737,9737,9738,0,1,1
2767,5,1,9742,9742,9743,0,1,4
2768,3,1,9745,9745,9746,0,1,2
2769,5,1,9750,9750,9751,0,1,4
2770,5,3,9755,9755,9758,0,3,4
2771,5,3,9760,9760,9763,0,3,2
2772,2,2,9762,9763,9765,1,3,0
2773,2,2,9764,9765,9767,1,3,0
2774,4,3,9768,9768,9771,0,3,1
2775,4,3,9772,9772,9775,0,3,1
2776,1,1,9773,9775,9776,2,3,0
2777,6,1,9779,9779,9780,0,1,3
2778,4,1,9783,9783,9784,0,1,3
2779,3,3,9786,9786,9789,0,3,2
2780,6,3,9792,9792,9795,0,3,3
2781,5,3,9797,9797,9800,0,3,2
2782,1,2,9798,9800,9802,2,4,0
2783,5,3,9803,9803,9806,0,3,1
2784,3,2,9806,9806,9808,0,2,0
2785,1,3,9807,9808,9811,1,4,0
2786,3,2,9810,9811,9813,1,3,0
2787,6,2,9816,9816,9818,0,2,3
2788,2,1,9818,9818,9819,0,1,0
2789,2,1,9820,9820,9821,0,1,1
2790,6,3,9826,9826,9829,0,3,5
2791,2,3,9828,9829,9832,1,4,0
2792,4,1,9832,9832,9833,0,1,0
2793,2,2,9834,9834,9836,0,2,1
2794,2,2,9836,9836,9838,0,2,0
2795,1,2,9837,9838,9840,1,3,0
2796,3,3,9840,9840,9843,0,3,0
2797,6,2,9846,9846,9848,0,2,3
2798,6,3,9852,9852,9855,0,3,4
2799,1,3,9853,9855,9858,2,5,0
2800,6,2,9859,9859,9861,0,2,1
2801,6,2,9865,9865,9867,0,2,4
2802,5,1,9870,9870,9871,0,1,3
2803,5,3,9875,9875,9878,0,3,4
2804,3,1,9878,9878,9879,0,1,0
2805,6,2,9884,9884,9886,0,2,5
2806,3,1,9887,9887,9888,0,1,1
2807,2,1,9889,9889,9890,0,1,1
2808,4,1,9893,9893,9894,0,1,3
2809,5,3,9898,9898,9901,0,3,4
2810,6,3,9904,9904,9907,0,3,3
2811,6,2,9910,9910,9912,0,2,3
2812,1,2,9911,9912,9914,1,3,0
2813,5,2,9916,9916,9918,0,2,2
2814,5,3,9921,9921,9924,0,3,3
2815,3,1,9924,9924,9925,0,1,0
2816,4,3,9928,9928,9931,0,3,3
2817,4,3,9932,9932,9935,0,3,1
2818,6,2,9938,9938,9940,0,2,3
2819,4,1,9942,9942,9943,0,1,2
2820,1,1,9943,9943,9944,0,1,0
2821,6,1,9949,9949,9950,0,1,5
2822,2,2,9951,9951,9953,0,2,1
2823,3,1,9954,9954,9955,0,1,1
2824,1,1,9955,9955,9956,0,1,0
2825,2,3,9957,9957,9960,0,3,1
2826,6,1,9963,9963,9964,0,1,3
2827,6,1,9969,9969,9970,0,1,5
2828,3,2,9972,9972,9974,0,2,2
2829,5,2,9977,9977,9979,0,2,3
2830,1,2,9978,9979,9981,1,3,0
2831,6,3,9984,9984,9987,0,3,3
2832,5,3,9989,9989,9992,0,3,2
2833,6,3,9995,9995,9998,0,3,3
2834,5,2,10000,10000,10002,0,2,2
2835,1,3,10001,10002,10005,1,4,0
2836,4,3,10005,10005,10008,0,3,0
2837,3,1,10008,10008,10009,0,1,0
2838,5,3,10013,10013,10016,0,3,4
2839,4,2,10017,10017,10019,0,2,1
2840,6,1,10023,10023,10024,0,1,4
2841,5,1,10028,10028,10029,0,1,4
2842,5,1,10033,10033,10034,0,1,4
2843,2,3,10035,10035,10038,0,3,1
2844,1,2,10036,10038,10040,2,4,0
2845,1,1,10037,10040,10041,3,4,0
2846,2,2,10039,10041,10043,2,4,0
2847,4,3,10043,10043,10046,0,3,0
2848,5,3,10048,10048,10051,0,3,2
2849,2,2,10050,10051,10053,1,3,0
2850,1,1,10051,10053,10054,2,3,0
2851,3,3,10054,10054,10057,0,3,0
2852,3,1,10057,10057,10058,0,1,0
2853,1,1,10058,10058,10059,0,1,0
2854,1,1,10059,10059,10060,0,1,0
2855,3,3,10062,10062,10065,0,3,2
2856,1,2,10063,10065,10067,2,4,0
2857,5,1,10068,10068,10069,0,1,1
2858,4,1,10072,10072,10073,0,1,3
2859,1,2,10073,10073,10075,0,2,0
2860,2,1,10075,10075,10076,0,1,0
2861,3,2,10078,10078,10080,0,2,2
2862,5,1,10083,10083,10084,0,1,3
2863,1,3,10084,10084,10087,0,3,0
2864,5,3,10089,10089,10092,0,3,2
2865,3,3,10092,10092,10095,0,3,0
2866,4,3,10096,10096,10099,0,3,1
2867,6,2,10102,10102,10104,0,2,3
2868,6,2,10108,10108,10110,0,2,4
2869,1,3,10109,10110,10113,1,4,0
2870,4,1,10113,10113,10114,0,1,0
2871,3,2,10116,10116,10118,0,2,2
2872,1,1,10117,10118,10119,1,2,0
2873,3,2,10120,10120,10122,0,2,1
2874,6,3,10126,10126,10129,0,3,4
2875,3,3,10129,10129,10132,0,3,0
2876,2,3,10131,10132,10135,1,4,0
2877,3,3,10134,10135,10138,1,4,0
2878,6,1,10140,10140,10141,0,1,2
2879,5,2,10145,10145,10147,0,2,4
2880,5,2,10150,10150,10152,0,2,3
2881,2,3,10152,10152,10155,0,3,0
2882,4,1,10156,10156,10157,0,1,1
2883,1,1,10157,10157,10158,0,1,0
2884,2,1,10159,10159,10160,0,1,1
2885,3,2,10162,10162,10164,0,2,2
2886,1,2,10163,10164,10166,1,3,0
2887,6,1,10169,10169,10170,0,1,3
2888,4,2,10173,10173,10175,0,2,3
2889,1,2,10174,10175,10177,1,3,0
2890,6,1,10180,10180,10181,0,1,3
2891,4,1,10184,10184,10185,0,1,3
2892,1,3,10185,10185,10188,0,3,0
2893,4,3,10189,10189,10192,0,3,1
2894,1,1,10190,10192,10193,2,3,0
2895,5,3,10195,10195,10198,0,3,2
2896,2,2,10197,10198,10200,1,3,0
2897,2,3,10199,10200,10203,1,4,0
2898,6,2,10205,10205,10207,0,2,2
2899,2,3,10207,10207,10210,0,3,0
2900,3,1,10210,10210,10211,0,1,0
2901,2,1,10212,10212,10213,0,1,1
2902,5,2,10217,10217,10219,0,2,4
2903,4,2,10221,10221,10223,0,2,2
2904,4,1,10225,10225,10226,0,1,2
2905,1,2,10226,10226,10228,0,2,0
2906,4,1,10230,10230,10231,0,1,2
2907,2,1,10232,10232,10233,0,1,1
2908,3,3,10235,10235,10238,0,3,2
2909,1,2,10236,10238,10240,2,4,0
2910,2,3,10238,10240,10243,2,5,0
2911,3,3,10241,10243,10246,2,5,0
2912,6,3,10247,10247,10250,0,3,1
2913,3,3,10250,10250,10253,0,3,0
2914,2,2,10252,10253,10255,1,3,0
2915,5,3,10257,10257,10260,0,3,2
2916,1,2,10258,10260,10262,2,4,0
2917,4,1,10262,10262,10263,0,1,0
2918,3,3,10265,10265,10268,0,3,2
2919,3,1,10268,10268,10269,0,1,0
2920,4,1,10272,10272,10273,0,1,3
2921,3,1,10275,10275,10276,0,1,2
2922,5,2,10280,10280,10282,0,2,4
2923,4,1,10284,10284,10285,0,1,2
2924,6,2,10290,10290,10292,0,2,5
2925,4,3,10294,10294,10297,0,3,2
2926,5,2,10299,10299,10301,0,2,2
2927,4,1,10303,10303,10304,0,1,2
2928,3,2,10306,10306,10308,0,2,2
2929,4,3,10310,10310,10313,0,3,2
2930,4,2,10314,10314,10316,0,2,1
2931,3,3,10317,10317,10320,0,3,1
2932,4,2,10321,10321,10323,0,2,1
2933,4,3,10325,10325,10328,0,3,2
2934,1,1,10326,10328,10329,2,3,0
2935,3,2,10329,10329,10331,0,2,0
2936,5,2,10334,10334,10336,0,2,3
2937,5,1,10339,10339,10340,0,1,3
2938,4,2,10343,10343,10345,0,2,3
2939,4,1,10347,10347,10348,0,1,2
2940,3,3,10350,10350,10353,0,3,2
2941,2,3,10352,10353,10356,1,4,0
2942,2,2,10354,10356,10358,2,4,0
2943,6,2,10360,10360,10362,0,2,2
2944,2,1,10362,10362,10363,0,1,0
2945,2,1,10364,10364,10365,0,1,1
2946,5,3,10369,10369,10372,0,3,4
2947,1,2,10370,10372,10374,2,4,0
2948,5,2,10375,10375,10377,0,2,1
2949,1,2,10376,10377,10379,1,3,0
2950,5,2,10381,10381,10383,0,2,2
2951,1,1,10382,10383,10384,1,2,0
2952,1,1,10383,10384,10385,1,2,0
2953,2,2,10385,10385,10387,0,2,0
2954,5,3,10390,10390,10393,0,3,3
2955,6,2,10396,10396,10398,0,2,3
2956,5,2,10401,10401,10403,0,2,3
2957,5,2,10406,10406,10408,0,2,3
2958,6,3,10412,10412,10415,0,3,4
2959,2,2,10414,10415,10417,1,3,0
2960,2,1,10416,10417,10418,1,2,0
2961,2,1,10418,10418,10419,0,1,0
2962,5,3,10423,10423,10426,0,3,4
2963,1,2,10424,10426,10428,2,4,0
2964,4,2,10428,10428,10430,0,2,0
2965,2,3,10430,10430,10433,0,3,0
2966,2,3,10432,10433,10436,1,4,0
2967,5,2,10437,10437,10439,0,2,1
2968,4,3,10441,10441,10444,0,3,2
2969,4,1,10445,10445,10446,0,1,1
2970,1,1,10446,10446,10447,0,1,0
2971,5,1,10451,10451,10452,0,1,4
2972,4,1,10455,10455,10456,0,1,3
2973,2,3,10457,10457,10460,0,3,1
2974,5,2,10462,10462,10464,0,2,2
2975,4,3,10466,10466,10469,0,3,2
2976,1,1,10467,10469,10470,2,3,0
2977,2,3,10469,10470,10473,1,4,0
2978,6,3,10475,10475,10478,0,3,2
2979,2,1,10477,10478,10479,1,2,0
2980,2,2,10479,10479,10481,0,2,0
2981,6,1,10485,10485,10486,0,1,4
2982,5,3,10490,10490,10493,0,3,4
2983,1,1,10491,10493,10494,2,3,0
2984,2,2,10493,10494,10496,1,3,0
2985,6,3,10499,10499,10502,0,3,3
2986,2,3,10501,10502,10505,1,4,0
2987,1,2,10502,10505,10507,3,5,0
2988,6,1,10508,10508,10509,0,1,1
2989,2,2,10510,10510,10512,0,2,1
2990,6,3,10516,10516,10519,0,3,4
2991,6,2,10522,10522,10524,0,2,3
2992,2,3,10524,10524,10527,0,3,0
2993,3,1,10527,10527,10528,0,1,0
2994,5,1,10532,10532,10533,0,1,4
2995,6,3,10538,10538,10541,0,3,5
2996,2,2,10540,10541,10543,1,3,0
2997,3,1,10543,10543,10544,0,1,0
2998,2,2,10545,10545,10547,0,2,1
2999,4,3,10549,10549,10552,0,3,2
3000,5,3,10554,10554,10557,0,3,2
3001,3,3,10557,10557,10560,0,3,0
3002,5,1,10562,10562,10563,0,1,2
3003,5,2,10567,10567,10569,0,2,4
3004,1,3,10568,10569,10572,1,4,0
3005,2,1,10570,10572,10573,2,3,0
3006,2,2,10572,10573,10575,1,3,0
3007,6,3,10578,10578,10581,0,3,3
3008,1,3,10579,10581,10584,2,5,0
3009,3,1,10582,10584,10585,2,3,0
3010,4,1,10586,10586,10587,0,1,1
3011,2,1,10588,10588,10589,0,1,1
3012,4,3,10592,10592,10595,0,3,3
3013,4,1,10596,10596,10597,0,1,1
3014,6,3,10602,10602,10605,0,3,5
3015,5,1,10607,10607,10608,0,1,2
3016,2,3,10609,10609,10612,0,3,1
3017,4,1,10613,10613,10614,0,1,1
3018,5,3,10618,10618,10621,0,3,4
3019,1,2,10619,10621,10623,2,4,0
3020,4,2,10623,10623,10625,0,2,0
3021,1,3,10624,10625,10628,1,4,0
3022,2,1,10626,10628,10629,2,3,0
3023,2,3,10628,10629,10632,1,4,0
3024,5,3,10633,10633,10636,0,3,1
3025,1,3,10634,10636,10639,2,5,0
3026,5,1,10639,10639,10640,0,1,0
3027,6,2,10645,10645,10647,0,2,5
3028,6,1,10651,10651,10652,0,1,4
3029,2,3,10653,10653,10656,0,3,1
3030,4,1,10657,10657,10658,0,1,1
3031,3,3,10660,10660,10663,0,3,2
3032,4,2,10664,10664,10666,0,2,1
3033,4,2,10668,10668,10670,0,2,2
3034,1,2,10669,10670,10672,1,3,0
3035,1,3,10670,10672,10675,2,5,0
3036,4,3,10674,10675,10678,1,4,0
3037,5,2,10679,10679,10681,0,2,1
3038,4,3,10683,10683,10686,0,3,2
3039,2,3,10685,10686,10689,1,4,0
3040,5,2,10690,10690,10692,0,2,1
3041,5,3,10695,10695,10698,0,3,3
3042,1,2,10696,10698,10700,2,4,0
3043,1,1,10697,10700,10701,3,4,0
3044,2,2,10699,10701,10703,2,4,0
3045,1,1,10700,10703,10704,3,4,0
3046,4,1,10704,10704,10705,0,1,0
3047,2,3,10706,10706,10709,0,3,1
3048,3,1,10709,10709,10710,0,1,0
3049,4,3,10713,10713,10716,0,3,3
3050,1,2,10714,10716,10718,2,4,0
3051,3,3,10717,10718,10721,1,4,0
3052,3,1,10720,10721,10722,1,2,0
3053,5,3,10725,10725,10728,0,3,3
3054,1,3,10726,10728,10731,2,5,0
3055,6,3,10732,10732,10735,0,3,1
3056,5,3,10737,10737,10740,0,3,2
3057,5,2,10742,10742,10744,0,2,2
3058,1,1,10743,10744,10745,1,2,0
3059,2,1,10745,10745,10746,0,1,0
3060,4,2,10749,10749,10751,0,2,3
3061,6,3,10755,10755,10758,0,3,4
3062,3,2,10758,10758,10760,0,2,0
3063,5,3,10763,10763,10766,0,3,3
3064,1,1,10764,10766,10767,2,3,0
3065,3,3,10767,10767,10770,0,3,0
3066,2,3,10769,10770,10773,1,4,0
3067,3,3,10772,10773,10776,1,4,0
3068,3,2,10775,10776,10778,1,3,0
3069,2,1,10777,10778,10779,1,2,0
3070,3,3,10780,10780,10783,0,3,1
3071,3,1,10783,10783,10784,0,1,0
3072,6,3,10789,10789,10792,0,3,5
3073,1,2,10790,10792,10794,2,4,0
3074,2,2,10792,10794,10796,2,4,0
3075,6,2,10798,10798,10800,0,2,2
3076,6,1,10804,10804,10805,0,1,4
3077,1,1,10805,10805,10806,0,1,0
3078,3,3,10808,10808,10811,0,3,2
3079,6,2,10814,10814,10816,0,2,3
3080,5,3,10819,10819,10822,0,3,3
3081,6,2,10825,10825,10827,0,2,3
3082,1,2,10826,10827,10829,1,3,0
3083,4,3,10830,10830,10833,0,3,1
3084,1,2,10831,10833,10835,2,4,0
3085,4,3,10835,10835,10838,0,3,0
3086,4,3,10839,10839,10842,0,3,1
3087,6,1,10845,10845,10846,0,1,3
3088,1,2,10846,10846,10848,0,2,0
3089,3,3,10849,10849,10852,0,3,1
3090,3,2,10852,10852,10854,0,2,0
3091,1,2,10853,10854,10856,1,3,0
3092,5,1,10858,10858,10859,0,1,2
3093,2,3,10860,10860,10863,0,3,1
3094,2,1,10862,10863,10864,1,2,0
3095,6,2,10868,10868,10870,0,2,4
3096,2,3,10870,10870,10873,0,3,0
3097,4,2,10874,10874,10876,0,2,1
3098,2,3,10876,10876,10879,0,3,0
3099,4,2,10880,10880,10882,0,2,1
3100,6,1,10886,10886,10887,0,1,4
3101,5,2,10891,10891,10893,0,2,4
3102,1,3,10892,10893,10896,1,4,0
3103,4,2,10896,10896,10898,0,2,0
3104,2,3,10898,10898,10901,0,3,0
3105,3,3,10901,10901,10904,0,3,0
3106,3,1,10904,10904,10905,0,1,0
3107,5,3,10909,10909,10912,0,3,4
3108,2,3,10911,10912,10915,1,4,0
3109,6,1,10917,10917,10918,0,1,2
3110,5,2,10922,10922,10924,0,2,4
3111,6,3,10928,10928,10931,0,3,4
3112,6,2,10934,10934,10936,0,2,3
3113,3,2,10937,10937,10939,0,2,1
3114,5,2,10942,10942,10944,0,2,3
3115,5,1,10947,10947,10948,0,1,3
3116,5,2,10952,10952,10954,0,2,4
3117,6,2,10958,10958,10960,0,2,4
3118,1,1,10959,10960,10961,1,2,0
3119,6,1,10965,10965,10966,0,1,4
3120,5,3,10970,10970,10973,0,3,4
3121,2,1,10972,10973,10974,1,2,0
3122,2,2,10974,10974,10976,0,2,0
3123,1,3,10975,10976,10979,1,4,0
3124,4,3,10979,10979,10982,0,3,0
3125,6,2,10985,10985,10987,0,2,3
3126,4,1,10989,10989,10990,0,1,2
3127,1,3,10990,10990,10993,0,3,0
3128,3,2,10993,10993,10995,0,2,0
3129,2,1,10995,10995,10996,0,1,0
3130,2,1,10997,10997,10998,0,1,1
3131,6,2,11003,11003,11005,0,2,5
3132,4,3,11007,11007,11010,0,3,2
3133,5,1,11012,11012,11013,0,1,2
3134,3,2,11015,11015,11017,0,2,2
3135,2,3,11017,11017,11020,0,3,0
3136,3,1,11020,11020,11021,0,1,0
3137,1,2,11021,11021,11023,0,2,0
3138,2,2,11023,11023,11025,0,2,0
3139,6,2,11029,11029,11031,0,2,4
3140,6,2,11035,11035,11037,0,2,4
3141,1,1,11036,11037,11038,1,2,0
3142,6,3,11042,11042,11045,0,3,4
3143,4,2,11046,11046,11048,0,2,1
3144,3,2,11049,11049,11051,0,2,1
3145,2,3,11051,11051,11054,0,3,0
3146,6,2,11057,11057,11059,0,2,3
3147,5,3,11062,11062,11065,0,3,3
3148,6,2,11068,11068,11070,0,2,3
3149,1,3,11069,11070,11073,1,4,0
3150,4,3,11073,11073,11076,0,3,0
3151,2,2,11075,11076,11078,1,3,0
3152,6,3,11081,11081,11084,0,3,3
3153,6,3,11087,11087,11090,0,3,3
3154,4,3,11091,11091,11094,0,3,1
3155,2,2,11093,11094,11096,1,3,0
3156,1,1,11094,11096,11097,2,3,0
3157,3,3,11097,11097,11100,0,3,0
3158,5,2,11102,11102,11104,0,2,2
3159,5,3,11107,11107,11110,0,3,3
3160,2,1,11109,11110,11111,1,2,0
3161,6,3,11115,11115,11118,0,3,4
3162,5,2,11120,11120,11122,0,2,2
3163,1,1,11121,11122,11123,1,2,0
3164,4,2,11125,11125,11127,0,2,2
3165,2,1,11127,11127,11128,0,1,0
3166,1,2,11128,11128,11130,0,2,0
3167,4,3,11132,11132,11135,0,3,2
3168,3,1,11135,11135,11136,0,1,0
3169,5,3,11140,11140,11143,0,3,4
3170,4,1,11144,11144,11145,0,1,1
3171,5,1,11149,11149,11150,0,1,4
3172,2,1,11151,11151,11152,0,1,1
3173,6,3,11157,11157,11160,0,3,5
3174,4,2,11161,11161,11163,0,2,1
3175,4,1,11165,11165,11166,0,1,2
3176,6,3,11171,11171,11174,0,3,5
3177,5,3,11176,11176,11179,0,3,2
3178,6,1,11182,11182,11183,0,1,3
3179,6,1,11188,11188,11189,0,1,5
3180,2,3,11190,11190,11193,0,3,1
3181,2,3,11192,11193,11196,1,4,0
3182,3,3,11195,11196,11199,1,4,0
3183,2,2,11197,11199,11201,2,4,0
3184,6,1,11203,11203,11204,0,1,2
3185,5,1,11208,11208,11209,0,1,4
3186,1,2,11209,11209,11211,0,2,0
3187,1,1,11210,11211,11212,1,2,0
3188,1,2,11211,11212,11214,1,3,0
3189,1,3,11212,11214,11217,2,5,0
3190,3,3,11215,11217,11220,2,5,0
3191,2,1,11217,11220,11221,3,4,0
3192,1,2,11218,11221,11223,3,5,0
3193,5,2,11223,11223,11225,0,2,0
3194,1,3,11224,11225,11228,1,4,0
3195,6,1,11230,11230,11231,0,1,2
3196,6,2,11236,11236,11238,0,2,5
3197,5,1,11241,11241,11242,0,1,3
3198,4,2,11245,11245,11247,0,2,3
3199,6,3,11251,11251,11254,0,3,4
3200,1,1,11252,11254,11255,2,3,0
3201,4,1,11256,11256,11257,0,1,1
3202,3,2,11259,11259,11261,0,2,2
3203,1,1,11260,11261,11262,1,2,0
3204,3,1,11263,11263,11264,0,1,1
3205,6,1,11269,11269,11270,0,1,5
3206,2,1,11271,11271,11272,0,1,1
3207,6,3,11277,11277,11280,0,3,5
3208,1,3,11278,11280,11283,2,5,0
3209,3,3,11281,11283,11286,2,5,0
3210,6,1,11287,11287,11288,0,1,1
3211,3,2,11290,11290,11292,0,2,2
3212,5,1,11295,11295,11296,0,1,3
3213,6,1,11301,11301,11302,0,1,5
3214,4,3,11305,11305,11308,0,3,3
3215,2,1,11307,11308,11309,1,2,0
3216,4,2,11311,11311,11313,0,2,2
3217,1,2,11312,11313,11315,1,3,0
3218,1,3,11313,11315,11318,2,5,0
3219,4,3,11317,11318,11321,1,4,0
3220,5,1,11322,11322,11323,0,1,1
3221,2,1,11324,11324,11325,0,1,1
3222,1,2,11325,11325,11327,0,2,0
3223,4,3,11329,11329,11332,0,3,2
3224,5,3,11334,11334,11337,0,3,2
3225,3,2,11337,11337,11339,0,2,0
3226,6,1,11343,11343,11344,0,1,4
3227,2,3,11345,11345,11348,0,3,1
3228,5,2,11350,11350,11352,0,2,2
3229,4,3,11354,11354,11357,0,3,2
3230,5,1,11359,11359,11360,0,1,2
3231,2,1,11361,11361,11362,0,1,1
3232,3,1,11364,11364,11365,0,1,2
3233,3,1,11367,11367,11368,0,1,2
3234,1,1,11368,11368,11369,0,1,0
3235,5,3,11373,11373,11376,0,3,4
3236,5,3,11378,11378,11381,0,3,2
3237,4,3,11382,11382,11385,0,3,1
3238,5,1,11387,11387,11388,0,1,2
3239,5,3,11392,11392,11395,0,3,4
3240,1,2,11393,11395,11397,2,4,0
3241,4,3,11397,11397,11400,0,3,0
3242,6,2,11403,11403,11405,0,2,3
3243,5,2,11408,11408,11410,0,2,3
3244,2,3,11410,11410,11413,0,3,0
3245,6,2,11416,11416,11418,0,2,3
3246,2,1,11418,11418,11419,0,1,0
3247,5,1,11423,11423,11424,0,1,4
3248,1,2,11424,11424,11426,0,2,0
3249,1,2,11425,11426,11428,1,3,0
3250,6,2,11431,11431,11433,0,2,3
3251,1,2,11432,11433,11435,1,3,0
3252,1,2,11433,11435,11437,2,4,0
3253,5,1,11438,11438,11439,0,1,1
3254,6,3,11444,11444,11447,0,3,5
3255,4,2,11448,11448,11450,0,2,1
3256,1,1,11449,11450,11451,1,2,0
3257,3,2,11452,11452,11454,0,2,1
3258,6,1,11458,11458,11459,0,1,4
3259,5,3,11463,11463,11466,0,3,4
3260,4,1,11467,11467,11468,0,1,1
3261,3,1,11470,11470,11471,0,1,2
3262,3,1,11473,11473,11474,0,1,2
3263,4,1,11477,11477,11478,0,1,3
3264,6,2,11483,11483,11485,0,2,5
3265,4,3,11487,11487,11490,0,3,2
3266,1,1,11488,11490,11491,2,3,0
3267,3,2,11491,11491,11493,0,2,0
3268,3,2,11494,11494,11496,0,2,1
3269,1,2,11495,11496,11498,1,3,0
3270,6,2,11501,11501,11503,0,2,3
3271,4,3,11505,11505,11508,0,3,2
3272,5,1,11510,11510,11511,0,1,2
3273,3,2,11513,11513,11515,0,2,2
3274,2,3,11515,11515,11518,0,3,0
3275,5,3,11520,11520,11523,0,3,2
3276,6,3,11526,11526,11529,0,3,3
3277,2,3,11528,11529,11532,1,4,0
3278,6,2,11534,11534,11536,0,2,2
3279,2,1,11536,11536,11537,0,1,0
3280,4,3,11540,11540,11543,0,3,3
3281,3,1,11543,11543,11544,0,1,0
3282,3,1,11546,11546,11547,0,1,2
3283,3,1,11549,11549,11550,0,1,2
3284,2,1,11551,11551,11552,0,1,1
3285,6,2,11557,11557,11559,0,2,5
3286,3,2,11560,11560,11562,0,2,1
3287,6,3,11566,11566,11569,0,3,4
3288,6,3,11572,11572,11575,0,3,3
3289,5,1,11577,11577,11578,0,1,2
3290,5,3,11582,11582,11585,0,3,4
3291,2,3,11584,11585,11588,1,4,0
3292,6,2,11590,11590,11592,0,2,2
3293,3,1,11593,11593,11594,0,1,1
3294,4,2,11597,11597,11599,0,2,3
3295,6,3,11603,11603,11606,0,3,4
3296,1,1,11604,11606,11607,2,3,0
3297,4,2,11608,11608,11610,0,2,1
3298,4,1,11612,11612,11613,0,1,2
3299,5,3,11617,11617,11620,0,3,4
3300,2,3,11619,11620,11623,1,4,0
3301,6,2,11625,11625,11627,0,2,2
3302,2,1,11627,11627,11628,0,1,0
3303,1,1,11628,11628,11629,0,1,0
3304,2,3,11630,11630,11633,0,3,1
3305,2,1,11632,11633,11634,1,2,0
3306,6,2,11638,11638,11640,0,2,4
3307,1,2,11639,11640,11642,1,3,0
3308,5,3,11644,11644,11647,0,3,2
3309,5,2,11649,11649,11651,0,2,2
3310,5,2,11654,11654,11656,0,2,3
3311,3,1,11657,11657,11658,0,1,1
3312,5,3,11662,11662,11665,0,3,4
3313,3,3,11665,11665,11668,0,3,0
3314,6,1,11671,11671,11672,0,1,3
3315,4,1,11675,11675,11676,0,1,3
3316,4,2,11679,11679,11681,0,2,3
3317,2,1,11681,11681,11682,0,1,0
3318,2,1,11683,11683,11684,0,1,1
3319,2,2,11685,11685,11687,0,2,1
3320,5,1,11690,11690,11691,0,1,3
3321,2,3,11692,11692,11695,0,3,1
3322,2,2,11694,11695,11697,1,3,0
3323,4,2,11698,11698,11700,0,2,1
3324,5,1,11703,11703,11704,0,1,3
3325,6,2,11709,11709,11711,0,2,5
3326,1,1,11710,11711,11712,1,2,0
3327,6,1,11716,11716,11717,0,1,4
3328,6,3,11722,11722,11725,0,3,5
3329,3,3,11725,11725,11728,0,3,0
3330,2,1,11727,11728,11729,1,2,0
3331,2,3,11729,11729,11732,0,3,0
3332,1,3,11730,11732,11735,2,5,0
3333,1,2,11731,11735,11737,4,6,0
3334,6,2,11737,11737,11739,0,2,0
3335,1,2,11738,11739,11741,1,3,0
3336,1,1,11739,11741,11742,2,3,0
3337,3,1,11742,11742,11743,0,1,0
3338,3,2,11745,11745,11747,0,2,2
3339,2,3,11747,11747,11750,0,3,0
3340,4,3,11751,11751,11754,0,3,1
3341,1,1,11752,11754,11755,2,3,0
3342,2,1,11754,11755,11756,1,2,0
3343,6,1,11760,11760,11761,0,1,4
3344,2,2,11762,11762,11764,0,2,1
3345,2,2,11764,11764,11766,0,2,0
3346,2,2,11766,11766,11768,0,2,0
3347,5,3,11771,11771,11774,0,3,3
3348,6,2,11777,11777,11779,0,2,3
3349,6,3,11783,11783,11786,0,3,4
3350,3,1,11786,11786,11787,0,1,0
3351,6,1,11792,11792,11793,0,1,5
3352,5,2,11797,11797,11799,0,2,4
3353,2,1,11799,11799,11800,0,1,0
3354,1,1,11800,11800,11801,0,1,0
3355,2,1,11802,11802,11803,0,1,1
3356,6,2,11808,11808,11810,0,2,5
3357,3,3,11811,11811,11814,0,3,1
3358,3,3,11814,11814,11817,0,3,0
3359,4,1,11818,11818,11819,0,1,1
3360,3,1,11821,11821,11822,0,1,2
3361,1,1,11822,11822,11823,0,1,0
3362,6,2,11828,11828,11830,0,2,5
3363,3,2,11831,11831,11833,0,2,1
3364,2,1,11833,11833,11834,0,1,0
3365,1,2,11834,11834,11836,0,2,0
3366,2,2,11836,11836,11838,0,2,0
3367,6,3,11842,11842,11845,0,3,4
3368,5,3,11847,11847,11850,0,3,2
3369,6,1,11853,11853,11854,0,1,3
3370,4,3,11857,11857,11860,0,3,3
3371,1,2,11858,11860,11862,2,4,0
3372,1,3,11859,11862,11865,3,6,0
3373,2,3,11861,11865,11868,4,7,0
3374,3,3,11864,11868,11871,4,7,0
3375,3,3,11867,11871,11874,4,7,0
3376,4,1,11871,11874,11875,3,4,0
3377,5,1,11876,11876,11877,0,1,1
3378,3,1,11879,11879,11880,0,1,2
3379,4,1,11883,11883,11884,0,1,3
3380,6,1,11889,11889,11890,0,1,5
3381,4,1,11893,11893,11894,0,1,3
3382,6,3,11899,11899,11902,0,3,5
3383,4,2,11903,11903,11905,0,2,1
3384,1,2,11904,11905,11907,1,3,0
3385,6,1,11910,11910,11911,0,1,3
3386,6,1,11916,11916,11917,0,1,5
3387,6,2,11922,11922,11924,0,2,5
3388,4,1,11926,11926,11927,0,1,2
3389,5,1,11931,11931,11932,0,1,4
3390,2,1,11933,11933,11934,0,1,1
3391,6,3,11939,11939,11942,0,3,5
3392,2,3,11941,11942,11945,1,4,0
3393,3,1,11944,11945,11946,1,2,0
3394,4,2,11948,11948,11950,0,2,2
3395,1,3,11949,11950,11953,1,4,0
3396,1,3,11950,11953,11956,3,6,0
3397,6,2,11956,11956,11958,0,2,0
3398,5,3,11961,11961,11964,0,3,3
3399,3,3,11964,11964,11967,0,3,0
3400,2,1,11966,11967,11968,1,2,0
3401,4,2,11970,11970,11972,0,2,2
3402,5,3,11975,11975,11978,0,3,3
3403,4,3,11979,11979,11982,0,3,1
3404,6,2,11985,11985,11987,0,2,3
3405,1,3,11986,11987,11990,1,4,0
3406,5,3,11991,11991,11994,0,3,1
3407,1,2,11992,11994,11996,2,4,0
3408,5,2,11997,11997,11999,0,2,1
3409,1,2,11998,11999,12001,1,3,0
3410,6,2,12004,12004,12006,0,2,3
3411,3,1,12007,12007,12008,0,1,1
3412,6,3,12013,12013,12016,0,3,5
3413,3,1,12016,12016,12017,0,1,0
3414,6,3,12022,12022,12025,0,3,5
3415,3,3,12025,12025,12028,0,3,0
3416,6,1,12031,12031,12032,0,1,3
3417,4,3,12035,12035,12038,0,3,3
3418,5,1,12040,12040,12041,0,1,2
3419,3,2,12043,12043,12045,0,2,2
3420,6,1,12049,12049,12050,0,1,4
3421,1,3,12050,12050,12053,0,3,0
3422,1,3,12051,12053,12056,2,5,0
3423,5,2,12056,12056,12058,0,2,0
3424,4,3,12060,12060,12063,0,3,2
3425,3,1,12063,12063,12064,0,1,0
3426,4,3,12067,12067,12070,0,3,3
3427,1,3,12068,12070,12073,2,5,0
3428,2,2,12070,12073,12075,3,5,0
3429,6,2,12076,12076,12078,0,2,1
3430,4,3,12080,12080,12083,0,3,2
3431,4,1,12084,12084,12085,0,1,1
3432,6,2,12090,12090,12092,0,2,5
3433,5,3,12095,12095,12098,0,3,3
3434,4,1,12099,12099,12100,0,1,1
3435,4,1,12103,12103,12104,0,1,3
3436,4,1,12107,12107,12108,0,1,3
3437,4,1,12111,12111,12112,0,1,3
3438,5,2,12116,12116,12118,0,2,4
3439,4,2,12120,12120,12122,0,2,2
3440,5,1,12125,12125,12126,0,1,3
3441,3,3,12128,12128,12131,0,3,2
3442,2,2,12130,12131,12133,1,3,0
3443,4,2,12134,12134,12136,0,2,1
3444,3,2,12137,12137,12139,0,2,1
3445,3,3,12140,12140,12143,0,3,1
3446,1,1,12141,12143,12144,2,3,0
3447,5,3,12146,12146,12149,0,3,2
3448,6,2,12152,12152,12154,0,2,3
3449,1,2,12153,12154,12156,1,3,0
3450,6,3,12159,12159,12162,0,3,3
3451,6,1,12165,12165,12166,0,1,3
3452,6,1,12171,12171,12172,0,1,5
3453,2,3,12173,12173,12176,0,3,1
3454,6,1,12179,12179,12180,0,1,3
3455,1,1,12180,12180,12181,0,1,0
3456,2,2,12182,12182,12184,0,2,1
3457,3,1,12185,12185,12186,0,1,1
3458,1,2,12186,12186,12188,0,2,0
3459,3,2,12189,12189,12191,0,2,1
3460,1,3,12190,12191,12194,1,4,0
3461,1,2,12191,12194,12196,3,5,0
3462,1,3,12192,12196,12199,4,7,0
3463,4,2,12196,12199,12201,3,5,0
3464,4,2,12200,12201,12203,1,3,0
3465,3,3,12203,12203,12206,0,3,0
3466,5,1,12208,12208,12209,0,1,2
3467,1,2,12209,12209,12211,0,2,0
3468,3,3,12212,12212,12215,0,3,1
3469,2,2,12214,12215,12217,1,3,0
3470,2,2,12216,12217,12219,1,3,0
3471,4,3,12220,12220,12223,0,3,1
3472,5,2,12225,12225,12227,0,2,2
3473,3,1,12228,12228,12229,0,1,1
3474,1,1,12229,12229,12230,0,1,0
3475,4,2,12233,12233,12235,0,2,3
3476,2,2,12235,12235,12237,0,2,0
3477,2,3,12237,12237,12240,0,3,0
3478,4,1,12241,12241,12242,0,1,1
3479,2,1,12243,12243,12244,0,1,1
3480,5,2,12248,12248,12250,0,2,4
3481,5,2,12253,12253,12255,0,2,3
3482,3,3,12256,12256,12259,0,3,1
3483,2,3,12258,12259,12262,1,4,0
3484,2,1,12260,12262,12263,2,3,0
3485,5,3,12265,12265,12268,0,3,2
3486,3,3,12268,12268,12271,0,3,0
3487,3,1,12271,12271,12272,0,1,0
3488,2,1,12273,12273,12274,0,1,1
3489,4,2,12277,12277,12279,0,2,3
3490,3,2,12280,12280,12282,0,2,1
3491,6,3,12286,12286,12289,0,3,4
3492,3,2,12289,12289,12291,0,2,0
3493,4,1,12293,12293,12294,0,1,2
3494,4,3,12297,12297,12300,0,3,3
3495,6,3,12303,12303,12306,0,3,3
3496,2,1,12305,12306,12307,1,2,0
3497,3,1,12308,12308,12309,0,1,1
3498,1,1,12309,12309,12310,0,1,0
3499,1,2,12310,12310,12312,0,2,0
3500,4,1,12314,12314,12315,0,1,2
3501,1,3,12315,12315,12318,0,3,0
3502,2,1,12317,12318,12319,1,2,0
3503,3,3,12320,12320,12323,0,3,1
3504,4,3,12324,12324,12327,0,3,1
3505,4,2,12328,12328,12330,0,2,1
3506,2,2,12330,12330,12332,0,2,0
3507,4,3,12334,12334,12337,0,3,2
3508,5,3,12339,12339,12342,0,3,2
3509,6,3,12345,12345,12348,0,3,3
3510,3,3,12348,12348,12351,0,3,0
3511,6,2,12354,12354,12356,0,2,3
3512,4,3,12358,12358,12361,0,3,2
3513,5,2,12363,12363,12365,0,2,2
3514,6,2,12369,12369,12371,0,2,4
3515,6,2,12375,12375,12377,0,2,4
3516,6,1,12381,12381,12382,0,1,4
3517,6,1,12387,12387,12388,0,1,5
3518,3,1,12390,12390,12391,0,1,2
3519,2,2,12392,12392,12394,0,2,1
3520,4,3,12396,12396,12399,0,3,2
3521,1,3,12397,12399,12402,2,5,0
3522,4,2,12401,12402,12404,1,3,0
3523,6,2,12407,12407,12409,0,2,3
3524,4,2,12411,12411,12413,0,2,2
3525,1,2,12412,12413,12415,1,3,0
3526,5,3,12417,12417,12420,0,3,2
3527,4,2,12421,12421,12423,0,2,1
3528,1,2,12422,12423,12425,1,3,0
3529,6,1,12428,12428,12429,0,1,3
3530,4,3,12432,12432,12435,0,3,3
3531,5,1,12437,12437,12438,0,1,2
3532,3,2,12440,12440,12442,0,2,2
3533,3,1,12443,12443,12444,0,1,1
3534,2,2,12445,12445,12447,0,2,1
3535,6,2,12451,12451,12453,0,2,4
3536,6,3,12457,12457,12460,0,3,4
3537,1,1,12458,12460,12461,2,3,0
3538,1,1,12459,12461,12462,2,3,0
3539,2,2,12461,12462,12464,1,3,0
3540,5,1,12466,12466,12467,0,1,2
3541,5,3,12471,12471,12474,0,3,4
3542,3,2,12474,12474,12476,0,2,0
3543,5,1,12479,12479,12480,0,1,3
3544,1,1,12480,12480,12481,0,1,0
3545,3,3,12483,12483,12486,0,3,2
3546,2,2,12485,12486,12488,1,3,0
3547,5,2,12490,12490,12492,0,2,2
3548,1,3,12491,12492,12495,1,4,0
3549,6,2,12497,12497,12499,0,2,2
3550,1,3,12498,12499,12502,1,4,0
3551,5,2,12503,12503,12505,0,2,1
3552,4,1,12507,12507,12508,0,1,2
3553,2,2,12509,12509,12511,0,2,1
3554,4,1,12513,12513,12514,0,1,2
3555,1,2,12514,12514,12516,0,2,0
3556,5,2,12519,12519,12521,0,2,3
3557,5,1,12524,12524,12525,0,1,3
3558,6,2,12530,12530,12532,0,2,5
3559,5,1,12535,12535,12536,0,1,3
3560,6,3,12541,12541,12544,0,3,5
3561,2,3,12543,12544,12547,1,4,0
3562,3,1,12546,12547,12548,1,2,0
3563,6,3,12552,12552,12555,0,3,4
3564,5,2,12557,12557,12559,0,2,2
3565,3,3,12560,12560,12563,0,3,1
3566,3,2,12563,12563,12565,0,2,0
3567,5,1,12568,12568,12569,0,1,3
3568,2,2,12570,12570,12572,0,2,1
3569,3,2,12573,12573,12575,0,2,1
3570,2,2,12575,12575,12577,0,2,0
3571,4,1,12579,12579,12580,0,1,2
3572,1,1,12580,12580,12581,0,1,0
3573,6,1,12586,12586,12587,0,1,5
3574,5,1,12591,12591,12592,0,1,4
3575,6,1,12597,12597,12598,0,1,5
3576,5,3,12602,12602,12605,0,3,4
3577,6,1,12608,12608,12609,0,1,3
3578,5,1,12613,12613,12614,0,1,4
3579,5,3,12618,12618,12621,0,3,4
3580,4,3,12622,12622,12625,0,3,1
3581,4,2,12626,12626,12628,0,2,1
3582,2,1,12628,12628,12629,0,1,0
3583,3,1,12631,12631,12632,0,1,2
3584,3,2,12634,12634,12636,0,2,2
3585,3,3,12637,12637,12640,0,3,1
3586,3,1,12640,12640,12641,0,1,0
3587,5,1,12645,12645,12646,0,1,4
3588,5,1,12650,12650,12651,0,1,4
3589,3,2,12653,12653,12655,0,2,2
3590,6,1,12659,12659,12660,0,1,4
3591,1,1,12660,12660,12661,0,1,0
3592,2,2,12662,12662,12664,0,2,1
3593,4,1,12666,12666,12667,0,1,2
3594,6,1,12672,12672,12673,0,1,5
3595,2,3,12674,12674,12677,0,3,1
3596,4,3,12678,12678,12681,0,3,1
3597,6,1,12684,12684,12685,0,1,3
3598,4,3,12688,12688,12691,0,3,3
3599,3,1,12691,12691,12692,0,1,0
3600,1,1,12692,12692,12693,0,1,0
3601,4,2,12696,12696,12698,0,2,3
3602,3,2,12699,12699,12701,0,2,1
3603,1,1,12700,12701,12702,1,2,0
3604,6,2,12706,12706,12708,0,2,4
3605,3,3,12709,12709,12712,0,3,1
3606,3,3,12712,12712,12715,0,3,0
3607,6,3,12718,12718,12721,0,3,3
3608,2,3,12720,12721,12724,1,4,0
3609,6,3,12726,12726,12729,0,3,2
3610,1,2,12727,12729,12731,2,4,0
3611,3,3,12730,12731,12734,1,4,0
3612,2,1,12732,12734,12735,2,3,0
3613,3,1,12735,12735,12736,0,1,0
3614,5,2,12740,12740,12742,0,2,4
3615,6,2,12746,12746,12748,0,2,4
3616,1,3,12747,12748,12751,1,4,0
3617,6,2,12753,12753,12755,0,2,2
3618,4,3,12757,12757,12760,0,3,2
3619,3,2,12760,12760,12762,0,2,0
3620,4,3,12764,12764,12767,0,3,2
3621,5,1,12769,12769,12770,0,1,2
3622,1,1,12770,12770,12771,0,1,0
3623,3,2,12773,12773,12775,0,2,2
3624,3,3,12776,12776,12779,0,3,1
3625,5,2,12781,12781,12783,0,2,2
3626,5,1,12786,12786,12787,0,1,3
3627,6,1,12792,12792,12793,0,1,5
3628,5,3,12797,12797,12800,0,3,4
3629,2,1,12799,12800,12801,1,2,0
3630,2,3,12801,12801,12804,0,3,0
3631,6,2,12807,12807,12809,0,2,3
3632,6,2,12813,12813,12815,0,2,4
3633,1,3,12814,12815,12818,1,4,0
3634,5,2,12819,12819,12821,0,2,1
3635,2,3,12821,12821,12824,0,3,0
3636,4,2,12825,12825,12827,0,2,1
3637,3,2,12828,12828,12830,0,2,1
3638,3,2,12831,12831,12833,0,2,1
3639,2,2,12833,12833,12835,0,2,0
3640,6,1,12839,12839,12840,0,1,4
3641,3,1,12842,12842,12843,0,1,2
3642,4,1,12846,12846,12847,0,1,3
3643,4,2,12850,12850,12852,0,2,3
3644,4,1,12854,12854,12855,0,1,2
3645,1,2,12855,12855,12857,0,2,0
3646,1,2,12856,12857,12859,1,3,0
3647,3,1,12859,12859,12860,0,1,0
3648,4,2,12863,12863,12865,0,2,3
3649,2,3,12865,12865,12868,0,3,0
3650,6,1,12871,12871,12872,0,1,3
3651,5,2,12876,12876,12878,0,2,4
3652,3,1,12879,12879,12880,0,1,1
3653,5,3,12884,12884,12887,0,3,4
3654,4,1,12888,12888,12889,0,1,1
3655,6,1,12894,12894,12895,0,1,5
3656,3,3,12897,12897,12900,0,3,2
3657,4,3,12901,12901,12904,0,3,1
3658,6,2,12907,12907,12909,0,2,3
3659,2,1,12909,12909,12910,0,1,0
3660,2,3,12911,12911,12914,0,3,1
3661,6,1,12917,12917,12918,0,1,3
3662,4,1,12921,12921,12922,0,1,3
3663,3,3,12924,12924,12927,0,3,2
3664,3,2,12927,12927,12929,0,2,0
3665,6,1,12933,12933,12934,0,1,4
3666,3,1,12936,12936,12937,0,1,2
3667,1,3,12937,12937,12940,0,3,0
3668,6,1,12943,12943,12944,0,1,3
3669,6,3,12949,12949,12952,0,3,5
3670,1,3,12950,12952,12955,2,5,0
3671,1,2,12951,12955,12957,4,6,0
3672,5,2,12956,12957,12959,1,3,0
3673,4,3,12960,12960,12963,0,3,1
3674,1,3,12961,12963,12966,2,5,0
3675,2,3,12963,12966,12969,3,6,0
3676,2,1,12965,12969,12970,4,5,0
3677,2,3,12967,12970,12973,3,6,0
3678,6,3,12973,12973,12976,0,3,0
3679,5,2,12978,12978,12980,0,2,2
3680,1,1,12979,12980,12981,1,2,0
3681,4,3,12983,12983,12986,0,3,2
3682,6,3,12989,12989,12992,0,3,3
3683,2,1,12991,12992,12993,1,2,0
3684,5,3,12996,12996,12999,0,3,3
3685,2,1,12998,12999,13000,1,2,0
3686,3,3,13001,13001,13004,0,3,1
3687,6,2,13007,13007,13009,0,2,3
3688,3,1,13010,13010,13011,0,1,1
3689,1,2,13011,13011,13013,0,2,0
3690,6,2,13017,13017,13019,0,2,4
3691,4,1,13021,13021,13022,0,1,2
3692,1,3,13022,13022,13025,0,3,0
3693,2,1,13024,13025,13026,1,2,0
3694,5,2,13029,13029,13031,0,2,3
3695,3,1,13032,13032,13033,0,1,1
3696,1,2,13033,13033,13035,0,2,0
3697,4,2,13037,13037,13039,0,2,2
3698,2,3,13039,13039,13042,0,3,0
3699,3,2,13042,13042,13044,0,2,0
3700,5,3,13047,13047,13050,0,3,3
3701,1,1,13048,13050,13051,2,3,0
3702,6,3,13054,13054,13057,0,3,3
3703,5,1,13059,13059,13060,0,1,2
3704,6,3,13065,13065,13068,0,3,5
3705,2,3,13067,13068,13071,1,4,0
3706,1,3,13068,13071,13074,3,6,0
3707,2,1,13070,13074,13075,4,5,0
3708,6,1,13076,13076,13077,0,1,1
3709,2,3,13078,13078,13081,0,3,1
3710,3,1,13081,13081,13082,0,1,0
3711,4,3,13085,13085,13088,0,3,3
3712,4,2,13089,13089,13091,0,2,1
3713,3,1,13092,13092,13093,0,1,1
3714,3,1,13095,13095,13096,0,1,2
3715,5,3,13100,13100,13103,0,3,4
3716,2,3,13102,13103,13106,1,4,0
3717,3,2,13105,13106,13108,1,3,0
3718,2,1,13107,13108,13109,1,2,0
3719,3,2,13110,13110,13112,0,2,1
3720,6,3,13116,13116,13119,0,3,4
3721,6,3,13122,13122,13125,0,3,3
3722,4,3,13126,13126,13129,0,3,1
3723,5,2,13131,13131,13133,0,2,2
3724,5,3,13136,13136,13139,0,3,3
3725,5,2,13141,13141,13143,0,2,2
3726,3,1,13144,13144,13145,0,1,1
3727,1,2,13145,13145,13147,0,2,0
3728,4,2,13149,13149,13151,0,2,2
3729,3,3,13152,13152,13155,0,3,1
3730,5,1,13157,13157,13158,0,1,2
3731,2,3,13159,13159,13162,0,3,1
3732,3,2,13162,13162,13164,0,2,0
3733,5,1,13167,13167,13168,0,1,3
3734,3,2,13170,13170,13172,0,2,2
3735,2,3,13172,13172,13175,0,3,0
3736,3,1,13175,13175,13176,0,1,0
3737,3,1,13178,13178,13179,0,1,2
3738,1,1,13179,13179,13180,0,1,0
3739,5,1,13184,13184,13185,0,1,4
3740,1,1,13185,13185,13186,0,1,0
3741,4,2,13189,13189,13191,0,2,3
3742,4,3,13193,13193,13196,0,3,2
3743,5,2,13198,13198,13200,0,2,2
3744,6,3,13204,13204,13207,0,3,4
3745,5,3,13209,13209,13212,0,3,2
3746,5,2,13214,13214,13216,0,2,2
3747,3,1,13217,13217,13218,0,1,1
3748,3,3,13220,13220,13223,0,3,2
3749,1,3,13221,13223,13226,2,5,0
3750,6,1,13227,13227,13228,0,1,1
3751,2,2,13229,13229,13231,0,2,1
3752,3,3,13232,13232,13235,0,3,1
3753,4,2,13236,13236,13238,0,2,1
3754,4,3,13240,13240,13243,0,3,2
3755,3,3,13243,13243,13246,0,3,0
3756,5,2,13248,13248,13250,0,2,2
3757,1,2,13249,13250,13252,1,3,0
3758,2,1,13251,13252,13253,1,2,0
3759,5,3,13256,13256,13259,0,3,3
3760,3,1,13259,13259,13260,0,1,0
3761,2,3,13261,13261,13264,0,3,1
3762,1,3,13262,13264,13267,2,5,0
3763,6,1,13268,13268,13269,0,1,1
3764,1,1,13269,13269,13270,0,1,0
3765,1,3,13270,13270,13273,0,3,0
3766,3,3,13273,13273,13276,0,3,0
3767,4,3,13277,13277,13280,0,3,1
3768,4,3,13281,13281,13284,0,3,1
3769,5,3,13286,13286,13289,0,3,2
3770,6,1,13292,13292,13293,0,1,3
3771,6,3,13298,13298,13301,0,3,5
3772,3,3,13301,13301,13304,0,3,0
3773,1,2,13302,13304,13306,2,4,0
3774,3,1,13305,13306,13307,1,2,0
3775,1,1,13306,13307,13308,1,2,0
3776,4,1,13310,13310,13311,0,1,2
3777,1,2,13311,13311,13313,0,2,0
3778,2,3,13313,13313,13316,0,3,0
3779,1,2,13314,13316,13318,2,4,0
3780,3,1,13317,13318,13319,1,2,0
3781,5,2,13322,13322,13324,0,2,3
3782,4,1,13326,13326,13327,0,1,2
3783,1,3,13327,13327,13330,0,3,0
3784,6,2,13333,13333,13335,0,2,3
3785,1,3,13334,13335,13338,1,4,0
3786,5,3,13339,13339,13342,0,3,1
3787,6,1,13345,13345,13346,0,1,3
3788,4,2,13349,13349,13351,0,2,3
3789,3,3,13352,13352,13355,0,3,1
3790,1,1,13353,13355,13356,2,3,0
3791,2,1,13355,13356,13357,1,2,0
3792,5,1,13360,13360,13361,0,1,3
3793,4,2,13364,13364,13366,0,2,3
3794,6,2,13370,13370,13372,0,2,4
3795,3,1,13373,13373,13374,0,1,1
3796,3,2,13376,13376,13378,0,2,2
3797,4,2,13380,13380,13382,0,2,2
3798,1,2,13381,13382,13384,1,3,0
3799,6,1,13387,13387,13388,0,1,3
3800,6,3,13393,13393,13396,0,3,5
3801,6,2,13399,13399,13401,0,2,3
3802,5,2,13404,13404,13406,0,2,3
3803,1,2,13405,13406,13408,1,3,0
3804,1,2,13406,13408,13410,2,4,0
3805,3,3,13409,13410,13413,1,4,0
3806,4,2,13413,13413,13415,0,2,0
3807,1,3,13414,13415,13418,1,4,0
3808,5,2,13419,13419,13421,0,2,1
3809,5,3,13424,13424,13427,0,3,3
3810,6,1,13430,13430,13431,0,1,3
3811,4,2,13434,13434,13436,0,2,3
3812,3,2,13437,13437,13439,0,2,1
3813,5,3,13442,13442,13445,0,3,3
3814,6,1,13448,13448,13449,0,1,3
3815,6,3,13454,13454,13457,0,3,5
3816,1,3,13455,13457,13460,2,5,0
3817,6,3,13461,13461,13464,0,3,1
3818,6,1,13467,13467,13468,0,1,3
3819,4,2,13471,13471,13473,0,2,3
3820,1,1,13472,13473,13474,1,2,0
3821,1,2,13473,13474,13476,1,3,0
3822,6,1,13479,13479,13480,0,1,3
3823,4,1,13483,13483,13484,0,1,3
3824,5,1,13488,13488,13489,0,1,4
3825,3,2,13491,13491,13493,0,2,2
3826,1,1,13492,13493,13494,1,2,0
3827,4,3,13496,13496,13499,0,3,2
3828,1,1,13497,13499,13500,2,3,0
3829,3,2,13500,13500,13502,0,2,0
3830,2,1,13502,13502,13503,0,1,0
3831,3,3,13505,13505,13508,0,3,2
3832,2,1,13507,13508,13509,1,2,0
3833,6,1,13513,13513,13514,0,1,4
3834,3,3,13516,13516,13519,0,3,2
3835,1,3,13517,13519,13522,2,5,0
3836,3,3,13520,13522,13525,2,5,0
3837,3,1,13523,13525,13526,2,3,0
3838,6,1,13529,13529,13530,0,1,3
3839,3,1,13532,13532,13533,0,1,2
3840,2,3,13534,13534,13537,0,3,1
3841,4,3,13538,13538,13541,0,3,1
3842,6,2,13544,13544,13546,0,2,3
3843,3,1,13547,13547,13548,0,1,1
3844,2,3,13549,13549,13552,0,3,1
3845,3,3,13552,13552,13555,0,3,0
3846,6,1,13558,13558,13559,0,1,3
3847,1,1,13559,13559,13560,0,1,0
3848,6,1,13565,13565,13566,0,1,5
3849,5,3,13570,13570,13573,0,3,4
3850,5,3,13575,13575,13578,0,3,2
3851,1,2,13576,13578,13580,2,4,0
3852,3,1,13579,13580,13581,1,2,0
3853,1,2,13580,13581,13583,1,3,0
3854,3,2,13583,13583,13585,0,2,0
3855,6,3,13589,13589,13592,0,3,4
3856,6,2,13595,13595,13597,0,2,3
3857,2,2,13597,13597,13599,0,2,0
3858,2,2,13599,13599,13601,0,2,0
3859,1,1,13600,13601,13602,1,2,0
3860,4,1,13604,13604,13605,0,1,2
3861,1,2,13605,13605,13607,0,2,0
3862,3,3,13608,13608,13611,0,3,1
3863,1,3,13609,13611,13614,2,5,0
3864,1,1,13610,13614,13615,4,5,0
3865,3,1,13613,13615,13616,2,3,0
3866,2,3,13615,13616,13619,1,4,0
3867,1,2,13616,13619,13621,3,5,0
3868,1,2,13617,13621,13623,4,6,0
3869,1,1,13618,13623,13624,5,6,0
3870,4,3,13622,13624,13627,2,5,0
3871,1,2,13623,13627,13629,4,6,0
3872,4,1,13627,13629,13630,2,3,0
3873,6,2,13633,13633,13635,0,2,3
3874,1,1,13634,13635,13636,1,2,0
3875,3,3,13637,13637,13640,0,3,1
3876,5,2,13642,13642,13644,0,2,2
3877,6,1,13648,13648,13649,0,1,4
3878,2,1,13650,13650,13651,0,1,1
3879,5,2,13655,13655,13657,0,2,4
3880,2,3,13657,13657,13660,0,3,0
3881,3,2,13660,13660,13662,0,2,0
3882,3,1,13663,13663,13664,0,1,1
3883,1,3,13664,13664,13667,0,3,0
3884,4,1,13668,13668,13669,0,1,1
3885,3,2,13671,13671,13673,0,2,2
3886,6,3,13677,13677,13680,0,3,4
3887,5,3,13682,13682,13685,0,3,2
3888,1,3,13683,13685,13688,2,5,0
3889,2,2,13685,13688,13690,3,5,0
3890,6,1,13691,13691,13692,0,1,1
3891,2,1,13693,13693,13694,0,1,1
3892,1,1,13694,13694,13695,0,1,0
3893,5,3,13699,13699,13702,0,3,4
3894,1,2,13700,13702,13704,2,4,0
3895,3,2,13703,13704,13706,1,3,0
3896,6,1,13709,13709,13710,0,1,3
3897,1,3,13710,13710,13713,0,3,0
3898,1,3,13711,13713,13716,2,5,0
3899,3,1,13714,13716,13717,2,3,0
3900,3,2,13717,13717,13719,0,2,0
3901,4,3,13721,13721,13724,0,3,2
3902,4,1,13725,13725,13726,0,1,1
3903,6,1,13731,13731,13732,0,1,5
3904,6,1,13737,13737,13738,0,1,5
3905,1,3,13738,13738,13741,0,3,0
3906,6,3,13744,13744,13747,0,3,3
3907,1,2,13745,13747,13749,2,4,0
3908,3,1,13748,13749,13750,1,2,0
3909,4,3,13752,13752,13755,0,3,2
3910,5,1,13757,13757,13758,0,1,2
3911,2,3,13759,13759,13762,0,3,1
3912,6,3,13765,13765,13768,0,3,3
3913,4,2,13769,13769,13771,0,2,1
3914,3,3,13772,13772,13775,0,3,1
3915,6,3,13778,13778,13781,0,3,3
3916,2,2,13780,13781,13783,1,3,0
3917,6,2,13786,13786,13788,0,2,3
3918,2,1,13788,13788,13789,0,1,0
3919,2,3,13790,13790,13793,0,3,1
3920,2,3,13792,13793,13796,1,4,0
3921,5,1,13797,13797,13798,0,1,1
3922,4,2,13801,13801,13803,0,2,3
3923,2,1,13803,13803,13804,0,1,0
3924,4,2,13807,13807,13809,0,2,3
3925,6,2,13813,13813,13815,0,2,4
3926,3,2,13816,13816,13818,0,2,1
3927,4,1,13820,13820,13821,0,1,2
3928,6,2,13826,13826,13828,0,2,5
3929,3,1,13829,13829,13830,0,1,1
3930,4,1,13833,13833,13834,0,1,3
3931,4,1,13837,13837,13838,0,1,3
3932,2,1,13839,13839,13840,0,1,1
3933,3,3,13842,13842,13845,0,3,2
3934,6,3,13848,13848,13851,0,3,3
3935,2,2,13850,13851,13853,1,3,0
3936,2,1,13852,13853,13854,1,2,0
3937,5,1,13857,13857,13858,0,1,3
3938,2,3,13859,13859,13862,0,3,1
3939,5,1,13864,13864,13865,0,1,2
3940,1,2,13865,13865,13867,0,2,0
3941,3,3,13868,13868,13871,0,3,1
3942,3,2,13871,13871,13873,0,2,0
3943,2,3,13873,13873,13876,0,3,0
3944,3,3,13876,13876,13879,0,3,0
3945,4,2,13880,13880,13882,0,2,1
3946,6,2,13886,13886,13888,0,2,4
3947,3,3,13889,13889,13892,0,3,1
3948,5,3,13894,13894,13897,0,3,2
3949,2,2,13896,13897,13899,1,3,0
3950,1,2,13897,13899,13901,2,4,0
3951,1,2,13898,13901,13903,3,5,0
3952,6,1,13904,13904,13905,0,1,1
3953,5,1,13909,13909,13910,0,1,4
3954,2,1,13911,13911,13912,0,1,1
3955,2,2,13913,13913,13915,0,2,1
3956,3,2,13916,13916,13918,0,2,1
3957,4,1,13920,13920,13921,0,1,2
3958,4,2,13924,13924,13926,0,2,3
3959,6,1,13930,13930,13931,0,1,4
3960,1,1,13931,13931,13932,0,1,0
3961,4,1,13935,13935,13936,0,1,3
3962,6,1,13941,13941,13942,0,1,5
3963,5,1,13946,13946,13947,0,1,4
3964,4,1,13950,13950,13951,0,1,3
3965,4,3,13954,13954,13957,0,3,3
3966,1,2,13955,13957,13959,2,4,0
3967,2,3,13957,13959,13962,2,5,0
3968,5,3,13962,13962,13965,0,3,0
3969,4,3,13966,13966,13969,0,3,1
3970,2,1,13968,13969,13970,1,2,0
3971,6,3,13974,13974,13977,0,3,4
3972,3,3,13977,13977,13980,0,3,0
3973,5,3,13982,13982,13985,0,3,2
3974,6,1,13988,13988,13989,0,1,3
3975,1,3,13989,13989,13992,0,3,0
3976,3,2,13992,13992,13994,0,2,0
3977,1,2,13993,13994,13996,1,3,0
3978,6,3,13999,13999,14002,0,3,3
3979,2,1,14001,14002,14003,1,2,0
3980,6,2,14007,14007,14009,0,2,4
3981,4,3,14011,14011,14014,0,3,2
3982,3,2,14014,14014,14016,0,2,0
3983,3,2,14017,14017,14019,0,2,1
3984,6,3,14023,14023,14026,0,3,4
3985,4,2,14027,14027,14029,0,2,1
3986,2,3,14029,14029,14032,0,3,0
3987,1,3,14030,14032,14035,2,5,0
3988,4,1,14034,14035,14036,1,2,0
3989,4,1,14038,14038,14039,0,1,2
3990,3,3,14041,14041,14044,0,3,2
3991,6,1,14047,14047,14048,0,1,3
3992,3,3,14050,14050,14053,0,3,2
3993,4,2,14054,14054,14056,0,2,1
3994,6,2,14060,14060,14062,0,2,4
3995,5,2,14065,14065,14067,0,2,3
3996,3,2,14068,14068,14070,0,2,1
3997,1,3,14069,14070,14073,1,4,0
3998,6,1,14075,14075,14076,0,1,2
3999,2,2,14077,14077,14079,0,2,1
4000,6,3,14083,14083,14086,0,3,4
4001,2,1,14085,14086,14087,1,2,0
4002,6,1,14091,14091,14092,0,1,4
4003,6,3,14097,14097,14100,0,3,5
4004,5,1,14102,14102,14103,0,1,2
4005,2,1,14104,14104,14105,0,1,1
4006,4,3,14108,14108,14111,0,3,3
4007,3,2,14111,14111,14113,0,2,0
4008,4,1,14115,14115,14116,0,1,2
4009,2,1,14117,14117,14118,0,1,1
4010,3,1,14120,14120,14121,0,1,2
4011,6,2,14126,14126,14128,0,2,5
4012,3,1,14129,14129,14130,0,1,1
4013,4,2,14133,14133,14135,0,2,3
4014,3,2,14136,14136,14138,0,2,1
4015,3,3,14139,14139,14142,0,3,1
4016,3,3,14142,14142,14145,0,3,0
4017,5,2,14147,14147,14149,0,2,2
4018,2,2,14149,14149,14151,0,2,0
4019,3,1,14152,14152,14153,0,1,1
4020,3,1,14155,14155,14156,0,1,2
4021,5,1,14160,14160,14161,0,1,4
4022,5,2,14165,14165,14167,0,2,4
4023,4,3,14169,14169,14172,0,3,2
4024,1,2,14170,14172,14174,2,4,0
4025,2,1,14172,14174,14175,2,3,0
4026,6,3,14178,14178,14181,0,3,3
4027,6,1,14184,14184,14185,0,1,3
4028,4,3,14188,14188,14191,0,3,3
4029,2,3,14190,14191,14194,1,4,0
4030,1,1,14191,14194,14195,3,4,0
4031,6,3,14197,14197,14200,0,3,2
4032,2,2,14199,14200,14202,1,3,0
4033,4,1,14203,14203,14204,0,1,1
4034,3,3,14206,14206,14209,0,3,2
4035,4,1,14210,14210,14211,0,1,1
4036,1,3,14211,14211,14214,0,3,0
4037,6,1,14217,14217,14218,0,1,3
4038,6,2,14223,14223,14225,0,2,5
4039,3,1,14226,14226,14227,0,1,1
4040,4,1,14230,14230,14231,0,1,3
4041,6,2,14236,14236,14238,0,2,5
4042,1,2,14237,14238,14240,1,3,0
4043,2,3,14239,14240,14243,1,4,0
4044,6,3,14245,14245,14248,0,3,2
4045,1,1,14246,14248,14249,2,3,0
4046,4,1,14250,14250,14251,0,1,1
4047,6,2,14256,14256,14258,0,2,5
4048,1,2,14257,14258,14260,1,3,0
4049,3,3,14260,14260,14263,0,3,0
4050,2,3,14262,14263,14266,1,4,0
4051,2,1,14264,14266,14267,2,3,0
4052,2,2,14266,14267,14269,1,3,0
4053,3,3,14269,14269,14272,0,3,0
4054,1,2,14270,14272,14274,2,4,0
4055,6,1,14276,14276,14277,0,1,2
4056,2,2,14278,14278,14280,0,2,1
4057,3,2,14281,14281,14283,0,2,1
4058,3,3,14284,14284,14287,0,3,1
4059,5,3,14289,14289,14292,0,3,2
4060,3,3,14292,14292,14295,0,3,0
4061,1,2,14293,14295,14297,2,4,0
4062,5,1,14298,14298,14299,0,1,1
4063,6,3,14304,14304,14307,0,3,5
4064,4,1,14308,14308,14309,0,1,1
4065,5,3,14313,14313,14316,0,3,4
4066,2,1,14315,14316,14317,1,2,0
4067,3,2,14318,14318,14320,0,2,1
4068,5,1,14323,14323,14324,0,1,3
4069,2,2,14325,14325,14327,0,2,1
4070,4,3,14329,14329,14332,0,3,2
4071,1,3,14330,14332,14335,2,5,0
4072,2,2,14332,14335,14337,3,5,0
4073,3,1,14335,14337,14338,2,3,0
4074,2,3,14337,14338,14341,1,4,0
4075,3,3,14340,14341,14344,1,4,0
4076,3,2,14343,14344,14346,1,3,0
4077,2,2,14345,14346,14348,1,3,0
4078,3,1,14348,14348,14349,0,1,0
4079,3,3,14351,14351,14354,0,3,2
4080,5,1,14356,14356,14357,0,1,2
4081,2,1,14358,14358,14359,0,1,1
4082,3,1,14361,14361,14362,0,1,2
4083,3,1,14364,14364,14365,0,1,2
4084,3,2,14367,14367,14369,0,2,2
4085,3,1,14370,14370,14371,0,1,1
4086,6,3,14376,14376,14379,0,3,5
4087,2,3,14378,14379,14382,1,4,0
4088,5,2,14383,14383,14385,0,2,1
4089,2,1,14385,14385,14386,0,1,0
4090,3,3,14388,14388,14391,0,3,2
4091,4,2,14392,14392,14394,0,2,1
4092,6,3,14398,14398,14401,0,3,4
4093,1,1,14399,14401,14402,2,3,0
4094,5,3,14404,14404,14407,0,3,2
4095,6,2,14410,14410,14412,0,2,3
4096,1,1,14411,14412,14413,1,2,0
4097,6,2,14417,14417,14419,0,2,4
4098,5,1,14422,14422,14423,0,1,3
4099,6,1,14428,14428,14429,0,1,5
4100,5,1,14433,14433,14434,0,1,4
4101,3,2,14436,14436,14438,0,2,2
4102,3,3,14439,14439,14442,0,3,1
4103,2,2,14441,14442,14444,1,3,0
4104,3,1,14444,14444,14445,0,1,0
4105,1,1,14445,14445,14446,0,1,0
4106,3,2,14448,14448,14450,0,2,2
4107,4,2,14452,14452,14454,0,2,2
4108,2,1,14454,14454,14455,0,1,0
4109,1,1,14455,14455,14456,0,1,0
4110,5,3,14460,14460,14463,0,3,4
4111,5,1,14465,14465,14466,0,1,2
4112,3,3,14468,14468,14471,0,3,2
4113,5,1,14473,14473,14474,0,1,2
4114,1,2,14474,14474,14476,0,2,0
4115,6,2,14480,14480,14482,0,2,4
4116,2,2,14482,14482,14484,0,2,0
4117,1,1,14483,14484,14485,1,2,0
4118,1,1,14484,14485,14486,1,2,0
4119,4,1,14488,14488,14489,0,1,2
4120,1,1,14489,14489,14490,0,1,0
4121,5,2,14494,14494,14496,0,2,4
4122,4,2,14498,14498,14500,0,2,2
4123,1,2,14499,14500,14502,1,3,0
4124,3,3,14502,14502,14505,0,3,0
4125,1,3,14503,14505,14508,2,5,0
4126,1,2,14504,14508,14510,4,6,0
4127,6,2,14510,14510,14512,0,2,0
4128,6,1,14516,14516,14517,0,1,4
4129,4,1,14520,14520,14521,0,1,3
4130,3,3,14523,14523,14526,0,3,2
4131,6,2,14529,14529,14531,0,2,3
4132,1,2,14530,14531,14533,1,3,0
4133,6,3,14536,14536,14539,0,3,3
4134,2,1,14538,14539,14540,1,2,0
4135,3,1,14541,14541,14542,0,1,1
4136,2,3,14543,14543,14546,0,3,1
4137,6,1,14549,14549,14550,0,1,3
4138,6,3,14555,14555,14558,0,3,5
4139,5,1,14560,14560,14561,0,1,2
4140,2,3,14562,14562,14565,0,3,1
4141,4,2,14566,14566,14568,0,2,1
4142,1,1,14567,14568,14569,1,2,0
4143,5,2,14572,14572,14574,0,2,3
4144,4,3,14576,14576,14579,0,3,2
4145,4,3,14580,14580,14583,0,3,1
4146,2,1,14582,14583,14584,1,2,0
4147,1,3,14583,14584,14587,1,4,0
4148,4,1,14587,14587,14588,0,1,0
4149,3,3,14590,14590,14593,0,3,2
4150,3,2,14593,14593,14595,0,2,0
4151,6,2,14599,14599,14601,0,2,4
4152,2,2,14601,14601,14603,0,2,0
4153,3,2,14604,14604,14606,0,2,1
4154,5,3,14609,14609,14612,0,3,3
4155,2,3,14611,14612,14615,1,4,0
4156,6,3,14617,14617,14620,0,3,2
4157,3,1,14620,14620,14621,0,1,0
4158,3,1,14623,14623,14624,0,1,2
4159,2,2,14625,14625,14627,0,2,1
4160,6,3,14631,14631,14634,0,3,4
4161,3,3,14634,14634,14637,0,3,0
4162,1,2,14635,14637,14639,2,4,0
4163,2,1,14637,14639,14640,2,3,0
4164,5,1,14642,14642,14643,0,1,2
4165,5,1,14647,14647,14648,0,1,4
4166,4,2,14651,14651,14653,0,2,3
4167,3,1,14654,14654,14655,0,1,1
4168,4,3,14658,14658,14661,0,3,3
4169,3,1,14661,14661,14662,0,1,0
4170,3,3,14664,14664,14667,0,3,2
4171,5,2,14669,14669,14671,0,2,2
4172,5,1,14674,14674,14675,0,1,3
4173,1,1,14675,14675,14676,0,1,0
4174,5,3,14680,14680,14683,0,3,4
4175,1,2,14681,14683,14685,2,4,0
4176,2,1,14683,14685,14686,2,3,0
4177,5,3,14688,14688,14691,0,3,2
4178,3,3,14691,14691,14694,0,3,0
4179,3,1,14694,14694,14695,0,1,0
4180,4,3,14698,14698,14701,0,3,3
4181,2,1,14700,14701,14702,1,2,0
4182,3,2,14703,14703,14705,0,2,1
4183,4,3,14707,14707,14710,0,3,2
4184,3,1,14710,14710,14711,0,1,0
4185,5,2,14715,14715,14717,0,2,4
4186,3,1,14718,14718,14719,0,1,1
4187,5,3,14723,14723,14726,0,3,4
4188,4,2,14727,14727,14729,0,2,1
4189,6,2,14733,14733,14735,0,2,4
4190,2,2,14735,14735,14737,0,2,0
4191,3,1,14738,14738,14739,0,1,1
4192,2,2,14740,14740,14742,0,2,1
4193,4,2,14744,14744,14746,0,2,2
4194,3,1,14747,14747,14748,0,1,1
4195,5,1,14752,14752,14753,0,1,4
4196,2,3,14754,14754,14757,0,3,1
4197,3,1,14757,14757,14758,0,1,0
4198,2,1,14759,14759,14760,0,1,1
4199,5,3,14764,14764,14767,0,3,4
4200,5,3,14769,14769,14772,0,3,2
4201,3,3,14772,14772,14775,0,3,0
4202,4,1,14776,14776,14777,0,1,1
4203,2,1,14778,14778,14779,0,1,1
4204,2,2,14780,14780,14782,0,2,1
4205,4,1,14784,14784,14785,0,1,2
4206,3,1,14787,14787,14788,0,1,2
4207,6,2,14793,14793,14795,0,2,5
4208,2,3,14795,14795,14798,0,3,0
4209,3,3,14798,14798,14801,0,3,0
4210,6,3,14804,14804,14807,0,3,3
4211,6,1,14810,14810,14811,0,1,3
4212,1,1,14811,14811,14812,0,1,0
4213,1,1,14812,14812,14813,0,1,0
4214,2,2,14814,14814,14816,0,2,1
4215,2,3,14816,14816,14819,0,3,0
4216,4,3,14820,14820,14823,0,3,1
4217,2,3,14822,14823,14826,1,4,0
4218,3,2,14825,14826,14828,1,3,0
4219,4,2,14829,14829,14831,0,2,1
4220,6,1,14835,14835,14836,0,1,4
4221,6,3,14841,14841,14844,0,3,5
4222,5,2,14846,14846,14848,0,2,2
4223,1,1,14847,14848,14849,1,2,0
4224,1,3,14848,14849,14852,1,4,0
4225,6,3,14854,14854,14857,0,3,2
4226,6,3,14860,14860,14863,0,3,3
4227,5,1,14865,14865,14866,0,1,2
4228,3,2,14868,14868,14870,0,2,2
4229,1,2,14869,14870,14872,1,3,0
4230,1,3,14870,14872,14875,2,5,0
4231,1,3,14871,14875,14878,4,7,0
4232,4,2,14875,14878,14880,3,5,0
4233,2,3,14877,14880,14883,3,6,0
4234,6,2,14883,14883,14885,0,2,0
4235,6,3,14889,14889,14892,0,3,4
4236,5,1,14894,14894,14895,0,1,2
4237,3,2,14897,14897,14899,0,2,2
4238,6,3,14903,14903,14906,0,3,4
4239,2,2,14905,14906,14908,1,3,0
4240,2,1,14907,14908,14909,1,2,0
4241,1,3,14908,14909,14912,1,4,0
4242,6,3,14914,14914,14917,0,3,2
4243,6,1,14920,14920,14921,0,1,3
4244,3,1,14923,14923,14924,0,1,2
4245,5,2,14928,14928,14930,0,2,4
4246,3,3,14931,14931,14934,0,3,1
4247,2,2,14933,14934,14936,1,3,0
4248,5,2,14938,14938,14940,0,2,2
4249,3,2,14941,14941,14943,0,2,1
4250,5,2,14946,14946,14948,0,2,3
4251,5,3,14951,14951,14954,0,3,3
4252,4,1,14955,14955,14956,0,1,1
4253,5,3,14960,14960,14963,0,3,4
4254,2,2,14962,14963,14965,1,3,0
4255,1,3,14963,14965,14968,2,5,0
4256,2,2,14965,14968,14970,3,5,0
4257,3,2,14968,14970,14972,2,4,0
4258,4,3,14972,14972,14975,0,3,0
4259,1,2,14973,14975,14977,2,4,0
4260,3,3,14976,14977,14980,1,4,0
4261,4,2,14980,14980,14982,0,2,0
4262,6,1,14986,14986,14987,0,1,4
4263,3,3,14989,14989,14992,0,3,2
4264,5,2,14994,14994,14996,0,2,2
4265,5,1,14999,14999,15000,0,1,3
4266,1,3,15000,15000,15003,0,3,0
4267,2,3,15002,15003,15006,1,4,0
4268,4,1,15006,15006,15007,0,1,0
4269,1,1,15007,15007,15008,0,1,0
4270,3,3,15010,15010,15013,0,3,2
4271,1,2,15011,15013,15015,2,4,0
4272,3,1,15014,15015,15016,1,2,0
4273,6,2,15020,15020,15022,0,2,4
4274,2,3,15022,15022,15025,0,3,0
4275,2,1,15024,15025,15026,1,2,0
4276,1,1,15025,15026,15027,1,2,0
4277,3,1,15028,15028,15029,0,1,1
4278,1,3,15029,15029,15032,0,3,0
4279,5,1,15034,15034,15035,0,1,2
4280,6,1,15040,15040,15041,0,1,5
4281,1,2,15041,15041,15043,0,2,0
4282,1,3,15042,15043,15046,1,4,0
4283,2,1,15044,15046,15047,2,3,0
4284,1,2,15045,15047,15049,2,4,0
4285,1,3,15046,15049,15052,3,6,0
4286,4,1,15050,15052,15053,2,3,0
4287,6,3,15056,15056,15059,0,3,3
4288,4,1,15060,15060,15061,0,1,1
4289,1,2,15061,15061,15063,0,2,0
4290,6,3,15067,15067,15070,0,3,4
4291,4,2,15071,15071,15073,0,2,1
4292,2,3,15073,15073,15076,0,3,0
4293,3,1,15076,15076,15077,0,1,0
4294,3,1,15079,15079,15080,0,1,2
4295,4,3,15083,15083,15086,0,3,3
4296,1,3,15084,15086,15089,2,5,0
4297,3,3,15087,15089,15092,2,5,0
4298,5,1,15092,15092,15093,0,1,0
4299,2,1,15094,15094,15095,0,1,1
4300,6,2,15100,15100,15102,0,2,5
4301,3,1,15103,15103,15104,0,1,1
4302,6,2,15109,15109,15111,0,2,5
4303,3,1,15112,15112,15113,0,1,1
4304,1,1,15113,15113,15114,0,1,0
4305,3,2,15116,15116,15118,0,2,2
4306,4,3,15120,15120,15123,0,3,2
4307,3,1,15123,15123,15124,0,1,0
4308,4,2,15127,15127,15129,0,2,3
4309,6,1,15133,15133,15134,0,1,4
4310,3,3,15136,15136,15139,0,3,2
4311,3,2,15139,15139,15141,0,2,0
4312,5,3,15144,15144,15147,0,3,3
4313,6,3,15150,15150,15153,0,3,3
4314,1,1,15151,15153,15154,2,3,0
4315,2,3,15153,15154,15157,1,4,0
4316,1,2,15154,15157,15159,3,5,0
4317,1,2,15155,15159,15161,4,6,0
4318,1,1,15156,15161,15162,5,6,0
4319,6,2,15162,15162,15164,0,2,0
4320,3,1,15165,15165,15166,0,1,1
4321,3,2,15168,15168,15170,0,2,2
4322,2,3,15170,15170,15173,0,3,0
4323,6,1,15176,15176,15177,0,1,3
4324,5,2,15181,15181,15183,0,2,4
4325,3,1,15184,15184,15185,0,1,1
4326,1,2,15185,15185,15187,0,2,0
4327,6,1,15191,15191,15192,0,1,4
4328,4,3,15195,15195,15198,0,3,3
4329,1,3,15196,15198,15201,2,5,0
4330,3,1,15199,15201,15202,2,3,0
4331,1,1,15200,15202,15203,2,3,0
4332,2,1,15202,15203,15204,1,2,0
4333,5,2,15207,15207,15209,0,2,3
4334,4,3,15211,15211,15214,0,3,2
4335,1,1,15212,15214,15215,2,3,0
4336,2,3,15214,15215,15218,1,4,0
4337,3,3,15217,15218,15221,1,4,0
4338,3,3,15220,15221,15224,1,4,0
4339,3,3,15223,15224,15227,1,4,0
4340,5,3,15228,15228,15231,0,3,1
4341,4,3,15232,15232,15235,0,3,1
4342,1,1,15233,15235,15236,2,3,0
4343,3,1,15236,15236,15237,0,1,0
4344,6,3,15242,15242,15245,0,3,5
4345,2,3,15244,15245,15248,1,4,0
4346,5,3,15249,15249,15252,0,3,1
4347,6,3,15255,15255,15258,0,3,3
4348,2,3,15257,15258,15261,1,4,0
4349,6,1,15263,15263,15264,0,1,2
4350,2,1,15265,15265,15266,0,1,1
4351,5,2,15270,15270,15272,0,2,4
4352,2,3,15272,15272,15275,0,3,0
4353,1,1,15273,15275,15276,2,3,0
4354,1,2,15274,15276,15278,2,4,0
4355,5,1,15279,15279,15280,0,1,1
4356,1,3,15280,15280,15283,0,3,0
4357,3,2,15283,15283,15285,0,2,0
4358,5,1,15288,15288,15289,0,1,3
4359,4,1,15292,15292,15293,0,1,3
4360,6,2,15298,15298,15300,0,2,5
4361,1,3,15299,15300,15303,1,4,0
4362,4,2,15303,15303,15305,0,2,0
4363,6,3,15309,15309,15312,0,3,4
4364,4,3,15313,15313,15316,0,3,1
4365,1,2,15314,15316,15318,2,4,0
4366,5,2,15319,15319,15321,0,2,1
4367,4,2,15323,15323,15325,0,2,2
4368,3,1,15326,15326,15327,0,1,1
4369,3,3,15329,15329,15332,0,3,2
4370,6,3,15335,15335,15338,0,3,3
4371,1,1,15336,15338,15339,2,3,0
4372,3,2,15339,15339,15341,0,2,0
4373,5,2,15344,15344,15346,0,2,3
4374,3,3,15347,15347,15350,0,3,1
4375,1,2,15348,15350,15352,2,4,0
4376,6,1,15354,15354,15355,0,1,2
4377,1,3,15355,15355,15358,0,3,0
4378,5,1,15360,15360,15361,0,1,2
4379,6,3,15366,15366,15369,0,3,5
4380,1,2,15367,15369,15371,2,4,0
4381,6,1,15373,15373,15374,0,1,2
4382,3,2,15376,15376,15378,0,2,2
4383,6,2,15382,15382,15384,0,2,4
4384,5,2,15387,15387,15389,0,2,3
4385,1,1,15388,15389,15390,1,2,0
4386,6,1,15394,15394,15395,0,1,4
4387,2,3,15396,15396,15399,0,3,1
4388,1,3,15397,15399,15402,2,5,0
4389,4,3,15401,15402,15405,1,4,0
4390,5,2,15406,15406,15408,0,2,1
4391,6,2,15412,15412,15414,0,2,4
4392,2,1,15414,15414,15415,0,1,0
4393,3,1,15417,15417,15418,0,1,2
4394,2,3,15419,15419,15422,0,3,1
4395,1,1,15420,15422,15423,2,3,0
4396,2,1,15422,15423,15424,1,2,0
4397,1,1,15423,15424,15425,1,2,0
4398,6,3,15429,15429,15432,0,3,4
4399,2,1,15431,15432,15433,1,2,0
4400,4,3,15435,15435,15438,0,3,2
4401,5,3,15440,15440,15443,0,3,2
4402,1,3,15441,15443,15446,2,5,0
4403,5,3,15446,15446,15449,0,3,0
4404,5,3,15451,15451,15454,0,3,2
4405,5,1,15456,15456,15457,0,1,2
4406,4,2,15460,15460,15462,0,2,3
4407,6,2,15466,15466,15468,0,2,4
4408,4,2,15470,15470,15472,0,2,2
4409,4,2,15474,15474,15476,0,2,2
4410,4,3,15478,15478,15481,0,3,2
4411,3,1,15481,15481,15482,0,1,0
4412,2,3,15483,15483,15486,0,3,1
4413,6,1,15489,15489,15490,0,1,3
4414,2,3,15491,15491,15494,0,3,1
4415,6,3,15497,15497,15500,0,3,3
4416,1,3,15498,15500,15503,2,5,0
4417,2,3,15500,15503,15506,3,6,0
4418,3,1,15503,15506,15507,3,4,0
4419,3,2,15506,15507,15509,1,3,0
4420,2,3,15508,15509,15512,1,4,0
4421,6,3,15514,15514,15517,0,3,2
4422,5,3,15519,15519,15522,0,3,2
4423,4,2,15523,15523,15525,0,2,1
4424,4,1,15527,15527,15528,0,1,2
4425,1,1,15528,15528,15529,0,1,0
4426,4,2,15532,15532,15534,0,2,3
4427,5,3,15537,15537,15540,0,3,3
4428,3,3,15540,15540,15543,0,3,0
4429,2,1,15542,15543,15544,1,2,0
4430,3,1,15545,15545,15546,0,1,1
4431,2,3,15547,15547,15550,0,3,1
4432,1,3,15548,15550,15553,2,5,0
4433,2,2,15550,15553,15555,3,5,0
4434,5,2,15555,15555,15557,0,2,0
4435,5,1,15560,15560,15561,0,1,3
4436,3,3,15563,15563,15566,0,3,2
4437,1,1,15564,15566,15567,2,3,0
4438,1,1,15565,15567,15568,2,3,0
4439,3,3,15568,15568,15571,0,3,0
4440,5,1,15573,15573,15574,0,1,2
4441,4,2,15577,15577,15579,0,2,3
4442,3,3,15580,15580,15583,0,3,1
4443,3,1,15583,15583,15584,0,1,0
4444,4,1,15587,15587,15588,0,1,3
4445,2,3,15589,15589,15592,0,3,1
4446,6,1,15595,15595,15596,0,1,3
4447,1,3,15596,15596,15599,0,3,0
4448,2,3,15598,15599,15602,1,4,0
4449,3,3,15601,15602,15605,1,4,0
4450,3,3,15604,15605,15608,1,4,0
4451,4,1,15608,15608,15609,0,1,0
4452,6,2,15614,15614,15616,0,2,5
4453,3,3,15617,15617,15620,0,3,1
4454,4,1,15621,15621,15622,0,1,1
4455,6,2,15627,15627,15629,0,2,5
4456,1,1,15628,15629,15630,1,2,0
4457,5,2,15633,15633,15635,0,2,3
4458,3,1,15636,15636,15637,0,1,1
4459,1,3,15637,15637,15640,0,3,0
4460,2,1,15639,15640,15641,1,2,0
4461,1,3,15640,15641,15644,1,4,0
4462,3,1,15643,15644,15645,1,2,0
4463,1,2,15644,15645,15647,1,3,0
4464,6,3,15650,15650,15653,0,3,3
4465,1,3,15651,15653,15656,2,5,0
4466,2,2,15653,15656,15658,3,5,0
4467,3,2,15656,15658,15660,2,4,0
4468,2,2,15658,15660,15662,2,4,0
4469,5,3,15663,15663,15666,0,3,1
4470,2,3,15665,15666,15669,1,4,0
4471,2,2,15667,15669,15671,2,4,0
4472,2,1,15669,15671,15672,2,3,0
4473,6,1,15675,15675,15676,0,1,3
4474,6,1,15681,15681,15682,0,1,5
4475,3,1,15684,15684,15685,0,1,2
4476,3,2,15687,15687,15689,0,2,2
4477,1,1,15688,15689,15690,1,2,0
4478,5,1,15693,15693,15694,0,1,3
4479,4,1,15697,15697,15698,0,1,3
4480,3,1,15700,15700,15701,0,1,2
4481,1,1,15701,15701,15702,0,1,0
4482,6,1,15707,15707,15708,0,1,5
4483,6,3,15713,15713,15716,0,3,5
4484,6,2,15719,15719,15721,0,2,3
4485,2,2,15721,15721,15723,0,2,0
4486,5,2,15726,15726,15728,0,2,3
4487,1,3,15727,15728,15731,1,4,0
4488,4,2,15731,15731,15733,0,2,0
4489,3,2,15734,15734,15736,0,2,1
4490,6,3,15740,15740,15743,0,3,4
4491,2,2,15742,15743,15745,1,3,0
4492,6,2,15748,15748,15750,0,2,3
4493,1,1,15749,15750,15751,1,2,0
4494,4,3,15753,15753,15756,0,3,2
4495,3,1,15756,15756,15757,0,1,0
4496,6,3,15762,15762,15765,0,3,5
4497,3,3,15765,15765,15768,0,3,0
4498,3,1,15768,15768,15769,0,1,0
4499,4,2,15772,15772,15774,0,2,3
4500,5,2,15777,15777,15779,0,2,3
4501,1,1,15778,15779,15780,1,2,0
4502,5,1,15783,15783,15784,0,1,3
4503,3,2,15786,15786,15788,0,2,2
4504,6,2,15792,15792,15794,0,2,4
4505,3,1,15795,15795,15796,0,1,1
4506,5,1,15800,15800,15801,0,1,4
4507,4,1,15804,15804,15805,0,1,3
4508,6,3,15810,15810,15813,0,3,5
4509,3,2,15813,15813,15815,0,2,0
4510,4,2,15817,15817,15819,0,2,2
4511,2,3,15819,15819,15822,0,3,0
4512,1,3,15820,15822,15825,2,5,0
4513,3,2,15823,15825,15827,2,4,0
4514,3,1,15826,15827,15828,1,2,0
4515,1,2,15827,15828,15830,1,3,0
4516,6,1,15833,15833,15834,0,1,3
4517,4,3,15837,15837,15840,0,3,3
4518,4,1,15841,15841,15842,0,1,1
4519,5,3,15846,15846,15849,0,3,4
4520,5,2,15851,15851,15853,0,2,2
4521,3,2,15854,15854,15856,0,2,1
4522,5,3,15859,15859,15862,0,3,3
4523,5,1,15864,15864,15865,0,1,2
4524,5,2,15869,15869,15871,0,2,4
4525,3,2,15872,15872,15874,0,2,1
4526,1,1,15873,15874,15875,1,2,0
4527,3,3,15876,15876,15879,0,3,1
4528,4,2,15880,15880,15882,0,2,1
4529,5,2,15885,15885,15887,0,2,3
4530,2,1,15887,15887,15888,0,1,0
4531,3,3,15890,15890,15893,0,3,2
4532,4,2,15894,15894,15896,0,2,1
4533,3,3,15897,15897,15900,0,3,1
4534,3,3,15900,15900,15903,0,3,0
4535,5,2,15905,15905,15907,0,2,2
4536,2,2,15907,15907,15909,0,2,0
4537,4,3,15911,15911,15914,0,3,2
4538,4,1,15915,15915,15916,0,1,1
4539,2,1,15917,15917,15918,0,1,1
4540,3,2,15920,15920,15922,0,2,2
4541,1,2,15921,15922,15924,1,3,0
4542,6,3,15927,15927,15930,0,3,3
4543,6,1,15933,15933,15934,0,1,3
4544,1,2,15934,15934,15936,0,2,0
4545,1,2,15935,15936,15938,1,3,0
4546,6,3,15941,15941,15944,0,3,3
4547,2,2,15943,15944,15946,1,3,0
4548,5,2,15948,15948,15950,0,2,2
4549,4,1,15952,15952,15953,0,1,2
4550,2,2,15954,15954,15956,0,2,1
4551,4,2,15958,15958,15960,0,2,2
4552,5,3,15963,15963,15966,0,3,3
4553,2,3,15965,15966,15969,1,4,0
4554,2,1,15967,15969,15970,2,3,0
4555,2,1,15969,15970,15971,1,2,0
4556,1,2,15970,15971,15973,1,3,0
4557,5,1,15975,15975,15976,0,1,2
4558,3,1,15978,15978,15979,0,1,2
4559,4,2,15982,15982,15984,0,2,3
4560,2,1,15984,15984,15985,0,1,0
4561,6,2,15990,15990,15992,0,2,5
4562,3,3,15993,15993,15996,0,3,1
4563,2,2,15995,15996,15998,1,3,0
4564,3,3,15998,15998,16001,0,3,0
4565,3,3,16001,16001,16004,0,3,0
4566,5,1,16006,16006,16007,0,1,2
4567,4,2,16010,16010,16012,0,2,3
4568,2,3,16012,16012,16015,0,3,0
4569,2,2,16014,16015,16017,1,3,0
4570,5,1,16019,16019,16020,0,1,2
4571,5,1,16024,16024,16025,0,1,4
4572,4,3,16028,16028,16031,0,3,3
4573,4,3,16032,16032,16035,0,3,1
4574,5,2,16037,16037,16039,0,2,2
4575,5,3,16042,16042,16045,0,3,3
4576,2,2,16044,16045,16047,1,3,0
4577,5,3,16049,16049,16052,0,3,2
4578,1,1,16050,16052,16053,2,3,0
4579,1,2,16051,16053,16055,2,4,0
4580,3,2,16054,16055,16057,1,3,0
4581,5,1,16059,16059,16060,0,1,2
4582,4,3,16063,16063,16066,0,3,3
4583,6,1,16069,16069,16070,0,1,3
4584,5,3,16074,16074,16077,0,3,4
4585,6,3,16080,16080,16083,0,3,3
4586,4,3,16084,16084,16087,0,3,1
4587,2,3,16086,16087,16090,1,4,0
4588,3,3,16089,16090,16093,1,4,0
4589,5,2,16094,16094,16096,0,2,1
4590,4,1,16098,16098,16099,0,1,2
4591,4,1,16102,16102,16103,0,1,3
4592,4,1,16106,16106,16107,0,1,3
4593,5,3,16111,16111,16114,0,3,4
4594,1,3,16112,16114,16117,2,5,0
4595,5,1,16117,16117,16118,0,1,0
4596,3,1,16120,16120,16121,0,1,2
4597,3,3,16123,16123,16126,0,3,2
4598,2,1,16125,16126,16127,1,2,0
4599,3,1,16128,16128,16129,0,1,1
4600,4,1,16132,16132,16133,0,1,3
4601,4,3,16136,16136,16139,0,3,3
4602,3,2,16139,16139,16141,0,2,0
4603,4,3,16143,16143,16146,0,3,2
4604,2,3,16145,16146,16149,1,4,0
4605,2,3,16147,16149,16152,2,5,0
4606,2,3,16149,16152,16155,3,6,0
4607,2,2,16151,16155,16157,4,6,0
4608,2,3,16153,16157,16160,4,7,0
4609,6,1,16159,16160,16161,1,2,0
4610,5,3,16164,16164,16167,0,3,3
4611,5,1,16169,16169,16170,0,1,2
4612,3,3,16172,16172,16175,0,3,2
4613,5,3,16177,16177,16180,0,3,2
4614,6,2,16183,16183,16185,0,2,3
4615,1,3,16184,16185,16188,1,4,0
4616,6,2,16190,16190,16192,0,2,2
4617,2,1,16192,16192,16193,0,1,0
4618,5,2,16197,16197,16199,0,2,4
4619,1,1,16198,16199,16200,1,2,0
4620,3,2,16201,16201,16203,0,2,1
4621,4,3,16205,16205,16208,0,3,2
4622,2,2,16207,16208,16210,1,3,0
4623,4,3,16211,16211,16214,0,3,1
4624,5,1,16216,16216,16217,0,1,2
4625,5,2,16221,16221,16223,0,2,4
4626,4,1,16225,16225,16226,0,1,2
4627,5,3,16230,16230,16233,0,3,4
4628,5,2,16235,16235,16237,0,2,2
4629,2,1,16237,16237,16238,0,1,0
4630,2,3,16239,16239,16242,0,3,1
4631,5,1,16244,16244,16245,0,1,2
4632,3,3,16247,16247,16250,0,3,2
4633,3,1,16250,16250,16251,0,1,0
4634,1,1,16251,16251,16252,0,1,0
4635,5,2,16256,16256,16258,0,2,4
4636,6,1,16262,16262,16263,0,1,4
4637,4,2,16266,16266,16268,0,2,3
4638,4,3,16270,16270,16273,0,3,2
4639,2,1,16272,16273,16274,1,2,0
4640,1,2,16273,16274,16276,1,3,0
4641,3,3,16276,16276,16279,0,3,0
4642,4,2,16280,16280,16282,0,2,1
4643,5,1,16285,16285,16286,0,1,3
4644,1,3,16286,16286,16289,0,3,0
4645,2,3,16288,16289,16292,1,4,0
4646,1,1,16289,16292,16293,3,4,0
4647,3,1,16292,16293,16294,1,2,0
4648,5,3,16297,16297,16300,0,3,3
4649,6,1,16303,16303,16304,0,1,3
4650,1,3,16304,16304,16307,0,3,0
4651,6,1,16310,16310,16311,0,1,3
4652,3,1,16313,16313,16314,0,1,2
4653,3,3,16316,16316,16319,0,3,2
4654,4,2,16320,16320,16322,0,2,1
4655,2,2,16322,16322,16324,0,2,0
4656,4,1,16326,16326,16327,0,1,2
4657,6,3,16332,16332,16335,0,3,5
4658,3,1,16335,16335,16336,0,1,0
4659,4,2,16339,16339,16341,0,2,3
4660,1,1,16340,16341,16342,1,2,0
4661,5,1,16345,16345,16346,0,1,3
4662,3,1,16348,16348,16349,0,1,2
4663,5,1,16353,16353,16354,0,1,4
4664,4,1,16357,16357,16358,0,1,3
4665,3,2,16360,16360,16362,0,2,2
4666,1,2,16361,16362,16364,1,3,0
4667,2,2,16363,16364,16366,1,3,0
4668,2,2,16365,16366,16368,1,3,0
4669,2,1,16367,16368,16369,1,2,0
4670,6,2,16373,16373,16375,0,2,4
4671,2,1,16375,16375,16376,0,1,0
4672,1,1,16376,16376,16377,0,1,0
4673,1,3,16377,16377,16380,0,3,0
4674,6,1,16383,16383,16384,0,1,3
4675,6,1,16389,16389,16390,0,1,5
4676,6,2,16395,16395,16397,0,2,5
4677,4,3,16399,16399,16402,0,3,2
4678,1,2,16400,16402,16404,2,4,0
4679,3,3,16403,16404,16407,1,4,0
4680,4,1,16407,16407,16408,0,1,0
4681,5,1,16412,16412,16413,0,1,4
4682,3,3,16415,16415,16418,0,3,2
4683,3,3,16418,16418,16421,0,3,0
4684,3,1,16421,16421,16422,0,1,0
4685,1,3,16422,16422,16425,0,3,0
4686,4,3,16426,16426,16429,0,3,1
4687,1,1,16427,16429,16430,2,3,0
4688,4,2,16431,16431,16433,0,2,1
4689,6,2,16437,16437,16439,0,2,4
4690,5,2,16442,16442,16444,0,2,3
4691,6,2,16448,16448,16450,0,2,4
4692,3,1,16451,16451,16452,0,1,1
4693,5,3,16456,16456,16459,0,3,4
4694,4,1,16460,16460,16461,0,1,1
4695,6,2,16466,16466,16468,0,2,5
4696,6,2,16472,16472,16474,0,2,4
4697,1,1,16473,16474,16475,1,2,0
4698,1,2,16474,16475,16477,1,3,0
4699,6,2,16480,16480,16482,0,2,3
4700,6,2,16486,16486,16488,0,2,4
4701,2,3,16488,16488,16491,0,3,0
4702,6,2,16494,16494,16496,0,2,3
4703,3,2,16497,16497,16499,0,2,1
4704,3,1,16500,16500,16501,0,1,1
4705,3,2,16503,16503,16505,0,2,2
4706,3,2,16506,16506,16508,0,2,1
4707,1,3,16507,16508,16511,1,4,0
4708,3,2,16510,16511,16513,1,3,0
4709,6,3,16516,16516,16519,0,3,3
4710,4,1,16520,16520,16521,0,1,1
4711,1,1,16521,16521,16522,0,1,0
4712,4,3,16525,16525,16528,0,3,3
4713,2,2,16527,16528,16530,1,3,0
4714,3,2,16530,16530,16532,0,2,0
4715,4,2,16534,16534,16536,0,2,2
4716,1,3,16535,16536,16539,1,4,0
4717,6,1,16541,16541,16542,0,1,2
4718,1,1,16542,16542,16543,0,1,0
4719,4,2,16546,16546,16548,0,2,3
4720,2,3,16548,16548,16551,0,3,0
4721,1,3,16549,16551,16554,2,5,0
4722,1,2,16550,16554,16556,4,6,0
4723,4,3,16554,16556,16559,2,5,0
4724,1,1,16555,16559,16560,4,5,0
4725,3,2,16558,16560,16562,2,4,0
4726,3,2,16561,16562,16564,1,3,0
4727,1,2,16562,16564,16566,2,4,0
4728,2,1,16564,16566,16567,2,3,0
4729,3,1,16567,16567,16568,0,1,0
4730,2,1,16569,16569,16570,0,1,1
4731,3,3,16572,16572,16575,0,3,2
4732,4,1,16576,16576,16577,0,1,1
4733,4,2,16580,16580,16582,0,2,3
4734,3,1,16583,16583,16584,0,1,1
4735,5,1,16588,16588,16589,0,1,4
4736,2,2,16590,16590,16592,0,2,1
4737,2,1,16592,16592,16593,0,1,0
4738,1,3,16593,16593,16596,0,3,0
4739,3,1,16596,16596,16597,0,1,0
4740,4,2,16600,16600,16602,0,2,3
4741,5,2,16605,16605,16607,0,2,3
4742,4,3,16609,16609,16612,0,3,2
4743,2,1,16611,16612,16613,1,2,0
4744,2,2,16613,16613,16615,0,2,0
4745,4,1,16617,16617,16618,0,1,2
4746,1,1,16618,16618,16619,0,1,0
4747,2,3,16620,16620,16623,0,3,1
4748,5,2,16625,16625,16627,0,2,2
4749,3,2,16628,16628,16630,0,2,1
4750,2,3,16630,16630,16633,0,3,0
4751,4,2,16634,16634,16636,0,2,1
4752,2,2,16636,16636,16638,0,2,0
4753,3,3,16639,16639,16642,0,3,1
4754,3,1,16642,16642,16643,0,1,0
4755,4,2,16646,16646,16648,0,2,3
4756,1,2,16647,16648,16650,1,3,0
4757,3,1,16650,16650,16651,0,1,0
4758,4,3,16654,16654,16657,0,3,3
4759,5,3,16659,16659,16662,0,3,2
4760,5,3,16664,16664,16667,0,3,2
4761,4,1,16668,16668,16669,0,1,1
4762,1,3,16669,16669,16672,0,3,0
4763,4,2,16673,16673,16675,0,2,1
4764,5,3,16678,16678,16681,0,3,3
4765,4,1,16682,16682,16683,0,1,1
4766,1,1,16683,16683,16684,0,1,0
4767,5,2,16688,16688,16690,0,2,4
4768,3,3,16691,16691,16694,0,3,1
4769,4,2,16695,16695,16697,0,2,1
4770,1,3,16696,16697,16700,1,4,0
4771,6,2,16702,16702,16704,0,2,2
4772,3,2,16705,16705,16707,0,2,1
4773,6,3,16711,16711,16714,0,3,4
4774,1,2,16712,16714,16716,2,4,0
4775,5,2,16717,16717,16719,0,2,1
4776,1,3,16718,16719,16722,1,4,0
4777,2,2,16720,16722,16724,2,4,0
4778,2,2,16722,16724,16726,2,4,0
4779,1,3,16723,16726,16729,3,6,0
4780,2,3,16725,16729,16732,4,7,0
4781,4,1,16729,16732,16733,3,4,0
4782,6,2,16735,16735,16737,0,2,2
4783,1,2,16736,16737,16739,1,3,0
4784,3,2,16739,16739,16741,0,2,0
4785,3,2,16742,16742,16744,0,2,1
4786,3,2,16745,16745,16747,0,2,1
4787,2,3,16747,16747,16750,0,3,0
4788,3,2,16750,16750,16752,0,2,0
4789,1,2,16751,16752,16754,1,3,0
4790,5,2,16756,16756,16758,0,2,2
4791,5,3,16761,16761,16764,0,3,3
4792,5,2,16766,16766,16768,0,2,2
4793,3,1,16769,16769,16770,0,1,1
4794,3,1,16772,16772,16773,0,1,2
4795,4,3,16776,16776,16779,0,3,3
4796,1,2,16777,16779,16781,2,4,0
4797,4,3,16781,16781,16784,0,3,0
4798,1,2,16782,16784,16786,2,4,0
4799,5,1,16787,16787,16788,0,1,1
4800,1,2,16788,16788,16790,0,2,0
4801,4,2,16792,16792,16794,0,2,2
4802,6,2,16798,16798,16800,0,2,4
4803,2,3,16800,16800,16803,0,3,0
4804,5,1,16805,16805,16806,0,1,2
4805,3,2,16808,16808,16810,0,2,2
4806,6,1,16814,16814,16815,0,1,4
4807,4,3,16818,16818,16821,0,3,3
4808,3,1,16821,16821,16822,0,1,0
4809,4,2,16825,16825,16827,0,2,3
4810,3,1,16828,16828,16829,0,1,1
4811,4,2,16832,16832,16834,0,2,3
4812,4,1,16836,16836,16837,0,1,2
4813,1,3,16837,16837,16840,0,3,0
4814,4,1,16841,16841,16842,0,1,1
4815,5,2,16846,16846,16848,0,2,4
4816,4,3,16850,16850,16853,0,3,2
4817,6,2,16856,16856,16858,0,2,3
4818,4,1,16860,16860,16861,0,1,2
4819,4,1,16864,16864,16865,0,1,3
4820,5,2,16869,16869,16871,0,2,4
4821,4,3,16873,16873,16876,0,3,2
4822,5,2,16878,16878,16880,0,2,2
4823,6,1,16884,16884,16885,0,1,4
4824,1,2,16885,16885,16887,0,2,0
4825,1,3,16886,16887,16890,1,4,0
4826,6,2,16892,16892,16894,0,2,2
4827,2,3,16894,16894,16897,0,3,0
4828,6,2,16900,16900,16902,0,2,3
4829,6,2,16906,16906,16908,0,2,4
4830,2,3,16908,16908,16911,0,3,0
4831,1,2,16909,16911,16913,2,4,0
4832,5,1,16914,16914,16915,0,1,1
4833,2,3,16916,16916,16919,0,3,1
4834,1,3,16917,16919,16922,2,5,0
4835,6,2,16923,16923,16925,0,2,1
4836,5,2,16928,16928,16930,0,2,3
4837,4,2,16932,16932,16934,0,2,2
4838,3,3,16935,16935,16938,0,3,1
4839,4,1,16939,16939,16940,0,1,1
4840,3,3,16942,16942,16945,0,3,2
4841,4,1,16946,16946,16947,0,1,1
4842,1,2,16947,16947,16949,0,2,0
4843,5,2,16952,16952,16954,0,2,3
4844,2,2,16954,16954,16956,0,2,0
4845,1,2,16955,16956,16958,1,3,0
4846,1,3,16956,16958,16961,2,5,0
4847,4,2,16960,16961,16963,1,3,0
4848,4,1,16964,16964,16965,0,1,1
4849,6,2,16970,16970,16972,0,2,5
4850,2,2,16972,16972,16974,0,2,0
4851,6,1,16978,16978,16979,0,1,4
4852,3,1,16981,16981,16982,0,1,2
4853,3,3,16984,16984,16987,0,3,2
4854,2,2,16986,16987,16989,1,3,0
4855,2,2,16988,16989,16991,1,3,0
4856,6,2,16994,16994,16996,0,2,3
4857,3,1,16997,16997,16998,0,1,1
4858,2,2,16999,16999,17001,0,2,1
4859,3,3,17002,17002,17005,0,3,1
4860,2,2,17004,17005,17007,1,3,0
4861,6,3,17010,17010,17013,0,3,3
4862,3,1,17013,17013,17014,0,1,0
4863,2,3,17015,17015,17018,0,3,1
4864,2,1,17017,17018,17019,1,2,0
4865,3,3,17020,17020,17023,0,3,1
4866,5,3,17025,17025,17028,0,3,2
4867,3,2,17028,17028,17030,0,2,0
4868,6,3,17034,17034,17037,0,3,4
4869,3,1,17037,17037,17038,0,1,0
4870,2,2,17039,17039,17041,0,2,1
4871,4,2,17043,17043,17045,0,2,2
4872,5,3,17048,17048,17051,0,3,3
4873,6,1,17054,17054,17055,0,1,3
4874,3,2,17057,17057,17059,0,2,2
4875,5,1,17062,17062,17063,0,1,3
4876,4,1,17066,17066,17067,0,1,3
4877,2,3,17068,17068,17071,0,3,1
4878,5,3,17073,17073,17076,0,3,2
4879,3,3,17076,17076,17079,0,3,0
4880,4,1,17080,17080,17081,0,1,1
4881,1,3,17081,17081,17084,0,3,0
4882,4,3,17085,17085,17088,0,3,1
4883,2,1,17087,17088,17089,1,2,0
4884,4,3,17091,17091,17094,0,3,2
4885,6,3,17097,17097,17100,0,3,3
4886,5,3,17102,17102,17105,0,3,2
4887,1,2,17103,17105,17107,2,4,0
4888,5,2,17108,17108,17110,0,2,1
4889,4,1,17112,17112,17113,0,1,2
4890,1,2,17113,17113,17115,0,2,0
4891,3,1,17116,17116,17117,0,1,1
4892,2,2,17118,17118,17120,0,2,1
4893,4,1,17122,17122,17123,0,1,2
4894,2,1,17124,17124,17125,0,1,1
4895,3,2,17127,17127,17129,0,2,2
4896,3,3,17130,17130,17133,0,3,1
4897,2,2,17132,17133,17135,1,3,0
4898,5,1,17137,17137,17138,0,1,2
4899,2,1,17139,17139,17140,0,1,1
4900,6,2,17145,17145,17147,0,2,5
4901,6,1,17151,17151,17152,0,1,4
4902,2,3,17153,17153,17156,0,3,1
4903,6,1,17159,17159,17160,0,1,3
4904,1,2,17160,17160,17162,0,2,0
4905,4,2,17164,17164,17166,0,2,2
4906,6,2,17170,17170,17172,0,2,4
4907,2,3,17172,17172,17175,0,3,0
4908,2,1,17174,17175,17176,1,2,0
4909,6,2,17180,17180,17182,0,2,4
4910,2,2,17182,17182,17184,0,2,0
4911,4,2,17186,17186,17188,0,2,2
4912,6,2,17192,17192,17194,0,2,4
4913,2,3,17194,17194,17197,0,3,0
4914,1,2,17195,17197,17199,2,4,0
4915,3,3,17198,17199,17202,1,4,0
4916,3,3,17201,17202,17205,1,4,0
4917,5,2,17206,17206,17208,0,2,1
4918,5,1,17211,17211,17212,0,1,3
4919,3,3,17214,17214,17217,0,3,2
4920,2,3,17216,17217,17220,1,4,0
4921,6,3,17222,17222,17225,0,3,2
4922,1,1,17223,17225,17226,2,3,0
4923,3,3,17226,17226,17229,0,3,0
4924,6,3,17232,17232,17235,0,3,3
4925,6,2,17238,17238,17240,0,2,3
4926,4,3,17242,17242,17245,0,3,2
4927,4,3,17246,17246,17249,0,3,1
4928,4,1,17250,17250,17251,0,1,1
4929,6,3,17256,17256,17259,0,3,5
4930,3,3,17259,17259,17262,0,3,0
4931,1,2,17260,17262,17264,2,4,0
4932,2,1,17262,17264,17265,2,3,0
4933,4,2,17266,17266,17268,0,2,1
4934,3,2,17269,17269,17271,0,2,1
4935,2,3,17271,17271,17274,0,3,0
4936,3,1,17274,17274,17275,0,1,0
4937,6,2,17280,17280,17282,0,2,5
4938,6,3,17286,17286,17289,0,3,4
4939,5,2,17291,17291,17293,0,2,2
4940,1,2,17292,17293,17295,1,3,0
4941,1,2,17293,17295,17297,2,4,0
4942,3,1,17296,17297,17298,1,2,0
4943,6,1,17302,17302,17303,0,1,4
4944,1,2,17303,17303,17305,0,2,0
4945,1,3,17304,17305,17308,1,4,0
4946,4,1,17308,17308,17309,0,1,0
4947,6,1,17314,17314,17315,0,1,5
4948,5,3,17319,17319,17322,0,3,4
4949,1,2,17320,17322,17324,2,4,0
4950,6,1,17326,17326,17327,0,1,2
4951,3,2,17329,17329,17331,0,2,2
4952,2,1,17331,17331,17332,0,1,0
4953,1,3,17332,17332,17335,0,3,0
4954,4,3,17336,17336,17339,0,3,1
4955,4,2,17340,17340,17342,0,2,1
4956,5,2,17345,17345,17347,0,2,3
4957,1,2,17346,17347,17349,1,3,0
4958,3,2,17349,17349,17351,0,2,0
4959,1,3,17350,17351,17354,1,4,0
4960,4,1,17354,17354,17355,0,1,0
4961,1,2,17355,17355,17357,0,2,0
4962,4,3,17359,17359,17362,0,3,2
4963,2,3,17361,17362,17365,1,4,0
4964,6,2,17367,17367,17369,0,2,2
4965,4,3,17371,17371,17374,0,3,2
4966,1,1,17372,17374,17375,2,3,0
4967,2,1,17374,17375,17376,1,2,0
4968,1,2,17375,17376,17378,1,3,0
4969,2,1,17377,17378,17379,1,2,0
4970,3,2,17380,17380,17382,0,2,1
4971,1,2,17381,17382,17384,1,3,0
4972,4,2,17385,17385,17387,0,2,1
4973,2,3,17387,17387,17390,0,3,0
4974,1,1,17388,17390,17391,2,3,0
4975,2,3,17390,17391,17394,1,4,0
4976,4,3,17394,17394,17397,0,3,0
4977,4,1,17398,17398,17399,0,1,1
4978,1,1,17399,17399,17400,0,1,0
4979,5,2,17404,17404,17406,0,2,4
4980,4,1,17408,17408,17409,0,1,2
4981,3,3,17411,17411,17414,0,3,2
4982,4,3,17415,17415,17418,0,3,1
4983,2,2,17417,17418,17420,1,3,0
4984,6,2,17423,17423,17425,0,2,3
4985,2,3,17425,17425,17428,0,3,0
4986,5,3,17430,17430,17433,0,3,2
4987,4,2,17434,17434,17436,0,2,1
4988,3,3,17437,17437,17440,0,3,1
4989,5,3,17442,17442,17445,0,3,2
4990,1,2,17443,17445,17447,2,4,0
4991,3,2,17446,17447,17449,1,3,0
4992,3,3,17449,17449,17452,0,3,0
4993,4,2,17453,17453,17455,0,2,1
4994,6,1,17459,17459,17460,0,1,4
4995,6,3,17465,17465,17468,0,3,5
4996,3,1,17468,17468,17469,0,1,0
4997,6,2,17474,17474,17476,0,2,5
4998,6,2,17480,17480,17482,0,2,4
4999,2,2,17482,17482,17484,0,2,0
5000,1,3,17483,17484,17487,1,4,0
5001,4,1,17487,17487,17488,0,1,0
5002,4,2,17491,17491,17493,0,2,3
5003,1,2,17492,17493,17495,1,3,0
5004,1,1,17493,17495,17496,2,3,0
5005,6,2,17499,17499,17501,0,2,3
5006,5,3,17504,17504,17507,0,3,3
5007,2,3,17506,17507,17510,1,4,0
5008,6,2,17512,17512,17514,0,2,2
5009,1,3,17513,17514,17517,1,4,0
5010,5,3,17518,17518,17521,0,3,1
5011,5,3,17523,17523,17526,0,3,2
5012,3,3,17526,17526,17529,0,3,0
5013,1,1,17527,17529,17530,2,3,0
5014,2,1,17529,17530,17531,1,2,0
5015,2,1,17531,17531,17532,0,1,0
5016,5,1,17536,17536,17537,0,1,4
5017,3,2,17539,17539,17541,0,2,2
5018,4,1,17543,17543,17544,0,1,2
5019,3,2,17546,17546,17548,0,2,2
5020,5,3,17551,17551,17554,0,3,3
5021,1,3,17552,17554,17557,2,5,0
5022,1,3,17553,17557,17560,4,7,0
5023,2,2,17555,17560,17562,5,7,0
5024,5,1,17560,17562,17563,2,3,0
5025,4,3,17564,17564,17567,0,3,1
5026,3,2,17567,17567,17569,0,2,0
5027,4,2,17571,17571,17573,0,2,2
5028,2,3,17573,17573,17576,0,3,0
5029,6,1,17579,17579,17580,0,1,3
5030,1,3,17580,17580,17583,0,3,0
5031,1,2,17581,17583,17585,2,4,0
5032,6,3,17587,17587,17590,0,3,2
5033,4,3,17591,17591,17594,0,3,1
5034,2,2,17593,17594,17596,1,3,0
5035,4,2,17597,17597,17599,0,2,1
5036,2,3,17599,17599,17602,0,3,0
5037,4,1,17603,17603,17604,0,1,1
5038,1,3,17604,17604,17607,0,3,0
5039,5,2,17609,17609,17611,0,2,2
5040,2,3,17611,17611,17614,0,3,0
5041,5,3,17616,17616,17619,0,3,2
5042,1,2,17617,17619,17621,2,4,0
5043,4,2,17621,17621,17623,0,2,0
5044,1,1,17622,17623,17624,1,2,0
5045,2,3,17624,17624,17627,0,3,0
5046,5,2,17629,17629,17631,0,2,2
5047,6,3,17635,17635,17638,0,3,4
5048,3,1,17638,17638,17639,0,1,0
5049,4,1,17642,17642,17643,0,1,3
5050,1,3,17643,17643,17646,0,3,0
5051,1,1,17644,17646,17647,2,3,0
5052,3,1,17647,17647,17648,0,1,0
5053,5,1,17652,17652,17653,0,1,4
5054,2,3,17654,17654,17657,0,3,1
5055,1,2,17655,17657,17659,2,4,0
5056,6,2,17661,17661,17663,0,2,2
5057,4,3,17665,17665,17668,0,3,2
5058,4,1,17669,17669,17670,0,1,1
5059,6,3,17675,17675,17678,0,3,5
5060,2,3,17677,17678,17681,1,4,0
5061,4,1,17681,17681,17682,0,1,0
5062,6,2,17687,17687,17689,0,2,5
5063,3,1,17690,17690,17691,0,1,1
5064,2,2,17692,17692,17694,0,2,1
5065,2,2,17694,17694,17696,0,2,0
5066,5,1,17699,17699,17700,0,1,3
5067,6,1,17705,17705,17706,0,1,5
5068,3,2,17708,17708,17710,0,2,2
5069,1,2,17709,17710,17712,1,3,0
5070,3,3,17712,17712,17715,0,3,0
5071,4,1,17716,17716,17717,0,1,1
5072,6,1,17722,17722,17723,0,1,5
5073,6,3,17728,17728,17731,0,3,5
5074,4,3,17732,17732,17735,0,3,1
5075,2,2,17734,17735,17737,1,3,0
5076,4,2,17738,17738,17740,0,2,1
5077,4,3,17742,17742,17745,0,3,2
5078,4,3,17746,17746,17749,0,3,1
5079,6,3,17752,17752,17755,0,3,3
5080,6,2,17758,17758,17760,0,2,3
5081,1,3,17759,17760,17763,1,4,0
5082,1,1,17760,17763,17764,3,4,0
5083,6,3,17766,17766,17769,0,3,2
5084,3,2,17769,17769,17771,0,2,0
5085,4,3,17773,17773,17776,0,3,2
5086,1,2,17774,17776,17778,2,4,0
5087,1,1,17775,17778,17779,3,4,0
5088,4,3,17779,17779,17782,0,3,0
5089,6,1,17785,17785,17786,0,1,3
5090,4,2,17789,17789,17791,0,2,3
5091,4,1,17793,17793,17794,0,1,2
5092,6,2,17799,17799,17801,0,2,5
5093,3,1,17802,17802,17803,0,1,1
5094,4,2,17806,17806,17808,0,2,3
5095,3,3,17809,17809,17812,0,3,1
5096,2,3,17811,17812,17815,1,4,0
5097,1,2,17812,17815,17817,3,5,0
5098,2,3,17814,17817,17820,3,6,0
5099,4,2,17818,17820,17822,2,4,0
5100,5,2,17823,17823,17825,0,2,1
5101,2,2,17825,17825,17827,0,2,0
5102,1,3,17826,17827,17830,1,4,0
5103,4,3,17830,17830,17833,0,3,0
5104,3,1,17833,17833,17834,0,1,0
5105,2,3,17835,17835,17838,0,3,1
5106,4,2,17839,17839,17841,0,2,1
5107,3,3,17842,17842,17845,0,3,1
5108,4,1,17846,17846,17847,0,1,1
5109,4,1,17850,17850,17851,0,1,3
5110,2,1,17852,17852,17853,0,1,1
5111,5,1,17857,17857,17858,0,1,4
5112,3,2,17860,17860,17862,0,2,2
5113,1,3,17861,17862,17865,1,4,0
5114,4,1,17865,17865,17866,0,1,0
5115,1,1,17866,17866,17867,0,1,0
5116,2,2,17868,17868,17870,0,2,1
5117,4,2,17872,17872,17874,0,2,2
5118,2,1,17874,17874,17875,0,1,0
5119,5,3,17879,17879,17882,0,3,4
5120,4,1,17883,17883,17884,0,1,1
5121,6,3,17889,17889,17892,0,3,5
5122,4,2,17893,17893,17895,0,2,1
5123,3,2,17896,17896,17898,0,2,1
5124,2,1,17898,17898,17899,0,1,0
5125,5,3,17903,17903,17906,0,3,4
5126,4,1,17907,17907,17908,0,1,1
5127,2,3,17909,17909,17912,0,3,1
5128,3,3,17912,17912,17915,0,3,0
5129,1,2,17913,17915,17917,2,4,0
5130,5,1,17918,17918,17919,0,1,1
5131,1,2,17919,17919,17921,0,2,0
5132,3,1,17922,17922,17923,0,1,1
5133,5,2,17927,17927,17929,0,2,4
5134,1,1,17928,17929,17930,1,2,0
5135,2,3,17930,17930,17933,0,3,0
5136,3,1,17933,17933,17934,0,1,0
5137,6,1,17939,17939,17940,0,1,5
5138,6,2,17945,17945,17947,0,2,5
5139,2,2,17947,17947,17949,0,2,0
5140,2,3,17949,17949,17952,0,3,0
5141,4,2,17953,17953,17955,0,2,1
5142,4,1,17957,17957,17958,0,1,2
5143,1,2,17958,17958,17960,0,2,0
5144,5,2,17963,17963,17965,0,2,3
5145,3,2,17966,17966,17968,0,2,1
5146,3,1,17969,17969,17970,0,1,1
5147,5,3,17974,17974,17977,0,3,4
5148,6,2,17980,17980,17982,0,2,3
5149,2,2,17982,17982,17984,0,2,0
5150,1,1,17983,17984,17985,1,2,0
5151,4,1,17987,17987,17988,0,1,2
5152,4,2,17991,17991,17993,0,2,3
5153,1,1,17992,17993,17994,1,2,0
5154,6,1,17998,17998,17999,0,1,4
5155,5,2,18003,18003,18005,0,2,4
5156,5,3,18008,18008,18011,0,3,3
5157,1,2,18009,18011,18013,2,4,0
5158,1,1,18010,18013,18014,3,4,0
5159,4,3,18014,18014,18017,0,3,0
5160,6,2,18020,18020,18022,0,2,3
5161,2,1,18022,18022,18023,0,1,0
5162,5,3,18027,18027,18030,0,3,4
5163,3,3,18030,18030,18033,0,3,0
5164,5,3,18035,18035,18038,0,3,2
5165,3,2,18038,18038,18040,0,2,0
5166,3,3,18041,18041,18044,0,3,1
5167,1,1,18042,18044,18045,2,3,0
5168,6,1,18048,18048,18049,0,1,3
5169,3,1,18051,18051,18052,0,1,2
5170,6,3,18057,18057,18060,0,3,5
5171,1,2,18058,18060,18062,2,4,0
5172,2,1,18060,18062,18063,2,3,0
5173,2,1,18062,18063,18064,1,2,0
5174,5,3,18067,18067,18070,0,3,3
5175,3,3,18070,18070,18073,0,3,0
5176,4,3,18074,18074,18077,0,3,1
5177,2,3,18076,18077,18080,1,4,0
5178,3,1,18079,18080,18081,1,2,0
5179,1,3,18080,18081,18084,1,4,0
5180,4,2,18084,18084,18086,0,2,0
5181,3,1,18087,18087,18088,0,1,1
5182,5,3,18092,18092,18095,0,3,4
5183,3,2,18095,18095,18097,0,2,0
5184,4,3,18099,18099,18102,0,3,2
5185,3,1,18102,18102,18103,0,1,0
5186,3,2,18105,18105,18107,0,2,2
5187,6,2,18111,18111,18113,0,2,4
5188,4,3,18115,18115,18118,0,3,2
5189,6,3,18121,18121,18124,0,3,3
5190,1,3,18122,18124,18127,2,5,0
5191,2,3,18124,18127,18130,3,6,0
5192,1,3,18125,18130,18133,5,8,0
5193,3,3,18128,18133,18136,5,8,0
5194,4,1,18132,18136,18137,4,5,0
5195,2,2,18134,18137,18139,3,5,0
5196,4,1,18138,18139,18140,1,2,0
5197,5,3,18143,18143,18146,0,3,3
5198,6,1,18149,18149,18150,0,1,3
5199,4,2,18153,18153,18155,0,2,3
5200,3,3,18156,18156,18159,0,3,1
5201,5,3,18161,18161,18164,0,3,2
5202,4,1,18165,18165,18166,0,1,1
5203,4,3,18169,18169,18172,0,3,3
5204,4,3,18173,18173,18176,0,3,1
5205,2,3,18175,18176,18179,1,4,0
5206,1,2,18176,18179,18181,3,5,0
5207,2,1,18178,18181,18182,3,4,0
5208,3,3,18181,18182,18185,1,4,0
5209,2,1,18183,18185,18186,2,3,0
5210,2,3,18185,18186,18189,1,4,0
5211,2,2,18187,18189,18191,2,4,0
5212,3,1,18190,18191,18192,1,2,0
5213,3,2,18193,18193,18195,0,2,1
5214,1,1,18194,18195,18196,1,2,0
5215,5,2,18199,18199,18201,0,2,3
5216,3,2,18202,18202,18204,0,2,1
5217,5,2,18207,18207,18209,0,2,3
5218,5,2,18212,18212,18214,0,2,3
5219,3,2,18215,18215,18217,0,2,1
5220,6,3,18221,18221,18224,0,3,4
5221,6,1,18227,18227,18228,0,1,3
5222,5,1,18232,18232,18233,0,1,4
5223,1,1,18233,18233,18234,0,1,0
5224,4,1,18237,18237,18238,0,1,3
5225,3,2,18240,18240,18242,0,2,2
5226,3,3,18243,18243,18246,0,3,1
5227,3,3,18246,18246,18249,0,3,0
5228,5,1,18251,18251,18252,0,1,2
5229,6,3,18257,18257,18260,0,3,5
5230,4,2,18261,18261,18263,0,2,1
5231,1,1,18262,18263,18264,1,2,0
5232,4,1,18266,18266,18267,0,1,2
5233,5,2,18271,18271,18273,0,2,4
5234,5,3,18276,18276,18279,0,3,3
5235,2,2,18278,18279,18281,1,3,0
5236,6,2,18284,18284,18286,0,2,3
5237,1,1,18285,18286,18287,1,2,0
5238,4,3,18289,18289,18292,0,3,2
5239,1,1,18290,18292,18293,2,3,0
5240,1,1,18291,18293,18294,2,3,0
5241,3,1,18294,18294,18295,0,1,0
5242,5,3,18299,18299,18302,0,3,4
5243,4,2,18303,18303,18305,0,2,1
5244,6,1,18309,18309,18310,0,1,4
5245,4,1,18313,18313,18314,0,1,3
5246,1,1,18314,18314,18315,0,1,0
5247,6,2,18320,18320,18322,0,2,5
5248,3,1,18323,18323,18324,0,1,1
5249,4,3,18327,18327,18330,0,3,3
5250,1,2,18328,18330,18332,2,4,0
5251,1,1,18329,18332,18333,3,4,0
5252,3,3,18332,18333,18336,1,4,0
5253,5,2,18337,18337,18339,0,2,1
5254,6,3,18343,18343,18346,0,3,4
5255,3,2,18346,18346,18348,0,2,0
5256,2,2,18348,18348,18350,0,2,0
5257,2,1,18350,18350,18351,0,1,0
5258,3,3,18353,18353,18356,0,3,2
5259,1,2,18354,18356,18358,2,4,0
5260,3,3,18357,18358,18361,1,4,0
5261,1,1,18358,18361,18362,3,4,0
5262,6,3,18364,18364,18367,0,3,2
5263,4,3,18368,18368,18371,0,3,1
5264,4,1,18372,18372,18373,0,1,1
5265,2,1,18374,18374,18375,0,1,1
5266,5,1,18379,18379,18380,0,1,4
5267,4,1,18383,18383,18384,0,1,3
5268,1,2,18384,18384,18386,0,2,0
5269,3,2,18387,18387,18389,0,2,1
5270,3,3,18390,18390,18393,0,3,1
5271,4,3,18394,18394,18397,0,3,1
5272,1,1,18395,18397,18398,2,3,0
5273,6,1,18401,18401,18402,0,1,3
5274,1,1,18402,18402,18403,0,1,0
5275,4,1,18406,18406,18407,0,1,3
5276,2,3,18408,18408,18411,0,3,1
5277,1,1,18409,18411,18412,2,3,0
5278,5,3,18414,18414,18417,0,3,2
5279,1,2,18415,18417,18419,2,4,0
5280,4,2,18419,18419,18421,0,2,0
5281,5,1,18424,18424,18425,0,1,3
5282,1,1,18425,18425,18426,0,1,0
5283,5,2,18430,18430,18432,0,2,4
5284,5,2,18435,18435,18437,0,2,3
5285,1,2,18436,18437,18439,1,3,0
5286,4,2,18440,18440,18442,0,2,1
5287,6,2,18446,18446,18448,0,2,4
5288,2,2,18448,18448,18450,0,2,0
5289,6,1,18454,18454,18455,0,1,4
5290,2,1,18456,18456,18457,0,1,1
5291,2,1,18458,18458,18459,0,1,1
5292,3,2,18461,18461,18463,0,2,2
5293,3,2,18464,18464,18466,0,2,1
5294,3,3,18467,18467,18470,0,3,1
5295,6,2,18473,18473,18475,0,2,3
5296,1,2,18474,18475,18477,1,3,0
5297,6,1,18480,18480,18481,0,1,3
5298,6,3,18486,18486,18489,0,3,5
5299,6,1,18492,18492,18493,0,1,3
5300,1,2,18493,18493,18495,0,2,0
5301,2,3,18495,18495,18498,0,3,0
5302,6,1,18501,18501,18502,0,1,3
5303,2,1,18503,18503,18504,0,1,1
5304,4,2,18507,18507,18509,0,2,3
5305,2,2,18509,18509,18511,0,2,0
5306,3,2,18512,18512,18514,0,2,1
5307,2,3,18514,18514,18517,0,3,0
5308,1,1,18515,18517,18518,2,3,0
5309,5,2,18520,18520,18522,0,2,2
5310,2,1,18522,18522,18523,0,1,0
5311,5,1,18527,18527,18528,0,1,4
5312,3,1,18530,18530,18531,0,1,2
5313,6,2,18536,18536,18538,0,2,5
5314,4,3,18540,18540,18543,0,3,2
5315,1,3,18541,18543,18546,2,5,0
5316,2,1,18543,18546,18547,3,4,0
5317,3,3,18546,18547,18550,1,4,0
5318,3,1,18549,18550,18551,1,2,0
5319,6,3,18555,18555,18558,0,3,4
5320,4,2,18559,18559,18561,0,2,1
5321,3,2,18562,18562,18564,0,2,1
5322,6,3,18568,18568,18571,0,3,4
5323,6,2,18574,18574,18576,0,2,3
5324,4,3,18578,18578,18581,0,3,2
5325,5,3,18583,18583,18586,0,3,2
5326,2,3,18585,18586,18589,1,4,0
5327,4,3,18589,18589,18592,0,3,0
5328,6,2,18595,18595,18597,0,2,3
5329,5,3,18600,18600,18603,0,3,3
5330,4,2,18604,18604,18606,0,2,1
5331,3,3,18607,18607,18610,0,3,1
5332,4,3,18611,18611,18614,0,3,1
5333,2,1,18613,18614,18615,1,2,0
5334,6,2,18619,18619,18621,0,2,4
5335,5,3,18624,18624,18627,0,3,3
5336,1,2,18625,18627,18629,2,4,0
5337,3,1,18628,18629,18630,1,2,0
5338,3,1,18631,18631,18632,0,1,1
5339,3,1,18634,18634,18635,0,1,2
5340,3,3,18637,18637,18640,0,3,2
5341,6,1,18643,18643,18644,0,1,3
5342,6,1,18649,18649,18650,0,1,5
5343,6,1,18655,18655,18656,0,1,5
5344,5,1,18660,18660,18661,0,1,4
5345,2,1,18662,18662,18663,0,1,1
5346,6,2,18668,18668,18670,0,2,5
5347,3,3,18671,18671,18674,0,3,1
5348,1,1,18672,18674,18675,2,3,0
5349,5,2,18677,18677,18679,0,2,2
5350,6,1,18683,18683,18684,0,1,4
5351,6,1,18689,18689,18690,0,1,5
5352,2,3,18691,18691,18694,0,3,1
5353,5,1,18696,18696,18697,0,1,2
5354,5,3,18701,18701,18704,0,3,4
5355,2,2,18703,18704,18706,1,3,0
5356,1,3,18704,18706,18709,2,5,0
5357,5,3,18709,18709,18712,0,3,0
5358,4,3,18713,18713,18716,0,3,1
5359,6,2,18719,18719,18721,0,2,3
5360,3,1,18722,18722,18723,0,1,1
5361,2,2,18724,18724,18726,0,2,1
5362,4,2,18728,18728,18730,0,2,2
5363,1,2,18729,18730,18732,1,3,0
5364,5,2,18734,18734,18736,0,2,2
5365,3,1,18737,18737,18738,0,1,1
5366,3,3,18740,18740,18743,0,3,2
5367,6,1,18746,18746,18747,0,1,3
5368,6,2,18752,18752,18754,0,2,5
5369,4,3,18756,18756,18759,0,3,2
5370,3,3,18759,18759,18762,0,3,0
5371,5,1,18764,18764,18765,0,1,2
5372,4,3,18768,18768,18771,0,3,3
5373,4,1,18772,18772,18773,0,1,1
5374,1,2,18773,18773,18775,0,2,0
5375,4,3,18777,18777,18780,0,3,2
5376,3,3,18780,18780,18783,0,3,0
5377,6,2,18786,18786,18788,0,2,3
5378,4,1,18790,18790,18791,0,1,2
5379,3,1,18793,18793,18794,0,1,2
5380,6,2,18799,18799,18801,0,2,5
5381,6,3,18805,18805,18808,0,3,4
5382,6,1,18811,18811,18812,0,1,3
5383,2,1,18813,18813,18814,0,1,1
5384,4,1,18817,18817,18818,0,1,3
5385,1,2,18818,18818,18820,0,2,0
5386,3,1,18821,18821,18822,0,1,1
5387,1,3,18822,18822,18825,0,3,0
5388,4,1,18826,18826,18827,0,1,1
5389,1,3,18827,18827,18830,0,3,0
5390,1,2,18828,18830,18832,2,4,0
5391,3,2,18831,18832,18834,1,3,0
5392,2,3,18833,18834,18837,1,4,0
5393,2,1,18835,18837,18838,2,3,0
5394,4,1,18839,18839,18840,0,1,1
5395,1,1,18840,18840,18841,0,1,0
5396,3,1,18843,18843,18844,0,1,2
5397,5,2,18848,18848,18850,0,2,4
5398,5,2,18853,18853,18855,0,2,3
5399,1,1,18854,18855,18856,1,2,0
5400,5,2,18859,18859,18861,0,2,3
5401,1,2,18860,18861,18863,1,3,0
5402,3,1,18863,18863,18864,0,1,0
5403,1,3,18864,18864,18867,0,3,0
5404,1,1,18865,18867,18868,2,3,0
5405,4,1,18869,18869,18870,0,1,1
5406,1,1,18870,18870,18871,0,1,0
5407,6,1,18876,18876,18877,0,1,5
5408,4,1,18880,18880,18881,0,1,3
5409,5,1,18885,18885,18886,0,1,4
5410,6,1,18891,18891,18892,0,1,5
5411,4,2,18895,18895,18897,0,2,3
5412,5,1,18900,18900,18901,0,1,3
5413,5,1,18905,18905,18906,0,1,4
5414,4,3,18909,18909,18912,0,3,3
5415,2,3,18911,18912,18915,1,4,0
5416,2,2,18913,18915,18917,2,4,0
5417,6,3,18919,18919,18922,0,3,2
5418,2,1,18921,18922,18923,1,2,0
5419,4,2,18925,18925,18927,0,2,2
5420,6,2,18931,18931,18933,0,2,4
5421,1,1,18932,18933,18934,1,2,0
5422,2,1,18934,18934,18935,0,1,0
5423,5,2,18939,18939,18941,0,2,4
5424,6,1,18945,18945,18946,0,1,4
5425,3,3,18948,18948,18951,0,3,2
5426,6,1,18954,18954,18955,0,1,3
5427,5,2,18959,18959,18961,0,2,4
5428,4,3,18963,18963,18966,0,3,2
5429,1,3,18964,18966,18969,2,5,0
5430,2,1,18966,18969,18970,3,4,0
5431,3,1,18969,18970,18971,1,2,0
5432,2,3,18971,18971,18974,0,3,0
5433,1,2,18972,18974,18976,2,4,0
5434,5,2,18977,18977,18979,0,2,1
5435,5,1,18982,18982,18983,0,1,3
5436,6,3,18988,18988,18991,0,3,5
5437,4,2,18992,18992,18994,0,2,1
5438,1,1,18993,18994,18995,1,2,0
5439,4,2,18997,18997,18999,0,2,2
5440,1,1,18998,18999,19000,1,2,0
5441,3,3,19001,19001,19004,0,3,1
5442,2,2,19003,19004,19006,1,3,0
5443,4,3,19007,19007,19010,0,3,1
5444,1,3,19008,19010,19013,2,5,0
5445,5,2,19013,19013,19015,0,2,0
5446,4,3,19017,19017,19020,0,3,2
5447,2,3,19019,19020,19023,1,4,0
5448,5,2,19024,19024,19026,0,2,1
5449,4,3,19028,19028,19031,0,3,2
5450,4,3,19032,19032,19035,0,3,1
5451,2,1,19034,19035,19036,1,2,0
5452,5,1,19039,19039,19040,0,1,3
5453,2,1,19041,19041,19042,0,1,1
5454,6,2,19047,19047,19049,0,2,5
5455,6,3,19053,19053,19056,0,3,4
5456,5,2,19058,19058,19060,0,2,2
5457,1,3,19059,19060,19063,1,4,0
5458,3,3,19062,19063,19066,1,4,0
5459,5,1,19067,19067,19068,0,1,1
5460,3,3,19070,19070,19073,0,3,2
5461,2,3,19072,19073,19076,1,4,0
5462,5,2,19077,19077,19079,0,2,1
5463,4,3,19081,19081,19084,0,3,2
5464,5,2,19086,19086,19088,0,2,2
5465,1,1,19087,19088,19089,1,2,0
5466,3,3,19090,19090,19093,0,3,1
5467,5,3,19095,19095,19098,0,3,2
5468,3,1,19098,19098,19099,0,1,0
5469,5,2,19103,19103,19105,0,2,4
5470,6,1,19109,19109,19110,0,1,4
5471,4,2,19113,19113,19115,0,2,3
5472,2,3,19115,19115,19118,0,3,0
5473,3,3,19118,19118,19121,0,3,0
5474,3,1,19121,19121,19122,0,1,0
5475,3,2,19124,19124,19126,0,2,2
5476,5,2,19129,19129,19131,0,2,3
5477,3,2,19132,19132,19134,0,2,1
5478,5,1,19137,19137,19138,0,1,3
5479,3,3,19140,19140,19143,0,3,2
5480,2,2,19142,19143,19145,1,3,0
5481,1,2,19143,19145,19147,2,4,0
5482,4,2,19147,19147,19149,0,2,0
5483,4,1,19151,19151,19152,0,1,2
5484,4,3,19155,19155,19158,0,3,3
5485,1,3,19156,19158,19161,2,5,0
5486,5,1,19161,19161,19162,0,1,0
5487,6,2,19167,19167,19169,0,2,5
5488,4,1,19171,19171,19172,0,1,2
5489,2,2,19173,19173,19175,0,2,1
5490,6,1,19179,19179,19180,0,1,4
5491,4,2,19183,19183,19185,0,2,3
5492,2,2,19185,19185,19187,0,2,0
5493,1,1,19186,19187,19188,1,2,0
5494,3,3,19189,19189,19192,0,3,1
5495,5,2,19194,19194,19196,0,2,2
5496,3,1,19197,19197,19198,0,1,1
5497,3,3,19200,19200,19203,0,3,2
5498,6,1,19206,19206,19207,0,1,3
5499,2,2,19208,19208,19210,0,2,1
5500,6,3,19214,19214,19217,0,3,4
5501,5,2,19219,19219,19221,0,2,2
5502,6,2,19225,19225,19227,0,2,4
5503,4,3,19229,19229,19232,0,3,2
5504,6,2,19235,19235,19237,0,2,3
5505,3,3,19238,19238,19241,0,3,1
5506,3,2,19241,19241,19243,0,2,0
5507,6,2,19247,19247,19249,0,2,4
5508,5,3,19252,19252,19255,0,3,3
5509,5,1,19257,19257,19258,0,1,2
5510,6,2,19263,19263,19265,0,2,5
5511,6,2,19269,19269,19271,0,2,4
5512,3,1,19272,19272,19273,0,1,1
5513,6,3,19278,19278,19281,0,3,5
5514,5,1,19283,19283,19284,0,1,2
5515,2,2,19285,19285,19287,0,2,1
5516,2,2,19287,19287,19289,0,2,0
5517,1,3,19288,19289,19292,1,4,0
5518,4,2,19292,19292,19294,0,2,0
5519,3,3,19295,19295,19298,0,3,1
5520,1,1,19296,19298,19299,2,3,0
5521,2,3,19298,19299,19302,1,4,0
5522,4,1,19302,19302,19303,0,1,0
5523,2,2,19304,19304,19306,0,2,1
5524,3,2,19307,19307,19309,0,2,1
5525,1,2,19308,19309,19311,1,3,0
5526,5,2,19313,19313,19315,0,2,2
5527,5,2,19318,19318,19320,0,2,3
5528,4,2,19322,19322,19324,0,2,2
5529,4,1,19326,19326,19327,0,1,2
5530,1,3,19327,19327,19330,0,3,0
5531,2,3,19329,19330,19333,1,4,0
5532,5,2,19334,19334,19336,0,2,1
5533,2,2,19336,19336,19338,0,2,0
5534,2,3,19338,19338,19341,0,3,0
5535,3,1,19341,19341,19342,0,1,0
5536,4,1,19345,19345,19346,0,1,3
5537,1,1,19346,19346,19347,0,1,0
5538,4,2,19350,19350,19352,0,2,3
5539,1,2,19351,19352,19354,1,3,0
5540,3,2,19354,19354,19356,0,2,0
5541,4,3,19358,19358,19361,0,3,2
5542,4,2,19362,19362,19364,0,2,1
5543,5,2,19367,19367,19369,0,2,3
5544,4,3,19371,19371,19374,0,3,2
5545,4,3,19375,19375,19378,0,3,1
5546,6,1,19381,19381,19382,0,1,3
5547,3,3,19384,19384,19387,0,3,2
5548,4,2,19388,19388,19390,0,2,1
5549,5,1,19393,19393,19394,0,1,3
5550,5,1,19398,19398,19399,0,1,4
5551,5,2,19403,19403,19405,0,2,4
5552,4,3,19407,19407,19410,0,3,2
5553,1,2,19408,19410,19412,2,4,0
5554,3,2,19411,19412,19414,1,3,0
5555,2,2,19413,19414,19416,1,3,0
5556,1,3,19414,19416,19419,2,5,0
5557,4,2,19418,19419,19421,1,3,0
5558,2,1,19420,19421,19422,1,2,0
5559,5,2,19425,19425,19427,0,2,3
5560,2,3,19427,19427,19430,0,3,0
5561,3,1,19430,19430,19431,0,1,0
5562,2,3,19432,19432,19435,0,3,1
5563,1,3,19433,19435,19438,2,5,0
5564,2,2,19435,19438,19440,3,5,0
5565,5,3,19440,19440,19443,0,3,0
5566,1,1,19441,19443,19444,2,3,0
5567,4,1,19445,19445,19446,0,1,1
5568,6,2,19451,19451,19453,0,2,5
5569,5,3,19456,19456,19459,0,3,3
5570,1,2,19457,19459,19461,2,4,0
5571,6,2,19463,19463,19465,0,2,2
5572,4,1,19467,19467,19468,0,1,2
5573,1,1,19468,19468,19469,0,1,0
5574,3,2,19471,19471,19473,0,2,2
5575,1,3,19472,19473,19476,1,4,0
5576,4,1,19476,19476,19477,0,1,0
5577,1,3,19477,19477,19480,0,3,0
5578,1,2,19478,19480,19482,2,4,0
5579,1,2,19479,19482,19484,3,5,0
5580,3,1,19482,19484,19485,2,3,0
5581,1,3,19483,19485,19488,2,5,0
5582,3,2,19486,19488,19490,2,4,0
5583,6,3,19492,19492,19495,0,3,2
5584,1,3,19493,19495,19498,2,5,0
5585,5,3,19498,19498,19501,0,3,0
5586,6,2,19504,19504,19506,0,2,3
5587,6,2,19510,19510,19512,0,2,4
5588,1,2,19511,19512,19514,1,3,0
5589,5,2,19516,19516,19518,0,2,2
5590,4,3,19520,19520,19523,0,3,2
5591,1,3,19521,19523,19526,2,5,0
5592,1,2,19522,19526,19528,4,6,0
5593,6,1,19528,19528,19529,0,1,0
5594,6,1,19534,19534,19535,0,1,5
5595,6,3,19540,19540,19543,0,3,5
5596,2,2,19542,19543,19545,1,3,0
5597,6,1,19548,19548,19549,0,1,3
5598,5,2,19553,19553,19555,0,2,4
5599,5,3,19558,19558,19561,0,3,3
5600,4,1,19562,19562,19563,0,1,1
5601,4,2,19566,19566,19568,0,2,3
5602,4,3,19570,19570,19573,0,3,2
5603,1,3,19571,19573,19576,2,5,0
5604,4,2,19575,19576,19578,1,3,0
5605,4,2,19579,19579,19581,0,2,1
5606,1,3,19580,19581,19584,1,4,0
5607,4,2,19584,19584,19586,0,2,0
5608,3,1,19587,19587,19588,0,1,1
5609,4,1,19591,19591,19592,0,1,3
5610,2,1,19593,19593,19594,0,1,1
5611,2,2,19595,19595,19597,0,2,1
5612,3,2,19598,19598,19600,0,2,1
5613,6,3,19604,19604,19607,0,3,4
5614,1,2,19605,19607,19609,2,4,0
5615,4,2,19609,19609,19611,0,2,0
5616,3,2,19612,19612,19614,0,2,1
5617,5,3,19617,19617,19620,0,3,3
5618,1,1,19618,19620,19621,2,3,0
5619,2,1,19620,19621,19622,1,2,0
5620,2,3,19622,19622,19625,0,3,0
5621,1,2,19623,19625,19627,2,4,0
5622,2,2,19625,19627,19629,2,4,0
5623,3,1,19628,19629,19630,1,2,0
5624,3,2,19631,19631,19633,0,2,1
5625,5,3,19636,19636,19639,0,3,3
5626,3,2,19639,19639,19641,0,2,0
5627,4,2,19643,19643,19645,0,2,2
5628,6,2,19649,19649,19651,0,2,4
5629,5,1,19654,19654,19655,0,1,3
5630,4,2,19658,19658,19660,0,2,3
5631,6,1,19664,19664,19665,0,1,4
5632,3,2,19667,19667,19669,0,2,2
5633,2,1,19669,19669,19670,0,1,0
5634,5,3,19674,19674,19677,0,3,4
5635,2,2,19676,19677,19679,1,3,0
5636,6,3,19682,19682,19685,0,3,3
5637,5,2,19687,19687,19689,0,2,2
5638,1,1,19688,19689,19690,1,2,0
5639,6,1,19694,19694,19695,0,1,4
5640,4,1,19698,19698,19699,0,1,3
5641,1,2,19699,19699,19701,0,2,0
5642,2,2,19701,19701,19703,0,2,0
5643,3,1,19704,19704,19705,0,1,1
5644,4,2,19708,19708,19710,0,2,3
5645,6,2,19714,19714,19716,0,2,4
5646,4,2,19718,19718,19720,0,2,2
5647,4,1,19722,19722,19723,0,1,2
5648,6,1,19728,19728,19729,0,1,5
5649,2,2,19730,19730,19732,0,2,1
5650,1,2,19731,19732,19734,1,3,0
5651,6,1,19737,19737,19738,0,1,3
5652,5,2,19742,19742,19744,0,2,4
5653,3,2,19745,19745,19747,0,2,1
5654,5,1,19750,19750,19751,0,1,3
5655,2,2,19752,19752,19754,0,2,1
5656,5,3,19757,19757,19760,0,3,3
5657,1,1,19758,19760,19761,2,3,0
5658,5,2,19763,19763,19765,0,2,2
5659,3,1,19766,19766,19767,0,1,1
5660,6,2,19772,19772,19774,0,2,5
5661,6,1,19778,19778,19779,0,1,4
5662,2,2,19780,19780,19782,0,2,1
5663,2,2,19782,19782,19784,0,2,0
5664,2,2,19784,19784,19786,0,2,0
5665,4,1,19788,19788,19789,0,1,2
5666,2,1,19790,19790,19791,0,1,1
5667,4,3,19794,19794,19797,0,3,3
5668,5,3,19799,19799,19802,0,3,2
5669,1,2,19800,19802,19804,2,4,0
5670,6,1,19806,19806,19807,0,1,2
5671,3,3,19809,19809,19812,0,3,2
5672,6,3,19815,19815,19818,0,3,3
5673,1,2,19816,19818,19820,2,4,0
5674,1,2,19817,19820,19822,3,5,0
5675,6,2,19823,19823,19825,0,2,1
5676,6,1,19829,19829,19830,0,1,4
5677,5,3,19834,19834,19837,0,3,4
5678,2,1,19836,19837,19838,1,2,0
5679,2,3,19838,19838,19841,0,3,0
5680,2,3,19840,19841,19844,1,4,0
5681,2,2,19842,19844,19846,2,4,0
5682,1,1,19843,19846,19847,3,4,0
5683,3,3,19846,19847,19850,1,4,0
5684,6,3,19852,19852,19855,0,3,2
5685,5,1,19857,19857,19858,0,1,2
5686,2,1,19859,19859,19860,0,1,1
5687,4,1,19863,19863,19864,0,1,3
5688,6,2,19869,19869,19871,0,2,5
5689,4,3,19873,19873,19876,0,3,2
5690,2,3,19875,19876,19879,1,4,0
5691,3,3,19878,19879,19882,1,4,0
5692,1,2,19879,19882,19884,3,5,0
5693,2,2,19881,19884,19886,3,5,0
5694,6,1,19887,19887,19888,0,1,1
5695,4,2,19891,19891,19893,0,2,3
5696,2,3,19893,19893,19896,0,3,0
5697,1,2,19894,19896,19898,2,4,0
5698,1,3,19895,19898,19901,3,6,0
5699,6,2,19901,19901,19903,0,2,0
5700,5,1,19906,19906,19907,0,1,3
5701,2,3,19908,19908,19911,0,3,1
5702,1,2,19909,19911,19913,2,4,0
5703,6,2,19915,19915,19917,0,2,2
5704,6,2,19921,19921,19923,0,2,4
5705,3,1,19924,19924,19925,0,1,1
5706,5,1,19929,19929,19930,0,1,4
5707,6,3,19935,19935,19938,0,3,5
5708,4,3,19939,19939,19942,0,3,1
5709,4,3,19943,19943,19946,0,3,1
5710,6,1,19949,19949,19950,0,1,3
5711,1,3,19950,19950,19953,0,3,0
5712,1,2,19951,19953,19955,2,4,0
5713,3,2,19954,19955,19957,1,3,0
5714,3,3,19957,19957,19960,0,3,0
5715,4,2,19961,19961,19963,0,2,1
5716,1,3,19962,19963,19966,1,4,0
5717,3,1,19965,19966,19967,1,2,0
5718,1,2,19966,19967,19969,1,3,0
5719,5,3,19971,19971,19974,0,3,2
5720,4,2,19975,19975,19977,0,2,1
5721,4,1,19979,19979,19980,0,1,2
5722,3,1,19982,19982,19983,0,1,2
5723,4,2,19986,19986,19988,0,2,3
5724,3,2,19989,19989,19991,0,2,1
5725,1,3,19990,19991,19994,1,4,0
5726,2,2,19992,19994,19996,2,4,0
5727,6,1,19998,19998,19999,0,1,2
5728,1,2,19999,19999,20001,0,2,0
5729,3,3,20002,20002,20005,0,3,1
5730,2,1,20004,20005,20006,1,2,0
5731,5,3,20009,20009,20012,0,3,3
5732,1,1,20010,20012,20013,2,3,0
5733,4,1,20014,20014,20015,0,1,1
5734,6,3,20020,20020,20023,0,3,5
5735,4,3,20024,20024,20027,0,3,1
5736,2,1,20026,20027,20028,1,2,0
5737,6,1,20032,20032,20033,0,1,4
5738,4,3,20036,20036,20039,0,3,3
5739,2,2,20038,20039,20041,1,3,0
5740,5,3,20043,20043,20046,0,3,2
5741,3,2,20046,20046,20048,0,2,0
5742,2,3,20048,20048,20051,0,3,0
5743,6,2,20054,20054,20056,0,2,3
5744,5,3,20059,20059,20062,0,3,3
5745,4,1,20063,20063,20064,0,1,1
5746,2,1,20065,20065,20066,0,1,1
5747,6,3,20071,20071,20074,0,3,5
5748,4,1,20075,20075,20076,0,1,1
5749,5,2,20080,20080,20082,0,2,4
5750,5,1,20085,20085,20086,0,1,3
5751,6,3,20091,20091,20094,0,3,5
5752,4,1,20095,20095,20096,0,1,1
5753,6,2,20101,20101,20103,0,2,5
5754,2,1,20103,20103,20104,0,1,0
5755,6,2,20109,20109,20111,0,2,5
5756,2,1,20111,20111,20112,0,1,0
5757,3,1,20114,20114,20115,0,1,2
5758,5,2,20119,20119,20121,0,2,4
5759,1,1,20120,20121,20122,1,2,0
5760,1,2,20121,20122,20124,1,3,0
5761,4,1,20125,20125,20126,0,1,1
5762,6,1,20131,20131,20132,0,1,5
5763,2,3,20133,20133,20136,0,3,1
5764,3,3,20136,20136,20139,0,3,0
5765,1,2,20137,20139,20141,2,4,0
5766,6,3,20143,20143,20146,0,3,2
5767,3,2,20146,20146,20148,0,2,0
5768,3,3,20149,20149,20152,0,3,1
5769,3,3,20152,20152,20155,0,3,0
5770,4,2,20156,20156,20158,0,2,1
5771,2,2,20158,20158,20160,0,2,0
5772,5,2,20163,20163,20165,0,2,3
5773,3,2,20166,20166,20168,0,2,1
5774,5,3,20171,20171,20174,0,3,3
5775,2,3,20173,20174,20177,1,4,0
5776,2,2,20175,20177,20179,2,4,0
5777,2,1,20177,20179,20180,2,3,0
5778,2,1,20179,20180,20181,1,2,0
5779,4,1,20183,20183,20184,0,1,2
5780,4,1,20187,20187,20188,0,1,3
5781,3,2,20190,20190,20192,0,2,2
5782,3,1,20193,20193,20194,0,1,1
5783,5,2,20198,20198,20200,0,2,4
5784,6,2,20204,20204,20206,0,2,4
5785,1,3,20205,20206,20209,1,4,0
5786,1,3,20206,20209,20212,3,6,0
5787,6,3,20212,20212,20215,0,3,0
5788,6,3,20218,20218,20221,0,3,3
5789,3,3,20221,20221,20224,0,3,0
5790,1,2,20222,20224,20226,2,4,0
5791,5,3,20227,20227,20230,0,3,1
5792,5,3,20232,20232,20235,0,3,2
5793,6,1,20238,20238,20239,0,1,3
5794,1,1,20239,20239,20240,0,1,0
5795,4,2,20243,20243,20245,0,2,3
5796,1,2,20244,20245,20247,1,3,0
5797,6,3,20250,20250,20253,0,3,3
5798,1,1,20251,20253,20254,2,3,0
5799,4,1,20255,20255,20256,0,1,1
5800,2,3,20257,20257,20260,0,3,1
5801,3,1,20260,20260,20261,0,1,0
5802,5,1,20265,20265,20266,0,1,4
5803,2,2,20267,20267,20269,0,2,1
5804,2,2,20269,20269,20271,0,2,0
5805,2,2,20271,20271,20273,0,2,0
5806,1,2,20272,20273,20275,1,3,0
5807,3,1,20275,20275,20276,0,1,0
5808,3,1,20278,20278,20279,0,1,2
5809,3,1,20281,20281,20282,0,1,2
5810,6,3,20287,20287,20290,0,3,5
5811,5,1,20292,20292,20293,0,1,2
5812,4,1,20296,20296,20297,0,1,3
5813,2,1,20298,20298,20299,0,1,1
5814,4,2,20302,20302,20304,0,2,3
5815,6,3,20308,20308,20311,0,3,4
5816,5,1,20313,20313,20314,0,1,2
5817,3,2,20316,20316,20318,0,2,2
5818,3,2,20319,20319,20321,0,2,1
5819,3,3,20322,20322,20325,0,3,1
5820,2,2,20324,20325,20327,1,3,0
5821,1,1,20325,20327,20328,2,3,0
5822,5,2,20330,20330,20332,0,2,2
5823,6,3,20336,20336,20339,0,3,4
5824,3,1,20339,20339,20340,0,1,0
5825,1,1,20340,20340,20341,0,1,0
5826,3,1,20343,20343,20344,0,1,2
5827,2,3,20345,20345,20348,0,3,1
5828,5,3,20350,20350,20353,0,3,2
5829,4,3,20354,20354,20357,0,3,1
5830,1,2,20355,20357,20359,2,4,0
5831,1,2,20356,20359,20361,3,5,0
5832,2,1,20358,20361,20362,3,4,0
5833,4,1,20362,20362,20363,0,1,0
5834,6,2,20368,20368,20370,0,2,5
5835,1,2,20369,20370,20372,1,3,0
5836,3,2,20372,20372,20374,0,2,0
5837,6,2,20378,20378,20380,0,2,4
5838,3,1,20381,20381,20382,0,1,1
5839,2,1,20383,20383,20384,0,1,1
5840,6,1,20389,20389,20390,0,1,5
5841,4,2,20393,20393,20395,0,2,3
5842,6,2,20399,20399,20401,0,2,4
5843,1,3,20400,20401,20404,1,4,0
5844,1,2,20401,20404,20406,3,5,0
5845,5,3,20406,20406,20409,0,3,0
5846,3,3,20409,20409,20412,0,3,0
5847,4,3,20413,20413,20416,0,3,1
5848,5,1,20418,20418,20419,0,1,2
5849,5,3,20423,20423,20426,0,3,4
5850,5,1,20428,20428,20429,0,1,2
5851,2,3,20430,20430,20433,0,3,1
5852,2,1,20432,20433,20434,1,2,0
5853,2,3,20434,20434,20437,0,3,0
5854,5,1,20439,20439,20440,0,1,2
5855,1,1,20440,20440,20441,0,1,0
5856,3,3,20443,20443,20446,0,3,2
5857,6,1,20449,20449,20450,0,1,3
5858,5,1,20454,20454,20455,0,1,4
5859,1,1,20455,20455,20456,0,1,0
5860,6,1,20461,20461,20462,0,1,5
5861,2,1,20463,20463,20464,0,1,1
5862,3,3,20466,20466,20469,0,3,2
5863,3,2,20469,20469,20471,0,2,0
5864,6,2,20475,20475,20477,0,2,4
5865,3,3,20478,20478,20481,0,3,1
5866,4,1,20482,20482,20483,0,1,1
5867,1,1,20483,20483,20484,0,1,0
5868,4,3,20487,20487,20490,0,3,3
5869,6,2,20493,20493,20495,0,2,3
5870,1,3,20494,20495,20498,1,4,0
5871,3,1,20497,20498,20499,1,2,0
5872,3,1,20500,20500,20501,0,1,1
5873,1,3,20501,20501,20504,0,3,0
5874,2,2,20503,20504,20506,1,3,0
5875,3,1,20506,20506,20507,0,1,0
5876,5,1,20511,20511,20512,0,1,4
5877,6,2,20517,20517,20519,0,2,5
5878,5,1,20522,20522,20523,0,1,3
5879,2,2,20524,20524,20526,0,2,1
5880,5,1,20529,20529,20530,0,1,3
5881,2,1,20531,20531,20532,0,1,1
5882,4,1,20535,20535,20536,0,1,3
5883,2,1,20537,20537,20538,0,1,1
5884,6,2,20543,20543,20545,0,2,5
5885,3,3,20546,20546,20549,0,3,1
5886,5,1,20551,20551,20552,0,1,2
5887,4,2,20555,20555,20557,0,2,3
5888,5,3,20560,20560,20563,0,3,3
5889,3,3,20563,20563,20566,0,3,0
5890,6,1,20569,20569,20570,0,1,3
5891,2,1,20571,20571,20572,0,1,1
5892,3,1,20574,20574,20575,0,1,2
5893,4,1,20578,20578,20579,0,1,3
5894,2,2,20580,20580,20582,0,2,1
5895,4,3,20584,20584,20587,0,3,2
5896,4,3,20588,20588,20591,0,3,1
5897,1,2,20589,20591,20593,2,4,0
5898,3,1,20592,20593,20594,1,2,0
5899,6,1,20598,20598,20599,0,1,4
5900,6,1,20604,20604,20605,0,1,5
5901,1,2,20605,20605,20607,0,2,0
5902,2,2,20607,20607,20609,0,2,0
5903,2,2,20609,20609,20611,0,2,0
5904,6,2,20615,20615,20617,0,2,4
5905,3,1,20618,20618,20619,0,1,1
5906,1,1,20619,20619,20620,0,1,0
5907,3,2,20622,20622,20624,0,2,2
5908,3,2,20625,20625,20627,0,2,1
5909,5,1,20630,20630,20631,0,1,3
5910,6,1,20636,20636,20637,0,1,5
5911,3,2,20639,20639,20641,0,2,2
5912,4,1,20643,20643,20644,0,1,2
5913,1,2,20644,20644,20646,0,2,0
5914,3,1,20647,20647,20648,0,1,1
5915,5,2,20652,20652,20654,0,2,4
5916,6,1,20658,20658,20659,0,1,4
5917,3,2,20661,20661,20663,0,2,2
5918,6,2,20667,20667,20669,0,2,4
5919,3,1,20670,20670,20671,0,1,1
5920,1,2,20671,20671,20673,0,2,0
5921,6,1,20677,20677,20678,0,1,4
5922,5,2,20682,20682,20684,0,2,4
5923,6,1,20688,20688,20689,0,1,4
5924,5,1,20693,20693,20694,0,1,4
5925,4,1,20697,20697,20698,0,1,3
5926,4,3,20701,20701,20704,0,3,3
5927,3,1,20704,20704,20705,0,1,0
5928,3,2,20707,20707,20709,0,2,2
5929,4,2,20711,20711,20713,0,2,2
5930,2,2,20713,20713,20715,0,2,0
5931,2,2,20715,20715,20717,0,2,0
5932,1,2,20716,20717,20719,1,3,0
5933,6,2,20722,20722,20724,0,2,3
5934,4,3,20726,20726,20729,0,3,2
5935,3,1,20729,20729,20730,0,1,0
5936,6,2,20735,20735,20737,0,2,5
5937,2,1,20737,20737,20738,0,1,0
5938,4,3,20741,20741,20744,0,3,3
5939,3,3,20744,20744,20747,0,3,0
5940,4,1,20748,20748,20749,0,1,1
5941,5,2,20753,20753,20755,0,2,4
5942,1,3,20754,20755,20758,1,4,0
5943,4,3,20758,20758,20761,0,3,0
5944,5,1,20763,20763,20764,0,1,2
5945,1,2,20764,20764,20766,0,2,0
5946,4,3,20768,20768,20771,0,3,2
5947,1,3,20769,20771,20774,2,5,0
5948,4,2,20773,20774,20776,1,3,0
5949,5,1,20778,20778,20779,0,1,2
5950,6,3,20784,20784,20787,0,3,5
5951,4,2,20788,20788,20790,0,2,1
5952,2,2,20790,20790,20792,0,2,0
5953,4,3,20794,20794,20797,0,3,2
5954,4,1,20798,20798,20799,0,1,1
5955,6,1,20804,20804,20805,0,1,5
5956,1,1,20805,20805,20806,0,1,0
5957,3,1,20808,20808,20809,0,1,2
5958,6,3,20814,20814,20817,0,3,5
5959,1,3,20815,20817,20820,2,5,0
5960,6,3,20821,20821,20824,0,3,1
5961,6,3,20827,20827,20830,0,3,3
5962,3,1,20830,20830,20831,0,1,0
5963,3,1,20833,20833,20834,0,1,2
5964,3,2,20836,20836,20838,0,2,2
5965,5,1,20841,20841,20842,0,1,3
5966,4,1,20845,20845,20846,0,1,3
5967,4,2,20849,20849,20851,0,2,3
5968,3,3,20852,20852,20855,0,3,1
5969,2,1,20854,20855,20856,1,2,0
5970,4,3,20858,20858,20861,0,3,2
5971,6,3,20864,20864,20867,0,3,3
5972,3,1,20867,20867,20868,0,1,0
5973,1,3,20868,20868,20871,0,3,0
5974,2,3,20870,20871,20874,1,4,0
5975,5,3,20875,20875,20878,0,3,1
5976,3,1,20878,20878,20879,0,1,0
5977,2,2,20880,20880,20882,0,2,1
5978,2,3,20882,20882,20885,0,3,0
5979,3,2,20885,20885,20887,0,2,0
5980,5,3,20890,20890,20893,0,3,3
5981,6,2,20896,20896,20898,0,2,3
5982,2,2,20898,20898,20900,0,2,0
5983,6,1,20904,20904,20905,0,1,4
5984,4,1,20908,20908,20909,0,1,3
5985,5,1,20913,20913,20914,0,1,4
5986,1,2,20914,20914,20916,0,2,0
5987,5,2,20919,20919,20921,0,2,3
5988,4,1,20923,20923,20924,0,1,2
5989,6,2,20929,20929,20931,0,2,5
5990,1,1,20930,20931,20932,1,2,0
5991,3,3,20933,20933,20936,0,3,1
5992,6,1,20939,20939,20940,0,1,3
5993,6,1,20945,20945,20946,0,1,5
5994,2,3,20947,20947,20950,0,3,1
5995,6,3,20953,20953,20956,0,3,3
5996,2,3,20955,20956,20959,1,4,0
5997,3,2,20958,20959,20961,1,3,0
5998,5,1,20963,20963,20964,0,1,2
5999,2,1,20965,20965,20966,0,1,1
6000,1,1,20966,20966,20967,0,1,0
6001,3,1,20969,20969,20970,0,1,2
6002,1,2,20970,20970,20972,0,2,0
6003,2,3,20972,20972,20975,0,3,0
6004,4,1,20976,20976,20977,0,1,1
6005,3,3,20979,20979,20982,0,3,2
6006,4,1,20983,20983,20984,0,1,1
6007,3,3,20986,20986,20989,0,3,2
6008,6,1,20992,20992,20993,0,1,3
6009,2,2,20994,20994,20996,0,2,1
6010,2,1,20996,20996,20997,0,1,0
6011,6,1,21002,21002,21003,0,1,5
6012,6,1,21008,21008,21009,0,1,5
6013,5,1,21013,21013,21014,0,1,4
6014,3,1,21016,21016,21017,0,1,2
6015,6,2,21022,21022,21024,0,2,5
6016,5,3,21027,21027,21030,0,3,3
6017,3,2,21030,21030,21032,0,2,0
6018,2,2,21032,21032,21034,0,2,0
6019,5,2,21037,21037,21039,0,2,3
6020,5,3,21042,21042,21045,0,3,3
6021,5,3,21047,21047,21050,0,3,2
6022,4,3,21051,21051,21054,0,3,1
6023,4,2,21055,21055,21057,0,2,1
6024,3,3,21058,21058,21061,0,3,1
6025,2,3,21060,21061,21064,1,4,0
6026,1,1,21061,21064,21065,3,4,0
6027,3,3,21064,21065,21068,1,4,0
6028,4,3,21068,21068,21071,0,3,0
6029,3,2,21071,21071,21073,0,2,0
6030,4,1,21075,21075,21076,0,1,2
6031,2,3,21077,21077,21080,0,3,1
6032,3,1,21080,21080,21081,0,1,0
6033,2,2,21082,21082,21084,0,2,1
6034,1,1,21083,21084,21085,1,2,0
6035,1,3,21084,21085,21088,1,4,0
6036,2,2,21086,21088,21090,2,4,0
6037,2,2,21088,21090,21092,2,4,0
6038,3,1,21091,21092,21093,1,2,0
6039,2,2,21093,21093,21095,0,2,0
6040,3,3,21096,21096,21099,0,3,1
6041,1,3,21097,21099,21102,2,5,0
6042,3,3,21100,21102,21105,2,5,0
6043,5,1,21105,21105,21106,0,1,0
6044,4,2,21109,21109,21111,0,2,3
6045,1,3,21110,21111,21114,1,4,0
6046,1,1,21111,21114,21115,3,4,0
6047,2,3,21113,21115,21118,2,5,0
6048,1,3,21114,21118,21121,4,7,0
6049,6,3,21120,21121,21124,1,4,0
6050,4,3,21124,21124,21127,0,3,0
6051,5,1,21129,21129,21130,0,1,2
6052,6,2,21135,21135,21137,0,2,5
6053,5,2,21140,21140,21142,0,2,3
6054,3,3,21143,21143,21146,0,3,1
6055,6,2,21149,21149,21151,0,2,3
6056,6,1,21155,21155,21156,0,1,4
6057,6,3,21161,21161,21164,0,3,5
6058,4,3,21165,21165,21168,0,3,1
6059,6,3,21171,21171,21174,0,3,3
6060,1,1,21172,21174,21175,2,3,0
6061,5,1,21177,21177,21178,0,1,2
6062,2,2,21179,21179,21181,0,2,1
6063,5,3,21184,21184,21187,0,3,3
6064,5,2,21189,21189,21191,0,2,2
6065,4,1,21193,21193,21194,0,1,2
6066,3,3,21196,21196,21199,0,3,2
6067,6,2,21202,21202,21204,0,2,3
6068,4,3,21206,21206,21209,0,3,2
6069,6,2,21212,21212,21214,0,2,3
6070,3,2,21215,21215,21217,0,2,1
6071,1,2,21216,21217,21219,1,3,0
6072,4,3,21220,21220,21223,0,3,1
6073,4,3,21224,21224,21227,0,3,1
6074,1,2,21225,21227,21229,2,4,0
6075,5,3,21230,21230,21233,0,3,1
6076,1,2,21231,21233,21235,2,4,0
6077,3,1,21234,21235,21236,1,2,0
6078,5,3,21239,21239,21242,0,3,3
6079,1,1,21240,21242,21243,2,3,0
6080,3,2,21243,21243,21245,0,2,0
6081,3,2,21246,21246,21248,0,2,1
6082,1,3,21247,21248,21251,1,4,0
6083,3,1,21250,21251,21252,1,2,0
6084,4,3,21254,21254,21257,0,3,2
6085,3,2,21257,21257,21259,0,2,0
6086,1,2,21258,21259,21261,1,3,0
6087,3,2,21261,21261,21263,0,2,0
6088,6,1,21267,21267,21268,0,1,4
6089,2,1,21269,21269,21270,0,1,1
6090,6,3,21275,21275,21278,0,3,5
6091,5,2,21280,21280,21282,0,2,2
6092,4,2,21284,21284,21286,0,2,2
6093,1,2,21285,21286,21288,1,3,0
6094,5,3,21290,21290,21293,0,3,2
6095,3,1,21293,21293,21294,0,1,0
6096,6,3,21299,21299,21302,0,3,5
6097,1,2,21300,21302,21304,2,4,0
6098,6,1,21306,21306,21307,0,1,2
6099,3,1,21309,21309,21310,0,1,2
6100,4,3,21313,21313,21316,0,3,3
6101,2,2,21315,21316,21318,1,3,0
6102,1,2,21316,21318,21320,2,4,0
6103,6,3,21322,21322,21325,0,3,2
6104,1,3,21323,21325,21328,2,5,0
6105,1,3,21324,21328,21331,4,7,0
6106,1,2,21325,21331,21333,6,8,0
6107,6,3,21331,21333,21336,2,5,0
6108,3,1,21334,21336,21337,2,3,0
6109,3,3,21337,21337,21340,0,3,0
6110,6,3,21343,21343,21346,0,3,3
6111,1,1,21344,21346,21347,2,3,0
6112,4,2,21348,21348,21350,0,2,1
6113,4,1,21352,21352,21353,0,1,2
6114,3,2,21355,21355,21357,0,2,2
6115,6,1,21361,21361,21362,0,1,4
6116,4,1,21365,21365,21366,0,1,3
6117,3,3,21368,21368,21371,0,3,2
6118,2,2,21370,21371,21373,1,3,0
6119,5,3,21375,21375,21378,0,3,2
6120,3,3,21378,21378,21381,0,3,0
6121,4,1,21382,21382,21383,0,1,1
6122,1,2,21383,21383,21385,0,2,0
6123,2,1,21385,21385,21386,0,1,0
6124,4,1,21389,21389,21390,0,1,3
6125,1,3,21390,21390,21393,0,3,0
6126,5,1,21395,21395,21396,0,1,2
6127,3,1,21398,21398,21399,0,1,2
6128,2,3,21400,21400,21403,0,3,1
6129,3,1,21403,21403,21404,0,1,0
6130,3,1,21406,21406,21407,0,1,2
6131,2,2,21408,21408,21410,0,2,1
6132,5,3,21413,21413,21416,0,3,3
6133,3,1,21416,21416,21417,0,1,0
6134,2,1,21418,21418,21419,0,1,1
6135,3,3,21421,21421,21424,0,3,2
6136,4,3,21425,21425,21428,0,3,1
6137,4,3,21429,21429,21432,0,3,1
6138,3,2,21432,21432,21434,0,2,0
6139,5,2,21437,21437,21439,0,2,3
6140,6,2,21443,21443,21445,0,2,4
6141,4,2,21447,21447,21449,0,2,2
6142,4,1,21451,21451,21452,0,1,2
6143,5,1,21456,21456,21457,0,1,4
6144,1,3,21457,21457,21460,0,3,0
6145,4,3,21461,21461,21464,0,3,1
6146,4,1,21465,21465,21466,0,1,1
6147,1,3,21466,21466,21469,0,3,0
6148,2,2,21468,21469,21471,1,3,0
6149,1,2,21469,21471,21473,2,4,0
6150,6,2,21475,21475,21477,0,2,2
6151,1,2,21476,21477,21479,1,3,0
6152,4,3,21480,21480,21483,0,3,1
6153,1,3,21481,21483,21486,2,5,0
6154,6,1,21487,21487,21488,0,1,1
6155,3,1,21490,21490,21491,0,1,2
6156,4,2,21494,21494,21496,0,2,3
6157,6,2,21500,21500,21502,0,2,4
6158,3,1,21503,21503,21504,0,1,1
6159,6,1,21509,21509,21510,0,1,5
6160,5,2,21514,21514,21516,0,2,4
6161,4,1,21518,21518,21519,0,1,2
6162,6,3,21524,21524,21527,0,3,5
6163,4,1,21528,21528,21529,0,1,1
6164,2,3,21530,21530,21533,0,3,1
6165,6,1,21536,21536,21537,0,1,3
6166,5,3,21541,21541,21544,0,3,4
6167,2,2,21543,21544,21546,1,3,0
6168,3,3,21546,21546,21549,0,3,0
6169,5,2,21551,21551,21553,0,2,2
6170,6,2,21557,21557,21559,0,2,4
6171,6,2,21563,21563,21565,0,2,4
6172,2,2,21565,21565,21567,0,2,0
6173,5,3,21570,21570,21573,0,3,3
6174,2,1,21572,21573,21574,1,2,0
6175,3,2,21575,21575,21577,0,2,1
6176,3,2,21578,21578,21580,0,2,1
6177,5,3,21583,21583,21586,0,3,3
6178,5,3,21588,21588,21591,0,3,2
6179,1,3,21589,21591,21594,2,5,0
6180,1,2,21590,21594,21596,4,6,0
6181,2,2,21592,21596,21598,4,6,0
6182,1,2,21593,21598,21600,5,7,0
6183,2,3,21595,21600,21603,5,8,0
6184,6,2,21601,21603,21605,2,4,0
6185,2,3,21603,21605,21608,2,5,0
6186,3,1,21606,21608,21609,2,3,0
6187,3,1,21609,21609,21610,0,1,0
6188,4,2,21613,21613,21615,0,2,3
6189,2,3,21615,21615,21618,0,3,0
6190,2,2,21617,21618,21620,1,3,0
6191,6,3,21623,21623,21626,0,3,3
6192,3,3,21626,21626,21629,0,3,0
6193,5,3,21631,21631,21634,0,3,2
6194,2,1,21633,21634,21635,1,2,0
6195,5,1,21638,21638,21639,0,1,3
6196,6,2,21644,21644,21646,0,2,5
6197,3,2,21647,21647,21649,0,2,1
6198,4,1,21651,21651,21652,0,1,2
6199,1,1,21652,21652,21653,0,1,0
6200,3,3,21655,21655,21658,0,3,2
6201,4,2,21659,21659,21661,0,2,1
6202,5,3,21664,21664,21667,0,3,3
6203,1,3,21665,21667,21670,2,5,0
6204,5,3,21670,21670,21673,0,3,0
6205,4,1,21674,21674,21675,0,1,1
6206,5,3,21679,21679,21682,0,3,4
6207,6,1,21685,21685,21686,0,1,3
6208,4,1,21689,21689,21690,0,1,3
6209,3,3,21692,21692,21695,0,3,2
6210,2,2,21694,21695,21697,1,3,0
6211,5,1,21699,21699,21700,0,1,2
6212,1,3,21700,21700,21703,0,3,0
6213,2,2,21702,21703,21705,1,3,0
6214,5,1,21707,21707,21708,0,1,2
6215,1,1,21708,21708,21709,0,1,0
6216,5,2,21713,21713,21715,0,2,4
6217,4,3,21717,21717,21720,0,3,2
6218,5,2,21722,21722,21724,0,2,2
6219,3,1,21725,21725,21726,0,1,1
6220,6,3,21731,21731,21734,0,3,5
6221,5,3,21736,21736,21739,0,3,2
6222,6,3,21742,21742,21745,0,3,3
6223,6,2,21748,21748,21750,0,2,3
6224,1,1,21749,21750,21751,1,2,0
6225,3,2,21752,21752,21754,0,2,1
6226,6,3,21758,21758,21761,0,3,4
6227,5,2,21763,21763,21765,0,2,2
6228,6,1,21769,21769,21770,0,1,4
6229,1,2,21770,21770,21772,0,2,0
6230,5,3,21775,21775,21778,0,3,3
6231,2,3,21777,21778,21781,1,4,0
6232,2,2,21779,21781,21783,2,4,0
6233,4,2,21783,21783,21785,0,2,0
6234,2,3,21785,21785,21788,0,3,0
6235,6,2,21791,21791,21793,0,2,3
6236,2,2,21793,21793,21795,0,2,0
6237,3,2,21796,21796,21798,0,2,1
6238,1,3,21797,21798,21801,1,4,0
6239,3,2,21800,21801,21803,1,3,0
6240,3,3,21803,21803,21806,0,3,0
6241,4,1,21807,21807,21808,0,1,1
6242,3,1,21810,21810,21811,0,1,2
6243,2,1,21812,21812,21813,0,1,1
6244,5,3,21817,21817,21820,0,3,4
6245,4,1,21821,21821,21822,0,1,1
6246,6,1,21827,21827,21828,0,1,5
6247,2,2,21829,21829,21831,0,2,1
6248,1,1,21830,21831,21832,1,2,0
6249,2,3,21832,21832,21835,0,3,0
6250,3,1,21835,21835,21836,0,1,0
6251,6,3,21841,21841,21844,0,3,5
6252,5,2,21846,21846,21848,0,2,2
6253,2,3,21848,21848,21851,0,3,0
6254,5,2,21853,21853,21855,0,2,2
6255,3,1,21856,21856,21857,0,1,1
6256,6,2,21862,21862,21864,0,2,5
6257,4,1,21866,21866,21867,0,1,2
6258,3,3,21869,21869,21872,0,3,2
6259,5,3,21874,21874,21877,0,3,2
6260,4,3,21878,21878,21881,0,3,1
6261,6,1,21884,21884,21885,0,1,3
6262,1,3,21885,21885,21888,0,3,0
6263,3,2,21888,21888,21890,0,2,0
6264,2,2,21890,21890,21892,0,2,0
6265,6,2,21896,21896,21898,0,2,4
6266,3,3,21899,21899,21902,0,3,1
6267,4,1,21903,21903,21904,0,1,1
6268,2,3,21905,21905,21908,0,3,1
6269,4,1,21909,21909,21910,0,1,1
6270,4,3,21913,21913,21916,0,3,3
6271,4,1,21917,21917,21918,0,1,1
6272,1,1,21918,21918,21919,0,1,0
6273,2,3,21920,21920,21923,0,3,1
6274,3,2,21923,21923,21925,0,2,0
6275,4,3,21927,21927,21930,0,3,2
6276,4,1,21931,21931,21932,0,1,1
6277,2,3,21933,21933,21936,0,3,1
6278,6,2,21939,21939,21941,0,2,3
6279,1,3,21940,21941,21944,1,4,0
6280,2,2,21942,21944,21946,2,4,0
6281,6,1,21948,21948,21949,0,1,2
6282,3,3,21951,21951,21954,0,3,2
6283,1,2,21952,21954,21956,2,4,0
6284,5,2,21957,21957,21959,0,2,1
6285,2,1,21959,21959,21960,0,1,0
6286,6,2,21965,21965,21967,0,2,5
6287,2,3,21967,21967,21970,0,3,0
6288,1,2,21968,21970,21972,2,4,0
6289,4,1,21972,21972,21973,0,1,0
6290,4,2,21976,21976,21978,0,2,3
6291,5,2,21981,21981,21983,0,2,3
6292,4,2,21985,21985,21987,0,2,2
6293,3,1,21988,21988,21989,0,1,1
6294,3,2,21991,21991,21993,0,2,2
6295,4,1,21995,21995,21996,0,1,2
6296,4,2,21999,21999,22001,0,2,3
6297,3,1,22002,22002,22003,0,1,1
6298,1,1,22003,22003,22004,0,1,0
6299,3,1,22006,22006,22007,0,1,2
6300,1,2,22007,22007,22009,0,2,0
6301,6,1,22013,22013,22014,0,1,4
6302,5,3,22018,22018,22021,0,3,4
6303,6,3,22024,22024,22027,0,3,3
6304,1,1,22025,22027,22028,2,3,0
6305,6,3,22031,22031,22034,0,3,3
6306,6,2,22037,22037,22039,0,2,3
6307,2,2,22039,22039,22041,0,2,0
6308,5,3,22044,22044,22047,0,3,3
6309,4,2,22048,22048,22050,0,2,1
6310,3,1,22051,22051,22052,0,1,1
6311,5,2,22056,22056,22058,0,2,4
6312,5,2,22061,22061,22063,0,2,3
6313,2,2,22063,22063,22065,0,2,0
6314,1,2,22064,22065,22067,1,3,0
6315,1,1,22065,22067,22068,2,3,0
6316,5,3,22070,22070,22073,0,3,2
6317,1,3,22071,22073,22076,2,5,0
6318,1,3,22072,22076,22079,4,7,0
6319,2,1,22074,22079,22080,5,6,0
6320,6,1,22080,22080,22081,0,1,0
6321,1,1,22081,22081,22082,0,1,0
6322,2,2,22083,22083,22085,0,2,1
6323,6,3,22089,22089,22092,0,3,4
6324,6,3,22095,22095,22098,0,3,3
6325,3,1,22098,22098,22099,0,1,0
6326,6,3,22104,22104,22107,0,3,5
6327,3,3,22107,22107,22110,0,3,0
6328,3,2,22110,22110,22112,0,2,0
6329,6,3,22116,22116,22119,0,3,4
6330,4,1,22120,22120,22121,0,1,1
6331,5,3,22125,22125,22128,0,3,4
6332,5,3,22130,22130,22133,0,3,2
6333,6,3,22136,22136,22139,0,3,3
6334,1,2,22137,22139,22141,2,4,0
6335,1,1,22138,22141,22142,3,4,0
6336,5,3,22143,22143,22146,0,3,1
6337,2,1,22145,22146,22147,1,2,0
6338,3,1,22148,22148,22149,0,1,1
6339,5,1,22153,22153,22154,0,1,4
6340,3,2,22156,22156,22158,0,2,2
6341,4,2,22160,22160,22162,0,2,2
6342,3,3,22163,22163,22166,0,3,1
6343,6,3,22169,22169,22172,0,3,3
6344,1,1,22170,22172,22173,2,3,0
6345,6,1,22176,22176,22177,0,1,3
6346,2,3,22178,22178,22181,0,3,1
6347,5,3,22183,22183,22186,0,3,2
6348,1,2,22184,22186,22188,2,4,0
6349,6,2,22190,22190,22192,0,2,2
6350,5,3,22195,22195,22198,0,3,3
6351,2,3,22197,22198,22201,1,4,0
6352,6,2,22203,22203,22205,0,2,2
6353,2,1,22205,22205,22206,0,1,0
6354,6,1,22211,22211,22212,0,1,5
6355,1,3,22212,22212,22215,0,3,0
6356,4,3,22216,22216,22219,0,3,1
6357,6,3,22222,22222,22225,0,3,3
6358,6,3,22228,22228,22231,0,3,3
6359,3,2,22231,22231,22233,0,2,0
6360,1,3,22232,22233,22236,1,4,0
6361,3,1,22235,22236,22237,1,2,0
6362,2,2,22237,22237,22239,0,2,0
6363,2,2,22239,22239,22241,0,2,0
6364,5,3,22244,22244,22247,0,3,3
6365,5,2,22249,22249,22251,0,2,2
6366,4,1,22253,22253,22254,0,1,2
6367,3,2,22256,22256,22258,0,2,2
6368,3,2,22259,22259,22261,0,2,1
6369,2,1,22261,22261,22262,0,1,0
6370,6,1,22267,22267,22268,0,1,5
6371,3,1,22270,22270,22271,0,1,2
6372,6,3,22276,22276,22279,0,3,5
6373,5,3,22281,22281,22284,0,3,2
6374,1,1,22282,22284,22285,2,3,0
6375,2,3,22284,22285,22288,1,4,0
6376,5,3,22289,22289,22292,0,3,1
6377,3,1,22292,22292,22293,0,1,0
6378,5,1,22297,22297,22298,0,1,4
6379,6,3,22303,22303,22306,0,3,5
6380,4,2,22307,22307,22309,0,2,1
6381,5,3,22312,22312,22315,0,3,3
6382,3,1,22315,22315,22316,0,1,0
6383,4,1,22319,22319,22320,0,1,3
6384,2,2,22321,22321,22323,0,2,1
6385,2,2,22323,22323,22325,0,2,0
6386,3,1,22326,22326,22327,0,1,1
6387,4,1,22330,22330,22331,0,1,3
6388,6,3,22336,22336,22339,0,3,5
6389,4,2,22340,22340,22342,0,2,1
6390,3,2,22343,22343,22345,0,2,1
6391,1,2,22344,22345,22347,1,3,0
6392,1,1,22345,22347,22348,2,3,0
6393,5,1,22350,22350,22351,0,1,2
6394,5,3,22355,22355,22358,0,3,4
6395,1,1,22356,22358,22359,2,3,0
6396,1,2,22357,22359,22361,2,4,0
6397,5,2,22362,22362,22364,0,2,1
6398,2,3,22364,22364,22367,0,3,0
6399,1,2,22365,22367,22369,2,4,0
6400,6,2,22371,22371,22373,0,2,2
6401,5,2,22376,22376,22378,0,2,3
6402,6,2,22382,22382,22384,0,2,4
6403,4,2,22386,22386,22388,0,2,2
6404,5,3,22391,22391,22394,0,3,3
6405,4,1,22395,22395,22396,0,1,1
6406,1,1,22396,22396,22397,0,1,0
6407,1,3,22397,22397,22400,0,3,0
6408,5,3,22402,22402,22405,0,3,2
6409,6,2,22408,22408,22410,0,2,3
6410,2,2,22410,22410,22412,0,2,0
6411,4,3,22414,22414,22417,0,3,2
6412,3,3,22417,22417,22420,0,3,0
6413,1,1,22418,22420,22421,2,3,0
6414,4,2,22422,22422,22424,0,2,1
6415,2,3,22424,22424,22427,0,3,0
6416,6,1,22430,22430,22431,0,1,3
6417,2,1,22432,22432,22433,0,1,1
6418,2,2,22434,22434,22436,0,2,1
6419,4,3,22438,22438,22441,0,3,2
6420,2,2,22440,22441,22443,1,3,0
6421,3,2,22443,22443,22445,0,2,0
6422,2,3,22445,22445,22448,0,3,0
6423,1,3,22446,22448,22451,2,5,0
6424,3,2,22449,22451,22453,2,4,0
6425,2,3,22451,22453,22456,2,5,0
6426,2,3,22453,22456,22459,3,6,0
6427,4,2,22457,22459,22461,2,4,0
6428,1,3,22458,22461,22464,3,6,0
6429,3,2,22461,22464,22466,3,5,0
6430,6,3,22467,22467,22470,0,3,1
6431,1,2,22468,22470,22472,2,4,0
6432,3,3,22471,22472,22475,1,4,0
6433,4,1,22475,22475,22476,0,1,0
6434,1,2,22476,22476,22478,0,2,0
6435,1,3,22477,22478,22481,1,4,0
6436,6,3,22483,22483,22486,0,3,2
6437,4,2,22487,22487,22489,0,2,1
6438,3,2,22490,22490,22492,0,2,1
6439,2,2,22492,22492,22494,0,2,0
6440,4,1,22496,22496,22497,0,1,2
6441,4,3,22500,22500,22503,0,3,3
6442,2,2,22502,22503,22505,1,3,0
6443,2,1,22504,22505,22506,1,2,0
6444,2,2,22506,22506,22508,0,2,0
6445,5,3,22511,22511,22514,0,3,3
6446,6,1,22517,22517,22518,0,1,3
6447,4,2,22521,22521,22523,0,2,3
6448,2,1,22523,22523,22524,0,1,0
6449,1,2,22524,22524,22526,0,2,0
6450,6,1,22530,22530,22531,0,1,4
6451,3,2,22533,22533,22535,0,2,2
6452,5,1,22538,22538,22539,0,1,3
6453,3,1,22541,22541,22542,0,1,2
6454,2,2,22543,22543,22545,0,2,1
6455,5,1,22548,22548,22549,0,1,3
6456,3,3,22551,22551,22554,0,3,2
6457,5,3,22556,22556,22559,0,3,2
6458,6,3,22562,22562,22565,0,3,3
6459,6,2,22568,22568,22570,0,2,3
6460,1,3,22569,22570,22573,1,4,0
6461,2,3,22571,22573,22576,2,5,0
6462,2,3,22573,22576,22579,3,6,0
6463,4,1,22577,22579,22580,2,3,0
6464,5,1,22582,22582,22583,0,1,2
6465,5,3,22587,22587,22590,0,3,4
6466,3,2,22590,22590,22592,0,2,0
6467,1,2,22591,22592,22594,1,3,0
6468,2,3,22593,22594,22597,1,4,0
6469,3,3,22596,22597,22600,1,4,0
6470,3,3,22599,22600,22603,1,4,0
6471,2,1,22601,22603,22604,2,3,0
6472,5,2,22606,22606,22608,0,2,2
6473,5,2,22611,22611,22613,0,2,3
6474,3,1,22614,22614,22615,0,1,1
6475,2,3,22616,22616,22619,0,3,1
6476,5,3,22621,22621,22624,0,3,2
6477,1,1,22622,22624,22625,2,3,0
6478,2,3,22624,22625,22628,1,4,0
6479,4,2,22628,22628,22630,0,2,0
6480,3,2,22631,22631,22633,0,2,1
6481,2,1,22633,22633,22634,0,1,0
6482,4,3,22637,22637,22640,0,3,3
6483,5,1,22642,22642,22643,0,1,2
6484,4,2,22646,22646,22648,0,2,3
6485,5,3,22651,22651,22654,0,3,3
6486,1,1,22652,22654,22655,2,3,0
6487,6,2,22658,22658,22660,0,2,3
6488,1,1,22659,22660,22661,1,2,0
6489,3,1,22662,22662,22663,0,1,1
6490,6,2,22668,22668,22670,0,2,5
6491,3,3,22671,22671,22674,0,3,1
6492,3,1,22674,22674,22675,0,1,0
6493,2,3,22676,22676,22679,0,3,1
6494,2,3,22678,22679,22682,1,4,0
6495,4,2,22682,22682,22684,0,2,0
6496,6,1,22688,22688,22689,0,1,4
6497,3,1,22691,22691,22692,0,1,2
6498,5,1,22696,22696,22697,0,1,4
6499,4,1,22700,22700,22701,0,1,3
6500,5,2,22705,22705,22707,0,2,4
6501,2,3,22707,22707,22710,0,3,0
6502,4,3,22711,22711,22714,0,3,1
6503,2,2,22713,22714,22716,1,3,0
6504,2,3,22715,22716,22719,1,4,0
6505,2,3,22717,22719,22722,2,5,0
6506,4,2,22721,22722,22724,1,3,0
6507,5,2,22726,22726,22728,0,2,2
6508,3,3,22729,22729,22732,0,3,1
6509,6,2,22735,22735,22737,0,2,3
6510,5,1,22740,22740,22741,0,1,3
6511,4,1,22744,22744,22745,0,1,3
6512,3,1,22747,22747,22748,0,1,2
6513,2,2,22749,22749,22751,0,2,1
6514,5,1,22754,22754,22755,0,1,3
6515,3,1,22757,22757,22758,0,1,2
6516,2,2,22759,22759,22761,0,2,1
6517,1,3,22760,22761,22764,1,4,0
6518,5,1,22765,22765,22766,0,1,1
6519,5,1,22770,22770,22771,0,1,4
6520,2,1,22772,22772,22773,0,1,1
6521,1,2,22773,22773,22775,0,2,0
6522,4,1,22777,22777,22778,0,1,2
6523,6,2,22783,22783,22785,0,2,5
6524,2,1,22785,22785,22786,0,1,0
6525,4,3,22789,22789,22792,0,3,3
6526,4,1,22793,22793,22794,0,1,1
6527,4,3,22797,22797,22800,0,3,3
6528,4,2,22801,22801,22803,0,2,1
6529,3,1,22804,22804,22805,0,1,1
6530,6,3,22810,22810,22813,0,3,5
6531,2,3,22812,22813,22816,1,4,0
6532,2,3,22814,22816,22819,2,5,0
6533,6,3,22820,22820,22823,0,3,1
6534,2,3,22822,22823,22826,1,4,0
6535,4,3,22826,22826,22829,0,3,0
6536,3,2,22829,22829,22831,0,2,0
6537,5,3,22834,22834,22837,0,3,3
6538,1,2,22835,22837,22839,2,4,0
6539,6,1,22841,22841,22842,0,1,2
6540,3,2,22844,22844,22846,0,2,2
6541,3,3,22847,22847,22850,0,3,1
6542,1,3,22848,22850,22853,2,5,0
6543,6,3,22854,22854,22857,0,3,1
6544,6,2,22860,22860,22862,0,2,3
6545,2,2,22862,22862,22864,0,2,0
6546,6,3,22868,22868,22871,0,3,4
6547,1,2,22869,22871,22873,2,4,0
6548,6,1,22875,22875,22876,0,1,2
6549,6,2,22881,22881,22883,0,2,5
6550,6,3,22887,22887,22890,0,3,4
6551,6,2,22893,22893,22895,0,2,3
6552,2,1,22895,22895,22896,0,1,0
6553,6,3,22901,22901,22904,0,3,5
6554,2,2,22903,22904,22906,1,3,0
6555,1,3,22904,22906,22909,2,5,0
6556,4,3,22908,22909,22912,1,4,0
6557,3,1,22911,22912,22913,1,2,0
6558,4,2,22915,22915,22917,0,2,2
6559,2,1,22917,22917,22918,0,1,0
6560,4,3,22921,22921,22924,0,3,3
6561,1,2,22922,22924,22926,2,4,0
6562,5,3,22927,22927,22930,0,3,1
6563,1,1,22928,22930,22931,2,3,0
6564,5,3,22933,22933,22936,0,3,2
6565,6,3,22939,22939,22942,0,3,3
6566,3,2,22942,22942,22944,0,2,0
6567,6,2,22948,22948,22950,0,2,4
6568,5,1,22953,22953,22954,0,1,3
6569,4,3,22957,22957,22960,0,3,3
6570,4,2,22961,22961,22963,0,2,1
6571,4,3,22965,22965,22968,0,3,2
6572,1,2,22966,22968,22970,2,4,0
6573,5,2,22971,22971,22973,0,2,1
6574,5,3,22976,22976,22979,0,3,3
6575,3,2,22979,22979,22981,0,2,0
6576,3,2,22982,22982,22984,0,2,1
6577,2,3,22984,22984,22987,0,3,0
6578,6,2,22990,22990,22992,0,2,3
6579,3,3,22993,22993,22996,0,3,1
6580,5,2,22998,22998,23000,0,2,2
6581,3,3,23001,23001,23004,0,3,1
6582,6,3,23007,23007,23010,0,3,3
6583,5,1,23012,23012,23013,0,1,2
6584,6,2,23018,23018,23020,0,2,5
6585,5,3,23023,23023,23026,0,3,3
6586,6,2,23029,23029,23031,0,2,3
6587,2,3,23031,23031,23034,0,3,0
6588,2,1,23033,23034,23035,1,2,0
6589,1,1,23034,23035,23036,1,2,0
6590,3,1,23037,23037,23038,0,1,1
6591,5,3,23042,23042,23045,0,3,4
6592,2,1,23044,23045,23046,1,2,0
6593,4,3,23048,23048,23051,0,3,2
6594,4,1,23052,23052,23053,0,1,1
6595,1,1,23053,23053,23054,0,1,0
6596,6,3,23059,23059,23062,0,3,5
6597,1,3,23060,23062,23065,2,5,0
6598,2,1,23062,23065,23066,3,4,0
6599,5,1,23067,23067,23068,0,1,1
6600,2,2,23069,23069,23071,0,2,1
6601,2,2,23071,23071,23073,0,2,0
6602,2,1,23073,23073,23074,0,1,0
6603,1,2,23074,23074,23076,0,2,0
6604,5,2,23079,23079,23081,0,2,3
6605,6,3,23085,23085,23088,0,3,4
6606,6,1,23091,23091,23092,0,1,3
6607,2,2,23093,23093,23095,0,2,1
6608,5,1,23098,23098,23099,0,1,3
6609,1,1,23099,23099,23100,0,1,0
6610,6,2,23105,23105,23107,0,2,5
6611,2,3,23107,23107,23110,0,3,0
6612,5,3,23112,23112,23115,0,3,2
6613,4,3,23116,23116,23119,0,3,1
6614,1,1,23117,23119,23120,2,3,0
6615,1,3,23118,23120,23123,2,5,0
6616,3,2,23121,23123,23125,2,4,0
6617,2,2,23123,23125,23127,2,4,0
6618,3,3,23126,23127,23130,1,4,0
6619,2,1,23128,23130,23131,2,3,0
6620,5,2,23133,23133,23135,0,2,2
6621,1,2,23134,23135,23137,1,3,0
6622,4,2,23138,23138,23140,0,2,1
6623,5,3,23143,23143,23146,0,3,3
6624,3,3,23146,23146,23149,0,3,0
6625,4,1,23150,23150,23151,0,1,1
6626,3,1,23153,23153,23154,0,1,2
6627,3,2,23156,23156,23158,0,2,2
6628,5,1,23161,23161,23162,0,1,3
6629,5,1,23166,23166,23167,0,1,4
6630,6,3,23172,23172,23175,0,3,5
6631,3,3,23175,23175,23178,0,3,0
6632,1,1,23176,23178,23179,2,3,0
6633,6,2,23182,23182,23184,0,2,3
6634,4,3,23186,23186,23189,0,3,2
6635,2,1,23188,23189,23190,1,2,0
6636,5,1,23193,23193,23194,0,1,3
6637,1,2,23194,23194,23196,0,2,0
6638,5,3,23199,23199,23202,0,3,3
6639,3,1,23202,23202,23203,0,1,0
6640,4,2,23206,23206,23208,0,2,3
6641,5,3,23211,23211,23214,0,3,3
6642,5,2,23216,23216,23218,0,2,2
6643,4,1,23220,23220,23221,0,1,2
6644,5,1,23225,23225,23226,0,1,4
6645,1,1,23226,23226,23227,0,1,0
6646,6,1,23232,23232,23233,0,1,5
6647,2,1,23234,23234,23235,0,1,1
6648,6,2,23240,23240,23242,0,2,5
6649,6,3,23246,23246,23249,0,3,4
6650,3,3,23249,23249,23252,0,3,0
6651,6,3,23255,23255,23258,0,3,3
6652,4,3,23259,23259,23262,0,3,1
6653,4,2,23263,23263,23265,0,2,1
6654,4,3,23267,23267,23270,0,3,2
6655,6,3,23273,23273,23276,0,3,3
6656,6,2,23279,23279,23281,0,2,3
6657,5,2,23284,23284,23286,0,2,3
6658,6,2,23290,23290,23292,0,2,4
6659,6,3,23296,23296,23299,0,3,4
6660,1,1,23297,23299,23300,2,3,0
6661,1,2,23298,23300,23302,2,4,0
6662,1,2,23299,23302,23304,3,5,0
6663,1,1,23300,23304,23305,4,5,0
6664,4,3,23304,23305,23308,1,4,0
6665,2,1,23306,23308,23309,2,3,0
6666,3,2,23309,23309,23311,0,2,0
6667,1,3,23310,23311,23314,1,4,0
6668,6,3,23316,23316,23319,0,3,2
6669,3,1,23319,23319,23320,0,1,0
6670,3,3,23322,23322,23325,0,3,2
6671,5,3,23327,23327,23330,0,3,2
6672,3,3,23330,23330,23333,0,3,0
6673,5,1,23335,23335,23336,0,1,2
6674,1,2,23336,23336,23338,0,2,0
6675,1,3,23337,23338,23341,1,4,0
6676,3,2,23340,23341,23343,1,3,0
6677,3,3,23343,23343,23346,0,3,0
6678,2,2,23345,23346,23348,1,3,0
6679,1,1,23346,23348,23349,2,3,0
6680,2,1,23348,23349,23350,1,2,0
6681,5,3,23353,23353,23356,0,3,3
6682,5,2,23358,23358,23360,0,2,2
6683,4,3,23362,23362,23365,0,3,2
6684,6,2,23368,23368,23370,0,2,3
6685,6,1,23374,23374,23375,0,1,4
6686,1,2,23375,23375,23377,0,2,0
6687,2,1,23377,23377,23378,0,1,0
6688,4,3,23381,23381,23384,0,3,3
6689,4,1,23385,23385,23386,0,1,1
6690,6,1,23391,23391,23392,0,1,5
6691,1,3,23392,23392,23395,0,3,0
6692,5,3,23397,23397,23400,0,3,2
6693,3,3,23400,23400,23403,0,3,0
6694,4,2,23404,23404,23406,0,2,1
6695,4,3,23408,23408,23411,0,3,2
6696,6,2,23414,23414,23416,0,2,3
6697,1,1,23415,23416,23417,1,2,0
6698,5,1,23420,23420,23421,0,1,3
6699,6,2,23426,23426,23428,0,2,5
6700,2,2,23428,23428,23430,0,2,0
6701,5,3,23433,23433,23436,0,3,3
6702,6,3,23439,23439,23442,0,3,3
6703,4,1,23443,23443,23444,0,1,1
6704,1,1,23444,23444,23445,0,1,0
6705,4,2,23448,23448,23450,0,2,3
6706,5,3,23453,23453,23456,0,3,3
6707,5,3,23458,23458,23461,0,3,2
6708,5,1,23463,23463,23464,0,1,2
6709,6,3,23469,23469,23472,0,3,5
6710,4,1,23473,23473,23474,0,1,1
6711,1,3,23474,23474,23477,0,3,0
6712,1,1,23475,23477,23478,2,3,0
6713,5,1,23480,23480,23481,0,1,2
6714,3,1,23483,23483,23484,0,1,2
6715,4,1,23487,23487,23488,0,1,3
6716,2,1,23489,23489,23490,0,1,1
6717,2,2,23491,23491,23493,0,2,1
6718,4,3,23495,23495,23498,0,3,2
6719,2,2,23497,23498,23500,1,3,0
6720,6,1,23503,23503,23504,0,1,3
6721,2,1,23505,23505,23506,0,1,1
6722,1,2,23506,23506,23508,0,2,0
6723,6,1,23512,23512,23513,0,1,4
6724,1,3,23513,23513,23516,0,3,0
6725,4,2,23517,23517,23519,0,2,1
6726,4,1,23521,23521,23522,0,1,2
6727,2,1,23523,23523,23524,0,1,1
6728,3,2,23526,23526,23528,0,2,2
6729,4,2,23530,23530,23532,0,2,2
6730,4,3,23534,23534,23537,0,3,2
6731,4,3,23538,23538,23541,0,3,1
6732,3,1,23541,23541,23542,0,1,0
6733,1,2,23542,23542,23544,0,2,0
6734,2,3,23544,23544,23547,0,3,0
6735,6,1,23550,23550,23551,0,1,3
6736,1,3,23551,23551,23554,0,3,0
6737,6,1,23557,23557,23558,0,1,3
6738,2,1,23559,23559,23560,0,1,1
6739,6,2,23565,23565,23567,0,2,5
6740,1,1,23566,23567,23568,1,2,0
6741,5,2,23571,23571,23573,0,2,3
6742,3,2,23574,23574,23576,0,2,1
6743,3,2,23577,23577,23579,0,2,1
6744,6,3,23583,23583,23586,0,3,4
6745,2,2,23585,23586,23588,1,3,0
6746,1,2,23586,23588,23590,2,4,0
6747,3,1,23589,23590,23591,1,2,0
6748,1,3,23590,23591,23594,1,4,0
6749,4,3,23594,23594,23597,0,3,0
6750,4,2,23598,23598,23600,0,2,1
6751,2,3,23600,23600,23603,0,3,0
6752,2,3,23602,23603,23606,1,4,0
6753,3,2,23605,23606,23608,1,3,0
6754,3,2,23608,23608,23610,0,2,0
6755,1,3,23609,23610,23613,1,4,0
6756,6,2,23615,23615,23617,0,2,2
6757,3,3,23618,23618,23621,0,3,1
6758,2,2,23620,23621,23623,1,3,0
6759,6,2,23626,23626,23628,0,2,3
6760,6,2,23632,23632,23634,0,2,4
6761,3,3,23635,23635,23638,0,3,1
6762,4,2,23639,23639,23641,0,2,1
6763,3,1,23642,23642,23643,0,1,1
6764,1,1,23643,23643,23644,0,1,0
6765,1,2,23644,23644,23646,0,2,0
6766,2,3,23646,23646,23649,0,3,0
6767,2,2,23648,23649,23651,1,3,0
6768,1,1,23649,23651,23652,2,3,0
6769,1,2,23650,23652,23654,2,4,0
6770,5,3,23655,23655,23658,0,3,1
6771,1,1,23656,23658,23659,2,3,0
6772,5,3,23661,23661,23664,0,3,2
6773,6,1,23667,23667,23668,0,1,3
6774,5,2,23672,23672,23674,0,2,4
6775,2,2,23674,23674,23676,0,2,0
6776,2,2,23676,23676,23678,0,2,0
6777,3,3,23679,23679,23682,0,3,1
6778,1,2,23680,23682,23684,2,4,0
6779,4,1,23684,23684,23685,0,1,0
6780,4,1,23688,23688,23689,0,1,3
6781,5,3,23693,23693,23696,0,3,4
6782,2,3,23695,23696,23699,1,4,0
6783,4,2,23699,23699,23701,0,2,0
6784,2,2,23701,23701,23703,0,2,0
6785,1,2,23702,23703,23705,1,3,0
6786,2,3,23704,23705,23708,1,4,0
6787,1,2,23705,23708,23710,3,5,0
6788,6,3,23711,23711,23714,0,3,1
6789,6,1,23717,23717,23718,0,1,3
6790,6,1,23723,23723,23724,0,1,5
6791,6,2,23729,23729,23731,0,2,5
6792,1,3,23730,23731,23734,1,4,0
6793,5,2,23735,23735,23737,0,2,1
6794,2,2,23737,23737,23739,0,2,0
6795,1,1,23738,23739,23740,1,2,0
6796,1,3,23739,23740,23743,1,4,0
6797,6,2,23745,23745,23747,0,2,2
6798,1,2,23746,23747,23749,1,3,0
6799,6,2,23752,23752,23754,0,2,3
6800,4,1,23756,23756,23757,0,1,2
6801,4,1,23760,23760,23761,0,1,3
6802,6,1,23766,23766,23767,0,1,5
6803,6,1,23772,23772,23773,0,1,5
6804,6,2,23778,23778,23780,0,2,5
6805,6,2,23784,23784,23786,0,2,4
6806,2,3,23786,23786,23789,0,3,0
6807,3,3,23789,23789,23792,0,3,0
6808,6,2,23795,23795,23797,0,2,3
6809,2,3,23797,23797,23800,0,3,0
6810,5,2,23802,23802,23804,0,2,2
6811,1,1,23803,23804,23805,1,2,0
6812,4,3,23807,23807,23810,0,3,2
6813,1,2,23808,23810,23812,2,4,0
6814,5,2,23813,23813,23815,0,2,1
6815,4,2,23817,23817,23819,0,2,2
6816,3,1,23820,23820,23821,0,1,1
6817,4,1,23824,23824,23825,0,1,3
6818,3,3,23827,23827,23830,0,3,2
6819,1,3,23828,23830,23833,2,5,0
6820,6,2,23834,23834,23836,0,2,1
6821,1,2,23835,23836,23838,1,3,0
6822,6,1,23841,23841,23842,0,1,3
6823,3,3,23844,23844,23847,0,3,2
6824,6,1,23850,23850,23851,0,1,3
6825,1,2,23851,23851,23853,0,2,0
6826,2,3,23853,23853,23856,0,3,0
6827,6,3,23859,23859,23862,0,3,3
6828,2,3,23861,23862,23865,1,4,0
6829,1,2,23862,23865,23867,3,5,0
6830,1,1,23863,23867,23868,4,5,0
6831,3,2,23866,23868,23870,2,4,0
6832,2,3,23868,23870,23873,2,5,0
6833,3,1,23871,23873,23874,2,3,0
6834,6,3,23877,23877,23880,0,3,3
6835,4,2,23881,23881,23883,0,2,1
6836,6,1,23887,23887,23888,0,1,4
6837,1,2,23888,23888,23890,0,2,0
6838,1,2,23889,23890,23892,1,3,0
6839,1,2,23890,23892,23894,2,4,0
6840,1,2,23891,23894,23896,3,5,0
6841,2,1,23893,23896,23897,3,4,0
6842,3,3,23896,23897,23900,1,4,0
6843,1,1,23897,23900,23901,3,4,0
6844,2,3,23899,23901,23904,2,5,0
6845,3,1,23902,23904,23905,2,3,0
6846,1,1,23903,23905,23906,2,3,0
6847,5,3,23908,23908,23911,0,3,2
6848,3,2,23911,23911,23913,0,2,0
6849,4,2,23915,23915,23917,0,2,2
6850,2,1,23917,23917,23918,0,1,0
6851,2,3,23919,23919,23922,0,3,1
6852,3,1,23922,23922,23923,0,1,0
6853,2,3,23924,23924,23927,0,3,1
6854,3,1,23927,23927,23928,0,1,0
6855,4,2,23931,23931,23933,0,2,3
6856,4,2,23935,23935,23937,0,2,2
6857,5,1,23940,23940,23941,0,1,3
6858,4,2,23944,23944,23946,0,2,3
6859,6,1,23950,23950,23951,0,1,4
6860,4,2,23954,23954,23956,0,2,3
6861,6,1,23960,23960,23961,0,1,4
6862,4,1,23964,23964,23965,0,1,3
6863,6,1,23970,23970,23971,0,1,5
6864,5,1,23975,23975,23976,0,1,4
6865,6,1,23981,23981,23982,0,1,5
6866,5,1,23986,23986,23987,0,1,4
6867,4,1,23990,23990,23991,0,1,3
6868,1,2,23991,23991,23993,0,2,0
6869,3,2,23994,23994,23996,0,2,1
6870,3,1,23997,23997,23998,0,1,1
6871,4,3,24001,24001,24004,0,3,3
6872,1,1,24002,24004,24005,2,3,0
6873,1,1,24003,24005,24006,2,3,0
6874,5,3,24008,24008,24011,0,3,2
6875,4,1,24012,24012,24013,0,1,1
6876,6,1,24018,24018,24019,0,1,5
6877,1,2,24019,24019,24021,0,2,0
6878,5,2,24024,24024,24026,0,2,3
6879,6,3,24030,24030,24033,0,3,4
6880,5,3,24035,24035,24038,0,3,2
6881,4,2,24039,24039,24041,0,2,1
6882,1,1,24040,24041,24042,1,2,0
6883,1,2,24041,24042,24044,1,3,0
6884,1,2,24042,24044,24046,2,4,0
6885,2,2,24044,24046,24048,2,4,0
6886,1,3,24045,24048,24051,3,6,0
6887,3,1,24048,24051,24052,3,4,0
6888,2,3,24050,24052,24055,2,5,0
6889,4,3,24054,24055,24058,1,4,0
6890,5,1,24059,24059,24060,0,1,1
6891,6,2,24065,24065,24067,0,2,5
6892,5,3,24070,24070,24073,0,3,3
6893,3,3,24073,24073,24076,0,3,0
6894,1,1,24074,24076,24077,2,3,0
6895,2,3,24076,24077,24080,1,4,0
6896,5,3,24081,24081,24084,0,3,1
6897,3,3,24084,24084,24087,0,3,0
6898,1,1,24085,24087,24088,2,3,0
6899,6,1,24091,24091,24092,0,1,3
6900,3,3,24094,24094,24097,0,3,2
6901,3,3,24097,24097,24100,0,3,0
6902,4,2,24101,24101,24103,0,2,1
6903,4,3,24105,24105,24108,0,3,2
6904,5,2,24110,24110,24112,0,2,2
6905,3,2,24113,24113,24115,0,2,1
6906,3,1,24116,24116,24117,0,1,1
6907,4,3,24120,24120,24123,0,3,3
6908,3,1,24123,24123,24124,0,1,0
6909,6,3,24129,24129,24132,0,3,5
6910,4,1,24133,24133,24134,0,1,1
6911,5,2,24138,24138,24140,0,2,4
6912,6,2,24144,24144,24146,0,2,4
6913,2,2,24146,24146,24148,0,2,0
6914,5,3,24151,24151,24154,0,3,3
6915,2,3,24153,24154,24157,1,4,0
6916,1,1,24154,24157,24158,3,4,0
6917,1,2,24155,24158,24160,3,5,0
6918,3,3,24158,24160,24163,2,5,0
6919,3,2,24161,24163,24165,2,4,0
6920,5,2,24166,24166,24168,0,2,1
6921,1,2,24167,24168,24170,1,3,0
6922,6,1,24173,24173,24174,0,1,3
6923,2,2,24175,24175,24177,0,2,1
6924,2,3,24177,24177,24180,0,3,0
6925,1,3,24178,24180,24183,2,5,0
6926,3,2,24181,24183,24185,2,4,0
6927,4,1,24185,24185,24186,0,1,0
6928,4,2,24189,24189,24191,0,2,3
6929,4,3,24193,24193,24196,0,3,2
6930,3,3,24196,24196,24199,0,3,0
6931,5,1,24201,24201,24202,0,1,2
6932,3,1,24204,24204,24205,0,1,2
6933,5,3,24209,24209,24212,0,3,4
6934,4,1,24213,24213,24214,0,1,1
6935,6,1,24219,24219,24220,0,1,5
6936,6,3,24225,24225,24228,0,3,5
6937,1,1,24226,24228,24229,2,3,0
6938,1,2,24227,24229,24231,2,4,0
6939,4,1,24231,24231,24232,0,1,0
6940,6,1,24237,24237,24238,0,1,5
6941,6,2,24243,24243,24245,0,2,5
6942,1,3,24244,24245,24248,1,4,0
6943,4,3,24248,24248,24251,0,3,0
6944,6,2,24254,24254,24256,0,2,3
6945,3,1,24257,24257,24258,0,1,1
6946,3,2,24260,24260,24262,0,2,2
6947,4,1,24264,24264,24265,0,1,2
6948,3,2,24267,24267,24269,0,2,2
6949,4,3,24271,24271,24274,0,3,2
6950,4,3,24275,24275,24278,0,3,1
6951,2,1,24277,24278,24279,1,2,0
6952,4,3,24281,24281,24284,0,3,2
6953,4,2,24285,24285,24287,0,2,1
6954,6,3,24291,24291,24294,0,3,4
6955,2,3,24293,24294,24297,1,4,0
6956,4,1,24297,24297,24298,0,1,0
6957,3,1,24300,24300,24301,0,1,2
6958,4,2,24304,24304,24306,0,2,3
6959,4,2,24308,24308,24310,0,2,2
6960,2,3,24310,24310,24313,0,3,0
6961,6,3,24316,24316,24319,0,3,3
6962,3,2,24319,24319,24321,0,2,0
6963,4,3,24323,24323,24326,0,3,2
6964,5,1,24328,24328,24329,0,1,2
6965,5,3,24333,24333,24336,0,3,4
6966,1,1,24334,24336,24337,2,3,0
6967,3,1,24337,24337,24338,0,1,0
6968,5,3,24342,24342,24345,0,3,4
6969,5,1,24347,24347,24348,0,1,2
6970,2,1,24349,24349,24350,0,1,1
6971,5,3,24354,24354,24357,0,3,4
6972,5,1,24359,24359,24360,0,1,2
6973,2,3,24361,24361,24364,0,3,1
6974,5,1,24366,24366,24367,0,1,2
6975,5,2,24371,24371,24373,0,2,4
6976,2,1,24373,24373,24374,0,1,0
6977,5,3,24378,24378,24381,0,3,4
6978,3,1,24381,24381,24382,0,1,0
6979,1,1,24382,24382,24383,0,1,0
6980,4,3,24386,24386,24389,0,3,3
6981,2,1,24388,24389,24390,1,2,0
6982,2,3,24390,24390,24393,0,3,0
6983,2,1,24392,24393,24394,1,2,0
6984,4,3,24396,24396,24399,0,3,2
6985,1,3,24397,24399,24402,2,5,0
6986,6,1,24403,24403,24404,0,1,1
6987,6,2,24409,24409,24411,0,2,5
6988,5,3,24414,24414,24417,0,3,3
6989,5,1,24419,24419,24420,0,1,2
6990,4,2,24423,24423,24425,0,2,3
6991,3,3,24426,24426,24429,0,3,1
6992,6,3,24432,24432,24435,0,3,3
6993,2,2,24434,24435,24437,1,3,0
6994,4,1,24438,24438,24439,0,1,1
6995,4,1,24442,24442,24443,0,1,3
6996,3,1,24445,24445,24446,0,1,2
6997,1,3,24446,24446,24449,0,3,0
6998,4,2,24450,24450,24452,0,2,1
6999,1,1,24451,24452,24453,1,2,0
7000,3,1,24454,24454,24455,0,1,1
7001,1,3,24455,24455,24458,0,3,0
7002,5,2,24460,24460,24462,0,2,2
7003,2,2,24462,24462,24464,0,2,0
7004,3,3,24465,24465,24468,0,3,1
7005,4,3,24469,24469,24472,0,3,1
7006,6,2,24475,24475,24477,0,2,3
7007,6,2,24481,24481,24483,0,2,4
7008,4,3,24485,24485,24488,0,3,2
7009,6,1,24491,24491,24492,0,1,3
7010,6,1,24497,24497,24498,0,1,5
7011,1,2,24498,24498,24500,0,2,0
7012,3,3,24501,24501,24504,0,3,1
7013,2,2,24503,24504,24506,1,3,0
7014,3,1,24506,24506,24507,0,1,0
7015,4,3,24510,24510,24513,0,3,3
7016,2,1,24512,24513,24514,1,2,0
7017,6,1,24518,24518,24519,0,1,4
7018,6,1,24524,24524,24525,0,1,5
7019,2,2,24526,24526,24528,0,2,1
7020,4,1,24530,24530,24531,0,1,2
7021,4,2,24534,24534,24536,0,2,3
7022,5,1,24539,24539,24540,0,1,3
7023,4,3,24543,24543,24546,0,3,3
7024,5,2,24548,24548,24550,0,2,2
7025,1,3,24549,24550,24553,1,4,0
7026,2,1,24551,24553,24554,2,3,0
7027,3,3,24554,24554,24557,0,3,0
7028,1,1,24555,24557,24558,2,3,0
7029,3,2,24558,24558,24560,0,2,0
7030,5,1,24563,24563,24564,0,1,3
7031,3,3,24566,24566,24569,0,3,2
7032,5,2,24571,24571,24573,0,2,2
7033,3,2,24574,24574,24576,0,2,1
7034,2,3,24576,24576,24579,0,3,0
7035,2,1,24578,24579,24580,1,2,0
7036,4,1,24582,24582,24583,0,1,2
7037,6,2,24588,24588,24590,0,2,5
7038,6,2,24594,24594,24596,0,2,4
7039,6,1,24600,24600,24601,0,1,4
7040,1,1,24601,24601,24602,0,1,0
7041,3,2,24604,24604,24606,0,2,2
7042,1,1,24605,24606,24607,1,2,0
7043,4,2,24609,24609,24611,0,2,2
7044,2,2,24611,24611,24613,0,2,0
7045,6,2,24617,24617,24619,0,2,4
7046,4,3,24621,24621,24624,0,3,2
7047,5,3,24626,24626,24629,0,3,2
7048,5,3,24631,24631,24634,0,3,2
7049,6,2,24637,24637,24639,0,2,3
7050,2,1,24639,24639,24640,0,1,0
7051,2,2,24641,24641,24643,0,2,1
7052,2,1,24643,24643,24644,0,1,0
7053,5,3,24648,24648,24651,0,3,4
7054,1,2,24649,24651,24653,2,4,0
7055,4,2,24653,24653,24655,0,2,0
7056,4,1,24657,24657,24658,0,1,2
7057,4,2,24661,24661,24663,0,2,3
7058,5,1,24666,24666,24667,0,1,3
7059,2,1,24668,24668,24669,0,1,1
7060,5,3,24673,24673,24676,0,3,4
7061,4,1,24677,24677,24678,0,1,1
7062,1,2,24678,24678,24680,0,2,0
7063,3,1,24681,24681,24682,0,1,1
7064,3,1,24684,24684,24685,0,1,2
7065,5,2,24689,24689,24691,0,2,4
7066,5,2,24694,24694,24696,0,2,3
7067,1,3,24695,24696,24699,1,4,0
7068,3,3,24698,24699,24702,1,4,0
7069,4,1,24702,24702,24703,0,1,0
7070,6,2,24708,24708,24710,0,2,5
7071,5,3,24713,24713,24716,0,3,3
7072,1,1,24714,24716,24717,2,3,0
7073,2,2,24716,24717,24719,1,3,0
7074,6,3,24722,24722,24725,0,3,3
7075,2,2,24724,24725,24727,1,3,0
7076,6,1,24730,24730,24731,0,1,3
7077,6,3,24736,24736,24739,0,3,5
7078,5,3,24741,24741,24744,0,3,2
7079,2,3,24743,24744,24747,1,4,0
7080,5,2,24748,24748,24750,0,2,1
7081,3,2,24751,24751,24753,0,2,1
7082,2,2,24753,24753,24755,0,2,0
7083,6,1,24759,24759,24760,0,1,4
7084,3,1,24762,24762,24763,0,1,2
7085,4,3,24766,24766,24769,0,3,3
7086,3,2,24769,24769,24771,0,2,0
7087,4,3,24773,24773,24776,0,3,2
7088,2,2,24775,24776,24778,1,3,0
7089,6,1,24781,24781,24782,0,1,3
7090,3,3,24784,24784,24787,0,3,2
7091,2,1,24786,24787,24788,1,2,0
7092,1,3,24787,24788,24791,1,4,0
7093,1,1,24788,24791,24792,3,4,0
7094,6,2,24794,24794,24796,0,2,2
7095,4,1,24798,24798,24799,0,1,2
7096,6,3,24804,24804,24807,0,3,5
7097,5,1,24809,24809,24810,0,1,2
7098,5,2,24814,24814,24816,0,2,4
7099,5,3,24819,24819,24822,0,3,3
7100,2,3,24821,24822,24825,1,4,0
7101,4,3,24825,24825,24828,0,3,0
7102,3,3,24828,24828,24831,0,3,0
7103,3,3,24831,24831,24834,0,3,0
7104,3,1,24834,24834,24835,0,1,0
7105,3,1,24837,24837,24838,0,1,2
7106,5,2,24842,24842,24844,0,2,4
7107,2,3,24844,24844,24847,0,3,0
7108,4,1,24848,24848,24849,0,1,1
7109,3,1,24851,24851,24852,0,1,2
7110,3,3,24854,24854,24857,0,3,2
7111,1,1,24855,24857,24858,2,3,0
7112,4,3,24859,24859,24862,0,3,1
7113,6,2,24865,24865,24867,0,2,3
7114,1,3,24866,24867,24870,1,4,0
7115,1,3,24867,24870,24873,3,6,0
7116,4,3,24871,24873,24876,2,5,0
7117,6,1,24877,24877,24878,0,1,1
7118,5,3,24882,24882,24885,0,3,4
7119,2,3,24884,24885,24888,1,4,0
7120,5,2,24889,24889,24891,0,2,1
7121,4,3,24893,24893,24896,0,3,2
7122,2,2,24895,24896,24898,1,3,0
7123,3,1,24898,24898,24899,0,1,0
7124,5,2,24903,24903,24905,0,2,4
7125,5,1,24908,24908,24909,0,1,3
7126,3,3,24911,24911,24914,0,3,2
7127,4,2,24915,24915,24917,0,2,1
7128,5,2,24920,24920,24922,0,2,3
7129,2,2,24922,24922,24924,0,2,0
7130,6,2,24928,24928,24930,0,2,4
7131,5,3,24933,24933,24936,0,3,3
7132,4,1,24937,24937,24938,0,1,1
7133,1,2,24938,24938,24940,0,2,0
7134,2,1,24940,24940,24941,0,1,0
7135,3,1,24943,24943,24944,0,1,2
7136,6,1,24949,24949,24950,0,1,5
7137,3,1,24952,24952,24953,0,1,2
7138,4,3,24956,24956,24959,0,3,3
7139,5,1,24961,24961,24962,0,1,2
7140,6,2,24967,24967,24969,0,2,5
7141,5,1,24972,24972,24973,0,1,3
7142,3,1,24975,24975,24976,0,1,2
7143,4,1,24979,24979,24980,0,1,3
7144,2,2,24981,24981,24983,0,2,1
7145,6,3,24987,24987,24990,0,3,4
7146,5,1,24992,24992,24993,0,1,2
7147,6,1,24998,24998,24999,0,1,5
7148,5,2,25003,25003,25005,0,2,4
7149,6,3,25009,25009,25012,0,3,4
7150,6,1,25015,25015,25016,0,1,3
7151,6,3,25021,25021,25024,0,3,5
7152,6,1,25027,25027,25028,0,1,3
7153,1,1,25028,25028,25029,0,1,0
7154,4,3,25032,25032,25035,0,3,3
7155,6,3,25038,25038,25041,0,3,3
7156,1,2,25039,25041,25043,2,4,0
7157,2,3,25041,25043,25046,2,5,0
7158,3,2,25044,25046,25048,2,4,0
7159,5,2,25049,25049,25051,0,2,1
7160,6,3,25055,25055,25058,0,3,4
7161,5,2,25060,25060,25062,0,2,2
7162,6,3,25066,25066,25069,0,3,4
7163,6,2,25072,25072,25074,0,2,3
7164,4,3,25076,25076,25079,0,3,2
7165,4,1,25080,25080,25081,0,1,1
7166,1,3,25081,25081,25084,0,3,0
7167,2,3,25083,25084,25087,1,4,0
7168,4,1,25087,25087,25088,0,1,0
7169,4,2,25091,25091,25093,0,2,3
7170,6,1,25097,25097,25098,0,1,4
7171,5,2,25102,25102,25104,0,2,4
7172,2,3,25104,25104,25107,0,3,0
7173,4,2,25108,25108,25110,0,2,1
7174,3,1,25111,25111,25112,0,1,1
7175,5,2,25116,25116,25118,0,2,4
7176,6,2,25122,25122,25124,0,2,4
7177,4,3,25126,25126,25129,0,3,2
7178,1,1,25127,25129,25130,2,3,0
7179,1,3,25128,25130,25133,2,5,0
7180,6,2,25134,25134,25136,0,2,1
7181,1,1,25135,25136,25137,1,2,0
7182,6,3,25141,25141,25144,0,3,4
7183,6,2,25147,25147,25149,0,2,3
7184,3,3,25150,25150,25153,0,3,1
7185,3,2,25153,25153,25155,0,2,0
7186,6,2,25159,25159,25161,0,2,4
7187,4,1,25163,25163,25164,0,1,2
7188,1,1,25164,25164,25165,0,1,0
7189,6,2,25170,25170,25172,0,2,5
7190,6,2,25176,25176,25178,0,2,4
7191,1,2,25177,25178,25180,1,3,0
7192,3,1,25180,25180,25181,0,1,0
7193,5,1,25185,25185,25186,0,1,4
7194,2,3,25187,25187,25190,0,3,1
7195,3,2,25190,25190,25192,0,2,0
7196,3,3,25193,25193,25196,0,3,1
7197,2,3,25195,25196,25199,1,4,0
7198,6,3,25201,25201,25204,0,3,2
7199,2,2,25203,25204,25206,1,3,0
7200,1,2,25204,25206,25208,2,4,0
7201,1,1,25205,25208,25209,3,4,0
7202,6,3,25211,25211,25214,0,3,2
7203,6,2,25217,25217,25219,0,2,3
7204,2,1,25219,25219,25220,0,1,0
7205,4,3,25223,25223,25226,0,3,3
7206,2,1,25225,25226,25227,1,2,0
7207,6,1,25231,25231,25232,0,1,4
7208,5,2,25236,25236,25238,0,2,4
7209,2,2,25238,25238,25240,0,2,0
7210,1,2,25239,25240,25242,1,3,0
7211,4,3,25243,25243,25246,0,3,1
7212,2,1,25245,25246,25247,1,2,0
7213,2,1,25247,25247,25248,0,1,0
7214,5,3,25252,25252,25255,0,3,4
7215,2,3,25254,25255,25258,1,4,0
7216,6,2,25260,25260,25262,0,2,2
7217,6,1,25266,25266,25267,0,1,4
7218,5,2,25271,25271,25273,0,2,4
7219,3,3,25274,25274,25277,0,3,1
7220,6,2,25280,25280,25282,0,2,3
7221,5,2,25285,25285,25287,0,2,3
7222,5,1,25290,25290,25291,0,1,3
7223,4,2,25294,25294,25296,0,2,3
7224,6,3,25300,25300,25303,0,3,4
7225,1,2,25301,25303,25305,2,4,0
7226,5,2,25306,25306,25308,0,2,1
7227,4,1,25310,25310,25311,0,1,2
7228,4,3,25314,25314,25317,0,3,3
7229,5,3,25319,25319,25322,0,3,2
7230,1,3,25320,25322,25325,2,5,0
7231,1,3,25321,25325,25328,4,7,0
7232,1,1,25322,25328,25329,6,7,0
7233,1,1,25323,25329,25330,6,7,0
7234,3,2,25326,25330,25332,4,6,0
7235,6,2,25332,25332,25334,0,2,0
7236,5,3,25337,25337,25340,0,3,3
7237,4,3,25341,25341,25344,0,3,1
7238,3,3,25344,25344,25347,0,3,0
7239,3,1,25347,25347,25348,0,1,0
7240,3,3,25350,25350,25353,0,3,2
7241,5,1,25355,25355,25356,0,1,2
7242,1,1,25356,25356,25357,0,1,0
7243,1,3,25357,25357,25360,0,3,0
7244,4,1,25361,25361,25362,0,1,1
7245,5,1,25366,25366,25367,0,1,4
7246,4,1,25370,25370,25371,0,1,3
7247,3,1,25373,25373,25374,0,1,2
7248,1,3,25374,25374,25377,0,3,0
7249,6,3,25380,25380,25383,0,3,3
7250,2,1,25382,25383,25384,1,2,0
7251,3,1,25385,25385,25386,0,1,1
7252,2,3,25387,25387,25390,0,3,1
7253,4,3,25391,25391,25394,0,3,1
7254,1,3,25392,25394,25397,2,5,0
7255,4,1,25396,25397,25398,1,2,0
7256,2,3,25398,25398,25401,0,3,0
7257,5,3,25403,25403,25406,0,3,2
7258,6,2,25409,25409,25411,0,2,3
7259,1,3,25410,25411,25414,1,4,0
7260,6,1,25416,25416,25417,0,1,2
7261,4,2,25420,25420,25422,0,2,3
7262,6,1,25426,25426,25427,0,1,4
7263,6,3,25432,25432,25435,0,3,5
7264,6,1,25438,25438,25439,0,1,3
7265,6,1,25444,25444,25445,0,1,5
7266,2,1,25446,25446,25447,0,1,1
7267,3,3,25449,25449,25452,0,3,2
7268,1,1,25450,25452,25453,2,3,0
7269,5,3,25455,25455,25458,0,3,2
7270,5,1,25460,25460,25461,0,1,2
7271,2,1,25462,25462,25463,0,1,1
7272,6,1,25468,25468,25469,0,1,5
7273,5,1,25473,25473,25474,0,1,4
7274,4,3,25477,25477,25480,0,3,3
7275,4,1,25481,25481,25482,0,1,1
7276,5,1,25486,25486,25487,0,1,4
7277,4,2,25490,25490,25492,0,2,3
7278,5,2,25495,25495,25497,0,2,3
7279,3,3,25498,25498,25501,0,3,1
7280,1,3,25499,25501,25504,2,5,0
7281,6,2,25505,25505,25507,0,2,1
7282,3,2,25508,25508,25510,0,2,1
7283,5,1,25513,25513,25514,0,1,3
7284,2,2,25515,25515,25517,0,2,1
7285,1,2,25516,25517,25519,1,3,0
7286,5,2,25521,25521,25523,0,2,2
7287,1,1,25522,25523,25524,1,2,0
7288,2,1,25524,25524,25525,0,1,0
7289,4,3,25528,25528,25531,0,3,3
7290,3,3,25531,25531,25534,0,3,0
7291,3,2,25534,25534,25536,0,2,0
7292,6,3,25540,25540,25543,0,3,4
7293,2,3,25542,25543,25546,1,4,0
7294,2,2,25544,25546,25548,2,4,0
7295,4,1,25548,25548,25549,0,1,0
7296,6,1,25554,25554,25555,0,1,5
7297,5,1,25559,25559,25560,0,1,4
7298,3,3,25562,25562,25565,0,3,2
7299,2,1,25564,25565,25566,1,2,0
7300,5,3,25569,25569,25572,0,3,3
7301,6,1,25575,25575,25576,0,1,3
7302,5,3,25580,25580,25583,0,3,4
7303,6,3,25586,25586,25589,0,3,3
7304,1,2,25587,25589,25591,2,4,0
7305,4,2,25591,25591,25593,0,2,0
7306,3,3,25594,25594,25597,0,3,1
7307,2,3,25596,25597,25600,1,4,0
7308,4,2,25600,25600,25602,0,2,0
7309,2,1,25602,25602,25603,0,1,0
7310,4,3,25606,25606,25609,0,3,3
7311,3,3,25609,25609,25612,0,3,0
7312,5,3,25614,25614,25617,0,3,2
7313,1,2,25615,25617,25619,2,4,0
7314,5,1,25620,25620,25621,0,1,1
7315,6,1,25626,25626,25627,0,1,5
7316,3,2,25629,25629,25631,0,2,2
7317,5,1,25634,25634,25635,0,1,3
7318,1,2,25635,25635,25637,0,2,0
7319,3,3,25638,25638,25641,0,3,1
7320,2,2,25640,25641,25643,1,3,0
7321,5,1,25645,25645,25646,0,1,2
7322,2,3,25647,25647,25650,0,3,1
7323,2,3,25649,25650,25653,1,4,0
7324,6,3,25655,25655,25658,0,3,2
7325,1,2,25656,25658,25660,2,4,0
7326,1,1,25657,25660,25661,3,4,0
7327,1,1,25658,25661,25662,3,4,0
7328,6,2,25664,25664,25666,0,2,2
7329,4,2,25668,25668,25670,0,2,2
7330,1,2,25669,25670,25672,1,3,0
7331,5,2,25674,25674,25676,0,2,2
7332,6,1,25680,25680,25681,0,1,4
7333,3,2,25683,25683,25685,0,2,2
7334,1,3,25684,25685,25688,1,4,0
7335,4,2,25688,25688,25690,0,2,0
7336,2,1,25690,25690,25691,0,1,0
7337,4,1,25694,25694,25695,0,1,3
7338,4,2,25698,25698,25700,0,2,3
7339,1,3,25699,25700,25703,1,4,0
7340,4,1,25703,25703,25704,0,1,0
7341,5,3,25708,25708,25711,0,3,4
7342,3,2,25711,25711,25713,0,2,0
7343,3,1,25714,25714,25715,0,1,1
7344,6,1,25720,25720,25721,0,1,5
7345,4,1,25724,25724,25725,0,1,3
7346,1,3,25725,25725,25728,0,3,0
7347,6,2,25731,25731,25733,0,2,3
7348,3,1,25734,25734,25735,0,1,1
7349,2,2,25736,25736,25738,0,2,1
7350,6,3,25742,25742,25745,0,3,4
7351,2,1,25744,25745,25746,1,2,0
7352,2,1,25746,25746,25747,0,1,0
7353,5,1,25751,25751,25752,0,1,4
7354,4,2,25755,25755,25757,0,2,3
7355,4,2,25759,25759,25761,0,2,2
7356,3,2,25762,25762,25764,0,2,1
7357,2,2,25764,25764,25766,0,2,0
7358,2,2,25766,25766,25768,0,2,0
7359,3,1,25769,25769,25770,0,1,1
7360,6,1,25775,25775,25776,0,1,5
7361,2,1,25777,25777,25778,0,1,1
7362,4,1,25781,25781,25782,0,1,3
7363,5,2,25786,25786,25788,0,2,4
7364,3,3,25789,25789,25792,0,3,1
7365,2,2,25791,25792,25794,1,3,0
7366,5,2,25796,25796,25798,0,2,2
7367,2,1,25798,25798,25799,0,1,0
7368,6,1,25804,25804,25805,0,1,5
7369,2,1,25806,25806,25807,0,1,1
7370,3,1,25809,25809,25810,0,1,2
7371,1,1,25810,25810,25811,0,1,0
7372,4,1,25814,25814,25815,0,1,3
7373,3,3,25817,25817,25820,0,3,2
7374,1,1,25818,25820,25821,2,3,0
7375,1,3,25819,25821,25824,2,5,0
7376,4,2,25823,25824,25826,1,3,0
7377,6,3,25829,25829,25832,0,3,3
7378,5,3,25834,25834,25837,0,3,2
7379,5,3,25839,25839,25842,0,3,2
7380,3,2,25842,25842,25844,0,2,0
7381,2,1,25844,25844,25845,0,1,0
7382,3,1,25847,25847,25848,0,1,2
7383,3,1,25850,25850,25851,0,1,2
7384,3,3,25853,25853,25856,0,3,2
7385,4,3,25857,25857,25860,0,3,1
7386,3,2,25860,25860,25862,0,2,0
7387,6,3,25866,25866,25869,0,3,4
7388,6,3,25872,25872,25875,0,3,3
7389,1,2,25873,25875,25877,2,4,0
7390,5,3,25878,25878,25881,0,3,1
7391,3,3,25881,25881,25884,0,3,0
7392,1,2,25882,25884,25886,2,4,0
7393,4,1,25886,25886,25887,0,1,0
7394,4,1,25890,25890,25891,0,1,3
7395,3,2,25893,25893,25895,0,2,2
7396,6,3,25899,25899,25902,0,3,4
7397,4,2,25903,25903,25905,0,2,1
7398,1,3,25904,25905,25908,1,4,0
7399,3,1,25907,25908,25909,1,2,0
7400,1,1,25908,25909,25910,1,2,0
7401,2,1,25910,25910,25911,0,1,0
7402,5,3,25915,25915,25918,0,3,4
7403,1,3,25916,25918,25921,2,5,0
7404,2,1,25918,25921,25922,3,4,0
7405,2,3,25920,25922,25925,2,5,0
7406,3,1,25923,25925,25926,2,3,0
7407,4,1,25927,25927,25928,0,1,1
7408,3,2,25930,25930,25932,0,2,2
7409,3,1,25933,25933,25934,0,1,1
7410,1,2,25934,25934,25936,0,2,0
7411,6,1,25940,25940,25941,0,1,4
7412,6,3,25946,25946,25949,0,3,5
7413,5,2,25951,25951,25953,0,2,2
7414,1,1,25952,25953,25954,1,2,0
7415,1,3,25953,25954,25957,1,4,0
7416,5,3,25958,25958,25961,0,3,1
7417,1,1,25959,25961,25962,2,3,0
7418,2,1,25961,25962,25963,1,2,0
7419,3,3,25964,25964,25967,0,3,1
7420,4,1,25968,25968,25969,0,1,1
7421,6,1,25974,25974,25975,0,1,5
7422,1,3,25975,25975,25978,0,3,0
7423,5,2,25980,25980,25982,0,2,2
7424,5,2,25985,25985,25987,0,2,3
7425,1,2,25986,25987,25989,1,3,0
7426,2,1,25988,25989,25990,1,2,0
7427,6,2,25994,25994,25996,0,2,4
7428,2,3,25996,25996,25999,0,3,0
7429,5,3,26001,26001,26004,0,3,2
7430,3,1,26004,26004,26005,0,1,0
7431,1,1,26005,26005,26006,0,1,0
7432,4,3,26009,26009,26012,0,3,3
7433,4,2,26013,26013,26015,0,2,1
7434,5,1,26018,26018,26019,0,1,3
7435,4,3,26022,26022,26025,0,3,3
7436,2,2,26024,26025,26027,1,3,0
7437,1,1,26025,26027,26028,2,3,0
7438,1,1,26026,26028,26029,2,3,0
7439,3,2,26029,26029,26031,0,2,0
7440,3,1,26032,26032,26033,0,1,1
7441,6,1,26038,26038,26039,0,1,5
7442,5,1,26043,26043,26044,0,1,4
7443,3,2,26046,26046,26048,0,2,2
7444,6,2,26052,26052,26054,0,2,4
7445,1,2,26053,26054,26056,1,3,0
7446,4,3,26057,26057,26060,0,3,1
7447,6,3,26063,26063,26066,0,3,3
7448,3,1,26066,26066,26067,0,1,0
7449,6,2,26072,26072,26074,0,2,5
7450,1,2,26073,26074,26076,1,3,0
7451,1,2,26074,26076,26078,2,4,0
7452,4,1,26078,26078,26079,0,1,0
7453,6,2,26084,26084,26086,0,2,5
7454,6,3,26090,26090,26093,0,3,4
7455,3,2,26093,26093,26095,0,2,0
7456,1,3,26094,26095,26098,1,4,0
7457,4,1,26098,26098,26099,0,1,0
7458,4,1,26102,26102,26103,0,1,3
7459,6,3,26108,26108,26111,0,3,5
7460,2,3,26110,26111,26114,1,4,0
7461,5,1,26115,26115,26116,0,1,1
7462,1,2,26116,26116,26118,0,2,0
7463,3,3,26119,26119,26122,0,3,1
7464,5,1,26124,26124,26125,0,1,2
7465,3,1,26127,26127,26128,0,1,2
7466,4,3,26131,26131,26134,0,3,3
7467,1,1,26132,26134,26135,2,3,0
7468,1,3,26133,26135,26138,2,5,0
7469,3,1,26136,26138,26139,2,3,0
7470,3,2,26139,26139,26141,0,2,0
7471,2,2,26141,26141,26143,0,2,0
7472,4,1,26145,26145,26146,0,1,2
7473,4,3,26149,26149,26152,0,3,3
7474,3,1,26152,26152,26153,0,1,0
7475,1,2,26153,26153,26155,0,2,0
7476,4,2,26157,26157,26159,0,2,2
7477,2,1,26159,26159,26160,0,1,0
7478,5,1,26164,26164,26165,0,1,4
7479,5,1,26169,26169,26170,0,1,4
7480,2,2,26171,26171,26173,0,2,1
7481,6,2,26177,26177,26179,0,2,4
7482,1,3,26178,26179,26182,1,4,0
7483,2,2,26180,26182,26184,2,4,0
7484,6,3,26186,26186,26189,0,3,2
7485,3,1,26189,26189,26190,0,1,0
7486,5,2,26194,26194,26196,0,2,4
7487,2,3,26196,26196,26199,0,3,0
7488,1,3,26197,26199,26202,2,5,0
7489,2,3,26199,26202,26205,3,6,0
7490,5,1,26204,26205,26206,1,2,0
7491,3,2,26207,26207,26209,0,2,1
7492,1,1,26208,26209,26210,1,2,0
7493,1,2,26209,26210,26212,1,3,0
7494,6,3,26215,26215,26218,0,3,3
7495,5,2,26220,26220,26222,0,2,2
7496,6,2,26226,26226,26228,0,2,4
7497,1,1,26227,26228,26229,1,2,0
7498,3,3,26230,26230,26233,0,3,1
7499,5,2,26235,26235,26237,0,2,2
7500,1,1,26236,26237,26238,1,2,0
7501,3,1,26239,26239,26240,0,1,1
7502,3,2,26242,26242,26244,0,2,2
7503,1,2,26243,26244,26246,1,3,0
7504,2,2,26245,26246,26248,1,3,0
7505,5,3,26250,26250,26253,0,3,2
7506,4,3,26254,26254,26257,0,3,1
7507,4,1,26258,26258,26259,0,1,1
7508,3,3,26261,26261,26264,0,3,2
7509,5,3,26266,26266,26269,0,3,2
7510,3,2,26269,26269,26271,0,2,0
7511,1,3,26270,26271,26274,1,4,0
7512,3,1,26273,26274,26275,1,2,0
7513,5,3,26278,26278,26281,0,3,3
7514,1,3,26279,26281,26284,2,5,0
7515,6,1,26285,26285,26286,0,1,1
7516,1,3,26286,26286,26289,0,3,0
7517,1,3,26287,26289,26292,2,5,0
7518,2,3,26289,26292,26295,3,6,0
7519,1,3,26290,26295,26298,5,8,0
7520,1,2,26291,26298,26300,7,9,0
7521,5,1,26296,26300,26301,4,5,0
7522,3,3,26299,26301,26304,2,5,0
7523,2,1,26301,26304,26305,3,4,0
7524,3,3,26304,26305,26308,1,4,0
7525,6,3,26310,26310,26313,0,3,2
7526,1,2,26311,26313,26315,2,4,0
7527,5,1,26316,26316,26317,0,1,1
7528,4,1,26320,26320,26321,0,1,3
7529,6,1,26326,26326,26327,0,1,5
7530,2,2,26328,26328,26330,0,2,1
7531,2,1,26330,26330,26331,0,1,0
7532,3,1,26333,26333,26334,0,1,2
7533,2,2,26335,26335,26337,0,2,1
7534,1,1,26336,26337,26338,1,2,0
7535,3,3,26339,26339,26342,0,3,1
7536,1,1,26340,26342,26343,2,3,0
7537,4,3,26344,26344,26347,0,3,1
7538,4,2,26348,26348,26350,0,2,1
7539,1,3,26349,26350,26353,1,4,0
7540,5,2,26354,26354,26356,0,2,1
7541,2,1,26356,26356,26357,0,1,0
7542,2,1,26358,26358,26359,0,1,1
7543,2,1,26360,26360,26361,0,1,1
7544,6,2,26366,26366,26368,0,2,5
7545,1,3,26367,26368,26371,1,4,0
7546,3,1,26370,26371,26372,1,2,0
7547,1,3,26371,26372,26375,1,4,0
7548,3,1,26374,26375,26376,1,2,0
7549,3,2,26377,26377,26379,0,2,1
7550,1,2,26378,26379,26381,1,3,0
7551,5,3,26383,26383,26386,0,3,2
7552,5,1,26388,26388,26389,0,1,2
7553,3,2,26391,26391,26393,0,2,2
7554,1,2,26392,26393,26395,1,3,0
7555,1,2,26393,26395,26397,2,4,0
7556,6,2,26399,26399,26401,0,2,2
7557,4,1,26403,26403,26404,0,1,2
7558,6,1,26409,26409,26410,0,1,5
7559,4,2,26413,26413,26415,0,2,3
7560,4,3,26417,26417,26420,0,3,2
7561,5,2,26422,26422,26424,0,2,2
7562,2,2,26424,26424,26426,0,2,0
7563,3,2,26427,26427,26429,0,2,1
7564,3,3,26430,26430,26433,0,3,1
7565,3,3,26433,26433,26436,0,3,0
7566,3,3,26436,26436,26439,0,3,0
7567,6,2,26442,26442,26444,0,2,3
7568,3,3,26445,26445,26448,0,3,1
7569,6,2,26451,26451,26453,0,2,3
7570,5,1,26456,26456,26457,0,1,3
7571,4,1,26460,26460,26461,0,1,3
7572,2,2,26462,26462,26464,0,2,1
7573,1,3,26463,26464,26467,1,4,0
7574,2,3,26465,26467,26470,2,5,0
7575,1,2,26466,26470,26472,4,6,0
7576,5,2,26471,26472,26474,1,3,0
7577,3,2,26474,26474,26476,0,2,0
7578,2,1,26476,26476,26477,0,1,0
7579,1,2,26477,26477,26479,0,2,0
7580,6,2,26483,26483,26485,0,2,4
7581,1,2,26484,26485,26487,1,3,0
7582,6,1,26490,26490,26491,0,1,3
7583,2,2,26492,26492,26494,0,2,1
7584,2,1,26494,26494,26495,0,1,0
7585,4,3,26498,26498,26501,0,3,3
7586,3,1,26501,26501,26502,0,1,0
7587,6,1,26507,26507,26508,0,1,5
7588,1,2,26508,26508,26510,0,2,0
7589,3,1,26511,26511,26512,0,1,1
7590,3,2,26514,26514,26516,0,2,2
7591,2,2,26516,26516,26518,0,2,0
7592,1,2,26517,26518,26520,1,3,0
7593,6,3,26523,26523,26526,0,3,3
7594,2,2,26525,26526,26528,1,3,0
7595,1,3,26526,26528,26531,2,5,0
7596,5,2,26531,26531,26533,0,2,0
7597,1,3,26532,26533,26536,1,4,0
7598,2,3,26534,26536,26539,2,5,0
7599,6,3,26540,26540,26543,0,3,1
7600,4,3,26544,26544,26547,0,3,1
7601,5,3,26549,26549,26552,0,3,2
7602,6,1,26555,26555,26556,0,1,3
7603,5,1,26560,26560,26561,0,1,4
7604,6,1,26566,26566,26567,0,1,5
7605,2,2,26568,26568,26570,0,2,1
7606,6,1,26574,26574,26575,0,1,4
7607,4,2,26578,26578,26580,0,2,3
7608,1,3,26579,26580,26583,1,4,0
7609,2,2,26581,26583,26585,2,4,0
7610,2,3,26583,26585,26588,2,5,0
7611,1,2,26584,26588,26590,4,6,0
7612,6,2,26590,26590,26592,0,2,0
7613,4,1,26594,26594,26595,0,1,2
7614,6,3,26600,26600,26603,0,3,5
7615,4,2,26604,26604,26606,0,2,1
7616,4,3,26608,26608,26611,0,3,2
7617,2,2,26610,26611,26613,1,3,0
7618,1,3,26611,26613,26616,2,5,0
7619,6,1,26617,26617,26618,0,1,1
7620,1,3,26618,26618,26621,0,3,0
7621,2,3,26620,26621,26624,1,4,0
7622,1,1,26621,26624,26625,3,4,0
7623,6,1,26627,26627,26628,0,1,2
7624,6,3,26633,26633,26636,0,3,5
7625,2,1,26635,26636,26637,1,2,0
7626,5,3,26640,26640,26643,0,3,3
7627,4,3,26644,26644,26647,0,3,1
7628,4,3,26648,26648,26651,0,3,1
7629,1,1,26649,26651,26652,2,3,0
7630,2,1,26651,26652,26653,1,2,0
7631,2,3,26653,26653,26656,0,3,0
7632,2,3,26655,26656,26659,1,4,0
7633,5,2,26660,26660,26662,0,2,1
7634,6,1,26666,26666,26667,0,1,4
7635,4,1,26670,26670,26671,0,1,3
7636,6,1,26676,26676,26677,0,1,5
7637,4,1,26680,26680,26681,0,1,3
7638,1,3,26681,26681,26684,0,3,0
7639,3,1,26684,26684,26685,0,1,0
7640,3,1,26687,26687,26688,0,1,2
7641,5,3,26692,26692,26695,0,3,4
7642,3,3,26695,26695,26698,0,3,0
7643,1,1,26696,26698,26699,2,3,0
7644,1,2,26697,26699,26701,2,4,0
7645,5,2,26702,26702,26704,0,2,1
7646,4,3,26706,26706,26709,0,3,2
7647,5,3,26711,26711,26714,0,3,2
7648,5,1,26716,26716,26717,0,1,2
7649,5,2,26721,26721,26723,0,2,4
7650,3,2,26724,26724,26726,0,2,1
7651,5,2,26729,26729,26731,0,2,3
7652,6,2,26735,26735,26737,0,2,4
7653,2,2,26737,26737,26739,0,2,0
7654,2,1,26739,26739,26740,0,1,0
7655,2,1,26741,26741,26742,0,1,1
7656,3,3,26744,26744,26747,0,3,2
7657,1,2,26745,26747,26749,2,4,0
7658,5,1,26750,26750,26751,0,1,1
7659,4,3,26754,26754,26757,0,3,3
7660,4,2,26758,26758,26760,0,2,1
7661,4,3,26762,26762,26765,0,3,2
7662,3,3,26765,26765,26768,0,3,0
7663,2,3,26767,26768,26771,1,4,0
7664,4,3,26771,26771,26774,0,3,0
7665,2,2,26773,26774,26776,1,3,0
7666,4,3,26777,26777,26780,0,3,1
7667,3,2,26780,26780,26782,0,2,0
7668,2,3,26782,26782,26785,0,3,0
7669,1,3,26783,26785,26788,2,5,0
7670,3,3,26786,26788,26791,2,5,0
7671,1,3,26787,26791,26794,4,7,0
7672,4,3,26791,26794,26797,3,6,0
7673,1,1,26792,26797,26798,5,6,0
7674,1,2,26793,26798,26800,5,7,0
7675,3,1,26796,26800,26801,4,5,0
7676,6,3,26802,26802,26805,0,3,1
7677,1,2,26803,26805,26807,2,4,0
7678,3,3,26806,26807,26810,1,4,0
7679,2,3,26808,26810,26813,2,5,0
7680,1,2,26809,26813,26815,4,6,0
7681,1,1,26810,26815,26816,5,6,0
7682,5,2,26815,26816,26818,1,3,0
7683,1,1,26816,26818,26819,2,3,0
7684,2,2,26818,26819,26821,1,3,0
7685,6,2,26824,26824,26826,0,2,3
7686,5,1,26829,26829,26830,0,1,3
7687,1,3,26830,26830,26833,0,3,0
7688,3,3,26833,26833,26836,0,3,0
7689,3,3,26836,26836,26839,0,3,0
7690,3,3,26839,26839,26842,0,3,0
7691,5,3,26844,26844,26847,0,3,2
7692,2,3,26846,26847,26850,1,4,0
7693,2,3,26848,26850,26853,2,5,0
7694,2,3,26850,26853,26856,3,6,0
7695,4,2,26854,26856,26858,2,4,0
7696,6,3,26860,26860,26863,0,3,2
7697,2,2,26862,26863,26865,1,3,0
7698,2,3,26864,26865,26868,1,4,0
7699,2,1,26866,26868,26869,2,3,0
7700,4,1,26870,26870,26871,0,1,1
7701,1,2,26871,26871,26873,0,2,0
7702,4,1,26875,26875,26876,0,1,2
7703,2,2,26877,26877,26879,0,2,1
7704,3,3,26880,26880,26883,0,3,1
7705,6,2,26886,26886,26888,0,2,3
7706,1,2,26887,26888,26890,1,3,0
7707,2,2,26889,26890,26892,1,3,0
7708,5,1,26894,26894,26895,0,1,2
7709,2,1,26896,26896,26897,0,1,1
7710,2,3,26898,26898,26901,0,3,1
7711,5,3,26903,26903,26906,0,3,2
7712,5,3,26908,26908,26911,0,3,2
7713,1,2,26909,26911,26913,2,4,0
7714,5,3,26914,26914,26917,0,3,1
7715,6,2,26920,26920,26922,0,2,3
7716,6,3,26926,26926,26929,0,3,4
7717,3,3,26929,26929,26932,0,3,0
7718,6,2,26935,26935,26937,0,2,3
7719,5,2,26940,26940,26942,0,2,3
7720,6,2,26946,26946,26948,0,2,4
7721,3,2,26949,26949,26951,0,2,1
7722,4,2,26953,26953,26955,0,2,2
7723,4,1,26957,26957,26958,0,1,2
7724,3,2,26960,26960,26962,0,2,2
7725,5,2,26965,26965,26967,0,2,3
7726,6,3,26971,26971,26974,0,3,4
7727,4,3,26975,26975,26978,0,3,1
7728,2,2,26977,26978,26980,1,3,0
7729,2,2,26979,26980,26982,1,3,0
7730,3,2,26982,26982,26984,0,2,0
7731,3,3,26985,26985,26988,0,3,1
7732,6,2,26991,26991,26993,0,2,3
7733,5,2,26996,26996,26998,0,2,3
7734,2,3,26998,26998,27001,0,3,0
7735,1,2,26999,27001,27003,2,4,0
7736,2,1,27001,27003,27004,2,3,0
7737,1,1,27002,27004,27005,2,3,0
7738,1,1,27003,27005,27006,2,3,0
7739,4,3,27007,27007,27010,0,3,1
7740,5,1,27012,27012,27013,0,1,2
7741,6,3,27018,27018,27021,0,3,5
7742,4,1,27022,27022,27023,0,1,1
7743,2,3,27024,27024,27027,0,3,1
7744,4,2,27028,27028,27030,0,2,1
7745,2,1,27030,27030,27031,0,1,0
7746,2,1,27032,27032,27033,0,1,1
7747,2,1,27034,27034,27035,0,1,1
7748,6,1,27040,27040,27041,0,1,5
7749,6,2,27046,27046,27048,0,2,5
7750,2,2,27048,27048,27050,0,2,0
7751,5,3,27053,27053,27056,0,3,3
7752,5,1,27058,27058,27059,0,1,2
7753,4,1,27062,27062,27063,0,1,3
7754,4,3,27066,27066,27069,0,3,3
7755,4,1,27070,27070,27071,0,1,1
7756,2,3,27072,27072,27075,0,3,1
7757,6,1,27078,27078,27079,0,1,3
7758,4,2,27082,27082,27084,0,2,3
7759,3,1,27085,27085,27086,0,1,1
7760,3,3,27088,27088,27091,0,3,2
7761,4,3,27092,27092,27095,0,3,1
7762,6,1,27098,27098,27099,0,1,3
7763,2,3,27100,27100,27103,0,3,1
7764,4,2,27104,27104,27106,0,2,1
7765,6,1,27110,27110,27111,0,1,4
7766,3,1,27113,27113,27114,0,1,2
7767,6,2,27119,27119,27121,0,2,5
7768,3,3,27122,27122,27125,0,3,1
7769,2,1,27124,27125,27126,1,2,0
7770,6,2,27130,27130,27132,0,2,4
7771,2,3,27132,27132,27135,0,3,0
7772,5,2,27137,27137,27139,0,2,2
7773,4,1,27141,27141,27142,0,1,2
7774,4,2,27145,27145,27147,0,2,3
7775,4,1,27149,27149,27150,0,1,2
7776,3,3,27152,27152,27155,0,3,2
7777,6,3,27158,27158,27161,0,3,3
7778,4,1,27162,27162,27163,0,1,1
7779,3,2,27165,27165,27167,0,2,2
7780,4,2,27169,27169,27171,0,2,2
7781,3,2,27172,27172,27174,0,2,1
7782,4,1,27176,27176,27177,0,1,2
7783,5,2,27181,27181,27183,0,2,4
7784,6,1,27187,27187,27188,0,1,4
7785,5,2,27192,27192,27194,0,2,4
7786,6,3,27198,27198,27201,0,3,4
7787,1,2,27199,27201,27203,2,4,0
7788,6,3,27205,27205,27208,0,3,2
7789,2,2,27207,27208,27210,1,3,0
7790,2,3,27209,27210,27213,1,4,0
7791,6,2,27215,27215,27217,0,2,2
7792,3,1,27218,27218,27219,0,1,1
7793,3,1,27221,27221,27222,0,1,2
7794,1,2,27222,27222,27224,0,2,0
7795,6,3,27228,27228,27231,0,3,4
7796,5,3,27233,27233,27236,0,3,2
7797,4,1,27237,27237,27238,0,1,1
7798,4,1,27241,27241,27242,0,1,3
7799,1,3,27242,27242,27245,0,3,0
7800,2,2,27244,27245,27247,1,3,0
7801,4,1,27248,27248,27249,0,1,1
7802,1,2,27249,27249,27251,0,2,0
7803,4,2,27253,27253,27255,0,2,2
7804,2,3,27255,27255,27258,0,3,0
7805,2,1,27257,27258,27259,1,2,0
7806,6,3,27263,27263,27266,0,3,4
7807,5,1,27268,27268,27269,0,1,2
7808,3,3,27271,27271,27274,0,3,2
7809,2,1,27273,27274,27275,1,2,0
7810,1,3,27274,27275,27278,1,4,0
7811,2,2,27276,27278,27280,2,4,0
7812,6,1,27282,27282,27283,0,1,2
7813,4,3,27286,27286,27289,0,3,3
7814,1,2,27287,27289,27291,2,4,0
7815,4,3,27291,27291,27294,0,3,0
7816,3,3,27294,27294,27297,0,3,0
7817,6,2,27300,27300,27302,0,2,3
7818,3,3,27303,27303,27306,0,3,1
7819,4,2,27307,27307,27309,0,2,1
7820,4,1,27311,27311,27312,0,1,2
7821,2,2,27313,27313,27315,0,2,1
7822,1,3,27314,27315,27318,1,4,0
7823,2,1,27316,27318,27319,2,3,0
7824,4,1,27320,27320,27321,0,1,1
7825,3,2,27323,27323,27325,0,2,2
7826,4,3,27327,27327,27330,0,3,2
7827,5,1,27332,27332,27333,0,1,2
7828,2,1,27334,27334,27335,0,1,1
7829,4,1,27338,27338,27339,0,1,3
7830,1,2,27339,27339,27341,0,2,0
7831,3,1,27342,27342,27343,0,1,1
7832,4,2,27346,27346,27348,0,2,3
7833,4,2,27350,27350,27352,0,2,2
7834,2,2,27352,27352,27354,0,2,0
7835,6,3,27358,27358,27361,0,3,4
7836,2,1,27360,27361,27362,1,2,0
7837,5,1,27365,27365,27366,0,1,3
7838,3,2,27368,27368,27370,0,2,2
7839,4,3,27372,27372,27375,0,3,2
7840,6,2,27378,27378,27380,0,2,3
7841,6,1,27384,27384,27385,0,1,4
7842,6,1,27390,27390,27391,0,1,5
7843,4,1,27394,27394,27395,0,1,3
7844,2,3,27396,27396,27399,0,3,1
7845,5,2,27401,27401,27403,0,2,2
7846,4,1,27405,27405,27406,0,1,2
7847,6,1,27411,27411,27412,0,1,5
7848,3,3,27414,27414,27417,0,3,2
7849,4,3,27418,27418,27421,0,3,1
7850,3,3,27421,27421,27424,0,3,0
7851,6,2,27427,27427,27429,0,2,3
7852,6,2,27433,27433,27435,0,2,4
7853,3,1,27436,27436,27437,0,1,1
7854,4,2,27440,27440,27442,0,2,3
7855,4,2,27444,27444,27446,0,2,2
7856,5,1,27449,27449,27450,0,1,3
7857,6,1,27455,27455,27456,0,1,5
7858,5,3,27460,27460,27463,0,3,4
7859,6,2,27466,27466,27468,0,2,3
7860,1,3,27467,27468,27471,1,4,0
7861,1,3,27468,27471,27474,3,6,0
7862,5,3,27473,27474,27477,1,4,0
7863,1,1,27474,27477,27478,3,4,0
7864,2,2,27476,27478,27480,2,4,0
7865,4,1,27480,27480,27481,0,1,0
7866,2,3,27482,27482,27485,0,3,1
7867,5,1,27487,27487,27488,0,1,2
7868,5,3,27492,27492,27495,0,3,4
7869,6,1,27498,27498,27499,0,1,3
7870,1,1,27499,27499,27500,0,1,0
7871,5,1,27504,27504,27505,0,1,4
7872,6,1,27510,27510,27511,0,1,5
7873,6,3,27516,27516,27519,0,3,5
7874,2,2,27518,27519,27521,1,3,0
7875,4,2,27522,27522,27524,0,2,1
7876,4,2,27526,27526,27528,0,2,2
7877,2,3,27528,27528,27531,0,3,0
7878,3,2,27531,27531,27533,0,2,0
7879,1,2,27532,27533,27535,1,3,0
7880,1,3,27533,27535,27538,2,5,0
7881,1,1,27534,27538,27539,4,5,0
7882,1,2,27535,27539,27541,4,6,0
7883,5,3,27540,27541,27544,1,4,0
7884,3,1,27543,27544,27545,1,2,0
7885,6,3,27549,27549,27552,0,3,4
7886,3,2,27552,27552,27554,0,2,0
7887,2,1,27554,27554,27555,0,1,0
7888,3,1,27557,27557,27558,0,1,2
7889,1,3,27558,27558,27561,0,3,0
7890,2,3,27560,27561,27564,1,4,0
7891,6,2,27566,27566,27568,0,2,2
7892,6,2,27572,27572,27574,0,2,4
7893,3,3,27575,27575,27578,0,3,1
7894,6,1,27581,27581,27582,0,1,3
7895,4,1,27585,27585,27586,0,1,3
7896,5,3,27590,27590,27593,0,3,4
7897,6,2,27596,27596,27598,0,2,3
7898,6,2,27602,27602,27604,0,2,4
7899,6,1,27608,27608,27609,0,1,4
7900,5,2,27613,27613,27615,0,2,4
7901,1,3,27614,27615,27618,1,4,0
7902,2,3,27616,27618,27621,2,5,0
7903,6,2,27622,27622,27624,0,2,1
7904,5,1,27627,27627,27628,0,1,3
7905,2,2,27629,27629,27631,0,2,1
7906,4,2,27633,27633,27635,0,2,2
7907,4,1,27637,27637,27638,0,1,2
7908,1,3,27638,27638,27641,0,3,0
7909,2,1,27640,27641,27642,1,2,0
7910,3,2,27643,27643,27645,0,2,1
7911,2,3,27645,27645,27648,0,3,0
7912,2,2,27647,27648,27650,1,3,0
7913,4,1,27651,27651,27652,0,1,1
7914,2,1,27653,27653,27654,0,1,1
7915,5,1,27658,27658,27659,0,1,4
7916,4,1,27662,27662,27663,0,1,3
7917,1,3,27663,27663,27666,0,3,0
7918,4,3,27667,27667,27670,0,3,1
7919,6,1,27673,27673,27674,0,1,3
7920,1,3,27674,27674,27677,0,3,0
7921,3,3,27677,27677,27680,0,3,0
7922,2,1,27679,27680,27681,1,2,0
7923,5,3,27684,27684,27687,0,3,3
7924,6,2,27690,27690,27692,0,2,3
7925,3,1,27693,27693,27694,0,1,1
7926,4,2,27697,27697,27699,0,2,3
7927,4,3,27701,27701,27704,0,3,2
7928,3,2,27704,27704,27706,0,2,0
7929,4,2,27708,27708,27710,0,2,2
7930,2,2,27710,27710,27712,0,2,0
7931,6,3,27716,27716,27719,0,3,4
7932,4,3,27720,27720,27723,0,3,1
7933,5,3,27725,27725,27728,0,3,2
7934,1,2,27726,27728,27730,2,4,0
7935,4,2,27730,27730,27732,0,2,0
7936,1,2,27731,27732,27734,1,3,0
7937,2,2,27733,27734,27736,1,3,0
7938,6,3,27739,27739,27742,0,3,3
7939,1,1,27740,27742,27743,2,3,0
7940,1,2,27741,27743,27745,2,4,0
7941,5,1,27746,27746,27747,0,1,1
7942,3,1,27749,27749,27750,0,1,2
7943,1,1,27750,27750,27751,0,1,0
7944,1,2,27751,27751,27753,0,2,0
7945,1,1,27752,27753,27754,1,2,0
7946,2,1,27754,27754,27755,0,1,0
7947,5,1,27759,27759,27760,0,1,4
7948,1,1,27760,27760,27761,0,1,0
7949,5,2,27765,27765,27767,0,2,4
7950,1,2,27766,27767,27769,1,3,0
7951,4,2,27770,27770,27772,0,2,1
7952,1,1,27771,27772,27773,1,2,0
7953,5,3,27776,27776,27779,0,3,3
7954,3,1,27779,27779,27780,0,1,0
7955,1,2,27780,27780,27782,0,2,0
7956,6,3,27786,27786,27789,0,3,4
7957,1,1,27787,27789,27790,2,3,0
7958,1,1,27788,27790,27791,2,3,0
7959,2,2,27790,27791,27793,1,3,0
7960,5,3,27795,27795,27798,0,3,2
7961,2,1,27797,27798,27799,1,2,0
7962,3,3,27800,27800,27803,0,3,1
7963,1,3,27801,27803,27806,2,5,0
7964,3,1,27804,27806,27807,2,3,0
7965,2,1,27806,27807,27808,1,2,0
7966,6,1,27812,27812,27813,0,1,4
7967,4,1,27816,27816,27817,0,1,3
7968,2,2,27818,27818,27820,0,2,1
7969,3,1,27821,27821,27822,0,1,1
7970,4,1,27825,27825,27826,0,1,3
7971,2,3,27827,27827,27830,0,3,1
7972,6,2,27833,27833,27835,0,2,3
7973,5,1,27838,27838,27839,0,1,3
7974,6,1,27844,27844,27845,0,1,5
7975,2,3,27846,27846,27849,0,3,1
7976,4,1,27850,27850,27851,0,1,1
7977,1,1,27851,27851,27852,0,1,0
7978,1,2,27852,27852,27854,0,2,0
7979,2,2,27854,27854,27856,0,2,0
7980,5,1,27859,27859,27860,0,1,3
7981,6,2,27865,27865,27867,0,2,5
7982,5,3,27870,27870,27873,0,3,3
7983,1,2,27871,27873,27875,2,4,0
7984,2,3,27873,27875,27878,2,5,0
7985,3,3,27876,27878,27881,2,5,0
7986,5,1,27881,27881,27882,0,1,0
7987,6,1,27887,27887,27888,0,1,5
7988,4,1,27891,27891,27892,0,1,3
7989,4,3,27895,27895,27898,0,3,3
7990,1,3,27896,27898,27901,2,5,0
7991,2,3,27898,27901,27904,3,6,0
7992,1,3,27899,27904,27907,5,8,0
7993,5,3,27904,27907,27910,3,6,0
7994,3,1,27907,27910,27911,3,4,0
7995,5,3,27912,27912,27915,0,3,1
7996,5,2,27917,27917,27919,0,2,2
7997,1,1,27918,27919,27920,1,2,0
7998,4,3,27922,27922,27925,0,3,2
7999,5,1,27927,27927,27928,0,1,2
8000,3,3,27930,27930,27933,0,3,2
8001,2,3,27932,27933,27936,1,4,0
8002,4,3,27936,27936,27939,0,3,0
8003,4,2,27940,27940,27942,0,2,1
8004,5,2,27945,27945,27947,0,2,3
8005,4,1,27949,27949,27950,0,1,2
8006,4,3,27953,27953,27956,0,3,3
8007,1,3,27954,27956,27959,2,5,0
8008,6,1,27960,27960,27961,0,1,1
8009,4,1,27964,27964,27965,0,1,3
8010,5,3,27969,27969,27972,0,3,4
8011,4,3,27973,27973,27976,0,3,1
8012,2,2,27975,27976,27978,1,3,0
8013,1,2,27976,27978,27980,2,4,0
8014,6,1,27982,27982,27983,0,1,2
8015,2,3,27984,27984,27987,0,3,1
8016,1,2,27985,27987,27989,2,4,0
8017,4,2,27989,27989,27991,0,2,0
8018,6,2,27995,27995,27997,0,2,4
8019,4,2,27999,27999,28001,0,2,2
8020,2,3,28001,28001,28004,0,3,0
8021,4,1,28005,28005,28006,0,1,1
8022,4,2,28009,28009,28011,0,2,3
8023,3,2,28012,28012,28014,0,2,1
8024,1,3,28013,28014,28017,1,4,0
8025,4,1,28017,28017,28018,0,1,0
8026,2,1,28019,28019,28020,0,1,1
8027,3,2,28022,28022,28024,0,2,2
8028,3,1,28025,28025,28026,0,1,1
8029,4,1,28029,28029,28030,0,1,3
8030,4,1,28033,28033,28034,0,1,3
8031,6,3,28039,28039,28042,0,3,5
8032,3,2,28042,28042,28044,0,2,0
8033,5,1,28047,28047,28048,0,1,3
8034,3,3,28050,28050,28053,0,3,2
8035,1,2,28051,28053,28055,2,4,0
8036,2,2,28053,28055,28057,2,4,0
8037,4,1,28057,28057,28058,0,1,0
8038,3,2,28060,28060,28062,0,2,2
8039,5,3,28065,28065,28068,0,3,3
8040,6,2,28071,28071,28073,0,2,3
8041,5,2,28076,28076,28078,0,2,3
8042,1,2,28077,28078,28080,1,3,0
8043,1,3,28078,28080,28083,2,5,0
8044,5,1,28083,28083,28084,0,1,0
8045,5,1,28088,28088,28089,0,1,4
8046,2,1,28090,28090,28091,0,1,1
8047,2,1,28092,28092,28093,0,1,1
8048,6,1,28098,28098,28099,0,1,5
8049,6,2,28104,28104,28106,0,2,5
8050,4,2,28108,28108,28110,0,2,2
8051,1,3,28109,28110,28113,1,4,0
8052,5,3,28114,28114,28117,0,3,1
8053,1,2,28115,28117,28119,2,4,0
8054,3,1,28118,28119,28120,1,2,0
8055,6,2,28124,28124,28126,0,2,4
8056,4,1,28128,28128,28129,0,1,2
8057,5,3,28133,28133,28136,0,3,4
8058,4,1,28137,28137,28138,0,1,1
8059,3,1,28140,28140,28141,0,1,2
8060,2,2,28142,28142,28144,0,2,1
8061,2,2,28144,28144,28146,0,2,0
8062,4,1,28148,28148,28149,0,1,2
8063,3,2,28151,28151,28153,0,2,2
8064,6,3,28157,28157,28160,0,3,4
8065,3,2,28160,28160,28162,0,2,0
8066,2,3,28162,28162,28165,0,3,0
8067,3,1,28165,28165,28166,0,1,0
8068,2,3,28167,28167,28170,0,3,1
8069,1,2,28168,28170,28172,2,4,0
8070,5,1,28173,28173,28174,0,1,1
8071,3,1,28176,28176,28177,0,1,2
8072,2,2,28178,28178,28180,0,2,1
8073,3,2,28181,28181,28183,0,2,1
8074,4,1,28185,28185,28186,0,1,2
8075,5,2,28190,28190,28192,0,2,4
8076,3,2,28193,28193,28195,0,2,1
8077,1,1,28194,28195,28196,1,2,0
8078,5,2,28199,28199,28201,0,2,3
8079,5,2,28204,28204,28206,0,2,3
8080,2,3,28206,28206,28209,0,3,0
8081,5,2,28211,28211,28213,0,2,2
8082,5,2,28216,28216,28218,0,2,3
8083,4,3,28220,28220,28223,0,3,2
8084,5,1,28225,28225,28226,0,1,2
8085,5,2,28230,28230,28232,0,2,4
8086,5,2,28235,28235,28237,0,2,3
8087,4,2,28239,28239,28241,0,2,2
8088,3,2,28242,28242,28244,0,2,1
8089,1,1,28243,28244,28245,1,2,0
8090,1,3,28244,28245,28248,1,4,0
8091,3,1,28247,28248,28249,1,2,0
8092,2,2,28249,28249,28251,0,2,0
8093,4,2,28253,28253,28255,0,2,2
8094,2,2,28255,28255,28257,0,2,0
8095,1,2,28256,28257,28259,1,3,0
8096,3,3,28259,28259,28262,0,3,0
8097,4,1,28263,28263,28264,0,1,1
8098,4,2,28267,28267,28269,0,2,3
8099,3,3,28270,28270,28273,0,3,1
8100,5,1,28275,28275,28276,0,1,2
8101,3,1,28278,28278,28279,0,1,2
8102,1,1,28279,28279,28280,0,1,0
8103,1,1,28280,28280,28281,0,1,0
8104,1,1,28281,28281,28282,0,1,0
8105,6,1,28287,28287,28288,0,1,5
8106,6,2,28293,28293,28295,0,2,5
8107,6,3,28299,28299,28302,0,3,4
8108,2,3,28301,28302,28305,1,4,0
8109,5,3,28306,28306,28309,0,3,1
8110,4,2,28310,28310,28312,0,2,1
8111,1,2,28311,28312,28314,1,3,0
8112,4,1,28315,28315,28316,0,1,1
8113,1,1,28316,28316,28317,0,1,0
8114,4,3,28320,28320,28323,0,3,3
8115,5,3,28325,28325,28328,0,3,2
8116,6,3,28331,28331,28334,0,3,3
8117,3,2,28334,28334,28336,0,2,0
8118,1,2,28335,28336,28338,1,3,0
8119,3,2,28338,28338,28340,0,2,0
8120,3,1,28341,28341,28342,0,1,1
8121,4,2,28345,28345,28347,0,2,3
8122,2,1,28347,28347,28348,0,1,0
8123,1,2,28348,28348,28350,0,2,0
8124,5,3,28353,28353,28356,0,3,3
8125,3,1,28356,28356,28357,0,1,0
8126,5,1,28361,28361,28362,0,1,4
8127,3,2,28364,28364,28366,0,2,2
8128,1,3,28365,28366,28369,1,4,0
8129,5,2,28370,28370,28372,0,2,1
8130,2,3,28372,28372,28375,0,3,0
8131,1,3,28373,28375,28378,2,5,0
8132,2,2,28375,28378,28380,3,5,0
8133,5,1,28380,28380,28381,0,1,0
8134,5,1,28385,28385,28386,0,1,4
8135,2,1,28387,28387,28388,0,1,1
8136,4,3,28391,28391,28394,0,3,3
8137,3,3,28394,28394,28397,0,3,0
8138,3,2,28397,28397,28399,0,2,0
8139,1,1,28398,28399,28400,1,2,0
8140,4,3,28402,28402,28405,0,3,2
8141,5,2,28407,28407,28409,0,2,2
8142,1,3,28408,28409,28412,1,4,0
8143,1,1,28409,28412,28413,3,4,0
8144,5,2,28414,28414,28416,0,2,1
8145,1,2,28415,28416,28418,1,3,0
8146,4,1,28419,28419,28420,0,1,1
8147,1,1,28420,28420,28421,0,1,0
8148,2,3,28422,28422,28425,0,3,1
8149,3,1,28425,28425,28426,0,1,0
8150,1,2,28426,28426,28428,0,2,0
8151,1,1,28427,28428,28429,1,2,0
8152,3,3,28430,28430,28433,0,3,1
8153,5,3,28435,28435,28438,0,3,2
8154,5,1,28440,28440,28441,0,1,2
8155,1,1,28441,28441,28442,0,1,0
8156,4,3,28445,28445,28448,0,3,3
8157,2,2,28447,28448,28450,1,3,0
8158,5,1,28452,28452,28453,0,1,2
8159,3,1,28455,28455,28456,0,1,2
8160,2,1,28457,28457,28458,0,1,1
8161,5,1,28462,28462,28463,0,1,4
8162,4,1,28466,28466,28467,0,1,3
8163,5,1,28471,28471,28472,0,1,4
8164,1,1,28472,28472,28473,0,1,0
8165,2,3,28474,28474,28477,0,3,1
8166,6,2,28480,28480,28482,0,2,3
8167,2,3,28482,28482,28485,0,3,0
8168,6,2,28488,28488,28490,0,2,3
8169,1,2,28489,28490,28492,1,3,0
8170,1,1,28490,28492,28493,2,3,0
8171,4,1,28494,28494,28495,0,1,1
8172,4,1,28498,28498,28499,0,1,3
8173,2,3,28500,28500,28503,0,3,1
8174,5,3,28505,28505,28508,0,3,2
8175,2,1,28507,28508,28509,1,2,0
8176,3,2,28510,28510,28512,0,2,1
8177,4,1,28514,28514,28515,0,1,2
8178,5,3,28519,28519,28522,0,3,4
8179,3,1,28522,28522,28523,0,1,0
8180,2,2,28524,28524,28526,0,2,1
8181,6,3,28530,28530,28533,0,3,4
8182,5,3,28535,28535,28538,0,3,2
8183,3,2,28538,28538,28540,0,2,0
8184,5,3,28543,28543,28546,0,3,3
8185,3,2,28546,28546,28548,0,2,0
8186,3,3,28549,28549,28552,0,3,1
8187,5,2,28554,28554,28556,0,2,2
8188,1,2,28555,28556,28558,1,3,0
8189,5,3,28560,28560,28563,0,3,2
8190,1,3,28561,28563,28566,2,5,0
8191,2,3,28563,28566,28569,3,6,0
8192,3,1,28566,28569,28570,3,4,0
8193,2,1,28568,28570,28571,2,3,0
8194,3,2,28571,28571,28573,0,2,0
8195,6,3,28577,28577,28580,0,3,4
8196,4,3,28581,28581,28584,0,3,1
8197,5,3,28586,28586,28589,0,3,2
8198,5,2,28591,28591,28593,0,2,2
8199,4,3,28595,28595,28598,0,3,2
8200,6,2,28601,28601,28603,0,2,3
8201,2,3,28603,28603,28606,0,3,0
8202,6,1,28609,28609,28610,0,1,3
8203,4,2,28613,28613,28615,0,2,3
8204,4,2,28617,28617,28619,0,2,2
8205,5,3,28622,28622,28625,0,3,3
8206,5,1,28627,28627,28628,0,1,2
8207,3,2,28630,28630,28632,0,2,2
8208,3,3,28633,28633,28636,0,3,1
8209,5,2,28638,28638,28640,0,2,2
8210,6,3,28644,28644,28647,0,3,4
8211,1,2,28645,28647,28649,2,4,0
8212,1,3,28646,28649,28652,3,6,0
8213,6,2,28652,28652,28654,0,2,0
8214,6,1,28658,28658,28659,0,1,4
8215,4,3,28662,28662,28665,0,3,3
8216,1,2,28663,28665,28667,2,4,0
8217,4,2,28667,28667,28669,0,2,0
8218,1,3,28668,28669,28672,1,4,0
8219,3,2,28671,28672,28674,1,3,0
8220,1,3,28672,28674,28677,2,5,0
8221,4,2,28676,28677,28679,1,3,0
8222,1,2,28677,28679,28681,2,4,0
8223,3,3,28680,28681,28684,1,4,0
8224,3,1,28683,28684,28685,1,2,0
8225,3,1,28686,28686,28687,0,1,1
8226,5,2,28691,28691,28693,0,2,4
8227,2,2,28693,28693,28695,0,2,0
8228,6,2,28699,28699,28701,0,2,4
8229,1,2,28700,28701,28703,1,3,0
8230,3,3,28703,28703,28706,0,3,0
8231,2,3,28705,28706,28709,1,4,0
8232,5,1,28710,28710,28711,0,1,1
8233,3,2,28713,28713,28715,0,2,2
8234,4,2,28717,28717,28719,0,2,2
8235,5,3,28722,28722,28725,0,3,3
8236,5,2,28727,28727,28729,0,2,2
8237,6,2,28733,28733,28735,0,2,4
8238,1,3,28734,28735,28738,1,4,0
8239,5,1,28739,28739,28740,0,1,1
8240,4,2,28743,28743,28745,0,2,3
8241,5,2,28748,28748,28750,0,2,3
8242,2,1,28750,28750,28751,0,1,0
8243,1,3,28751,28751,28754,0,3,0
8244,2,2,28753,28754,28756,1,3,0
8245,5,2,28758,28758,28760,0,2,2
8246,5,3,28763,28763,28766,0,3,3
8247,4,3,28767,28767,28770,0,3,1
8248,4,3,28771,28771,28774,0,3,1
8249,6,1,28777,28777,28778,0,1,3
8250,5,3,28782,28782,28785,0,3,4
8251,4,1,28786,28786,28787,0,1,1
8252,1,2,28787,28787,28789,0,2,0
8253,3,3,28790,28790,28793,0,3,1
8254,4,1,28794,28794,28795,0,1,1
8255,2,3,28796,28796,28799,0,3,1
8256,3,3,28799,28799,28802,0,3,0
8257,1,3,28800,28802,28805,2,5,0
8258,2,3,28802,28805,28808,3,6,0
8259,2,2,28804,28808,28810,4,6,0
8260,6,3,28810,28810,28813,0,3,0
8261,6,3,28816,28816,28819,0,3,3
8262,2,2,28818,28819,28821,1,3,0
8263,2,1,28820,28821,28822,1,2,0
8264,2,3,28822,28822,28825,0,3,0
8265,2,1,28824,28825,28826,1,2,0
8266,3,3,28827,28827,28830,0,3,1
8267,2,2,28829,28830,28832,1,3,0
8268,6,1,28835,28835,28836,0,1,3
8269,5,3,28840,28840,28843,0,3,4
8270,3,1,28843,28843,28844,0,1,0
8271,5,1,28848,28848,28849,0,1,4
8272,4,3,28852,28852,28855,0,3,3
8273,2,2,28854,28855,28857,1,3,0
8274,4,1,28858,28858,28859,0,1,1
8275,5,1,28863,28863,28864,0,1,4
8276,5,1,28868,28868,28869,0,1,4
8277,4,2,28872,28872,28874,0,2,3
8278,4,1,28876,28876,28877,0,1,2
8279,4,2,28880,28880,28882,0,2,3
8280,5,3,28885,28885,28888,0,3,3
8281,1,2,28886,28888,28890,2,4,0
8282,2,1,28888,28890,28891,2,3,0
8283,3,3,28891,28891,28894,0,3,0
8284,4,2,28895,28895,28897,0,2,1
8285,2,2,28897,28897,28899,0,2,0
8286,6,2,28903,28903,28905,0,2,4
8287,2,1,28905,28905,28906,0,1,0
8288,2,3,28907,28907,28910,0,3,1
8289,5,2,28912,28912,28914,0,2,2
8290,3,3,28915,28915,28918,0,3,1
8291,3,2,28918,28918,28920,0,2,0
8292,2,3,28920,28920,28923,0,3,0
8293,3,3,28923,28923,28926,0,3,0
8294,5,2,28928,28928,28930,0,2,2
8295,6,1,28934,28934,28935,0,1,4
8296,3,2,28937,28937,28939,0,2,2
8297,4,2,28941,28941,28943,0,2,2
8298,5,2,28946,28946,28948,0,2,3
8299,1,2,28947,28948,28950,1,3,0
8300,5,1,28952,28952,28953,0,1,2
8301,5,3,28957,28957,28960,0,3,4
8302,1,3,28958,28960,28963,2,5,0
8303,3,3,28961,28963,28966,2,5,0
8304,2,1,28963,28966,28967,3,4,0
8305,2,1,28965,28967,28968,2,3,0
8306,3,3,28968,28968,28971,0,3,0
8307,4,1,28972,28972,28973,0,1,1
8308,1,2,28973,28973,28975,0,2,0
8309,4,3,28977,28977,28980,0,3,2
8310,3,3,28980,28980,28983,0,3,0
8311,3,1,28983,28983,28984,0,1,0
8312,1,2,28984,28984,28986,0,2,0
8313,6,2,28990,28990,28992,0,2,4
8314,6,1,28996,28996,28997,0,1,4
8315,4,2,29000,29000,29002,0,2,3
8316,2,3,29002,29002,29005,0,3,0
8317,1,3,29003,29005,29008,2,5,0
8318,6,3,29009,29009,29012,0,3,1
8319,1,3,29010,29012,29015,2,5,0
8320,5,1,29015,29015,29016,0,1,0
8321,2,1,29017,29017,29018,0,1,1
8322,3,1,29020,29020,29021,0,1,2
8323,3,2,29023,29023,29025,0,2,2
8324,3,1,29026,29026,29027,0,1,1
8325,4,3,29030,29030,29033,0,3,3
8326,3,2,29033,29033,29035,0,2,0
8327,4,3,29037,29037,29040,0,3,2
8328,5,2,29042,29042,29044,0,2,2
8329,3,1,29045,29045,29046,0,1,1
8330,4,3,29049,29049,29052,0,3,3
8331,1,3,29050,29052,29055,2,5,0
8332,2,3,29052,29055,29058,3,6,0
8333,2,2,29054,29058,29060,4,6,0
8334,2,3,29056,29060,29063,4,7,0
8335,4,2,29060,29063,29065,3,5,0
8336,3,1,29063,29065,29066,2,3,0
8337,6,2,29069,29069,29071,0,2,3
8338,4,2,29073,29073,29075,0,2,2
8339,5,1,29078,29078,29079,0,1,3
8340,1,1,29079,29079,29080,0,1,0
8341,2,2,29081,29081,29083,0,2,1
8342,4,1,29085,29085,29086,0,1,2
8343,6,2,29091,29091,29093,0,2,5
8344,4,1,29095,29095,29096,0,1,2
8345,4,2,29099,29099,29101,0,2,3
8346,5,1,29104,29104,29105,0,1,3
8347,6,2,29110,29110,29112,0,2,5
8348,2,2,29112,29112,29114,0,2,0
8349,2,1,29114,29114,29115,0,1,0
8350,4,3,29118,29118,29121,0,3,3
8351,5,1,29123,29123,29124,0,1,2
8352,4,1,29127,29127,29128,0,1,3
8353,3,3,29130,29130,29133,0,3,2
8354,1,3,29131,29133,29136,2,5,0
8355,5,2,29136,29136,29138,0,2,0
8356,3,3,29139,29139,29142,0,3,1
8357,1,3,29140,29142,29145,2,5,0
8358,6,1,29146,29146,29147,0,1,1
8359,1,1,29147,29147,29148,0,1,0
8360,6,1,29153,29153,29154,0,1,5
8361,1,1,29154,29154,29155,0,1,0
8362,3,1,29157,29157,29158,0,1,2
8363,2,2,29159,29159,29161,0,2,1
8364,1,2,29160,29161,29163,1,3,0
8365,4,3,29164,29164,29167,0,3,1
8366,3,2,29167,29167,29169,0,2,0
8367,4,1,29171,29171,29172,0,1,2
8368,1,2,29172,29172,29174,0,2,0
8369,2,2,29174,29174,29176,0,2,0
8370,3,1,29177,29177,29178,0,1,1
8371,3,2,29180,29180,29182,0,2,2
8372,4,3,29184,29184,29187,0,3,2
8373,3,3,29187,29187,29190,0,3,0
8374,5,3,29192,29192,29195,0,3,2
8375,5,3,29197,29197,29200,0,3,2
8376,3,1,29200,29200,29201,0,1,0
8377,5,1,29205,29205,29206,0,1,4
8378,6,3,29211,29211,29214,0,3,5
8379,4,2,29215,29215,29217,0,2,1
8380,5,2,29220,29220,29222,0,2,3
8381,4,3,29224,29224,29227,0,3,2
8382,5,2,29229,29229,29231,0,2,2
8383,3,3,29232,29232,29235,0,3,1
8384,1,1,29233,29235,29236,2,3,0
8385,4,2,29237,29237,29239,0,2,1
8386,3,3,29240,29240,29243,0,3,1
8387,5,3,29245,29245,29248,0,3,2
8388,3,3,29248,29248,29251,0,3,0
8389,6,1,29254,29254,29255,0,1,3
8390,5,1,29259,29259,29260,0,1,4
8391,5,2,29264,29264,29266,0,2,4
8392,1,2,29265,29266,29268,1,3,0
8393,1,1,29266,29268,29269,2,3,0
8394,5,2,29271,29271,29273,0,2,2
8395,3,3,29274,29274,29277,0,3,1
8396,2,3,29276,29277,29280,1,4,0
8397,2,1,29278,29280,29281,2,3,0
8398,5,2,29283,29283,29285,0,2,2
8399,6,2,29289,29289,29291,0,2,4
8400,2,1,29291,29291,29292,0,1,0
8401,1,1,29292,29292,29293,0,1,0
8402,6,1,29298,29298,29299,0,1,5
8403,1,1,29299,29299,29300,0,1,0
8404,5,1,29304,29304,29305,0,1,4
8405,1,3,29305,29305,29308,0,3,0
8406,6,3,29311,29311,29314,0,3,3
8407,5,3,29316,29316,29319,0,3,2
8408,1,2,29317,29319,29321,2,4,0
8409,5,2,29322,29322,29324,0,2,1
8410,2,2,29324,29324,29326,0,2,0
8411,5,3,29329,29329,29332,0,3,3
8412,2,1,29331,29332,29333,1,2,0
8413,4,3,29335,29335,29338,0,3,2
8414,4,1,29339,29339,29340,0,1,1
8415,4,3,29343,29343,29346,0,3,3
8416,3,3,29346,29346,29349,0,3,0
8417,6,2,29352,29352,29354,0,2,3
8418,6,1,29358,29358,29359,0,1,4
8419,2,1,29360,29360,29361,0,1,1
8420,6,3,29366,29366,29369,0,3,5
8421,1,1,29367,29369,29370,2,3,0
8422,3,1,29370,29370,29371,0,1,0
8423,6,3,29376,29376,29379,0,3,5
8424,6,3,29382,29382,29385,0,3,3
8425,4,3,29386,29386,29389,0,3,1
8426,4,3,29390,29390,29393,0,3,1
8427,2,3,29392,29393,29396,1,4,0
8428,2,2,29394,29396,29398,2,4,0
8429,6,3,29400,29400,29403,0,3,2
8430,1,3,29401,29403,29406,2,5,0
8431,5,1,29406,29406,29407,0,1,0
8432,2,3,29408,29408,29411,0,3,1
8433,6,1,29414,29414,29415,0,1,3
8434,3,3,29417,29417,29420,0,3,2
8435,5,3,29422,29422,29425,0,3,2
8436,6,3,29428,29428,29431,0,3,3
8437,3,1,29431,29431,29432,0,1,0
8438,5,1,29436,29436,29437,0,1,4
8439,6,2,29442,29442,29444,0,2,5
8440,6,3,29448,29448,29451,0,3,4
8441,3,1,29451,29451,29452,0,1,0
8442,6,1,29457,29457,29458,0,1,5
8443,3,3,29460,29460,29463,0,3,2
8444,5,2,29465,29465,29467,0,2,2
8445,1,1,29466,29467,29468,1,2,0
8446,5,3,29471,29471,29474,0,3,3
8447,4,2,29475,29475,29477,0,2,1
8448,4,3,29479,29479,29482,0,3,2
8449,1,1,29480,29482,29483,2,3,0
8450,4,2,29484,29484,29486,0,2,1
8451,6,2,29490,29490,29492,0,2,4
8452,5,2,29495,29495,29497,0,2,3
8453,4,1,29499,29499,29500,0,1,2
8454,3,3,29502,29502,29505,0,3,2
8455,3,1,29505,29505,29506,0,1,0
8456,4,3,29509,29509,29512,0,3,3
8457,2,1,29511,29512,29513,1,2,0
8458,3,3,29514,29514,29517,0,3,1
8459,2,1,29516,29517,29518,1,2,0
8460,6,3,29522,29522,29525,0,3,4
8461,5,2,29527,29527,29529,0,2,2
8462,3,3,29530,29530,29533,0,3,1
8463,6,2,29536,29536,29538,0,2,3
8464,2,2,29538,29538,29540,0,2,0
8465,2,1,29540,29540,29541,0,1,0
8466,6,1,29546,29546,29547,0,1,5
8467,6,1,29552,29552,29553,0,1,5
8468,5,2,29557,29557,29559,0,2,4
8469,3,1,29560,29560,29561,0,1,1
8470,4,1,29564,29564,29565,0,1,3
8471,5,2,29569,29569,29571,0,2,4
8472,6,3,29575,29575,29578,0,3,4
8473,1,2,29576,29578,29580,2,4,0
8474,1,1,29577,29580,29581,3,4,0
8475,3,2,29580,29581,29583,1,3,0
8476,1,3,29581,29583,29586,2,5,0
8477,3,3,29584,29586,29589,2,5,0
8478,6,2,29590,29590,29592,0,2,1
8479,5,3,29595,29595,29598,0,3,3
8480,4,1,29599,29599,29600,0,1,1
8481,6,3,29605,29605,29608,0,3,5
8482,3,2,29608,29608,29610,0,2,0
8483,1,1,29609,29610,29611,1,2,0
8484,3,3,29612,29612,29615,0,3,1
8485,1,1,29613,29615,29616,2,3,0
8486,4,2,29617,29617,29619,0,2,1
8487,4,1,29621,29621,29622,0,1,2
8488,2,3,29623,29623,29626,0,3,1
8489,2,3,29625,29626,29629,1,4,0
8490,5,3,29630,29630,29633,0,3,1
8491,3,2,29633,29633,29635,0,2,0
8492,5,2,29638,29638,29640,0,2,3
8493,4,3,29642,29642,29645,0,3,2
8494,2,3,29644,29645,29648,1,4,0
8495,6,1,29650,29650,29651,0,1,2
8496,2,1,29652,29652,29653,0,1,1
8497,1,2,29653,29653,29655,0,2,0
8498,5,1,29658,29658,29659,0,1,3
8499,4,3,29662,29662,29665,0,3,3
8500,6,2,29668,29668,29670,0,2,3
8501,3,1,29671,29671,29672,0,1,1
8502,3,2,29674,29674,29676,0,2,2
8503,3,2,29677,29677,29679,0,2,1
8504,3,1,29680,29680,29681,0,1,1
8505,6,1,29686,29686,29687,0,1,5
8506,4,1,29690,29690,29691,0,1,3
8507,3,2,29693,29693,29695,0,2,2
8508,3,1,29696,29696,29697,0,1,1
8509,1,1,29697,29697,29698,0,1,0
8510,4,2,29701,29701,29703,0,2,3
8511,2,3,29703,29703,29706,0,3,0
8512,2,3,29705,29706,29709,1,4,0
8513,2,1,29707,29709,29710,2,3,0
8514,1,2,29708,29710,29712,2,4,0
8515,6,2,29714,29714,29716,0,2,2
8516,6,2,29720,29720,29722,0,2,4
8517,2,2,29722,29722,29724,0,2,0
8518,1,2,29723,29724,29726,1,3,0
8519,2,3,29725,29726,29729,1,4,0
8520,5,3,29730,29730,29733,0,3,1
8521,1,3,29731,29733,29736,2,5,0
8522,5,1,29736,29736,29737,0,1,0
8523,6,1,29742,29742,29743,0,1,5
8524,3,2,29745,29745,29747,0,2,2
8525,5,3,29750,29750,29753,0,3,3
8526,6,2,29756,29756,29758,0,2,3
8527,5,1,29761,29761,29762,0,1,3
8528,5,2,29766,29766,29768,0,2,4
8529,1,2,29767,29768,29770,1,3,0
8530,4,1,29771,29771,29772,0,1,1
8531,6,1,29777,29777,29778,0,1,5
8532,5,3,29782,29782,29785,0,3,4
8533,3,3,29785,29785,29788,0,3,0
8534,3,2,29788,29788,29790,0,2,0
8535,6,2,29794,29794,29796,0,2,4
8536,3,3,29797,29797,29800,0,3,1
8537,5,1,29802,29802,29803,0,1,2
8538,2,3,29804,29804,29807,0,3,1
8539,6,3,29810,29810,29813,0,3,3
8540,6,2,29816,29816,29818,0,2,3
8541,5,1,29821,29821,29822,0,1,3
8542,2,2,29823,29823,29825,0,2,1
8543,2,3,29825,29825,29828,0,3,0
8544,2,2,29827,29828,29830,1,3,0
8545,4,1,29831,29831,29832,0,1,1
8546,3,3,29834,29834,29837,0,3,2
8547,3,2,29837,29837,29839,0,2,0
8548,3,2,29840,29840,29842,0,2,1
8549,4,1,29844,29844,29845,0,1,2
8550,5,3,29849,29849,29852,0,3,4
8551,2,1,29851,29852,29853,1,2,0
8552,1,2,29852,29853,29855,1,3,0
8553,5,2,29857,29857,29859,0,2,2
8554,6,2,29863,29863,29865,0,2,4
8555,3,3,29866,29866,29869,0,3,1
8556,4,3,29870,29870,29873,0,3,1
8557,1,1,29871,29873,29874,2,3,0
8558,5,3,29876,29876,29879,0,3,2
8559,4,1,29880,29880,29881,0,1,1
8560,1,2,29881,29881,29883,0,2,0
8561,1,1,29882,29883,29884,1,2,0
8562,5,3,29887,29887,29890,0,3,3
8563,3,2,29890,29890,29892,0,2,0
8564,3,1,29893,29893,29894,0,1,1
8565,3,2,29896,29896,29898,0,2,2
8566,4,3,29900,29900,29903,0,3,2
8567,4,3,29904,29904,29907,0,3,1
8568,4,2,29908,29908,29910,0,2,1
8569,3,2,29911,29911,29913,0,2,1
8570,5,2,29916,29916,29918,0,2,3
8571,4,2,29920,29920,29922,0,2,2
8572,2,2,29922,29922,29924,0,2,0
8573,1,2,29923,29924,29926,1,3,0
8574,2,3,29925,29926,29929,1,4,0
8575,5,3,29930,29930,29933,0,3,1
8576,2,3,29932,29933,29936,1,4,0
8577,2,1,29934,29936,29937,2,3,0
8578,4,2,29938,29938,29940,0,2,1
8579,4,2,29942,29942,29944,0,2,2
8580,3,2,29945,29945,29947,0,2,1
8581,6,2,29951,29951,29953,0,2,4
8582,2,3,29953,29953,29956,0,3,0
8583,5,3,29958,29958,29961,0,3,2
8584,5,1,29963,29963,29964,0,1,2
8585,5,3,29968,29968,29971,0,3,4
8586,6,2,29974,29974,29976,0,2,3
8587,1,3,29975,29976,29979,1,4,0
8588,4,1,29979,29979,29980,0,1,0
8589,1,1,29980,29980,29981,0,1,0
8590,6,1,29986,29986,29987,0,1,5
8591,3,2,29989,29989,29991,0,2,2
8592,3,3,29992,29992,29995,0,3,1
8593,4,1,29996,29996,29997,0,1,1
8594,3,2,29999,29999,30001,0,2,2
8595,3,2,30002,30002,30004,0,2,1
8596,2,3,30004,30004,30007,0,3,0
8597,4,2,30008,30008,30010,0,2,1
8598,3,2,30011,30011,30013,0,2,1
8599,5,1,30016,30016,30017,0,1,3
8600,6,2,30022,30022,30024,0,2,5
8601,3,3,30025,30025,30028,0,3,1
8602,1,3,30026,30028,30031,2,5,0
8603,2,3,30028,30031,30034,3,6,0
8604,3,2,30031,30034,30036,3,5,0
8605,5,1,30036,30036,30037,0,1,0
8606,1,2,30037,30037,30039,0,2,0
8607,4,3,30041,30041,30044,0,3,2
8608,3,1,30044,30044,30045,0,1,0
8609,3,1,30047,30047,30048,0,1,2
8610,5,3,30052,30052,30055,0,3,4
8611,1,2,30053,30055,30057,2,4,0
8612,1,1,30054,30057,30058,3,4,0
8613,2,1,30056,30058,30059,2,3,0
8614,5,2,30061,30061,30063,0,2,2
8615,2,2,30063,30063,30065,0,2,0
8616,3,3,30066,30066,30069,0,3,1
8617,1,1,30067,30069,30070,2,3,0
8618,3,2,30070,30070,30072,0,2,0
8619,2,3,30072,30072,30075,0,3,0
8620,5,2,30077,30077,30079,0,2,2
8621,3,3,30080,30080,30083,0,3,1
8622,5,2,30085,30085,30087,0,2,2
8623,6,2,30091,30091,30093,0,2,4
8624,1,1,30092,30093,30094,1,2,0
8625,3,2,30095,30095,30097,0,2,1
8626,2,2,30097,30097,30099,0,2,0
8627,3,1,30100,30100,30101,0,1,1
8628,1,3,30101,30101,30104,0,3,0
8629,6,2,30107,30107,30109,0,2,3
8630,3,1,30110,30110,30111,0,1,1
8631,1,2,30111,30111,30113,0,2,0
8632,6,2,30117,30117,30119,0,2,4
8633,2,3,30119,30119,30122,0,3,0
8634,3,2,30122,30122,30124,0,2,0
8635,4,1,30126,30126,30127,0,1,2
8636,6,3,30132,30132,30135,0,3,5
8637,3,1,30135,30135,30136,0,1,0
8638,5,2,30140,30140,30142,0,2,4
8639,1,1,30141,30142,30143,1,2,0
8640,5,2,30146,30146,30148,0,2,3
8641,3,1,30149,30149,30150,0,1,1
8642,2,3,30151,30151,30154,0,3,1
8643,5,3,30156,30156,30159,0,3,2
8644,1,2,30157,30159,30161,2,4,0
8645,1,3,30158,30161,30164,3,6,0
8646,3,1,30161,30164,30165,3,4,0
8647,6,1,30167,30167,30168,0,1,2
8648,4,3,30171,30171,30174,0,3,3
8649,5,3,30176,30176,30179,0,3,2
8650,4,1,30180,30180,30181,0,1,1
8651,6,1,30186,30186,30187,0,1,5
8652,5,1,30191,30191,30192,0,1,4
8653,6,1,30197,30197,30198,0,1,5
8654,3,2,30200,30200,30202,0,2,2
8655,2,1,30202,30202,30203,0,1,0
8656,4,2,30206,30206,30208,0,2,3
8657,2,2,30208,30208,30210,0,2,0
8658,5,1,30213,30213,30214,0,1,3
8659,5,3,30218,30218,30221,0,3,4
8660,3,2,30221,30221,30223,0,2,0
8661,3,3,30224,30224,30227,0,3,1
8662,6,3,30230,30230,30233,0,3,3
8663,2,1,30232,30233,30234,1,2,0
8664,1,2,30233,30234,30236,1,3,0
8665,2,2,30235,30236,30238,1,3,0
8666,4,1,30239,30239,30240,0,1,1
8667,2,1,30241,30241,30242,0,1,1
8668,3,1,30244,30244,30245,0,1,2
8669,2,2,30246,30246,30248,0,2,1
8670,2,1,30248,30248,30249,0,1,0
8671,4,2,30252,30252,30254,0,2,3
8672,2,1,30254,30254,30255,0,1,0
8673,4,2,30258,30258,30260,0,2,3
8674,4,2,30262,30262,30264,0,2,2
8675,2,2,30264,30264,30266,0,2,0
8676,5,3,30269,30269,30272,0,3,3
8677,5,1,30274,30274,30275,0,1,2
8678,5,3,30279,30279,30282,0,3,4
8679,3,2,30282,30282,30284,0,2,0
8680,4,3,30286,30286,30289,0,3,2
8681,5,2,30291,30291,30293,0,2,2
8682,6,3,30297,30297,30300,0,3,4
8683,2,2,30299,30300,30302,1,3,0
8684,6,2,30305,30305,30307,0,2,3
8685,1,2,30306,30307,30309,1,3,0
8686,1,3,30307,30309,30312,2,5,0
8687,1,1,30308,30312,30313,4,5,0
8688,1,3,30309,30313,30316,4,7,0
8689,4,2,30313,30316,30318,3,5,0
8690,3,3,30316,30318,30321,2,5,0
8691,3,3,30319,30321,30324,2,5,0
8692,1,1,30320,30324,30325,4,5,0
8693,3,2,30323,30325,30327,2,4,0
8694,1,1,30324,30327,30328,3,4,0
8695,1,3,30325,30328,30331,3,6,0
8696,2,1,30327,30331,30332,4,5,0
8697,2,1,30329,30332,30333,3,4,0
8698,3,3,30332,30333,30336,1,4,0
8699,1,1,30333,30336,30337,3,4,0
8700,1,3,30334,30337,30340,3,6,0
8701,4,3,30338,30340,30343,2,5,0
8702,3,2,30341,30343,30345,2,4,0
8703,5,2,30346,30346,30348,0,2,1
8704,5,2,30351,30351,30353,0,2,3
8705,4,3,30355,30355,30358,0,3,2
8706,3,1,30358,30358,30359,0,1,0
8707,3,2,30361,30361,30363,0,2,2
8708,4,2,30365,30365,30367,0,2,2
8709,4,3,30369,30369,30372,0,3,2
8710,1,1,30370,30372,30373,2,3,0
8711,3,1,30373,30373,30374,0,1,0
8712,4,3,30377,30377,30380,0,3,3
8713,3,2,30380,30380,30382,0,2,0
8714,3,1,30383,30383,30384,0,1,1
8715,5,1,30388,30388,30389,0,1,4
8716,3,2,30391,30391,30393,0,2,2
8717,1,1,30392,30393,30394,1,2,0
8718,2,1,30394,30394,30395,0,1,0
8719,5,3,30399,30399,30402,0,3,4
8720,6,1,30405,30405,30406,0,1,3
8721,3,3,30408,30408,30411,0,3,2
8722,3,1,30411,30411,30412,0,1,0
8723,1,3,30412,30412,30415,0,3,0
8724,5,1,30417,30417,30418,0,1,2
8725,3,2,30420,30420,30422,0,2,2
8726,1,3,30421,30422,30425,1,4,0
8727,2,2,30423,30425,30427,2,4,0
8728,1,1,30424,30427,30428,3,4,0
8729,1,3,30425,30428,30431,3,6,0
8730,4,1,30429,30431,30432,2,3,0
8731,6,1,30435,30435,30436,0,1,3
8732,2,3,30437,30437,30440,0,3,1
8733,1,1,30438,30440,30441,2,3,0
8734,4,1,30442,30442,30443,0,1,1
8735,4,1,30446,30446,30447,0,1,3
8736,3,3,30449,30449,30452,0,3,2
8737,3,1,30452,30452,30453,0,1,0
8738,2,3,30454,30454,30457,0,3,1
8739,4,1,30458,30458,30459,0,1,1
8740,1,3,30459,30459,30462,0,3,0
8741,6,3,30465,30465,30468,0,3,3
8742,6,1,30471,30471,30472,0,1,3
8743,1,1,30472,30472,30473,0,1,0
8744,5,3,30477,30477,30480,0,3,4
8745,3,1,30480,30480,30481,0,1,0
8746,5,3,30485,30485,30488,0,3,4
8747,2,3,30487,30488,30491,1,4,0
8748,2,2,30489,30491,30493,2,4,0
8749,1,2,30490,30493,30495,3,5,0
8750,4,2,30494,30495,30497,1,3,0
8751,3,2,30497,30497,30499,0,2,0
8752,6,2,30503,30503,30505,0,2,4
8753,4,2,30507,30507,30509,0,2,2
8754,5,2,30512,30512,30514,0,2,3
8755,6,3,30518,30518,30521,0,3,4
8756,4,1,30522,30522,30523,0,1,1
8757,5,1,30527,30527,30528,0,1,4
8758,5,1,30532,30532,30533,0,1,4
8759,3,2,30535,30535,30537,0,2,2
8760,4,2,30539,30539,30541,0,2,2
8761,6,2,30545,30545,30547,0,2,4
8762,5,2,30550,30550,30552,0,2,3
8763,5,2,30555,30555,30557,0,2,3
8764,2,2,30557,30557,30559,0,2,0
8765,5,1,30562,30562,30563,0,1,3
8766,3,3,30565,30565,30568,0,3,2
8767,6,2,30571,30571,30573,0,2,3
8768,1,1,30572,30573,30574,1,2,0
8769,5,1,30577,30577,30578,0,1,3
8770,1,2,30578,30578,30580,0,2,0
8771,5,3,30583,30583,30586,0,3,3
8772,3,2,30586,30586,30588,0,2,0
8773,4,1,30590,30590,30591,0,1,2
8774,5,3,30595,30595,30598,0,3,4
8775,5,3,30600,30600,30603,0,3,2
8776,3,2,30603,30603,30605,0,2,0
8777,5,1,30608,30608,30609,0,1,3
8778,1,2,30609,30609,30611,0,2,0
8779,2,1,30611,30611,30612,0,1,0
8780,6,1,30617,30617,30618,0,1,5
8781,1,1,30618,30618,30619,0,1,0
8782,5,1,30623,30623,30624,0,1,4
8783,2,3,30625,30625,30628,0,3,1
8784,4,3,30629,30629,30632,0,3,1
8785,6,3,30635,30635,30638,0,3,3
8786,5,1,30640,30640,30641,0,1,2
8787,4,3,30644,30644,30647,0,3,3
8788,1,1,30645,30647,30648,2,3,0
8789,2,1,30647,30648,30649,1,2,0
8790,2,2,30649,30649,30651,0,2,0
8791,1,3,30650,30651,30654,1,4,0
8792,3,2,30653,30654,30656,1,3,0
8793,2,2,30655,30656,30658,1,3,0
8794,1,3,30656,30658,30661,2,5,0
8795,1,3,30657,30661,30664,4,7,0
8796,6,3,30663,30664,30667,1,4,0
8797,2,2,30665,30667,30669,2,4,0
8798,6,3,30671,30671,30674,0,3,2
8799,1,1,30672,30674,30675,2,3,0
8800,6,1,30678,30678,30679,0,1,3
8801,6,1,30684,30684,30685,0,1,5
8802,4,1,30688,30688,30689,0,1,3
8803,4,1,30692,30692,30693,0,1,3
8804,3,2,30695,30695,30697,0,2,2
8805,3,2,30698,30698,30700,0,2,1
8806,6,1,30704,30704,30705,0,1,4
8807,3,3,30707,30707,30710,0,3,2
8808,6,2,30713,30713,30715,0,2,3
8809,5,2,30718,30718,30720,0,2,3
8810,5,2,30723,30723,30725,0,2,3
8811,3,3,30726,30726,30729,0,3,1
8812,3,2,30729,30729,30731,0,2,0
8813,5,2,30734,30734,30736,0,2,3
8814,5,1,30739,30739,30740,0,1,3
8815,6,2,30745,30745,30747,0,2,5
8816,3,3,30748,30748,30751,0,3,1
8817,6,1,30754,30754,30755,0,1,3
8818,2,3,30756,30756,30759,0,3,1
8819,6,3,30762,30762,30765,0,3,3
8820,2,3,30764,30765,30768,1,4,0
8821,3,3,30767,30768,30771,1,4,0
8822,1,2,30768,30771,30773,3,5,0
8823,2,1,30770,30773,30774,3,4,0
8824,3,1,30773,30774,30775,1,2,0
8825,5,1,30778,30778,30779,0,1,3
8826,3,3,30781,30781,30784,0,3,2
8827,3,3,30784,30784,30787,0,3,0
8828,6,1,30790,30790,30791,0,1,3
8829,4,3,30794,30794,30797,0,3,3
8830,1,1,30795,30797,30798,2,3,0
8831,2,2,30797,30798,30800,1,3,0
8832,2,3,30799,30800,30803,1,4,0
8833,4,2,30803,30803,30805,0,2,0
8834,2,2,30805,30805,30807,0,2,0
8835,2,3,30807,30807,30810,0,3,0
8836,1,2,30808,30810,30812,2,4,0
8837,2,1,30810,30812,30813,2,3,0
8838,2,1,30812,30813,30814,1,2,0
8839,4,2,30816,30816,30818,0,2,2
8840,6,1,30822,30822,30823,0,1,4
8841,5,1,30827,30827,30828,0,1,4
8842,4,1,30831,30831,30832,0,1,3
8843,1,1,30832,30832,30833,0,1,0
8844,3,1,30835,30835,30836,0,1,2
8845,2,3,30837,30837,30840,0,3,1
8846,6,2,30843,30843,30845,0,2,3
8847,5,3,30848,30848,30851,0,3,3
8848,1,2,30849,30851,30853,2,4,0
8849,6,1,30855,30855,30856,0,1,2
8850,3,3,30858,30858,30861,0,3,2
8851,5,1,30863,30863,30864,0,1,2
8852,2,2,30865,30865,30867,0,2,1
8853,6,3,30871,30871,30874,0,3,4
8854,2,3,30873,30874,30877,1,4,0
8855,5,3,30878,30878,30881,0,3,1
8856,1,3,30879,30881,30884,2,5,0
8857,1,2,30880,30884,30886,4,6,0
8858,2,2,30882,30886,30888,4,6,0
8859,4,2,30886,30888,30890,2,4,0
8860,4,1,30890,30890,30891,0,1,0
8861,4,2,30894,30894,30896,0,2,3
8862,6,3,30900,30900,30903,0,3,4
8863,1,3,30901,30903,30906,2,5,0
8864,6,2,30907,30907,30909,0,2,1
8865,5,1,30912,30912,30913,0,1,3
8866,6,1,30918,30918,30919,0,1,5
8867,4,2,30922,30922,30924,0,2,3
8868,2,1,30924,30924,30925,0,1,0
8869,4,1,30928,30928,30929,0,1,3
8870,2,1,30930,30930,30931,0,1,1
8871,4,2,30934,30934,30936,0,2,3
8872,1,2,30935,30936,30938,1,3,0
8873,5,1,30940,30940,30941,0,1,2
8874,6,1,30946,30946,30947,0,1,5
8875,6,2,30952,30952,30954,0,2,5
8876,5,1,30957,30957,30958,0,1,3
8877,5,1,30962,30962,30963,0,1,4
8878,3,1,30965,30965,30966,0,1,2
8879,3,2,30968,30968,30970,0,2,2
8880,1,2,30969,30970,30972,1,3,0
8881,4,2,30973,30973,30975,0,2,1
8882,5,2,30978,30978,30980,0,2,3
8883,3,3,30981,30981,30984,0,3,1
8884,6,3,30987,30987,30990,0,3,3
8885,2,1,30989,30990,30991,1,2,0
8886,1,2,30990,30991,30993,1,3,0
8887,5,1,30995,30995,30996,0,1,2
8888,1,1,30996,30996,30997,0,1,0
8889,2,3,30998,30998,31001,0,3,1
8890,3,1,31001,31001,31002,0,1,0
8891,2,3,31003,31003,31006,0,3,1
8892,1,3,31004,31006,31009,2,5,0
8893,1,2,31005,31009,31011,4,6,0
8894,2,2,31007,31011,31013,4,6,0
8895,2,2,31009,31013,31015,4,6,0
8896,6,1,31015,31015,31016,0,1,0
8897,1,2,31016,31016,31018,0,2,0
8898,5,3,31021,31021,31024,0,3,3
8899,2,3,31023,31024,31027,1,4,0
8900,4,1,31027,31027,31028,0,1,0
8901,2,1,31029,31029,31030,0,1,1
8902,4,1,31033,31033,31034,0,1,3
8903,4,1,31037,31037,31038,0,1,3
8904,3,3,31040,31040,31043,0,3,2
8905,6,1,31046,31046,31047,0,1,3
8906,2,1,31048,31048,31049,0,1,1
8907,5,1,31053,31053,31054,0,1,4
8908,2,2,31055,31055,31057,0,2,1
8909,5,2,31060,31060,31062,0,2,3
8910,5,3,31065,31065,31068,0,3,3
8911,2,2,31067,31068,31070,1,3,0
8912,3,1,31070,31070,31071,0,1,0
8913,4,2,31074,31074,31076,0,2,3
8914,2,1,31076,31076,31077,0,1,0
8915,1,2,31077,31077,31079,0,2,0
8916,3,3,31080,31080,31083,0,3,1
8917,6,1,31086,31086,31087,0,1,3
8918,1,1,31087,31087,31088,0,1,0
8919,4,2,31091,31091,31093,0,2,3
8920,2,3,31093,31093,31096,0,3,0
8921,4,1,31097,31097,31098,0,1,1
8922,4,2,31101,31101,31103,0,2,3
8923,1,2,31102,31103,31105,1,3,0
8924,2,3,31104,31105,31108,1,4,0
8925,6,3,31110,31110,31113,0,3,2
8926,6,3,31116,31116,31119,0,3,3
8927,1,1,31117,31119,31120,2,3,0
8928,2,1,31119,31120,31121,1,2,0
8929,6,3,31125,31125,31128,0,3,4
8930,4,1,31129,31129,31130,0,1,1
8931,6,3,31135,31135,31138,0,3,5
8932,6,3,31141,31141,31144,0,3,3
8933,3,2,31144,31144,31146,0,2,0
8934,2,1,31146,31146,31147,0,1,0
8935,6,3,31152,31152,31155,0,3,5
8936,2,1,31154,31155,31156,1,2,0
8937,6,3,31160,31160,31163,0,3,4
8938,6,2,31166,31166,31168,0,2,3
8939,5,3,31171,31171,31174,0,3,3
8940,3,3,31174,31174,31177,0,3,0
8941,4,2,31178,31178,31180,0,2,1
8942,6,3,31184,31184,31187,0,3,4
8943,3,3,31187,31187,31190,0,3,0
8944,2,3,31189,31190,31193,1,4,0
8945,2,3,31191,31193,31196,2,5,0
8946,3,1,31194,31196,31197,2,3,0
8947,3,3,31197,31197,31200,0,3,0
8948,4,2,31201,31201,31203,0,2,1
8949,3,1,31204,31204,31205,0,1,1
8950,2,1,31206,31206,31207,0,1,1
8951,6,3,31212,31212,31215,0,3,5
8952,6,2,31218,31218,31220,0,2,3
8953,1,3,31219,31220,31223,1,4,0
8954,1,2,31220,31223,31225,3,5,0
8955,5,2,31225,31225,31227,0,2,0
8956,5,3,31230,31230,31233,0,3,3
8957,1,2,31231,31233,31235,2,4,0
8958,6,3,31237,31237,31240,0,3,2
8959,6,2,31243,31243,31245,0,2,3
8960,2,1,31245,31245,31246,0,1,0
8961,2,2,31247,31247,31249,0,2,1
8962,6,2,31253,31253,31255,0,2,4
8963,5,1,31258,31258,31259,0,1,3
8964,3,2,31261,31261,31263,0,2,2
8965,5,1,31266,31266,31267,0,1,3
8966,1,1,31267,31267,31268,0,1,0
8967,4,2,31271,31271,31273,0,2,3
8968,6,1,31277,31277,31278,0,1,4
8969,5,1,31282,31282,31283,0,1,4
8970,5,2,31287,31287,31289,0,2,4
8971,4,1,31291,31291,31292,0,1,2
8972,5,3,31296,31296,31299,0,3,4
8973,6,3,31302,31302,31305,0,3,3
8974,6,2,31308,31308,31310,0,2,3
8975,3,2,31311,31311,31313,0,2,1
8976,2,2,31313,31313,31315,0,2,0
8977,5,3,31318,31318,31321,0,3,3
8978,3,2,31321,31321,31323,0,2,0
8979,3,1,31324,31324,31325,0,1,1
8980,4,2,31328,31328,31330,0,2,3
8981,1,2,31329,31330,31332,1,3,0
8982,2,3,31331,31332,31335,1,4,0
8983,2,2,31333,31335,31337,2,4,0
8984,3,3,31336,31337,31340,1,4,0
8985,4,1,31340,31340,31341,0,1,0
8986,2,2,31342,31342,31344,0,2,1
8987,1,1,31343,31344,31345,1,2,0
8988,5,3,31348,31348,31351,0,3,3
8989,6,2,31354,31354,31356,0,2,3
8990,5,3,31359,31359,31362,0,3,3
8991,6,1,31365,31365,31366,0,1,3
8992,6,1,31371,31371,31372,0,1,5
8993,2,3,31373,31373,31376,0,3,1
8994,4,1,31377,31377,31378,0,1,1
8995,2,1,31379,31379,31380,0,1,1
8996,6,3,31385,31385,31388,0,3,5
8997,1,1,31386,31388,31389,2,3,0
8998,3,1,31389,31389,31390,0,1,0
8999,6,2,31395,31395,31397,0,2,5
9000,1,1,31396,31397,31398,1,2,0
9001,3,1,31399,31399,31400,0,1,1
9002,6,3,31405,31405,31408,0,3,5
9003,4,2,31409,31409,31411,0,2,1
9004,6,2,31415,31415,31417,0,2,4
9005,6,1,31421,31421,31422,0,1,4
9006,6,1,31427,31427,31428,0,1,5
9007,1,1,31428,31428,31429,0,1,0
9008,1,3,31429,31429,31432,0,3,0
9009,3,2,31432,31432,31434,0,2,0
9010,2,2,31434,31434,31436,0,2,0
9011,4,2,31438,31438,31440,0,2,2
9012,6,1,31444,31444,31445,0,1,4
9013,4,1,31448,31448,31449,0,1,3
9014,2,1,31450,31450,31451,0,1,1
9015,5,1,31455,31455,31456,0,1,4
9016,2,3,31457,31457,31460,0,3,1
9017,6,3,31463,31463,31466,0,3,3
9018,2,1,31465,31466,31467,1,2,0
9019,4,1,31469,31469,31470,0,1,2
9020,5,2,31474,31474,31476,0,2,4
9021,2,1,31476,31476,31477,0,1,0
9022,4,3,31480,31480,31483,0,3,3
9023,5,1,31485,31485,31486,0,1,2
9024,3,1,31488,31488,31489,0,1,2
9025,5,1,31493,31493,31494,0,1,4
9026,1,1,31494,31494,31495,0,1,0
9027,3,3,31497,31497,31500,0,3,2
9028,5,2,31502,31502,31504,0,2,2
9029,4,3,31506,31506,31509,0,3,2
9030,6,3,31512,31512,31515,0,3,3
9031,1,3,31513,31515,31518,2,5,0
9032,6,1,31519,31519,31520,0,1,1
9033,5,3,31524,31524,31527,0,3,4
9034,6,3,31530,31530,31533,0,3,3
9035,4,1,31534,31534,31535,0,1,1
9036,2,1,31536,31536,31537,0,1,1
9037,4,1,31540,31540,31541,0,1,3
9038,3,3,31543,31543,31546,0,3,2
9039,6,1,31549,31549,31550,0,1,3
9040,3,2,31552,31552,31554,0,2,2
9041,2,3,31554,31554,31557,0,3,0
9042,2,2,31556,31557,31559,1,3,0
9043,3,2,31559,31559,31561,0,2,0
9044,5,2,31564,31564,31566,0,2,3
9045,3,2,31567,31567,31569,0,2,1
9046,1,1,31568,31569,31570,1,2,0
9047,3,1,31571,31571,31572,0,1,1
9048,5,3,31576,31576,31579,0,3,4
9049,2,1,31578,31579,31580,1,2,0
9050,4,2,31582,31582,31584,0,2,2
9051,3,3,31585,31585,31588,0,3,1
9052,6,3,31591,31591,31594,0,3,3
9053,6,2,31597,31597,31599,0,2,3
9054,5,2,31602,31602,31604,0,2,3
9055,6,1,31608,31608,31609,0,1,4
9056,4,3,31612,31612,31615,0,3,3
9057,4,2,31616,31616,31618,0,2,1
9058,1,3,31617,31618,31621,1,4,0
9059,6,1,31623,31623,31624,0,1,2
9060,3,3,31626,31626,31629,0,3,2
9061,4,3,31630,31630,31633,0,3,1
9062,6,3,31636,31636,31639,0,3,3
9063,2,1,31638,31639,31640,1,2,0
9064,6,2,31644,31644,31646,0,2,4
9065,1,3,31645,31646,31649,1,4,0
9066,2,1,31647,31649,31650,2,3,0
9067,3,3,31650,31650,31653,0,3,0
9068,3,1,31653,31653,31654,0,1,0
9069,4,1,31657,31657,31658,0,1,3
9070,3,3,31660,31660,31663,0,3,2
9071,6,3,31666,31666,31669,0,3,3
9072,6,1,31672,31672,31673,0,1,3
9073,1,2,31673,31673,31675,0,2,0
9074,5,3,31678,31678,31681,0,3,3
9075,1,1,31679,31681,31682,2,3,0
9076,6,1,31685,31685,31686,0,1,3
9077,4,3,31689,31689,31692,0,3,3
9078,5,3,31694,31694,31697,0,3,2
9079,2,2,31696,31697,31699,1,3,0
9080,1,3,31697,31699,31702,2,5,0
9081,6,1,31703,31703,31704,0,1,1
9082,3,1,31706,31706,31707,0,1,2
9083,1,3,31707,31707,31710,0,3,0
9084,3,3,31710,31710,31713,0,3,0
9085,5,1,31715,31715,31716,0,1,2
9086,6,3,31721,31721,31724,0,3,5
9087,4,1,31725,31725,31726,0,1,1
9088,4,1,31729,31729,31730,0,1,3
9089,2,1,31731,31731,31732,0,1,1
9090,6,2,31737,31737,31739,0,2,5
9091,2,2,31739,31739,31741,0,2,0
9092,6,2,31745,31745,31747,0,2,4
9093,6,3,31751,31751,31754,0,3,4
9094,2,3,31753,31754,31757,1,4,0
9095,2,1,31755,31757,31758,2,3,0
9096,5,1,31760,31760,31761,0,1,2
9097,5,1,31765,31765,31766,0,1,4
9098,3,1,31768,31768,31769,0,1,2
9099,1,2,31769,31769,31771,0,2,0
9100,3,2,31772,31772,31774,0,2,1
9101,3,1,31775,31775,31776,0,1,1
9102,3,3,31778,31778,31781,0,3,2
9103,5,3,31783,31783,31786,0,3,2
9104,4,3,31787,31787,31790,0,3,1
9105,2,3,31789,31790,31793,1,4,0
9106,1,3,31790,31793,31796,3,6,0
9107,2,2,31792,31796,31798,4,6,0
9108,5,1,31797,31798,31799,1,2,0
9109,4,2,31801,31801,31803,0,2,2
9110,4,2,31805,31805,31807,0,2,2
9111,5,3,31810,31810,31813,0,3,3
9112,1,3,31811,31813,31816,2,5,0
9113,1,2,31812,31816,31818,4,6,0
9114,2,1,31814,31818,31819,4,5,0
9115,3,3,31817,31819,31822,2,5,0
9116,4,1,31821,31822,31823,1,2,0
9117,1,1,31822,31823,31824,1,2,0
9118,1,1,31823,31824,31825,1,2,0
9119,4,2,31827,31827,31829,0,2,2
9120,5,1,31832,31832,31833,0,1,3
9121,2,2,31834,31834,31836,0,2,1
9122,1,2,31835,31836,31838,1,3,0
9123,1,3,31836,31838,31841,2,5,0
9124,6,3,31842,31842,31845,0,3,1
9125,1,1,31843,31845,31846,2,3,0
9126,1,3,31844,31846,31849,2,5,0
9127,6,1,31850,31850,31851,0,1,1
9128,5,1,31855,31855,31856,0,1,4
9129,3,2,31858,31858,31860,0,2,2
9130,6,3,31864,31864,31867,0,3,4
9131,5,1,31869,31869,31870,0,1,2
9132,1,1,31870,31870,31871,0,1,0
9133,4,1,31874,31874,31875,0,1,3
9134,2,2,31876,31876,31878,0,2,1
9135,5,2,31881,31881,31883,0,2,3
9136,3,2,31884,31884,31886,0,2,1
9137,5,2,31889,31889,31891,0,2,3
9138,3,3,31892,31892,31895,0,3,1
9139,2,3,31894,31895,31898,1,4,0
9140,1,1,31895,31898,31899,3,4,0
9141,2,2,31897,31899,31901,2,4,0
9142,6,1,31903,31903,31904,0,1,2
9143,5,3,31908,31908,31911,0,3,4
9144,5,1,31913,31913,31914,0,1,2
9145,6,1,31919,31919,31920,0,1,5
9146,6,1,31925,31925,31926,0,1,5
9147,1,1,31926,31926,31927,0,1,0
9148,3,2,31929,31929,31931,0,2,2
9149,2,1,31931,31931,31932,0,1,0
9150,2,3,31933,31933,31936,0,3,1
9151,6,1,31939,31939,31940,0,1,3
9152,2,1,31941,31941,31942,0,1,1
9153,2,3,31943,31943,31946,0,3,1
9154,2,2,31945,31946,31948,1,3,0
9155,1,3,31946,31948,31951,2,5,0
9156,3,3,31949,31951,31954,2,5,0
9157,3,1,31952,31954,31955,2,3,0
9158,1,3,31953,31955,31958,2,5,0
9159,3,3,31956,31958,31961,2,5,0
9160,6,1,31962,31962,31963,0,1,1
9161,6,2,31968,31968,31970,0,2,5
9162,3,1,31971,31971,31972,0,1,1
9163,5,1,31976,31976,31977,0,1,4
9164,6,3,31982,31982,31985,0,3,5
9165,4,2,31986,31986,31988,0,2,1
9166,1,2,31987,31988,31990,1,3,0
9167,2,1,31989,31990,31991,1,2,0
9168,6,1,31995,31995,31996,0,1,4
9169,5,3,32000,32000,32003,0,3,4
9170,4,1,32004,32004,32005,0,1,1
9171,3,1,32007,32007,32008,0,1,2
9172,1,3,32008,32008,32011,0,3,0
9173,5,3,32013,32013,32016,0,3,2
9174,6,1,32019,32019,32020,0,1,3
9175,6,3,32025,32025,32028,0,3,5
9176,2,2,32027,32028,32030,1,3,0
9177,2,3,32029,32030,32033,1,4,0
9178,4,1,32033,32033,32034,0,1,0
9179,5,2,32038,32038,32040,0,2,4
9180,3,3,32041,32041,32044,0,3,1
9181,1,3,32042,32044,32047,2,5,0
9182,6,2,32048,32048,32050,0,2,1
9183,6,3,32054,32054,32057,0,3,4
9184,2,1,32056,32057,32058,1,2,0
9185,6,2,32062,32062,32064,0,2,4
9186,1,2,32063,32064,32066,1,3,0
9187,6,1,32069,32069,32070,0,1,3
9188,1,3,32070,32070,32073,0,3,0
9189,1,1,32071,32073,32074,2,3,0
9190,4,3,32075,32075,32078,0,3,1
9191,3,3,32078,32078,32081,0,3,0
9192,6,3,32084,32084,32087,0,3,3
9193,3,2,32087,32087,32089,0,2,0
9194,2,3,32089,32089,32092,0,3,0
9195,5,1,32094,32094,32095,0,1,2
9196,3,3,32097,32097,32100,0,3,2
9197,6,1,32103,32103,32104,0,1,3
9198,2,2,32105,32105,32107,0,2,1
9199,1,2,32106,32107,32109,1,3,0
9200,2,2,32108,32109,32111,1,3,0
9201,1,1,32109,32111,32112,2,3,0
9202,2,1,32111,32112,32113,1,2,0
9203,1,2,32112,32113,32115,1,3,0
9204,3,1,32115,32115,32116,0,1,0
9205,3,3,32118,32118,32121,0,3,2
9206,1,2,32119,32121,32123,2,4,0
9207,6,3,32125,32125,32128,0,3,2
9208,1,1,32126,32128,32129,2,3,0
9209,3,2,32129,32129,32131,0,2,0
9210,1,3,32130,32131,32134,1,4,0
9211,3,2,32133,32134,32136,1,3,0
9212,6,3,32139,32139,32142,0,3,3
9213,3,1,32142,32142,32143,0,1,0
9214,6,2,32148,32148,32150,0,2,5
9215,1,1,32149,32150,32151,1,2,0
9216,6,3,32155,32155,32158,0,3,4
9217,3,3,32158,32158,32161,0,3,0
9218,5,1,32163,32163,32164,0,1,2
9219,5,2,32168,32168,32170,0,2,4
9220,3,2,32171,32171,32173,0,2,1
9221,5,1,32176,32176,32177,0,1,3
9222,6,1,32182,32182,32183,0,1,5
9223,6,3,32188,32188,32191,0,3,5
9224,4,2,32192,32192,32194,0,2,1
9225,1,1,32193,32194,32195,1,2,0
9226,6,1,32199,32199,32200,0,1,4
9227,4,3,32203,32203,32206,0,3,3
9228,1,3,32204,32206,32209,2,5,0
9229,3,1,32207,32209,32210,2,3,0
9230,5,1,32212,32212,32213,0,1,2
9231,6,3,32218,32218,32221,0,3,5
9232,2,3,32220,32221,32224,1,4,0
9233,4,2,32224,32224,32226,0,2,0
9234,6,1,32230,32230,32231,0,1,4
9235,3,1,32233,32233,32234,0,1,2
9236,2,3,32235,32235,32238,0,3,1
9237,2,2,32237,32238,32240,1,3,0
9238,2,2,32239,32240,32242,1,3,0
9239,5,2,32244,32244,32246,0,2,2
9240,4,1,32248,32248,32249,0,1,2
9241,5,3,32253,32253,32256,0,3,4
9242,4,2,32257,32257,32259,0,2,1
9243,4,1,32261,32261,32262,0,1,2
9244,5,2,32266,32266,32268,0,2,4
9245,3,2,32269,32269,32271,0,2,1
9246,4,1,32273,32273,32274,0,1,2
9247,1,2,32274,32274,32276,0,2,0
9248,6,2,32280,32280,32282,0,2,4
9249,1,3,32281,32282,32285,1,4,0
9250,3,1,32284,32285,32286,1,2,0
9251,4,3,32288,32288,32291,0,3,2
9252,1,3,32289,32291,32294,2,5,0
9253,6,3,32295,32295,32298,0,3,1
9254,3,2,32298,32298,32300,0,2,0
9255,1,3,32299,32300,32303,1,4,0
9256,3,1,32302,32303,32304,1,2,0
9257,2,2,32304,32304,32306,0,2,0
9258,5,3,32309,32309,32312,0,3,3
9259,2,3,32311,32312,32315,1,4,0
9260,2,3,32313,32315,32318,2,5,0
9261,2,1,32315,32318,32319,3,4,0
9262,5,1,32320,32320,32321,0,1,1
9263,3,1,32323,32323,32324,0,1,2
9264,3,2,32326,32326,32328,0,2,2
9265,1,1,32327,32328,32329,1,2,0
9266,5,3,32332,32332,32335,0,3,3
9267,2,1,32334,32335,32336,1,2,0
9268,1,2,32335,32336,32338,1,3,0
9269,5,1,32340,32340,32341,0,1,2
9270,3,2,32343,32343,32345,0,2,2
9271,2,1,32345,32345,32346,0,1,0
9272,4,3,32349,32349,32352,0,3,3
9273,1,3,32350,32352,32355,2,5,0
9274,3,2,32353,32355,32357,2,4,0
9275,3,2,32356,32357,32359,1,3,0
9276,5,2,32361,32361,32363,0,2,2
9277,4,3,32365,32365,32368,0,3,2
9278,5,3,32370,32370,32373,0,3,2
9279,6,3,32376,32376,32379,0,3,3
9280,2,3,32378,32379,32382,1,4,0
9281,3,3,32381,32382,32385,1,4,0
9282,3,1,32384,32385,32386,1,2,0
9283,2,2,32386,32386,32388,0,2,0
9284,6,2,32392,32392,32394,0,2,4
9285,4,1,32396,32396,32397,0,1,2
9286,4,3,32400,32400,32403,0,3,3
9287,2,3,32402,32403,32406,1,4,0
9288,6,3,32408,32408,32411,0,3,2
9289,5,3,32413,32413,32416,0,3,2
9290,1,2,32414,32416,32418,2,4,0
9291,6,3,32420,32420,32423,0,3,2
9292,6,2,32426,32426,32428,0,2,3
9293,5,1,32431,32431,32432,0,1,3
9294,6,2,32437,32437,32439,0,2,5
9295,5,3,32442,32442,32445,0,3,3
9296,3,2,32445,32445,32447,0,2,0
9297,1,2,32446,32447,32449,1,3,0
9298,6,1,32452,32452,32453,0,1,3
9299,4,2,32456,32456,32458,0,2,3
9300,5,1,32461,32461,32462,0,1,3
9301,3,3,32464,32464,32467,0,3,2
9302,6,3,32470,32470,32473,0,3,3
9303,3,2,32473,32473,32475,0,2,0
9304,3,2,32476,32476,32478,0,2,1
9305,1,1,32477,32478,32479,1,2,0
9306,1,1,32478,32479,32480,1,2,0
9307,6,3,32484,32484,32487,0,3,4
9308,3,3,32487,32487,32490,0,3,0
9309,1,2,32488,32490,32492,2,4,0
9310,3,3,32491,32492,32495,1,4,0
9311,6,2,32497,32497,32499,0,2,2
9312,1,3,32498,32499,32502,1,4,0
9313,1,1,32499,32502,32503,3,4,0
9314,4,2,32503,32503,32505,0,2,0
9315,6,3,32509,32509,32512,0,3,4
9316,4,2,32513,32513,32515,0,2,1
9317,6,1,32519,32519,32520,0,1,4
9318,6,1,32525,32525,32526,0,1,5
9319,3,3,32528,32528,32531,0,3,2
9320,4,3,32532,32532,32535,0,3,1
9321,3,1,32535,32535,32536,0,1,0
9322,5,3,32540,32540,32543,0,3,4
9323,5,3,32545,32545,32548,0,3,2
9324,2,1,32547,32548,32549,1,2,0
9325,1,1,32548,32549,32550,1,2,0
9326,3,3,32551,32551,32554,0,3,1
9327,3,1,32554,32554,32555,0,1,0
9328,1,3,32555,32555,32558,0,3,0
9329,4,2,32559,32559,32561,0,2,1
9330,6,1,32565,32565,32566,0,1,4
9331,2,3,32567,32567,32570,0,3,1
9332,3,1,32570,32570,32571,0,1,0
9333,6,2,32576,32576,32578,0,2,5
9334,2,2,32578,32578,32580,0,2,0
9335,1,2,32579,32580,32582,1,3,0
9336,1,3,32580,32582,32585,2,5,0
9337,2,3,32582,32585,32588,3,6,0
9338,3,3,32585,32588,32591,3,6,0
9339,3,1,32588,32591,32592,3,4,0
9340,2,1,32590,32592,32593,2,3,0
9341,6,1,32596,32596,32597,0,1,3
9342,2,2,32598,32598,32600,0,2,1
9343,1,3,32599,32600,32603,1,4,0
9344,4,3,32603,32603,32606,0,3,0
9345,3,3,32606,32606,32609,0,3,0
9346,2,1,32608,32609,32610,1,2,0
9347,1,3,32609,32610,32613,1,4,0
9348,2,3,32611,32613,32616,2,5,0
9349,6,1,32617,32617,32618,0,1,1
9350,2,2,32619,32619,32621,0,2,1
9351,1,1,32620,32621,32622,1,2,0
9352,4,3,32624,32624,32627,0,3,2
9353,5,1,32629,32629,32630,0,1,2
9354,1,3,32630,32630,32633,0,3,0
9355,6,3,32636,32636,32639,0,3,3
9356,5,3,32641,32641,32644,0,3,2
9357,3,3,32644,32644,32647,0,3,0
9358,5,3,32649,32649,32652,0,3,2
9359,1,3,32650,32652,32655,2,5,0
9360,5,3,32655,32655,32658,0,3,0
9361,2,2,32657,32658,32660,1,3,0
9362,1,3,32658,32660,32663,2,5,0
9363,1,2,32659,32663,32665,4,6,0
9364,5,3,32664,32665,32668,1,4,0
9365,1,2,32665,32668,32670,3,5,0
9366,6,3,32671,32671,32674,0,3,1
9367,4,1,32675,32675,32676,0,1,1
9368,2,2,32677,32677,32679,0,2,1
9369,4,1,32681,32681,32682,0,1,2
9370,5,1,32686,32686,32687,0,1,4
9371,6,2,32692,32692,32694,0,2,5
9372,6,1,32698,32698,32699,0,1,4
9373,6,1,32704,32704,32705,0,1,5
9374,4,3,32708,32708,32711,0,3,3
9375,6,3,32714,32714,32717,0,3,3
9376,6,2,32720,32720,32722,0,2,3
9377,5,3,32725,32725,32728,0,3,3
9378,3,2,32728,32728,32730,0,2,0
9379,6,2,32734,32734,32736,0,2,4
9380,1,2,32735,32736,32738,1,3,0
9381,6,3,32741,32741,32744,0,3,3
9382,5,3,32746,32746,32749,0,3,2
9383,4,1,32750,32750,32751,0,1,1
9384,5,2,32755,32755,32757,0,2,4
9385,1,1,32756,32757,32758,1,2,0
9386,3,1,32759,32759,32760,0,1,1
9387,2,1,32761,32761,32762,0,1,1
9388,2,2,32763,32763,32765,0,2,1
9389,2,3,32765,32765,32768,0,3,0
9390,6,1,32771,32771,32772,0,1,3
9391,3,1,32774,32774,32775,0,1,2
9392,5,2,32779,32779,32781,0,2,4
9393,1,3,32780,32781,32784,1,4,0
9394,6,3,32786,32786,32789,0,3,2
9395,1,1,32787,32789,32790,2,3,0
9396,6,3,32793,32793,32796,0,3,3
9397,6,1,32799,32799,32800,0,1,3
9398,4,3,32803,32803,32806,0,3,3
9399,5,1,32808,32808,32809,0,1,2
9400,4,2,32812,32812,32814,0,2,3
9401,5,2,32817,32817,32819,0,2,3
9402,3,3,32820,32820,32823,0,3,1
9403,4,2,32824,32824,32826,0,2,1
9404,1,3,32825,32826,32829,1,4,0
9405,3,1,32828,32829,32830,1,2,0
9406,3,3,32831,32831,32834,0,3,1
9407,6,3,32837,32837,32840,0,3,3
9408,4,1,32841,32841,32842,0,1,1
9409,1,2,32842,32842,32844,0,2,0
9410,5,3,32847,32847,32850,0,3,3
9411,5,2,32852,32852,32854,0,2,2
9412,1,2,32853,32854,32856,1,3,0
9413,2,2,32855,32856,32858,1,3,0
9414,1,2,32856,32858,32860,2,4,0
9415,5,3,32861,32861,32864,0,3,1
9416,4,2,32865,32865,32867,0,2,1
9417,4,1,32869,32869,32870,0,1,2
9418,4,1,32873,32873,32874,0,1,3
9419,4,1,32877,32877,32878,0,1,3
9420,5,1,32882,32882,32883,0,1,4
9421,5,1,32887,32887,32888,0,1,4
9422,3,3,32890,32890,32893,0,3,2
9423,5,3,32895,32895,32898,0,3,2
9424,5,1,32900,32900,32901,0,1,2
9425,1,1,32901,32901,32902,0,1,0
9426,6,2,32907,32907,32909,0,2,5
9427,2,2,32909,32909,32911,0,2,0
9428,5,3,32914,32914,32917,0,3,3
9429,5,3,32919,32919,32922,0,3,2
9430,6,2,32925,32925,32927,0,2,3
9431,1,1,32926,32927,32928,1,2,0
9432,3,2,32929,32929,32931,0,2,1
9433,2,1,32931,32931,32932,0,1,0
9434,2,3,32933,32933,32936,0,3,1
9435,2,2,32935,32936,32938,1,3,0
9436,4,3,32939,32939,32942,0,3,1
9437,4,1,32943,32943,32944,0,1,1
9438,2,2,32945,32945,32947,0,2,1
9439,1,3,32946,32947,32950,1,4,0
9440,2,2,32948,32950,32952,2,4,0
9441,1,3,32949,32952,32955,3,6,0
9442,2,3,32951,32955,32958,4,7,0
9443,5,2,32956,32958,32960,2,4,0
9444,5,3,32961,32961,32964,0,3,1
9445,2,1,32963,32964,32965,1,2,0
9446,4,1,32967,32967,32968,0,1,2
9447,1,2,32968,32968,32970,0,2,0
9448,2,3,32970,32970,32973,0,3,0
9449,5,3,32975,32975,32978,0,3,2
9450,3,2,32978,32978,32980,0,2,0
9451,3,1,32981,32981,32982,0,1,1
9452,3,3,32984,32984,32987,0,3,2
9453,2,2,32986,32987,32989,1,3,0
9454,6,3,32992,32992,32995,0,3,3
9455,3,3,32995,32995,32998,0,3,0
9456,5,1,33000,33000,33001,0,1,2
9457,6,2,33006,33006,33008,0,2,5
9458,2,3,33008,33008,33011,0,3,0
9459,4,1,33012,33012,33013,0,1,1
9460,2,3,33014,33014,33017,0,3,1
9461,3,2,33017,33017,33019,0,2,0
9462,4,3,33021,33021,33024,0,3,2
9463,6,3,33027,33027,33030,0,3,3
9464,4,2,33031,33031,33033,0,2,1
9465,5,1,33036,33036,33037,0,1,3
9466,2,3,33038,33038,33041,0,3,1
9467,5,2,33043,33043,33045,0,2,2
9468,6,1,33049,33049,33050,0,1,4
9469,4,2,33053,33053,33055,0,2,3
9470,6,1,33059,33059,33060,0,1,4
9471,4,2,33063,33063,33065,0,2,3
9472,1,3,33064,33065,33068,1,4,0
9473,5,2,33069,33069,33071,0,2,1
9474,1,1,33070,33071,33072,1,2,0
9475,4,3,33074,33074,33077,0,3,2
9476,5,3,33079,33079,33082,0,3,2
9477,5,3,33084,33084,33087,0,3,2
9478,3,3,33087,33087,33090,0,3,0
9479,2,2,33089,33090,33092,1,3,0
9480,2,1,33091,33092,33093,1,2,0
9481,3,1,33094,33094,33095,0,1,1
9482,2,1,33096,33096,33097,0,1,1
9483,3,2,33099,33099,33101,0,2,2
9484,3,3,33102,33102,33105,0,3,1
9485,1,3,33103,33105,33108,2,5,0
9486,1,1,33104,33108,33109,4,5,0
9487,6,3,33110,33110,33113,0,3,1
9488,6,3,33116,33116,33119,0,3,3
9489,5,2,33121,33121,33123,0,2,2
9490,6,2,33127,33127,33129,0,2,4
9491,2,2,33129,33129,33131,0,2,0
9492,5,3,33134,33134,33137,0,3,3
9493,6,1,33140,33140,33141,0,1,3
9494,1,1,33141,33141,33142,0,1,0
9495,2,2,33143,33143,33145,0,2,1
9496,3,1,33146,33146,33147,0,1,1
9497,5,3,33151,33151,33154,0,3,4
9498,4,3,33155,33155,33158,0,3,1
9499,2,2,33157,33158,33160,1,3,0
9500,1,2,33158,33160,33162,2,4,0
9501,1,3,33159,33162,33165,3,6,0
9502,2,1,33161,33165,33166,4,5,0
9503,5,2,33166,33166,33168,0,2,0
9504,3,3,33169,33169,33172,0,3,1
9505,1,3,33170,33172,33175,2,5,0
9506,6,3,33176,33176,33179,0,3,1
9507,4,1,33180,33180,33181,0,1,1
9508,1,3,33181,33181,33184,0,3,0
9509,5,1,33186,33186,33187,0,1,2
9510,1,3,33187,33187,33190,0,3,0
9511,3,2,33190,33190,33192,0,2,0
9512,5,3,33195,33195,33198,0,3,3
9513,4,2,33199,33199,33201,0,2,1
9514,3,2,33202,33202,33204,0,2,1
9515,6,3,33208,33208,33211,0,3,4
9516,6,3,33214,33214,33217,0,3,3
9517,4,1,33218,33218,33219,0,1,1
9518,6,1,33224,33224,33225,0,1,5
9519,6,2,33230,33230,33232,0,2,5
9520,3,2,33233,33233,33235,0,2,1
9521,2,2,33235,33235,33237,0,2,0
9522,5,1,33240,33240,33241,0,1,3
9523,1,2,33241,33241,33243,0,2,0
9524,5,1,33246,33246,33247,0,1,3
9525,5,2,33251,33251,33253,0,2,4
9526,1,3,33252,33253,33256,1,4,0
9527,3,3,33255,33256,33259,1,4,0
9528,5,2,33260,33260,33262,0,2,1
9529,3,1,33263,33263,33264,0,1,1
9530,1,3,33264,33264,33267,0,3,0
9531,1,3,33265,33267,33270,2,5,0
9532,5,1,33270,33270,33271,0,1,0
9533,5,2,33275,33275,33277,0,2,4
9534,2,3,33277,33277,33280,0,3,0
9535,2,1,33279,33280,33281,1,2,0
9536,1,3,33280,33281,33284,1,4,0
9537,6,2,33286,33286,33288,0,2,2
9538,2,2,33288,33288,33290,0,2,0
9539,6,2,33294,33294,33296,0,2,4
9540,5,3,33299,33299,33302,0,3,3
9541,3,2,33302,33302,33304,0,2,0
9542,6,1,33308,33308,33309,0,1,4
9543,2,1,33310,33310,33311,0,1,1
9544,1,2,33311,33311,33313,0,2,0
9545,3,3,33314,33314,33317,0,3,1
9546,5,2,33319,33319,33321,0,2,2
9547,2,1,33321,33321,33322,0,1,0
9548,3,1,33324,33324,33325,0,1,2
9549,5,2,33329,33329,33331,0,2,4
9550,5,2,33334,33334,33336,0,2,3
9551,1,2,33335,33336,33338,1,3,0
9552,4,1,33339,33339,33340,0,1,1
9553,5,3,33344,33344,33347,0,3,4
9554,1,1,33345,33347,33348,2,3,0
9555,5,3,33350,33350,33353,0,3,2
9556,6,1,33356,33356,33357,0,1,3
9557,4,2,33360,33360,33362,0,2,3
9558,6,3,33366,33366,33369,0,3,4
9559,4,3,33370,33370,33373,0,3,1
9560,3,2,33373,33373,33375,0,2,0
9561,6,3,33379,33379,33382,0,3,4
9562,5,1,33384,33384,33385,0,1,2
9563,4,3,33388,33388,33391,0,3,3
9564,2,3,33390,33391,33394,1,4,0
9565,1,1,33391,33394,33395,3,4,0
9566,3,3,33394,33395,33398,1,4,0
9567,2,3,33396,33398,33401,2,5,0
9568,2,3,33398,33401,33404,3,6,0
9569,4,1,33402,33404,33405,2,3,0
9570,3,2,33405,33405,33407,0,2,0
9571,3,1,33408,33408,33409,0,1,1
9572,1,1,33409,33409,33410,0,1,0
9573,1,1,33410,33410,33411,0,1,0
9574,2,2,33412,33412,33414,0,2,1
9575,5,2,33417,33417,33419,0,2,3
9576,3,2,33420,33420,33422,0,2,1
9577,2,2,33422,33422,33424,0,2,0
9578,2,2,33424,33424,33426,0,2,0
9579,3,1,33427,33427,33428,0,1,1
9580,1,3,33428,33428,33431,0,3,0
9581,3,3,33431,33431,33434,0,3,0
9582,4,3,33435,33435,33438,0,3,1
9583,4,3,33439,33439,33442,0,3,1
9584,2,1,33441,33442,33443,1,2,0
9585,6,3,33447,33447,33450,0,3,4
9586,2,3,33449,33450,33453,1,4,0
9587,2,1,33451,33453,33454,2,3,0
9588,4,2,33455,33455,33457,0,2,1
9589,4,3,33459,33459,33462,0,3,2
9590,6,3,33465,33465,33468,0,3,3
9591,2,1,33467,33468,33469,1,2,0
9592,2,3,33469,33469,33472,0,3,0
9593,5,1,33474,33474,33475,0,1,2
9594,5,2,33479,33479,33481,0,2,4
9595,3,1,33482,33482,33483,0,1,1
9596,2,2,33484,33484,33486,0,2,1
9597,1,1,33485,33486,33487,1,2,0
9598,2,1,33487,33487,33488,0,1,0
9599,2,3,33489,33489,33492,0,3,1
9600,2,1,33491,33492,33493,1,2,0
9601,1,1,33492,33493,33494,1,2,0
9602,3,1,33495,33495,33496,0,1,1
9603,3,2,33498,33498,33500,0,2,2
9604,2,1,33500,33500,33501,0,1,0
9605,4,1,33504,33504,33505,0,1,3
9606,5,1,33509,33509,33510,0,1,4
9607,5,3,33514,33514,33517,0,3,4
9608,5,2,33519,33519,33521,0,2,2
9609,2,1,33521,33521,33522,0,1,0
9610,1,1,33522,33522,33523,0,1,0
9611,4,3,33526,33526,33529,0,3,3
9612,4,2,33530,33530,33532,0,2,1
9613,1,3,33531,33532,33535,1,4,0
9614,6,2,33537,33537,33539,0,2,2
9615,3,3,33540,33540,33543,0,3,1
9616,4,2,33544,33544,33546,0,2,1
9617,5,3,33549,33549,33552,0,3,3
9618,6,3,33555,33555,33558,0,3,3
9619,5,3,33560,33560,33563,0,3,2
9620,4,1,33564,33564,33565,0,1,1
9621,4,1,33568,33568,33569,0,1,3
9622,1,1,33569,33569,33570,0,1,0
9623,1,2,33570,33570,33572,0,2,0
9624,1,1,33571,33572,33573,1,2,0
9625,5,3,33576,33576,33579,0,3,3
9626,1,2,33577,33579,33581,2,4,0
9627,3,2,33580,33581,33583,1,3,0
9628,3,3,33583,33583,33586,0,3,0
9629,3,1,33586,33586,33587,0,1,0
9630,1,2,33587,33587,33589,0,2,0
9631,1,3,33588,33589,33592,1,4,0
9632,1,2,33589,33592,33594,3,5,0
9633,5,2,33594,33594,33596,0,2,0
9634,3,3,33597,33597,33600,0,3,1
9635,1,1,33598,33600,33601,2,3,0
9636,3,1,33601,33601,33602,0,1,0
9637,3,2,33604,33604,33606,0,2,2
9638,1,2,33605,33606,33608,1,3,0
9639,4,3,33609,33609,33612,0,3,1
9640,4,3,33613,33613,33616,0,3,1
9641,4,2,33617,33617,33619,0,2,1
9642,3,2,33620,33620,33622,0,2,1
9643,5,1,33625,33625,33626,0,1,3
9644,1,3,33626,33626,33629,0,3,0
9645,2,2,33628,33629,33631,1,3,0
9646,4,3,33632,33632,33635,0,3,1
9647,1,1,33633,33635,33636,2,3,0
9648,6,3,33639,33639,33642,0,3,3
9649,2,2,33641,33642,33644,1,3,0
9650,1,2,33642,33644,33646,2,4,0
9651,1,2,33643,33646,33648,3,5,0
9652,6,1,33649,33649,33650,0,1,1
9653,4,1,33653,33653,33654,0,1,3
9654,3,3,33656,33656,33659,0,3,2
9655,1,3,33657,33659,33662,2,5,0
9656,6,3,33663,33663,33666,0,3,1
9657,2,1,33665,33666,33667,1,2,0
9658,2,3,33667,33667,33670,0,3,0
9659,4,3,33671,33671,33674,0,3,1
9660,4,3,33675,33675,33678,0,3,1
9661,5,1,33680,33680,33681,0,1,2
9662,1,3,33681,33681,33684,0,3,0
9663,2,3,33683,33684,33687,1,4,0
9664,4,3,33687,33687,33690,0,3,0
9665,2,3,33689,33690,33693,1,4,0
9666,2,1,33691,33693,33694,2,3,0
9667,6,3,33697,33697,33700,0,3,3
9668,4,1,33701,33701,33702,0,1,1
9669,4,3,33705,33705,33708,0,3,3
9670,3,1,33708,33708,33709,0,1,0
9671,2,1,33710,33710,33711,0,1,1
9672,3,2,33713,33713,33715,0,2,2
9673,1,2,33714,33715,33717,1,3,0
9674,5,3,33719,33719,33722,0,3,2
9675,6,2,33725,33725,33727,0,2,3
9676,5,1,33730,33730,33731,0,1,3
9677,6,2,33736,33736,33738,0,2,5
9678,6,2,33742,33742,33744,0,2,4
9679,5,1,33747,33747,33748,0,1,3
9680,1,2,33748,33748,33750,0,2,0
9681,1,3,33749,33750,33753,1,4,0
9682,4,2,33753,33753,33755,0,2,0
9683,5,1,33758,33758,33759,0,1,3
9684,3,3,33761,33761,33764,0,3,2
9685,3,2,33764,33764,33766,0,2,0
9686,6,1,33770,33770,33771,0,1,4
9687,6,3,33776,33776,33779,0,3,5
9688,5,1,33781,33781,33782,0,1,2
9689,4,2,33785,33785,33787,0,2,3
9690,3,3,33788,33788,33791,0,3,1
9691,4,1,33792,33792,33793,0,1,1
9692,3,1,33795,33795,33796,0,1,2
9693,4,3,33799,33799,33802,0,3,3
9694,6,1,33805,33805,33806,0,1,3
9695,3,2,33808,33808,33810,0,2,2
9696,1,1,33809,33810,33811,1,2,0
9697,5,2,33814,33814,33816,0,2,3
9698,5,3,33819,33819,33822,0,3,3
9699,2,2,33821,33822,33824,1,3,0
9700,5,3,33826,33826,33829,0,3,2
9701,1,3,33827,33829,33832,2,5,0
9702,2,1,33829,33832,33833,3,4,0
9703,6,1,33835,33835,33836,0,1,2
9704,3,3,33838,33838,33841,0,3,2
9705,2,1,33840,33841,33842,1,2,0
9706,1,1,33841,33842,33843,1,2,0
9707,4,1,33845,33845,33846,0,1,2
9708,6,1,33851,33851,33852,0,1,5
9709,3,2,33854,33854,33856,0,2,2
9710,6,1,33860,33860,33861,0,1,4
9711,2,2,33862,33862,33864,0,2,1
9712,1,2,33863,33864,33866,1,3,0
9713,1,2,33864,33866,33868,2,4,0
9714,6,1,33870,33870,33871,0,1,2
9715,5,1,33875,33875,33876,0,1,4
9716,3,3,33878,33878,33881,0,3,2
9717,2,1,33880,33881,33882,1,2,0
9718,1,2,33881,33882,33884,1,3,0
9719,4,3,33885,33885,33888,0,3,1
9720,1,2,33886,33888,33890,2,4,0
9721,6,3,33892,33892,33895,0,3,2
9722,5,3,33897,33897,33900,0,3,2
9723,2,2,33899,33900,33902,1,3,0
9724,6,3,33905,33905,33908,0,3,3
9725,1,2,33906,33908,33910,2,4,0
9726,6,2,33912,33912,33914,0,2,2
9727,6,2,33918,33918,33920,0,2,4
9728,3,2,33921,33921,33923,0,2,1
9729,4,3,33925,33925,33928,0,3,2
9730,5,2,33930,33930,33932,0,2,2
9731,3,2,33933,33933,33935,0,2,1
9732,4,1,33937,33937,33938,0,1,2
9733,6,1,33943,33943,33944,0,1,5
9734,5,1,33948,33948,33949,0,1,4
9735,5,2,33953,33953,33955,0,2,4
9736,2,3,33955,33955,33958,0,3,0
9737,4,2,33959,33959,33961,0,2,1
9738,4,3,33963,33963,33966,0,3,2
9739,5,2,33968,33968,33970,0,2,2
9740,4,3,33972,33972,33975,0,3,2
9741,5,3,33977,33977,33980,0,3,2
9742,3,1,33980,33980,33981,0,1,0
9743,6,3,33986,33986,33989,0,3,5
9744,3,1,33989,33989,33990,0,1,0
9745,3,1,33992,33992,33993,0,1,2
9746,5,2,33997,33997,33999,0,2,4
9747,4,3,34001,34001,34004,0,3,2
9748,4,1,34005,34005,34006,0,1,1
9749,6,3,34011,34011,34014,0,3,5
9750,3,1,34014,34014,34015,0,1,0
9751,1,2,34015,34015,34017,0,2,0
9752,3,2,34018,34018,34020,0,2,1
9753,4,3,34022,34022,34025,0,3,2
9754,5,3,34027,34027,34030,0,3,2
9755,6,2,34033,34033,34035,0,2,3
9756,6,1,34039,34039,34040,0,1,4
9757,4,2,34043,34043,34045,0,2,3
9758,4,1,34047,34047,34048,0,1,2
9759,3,2,34050,34050,34052,0,2,2
9760,1,3,34051,34052,34055,1,4,0
9761,4,1,34055,34055,34056,0,1,0
9762,2,1,34057,34057,34058,0,1,1
9763,5,1,34062,34062,34063,0,1,4
9764,3,2,34065,34065,34067,0,2,2
9765,4,1,34069,34069,34070,0,1,2
9766,2,1,34071,34071,34072,0,1,1
9767,1,2,34072,34072,34074,0,2,0
9768,4,3,34076,34076,34079,0,3,2
9769,1,1,34077,34079,34080,2,3,0
9770,1,3,34078,34080,34083,2,5,0
9771,2,1,34080,34083,34084,3,4,0
9772,6,3,34086,34086,34089,0,3,2
9773,1,3,34087,34089,34092,2,5,0
9774,4,3,34091,34092,34095,1,4,0
9775,4,1,34095,34095,34096,0,1,0
9776,3,2,34098,34098,34100,0,2,2
9777,1,3,34099,34100,34103,1,4,0
9778,6,1,34105,34105,34106,0,1,2
9779,4,3,34109,34109,34112,0,3,3
9780,4,3,34113,34113,34116,0,3,1
9781,4,2,34117,34117,34119,0,2,1
9782,1,3,34118,34119,34122,1,4,0
9783,6,3,34124,34124,34127,0,3,2
9784,1,3,34125,34127,34130,2,5,0
9785,6,2,34131,34131,34133,0,2,1
9786,4,2,34135,34135,34137,0,2,2
9787,5,2,34140,34140,34142,0,2,3
9788,3,3,34143,34143,34146,0,3,1
9789,3,1,34146,34146,34147,0,1,0
9790,3,2,34149,34149,34151,0,2,2
9791,2,3,34151,34151,34154,0,3,0
9792,2,3,34153,34154,34157,1,4,0
9793,2,1,34155,34157,34158,2,3,0
9794,6,1,34161,34161,34162,0,1,3
9795,3,1,34164,34164,34165,0,1,2
9796,6,2,34170,34170,34172,0,2,5
9797,6,3,34176,34176,34179,0,3,4
9798,3,1,34179,34179,34180,0,1,0
9799,6,1,34185,34185,34186,0,1,5
9800,4,3,34189,34189,34192,0,3,3
9801,5,2,34194,34194,34196,0,2,2
9802,4,3,34198,34198,34201,0,3,2
9803,4,1,34202,34202,34203,0,1,1
9804,2,2,34204,34204,34206,0,2,1
9805,5,2,34209,34209,34211,0,2,3
9806,6,2,34215,34215,34217,0,2,4
9807,4,2,34219,34219,34221,0,2,2
9808,1,1,34220,34221,34222,1,2,0
9809,2,3,34222,34222,34225,0,3,0
9810,6,3,34228,34228,34231,0,3,3
9811,3,3,34231,34231,34234,0,3,0
9812,3,2,34234,34234,34236,0,2,0
9813,5,3,34239,34239,34242,0,3,3
9814,6,1,34245,34245,34246,0,1,3
9815,5,1,34250,34250,34251,0,1,4
9816,2,3,34252,34252,34255,0,3,1
9817,3,3,34255,34255,34258,0,3,0
9818,2,2,34257,34258,34260,1,3,0
9819,5,1,34262,34262,34263,0,1,2
9820,3,1,34265,34265,34266,0,1,2
9821,1,1,34266,34266,34267,0,1,0
9822,5,1,34271,34271,34272,0,1,4
9823,4,1,34275,34275,34276,0,1,3
9824,4,1,34279,34279,34280,0,1,3
9825,2,3,34281,34281,34284,0,3,1
9826,1,1,34282,34284,34285,2,3,0
9827,1,1,34283,34285,34286,2,3,0
9828,6,1,34289,34289,34290,0,1,3
9829,2,1,34291,34291,34292,0,1,1
9830,3,1,34294,34294,34295,0,1,2
9831,5,1,34299,34299,34300,0,1,4
9832,1,3,34300,34300,34303,0,3,0
9833,5,3,34305,34305,34308,0,3,2
9834,5,3,34310,34310,34313,0,3,2
9835,5,2,34315,34315,34317,0,2,2
9836,2,1,34317,34317,34318,0,1,0
9837,5,1,34322,34322,34323,0,1,4
9838,5,2,34327,34327,34329,0,2,4
9839,1,3,34328,34329,34332,1,4,0
9840,4,3,34332,34332,34335,0,3,0
9841,1,1,34333,34335,34336,2,3,0
9842,1,1,34334,34336,34337,2,3,0
9843,5,1,34339,34339,34340,0,1,2
9844,2,3,34341,34341,34344,0,3,1
9845,1,2,34342,34344,34346,2,4,0
9846,6,3,34348,34348,34351,0,3,2
9847,3,1,34351,34351,34352,0,1,0
9848,5,1,34356,34356,34357,0,1,4
9849,5,1,34361,34361,34362,0,1,4
9850,3,2,34364,34364,34366,0,2,2
9851,2,3,34366,34366,34369,0,3,0
9852,1,2,34367,34369,34371,2,4,0
9853,1,1,34368,34371,34372,3,4,0
9854,6,2,34374,34374,34376,0,2,2
9855,4,2,34378,34378,34380,0,2,2
9856,5,1,34383,34383,34384,0,1,3
9857,4,2,34387,34387,34389,0,2,3
9858,6,3,34393,34393,34396,0,3,4
9859,3,2,34396,34396,34398,0,2,0
9860,1,2,34397,34398,34400,1,3,0
9861,3,3,34400,34400,34403,0,3,0
9862,3,3,34403,34403,34406,0,3,0
9863,5,1,34408,34408,34409,0,1,2
9864,4,3,34412,34412,34415,0,3,3
9865,5,1,34417,34417,34418,0,1,2
9866,6,2,34423,34423,34425,0,2,5
9867,3,2,34426,34426,34428,0,2,1
9868,1,1,34427,34428,34429,1,2,0
9869,4,1,34431,34431,34432,0,1,2
9870,5,3,34436,34436,34439,0,3,4
9871,6,3,34442,34442,34445,0,3,3
9872,4,1,34446,34446,34447,0,1,1
9873,1,2,34447,34447,34449,0,2,0
9874,3,3,34450,34450,34453,0,3,1
9875,3,1,34453,34453,34454,0,1,0
9876,5,3,34458,34458,34461,0,3,4
9877,5,1,34463,34463,34464,0,1,2
9878,5,1,34468,34468,34469,0,1,4
9879,1,1,34469,34469,34470,0,1,0
9880,1,1,34470,34470,34471,0,1,0
9881,1,2,34471,34471,34473,0,2,0
9882,5,3,34476,34476,34479,0,3,3
9883,6,1,34482,34482,34483,0,1,3
9884,2,2,34484,34484,34486,0,2,1
9885,4,3,34488,34488,34491,0,3,2
9886,3,1,34491,34491,34492,0,1,0
9887,1,1,34492,34492,34493,0,1,0
9888,3,2,34495,34495,34497,0,2,2
9889,1,2,34496,34497,34499,1,3,0
9890,3,3,34499,34499,34502,0,3,0
9891,6,3,34505,34505,34508,0,3,3
9892,2,1,34507,34508,34509,1,2,0
9893,1,3,34508,34509,34512,1,4,0
9894,2,2,34510,34512,34514,2,4,0
9895,2,3,34512,34514,34517,2,5,0
9896,1,1,34513,34517,34518,4,5,0
9897,6,2,34519,34519,34521,0,2,1
9898,2,3,34521,34521,34524,0,3,0
9899,1,2,34522,34524,34526,2,4,0
9900,3,1,34525,34526,34527,1,2,0
9901,2,1,34527,34527,34528,0,1,0
9902,4,3,34531,34531,34534,0,3,3
9903,5,1,34536,34536,34537,0,1,2
9904,6,3,34542,34542,34545,0,3,5
9905,4,2,34546,34546,34548,0,2,1
9906,2,2,34548,34548,34550,0,2,0
9907,2,1,34550,34550,34551,0,1,0
9908,1,3,34551,34551,34554,0,3,0
9909,2,3,34553,34554,34557,1,4,0
9910,1,2,34554,34557,34559,3,5,0
9911,5,1,34559,34559,34560,0,1,0
9912,4,3,34563,34563,34566,0,3,3
9913,4,3,34567,34567,34570,0,3,1
9914,5,2,34572,34572,34574,0,2,2
9915,2,3,34574,34574,34577,0,3,0
9916,3,2,34577,34577,34579,0,2,0
9917,1,3,34578,34579,34582,1,4,0
9918,5,2,34583,34583,34585,0,2,1
9919,1,1,34584,34585,34586,1,2,0
9920,6,2,34590,34590,34592,0,2,4
9921,1,1,34591,34592,34593,1,2,0
9922,5,2,34596,34596,34598,0,2,3
9923,3,2,34599,34599,34601,0,2,1
9924,1,3,34600,34601,34604,1,4,0
9925,2,2,34602,34604,34606,2,4,0
9926,2,1,34604,34606,34607,2,3,0
9927,4,3,34608,34608,34611,0,3,1
9928,4,1,34612,34612,34613,0,1,1
9929,4,2,34616,34616,34618,0,2,3
9930,6,1,34622,34622,34623,0,1,4
9931,3,3,34625,34625,34628,0,3,2
9932,2,2,34627,34628,34630,1,3,0
9933,5,2,34632,34632,34634,0,2,2
9934,1,2,34633,34634,34636,1,3,0
9935,1,2,34634,34636,34638,2,4,0
9936,5,3,34639,34639,34642,0,3,1
9937,5,1,34644,34644,34645,0,1,2
9938,2,2,34646,34646,34648,0,2,1
9939,5,1,34651,34651,34652,0,1,3
9940,1,3,34652,34652,34655,0,3,0
9941,2,1,34654,34655,34656,1,2,0
9942,5,2,34659,34659,34661,0,2,3
9943,3,2,34662,34662,34664,0,2,1
9944,3,1,34665,34665,34666,0,1,1
9945,6,3,34671,34671,34674,0,3,5
9946,6,2,34677,34677,34679,0,2,3
9947,4,3,34681,34681,34684,0,3,2
9948,2,2,34683,34684,34686,1,3,0
9949,3,3,34686,34686,34689,0,3,0
9950,5,1,34691,34691,34692,0,1,2
9951,4,1,34695,34695,34696,0,1,3
9952,3,1,34698,34698,34699,0,1,2
9953,6,3,34704,34704,34707,0,3,5
9954,6,1,34710,34710,34711,0,1,3
9955,5,2,34715,34715,34717,0,2,4
9956,2,3,34717,34717,34720,0,3,0
9957,4,3,34721,34721,34724,0,3,1
9958,4,1,34725,34725,34726,0,1,1
9959,4,1,34729,34729,34730,0,1,3
9960,1,2,34730,34730,34732,0,2,0
9961,4,3,34734,34734,34737,0,3,2
9962,5,2,34739,34739,34741,0,2,2
9963,3,1,34742,34742,34743,0,1,1
9964,2,1,34744,34744,34745,0,1,1
9965,6,2,34750,34750,34752,0,2,5
9966,5,2,34755,34755,34757,0,2,3
9967,6,2,34761,34761,34763,0,2,4
9968,2,1,34763,34763,34764,0,1,0
9969,5,3,34768,34768,34771,0,3,4
9970,1,1,34769,34771,34772,2,3,0
9971,6,1,34775,34775,34776,0,1,3
9972,3,3,34778,34778,34781,0,3,2
9973,3,2,34781,34781,34783,0,2,0
9974,5,2,34786,34786,34788,0,2,3
9975,2,3,34788,34788,34791,0,3,0
9976,3,2,34791,34791,34793,0,2,0
9977,2,3,34793,34793,34796,0,3,0
9978,3,1,34796,34796,34797,0,1,0
9979,2,1,34798,34798,34799,0,1,1
9980,2,3,34800,34800,34803,0,3,1
9981,6,1,34806,34806,34807,0,1,3
9982,2,2,34808,34808,34810,0,2,1
9983,4,2,34812,34812,34814,0,2,2
9984,4,1,34816,34816,34817,0,1,2
9985,3,1,34819,34819,34820,0,1,2
9986,3,3,34822,34822,34825,0,3,2
9987,4,2,34826,34826,34828,0,2,1
9988,3,1,34829,34829,34830,0,1,1
9989,2,3,34831,34831,34834,0,3,1
9990,3,1,34834,34834,34835,0,1,0
9991,5,2,34839,34839,34841,0,2,4
9992,3,2,34842,34842,34844,0,2,1
9993,2,2,34844,34844,34846,0,2,0
9994,4,3,34848,34848,34851,0,3,2
9995,6,2,34854,34854,34856,0,2,3
9996,6,3,34860,34860,34863,0,3,4
9997,3,2,34863,34863,34865,0,2,0
9998,3,1,34866,34866,34867,0,1,1
9999,3,2,34869,34869,34871,0,2,2
10000,3,2,34872,34872,34874,0,2,1
10001,4,3,34876,34876,34879,0,3,2
10002,6,1,34882,34882,34883,0,1,3
10003,6,3,34888,34888,34891,0,3,5
10004,5,1,34893,34893,34894,0,1,2
10005,3,2,34896,34896,34898,0,2,2
10006,6,2,34902,34902,34904,0,2,4
10007,1,2,34903,34904,34906,1,3,0
10008,2,3,34905,34906,34909,1,4,0
10009,3,2,34908,34909,34911,1,3,0
10010,4,3,34912,34912,34915,0,3,1
10011,5,3,34917,34917,34920,0,3,2
10012,4,2,34921,34921,34923,0,2,1
10013,6,1,34927,34927,34928,0,1,4
10014,6,2,34933,34933,34935,0,2,5
10015,3,3,34936,34936,34939,0,3,1
10016,1,2,34937,34939,34941,2,4,0
10017,4,3,34941,34941,34944,0,3,0
10018,2,3,34943,34944,34947,1,4,0
10019,5,3,34948,34948,34951,0,3,1
10020,5,3,34953,34953,34956,0,3,2
10021,3,1,34956,34956,34957,0,1,0
10022,3,3,34959,34959,34962,0,3,2
10023,4,3,34963,34963,34966,0,3,1
10024,4,1,34967,34967,34968,0,1,1
10025,3,3,34970,34970,34973,0,3,2
10026,6,3,34976,34976,34979,0,3,3
10027,2,3,34978,34979,34982,1,4,0
10028,2,1,34980,34982,34983,2,3,0
10029,3,2,34983,34983,34985,0,2,0
10030,3,3,34986,34986,34989,0,3,1
10031,5,2,34991,34991,34993,0,2,2
10032,5,2,34996,34996,34998,0,2,3
10033,6,2,35002,35002,35004,0,2,4
10034,2,2,35004,35004,35006,0,2,0
10035,1,3,35005,35006,35009,1,4,0
10036,2,2,35007,35009,35011,2,4,0
10037,6,1,35013,35013,35014,0,1,2
10038,2,1,35015,35015,35016,0,1,1
10039,3,3,35018,35018,35021,0,3,2
10040,4,3,35022,35022,35025,0,3,1
10041,5,3,35027,35027,35030,0,3,2
10042,2,3,35029,35030,35033,1,4,0
10043,1,2,35030,35033,35035,3,5,0
10044,3,2,35033,35035,35037,2,4,0
10045,3,1,35036,35037,35038,1,2,0
10046,5,1,35041,35041,35042,0,1,3
10047,2,3,35043,35043,35046,0,3,1
10048,1,1,35044,35046,35047,2,3,0
10049,2,3,35046,35047,35050,1,4,0
10050,3,2,35049,35050,35052,1,3,0
10051,6,2,35055,35055,35057,0,2,3
10052,3,3,35058,35058,35061,0,3,1
10053,5,3,35063,35063,35066,0,3,2
10054,1,2,35064,35066,35068,2,4,0
10055,3,3,35067,35068,35071,1,4,0
10056,5,1,35072,35072,35073,0,1,1
10057,3,3,35075,35075,35078,0,3,2
10058,6,2,35081,35081,35083,0,2,3
10059,3,3,35084,35084,35087,0,3,1
10060,3,3,35087,35087,35090,0,3,0
10061,5,1,35092,35092,35093,0,1,2
10062,5,1,35097,35097,35098,0,1,4
10063,5,3,35102,35102,35105,0,3,4
10064,2,3,35104,35105,35108,1,4,0
10065,2,1,35106,35108,35109,2,3,0
10066,5,3,35111,35111,35114,0,3,2
10067,4,3,35115,35115,35118,0,3,1
10068,5,2,35120,35120,35122,0,2,2
10069,5,2,35125,35125,35127,0,2,3
10070,1,2,35126,35127,35129,1,3,0
10071,3,3,35129,35129,35132,0,3,0
10072,1,3,35130,35132,35135,2,5,0
10073,6,1,35136,35136,35137,0,1,1
10074,3,1,35139,35139,35140,0,1,2
10075,3,2,35142,35142,35144,0,2,2
10076,6,3,35148,35148,35151,0,3,4
10077,5,3,35153,35153,35156,0,3,2
10078,6,3,35159,35159,35162,0,3,3
10079,6,2,35165,35165,35167,0,2,3
10080,3,3,35168,35168,35171,0,3,1
10081,4,3,35172,35172,35175,0,3,1
10082,6,1,35178,35178,35179,0,1,3
10083,5,1,35183,35183,35184,0,1,4
10084,5,1,35188,35188,35189,0,1,4
10085,3,2,35191,35191,35193,0,2,2
10086,1,3,35192,35193,35196,1,4,0
10087,5,2,35197,35197,35199,0,2,1
10088,1,2,35198,35199,35201,1,3,0
10089,5,1,35203,35203,35204,0,1,2
10090,4,1,35207,35207,35208,0,1,3
10091,3,2,35210,35210,35212,0,2,2
10092,3,1,35213,35213,35214,0,1,1
10093,1,3,35214,35214,35217,0,3,0
10094,3,1,35217,35217,35218,0,1,0
10095,5,1,35222,35222,35223,0,1,4
10096,1,1,35223,35223,35224,0,1,0
10097,4,2,35227,35227,35229,0,2,3
10098,6,2,35233,35233,35235,0,2,4
10099,5,2,35238,35238,35240,0,2,3
10100,1,2,35239,35240,35242,1,3,0
10101,1,3,35240,35242,35245,2,5,0
10102,3,2,35243,35245,35247,2,4,0
10103,5,1,35248,35248,35249,0,1,1
10104,3,3,35251,35251,35254,0,3,2
10105,2,3,35253,35254,35257,1,4,0
10106,1,1,35254,35257,35258,3,4,0
10107,4,1,35258,35258,35259,0,1,0
10108,1,2,35259,35259,35261,0,2,0
10109,1,1,35260,35261,35262,1,2,0
10110,6,3,35266,35266,35269,0,3,4
10111,4,1,35270,35270,35271,0,1,1
10112,3,2,35273,35273,35275,0,2,2
10113,4,2,35277,35277,35279,0,2,2
10114,2,3,35279,35279,35282,0,3,0
10115,6,2,35285,35285,35287,0,2,3
10116,2,3,35287,35287,35290,0,3,0
10117,6,3,35293,35293,35296,0,3,3
10118,5,3,35298,35298,35301,0,3,2
10119,6,3,35304,35304,35307,0,3,3
10120,2,3,35306,35307,35310,1,4,0
10121,6,2,35312,35312,35314,0,2,2
10122,4,2,35316,35316,35318,0,2,2
10123,2,3,35318,35318,35321,0,3,0
10124,1,2,35319,35321,35323,2,4,0
10125,6,3,35325,35325,35328,0,3,2
10126,5,3,35330,35330,35333,0,3,2
10127,3,1,35333,35333,35334,0,1,0
10128,1,3,35334,35334,35337,0,3,0
10129,4,2,35338,35338,35340,0,2,1
10130,4,3,35342,35342,35345,0,3,2
10131,4,2,35346,35346,35348,0,2,1
10132,6,3,35352,35352,35355,0,3,4
10133,4,2,35356,35356,35358,0,2,1
10134,6,3,35362,35362,35365,0,3,4
10135,3,3,35365,35365,35368,0,3,0
10136,3,1,35368,35368,35369,0,1,0
10137,2,2,35370,35370,35372,0,2,1
10138,3,3,35373,35373,35376,0,3,1
10139,4,2,35377,35377,35379,0,2,1
10140,3,1,35380,35380,35381,0,1,1
10141,5,3,35385,35385,35388,0,3,4
10142,2,1,35387,35388,35389,1,2,0
10143,1,3,35388,35389,35392,1,4,0
10144,4,2,35392,35392,35394,0,2,0
10145,2,3,35394,35394,35397,0,3,0
10146,2,1,35396,35397,35398,1,2,0
10147,1,2,35397,35398,35400,1,3,0
10148,6,3,35403,35403,35406,0,3,3
10149,6,3,35409,35409,35412,0,3,3
10150,5,2,35414,35414,35416,0,2,2
10151,2,3,35416,35416,35419,0,3,0
10152,6,2,35422,35422,35424,0,2,3
10153,4,2,35426,35426,35428,0,2,2
10154,1,2,35427,35428,35430,1,3,0
10155,3,2,35430,35430,35432,0,2,0
10156,3,1,35433,35433,35434,0,1,1
10157,4,2,35437,35437,35439,0,2,3
10158,2,1,35439,35439,35440,0,1,0
10159,2,1,35441,35441,35442,0,1,1
10160,6,3,35447,35447,35450,0,3,5
10161,2,1,35449,35450,35451,1,2,0
10162,5,3,35454,35454,35457,0,3,3
10163,4,2,35458,35458,35460,0,2,1
10164,3,2,35461,35461,35463,0,2,1
10165,2,1,35463,35463,35464,0,1,0
10166,2,1,35465,35465,35466,0,1,1
10167,5,2,35470,35470,35472,0,2,4
10168,4,1,35474,35474,35475,0,1,2
10169,2,1,35476,35476,35477,0,1,1
10170,2,3,35478,35478,35481,0,3,1
10171,5,3,35483,35483,35486,0,3,2
10172,6,3,35489,35489,35492,0,3,3
10173,1,1,35490,35492,35493,2,3,0
10174,2,2,35492,35493,35495,1,3,0
10175,2,2,35494,35495,35497,1,3,0
10176,6,3,35500,35500,35503,0,3,3
10177,4,2,35504,35504,35506,0,2,1
10178,3,3,35507,35507,35510,0,3,1
10179,5,1,35512,35512,35513,0,1,2
10180,4,1,35516,35516,35517,0,1,3
10181,3,2,35519,35519,35521,0,2,2
10182,4,1,35523,35523,35524,0,1,2
10183,4,3,35527,35527,35530,0,3,3
10184,6,1,35533,35533,35534,0,1,3
10185,3,1,35536,35536,35537,0,1,2
10186,5,1,35541,35541,35542,0,1,4
10187,5,1,35546,35546,35547,0,1,4
10188,6,2,35552,35552,35554,0,2,5
10189,4,2,35556,35556,35558,0,2,2
10190,1,2,35557,35558,35560,1,3,0
10191,1,3,35558,35560,35563,2,5,0
10192,3,1,35561,35563,35564,2,3,0
10193,2,2,35563,35564,35566,1,3,0
10194,2,3,35565,35566,35569,1,4,0
10195,1,2,35566,35569,35571,3,5,0
10196,1,3,35567,35571,35574,4,7,0
10197,6,2,35573,35574,35576,1,3,0
10198,1,1,35574,35576,35577,2,3,0
10199,4,3,35578,35578,35581,0,3,1
10200,4,1,35582,35582,35583,0,1,1
10201,2,1,35584,35584,35585,0,1,1
10202,2,1,35586,35586,35587,0,1,1
10203,5,3,35591,35591,35594,0,3,4
10204,5,1,35596,35596,35597,0,1,2
10205,1,1,35597,35597,35598,0,1,0
10206,4,2,35601,35601,35603,0,2,3
10207,6,3,35607,35607,35610,0,3,4
10208,6,2,35613,35613,35615,0,2,3
10209,4,3,35617,35617,35620,0,3,2
10210,5,3,35622,35622,35625,0,3,2
10211,6,1,35628,35628,35629,0,1,3
10212,6,1,35634,35634,35635,0,1,5
10213,4,2,35638,35638,35640,0,2,3
10214,2,1,35640,35640,35641,0,1,0
10215,5,3,35645,35645,35648,0,3,4
10216,3,1,35648,35648,35649,0,1,0
10217,2,1,35650,35650,35651,0,1,1
10218,3,3,35653,35653,35656,0,3,2
10219,5,2,35658,35658,35660,0,2,2
10220,2,3,35660,35660,35663,0,3,0
10221,1,2,35661,35663,35665,2,4,0
10222,3,1,35664,35665,35666,1,2,0
10223,5,1,35669,35669,35670,0,1,3
10224,2,1,35671,35671,35672,0,1,1
10225,3,3,35674,35674,35677,0,3,2
10226,4,1,35678,35678,35679,0,1,1
10227,6,3,35684,35684,35687,0,3,5
10228,4,2,35688,35688,35690,0,2,1
10229,6,2,35694,35694,35696,0,2,4
10230,4,1,35698,35698,35699,0,1,2
10231,6,1,35704,35704,35705,0,1,5
10232,1,2,35705,35705,35707,0,2,0
10233,1,2,35706,35707,35709,1,3,0
10234,2,2,35708,35709,35711,1,3,0
10235,5,3,35713,35713,35716,0,3,2
10236,1,3,35714,35716,35719,2,5,0
10237,3,1,35717,35719,35720,2,3,0
10238,3,3,35720,35720,35723,0,3,0
10239,3,3,35723,35723,35726,0,3,0
10240,4,3,35727,35727,35730,0,3,1
10241,1,2,35728,35730,35732,2,4,0
10242,2,3,35730,35732,35735,2,5,0
10243,1,3,35731,35735,35738,4,7,0
10244,4,2,35735,35738,35740,3,5,0
10245,5,1,35740,35740,35741,0,1,0
10246,4,1,35744,35744,35745,0,1,3
10247,5,3,35749,35749,35752,0,3,4
10248,4,2,35753,35753,35755,0,2,1
10249,3,3,35756,35756,35759,0,3,1
10250,4,1,35760,35760,35761,0,1,1
10251,2,1,35762,35762,35763,0,1,1
10252,3,2,35765,35765,35767,0,2,2
10253,4,1,35769,35769,35770,0,1,2
10254,3,1,35772,35772,35773,0,1,2
10255,2,2,35774,35774,35776,0,2,1
10256,5,2,35779,35779,35781,0,2,3
10257,1,3,35780,35781,35784,1,4,0
10258,6,2,35786,35786,35788,0,2,2
10259,4,2,35790,35790,35792,0,2,2
10260,2,1,35792,35792,35793,0,1,0
10261,5,3,35797,35797,35800,0,3,4
10262,4,1,35801,35801,35802,0,1,1
10263,2,3,35803,35803,35806,0,3,1
10264,4,1,35807,35807,35808,0,1,1
10265,4,2,35811,35811,35813,0,2,3
10266,2,3,35813,35813,35816,0,3,0
10267,2,3,35815,35816,35819,1,4,0
10268,4,3,35819,35819,35822,0,3,0
10269,3,2,35822,35822,35824,0,2,0
10270,5,2,35827,35827,35829,0,2,3
10271,2,3,35829,35829,35832,0,3,0
10272,2,3,35831,35832,35835,1,4,0
10273,3,2,35834,35835,35837,1,3,0
10274,3,1,35837,35837,35838,0,1,0
10275,1,2,35838,35838,35840,0,2,0
10276,4,2,35842,35842,35844,0,2,2
10277,6,1,35848,35848,35849,0,1,4
10278,1,2,35849,35849,35851,0,2,0
10279,6,2,35855,35855,35857,0,2,4
10280,1,1,35856,35857,35858,1,2,0
10281,5,3,35861,35861,35864,0,3,3
10282,6,1,35867,35867,35868,0,1,3
10283,2,2,35869,35869,35871,0,2,1
10284,4,2,35873,35873,35875,0,2,2
10285,6,1,35879,35879,35880,0,1,4
10286,2,3,35881,35881,35884,0,3,1
10287,2,2,35883,35884,35886,1,3,0
10288,6,3,35889,35889,35892,0,3,3
10289,6,3,35895,35895,35898,0,3,3
10290,3,2,35898,35898,35900,0,2,0
10291,6,3,35904,35904,35907,0,3,4
10292,5,1,35909,35909,35910,0,1,2
10293,4,2,35913,35913,35915,0,2,3
10294,3,2,35916,35916,35918,0,2,1
10295,5,3,35921,35921,35924,0,3,3
10296,3,1,35924,35924,35925,0,1,0
10297,5,3,35929,35929,35932,0,3,4
10298,1,1,35930,35932,35933,2,3,0
10299,1,2,35931,35933,35935,2,4,0
10300,3,1,35934,35935,35936,1,2,0
10301,1,3,35935,35936,35939,1,4,0
10302,4,2,35939,35939,35941,0,2,0
10303,4,3,35943,35943,35946,0,3,2
10304,5,1,35948,35948,35949,0,1,2
10305,1,1,35949,35949,35950,0,1,0
10306,2,1,35951,35951,35952,0,1,1
10307,5,2,35956,35956,35958,0,2,4
10308,6,2,35962,35962,35964,0,2,4
10309,3,2,35965,35965,35967,0,2,1
10310,4,3,35969,35969,35972,0,3,2
10311,4,3,35973,35973,35976,0,3,1
10312,5,2,35978,35978,35980,0,2,2
10313,2,2,35980,35980,35982,0,2,0
10314,5,1,35985,35985,35986,0,1,3
10315,2,2,35987,35987,35989,0,2,1
10316,4,2,35991,35991,35993,0,2,2
10317,2,1,35993,35993,35994,0,1,0
10318,1,2,35994,35994,35996,0,2,0
10319,4,2,35998,35998,36000,0,2,2
10320,1,2,35999,36000,36002,1,3,0
10321,5,3,36004,36004,36007,0,3,2
10322,1,1,36005,36007,36008,2,3,0
10323,6,2,36011,36011,36013,0,2,3
10324,2,1,36013,36013,36014,0,1,0
10325,5,3,36018,36018,36021,0,3,4
10326,3,2,36021,36021,36023,0,2,0
10327,1,1,36022,36023,36024,1,2,0
10328,4,3,36026,36026,36029,0,3,2
10329,5,3,36031,36031,36034,0,3,2
10330,6,2,36037,36037,36039,0,2,3
10331,6,1,36043,36043,36044,0,1,4
10332,4,2,36047,36047,36049,0,2,3
10333,4,3,36051,36051,36054,0,3,2
10334,2,1,36053,36054,36055,1,2,0
10335,6,2,36059,36059,36061,0,2,4
10336,6,1,36065,36065,36066,0,1,4
10337,6,2,36071,36071,36073,0,2,5
10338,3,3,36074,36074,36077,0,3,1
10339,1,1,36075,36077,36078,2,3,0
10340,4,1,36079,36079,36080,0,1,1
10341,2,2,36081,36081,36083,0,2,1
10342,3,1,36084,36084,36085,0,1,1
10343,1,1,36085,36085,36086,0,1,0
10344,4,3,36089,36089,36092,0,3,3
10345,3,3,36092,36092,36095,0,3,0
10346,2,3,36094,36095,36098,1,4,0
10347,4,3,36098,36098,36101,0,3,0
10348,5,2,36103,36103,36105,0,2,2
10349,2,1,36105,36105,36106,0,1,0
10350,3,3,36108,36108,36111,0,3,2
10351,1,2,36109,36111,36113,2,4,0
10352,6,2,36115,36115,36117,0,2,2
10353,5,3,36120,36120,36123,0,3,3
10354,1,1,36121,36123,36124,2,3,0
10355,2,2,36123,36124,36126,1,3,0
10356,3,1,36126,36126,36127,0,1,0
10357,6,1,36132,36132,36133,0,1,5
10358,5,3,36137,36137,36140,0,3,4
10359,4,3,36141,36141,36144,0,3,1
10360,4,1,36145,36145,36146,0,1,1
10361,5,3,36150,36150,36153,0,3,4
10362,1,2,36151,36153,36155,2,4,0
10363,2,3,36153,36155,36158,2,5,0
10364,3,3,36156,36158,36161,2,5,0
10365,5,2,36161,36161,36163,0,2,0
10366,4,3,36165,36165,36168,0,3,2
10367,3,2,36168,36168,36170,0,2,0
10368,5,2,36173,36173,36175,0,2,3
10369,1,1,36174,36175,36176,1,2,0
10370,4,3,36178,36178,36181,0,3,2
10371,1,3,36179,36181,36184,2,5,0
10372,2,1,36181,36184,36185,3,4,0
10373,3,3,36184,36185,36188,1,4,0
10374,6,3,36190,36190,36193,0,3,2
10375,6,2,36196,36196,36198,0,2,3
10376,1,1,36197,36198,36199,1,2,0
10377,4,1,36201,36201,36202,0,1,2
10378,3,3,36204,36204,36207,0,3,2
10379,1,2,36205,36207,36209,2,4,0
10380,3,1,36208,36209,36210,1,2,0
10381,4,2,36212,36212,36214,0,2,2
10382,2,2,36214,36214,36216,0,2,0
10383,3,1,36217,36217,36218,0,1,1
10384,6,2,36223,36223,36225,0,2,5
10385,1,3,36224,36225,36228,1,4,0
10386,6,1,36230,36230,36231,0,1,2
10387,3,2,36233,36233,36235,0,2,2
10388,6,2,36239,36239,36241,0,2,4
10389,5,1,36244,36244,36245,0,1,3
10390,2,2,36246,36246,36248,0,2,1
10391,2,3,36248,36248,36251,0,3,0
10392,4,2,36252,36252,36254,0,2,1
10393,3,3,36255,36255,36258,0,3,1
10394,2,1,36257,36258,36259,1,2,0
10395,1,2,36258,36259,36261,1,3,0
10396,2,1,36260,36261,36262,1,2,0
10397,4,2,36264,36264,36266,0,2,2
10398,2,3,36266,36266,36269,0,3,0
10399,6,3,36272,36272,36275,0,3,3
10400,2,1,36274,36275,36276,1,2,0
10401,6,1,36280,36280,36281,0,1,4
10402,5,3,36285,36285,36288,0,3,4
10403,2,1,36287,36288,36289,1,2,0
10404,3,1,36290,36290,36291,0,1,1
10405,1,3,36291,36291,36294,0,3,0
10406,3,2,36294,36294,36296,0,2,0
10407,1,3,36295,36296,36299,1,4,0
10408,1,1,36296,36299,36300,3,4,0
10409,6,1,36302,36302,36303,0,1,2
10410,1,3,36303,36303,36306,0,3,0
10411,5,1,36308,36308,36309,0,1,2
10412,2,1,36310,36310,36311,0,1,1
10413,4,3,36314,36314,36317,0,3,3
10414,4,1,36318,36318,36319,0,1,1
10415,1,1,36319,36319,36320,0,1,0
10416,1,1,36320,36320,36321,0,1,0
10417,4,1,36324,36324,36325,0,1,3
10418,4,2,36328,36328,36330,0,2,3
10419,2,2,36330,36330,36332,0,2,0
10420,2,1,36332,36332,36333,0,1,0
10421,1,2,36333,36333,36335,0,2,0
10422,5,1,36338,36338,36339,0,1,3
10423,3,2,36341,36341,36343,0,2,2
10424,4,3,36345,36345,36348,0,3,2
10425,1,1,36346,36348,36349,2,3,0
10426,5,2,36351,36351,36353,0,2,2
10427,5,1,36356,36356,36357,0,1,3
10428,6,1,36362,36362,36363,0,1,5
10429,4,1,36366,36366,36367,0,1,3
10430,2,2,36368,36368,36370,0,2,1
10431,4,1,36372,36372,36373,0,1,2
10432,1,2,36373,36373,36375,0,2,0
10433,2,3,36375,36375,36378,0,3,0
10434,1,3,36376,36378,36381,2,5,0
10435,1,1,36377,36381,36382,4,5,0
10436,3,3,36380,36382,36385,2,5,0
10437,2,1,36382,36385,36386,3,4,0
10438,6,2,36388,36388,36390,0,2,2
10439,5,3,36393,36393,36396,0,3,3
10440,1,2,36394,36396,36398,2,4,0
10441,2,3,36396,36398,36401,2,5,0
10442,5,1,36401,36401,36402,0,1,0
10443,6,1,36407,36407,36408,0,1,5
10444,3,1,36410,36410,36411,0,1,2
10445,5,1,36415,36415,36416,0,1,4
10446,4,3,36419,36419,36422,0,3,3
10447,4,3,36423,36423,36426,0,3,1
10448,5,3,36428,36428,36431,0,3,2
10449,5,2,36433,36433,36435,0,2,2
10450,3,3,36436,36436,36439,0,3,1
10451,3,1,36439,36439,36440,0,1,0
10452,2,3,36441,36441,36444,0,3,1
10453,4,3,36445,36445,36448,0,3,1
10454,1,3,36446,36448,36451,2,5,0
10455,1,1,36447,36451,36452,4,5,0
10456,6,2,36453,36453,36455,0,2,1
10457,2,1,36455,36455,36456,0,1,0
10458,6,2,36461,36461,36463,0,2,5
10459,5,2,36466,36466,36468,0,2,3
10460,4,1,36470,36470,36471,0,1,2
10461,5,3,36475,36475,36478,0,3,4
10462,2,3,36477,36478,36481,1,4,0
10463,2,1,36479,36481,36482,2,3,0
10464,1,3,36480,36482,36485,2,5,0
10465,1,1,36481,36485,36486,4,5,0
10466,2,3,36483,36486,36489,3,6,0
10467,5,3,36488,36489,36492,1,4,0
10468,1,1,36489,36492,36493,3,4,0
10469,4,2,36493,36493,36495,0,2,0
10470,6,2,36499,36499,36501,0,2,4
10471,1,1,36500,36501,36502,1,2,0
10472,6,3,36506,36506,36509,0,3,4
10473,4,2,36510,36510,36512,0,2,1
10474,2,3,36512,36512,36515,0,3,0
10475,6,2,36518,36518,36520,0,2,3
10476,6,1,36524,36524,36525,0,1,4
10477,4,2,36528,36528,36530,0,2,3
10478,6,1,36534,36534,36535,0,1,4
10479,3,3,36537,36537,36540,0,3,2
10480,4,3,36541,36541,36544,0,3,1
10481,3,2,36544,36544,36546,0,2,0
10482,4,1,36548,36548,36549,0,1,2
10483,2,3,36550,36550,36553,0,3,1
10484,4,2,36554,36554,36556,0,2,1
10485,3,2,36557,36557,36559,0,2,1
10486,6,1,36563,36563,36564,0,1,4
10487,1,1,36564,36564,36565,0,1,0
10488,1,3,36565,36565,36568,0,3,0
10489,3,3,36568,36568,36571,0,3,0
10490,4,1,36572,36572,36573,0,1,1
10491,3,1,36575,36575,36576,0,1,2
10492,5,2,36580,36580,36582,0,2,4
10493,1,1,36581,36582,36583,1,2,0
10494,2,2,36583,36583,36585,0,2,0
10495,3,1,36586,36586,36587,0,1,1
10496,1,3,36587,36587,36590,0,3,0
10497,1,1,36588,36590,36591,2,3,0
10498,2,1,36590,36591,36592,1,2,0
10499,4,1,36594,36594,36595,0,1,2
10500,3,1,36597,36597,36598,0,1,2
10501,1,1,36598,36598,36599,0,1,0
10502,6,3,36604,36604,36607,0,3,5
10503,1,3,36605,36607,36610,2,5,0
10504,6,2,36611,36611,36613,0,2,1
10505,6,2,36617,36617,36619,0,2,4
10506,1,3,36618,36619,36622,1,4,0
10507,3,3,36621,36622,36625,1,4,0
10508,2,3,36623,36625,36628,2,5,0
10509,1,1,36624,36628,36629,4,5,0
10510,4,3,36628,36629,36632,1,4,0
10511,5,2,36633,36633,36635,0,2,1
10512,5,2,36638,36638,36640,0,2,3
10513,6,1,36644,36644,36645,0,1,4
10514,5,3,36649,36649,36652,0,3,4
10515,2,2,36651,36652,36654,1,3,0
10516,6,3,36657,36657,36660,0,3,3
10517,2,3,36659,36660,36663,1,4,0
10518,2,2,36661,36663,36665,2,4,0
10519,6,1,36667,36667,36668,0,1,2
10520,1,2,36668,36668,36670,0,2,0
10521,6,2,36674,36674,36676,0,2,4
10522,4,2,36678,36678,36680,0,2,2
10523,4,1,36682,36682,36683,0,1,2
10524,5,2,36687,36687,36689,0,2,4
10525,5,2,36692,36692,36694,0,2,3
10526,6,1,36698,36698,36699,0,1,4
10527,5,3,36703,36703,36706,0,3,4
10528,6,3,36709,36709,36712,0,3,3
10529,6,2,36715,36715,36717,0,2,3
10530,1,1,36716,36717,36718,1,2,0
10531,6,2,36722,36722,36724,0,2,4
10532,3,2,36725,36725,36727,0,2,1
10533,5,1,36730,36730,36731,0,1,3
10534,1,1,36731,36731,36732,0,1,0
10535,3,3,36734,36734,36737,0,3,2
10536,4,1,36738,36738,36739,0,1,1
10537,3,1,36741,36741,36742,0,1,2
10538,1,3,36742,36742,36745,0,3,0
10539,6,1,36748,36748,36749,0,1,3
10540,6,1,36754,36754,36755,0,1,5
10541,2,1,36756,36756,36757,0,1,1
10542,4,2,36760,36760,36762,0,2,3
10543,1,1,36761,36762,36763,1,2,0
10544,5,2,36766,36766,36768,0,2,3
10545,5,1,36771,36771,36772,0,1,3
10546,3,2,36774,36774,36776,0,2,2
10547,2,1,36776,36776,36777,0,1,0
10548,3,3,36779,36779,36782,0,3,2
10549,1,1,36780,36782,36783,2,3,0
10550,4,1,36784,36784,36785,0,1,1
10551,5,1,36789,36789,36790,0,1,4
10552,1,2,36790,36790,36792,0,2,0
10553,2,1,36792,36792,36793,0,1,0
10554,2,1,36794,36794,36795,0,1,1
10555,2,2,36796,36796,36798,0,2,1
10556,6,1,36802,36802,36803,0,1,4
10557,1,2,36803,36803,36805,0,2,0
10558,3,1,36806,36806,36807,0,1,1
10559,3,2,36809,36809,36811,0,2,2
10560,4,3,36813,36813,36816,0,3,2
10561,4,2,36817,36817,36819,0,2,1
10562,4,1,36821,36821,36822,0,1,2
10563,3,2,36824,36824,36826,0,2,2
10564,2,3,36826,36826,36829,0,3,0
10565,6,3,36832,36832,36835,0,3,3
10566,4,1,36836,36836,36837,0,1,1
10567,4,2,36840,36840,36842,0,2,3
10568,4,2,36844,36844,36846,0,2,2
10569,2,2,36846,36846,36848,0,2,0
10570,6,2,36852,36852,36854,0,2,4
10571,2,3,36854,36854,36857,0,3,0
10572,4,3,36858,36858,36861,0,3,1
10573,3,2,36861,36861,36863,0,2,0
10574,5,3,36866,36866,36869,0,3,3
10575,6,1,36872,36872,36873,0,1,3
10576,4,1,36876,36876,36877,0,1,3
10577,1,2,36877,36877,36879,0,2,0
10578,5,3,36882,36882,36885,0,3,3
10579,6,1,36888,36888,36889,0,1,3
10580,2,3,36890,36890,36893,0,3,1
10581,5,1,36895,36895,36896,0,1,2
10582,2,2,36897,36897,36899,0,2,1
10583,3,1,36900,36900,36901,0,1,1
10584,1,2,36901,36901,36903,0,2,0
10585,3,2,36904,36904,36906,0,2,1
10586,5,3,36909,36909,36912,0,3,3
10587,3,3,36912,36912,36915,0,3,0
10588,6,2,36918,36918,36920,0,2,3
10589,3,3,36921,36921,36924,0,3,1
10590,3,2,36924,36924,36926,0,2,0
10591,4,3,36928,36928,36931,0,3,2
10592,3,2,36931,36931,36933,0,2,0
10593,2,3,36933,36933,36936,0,3,0
10594,5,3,36938,36938,36941,0,3,2
10595,6,1,36944,36944,36945,0,1,3
10596,1,1,36945,36945,36946,0,1,0
10597,6,2,36951,36951,36953,0,2,5
10598,4,1,36955,36955,36956,0,1,2
10599,4,3,36959,36959,36962,0,3,3
10600,4,3,36963,36963,36966,0,3,1
10601,5,1,36968,36968,36969,0,1,2
10602,5,2,36973,36973,36975,0,2,4
10603,3,2,36976,36976,36978,0,2,1
10604,4,1,36980,36980,36981,0,1,2
10605,5,1,36985,36985,36986,0,1,4
10606,5,2,36990,36990,36992,0,2,4
10607,6,1,36996,36996,36997,0,1,4
10608,4,1,37000,37000,37001,0,1,3
10609,4,2,37004,37004,37006,0,2,3
10610,5,2,37009,37009,37011,0,2,3
10611,6,3,37015,37015,37018,0,3,4
10612,2,2,37017,37018,37020,1,3,0
10613,6,3,37023,37023,37026,0,3,3
10614,2,2,37025,37026,37028,1,3,0
10615,5,2,37030,37030,37032,0,2,2
10616,6,2,37036,37036,37038,0,2,4
10617,5,2,37041,37041,37043,0,2,3
10618,1,1,37042,37043,37044,1,2,0
10619,1,1,37043,37044,37045,1,2,0
10620,2,1,37045,37045,37046,0,1,0
10621,3,3,37048,37048,37051,0,3,2
10622,6,1,37054,37054,37055,0,1,3
10623,4,1,37058,37058,37059,0,1,3
10624,5,1,37063,37063,37064,0,1,4
10625,1,1,37064,37064,37065,0,1,0
10626,4,2,37068,37068,37070,0,2,3
10627,1,1,37069,37070,37071,1,2,0
10628,4,2,37073,37073,37075,0,2,2
10629,3,2,37076,37076,37078,0,2,1
10630,3,1,37079,37079,37080,0,1,1
10631,2,2,37081,37081,37083,0,2,1
10632,4,1,37085,37085,37086,0,1,2
10633,6,3,37091,37091,37094,0,3,5
10634,3,1,37094,37094,37095,0,1,0
10635,4,2,37098,37098,37100,0,2,3
10636,1,1,37099,37100,37101,1,2,0
10637,5,3,37104,37104,37107,0,3,3
10638,1,3,37105,37107,37110,2,5,0
10639,6,1,37111,37111,37112,0,1,1
10640,4,3,37115,37115,37118,0,3,3
10641,3,1,37118,37118,37119,0,1,0
10642,6,2,37124,37124,37126,0,2,5
10643,5,1,37129,37129,37130,0,1,3
10644,5,2,37134,37134,37136,0,2,4
10645,1,1,37135,37136,37137,1,2,0
10646,5,1,37140,37140,37141,0,1,3
10647,6,3,37146,37146,37149,0,3,5
10648,2,2,37148,37149,37151,1,3,0
10649,3,3,37151,37151,37154,0,3,0
10650,3,2,37154,37154,37156,0,2,0
10651,5,3,37159,37159,37162,0,3,3
10652,2,3,37161,37162,37165,1,4,0
10653,5,1,37166,37166,37167,0,1,1
10654,3,3,37169,37169,37172,0,3,2
10655,6,1,37175,37175,37176,0,1,3
10656,1,3,37176,37176,37179,0,3,0
10657,4,2,37180,37180,37182,0,2,1
10658,2,3,37182,37182,37185,0,3,0
10659,2,2,37184,37185,37187,1,3,0
10660,6,3,37190,37190,37193,0,3,3
10661,4,2,37194,37194,37196,0,2,1
10662,6,2,37200,37200,37202,0,2,4
10663,3,2,37203,37203,37205,0,2,1
10664,4,1,37207,37207,37208,0,1,2
10665,2,1,37209,37209,37210,0,1,1
10666,4,3,37213,37213,37216,0,3,3
10667,5,2,37218,37218,37220,0,2,2
10668,5,1,37223,37223,37224,0,1,3
10669,5,1,37228,37228,37229,0,1,4
10670,1,3,37229,37229,37232,0,3,0
10671,6,1,37235,37235,37236,0,1,3
10672,1,3,37236,37236,37239,0,3,0
10673,6,3,37242,37242,37245,0,3,3
10674,6,1,37248,37248,37249,0,1,3
10675,1,3,37249,37249,37252,0,3,0
10676,6,1,37255,37255,37256,0,1,3
10677,3,2,37258,37258,37260,0,2,2
10678,1,2,37259,37260,37262,1,3,0
10679,3,1,37262,37262,37263,0,1,0
10680,1,3,37263,37263,37266,0,3,0
10681,5,3,37268,37268,37271,0,3,2
10682,6,1,37274,37274,37275,0,1,3
10683,2,3,37276,37276,37279,0,3,1
10684,2,2,37278,37279,37281,1,3,0
10685,3,2,37281,37281,37283,0,2,0
10686,2,2,37283,37283,37285,0,2,0
10687,1,2,37284,37285,37287,1,3,0
10688,5,2,37289,37289,37291,0,2,2
10689,6,3,37295,37295,37298,0,3,4
10690,5,1,37300,37300,37301,0,1,2
10691,1,2,37301,37301,37303,0,2,0
10692,6,3,37307,37307,37310,0,3,4
10693,1,2,37308,37310,37312,2,4,0
10694,5,3,37313,37313,37316,0,3,1
10695,5,3,37318,37318,37321,0,3,2
10696,2,2,37320,37321,37323,1,3,0
10697,5,1,37325,37325,37326,0,1,2
10698,3,1,37328,37328,37329,0,1,2
10699,5,3,37333,37333,37336,0,3,4
10700,2,3,37335,37336,37339,1,4,0
10701,1,3,37336,37339,37342,3,6,0
10702,4,2,37340,37342,37344,2,4,0
10703,3,3,37343,37344,37347,1,4,0
10704,6,3,37349,37349,37352,0,3,2
10705,1,1,37350,37352,37353,2,3,0
10706,6,2,37356,37356,37358,0,2,3
10707,5,1,37361,37361,37362,0,1,3
10708,2,1,37363,37363,37364,0,1,1
10709,6,2,37369,37369,37371,0,2,5
10710,6,2,37375,37375,37377,0,2,4
10711,1,3,37376,37377,37380,1,4,0
10712,6,3,37382,37382,37385,0,3,2
10713,6,1,37388,37388,37389,0,1,3
10714,6,3,37394,37394,37397,0,3,5
10715,4,1,37398,37398,37399,0,1,1
10716,2,2,37400,37400,37402,0,2,1
10717,1,3,37401,37402,37405,1,4,0
10718,1,2,37402,37405,37407,3,5,0
10719,3,3,37405,37407,37410,2,5,0
10720,6,2,37411,37411,37413,0,2,1
10721,1,2,37412,37413,37415,1,3,0
10722,6,3,37418,37418,37421,0,3,3
10723,6,3,37424,37424,37427,0,3,3
10724,6,2,37430,37430,37432,0,2,3
10725,1,3,37431,37432,37435,1,4,0
10726,1,2,37432,37435,37437,3,5,0
10727,6,2,37438,37438,37440,0,2,1
10728,1,1,37439,37440,37441,1,2,0
10729,1,2,37440,37441,37443,1,3,0
10730,6,3,37446,37446,37449,0,3,3
10731,2,3,37448,37449,37452,1,4,0
10732,5,2,37453,37453,37455,0,2,1
10733,5,2,37458,37458,37460,0,2,3
10734,2,1,37460,37460,37461,0,1,0
10735,1,1,37461,37461,37462,0,1,0
10736,5,2,37466,37466,37468,0,2,4
10737,1,1,37467,37468,37469,1,2,0
10738,1,1,37468,37469,37470,1,2,0
10739,4,3,37472,37472,37475,0,3,2
10740,4,3,37476,37476,37479,0,3,1
10741,5,1,37481,37481,37482,0,1,2
10742,6,3,37487,37487,37490,0,3,5
10743,1,3,37488,37490,37493,2,5,0
10744,4,3,37492,37493,37496,1,4,0
10745,1,3,37493,37496,37499,3,6,0
10746,6,3,37499,37499,37502,0,3,0
10747,4,2,37503,37503,37505,0,2,1
10748,2,1,37505,37505,37506,0,1,0
10749,5,3,37510,37510,37513,0,3,4
10750,5,1,37515,37515,37516,0,1,2
10751,3,1,37518,37518,37519,0,1,2
10752,6,1,37524,37524,37525,0,1,5
10753,1,1,37525,37525,37526,0,1,0
10754,1,2,37526,37526,37528,0,2,0
10755,2,2,37528,37528,37530,0,2,0
10756,5,3,37533,37533,37536,0,3,3
10757,3,2,37536,37536,37538,0,2,0
10758,5,3,37541,37541,37544,0,3,3
10759,4,2,37545,37545,37547,0,2,1
10760,5,2,37550,37550,37552,0,2,3
10761,5,1,37555,37555,37556,0,1,3
10762,2,1,37557,37557,37558,0,1,1
10763,3,2,37560,37560,37562,0,2,2
10764,6,3,37566,37566,37569,0,3,4
10765,5,3,37571,37571,37574,0,3,2
10766,3,2,37574,37574,37576,0,2,0
10767,4,1,37578,37578,37579,0,1,2
10768,3,3,37581,37581,37584,0,3,2
10769,4,2,37585,37585,37587,0,2,1
10770,2,2,37587,37587,37589,0,2,0
10771,4,1,37591,37591,37592,0,1,2
10772,6,3,37597,37597,37600,0,3,5
10773,5,1,37602,37602,37603,0,1,2
10774,6,3,37608,37608,37611,0,3,5
10775,1,2,37609,37611,37613,2,4,0
10776,5,3,37614,37614,37617,0,3,1
10777,1,3,37615,37617,37620,2,5,0
10778,4,2,37619,37620,37622,1,3,0
10779,5,2,37624,37624,37626,0,2,2
10780,5,2,37629,37629,37631,0,2,3
10781,2,1,37631,37631,37632,0,1,0
10782,5,1,37636,37636,37637,0,1,4
10783,1,2,37637,37637,37639,0,2,0
10784,5,3,37642,37642,37645,0,3,3
10785,1,2,37643,37645,37647,2,4,0
10786,2,3,37645,37647,37650,2,5,0
10787,1,2,37646,37650,37652,4,6,0
10788,3,2,37649,37652,37654,3,5,0
10789,2,2,37651,37654,37656,3,5,0
10790,6,1,37657,37657,37658,0,1,1
10791,2,2,37659,37659,37661,0,2,1
10792,5,1,37664,37664,37665,0,1,3
10793,2,3,37666,37666,37669,0,3,1
10794,5,1,37671,37671,37672,0,1,2
10795,3,1,37674,37674,37675,0,1,2
10796,6,1,37680,37680,37681,0,1,5
10797,4,2,37684,37684,37686,0,2,3
10798,4,1,37688,37688,37689,0,1,2
10799,2,2,37690,37690,37692,0,2,1
10800,4,2,37694,37694,37696,0,2,2
10801,4,3,37698,37698,37701,0,3,2
10802,6,2,37704,37704,37706,0,2,3
10803,5,1,37709,37709,37710,0,1,3
10804,1,2,37710,37710,37712,0,2,0
10805,4,1,37714,37714,37715,0,1,2
10806,4,3,37718,37718,37721,0,3,3
10807,3,3,37721,37721,37724,0,3,0
10808,5,3,37726,37726,37729,0,3,2
10809,3,3,37729,37729,37732,0,3,0
10810,1,1,37730,37732,37733,2,3,0
10811,6,2,37736,37736,37738,0,2,3
10812,6,2,37742,37742,37744,0,2,4
10813,1,3,37743,37744,37747,1,4,0
10814,5,3,37748,37748,37751,0,3,1
10815,2,1,37750,37751,37752,1,2,0
10816,3,3,37753,37753,37756,0,3,1
10817,4,2,37757,37757,37759,0,2,1
10818,3,3,37760,37760,37763,0,3,1
10819,2,2,37762,37763,37765,1,3,0
10820,1,3,37763,37765,37768,2,5,0
10821,2,1,37765,37768,37769,3,4,0
10822,1,2,37766,37769,37771,3,5,0
10823,4,3,37770,37771,37774,1,4,0
10824,2,2,37772,37774,37776,2,4,0
10825,4,2,37776,37776,37778,0,2,0
10826,1,2,37777,37778,37780,1,3,0
10827,2,3,37779,37780,37783,1,4,0
10828,5,2,37784,37784,37786,0,2,1
10829,4,3,37788,37788,37791,0,3,2
10830,5,3,37793,37793,37796,0,3,2
10831,1,1,37794,37796,37797,2,3,0
10832,6,3,37800,37800,37803,0,3,3
10833,1,2,37801,37803,37805,2,4,0
10834,3,1,37804,37805,37806,1,2,0
10835,3,3,37807,37807,37810,0,3,1
10836,3,2,37810,37810,37812,0,2,0
10837,5,2,37815,37815,37817,0,2,3
10838,3,2,37818,37818,37820,0,2,1
10839,1,1,37819,37820,37821,1,2,0
10840,4,1,37823,37823,37824,0,1,2
10841,3,1,37826,37826,37827,0,1,2
10842,1,2,37827,37827,37829,0,2,0
10843,2,3,37829,37829,37832,0,3,0
10844,5,2,37834,37834,37836,0,2,2
10845,3,3,37837,37837,37840,0,3,1
10846,6,1,37843,37843,37844,0,1,3
10847,4,2,37847,37847,37849,0,2,3
10848,5,1,37852,37852,37853,0,1,3
10849,2,1,37854,37854,37855,0,1,1
10850,1,3,37855,37855,37858,0,3,0
10851,2,3,37857,37858,37861,1,4,0
10852,4,1,37861,37861,37862,0,1,0
10853,4,3,37865,37865,37868,0,3,3
10854,1,1,37866,37868,37869,2,3,0
10855,1,2,37867,37869,37871,2,4,0
10856,4,1,37871,37871,37872,0,1,0
10857,5,3,37876,37876,37879,0,3,4
10858,1,2,37877,37879,37881,2,4,0
10859,1,3,37878,37881,37884,3,6,0
10860,1,2,37879,37884,37886,5,7,0
10861,2,3,37881,37886,37889,5,8,0
10862,1,3,37882,37889,37892,7,10,0
10863,1,1,37883,37892,37893,9,10,0
10864,5,1,37888,37893,37894,5,6,0
10865,6,3,37894,37894,37897,0,3,0
10866,1,3,37895,37897,37900,2,5,0
10867,6,2,37901,37901,37903,0,2,1
10868,1,3,37902,37903,37906,1,4,0
10869,1,1,37903,37906,37907,3,4,0
10870,4,3,37907,37907,37910,0,3,0
10871,3,1,37910,37910,37911,0,1,0
10872,4,2,37914,37914,37916,0,2,3
10873,2,1,37916,37916,37917,0,1,0
10874,6,2,37922,37922,37924,0,2,5
10875,1,2,37923,37924,37926,1,3,0
10876,6,3,37929,37929,37932,0,3,3
10877,5,1,37934,37934,37935,0,1,2
10878,4,2,37938,37938,37940,0,2,3
10879,1,2,37939,37940,37942,1,3,0
10880,1,2,37940,37942,37944,2,4,0
10881,6,1,37946,37946,37947,0,1,2
10882,2,2,37948,37948,37950,0,2,1
10883,4,2,37952,37952,37954,0,2,2
10884,3,2,37955,37955,37957,0,2,1
10885,3,2,37958,37958,37960,0,2,1
10886,4,2,37962,37962,37964,0,2,2
10887,4,1,37966,37966,37967,0,1,2
10888,5,2,37971,37971,37973,0,2,4
10889,1,1,37972,37973,37974,1,2,0
10890,4,2,37976,37976,37978,0,2,2
10891,5,1,37981,37981,37982,0,1,3
10892,5,1,37986,37986,37987,0,1,4
10893,4,3,37990,37990,37993,0,3,3
10894,5,3,37995,37995,37998,0,3,2
10895,6,1,38001,38001,38002,0,1,3
10896,3,3,38004,38004,38007,0,3,2
10897,2,1,38006,38007,38008,1,2,0
10898,1,1,38007,38008,38009,1,2,0
10899,5,1,38012,38012,38013,0,1,3
10900,2,2,38014,38014,38016,0,2,1
10901,2,2,38016,38016,38018,0,2,0
10902,3,1,38019,38019,38020,0,1,1
10903,6,3,38025,38025,38028,0,3,5
10904,2,1,38027,38028,38029,1,2,0
10905,3,2,38030,38030,38032,0,2,1
10906,4,1,38034,38034,38035,0,1,2
10907,2,3,38036,38036,38039,0,3,1
10908,2,1,38038,38039,38040,1,2,0
10909,5,1,38043,38043,38044,0,1,3
10910,2,1,38045,38045,38046,0,1,1
10911,4,3,38049,38049,38052,0,3,3
10912,2,1,38051,38052,38053,1,2,0
10913,3,2,38054,38054,38056,0,2,1
10914,2,3,38056,38056,38059,0,3,0
10915,4,3,38060,38060,38063,0,3,1
10916,5,3,38065,38065,38068,0,3,2
10917,3,2,38068,38068,38070,0,2,0
10918,2,1,38070,38070,38071,0,1,0
10919,5,1,38075,38075,38076,0,1,4
10920,1,1,38076,38076,38077,0,1,0
10921,6,1,38082,38082,38083,0,1,5
10922,2,2,38084,38084,38086,0,2,1
10923,5,2,38089,38089,38091,0,2,3
10924,5,2,38094,38094,38096,0,2,3
10925,2,3,38096,38096,38099,0,3,0
10926,2,3,38098,38099,38102,1,4,0
10927,3,2,38101,38102,38104,1,3,0
10928,5,3,38106,38106,38109,0,3,2
10929,5,2,38111,38111,38113,0,2,2
10930,2,1,38113,38113,38114,0,1,0
10931,4,2,38117,38117,38119,0,2,3
10932,2,3,38119,38119,38122,0,3,0
10933,5,3,38124,38124,38127,0,3,2
10934,3,3,38127,38127,38130,0,3,0
10935,4,1,38131,38131,38132,0,1,1
10936,1,2,38132,38132,38134,0,2,0
10937,4,2,38136,38136,38138,0,2,2
10938,3,1,38139,38139,38140,0,1,1
10939,5,3,38144,38144,38147,0,3,4
10940,1,2,38145,38147,38149,2,4,0
10941,3,2,38148,38149,38151,1,3,0
10942,5,2,38153,38153,38155,0,2,2
10943,4,1,38157,38157,38158,0,1,2
10944,6,1,38163,38163,38164,0,1,5
10945,5,1,38168,38168,38169,0,1,4
10946,2,3,38170,38170,38173,0,3,1
10947,6,3,38176,38176,38179,0,3,3
10948,4,1,38180,38180,38181,0,1,1
10949,4,2,38184,38184,38186,0,2,3
10950,4,2,38188,38188,38190,0,2,2
10951,1,2,38189,38190,38192,1,3,0
10952,6,1,38195,38195,38196,0,1,3
10953,4,2,38199,38199,38201,0,2,3
10954,2,3,38201,38201,38204,0,3,0
10955,4,1,38205,38205,38206,0,1,1
10956,2,2,38207,38207,38209,0,2,1
10957,1,3,38208,38209,38212,1,4,0
10958,2,1,38210,38212,38213,2,3,0
10959,4,3,38214,38214,38217,0,3,1
10960,2,1,38216,38217,38218,1,2,0
10961,4,2,38220,38220,38222,0,2,2
10962,5,2,38225,38225,38227,0,2,3
10963,5,2,38230,38230,38232,0,2,3
10964,5,1,38235,38235,38236,0,1,3
10965,6,1,38241,38241,38242,0,1,5
10966,3,1,38244,38244,38245,0,1,2
10967,2,3,38246,38246,38249,0,3,1
10968,5,1,38251,38251,38252,0,1,2
10969,3,1,38254,38254,38255,0,1,2
10970,6,1,38260,38260,38261,0,1,5
10971,2,2,38262,38262,38264,0,2,1
10972,1,3,38263,38264,38267,1,4,0
10973,2,2,38265,38267,38269,2,4,0
10974,6,3,38271,38271,38274,0,3,2
10975,2,1,38273,38274,38275,1,2,0
10976,4,3,38277,38277,38280,0,3,2
10977,6,2,38283,38283,38285,0,2,3
10978,2,2,38285,38285,38287,0,2,0
10979,2,3,38287,38287,38290,0,3,0
10980,1,3,38288,38290,38293,2,5,0
10981,5,2,38293,38293,38295,0,2,0
10982,2,1,38295,38295,38296,0,1,0
10983,5,3,38300,38300,38303,0,3,4
10984,1,2,38301,38303,38305,2,4,0
10985,6,3,38307,38307,38310,0,3,2
10986,1,1,38308,38310,38311,2,3,0
10987,6,3,38314,38314,38317,0,3,3
10988,5,1,38319,38319,38320,0,1,2
10989,2,1,38321,38321,38322,0,1,1
10990,3,1,38324,38324,38325,0,1,2
10991,5,1,38329,38329,38330,0,1,4
10992,2,3,38331,38331,38334,0,3,1
10993,4,2,38335,38335,38337,0,2,1
10994,4,3,38339,38339,38342,0,3,2
10995,1,3,38340,38342,38345,2,5,0
10996,1,2,38341,38345,38347,4,6,0
10997,2,2,38343,38347,38349,4,6,0
10998,4,3,38347,38349,38352,2,5,0
10999,3,2,38350,38352,38354,2,4,0
11000,1,3,38351,38354,38357,3,6,0
11001,2,3,38353,38357,38360,4,7,0
11002,3,2,38356,38360,38362,4,6,0
11003,3,1,38359,38362,38363,3,4,0
11004,6,2,38365,38365,38367,0,2,2
11005,4,1,38369,38369,38370,0,1,2
11006,1,1,38370,38370,38371,0,1,0
11007,3,3,38373,38373,38376,0,3,2
11008,6,2,38379,38379,38381,0,2,3
11009,5,3,38384,38384,38387,0,3,3
11010,3,1,38387,38387,38388,0,1,0
11011,2,2,38389,38389,38391,0,2,1
11012,5,1,38394,38394,38395,0,1,3
11013,2,3,38396,38396,38399,0,3,1
11014,5,2,38401,38401,38403,0,2,2
11015,4,1,38405,38405,38406,0,1,2
11016,6,3,38411,38411,38414,0,3,5
11017,3,3,38414,38414,38417,0,3,0
11018,5,3,38419,38419,38422,0,3,2
11019,4,3,38423,38423,38426,0,3,1
11020,3,1,38426,38426,38427,0,1,0
11021,4,2,38430,38430,38432,0,2,3
11022,2,2,38432,38432,38434,0,2,0
11023,6,2,38438,38438,38440,0,2,4
11024,5,1,38443,38443,38444,0,1,3
11025,5,3,38448,38448,38451,0,3,4
11026,2,2,38450,38451,38453,1,3,0
11027,6,3,38456,38456,38459,0,3,3
11028,4,1,38460,38460,38461,0,1,1
11029,4,3,38464,38464,38467,0,3,3
11030,1,2,38465,38467,38469,2,4,0
11031,2,2,38467,38469,38471,2,4,0
11032,4,2,38471,38471,38473,0,2,0
11033,6,1,38477,38477,38478,0,1,4
11034,3,3,38480,38480,38483,0,3,2
11035,1,2,38481,38483,38485,2,4,0
11036,2,1,38483,38485,38486,2,3,0
11037,3,3,38486,38486,38489,0,3,0
11038,6,3,38492,38492,38495,0,3,3
11039,3,2,38495,38495,38497,0,2,0
11040,4,1,38499,38499,38500,0,1,2
11041,5,3,38504,38504,38507,0,3,4
11042,6,3,38510,38510,38513,0,3,3
11043,5,3,38515,38515,38518,0,3,2
11044,1,2,38516,38518,38520,2,4,0
11045,1,1,38517,38520,38521,3,4,0
11046,4,3,38521,38521,38524,0,3,0
11047,3,1,38524,38524,38525,0,1,0
11048,6,2,38530,38530,38532,0,2,5
11049,6,3,38536,38536,38539,0,3,4
11050,5,1,38541,38541,38542,0,1,2
11051,2,2,38543,38543,38545,0,2,1
11052,1,1,38544,38545,38546,1,2,0
11053,1,3,38545,38546,38549,1,4,0
11054,1,3,38546,38549,38552,3,6,0
11055,2,2,38548,38552,38554,4,6,0
11056,5,2,38553,38554,38556,1,3,0
11057,3,1,38556,38556,38557,0,1,0
11058,2,2,38558,38558,38560,0,2,1
11059,1,3,38559,38560,38563,1,4,0
11060,3,3,38562,38563,38566,1,4,0
11061,4,3,38566,38566,38569,0,3,0
11062,5,3,38571,38571,38574,0,3,2
11063,1,3,38572,38574,38577,2,5,0
11064,1,1,38573,38577,38578,4,5,0
11065,6,3,38579,38579,38582,0,3,1
11066,3,2,38582,38582,38584,0,2,0
11067,6,2,38588,38588,38590,0,2,4
11068,1,2,38589,38590,38592,1,3,0
11069,4,3,38593,38593,38596,0,3,1
11070,4,1,38597,38597,38598,0,1,1
11071,4,1,38601,38601,38602,0,1,3
11072,3,1,38604,38604,38605,0,1,2
11073,5,2,38609,38609,38611,0,2,4
11074,2,2,38611,38611,38613,0,2,0
11075,6,2,38617,38617,38619,0,2,4
11076,4,1,38621,38621,38622,0,1,2
11077,1,3,38622,38622,38625,0,3,0
11078,2,3,38624,38625,38628,1,4,0
11079,4,3,38628,38628,38631,0,3,0
11080,4,2,38632,38632,38634,0,2,1
11081,5,2,38637,38637,38639,0,2,3
11082,2,1,38639,38639,38640,0,1,0
11083,3,2,38642,38642,38644,0,2,2
11084,6,2,38648,38648,38650,0,2,4
11085,2,3,38650,38650,38653,0,3,0
11086,3,3,38653,38653,38656,0,3,0
11087,4,3,38657,38657,38660,0,3,1
11088,4,3,38661,38661,38664,0,3,1
11089,1,3,38662,38664,38667,2,5,0
11090,5,2,38667,38667,38669,0,2,0
11091,6,3,38673,38673,38676,0,3,4
11092,6,3,38679,38679,38682,0,3,3
11093,6,3,38685,38685,38688,0,3,3
11094,1,2,38686,38688,38690,2,4,0
11095,6,2,38692,38692,38694,0,2,2
11096,4,1,38696,38696,38697,0,1,2
11097,1,1,38697,38697,38698,0,1,0
11098,6,2,38703,38703,38705,0,2,5
11099,3,3,38706,38706,38709,0,3,1
11100,6,3,38712,38712,38715,0,3,3
11101,2,1,38714,38715,38716,1,2,0
11102,4,2,38718,38718,38720,0,2,2
11103,1,3,38719,38720,38723,1,4,0
11104,2,2,38721,38723,38725,2,4,0
11105,1,3,38722,38725,38728,3,6,0
11106,1,3,38723,38728,38731,5,8,0
11107,1,2,38724,38731,38733,7,9,0
11108,6,3,38730,38733,38736,3,6,0
11109,3,3,38733,38736,38739,3,6,0
11110,5,2,38738,38739,38741,1,3,0
11111,2,2,38740,38741,38743,1,3,0
11112,3,1,38743,38743,38744,0,1,0
11113,3,2,38746,38746,38748,0,2,2
11114,3,1,38749,38749,38750,0,1,1
11115,6,1,38755,38755,38756,0,1,5
11116,4,2,38759,38759,38761,0,2,3
11117,4,2,38763,38763,38765,0,2,2
11118,3,1,38766,38766,38767,0,1,1
11119,2,2,38768,38768,38770,0,2,1
11120,5,1,38773,38773,38774,0,1,3
11121,5,2,38778,38778,38780,0,2,4
11122,6,3,38784,38784,38787,0,3,4
11123,4,1,38788,38788,38789,0,1,1
11124,3,2,38791,38791,38793,0,2,2
11125,3,2,38794,38794,38796,0,2,1
11126,2,3,38796,38796,38799,0,3,0
11127,3,1,38799,38799,38800,0,1,0
11128,5,3,38804,38804,38807,0,3,4
11129,1,3,38805,38807,38810,2,5,0
11130,1,2,38806,38810,38812,4,6,0
11131,5,1,38811,38812,38813,1,2,0
11132,1,3,38812,38813,38816,1,4,0
11133,2,2,38814,38816,38818,2,4,0
11134,3,1,38817,38818,38819,1,2,0
11135,1,1,38818,38819,38820,1,2,0
11136,3,2,38821,38821,38823,0,2,1
11137,5,1,38826,38826,38827,0,1,3
11138,6,2,38832,38832,38834,0,2,5
11139,1,1,38833,38834,38835,1,2,0
11140,1,2,38834,38835,38837,1,3,0
11141,4,3,38838,38838,38841,0,3,1
11142,2,2,38840,38841,38843,1,3,0
11143,4,2,38844,38844,38846,0,2,1
11144,5,1,38849,38849,38850,0,1,3
11145,4,1,38853,38853,38854,0,1,3
11146,3,1,38856,38856,38857,0,1,2
11147,1,1,38857,38857,38858,0,1,0
11148,3,3,38860,38860,38863,0,3,2
11149,6,2,38866,38866,38868,0,2,3
11150,1,1,38867,38868,38869,1,2,0
11151,1,3,38868,38869,38872,1,4,0
11152,2,2,38870,38872,38874,2,4,0
11153,3,3,38873,38874,38877,1,4,0
11154,2,3,38875,38877,38880,2,5,0
11155,5,1,38880,38880,38881,0,1,0
11156,6,3,38886,38886,38889,0,3,5
11157,1,1,38887,38889,38890,2,3,0
11158,4,3,38891,38891,38894,0,3,1
11159,6,1,38897,38897,38898,0,1,3
11160,2,3,38899,38899,38902,0,3,1
11161,4,3,38903,38903,38906,0,3,1
11162,3,1,38906,38906,38907,0,1,0
11163,6,3,38912,38912,38915,0,3,5
11164,3,1,38915,38915,38916,0,1,0
11165,4,2,38919,38919,38921,0,2,3
11166,2,1,38921,38921,38922,0,1,0
11167,3,1,38924,38924,38925,0,1,2
11168,3,3,38927,38927,38930,0,3,2
11169,4,3,38931,38931,38934,0,3,1
11170,1,1,38932,38934,38935,2,3,0
11171,5,2,38937,38937,38939,0,2,2
11172,6,3,38943,38943,38946,0,3,4
11173,3,1,38946,38946,38947,0,1,0
11174,1,1,38947,38947,38948,0,1,0
11175,1,2,38948,38948,38950,0,2,0
11176,3,1,38951,38951,38952,0,1,1
11177,6,1,38957,38957,38958,0,1,5
11178,2,2,38959,38959,38961,0,2,1
11179,1,1,38960,38961,38962,1,2,0
11180,4,2,38964,38964,38966,0,2,2
11181,5,1,38969,38969,38970,0,1,3
11182,5,2,38974,38974,38976,0,2,4
11183,2,2,38976,38976,38978,0,2,0
11184,2,2,38978,38978,38980,0,2,0
11185,6,3,38984,38984,38987,0,3,4
11186,3,2,38987,38987,38989,0,2,0
11187,2,3,38989,38989,38992,0,3,0
11188,6,2,38995,38995,38997,0,2,3
11189,1,1,38996,38997,38998,1,2,0
11190,6,2,39002,39002,39004,0,2,4
11191,3,2,39005,39005,39007,0,2,1
11192,2,2,39007,39007,39009,0,2,0
11193,6,3,39013,39013,39016,0,3,4
11194,6,3,39019,39019,39022,0,3,3
11195,3,1,39022,39022,39023,0,1,0
11196,6,1,39028,39028,39029,0,1,5
11197,5,2,39033,39033,39035,0,2,4
11198,5,1,39038,39038,39039,0,1,3
11199,5,3,39043,39043,39046,0,3,4
11200,1,2,39044,39046,39048,2,4,0
11201,2,3,39046,39048,39051,2,5,0
11202,1,2,39047,39051,39053,4,6,0
11203,3,2,39050,39053,39055,3,5,0
11204,5,1,39055,39055,39056,0,1,0
11205,6,2,39061,39061,39063,0,2,5
11206,2,2,39063,39063,39065,0,2,0
11207,2,2,39065,39065,39067,0,2,0
11208,2,3,39067,39067,39070,0,3,0
11209,2,3,39069,39070,39073,1,4,0
11210,5,1,39074,39074,39075,0,1,1
11211,3,1,39077,39077,39078,0,1,2
11212,5,3,39082,39082,39085,0,3,4
11213,3,3,39085,39085,39088,0,3,0
11214,6,3,39091,39091,39094,0,3,3
11215,2,1,39093,39094,39095,1,2,0
11216,1,1,39094,39095,39096,1,2,0
11217,5,3,39099,39099,39102,0,3,3
11218,5,1,39104,39104,39105,0,1,2
11219,3,2,39107,39107,39109,0,2,2
11220,6,3,39113,39113,39116,0,3,4
11221,3,2,39116,39116,39118,0,2,0
11222,5,2,39121,39121,39123,0,2,3
11223,2,2,39123,39123,39125,0,2,0
11224,5,3,39128,39128,39131,0,3,3
11225,2,2,39130,39131,39133,1,3,0
11226,1,1,39131,39133,39134,2,3,0
11227,3,3,39134,39134,39137,0,3,0
11228,2,1,39136,39137,39138,1,2,0
11229,2,2,39138,39138,39140,0,2,0
11230,5,1,39143,39143,39144,0,1,3
11231,1,3,39144,39144,39147,0,3,0
11232,1,2,39145,39147,39149,2,4,0
11233,2,1,39147,39149,39150,2,3,0
11234,3,3,39150,39150,39153,0,3,0
11235,4,2,39154,39154,39156,0,2,1
11236,2,1,39156,39156,39157,0,1,0
11237,5,2,39161,39161,39163,0,2,4
11238,5,3,39166,39166,39169,0,3,3
11239,6,3,39172,39172,39175,0,3,3
11240,5,2,39177,39177,39179,0,2,2
11241,2,3,39179,39179,39182,0,3,0
11242,6,3,39185,39185,39188,0,3,3
11243,2,2,39187,39188,39190,1,3,0
11244,1,3,39188,39190,39193,2,5,0
11245,5,2,39193,39193,39195,0,2,0
11246,3,2,39196,39196,39198,0,2,1
11247,1,2,39197,39198,39200,1,3,0
11248,2,2,39199,39200,39202,1,3,0
11249,3,2,39202,39202,39204,0,2,0
11250,5,2,39207,39207,39209,0,2,3
11251,2,3,39209,39209,39212,0,3,0
11252,3,3,39212,39212,39215,0,3,0
11253,4,2,39216,39216,39218,0,2,1
11254,6,2,39222,39222,39224,0,2,4
11255,4,2,39226,39226,39228,0,2,2
11256,5,2,39231,39231,39233,0,2,3
11257,6,3,39237,39237,39240,0,3,4
11258,4,2,39241,39241,39243,0,2,1
11259,4,3,39245,39245,39248,0,3,2
11260,5,1,39250,39250,39251,0,1,2
11261,6,1,39256,39256,39257,0,1,5
11262,3,1,39259,39259,39260,0,1,2
11263,2,1,39261,39261,39262,0,1,1
11264,4,2,39265,39265,39267,0,2,3
11265,4,1,39269,39269,39270,0,1,2
11266,6,1,39275,39275,39276,0,1,5
11267,6,3,39281,39281,39284,0,3,5
11268,4,1,39285,39285,39286,0,1,1
11269,2,1,39287,39287,39288,0,1,1
11270,1,2,39288,39288,39290,0,2,0
11271,6,2,39294,39294,39296,0,2,4
11272,6,1,39300,39300,39301,0,1,4
11273,3,2,39303,39303,39305,0,2,2
11274,5,2,39308,39308,39310,0,2,3
11275,6,2,39314,39314,39316,0,2,4
11276,3,2,39317,39317,39319,0,2,1
11277,2,2,39319,39319,39321,0,2,0
11278,6,1,39325,39325,39326,0,1,4
11279,1,2,39326,39326,39328,0,2,0
11280,3,1,39329,39329,39330,0,1,1
11281,2,1,39331,39331,39332,0,1,1
11282,4,1,39335,39335,39336,0,1,3
11283,1,3,39336,39336,39339,0,3,0
11284,5,2,39341,39341,39343,0,2,2
11285,5,3,39346,39346,39349,0,3,3
11286,5,1,39351,39351,39352,0,1,2
11287,3,2,39354,39354,39356,0,2,2
11288,5,3,39359,39359,39362,0,3,3
11289,5,3,39364,39364,39367,0,3,2
11290,6,3,39370,39370,39373,0,3,3
11291,6,2,39376,39376,39378,0,2,3
11292,5,2,39381,39381,39383,0,2,3
11293,2,1,39383,39383,39384,0,1,0
11294,4,3,39387,39387,39390,0,3,3
11295,4,3,39391,39391,39394,0,3,1
11296,1,1,39392,39394,39395,2,3,0
11297,1,1,39393,39395,39396,2,3,0
11298,2,3,39395,39396,39399,1,4,0
11299,3,1,39398,39399,39400,1,2,0
11300,3,2,39401,39401,39403,0,2,1
11301,3,1,39404,39404,39405,0,1,1
11302,4,1,39408,39408,39409,0,1,3
11303,4,1,39412,39412,39413,0,1,3
11304,1,3,39413,39413,39416,0,3,0
11305,5,1,39418,39418,39419,0,1,2
11306,4,1,39422,39422,39423,0,1,3
11307,3,1,39425,39425,39426,0,1,2
11308,2,2,39427,39427,39429,0,2,1
11309,6,2,39433,39433,39435,0,2,4
11310,6,3,39439,39439,39442,0,3,4
11311,5,2,39444,39444,39446,0,2,2
11312,3,1,39447,39447,39448,0,1,1
11313,2,3,39449,39449,39452,0,3,1
11314,2,2,39451,39452,39454,1,3,0
11315,1,1,39452,39454,39455,2,3,0
11316,2,1,39454,39455,39456,1,2,0
11317,6,2,39460,39460,39462,0,2,4
11318,6,3,39466,39466,39469,0,3,4
11319,3,1,39469,39469,39470,0,1,0
11320,3,3,39472,39472,39475,0,3,2
11321,5,1,39477,39477,39478,0,1,2
11322,6,2,39483,39483,39485,0,2,5
11323,3,2,39486,39486,39488,0,2,1
11324,3,2,39489,39489,39491,0,2,1
11325,1,2,39490,39491,39493,1,3,0
11326,1,1,39491,39493,39494,2,3,0
11327,4,1,39495,39495,39496,0,1,1
11328,1,3,39496,39496,39499,0,3,0
11329,6,3,39502,39502,39505,0,3,3
11330,6,1,39508,39508,39509,0,1,3
11331,2,3,39510,39510,39513,0,3,1
11332,5,1,39515,39515,39516,0,1,2
11333,6,1,39521,39521,39522,0,1,5
11334,4,1,39525,39525,39526,0,1,3
11335,4,1,39529,39529,39530,0,1,3
11336,4,3,39533,39533,39536,0,3,3
11337,6,3,39539,39539,39542,0,3,3
11338,6,1,39545,39545,39546,0,1,3
11339,6,2,39551,39551,39553,0,2,5
11340,5,2,39556,39556,39558,0,2,3
11341,5,2,39561,39561,39563,0,2,3
11342,3,1,39564,39564,39565,0,1,1
11343,5,2,39569,39569,39571,0,2,4
11344,4,2,39573,39573,39575,0,2,2
11345,1,1,39574,39575,39576,1,2,0
11346,6,2,39580,39580,39582,0,2,4
11347,2,3,39582,39582,39585,0,3,0
11348,1,2,39583,39585,39587,2,4,0
11349,2,1,39585,39587,39588,2,3,0
11350,1,3,39586,39588,39591,2,5,0
11351,5,1,39591,39591,39592,0,1,0
11352,5,3,39596,39596,39599,0,3,4
11353,2,1,39598,39599,39600,1,2,0
11354,1,1,39599,39600,39601,1,2,0
11355,3,2,39602,39602,39604,0,2,1
11356,2,1,39604,39604,39605,0,1,0
11357,2,1,39606,39606,39607,0,1,1
11358,3,3,39609,39609,39612,0,3,2
11359,5,1,39614,39614,39615,0,1,2
11360,6,1,39620,39620,39621,0,1,5
11361,5,3,39625,39625,39628,0,3,4
11362,2,1,39627,39628,39629,1,2,0
11363,6,3,39633,39633,39636,0,3,4
11364,2,3,39635,39636,39639,1,4,0
11365,5,3,39640,39640,39643,0,3,1
11366,1,3,39641,39643,39646,2,5,0
11367,2,1,39643,39646,39647,3,4,0
11368,2,1,39645,39647,39648,2,3,0
11369,3,2,39648,39648,39650,0,2,0
11370,1,3,39649,39650,39653,1,4,0
11371,1,3,39650,39653,39656,3,6,0
11372,1,2,39651,39656,39658,5,7,0
11373,3,2,39654,39658,39660,4,6,0
11374,5,3,39659,39660,39663,1,4,0
11375,6,3,39665,39665,39668,0,3,2
11376,1,3,39666,39668,39671,2,5,0
11377,4,2,39670,39671,39673,1,3,0
11378,3,3,39673,39673,39676,0,3,0
11379,6,1,39679,39679,39680,0,1,3
11380,6,2,39685,39685,39687,0,2,5
11381,5,3,39690,39690,39693,0,3,3
11382,4,2,39694,39694,39696,0,2,1
11383,6,1,39700,39700,39701,0,1,4
11384,2,3,39702,39702,39705,0,3,1
11385,3,3,39705,39705,39708,0,3,0
11386,4,3,39709,39709,39712,0,3,1
11387,1,1,39710,39712,39713,2,3,0
11388,4,2,39714,39714,39716,0,2,1
11389,3,3,39717,39717,39720,0,3,1
11390,2,3,39719,39720,39723,1,4,0
11391,2,3,39721,39723,39726,2,5,0
11392,6,2,39727,39727,39729,0,2,1
11393,4,1,39731,39731,39732,0,1,2
11394,6,2,39737,39737,39739,0,2,5
11395,6,1,39743,39743,39744,0,1,4
11396,5,2,39748,39748,39750,0,2,4
11397,2,1,39750,39750,39751,0,1,0
11398,3,3,39753,39753,39756,0,3,2
11399,4,3,39757,39757,39760,0,3,1
11400,4,1,39761,39761,39762,0,1,1
11401,2,1,39763,39763,39764,0,1,1
11402,2,1,39765,39765,39766,0,1,1
11403,3,3,39768,39768,39771,0,3,2
11404,3,3,39771,39771,39774,0,3,0
11405,2,3,39773,39774,39777,1,4,0
11406,3,3,39776,39777,39780,1,4,0
11407,2,1,39778,39780,39781,2,3,0
11408,1,1,39779,39781,39782,2,3,0
11409,3,1,39782,39782,39783,0,1,0
11410,4,1,39786,39786,39787,0,1,3
11411,3,3,39789,39789,39792,0,3,2
11412,1,1,39790,39792,39793,2,3,0
11413,4,3,39794,39794,39797,0,3,1
11414,5,3,39799,39799,39802,0,3,2
11415,5,1,39804,39804,39805,0,1,2
11416,5,3,39809,39809,39812,0,3,4
11417,5,2,39814,39814,39816,0,2,2
11418,6,1,39820,39820,39821,0,1,4
11419,5,3,39825,39825,39828,0,3,4
11420,6,2,39831,39831,39833,0,2,3
11421,1,2,39832,39833,39835,1,3,0
11422,4,2,39836,39836,39838,0,2,1
11423,3,3,39839,39839,39842,0,3,1
11424,1,3,39840,39842,39845,2,5,0
11425,2,3,39842,39845,39848,3,6,0
11426,2,2,39844,39848,39850,4,6,0
11427,3,2,39847,39850,39852,3,5,0
11428,5,2,39852,39852,39854,0,2,0
11429,4,1,39856,39856,39857,0,1,2
11430,3,2,39859,39859,39861,0,2,2
11431,5,3,39864,39864,39867,0,3,3
11432,1,1,39865,39867,39868,2,3,0
11433,3,2,39868,39868,39870,0,2,0
11434,5,2,39873,39873,39875,0,2,3
11435,2,3,39875,39875,39878,0,3,0
11436,1,2,39876,39878,39880,2,4,0
11437,2,1,39878,39880,39881,2,3,0
11438,6,2,39884,39884,39886,0,2,3
11439,3,2,39887,39887,39889,0,2,1
11440,6,1,39893,39893,39894,0,1,4
11441,2,1,39895,39895,39896,0,1,1
11442,2,3,39897,39897,39900,0,3,1
11443,1,2,39898,39900,39902,2,4,0
11444,5,3,39903,39903,39906,0,3,1
11445,5,2,39908,39908,39910,0,2,2
11446,3,2,39911,39911,39913,0,2,1
11447,5,2,39916,39916,39918,0,2,3
11448,3,3,39919,39919,39922,0,3,1
11449,1,1,39920,39922,39923,2,3,0
11450,4,2,39924,39924,39926,0,2,1
11451,3,3,39927,39927,39930,0,3,1
11452,3,1,39930,39930,39931,0,1,0
11453,1,2,39931,39931,39933,0,2,0
11454,4,2,39935,39935,39937,0,2,2
11455,1,3,39936,39937,39940,1,4,0
11456,2,1,39938,39940,39941,2,3,0
11457,2,1,39940,39941,39942,1,2,0
11458,5,1,39945,39945,39946,0,1,3
11459,3,2,39948,39948,39950,0,2,2
11460,2,2,39950,39950,39952,0,2,0
11461,6,1,39956,39956,39957,0,1,4
11462,4,1,39960,39960,39961,0,1,3
11463,5,2,39965,39965,39967,0,2,4
11464,5,2,39970,39970,39972,0,2,3
11465,1,1,39971,39972,39973,1,2,0
11466,5,2,39976,39976,39978,0,2,3
11467,5,3,39981,39981,39984,0,3,3
11468,5,1,39986,39986,39987,0,1,2
11469,2,3,39988,39988,39991,0,3,1
11470,6,2,39994,39994,39996,0,2,3
11471,2,1,39996,39996,39997,0,1,0
11472,2,2,39998,39998,40000,0,2,1
11473,5,2,40003,40003,40005,0,2,3
11474,1,3,40004,40005,40008,1,4,0
11475,3,3,40007,40008,40011,1,4,0
11476,1,2,40008,40011,40013,3,5,0
11477,4,3,40012,40013,40016,1,4,0
11478,2,2,40014,40016,40018,2,4,0
11479,2,2,40016,40018,40020,2,4,0
11480,3,1,40019,40020,40021,1,2,0
11481,4,1,40023,40023,40024,0,1,2
11482,5,3,40028,40028,40031,0,3,4
11483,4,2,40032,40032,40034,0,2,1
11484,1,1,40033,40034,40035,1,2,0
11485,4,1,40037,40037,40038,0,1,2
11486,4,2,40041,40041,40043,0,2,3
11487,5,3,40046,40046,40049,0,3,3
11488,4,2,40050,40050,40052,0,2,1
11489,2,2,40052,40052,40054,0,2,0
11490,4,3,40056,40056,40059,0,3,2
11491,1,3,40057,40059,40062,2,5,0
11492,4,3,40061,40062,40065,1,4,0
11493,1,3,40062,40065,40068,3,6,0
11494,6,3,40068,40068,40071,0,3,0
11495,5,3,40073,40073,40076,0,3,2
11496,3,2,40076,40076,40078,0,2,0
11497,6,3,40082,40082,40085,0,3,4
11498,3,1,40085,40085,40086,0,1,0
11499,6,3,40091,40091,40094,0,3,5
11500,4,3,40095,40095,40098,0,3,1
11501,5,1,40100,40100,40101,0,1,2
11502,6,1,40106,40106,40107,0,1,5
11503,6,3,40112,40112,40115,0,3,5
11504,4,2,40116,40116,40118,0,2,1
11505,3,2,40119,40119,40121,0,2,1
11506,6,2,40125,40125,40127,0,2,4
11507,2,3,40127,40127,40130,0,3,0
11508,3,1,40130,40130,40131,0,1,0
11509,4,1,40134,40134,40135,0,1,3
11510,3,1,40137,40137,40138,0,1,2
11511,4,1,40141,40141,40142,0,1,3
11512,3,2,40144,40144,40146,0,2,2
11513,1,2,40145,40146,40148,1,3,0
11514,5,3,40150,40150,40153,0,3,2
11515,2,2,40152,40153,40155,1,3,0
11516,2,3,40154,40155,40158,1,4,0
11517,3,3,40157,40158,40161,1,4,0
11518,1,2,40158,40161,40163,3,5,0
11519,5,2,40163,40163,40165,0,2,0
11520,1,2,40164,40165,40167,1,3,0
11521,3,2,40167,40167,40169,0,2,0
11522,1,2,40168,40169,40171,1,3,0
11523,4,3,40172,40172,40175,0,3,1
11524,2,1,40174,40175,40176,1,2,0
11525,6,2,40180,40180,40182,0,2,4
11526,6,3,40186,40186,40189,0,3,4
11527,1,3,40187,40189,40192,2,5,0
11528,3,3,40190,40192,40195,2,5,0
11529,6,3,40196,40196,40199,0,3,1
11530,5,1,40201,40201,40202,0,1,2
11531,5,1,40206,40206,40207,0,1,4
11532,4,2,40210,40210,40212,0,2,3
11533,4,2,40214,40214,40216,0,2,2
11534,1,2,40215,40216,40218,1,3,0
11535,6,3,40221,40221,40224,0,3,3
11536,4,2,40225,40225,40227,0,2,1
11537,1,3,40226,40227,40230,1,4,0
11538,6,2,40232,40232,40234,0,2,2
11539,6,3,40238,40238,40241,0,3,4
11540,4,3,40242,40242,40245,0,3,1
11541,3,2,40245,40245,40247,0,2,0
11542,4,2,40249,40249,40251,0,2,2
11543,6,3,40255,40255,40258,0,3,4
11544,1,2,40256,40258,40260,2,4,0
11545,6,3,40262,40262,40265,0,3,2
11546,4,2,40266,40266,40268,0,2,1
11547,6,2,40272,40272,40274,0,2,4
11548,2,3,40274,40274,40277,0,3,0
11549,1,2,40275,40277,40279,2,4,0
11550,6,1,40281,40281,40282,0,1,2
11551,2,3,40283,40283,40286,0,3,1
11552,4,3,40287,40287,40290,0,3,1
11553,5,2,40292,40292,40294,0,2,2
11554,6,3,40298,40298,40301,0,3,4
11555,2,3,40300,40301,40304,1,4,0
11556,4,1,40304,40304,40305,0,1,0
11557,4,1,40308,40308,40309,0,1,3
11558,5,1,40313,40313,40314,0,1,4
11559,4,2,40317,40317,40319,0,2,3
11560,4,2,40321,40321,40323,0,2,2
11561,6,2,40327,40327,40329,0,2,4
11562,6,2,40333,40333,40335,0,2,4
11563,1,1,40334,40335,40336,1,2,0
11564,4,2,40338,40338,40340,0,2,2
11565,6,3,40344,40344,40347,0,3,4
11566,3,3,40347,40347,40350,0,3,0
11567,4,3,40351,40351,40354,0,3,1
11568,3,2,40354,40354,40356,0,2,0
11569,2,3,40356,40356,40359,0,3,0
11570,1,1,40357,40359,40360,2,3,0
11571,1,1,40358,40360,40361,2,3,0
11572,1,1,40359,40361,40362,2,3,0
11573,1,2,40360,40362,40364,2,4,0
11574,1,1,40361,40364,40365,3,4,0
11575,5,2,40366,40366,40368,0,2,1
11576,2,2,40368,40368,40370,0,2,0
11577,4,3,40372,40372,40375,0,3,2
11578,2,1,40374,40375,40376,1,2,0
11579,6,2,40380,40380,40382,0,2,4
11580,3,3,40383,40383,40386,0,3,1
11581,6,1,40389,40389,40390,0,1,3
11582,1,2,40390,40390,40392,0,2,0
11583,3,3,40393,40393,40396,0,3,1
11584,1,2,40394,40396,40398,2,4,0
11585,1,2,40395,40398,40400,3,5,0
11586,5,2,40400,40400,40402,0,2,0
11587,2,1,40402,40402,40403,0,1,0
11588,4,3,40406,40406,40409,0,3,3
11589,4,1,40410,40410,40411,0,1,1
11590,6,2,40416,40416,40418,0,2,5
11591,1,3,40417,40418,40421,1,4,0
11592,2,3,40419,40421,40424,2,5,0
11593,4,1,40423,40424,40425,1,2,0
11594,6,2,40429,40429,40431,0,2,4
11595,4,1,40433,40433,40434,0,1,2
11596,5,3,40438,40438,40441,0,3,4
11597,5,2,40443,40443,40445,0,2,2
11598,2,3,40445,40445,40448,0,3,0
11599,4,3,40449,40449,40452,0,3,1
11600,2,1,40451,40452,40453,1,2,0
11601,4,1,40455,40455,40456,0,1,2
11602,2,3,40457,40457,40460,0,3,1
11603,1,3,40458,40460,40463,2,5,0
11604,4,3,40462,40463,40466,1,4,0
11605,1,2,40463,40466,40468,3,5,0
11606,3,1,40466,40468,40469,2,3,0
11607,3,1,40469,40469,40470,0,1,0
11608,5,2,40474,40474,40476,0,2,4
11609,5,3,40479,40479,40482,0,3,3
11610,6,2,40485,40485,40487,0,2,3
11611,2,3,40487,40487,40490,0,3,0
11612,1,3,40488,40490,40493,2,5,0
11613,4,1,40492,40493,40494,1,2,0
11614,3,1,40495,40495,40496,0,1,1
11615,4,2,40499,40499,40501,0,2,3
11616,3,2,40502,40502,40504,0,2,1
11617,4,3,40506,40506,40509,0,3,2
11618,6,2,40512,40512,40514,0,2,3
11619,2,3,40514,40514,40517,0,3,0
11620,5,3,40519,40519,40522,0,3,2
11621,5,3,40524,40524,40527,0,3,2
11622,6,3,40530,40530,40533,0,3,3
11623,5,3,40535,40535,40538,0,3,2
11624,3,3,40538,40538,40541,0,3,0
11625,5,2,40543,40543,40545,0,2,2
11626,6,1,40549,40549,40550,0,1,4
11627,4,1,40553,40553,40554,0,1,3
11628,4,3,40557,40557,40560,0,3,3
11629,3,3,40560,40560,40563,0,3,0
11630,3,1,40563,40563,40564,0,1,0
11631,2,1,40565,40565,40566,0,1,1
11632,6,3,40571,40571,40574,0,3,5
11633,6,3,40577,40577,40580,0,3,3
11634,1,1,40578,40580,40581,2,3,0
11635,6,2,40584,40584,40586,0,2,3
11636,4,2,40588,40588,40590,0,2,2
11637,6,3,40594,40594,40597,0,3,4
11638,6,1,40600,40600,40601,0,1,3
11639,1,1,40601,40601,40602,0,1,0
11640,3,3,40604,40604,40607,0,3,2
11641,2,3,40606,40607,40610,1,4,0
11642,6,2,40612,40612,40614,0,2,2
11643,2,2,40614,40614,40616,0,2,0
11644,6,2,40620,40620,40622,0,2,4
11645,2,2,40622,40622,40624,0,2,0
11646,5,2,40627,40627,40629,0,2,3
11647,6,1,40633,40633,40634,0,1,4
11648,4,3,40637,40637,40640,0,3,3
11649,5,2,40642,40642,40644,0,2,2
11650,6,1,40648,40648,40649,0,1,4
11651,2,1,40650,40650,40651,0,1,1
11652,1,1,40651,40651,40652,0,1,0
11653,1,2,40652,40652,40654,0,2,0
11654,5,1,40657,40657,40658,0,1,3
11655,1,1,40658,40658,40659,0,1,0
11656,2,3,40660,40660,40663,0,3,1
11657,6,1,40666,40666,40667,0,1,3
11658,4,3,40670,40670,40673,0,3,3
11659,6,1,40676,40676,40677,0,1,3
11660,5,1,40681,40681,40682,0,1,4
11661,2,2,40683,40683,40685,0,2,1
11662,4,2,40687,40687,40689,0,2,2
11663,2,1,40689,40689,40690,0,1,0
11664,6,1,40695,40695,40696,0,1,5
11665,4,3,40699,40699,40702,0,3,3
11666,6,3,40705,40705,40708,0,3,3
11667,6,3,40711,40711,40714,0,3,3
11668,5,2,40716,40716,40718,0,2,2
11669,5,3,40721,40721,40724,0,3,3
11670,2,3,40723,40724,40727,1,4,0
11671,6,1,40729,40729,40730,0,1,2
11672,5,3,40734,40734,40737,0,3,4
11673,5,2,40739,40739,40741,0,2,2
11674,6,1,40745,40745,40746,0,1,4
11675,1,2,40746,40746,40748,0,2,0
11676,5,1,40751,40751,40752,0,1,3
11677,4,1,40755,40755,40756,0,1,3
11678,5,1,40760,40760,40761,0,1,4
11679,5,2,40765,40765,40767,0,2,4
11680,2,1,40767,40767,40768,0,1,0
11681,6,2,40773,40773,40775,0,2,5
11682,1,1,40774,40775,40776,1,2,0
11683,1,3,40775,40776,40779,1,4,0
11684,3,1,40778,40779,40780,1,2,0
11685,5,3,40783,40783,40786,0,3,3
11686,3,2,40786,40786,40788,0,2,0
11687,4,2,40790,40790,40792,0,2,2
11688,3,1,40793,40793,40794,0,1,1
11689,4,2,40797,40797,40799,0,2,3
11690,3,1,40800,40800,40801,0,1,1
11691,6,1,40806,40806,40807,0,1,5
11692,5,3,40811,40811,40814,0,3,4
11693,2,2,40813,40814,40816,1,3,0
11694,5,1,40818,40818,40819,0,1,2
11695,2,3,40820,40820,40823,0,3,1
11696,1,1,40821,40823,40824,2,3,0
11697,5,2,40826,40826,40828,0,2,2
11698,5,2,40831,40831,40833,0,2,3
11699,1,2,40832,40833,40835,1,3,0
11700,5,2,40837,40837,40839,0,2,2
11701,3,1,40840,40840,40841,0,1,1
11702,6,3,40846,40846,40849,0,3,5
11703,5,1,40851,40851,40852,0,1,2
11704,3,1,40854,40854,40855,0,1,2
11705,5,2,40859,40859,40861,0,2,4
11706,6,1,40865,40865,40866,0,1,4
11707,1,1,40866,40866,40867,0,1,0
11708,1,1,40867,40867,40868,0,1,0
11709,1,1,40868,40868,40869,0,1,0
11710,6,3,40874,40874,40877,0,3,5
11711,2,2,40876,40877,40879,1,3,0
11712,4,1,40880,40880,40881,0,1,1
11713,5,1,40885,40885,40886,0,1,4
11714,2,2,40887,40887,40889,0,2,1
11715,3,1,40890,40890,40891,0,1,1
11716,1,1,40891,40891,40892,0,1,0
11717,5,2,40896,40896,40898,0,2,4
11718,2,1,40898,40898,40899,0,1,0
11719,4,2,40902,40902,40904,0,2,3
11720,4,3,40906,40906,40909,0,3,2
11721,6,1,40912,40912,40913,0,1,3
11722,5,2,40917,40917,40919,0,2,4
11723,4,1,40921,40921,40922,0,1,2
11724,3,3,40924,40924,40927,0,3,2
11725,6,3,40930,40930,40933,0,3,3
11726,5,1,40935,40935,40936,0,1,2
11727,1,1,40936,40936,40937,0,1,0
11728,6,1,40942,40942,40943,0,1,5
11729,4,2,40946,40946,40948,0,2,3
11730,5,2,40951,40951,40953,0,2,3
11731,2,3,40953,40953,40956,0,3,0
11732,5,1,40958,40958,40959,0,1,2
11733,1,3,40959,40959,40962,0,3,0
11734,2,2,40961,40962,40964,1,3,0
11735,4,3,40965,40965,40968,0,3,1
11736,6,2,40971,40971,40973,0,2,3
11737,1,1,40972,40973,40974,1,2,0
11738,1,1,40973,40974,40975,1,2,0
11739,3,1,40976,40976,40977,0,1,1
11740,5,3,40981,40981,40984,0,3,4
11741,3,3,40984,40984,40987,0,3,0
11742,1,3,40985,40987,40990,2,5,0
11743,5,1,40990,40990,40991,0,1,0
11744,4,3,40994,40994,40997,0,3,3
11745,3,3,40997,40997,41000,0,3,0
11746,3,2,41000,41000,41002,0,2,0
11747,3,2,41003,41003,41005,0,2,1
11748,3,1,41006,41006,41007,0,1,1
11749,2,1,41008,41008,41009,0,1,1
11750,3,2,41011,41011,41013,0,2,2
11751,3,3,41014,41014,41017,0,3,1
11752,3,2,41017,41017,41019,0,2,0
11753,3,2,41020,41020,41022,0,2,1
11754,1,1,41021,41022,41023,1,2,0
11755,3,1,41024,41024,41025,0,1,1
11756,1,3,41025,41025,41028,0,3,0
11757,2,2,41027,41028,41030,1,3,0
11758,6,3,41033,41033,41036,0,3,3
11759,2,1,41035,41036,41037,1,2,0
11760,3,3,41038,41038,41041,0,3,1
11761,3,2,41041,41041,41043,0,2,0
11762,6,1,41047,41047,41048,0,1,4
11763,2,3,41049,41049,41052,0,3,1
11764,1,2,41050,41052,41054,2,4,0
11765,6,2,41056,41056,41058,0,2,2
11766,1,2,41057,41058,41060,1,3,0
11767,2,2,41059,41060,41062,1,3,0
11768,4,1,41063,41063,41064,0,1,1
11769,5,2,41068,41068,41070,0,2,4
11770,5,3,41073,41073,41076,0,3,3
11771,6,1,41079,41079,41080,0,1,3
11772,5,1,41084,41084,41085,0,1,4
11773,2,3,41086,41086,41089,0,3,1
11774,4,1,41090,41090,41091,0,1,1
11775,4,3,41094,41094,41097,0,3,3
11776,2,2,41096,41097,41099,1,3,0
11777,4,1,41100,41100,41101,0,1,1
11778,6,2,41106,41106,41108,0,2,5
11779,6,1,41112,41112,41113,0,1,4
11780,6,3,41118,41118,41121,0,3,5
11781,3,2,41121,41121,41123,0,2,0
11782,6,1,41127,41127,41128,0,1,4
11783,3,1,41130,41130,41131,0,1,2
11784,2,2,41132,41132,41134,0,2,1
11785,2,3,41134,41134,41137,0,3,0
11786,6,1,41140,41140,41141,0,1,3
11787,4,2,41144,41144,41146,0,2,3
11788,5,2,41149,41149,41151,0,2,3
11789,2,3,41151,41151,41154,0,3,0
11790,6,1,41157,41157,41158,0,1,3
11791,4,1,41161,41161,41162,0,1,3
11792,1,2,41162,41162,41164,0,2,0
11793,3,3,41165,41165,41168,0,3,1
11794,3,1,41168,41168,41169,0,1,0
11795,1,3,41169,41169,41172,0,3,0
11796,1,3,41170,41172,41175,2,5,0
11797,1,2,41171,41175,41177,4,6,0
11798,6,3,41177,41177,41180,0,3,0
11799,3,2,41180,41180,41182,0,2,0
11800,2,3,41182,41182,41185,0,3,0
11801,3,2,41185,41185,41187,0,2,0
11802,2,1,41187,41187,41188,0,1,0
11803,5,2,41192,41192,41194,0,2,4
11804,1,3,41193,41194,41197,1,4,0
11805,5,1,41198,41198,41199,0,1,1
11806,4,1,41202,41202,41203,0,1,3
11807,4,3,41206,41206,41209,0,3,3
11808,4,3,41210,41210,41213,0,3,1
11809,5,2,41215,41215,41217,0,2,2
11810,1,2,41216,41217,41219,1,3,0
11811,5,3,41221,41221,41224,0,3,2
11812,2,3,41223,41224,41227,1,4,0
11813,4,1,41227,41227,41228,0,1,0
11814,3,3,41230,41230,41233,0,3,2
11815,4,1,41234,41234,41235,0,1,1
11816,1,3,41235,41235,41238,0,3,0
11817,4,1,41239,41239,41240,0,1,1
11818,1,2,41240,41240,41242,0,2,0
11819,4,3,41244,41244,41247,0,3,2
11820,4,2,41248,41248,41250,0,2,1
11821,6,2,41254,41254,41256,0,2,4
11822,4,2,41258,41258,41260,0,2,2
11823,6,2,41264,41264,41266,0,2,4
11824,1,2,41265,41266,41268,1,3,0
11825,5,2,41270,41270,41272,0,2,2
11826,2,2,41272,41272,41274,0,2,0
11827,6,3,41278,41278,41281,0,3,4
11828,5,2,41283,41283,41285,0,2,2
11829,2,1,41285,41285,41286,0,1,0
11830,3,3,41288,41288,41291,0,3,2
11831,5,3,41293,41293,41296,0,3,2
11832,4,2,41297,41297,41299,0,2,1
11833,3,2,41300,41300,41302,0,2,1
11834,2,2,41302,41302,41304,0,2,0
11835,2,1,41304,41304,41305,0,1,0
11836,2,3,41306,41306,41309,0,3,1
11837,2,1,41308,41309,41310,1,2,0
11838,2,3,41310,41310,41313,0,3,0
11839,4,1,41314,41314,41315,0,1,1
11840,3,3,41317,41317,41320,0,3,2
11841,2,2,41319,41320,41322,1,3,0
11842,3,1,41322,41322,41323,0,1,0
11843,3,1,41325,41325,41326,0,1,2
11844,2,1,41327,41327,41328,0,1,1
11845,6,1,41333,41333,41334,0,1,5
11846,1,3,41334,41334,41337,0,3,0
11847,6,1,41340,41340,41341,0,1,3
11848,2,3,41342,41342,41345,0,3,1
11849,6,3,41348,41348,41351,0,3,3
11850,5,1,41353,41353,41354,0,1,2
11851,2,2,41355,41355,41357,0,2,1
11852,4,1,41359,41359,41360,0,1,2
11853,5,3,41364,41364,41367,0,3,4
11854,5,3,41369,41369,41372,0,3,2
11855,3,1,41372,41372,41373,0,1,0
11856,4,3,41376,41376,41379,0,3,3
11857,5,3,41381,41381,41384,0,3,2
11858,4,1,41385,41385,41386,0,1,1
11859,4,3,41389,41389,41392,0,3,3
11860,1,2,41390,41392,41394,2,4,0
11861,2,1,41392,41394,41395,2,3,0
11862,3,3,41395,41395,41398,0,3,0
11863,5,2,41400,41400,41402,0,2,2
11864,6,1,41406,41406,41407,0,1,4
11865,3,1,41409,41409,41410,0,1,2
11866,1,3,41410,41410,41413,0,3,0
11867,3,3,41413,41413,41416,0,3,0
11868,1,3,41414,41416,41419,2,5,0
11869,6,1,41420,41420,41421,0,1,1
11870,6,3,41426,41426,41429,0,3,5
11871,1,2,41427,41429,41431,2,4,0
11872,3,1,41430,41431,41432,1,2,0
11873,1,3,41431,41432,41435,1,4,0
11874,3,1,41434,41435,41436,1,2,0
11875,3,3,41437,41437,41440,0,3,1
11876,3,2,41440,41440,41442,0,2,0
11877,4,3,41444,41444,41447,0,3,2
11878,6,2,41450,41450,41452,0,2,3
11879,5,2,41455,41455,41457,0,2,3
11880,2,3,41457,41457,41460,0,3,0
11881,6,2,41463,41463,41465,0,2,3
11882,1,3,41464,41465,41468,1,4,0
11883,3,1,41467,41468,41469,1,2,0
11884,3,1,41470,41470,41471,0,1,1
11885,3,2,41473,41473,41475,0,2,2
11886,3,1,41476,41476,41477,0,1,1
11887,2,3,41478,41478,41481,0,3,1
11888,1,1,41479,41481,41482,2,3,0
11889,4,3,41483,41483,41486,0,3,1
11890,1,1,41484,41486,41487,2,3,0
11891,6,1,41490,41490,41491,0,1,3
11892,5,1,41495,41495,41496,0,1,4
11893,3,3,41498,41498,41501,0,3,2
11894,2,3,41500,41501,41504,1,4,0
11895,1,1,41501,41504,41505,3,4,0
11896,4,2,41505,41505,41507,0,2,0
11897,1,1,41506,41507,41508,1,2,0
11898,2,3,41508,41508,41511,0,3,0
11899,6,1,41514,41514,41515,0,1,3
11900,3,1,41517,41517,41518,0,1,2
11901,5,2,41522,41522,41524,0,2,4
11902,3,2,41525,41525,41527,0,2,1
11903,1,1,41526,41527,41528,1,2,0
11904,6,3,41532,41532,41535,0,3,4
11905,6,2,41538,41538,41540,0,2,3
11906,1,1,41539,41540,41541,1,2,0
11907,6,1,41545,41545,41546,0,1,4
11908,5,3,41550,41550,41553,0,3,4
11909,4,2,41554,41554,41556,0,2,1
11910,1,1,41555,41556,41557,1,2,0
11911,4,2,41559,41559,41561,0,2,2
11912,1,2,41560,41561,41563,1,3,0
11913,5,3,41565,41565,41568,0,3,2
11914,2,3,41567,41568,41571,1,4,0
11915,4,1,41571,41571,41572,0,1,0
11916,2,3,41573,41573,41576,0,3,1
11917,4,1,41577,41577,41578,0,1,1
11918,4,2,41581,41581,41583,0,2,3
11919,2,3,41583,41583,41586,0,3,0
11920,2,2,41585,41586,41588,1,3,0
11921,4,3,41589,41589,41592,0,3,1
11922,5,1,41594,41594,41595,0,1,2
11923,1,1,41595,41595,41596,0,1,0
11924,1,1,41596,41596,41597,0,1,0
11925,6,3,41602,41602,41605,0,3,5
11926,2,2,41604,41605,41607,1,3,0
11927,3,2,41607,41607,41609,0,2,0
11928,4,1,41611,41611,41612,0,1,2
11929,3,2,41614,41614,41616,0,2,2
11930,4,2,41618,41618,41620,0,2,2
11931,6,2,41624,41624,41626,0,2,4
11932,3,3,41627,41627,41630,0,3,1
11933,3,2,41630,41630,41632,0,2,0
11934,4,3,41634,41634,41637,0,3,2
11935,5,1,41639,41639,41640,0,1,2
11936,4,1,41643,41643,41644,0,1,3
11937,5,3,41648,41648,41651,0,3,4
11938,2,3,41650,41651,41654,1,4,0
11939,5,1,41655,41655,41656,0,1,1
11940,4,1,41659,41659,41660,0,1,3
11941,1,2,41660,41660,41662,0,2,0
11942,2,2,41662,41662,41664,0,2,0
11943,5,1,41667,41667,41668,0,1,3
11944,6,1,41673,41673,41674,0,1,5
11945,4,3,41677,41677,41680,0,3,3
11946,3,1,41680,41680,41681,0,1,0
11947,5,3,41685,41685,41688,0,3,4
11948,2,3,41687,41688,41691,1,4,0
11949,5,1,41692,41692,41693,0,1,1
11950,4,2,41696,41696,41698,0,2,3
11951,1,3,41697,41698,41701,1,4,0
11952,2,3,41699,41701,41704,2,5,0
11953,1,1,41700,41704,41705,4,5,0
11954,3,1,41703,41705,41706,2,3,0
11955,1,2,41704,41706,41708,2,4,0
11956,1,1,41705,41708,41709,3,4,0
11957,6,1,41711,41711,41712,0,1,2
11958,4,2,41715,41715,41717,0,2,3
11959,5,3,41720,41720,41723,0,3,3
11960,2,1,41722,41723,41724,1,2,0
11961,6,2,41728,41728,41730,0,2,4
11962,1,2,41729,41730,41732,1,3,0
11963,6,3,41735,41735,41738,0,3,3
11964,6,2,41741,41741,41743,0,2,3
11965,6,3,41747,41747,41750,0,3,4
11966,2,3,41749,41750,41753,1,4,0
11967,4,3,41753,41753,41756,0,3,0
11968,4,2,41757,41757,41759,0,2,1
11969,3,2,41760,41760,41762,0,2,1
11970,1,3,41761,41762,41765,1,4,0
11971,4,2,41765,41765,41767,0,2,0
11972,3,2,41768,41768,41770,0,2,1
11973,3,2,41771,41771,41773,0,2,1
11974,2,2,41773,41773,41775,0,2,0
11975,2,2,41775,41775,41777,0,2,0
11976,3,3,41778,41778,41781,0,3,1
11977,4,3,41782,41782,41785,0,3,1
11978,2,1,41784,41785,41786,1,2,0
11979,4,1,41788,41788,41789,0,1,2
11980,6,2,41794,41794,41796,0,2,5
11981,4,2,41798,41798,41800,0,2,2
11982,3,1,41801,41801,41802,0,1,1
11983,1,3,41802,41802,41805,0,3,0
11984,6,3,41808,41808,41811,0,3,3
11985,1,2,41809,41811,41813,2,4,0
11986,2,3,41811,41813,41816,2,5,0
11987,1,2,41812,41816,41818,4,6,0
11988,5,2,41817,41818,41820,1,3,0
11989,2,1,41819,41820,41821,1,2,0
11990,1,1,41820,41821,41822,1,2,0
11991,5,1,41825,41825,41826,0,1,3
11992,1,1,41826,41826,41827,0,1,0
11993,4,2,41830,41830,41832,0,2,3
11994,4,1,41834,41834,41835,0,1,2
11995,5,3,41839,41839,41842,0,3,4
11996,5,1,41844,41844,41845,0,1,2
11997,1,3,41845,41845,41848,0,3,0
11998,4,2,41849,41849,41851,0,2,1
11999,2,2,41851,41851,41853,0,2,0
12000,6,1,41857,41857,41858,0,1,4
12001,4,3,41861,41861,41864,0,3,3
12002,1,1,41862,41864,41865,2,3,0
12003,4,3,41866,41866,41869,0,3,1
12004,5,3,41871,41871,41874,0,3,2
12005,1,1,41872,41874,41875,2,3,0
12006,2,1,41874,41875,41876,1,2,0
12007,6,2,41880,41880,41882,0,2,4
12008,1,1,41881,41882,41883,1,2,0
12009,5,3,41886,41886,41889,0,3,3
12010,1,1,41887,41889,41890,2,3,0
12011,6,1,41893,41893,41894,0,1,3
12012,4,3,41897,41897,41900,0,3,3
12013,4,1,41901,41901,41902,0,1,1
12014,4,2,41905,41905,41907,0,2,3
12015,6,1,41911,41911,41912,0,1,4
12016,3,1,41914,41914,41915,0,1,2
12017,5,2,41919,41919,41921,0,2,4
12018,6,2,41925,41925,41927,0,2,4
12019,1,1,41926,41927,41928,1,2,0
12020,5,3,41931,41931,41934,0,3,3
12021,4,2,41935,41935,41937,0,2,1
12022,6,1,41941,41941,41942,0,1,4
12023,3,2,41944,41944,41946,0,2,2
12024,4,2,41948,41948,41950,0,2,2
12025,4,1,41952,41952,41953,0,1,2
12026,4,3,41956,41956,41959,0,3,3
12027,2,1,41958,41959,41960,1,2,0
12028,6,2,41964,41964,41966,0,2,4
12029,3,2,41967,41967,41969,0,2,1
12030,6,3,41973,41973,41976,0,3,4
12031,6,1,41979,41979,41980,0,1,3
12032,6,2,41985,41985,41987,0,2,5
12033,2,3,41987,41987,41990,0,3,0
12034,6,3,41993,41993,41996,0,3,3
12035,4,3,41997,41997,42000,0,3,1
12036,5,1,42002,42002,42003,0,1,2
12037,4,3,42006,42006,42009,0,3,3
12038,1,2,42007,42009,42011,2,4,0
12039,2,1,42009,42011,42012,2,3,0
12040,2,2,42011,42012,42014,1,3,0
12041,5,1,42016,42016,42017,0,1,2
12042,5,3,42021,42021,42024,0,3,4
12043,3,1,42024,42024,42025,0,1,0
12044,5,1,42029,42029,42030,0,1,4
12045,3,3,42032,42032,42035,0,3,2
12046,6,1,42038,42038,42039,0,1,3
12047,4,2,42042,42042,42044,0,2,3
12048,3,1,42045,42045,42046,0,1,1
12049,5,2,42050,42050,42052,0,2,4
12050,2,3,42052,42052,42055,0,3,0
12051,4,2,42056,42056,42058,0,2,1
12052,1,1,42057,42058,42059,1,2,0
12053,3,3,42060,42060,42063,0,3,1
12054,1,1,42061,42063,42064,2,3,0
12055,2,3,42063,42064,42067,1,4,0
12056,4,1,42067,42067,42068,0,1,0
12057,2,2,42069,42069,42071,0,2,1
12058,6,2,42075,42075,42077,0,2,4
12059,1,3,42076,42077,42080,1,4,0
12060,2,1,42078,42080,42081,2,3,0
12061,4,1,42082,42082,42083,0,1,1
12062,5,3,42087,42087,42090,0,3,4
12063,1,2,42088,42090,42092,2,4,0
12064,4,1,42092,42092,42093,0,1,0
12065,3,3,42095,42095,42098,0,3,2
12066,1,2,42096,42098,42100,2,4,0
12067,4,2,42100,42100,42102,0,2,0
12068,3,1,42103,42103,42104,0,1,1
12069,6,3,42109,42109,42112,0,3,5
12070,6,3,42115,42115,42118,0,3,3
12071,2,3,42117,42118,42121,1,4,0
12072,5,3,42122,42122,42125,0,3,1
12073,5,2,42127,42127,42129,0,2,2
12074,3,3,42130,42130,42133,0,3,1
12075,4,2,42134,42134,42136,0,2,1
12076,3,3,42137,42137,42140,0,3,1
12077,1,1,42138,42140,42141,2,3,0
12078,3,2,42141,42141,42143,0,2,0
12079,1,1,42142,42143,42144,1,2,0
12080,4,2,42146,42146,42148,0,2,2
12081,3,1,42149,42149,42150,0,1,1
12082,6,3,42155,42155,42158,0,3,5
12083,6,3,42161,42161,42164,0,3,3
12084,6,3,42167,42167,42170,0,3,3
12085,4,2,42171,42171,42173,0,2,1
12086,4,1,42175,42175,42176,0,1,2
12087,6,3,42181,42181,42184,0,3,5
12088,3,1,42184,42184,42185,0,1,0
12089,1,3,42185,42185,42188,0,3,0
12090,2,1,42187,42188,42189,1,2,0
12091,1,3,42188,42189,42192,1,4,0
12092,1,3,42189,42192,42195,3,6,0
12093,5,2,42194,42195,42197,1,3,0
12094,4,3,42198,42198,42201,0,3,1
12095,4,3,42202,42202,42205,0,3,1
12096,1,1,42203,42205,42206,2,3,0
12097,2,2,42205,42206,42208,1,3,0
12098,1,1,42206,42208,42209,2,3,0
12099,3,2,42209,42209,42211,0,2,0
12100,6,2,42215,42215,42217,0,2,4
12101,3,3,42218,42218,42221,0,3,1
12102,2,1,42220,42221,42222,1,2,0
12103,4,3,42224,42224,42227,0,3,2
12104,1,3,42225,42227,42230,2,5,0
12105,4,3,42229,42230,42233,1,4,0
12106,3,1,42232,42233,42234,1,2,0
12107,5,1,42237,42237,42238,0,1,3
12108,2,2,42239,42239,42241,0,2,1
12109,2,3,42241,42241,42244,0,3,0
12110,1,2,42242,42244,42246,2,4,0
12111,5,3,42247,42247,42250,0,3,1
12112,1,2,42248,42250,42252,2,4,0
12113,2,2,42250,42252,42254,2,4,0
12114,1,1,42251,42254,42255,3,4,0
12115,6,3,42257,42257,42260,0,3,2
12116,2,2,42259,42260,42262,1,3,0
12117,6,3,42265,42265,42268,0,3,3
12118,6,1,42271,42271,42272,0,1,3
12119,5,2,42276,42276,42278,0,2,4
12120,5,2,42281,42281,42283,0,2,3
12121,2,2,42283,42283,42285,0,2,0
12122,6,1,42289,42289,42290,0,1,4
12123,4,1,42293,42293,42294,0,1,3
12124,4,2,42297,42297,42299,0,2,3
12125,2,1,42299,42299,42300,0,1,0
12126,4,1,42303,42303,42304,0,1,3
12127,1,3,42304,42304,42307,0,3,0
12128,6,2,42310,42310,42312,0,2,3
12129,4,1,42314,42314,42315,0,1,2
12130,6,3,42320,42320,42323,0,3,5
12131,1,3,42321,42323,42326,2,5,0
12132,3,1,42324,42326,42327,2,3,0
12133,4,1,42328,42328,42329,0,1,1
12134,4,1,42332,42332,42333,0,1,3
12135,2,3,42334,42334,42337,0,3,1
12136,1,1,42335,42337,42338,2,3,0
12137,5,1,42340,42340,42341,0,1,2
12138,4,2,42344,42344,42346,0,2,3
12139,5,1,42349,42349,42350,0,1,3
12140,1,3,42350,42350,42353,0,3,0
12141,4,2,42354,42354,42356,0,2,1
12142,3,2,42357,42357,42359,0,2,1
12143,3,1,42360,42360,42361,0,1,1
12144,1,1,42361,42361,42362,0,1,0
12145,5,1,42366,42366,42367,0,1,4
12146,6,2,42372,42372,42374,0,2,5
12147,6,3,42378,42378,42381,0,3,4
12148,4,1,42382,42382,42383,0,1,1
12149,2,1,42384,42384,42385,0,1,1
12150,1,2,42385,42385,42387,0,2,0
12151,1,1,42386,42387,42388,1,2,0
12152,6,1,42392,42392,42393,0,1,4
12153,5,1,42397,42397,42398,0,1,4
12154,6,2,42403,42403,42405,0,2,5
12155,6,1,42409,42409,42410,0,1,4
12156,5,2,42414,42414,42416,0,2,4
12157,3,1,42417,42417,42418,0,1,1
12158,3,2,42420,42420,42422,0,2,2
12159,3,1,42423,42423,42424,0,1,1
12160,5,3,42428,42428,42431,0,3,4
12161,3,1,42431,42431,42432,0,1,0
12162,6,2,42437,42437,42439,0,2,5
12163,5,1,42442,42442,42443,0,1,3
12164,6,1,42448,42448,42449,0,1,5
12165,5,1,42453,42453,42454,0,1,4
12166,1,1,42454,42454,42455,0,1,0
12167,1,2,42455,42455,42457,0,2,0
12168,6,2,42461,42461,42463,0,2,4
12169,5,2,42466,42466,42468,0,2,3
12170,5,1,42471,42471,42472,0,1,3
12171,3,3,42474,42474,42477,0,3,2
12172,3,1,42477,42477,42478,0,1,0
12173,4,1,42481,42481,42482,0,1,3
12174,5,3,42486,42486,42489,0,3,4
12175,6,2,42492,42492,42494,0,2,3
12176,6,3,42498,42498,42501,0,3,4
12177,6,2,42504,42504,42506,0,2,3
12178,5,3,42509,42509,42512,0,3,3
12179,2,3,42511,42512,42515,1,4,0
12180,6,2,42517,42517,42519,0,2,2
12181,2,2,42519,42519,42521,0,2,0
12182,1,3,42520,42521,42524,1,4,0
12183,4,3,42524,42524,42527,0,3,0
12184,3,1,42527,42527,42528,0,1,0
12185,2,1,42529,42529,42530,0,1,1
12186,4,3,42533,42533,42536,0,3,3
12187,3,2,42536,42536,42538,0,2,0
12188,1,3,42537,42538,42541,1,4,0
12189,4,1,42541,42541,42542,0,1,0
12190,6,3,42547,42547,42550,0,3,5
12191,1,1,42548,42550,42551,2,3,0
12192,5,3,42553,42553,42556,0,3,2
12193,3,1,42556,42556,42557,0,1,0
12194,1,1,42557,42557,42558,0,1,0
12195,3,2,42560,42560,42562,0,2,2
12196,5,1,42565,42565,42566,0,1,3
12197,4,2,42569,42569,42571,0,2,3
12198,4,1,42573,42573,42574,0,1,2
12199,3,2,42576,42576,42578,0,2,2
12200,6,3,42582,42582,42585,0,3,4
12201,1,3,42583,42585,42588,2,5,0
12202,4,3,42587,42588,42591,1,4,0
12203,5,1,42592,42592,42593,0,1,1
12204,6,3,42598,42598,42601,0,3,5
12205,1,2,42599,42601,42603,2,4,0
12206,5,3,42604,42604,42607,0,3,1
12207,2,1,42606,42607,42608,1,2,0
12208,1,3,42607,42608,42611,1,4,0
12209,5,3,42612,42612,42615,0,3,1
12210,4,3,42616,42616,42619,0,3,1
12211,6,3,42622,42622,42625,0,3,3
12212,4,1,42626,42626,42627,0,1,1
12213,4,2,42630,42630,42632,0,2,3
12214,2,1,42632,42632,42633,0,1,0
12215,5,2,42637,42637,42639,0,2,4
12216,1,2,42638,42639,42641,1,3,0
12217,2,1,42640,42641,42642,1,2,0
12218,1,2,42641,42642,42644,1,3,0
12219,4,3,42645,42645,42648,0,3,1
12220,3,2,42648,42648,42650,0,2,0
12221,1,1,42649,42650,42651,1,2,0
12222,6,3,42655,42655,42658,0,3,4
12223,2,3,42657,42658,42661,1,4,0
12224,3,1,42660,42661,42662,1,2,0
12225,3,3,42663,42663,42666,0,3,1
12226,5,3,42668,42668,42671,0,3,2
12227,6,2,42674,42674,42676,0,2,3
12228,2,1,42676,42676,42677,0,1,0
12229,4,1,42680,42680,42681,0,1,3
12230,5,2,42685,42685,42687,0,2,4
12231,3,1,42688,42688,42689,0,1,1
12232,3,3,42691,42691,42694,0,3,2
12233,5,1,42696,42696,42697,0,1,2
12234,2,3,42698,42698,42701,0,3,1
12235,5,1,42703,42703,42704,0,1,2
12236,5,3,42708,42708,42711,0,3,4
12237,1,1,42709,42711,42712,2,3,0
12238,3,1,42712,42712,42713,0,1,0
12239,5,3,42717,42717,42720,0,3,4
12240,3,1,42720,42720,42721,0,1,0
12241,4,2,42724,42724,42726,0,2,3
12242,3,1,42727,42727,42728,0,1,1
12243,6,1,42733,42733,42734,0,1,5
12244,2,3,42735,42735,42738,0,3,1
12245,2,3,42737,42738,42741,1,4,0
12246,4,2,42741,42741,42743,0,2,0
12247,1,3,42742,42743,42746,1,4,0
12248,3,3,42745,42746,42749,1,4,0
12249,2,1,42747,42749,42750,2,3,0
12250,1,2,42748,42750,42752,2,4,0
12251,3,1,42751,42752,42753,1,2,0
12252,4,3,42755,42755,42758,0,3,2
12253,3,2,42758,42758,42760,0,2,0
12254,4,2,42762,42762,42764,0,2,2
12255,1,1,42763,42764,42765,1,2,0
12256,1,3,42764,42765,42768,1,4,0
12257,2,3,42766,42768,42771,2,5,0
12258,6,2,42772,42772,42774,0,2,1
12259,2,1,42774,42774,42775,0,1,0
12260,5,2,42779,42779,42781,0,2,4
12261,1,3,42780,42781,42784,1,4,0
12262,6,1,42786,42786,42787,0,1,2
12263,2,3,42788,42788,42791,0,3,1
12264,5,3,42793,42793,42796,0,3,2
12265,3,3,42796,42796,42799,0,3,0
12266,3,2,42799,42799,42801,0,2,0
12267,2,2,42801,42801,42803,0,2,0
12268,6,2,42807,42807,42809,0,2,4
12269,1,1,42808,42809,42810,1,2,0
12270,2,2,42810,42810,42812,0,2,0
12271,4,2,42814,42814,42816,0,2,2
12272,2,3,42816,42816,42819,0,3,0
12273,6,3,42822,42822,42825,0,3,3
12274,6,1,42828,42828,42829,0,1,3
12275,2,2,42830,42830,42832,0,2,1
12276,4,2,42834,42834,42836,0,2,2
12277,3,2,42837,42837,42839,0,2,1
12278,3,1,42840,42840,42841,0,1,1
12279,2,2,42842,42842,42844,0,2,1
12280,3,3,42845,42845,42848,0,3,1
12281,5,1,42850,42850,42851,0,1,2
12282,5,3,42855,42855,42858,0,3,4
12283,1,3,42856,42858,42861,2,5,0
12284,3,2,42859,42861,42863,2,4,0
12285,2,1,42861,42863,42864,2,3,0
12286,1,1,42862,42864,42865,2,3,0
12287,6,1,42868,42868,42869,0,1,3
12288,1,1,42869,42869,42870,0,1,0
12289,3,1,42872,42872,42873,0,1,2
12290,1,1,42873,42873,42874,0,1,0
12291,6,1,42879,42879,42880,0,1,5
12292,2,1,42881,42881,42882,0,1,1
12293,6,3,42887,42887,42890,0,3,5
12294,5,3,42892,42892,42895,0,3,2
12295,2,3,42894,42895,42898,1,4,0
12296,2,2,42896,42898,42900,2,4,0
12297,2,3,42898,42900,42903,2,5,0
12298,1,1,42899,42903,42904,4,5,0
12299,1,2,42900,42904,42906,4,6,0
12300,1,1,42901,42906,42907,5,6,0
12301,2,3,42903,42907,42910,4,7,0
12302,5,1,42908,42910,42911,2,3,0
12303,1,1,42909,42911,42912,2,3,0
12304,1,2,42910,42912,42914,2,4,0
12305,2,3,42912,42914,42917,2,5,0
12306,4,1,42916,42917,42918,1,2,0
12307,1,3,42917,42918,42921,1,4,0
12308,6,2,42923,42923,42925,0,2,2
12309,3,1,42926,42926,42927,0,1,1
12310,4,3,42930,42930,42933,0,3,3
12311,5,1,42935,42935,42936,0,1,2
12312,5,2,42940,42940,42942,0,2,4
12313,2,1,42942,42942,42943,0,1,0
12314,6,3,42948,42948,42951,0,3,5
12315,4,3,42952,42952,42955,0,3,1
12316,2,3,42954,42955,42958,1,4,0
12317,4,2,42958,42958,42960,0,2,0
12318,3,2,42961,42961,42963,0,2,1
12319,3,1,42964,42964,42965,0,1,1
12320,5,3,42969,42969,42972,0,3,4
12321,2,2,42971,42972,42974,1,3,0
12322,3,2,42974,42974,42976,0,2,0
12323,6,1,42980,42980,42981,0,1,4
12324,2,3,42982,42982,42985,0,3,1
12325,4,1,42986,42986,42987,0,1,1
12326,6,3,42992,42992,42995,0,3,5
12327,2,2,42994,42995,42997,1,3,0
12328,3,1,42997,42997,42998,0,1,0
12329,5,1,43002,43002,43003,0,1,4
12330,2,3,43004,43004,43007,0,3,1
12331,6,2,43010,43010,43012,0,2,3
12332,5,1,43015,43015,43016,0,1,3
12333,5,2,43020,43020,43022,0,2,4
12334,6,1,43026,43026,43027,0,1,4
12335,4,1,43030,43030,43031,0,1,3
12336,3,3,43033,43033,43036,0,3,2
12337,1,2,43034,43036,43038,2,4,0
12338,4,1,43038,43038,43039,0,1,0
12339,2,1,43040,43040,43041,0,1,1
12340,5,3,43045,43045,43048,0,3,4
12341,3,2,43048,43048,43050,0,2,0
12342,2,3,43050,43050,43053,0,3,0
12343,1,3,43051,43053,43056,2,5,0
12344,1,3,43052,43056,43059,4,7,0
12345,5,1,43057,43059,43060,2,3,0
12346,6,3,43063,43063,43066,0,3,3
12347,2,3,43065,43066,43069,1,4,0
12348,1,1,43066,43069,43070,3,4,0
12349,2,3,43068,43070,43073,2,5,0
12350,3,3,43071,43073,43076,2,5,0
12351,1,2,43072,43076,43078,4,6,0
12352,3,3,43075,43078,43081,3,6,0
12353,3,3,43078,43081,43084,3,6,0
12354,2,3,43080,43084,43087,4,7,0
12355,6,2,43086,43087,43089,1,3,0
12356,2,1,43088,43089,43090,1,2,0
12357,6,2,43094,43094,43096,0,2,4
12358,2,3,43096,43096,43099,0,3,0
12359,3,2,43099,43099,43101,0,2,0
12360,1,3,43100,43101,43104,1,4,0
12361,3,3,43103,43104,43107,1,4,0
12362,2,3,43105,43107,43110,2,5,0
12363,3,1,43108,43110,43111,2,3,0
12364,4,1,43112,43112,43113,0,1,1
12365,1,1,43113,43113,43114,0,1,0
12366,1,1,43114,43114,43115,0,1,0
12367,3,1,43117,43117,43118,0,1,2
12368,4,1,43121,43121,43122,0,1,3
12369,6,1,43127,43127,43128,0,1,5
12370,4,1,43131,43131,43132,0,1,3
12371,3,1,43134,43134,43135,0,1,2
12372,3,3,43137,43137,43140,0,3,2
12373,4,3,43141,43141,43144,0,3,1
12374,4,2,43145,43145,43147,0,2,1
12375,1,3,43146,43147,43150,1,4,0
12376,2,3,43148,43150,43153,2,5,0
12377,4,2,43152,43153,43155,1,3,0
12378,5,1,43157,43157,43158,0,1,2
12379,5,3,43162,43162,43165,0,3,4
12380,5,2,43167,43167,43169,0,2,2
12381,5,1,43172,43172,43173,0,1,3
12382,2,2,43174,43174,43176,0,2,1
12383,5,1,43179,43179,43180,0,1,3
12384,3,2,43182,43182,43184,0,2,2
12385,1,2,43183,43184,43186,1,3,0
12386,3,3,43186,43186,43189,0,3,0
12387,6,2,43192,43192,43194,0,2,3
12388,5,2,43197,43197,43199,0,2,3
12389,3,2,43200,43200,43202,0,2,1
12390,6,2,43206,43206,43208,0,2,4
12391,6,3,43212,43212,43215,0,3,4
12392,5,1,43217,43217,43218,0,1,2
12393,1,3,43218,43218,43221,0,3,0
12394,5,3,43223,43223,43226,0,3,2
12395,1,1,43224,43226,43227,2,3,0
12396,2,2,43226,43227,43229,1,3,0
12397,3,3,43229,43229,43232,0,3,0
12398,2,2,43231,43232,43234,1,3,0
12399,2,1,43233,43234,43235,1,2,0
12400,6,3,43239,43239,43242,0,3,4
12401,2,1,43241,43242,43243,1,2,0
12402,2,2,43243,43243,43245,0,2,0
12403,1,1,43244,43245,43246,1,2,0
12404,2,3,43246,43246,43249,0,3,0
12405,2,3,43248,43249,43252,1,4,0
12406,4,2,43252,43252,43254,0,2,0
12407,5,1,43257,43257,43258,0,1,3
12408,4,3,43261,43261,43264,0,3,3
12409,6,1,43267,43267,43268,0,1,3
12410,3,1,43270,43270,43271,0,1,2
12411,6,2,43276,43276,43278,0,2,5
12412,1,2,43277,43278,43280,1,3,0
12413,6,3,43283,43283,43286,0,3,3
12414,5,2,43288,43288,43290,0,2,2
12415,2,2,43290,43290,43292,0,2,0
12416,3,1,43293,43293,43294,0,1,1
12417,2,1,43295,43295,43296,0,1,1
12418,4,1,43299,43299,43300,0,1,3
12419,6,3,43305,43305,43308,0,3,5
12420,4,1,43309,43309,43310,0,1,1
12421,1,1,43310,43310,43311,0,1,0
12422,1,1,43311,43311,43312,0,1,0
12423,3,1,43314,43314,43315,0,1,2
12424,5,3,43319,43319,43322,0,3,4
12425,2,1,43321,43322,43323,1,2,0
12426,1,1,43322,43323,43324,1,2,0
12427,1,2,43323,43324,43326,1,3,0
12428,2,3,43325,43326,43329,1,4,0
12429,3,1,43328,43329,43330,1,2,0
12430,3,2,43331,43331,43333,0,2,1
12431,5,2,43336,43336,43338,0,2,3
12432,1,3,43337,43338,43341,1,4,0
12433,3,2,43340,43341,43343,1,3,0
12434,3,3,43343,43343,43346,0,3,0
12435,3,2,43346,43346,43348,0,2,0
12436,3,2,43349,43349,43351,0,2,1
12437,4,2,43353,43353,43355,0,2,2
12438,2,3,43355,43355,43358,0,3,0
12439,4,2,43359,43359,43361,0,2,1
12440,1,3,43360,43361,43364,1,4,0
12441,4,1,43364,43364,43365,0,1,0
12442,3,1,43367,43367,43368,0,1,2
12443,5,3,43372,43372,43375,0,3,4
12444,1,3,43373,43375,43378,2,5,0
12445,3,3,43376,43378,43381,2,5,0
12446,3,1,43379,43381,43382,2,3,0
12447,2,1,43381,43382,43383,1,2,0
12448,4,1,43385,43385,43386,0,1,2
12449,4,1,43389,43389,43390,0,1,3
12450,1,1,43390,43390,43391,0,1,0
12451,3,1,43393,43393,43394,0,1,2
12452,4,1,43397,43397,43398,0,1,3
12453,5,2,43402,43402,43404,0,2,4
12454,5,2,43407,43407,43409,0,2,3
12455,1,3,43408,43409,43412,1,4,0
12456,3,1,43411,43412,43413,1,2,0
12457,2,3,43413,43413,43416,0,3,0
12458,6,3,43419,43419,43422,0,3,3
12459,3,1,43422,43422,43423,0,1,0
12460,4,3,43426,43426,43429,0,3,3
12461,1,1,43427,43429,43430,2,3,0
12462,3,2,43430,43430,43432,0,2,0
12463,4,3,43434,43434,43437,0,3,2
12464,5,1,43439,43439,43440,0,1,2
12465,2,1,43441,43441,43442,0,1,1
12466,1,1,43442,43442,43443,0,1,0
12467,6,3,43448,43448,43451,0,3,5
12468,6,1,43454,43454,43455,0,1,3
12469,5,3,43459,43459,43462,0,3,4
12470,1,1,43460,43462,43463,2,3,0
12471,2,1,43462,43463,43464,1,2,0
12472,1,2,43463,43464,43466,1,3,0
12473,5,2,43468,43468,43470,0,2,2
12474,1,3,43469,43470,43473,1,4,0
12475,2,1,43471,43473,43474,2,3,0
12476,6,3,43477,43477,43480,0,3,3
12477,1,1,43478,43480,43481,2,3,0
12478,5,1,43483,43483,43484,0,1,2
12479,5,2,43488,43488,43490,0,2,4
12480,2,1,43490,43490,43491,0,1,0
12481,3,2,43493,43493,43495,0,2,2
12482,3,3,43496,43496,43499,0,3,1
12483,1,3,43497,43499,43502,2,5,0
12484,5,1,43502,43502,43503,0,1,0
12485,5,3,43507,43507,43510,0,3,4
12486,3,3,43510,43510,43513,0,3,0
12487,5,2,43515,43515,43517,0,2,2
12488,2,1,43517,43517,43518,0,1,0
12489,1,2,43518,43518,43520,0,2,0
12490,3,2,43521,43521,43523,0,2,1
12491,1,1,43522,43523,43524,1,2,0
12492,1,2,43523,43524,43526,1,3,0
12493,5,2,43528,43528,43530,0,2,2
12494,5,1,43533,43533,43534,0,1,3
12495,5,2,43538,43538,43540,0,2,4
12496,2,3,43540,43540,43543,0,3,0
12497,2,1,43542,43543,43544,1,2,0
12498,6,2,43548,43548,43550,0,2,4
12499,6,1,43554,43554,43555,0,1,4
12500,5,1,43559,43559,43560,0,1,4
12501,1,3,43560,43560,43563,0,3,0
12502,6,2,43566,43566,43568,0,2,3
12503,5,2,43571,43571,43573,0,2,3
12504,2,1,43573,43573,43574,0,1,0
12505,4,2,43577,43577,43579,0,2,3
12506,6,2,43583,43583,43585,0,2,4
12507,4,3,43587,43587,43590,0,3,2
12508,2,2,43589,43590,43592,1,3,0
12509,6,1,43595,43595,43596,0,1,3
12510,2,2,43597,43597,43599,0,2,1
12511,5,2,43602,43602,43604,0,2,3
12512,5,2,43607,43607,43609,0,2,3
12513,1,1,43608,43609,43610,1,2,0
12514,2,3,43610,43610,43613,0,3,0
12515,4,2,43614,43614,43616,0,2,1
12516,4,1,43618,43618,43619,0,1,2
12517,1,1,43619,43619,43620,0,1,0
12518,2,3,43621,43621,43624,0,3,1
12519,4,1,43625,43625,43626,0,1,1
12520,6,2,43631,43631,43633,0,2,5
12521,4,1,43635,43635,43636,0,1,2
12522,4,1,43639,43639,43640,0,1,3
12523,5,1,43644,43644,43645,0,1,4
12524,4,2,43648,43648,43650,0,2,3
12525,1,2,43649,43650,43652,1,3,0
12526,4,2,43653,43653,43655,0,2,1
12527,5,3,43658,43658,43661,0,3,3
12528,2,1,43660,43661,43662,1,2,0
12529,2,3,43662,43662,43665,0,3,0
12530,1,1,43663,43665,43666,2,3,0
12531,2,2,43665,43666,43668,1,3,0
12532,2,2,43667,43668,43670,1,3,0
12533,6,3,43673,43673,43676,0,3,3
12534,4,1,43677,43677,43678,0,1,1
12535,5,2,43682,43682,43684,0,2,4
12536,5,1,43687,43687,43688,0,1,3
12537,6,2,43693,43693,43695,0,2,5
12538,4,3,43697,43697,43700,0,3,2
12539,6,1,43703,43703,43704,0,1,3
12540,1,3,43704,43704,43707,0,3,0
12541,4,1,43708,43708,43709,0,1,1
12542,2,2,43710,43710,43712,0,2,1
12543,1,1,43711,43712,43713,1,2,0
12544,4,1,43715,43715,43716,0,1,2
12545,1,3,43716,43716,43719,0,3,0
12546,4,1,43720,43720,43721,0,1,1
12547,6,3,43726,43726,43729,0,3,5
12548,3,2,43729,43729,43731,0,2,0
12549,3,1,43732,43732,43733,0,1,1
12550,1,1,43733,43733,43734,0,1,0
12551,4,2,43737,43737,43739,0,2,3
12552,2,2,43739,43739,43741,0,2,0
12553,3,3,43742,43742,43745,0,3,1
12554,5,1,43747,43747,43748,0,1,2
12555,1,3,43748,43748,43751,0,3,0
12556,6,2,43754,43754,43756,0,2,3
12557,2,2,43756,43756,43758,0,2,0
12558,6,2,43762,43762,43764,0,2,4
12559,2,3,43764,43764,43767,0,3,0
12560,4,2,43768,43768,43770,0,2,1
12561,5,1,43773,43773,43774,0,1,3
12562,2,3,43775,43775,43778,0,3,1
12563,2,3,43777,43778,43781,1,4,0
12564,6,1,43783,43783,43784,0,1,2
12565,3,2,43786,43786,43788,0,2,2
12566,4,1,43790,43790,43791,0,1,2
12567,6,1,43796,43796,43797,0,1,5
12568,4,3,43800,43800,43803,0,3,3
12569,3,2,43803,43803,43805,0,2,0
12570,5,3,43808,43808,43811,0,3,3
12571,1,1,43809,43811,43812,2,3,0
12572,2,1,43811,43812,43813,1,2,0
12573,4,3,43815,43815,43818,0,3,2
12574,6,3,43821,43821,43824,0,3,3
12575,6,1,43827,43827,43828,0,1,3
12576,3,3,43830,43830,43833,0,3,2
12577,6,3,43836,43836,43839,0,3,3
12578,1,3,43837,43839,43842,2,5,0
12579,5,3,43842,43842,43845,0,3,0
12580,6,3,43848,43848,43851,0,3,3
12581,2,3,43850,43851,43854,1,4,0
12582,5,1,43855,43855,43856,0,1,1
12583,5,3,43860,43860,43863,0,3,4
12584,1,1,43861,43863,43864,2,3,0
12585,1,1,43862,43864,43865,2,3,0
12586,1,2,43863,43865,43867,2,4,0
12587,3,3,43866,43867,43870,1,4,0
12588,1,2,43867,43870,43872,3,5,0
12589,2,2,43869,43872,43874,3,5,0
12590,1,3,43870,43874,43877,4,7,0
12591,6,1,43876,43877,43878,1,2,0
12592,1,3,43877,43878,43881,1,4,0
12593,4,3,43881,43881,43884,0,3,0
12594,6,1,43887,43887,43888,0,1,3
12595,3,1,43890,43890,43891,0,1,2
12596,1,1,43891,43891,43892,0,1,0
12597,4,3,43895,43895,43898,0,3,3
12598,2,2,43897,43898,43900,1,3,0
12599,6,2,43903,43903,43905,0,2,3
12600,6,1,43909,43909,43910,0,1,4
12601,5,3,43914,43914,43917,0,3,4
12602,2,2,43916,43917,43919,1,3,0
12603,3,3,43919,43919,43922,0,3,0
12604,4,3,43923,43923,43926,0,3,1
12605,3,1,43926,43926,43927,0,1,0
12606,3,3,43929,43929,43932,0,3,2
12607,2,2,43931,43932,43934,1,3,0
12608,2,2,43933,43934,43936,1,3,0
12609,3,2,43936,43936,43938,0,2,0
12610,6,1,43942,43942,43943,0,1,4
12611,2,2,43944,43944,43946,0,2,1
12612,1,1,43945,43946,43947,1,2,0
12613,5,3,43950,43950,43953,0,3,3
12614,6,1,43956,43956,43957,0,1,3
12615,3,2,43959,43959,43961,0,2,2
12616,1,2,43960,43961,43963,1,3,0
12617,1,2,43961,43963,43965,2,4,0
12618,6,2,43967,43967,43969,0,2,2
12619,5,3,43972,43972,43975,0,3,3
12620,3,1,43975,43975,43976,0,1,0
12621,3,1,43978,43978,43979,0,1,2
12622,4,3,43982,43982,43985,0,3,3
12623,1,3,43983,43985,43988,2,5,0
12624,5,1,43988,43988,43989,0,1,0
12625,2,2,43990,43990,43992,0,2,1
12626,2,2,43992,43992,43994,0,2,0
12627,6,2,43998,43998,44000,0,2,4
12628,4,1,44002,44002,44003,0,1,2
12629,5,1,44007,44007,44008,0,1,4
12630,1,2,44008,44008,44010,0,2,0
12631,1,1,44009,44010,44011,1,2,0
12632,1,3,44010,44011,44014,1,4,0
12633,6,2,44016,44016,44018,0,2,2
12634,1,3,44017,44018,44021,1,4,0
12635,6,3,44023,44023,44026,0,3,2
12636,1,1,44024,44026,44027,2,3,0
12637,1,2,44025,44027,44029,2,4,0
12638,4,2,44029,44029,44031,0,2,0
12639,6,2,44035,44035,44037,0,2,4
12640,3,3,44038,44038,44041,0,3,1
12641,4,2,44042,44042,44044,0,2,1
12642,2,2,44044,44044,44046,0,2,0
12643,6,2,44050,44050,44052,0,2,4
12644,2,2,44052,44052,44054,0,2,0
12645,1,1,44053,44054,44055,1,2,0
12646,1,1,44054,44055,44056,1,2,0
12647,6,3,44060,44060,44063,0,3,4
12648,6,3,44066,44066,44069,0,3,3
12649,1,3,44067,44069,44072,2,5,0
12650,1,2,44068,44072,44074,4,6,0
12651,4,1,44072,44074,44075,2,3,0
12652,6,3,44078,44078,44081,0,3,3
12653,5,1,44083,44083,44084,0,1,2
12654,3,1,44086,44086,44087,0,1,2
12655,4,1,44090,44090,44091,0,1,3
12656,5,2,44095,44095,44097,0,2,4
12657,6,1,44101,44101,44102,0,1,4
12658,1,1,44102,44102,44103,0,1,0
12659,6,2,44108,44108,44110,0,2,5
12660,1,2,44109,44110,44112,1,3,0
12661,2,1,44111,44112,44113,1,2,0
12662,6,2,44117,44117,44119,0,2,4
12663,2,3,44119,44119,44122,0,3,0
12664,5,2,44124,44124,44126,0,2,2
12665,3,1,44127,44127,44128,0,1,1
12666,2,1,44129,44129,44130,0,1,1
12667,2,3,44131,44131,44134,0,3,1
12668,4,3,44135,44135,44138,0,3,1
12669,3,2,44138,44138,44140,0,2,0
12670,2,3,44140,44140,44143,0,3,0
12671,3,3,44143,44143,44146,0,3,0
12672,4,2,44147,44147,44149,0,2,1
12673,4,1,44151,44151,44152,0,1,2
12674,5,1,44156,44156,44157,0,1,4
12675,6,3,44162,44162,44165,0,3,5
12676,6,1,44168,44168,44169,0,1,3
12677,5,3,44173,44173,44176,0,3,4
12678,5,3,44178,44178,44181,0,3,2
12679,6,1,44184,44184,44185,0,1,3
12680,1,2,44185,44185,44187,0,2,0
12681,2,2,44187,44187,44189,0,2,0
12682,1,1,44188,44189,44190,1,2,0
12683,6,2,44194,44194,44196,0,2,4
12684,1,1,44195,44196,44197,1,2,0
12685,3,2,44198,44198,44200,0,2,1
12686,4,1,44202,44202,44203,0,1,2
12687,5,1,44207,44207,44208,0,1,4
12688,6,2,44213,44213,44215,0,2,5
12689,3,2,44216,44216,44218,0,2,1
12690,5,1,44221,44221,44222,0,1,3
12691,3,3,44224,44224,44227,0,3,2
12692,3,3,44227,44227,44230,0,3,0
12693,6,1,44233,44233,44234,0,1,3
12694,4,1,44237,44237,44238,0,1,3
12695,1,2,44238,44238,44240,0,2,0
12696,3,3,44241,44241,44244,0,3,1
12697,4,2,44245,44245,44247,0,2,1
12698,2,1,44247,44247,44248,0,1,0
12699,6,2,44253,44253,44255,0,2,5
12700,2,2,44255,44255,44257,0,2,0
12701,6,3,44261,44261,44264,0,3,4
12702,2,1,44263,44264,44265,1,2,0
12703,6,2,44269,44269,44271,0,2,4
12704,2,2,44271,44271,44273,0,2,0
12705,2,3,44273,44273,44276,0,3,0
12706,5,3,44278,44278,44281,0,3,2
12707,1,3,44279,44281,44284,2,5,0
12708,2,1,44281,44284,44285,3,4,0
12709,1,2,44282,44285,44287,3,5,0
12710,1,2,44283,44287,44289,4,6,0
12711,6,2,44289,44289,44291,0,2,0
12712,4,1,44293,44293,44294,0,1,2
12713,3,3,44296,44296,44299,0,3,2
12714,5,2,44301,44301,44303,0,2,2
12715,3,3,44304,44304,44307,0,3,1
12716,2,2,44306,44307,44309,1,3,0
12717,5,3,44311,44311,44314,0,3,2
12718,2,2,44313,44314,44316,1,3,0
12719,4,3,44317,44317,44320,0,3,1
12720,5,1,44322,44322,44323,0,1,2
12721,1,3,44323,44323,44326,0,3,0
12722,5,1,44328,44328,44329,0,1,2
12723,2,3,44330,44330,44333,0,3,1
12724,6,2,44336,44336,44338,0,2,3
12725,3,3,44339,44339,44342,0,3,1
12726,3,3,44342,44342,44345,0,3,0
12727,4,1,44346,44346,44347,0,1,1
12728,2,2,44348,44348,44350,0,2,1
12729,3,2,44351,44351,44353,0,2,1
12730,4,1,44355,44355,44356,0,1,2
12731,6,2,44361,44361,44363,0,2,5
12732,4,1,44365,44365,44366,0,1,2
12733,5,3,44370,44370,44373,0,3,4
12734,2,1,44372,44373,44374,1,2,0
12735,6,3,44378,44378,44381,0,3,4
12736,6,2,44384,44384,44386,0,2,3
12737,1,1,44385,44386,44387,1,2,0
12738,1,1,44386,44387,44388,1,2,0
12739,2,2,44388,44388,44390,0,2,0
12740,6,2,44394,44394,44396,0,2,4
12741,3,1,44397,44397,44398,0,1,1
12742,4,1,44401,44401,44402,0,1,3
12743,3,1,44404,44404,44405,0,1,2
12744,5,2,44409,44409,44411,0,2,4
12745,6,2,44415,44415,44417,0,2,4
12746,1,1,44416,44417,44418,1,2,0
12747,6,2,44422,44422,44424,0,2,4
12748,3,2,44425,44425,44427,0,2,1
12749,6,2,44431,44431,44433,0,2,4
12750,4,3,44435,44435,44438,0,3,2
12751,1,1,44436,44438,44439,2,3,0
12752,6,2,44442,44442,44444,0,2,3
12753,4,2,44446,44446,44448,0,2,2
12754,1,2,44447,44448,44450,1,3,0
12755,2,3,44449,44450,44453,1,4,0
12756,1,1,44450,44453,44454,3,4,0
12757,2,1,44452,44454,44455,2,3,0
12758,1,3,44453,44455,44458,2,5,0
12759,2,1,44455,44458,44459,3,4,0
12760,2,1,44457,44459,44460,2,3,0
12761,5,2,44462,44462,44464,0,2,2
12762,4,3,44466,44466,44469,0,3,2
12763,3,1,44469,44469,44470,0,1,0
12764,4,2,44473,44473,44475,0,2,3
12765,1,2,44474,44475,44477,1,3,0
12766,5,3,44479,44479,44482,0,3,2
12767,6,1,44485,44485,44486,0,1,3
12768,5,3,44490,44490,44493,0,3,4
12769,2,2,44492,44493,44495,1,3,0
12770,3,1,44495,44495,44496,0,1,0
12771,3,3,44498,44498,44501,0,3,2
12772,4,3,44502,44502,44505,0,3,1
12773,6,1,44508,44508,44509,0,1,3
12774,4,1,44512,44512,44513,0,1,3
12775,6,3,44518,44518,44521,0,3,5
12776,1,2,44519,44521,44523,2,4,0
12777,6,3,44525,44525,44528,0,3,2
12778,6,2,44531,44531,44533,0,2,3
12779,2,1,44533,44533,44534,0,1,0
12780,1,2,44534,44534,44536,0,2,0
12781,5,3,44539,44539,44542,0,3,3
12782,6,3,44545,44545,44548,0,3,3
12783,5,2,44550,44550,44552,0,2,2
12784,3,2,44553,44553,44555,0,2,1
12785,6,2,44559,44559,44561,0,2,4
12786,3,3,44562,44562,44565,0,3,1
12787,5,2,44567,44567,44569,0,2,2
12788,3,1,44570,44570,44571,0,1,1
12789,5,1,44575,44575,44576,0,1,4
12790,6,3,44581,44581,44584,0,3,5
12791,5,1,44586,44586,44587,0,1,2
12792,1,3,44587,44587,44590,0,3,0
12793,3,3,44590,44590,44593,0,3,0
12794,3,1,44593,44593,44594,0,1,0
12795,2,3,44595,44595,44598,0,3,1
12796,6,1,44601,44601,44602,0,1,3
12797,3,3,44604,44604,44607,0,3,2
12798,2,3,44606,44607,44610,1,4,0
12799,5,1,44611,44611,44612,0,1,1
12800,4,1,44615,44615,44616,0,1,3
12801,5,3,44620,44620,44623,0,3,4
12802,6,2,44626,44626,44628,0,2,3
12803,1,3,44627,44628,44631,1,4,0
12804,2,1,44629,44631,44632,2,3,0
12805,2,3,44631,44632,44635,1,4,0
12806,4,1,44635,44635,44636,0,1,0
12807,4,3,44639,44639,44642,0,3,3
12808,3,2,44642,44642,44644,0,2,0
12809,3,3,44645,44645,44648,0,3,1
12810,3,3,44648,44648,44651,0,3,0
12811,1,2,44649,44651,44653,2,4,0
12812,1,2,44650,44653,44655,3,5,0
12813,6,3,44656,44656,44659,0,3,1
12814,4,1,44660,44660,44661,0,1,1
12815,3,3,44663,44663,44666,0,3,2
12816,2,3,44665,44666,44669,1,4,0
12817,5,1,44670,44670,44671,0,1,1
12818,2,2,44672,44672,44674,0,2,1
12819,3,1,44675,44675,44676,0,1,1
12820,5,3,44680,44680,44683,0,3,4
12821,6,3,44686,44686,44689,0,3,3
12822,5,1,44691,44691,44692,0,1,2
12823,5,3,44696,44696,44699,0,3,4
12824,3,1,44699,44699,44700,0,1,0
12825,3,2,44702,44702,44704,0,2,2
12826,5,2,44707,44707,44709,0,2,3
12827,3,1,44710,44710,44711,0,1,1
12828,2,2,44712,44712,44714,0,2,1
12829,4,1,44716,44716,44717,0,1,2
12830,1,1,44717,44717,44718,0,1,0
12831,6,1,44723,44723,44724,0,1,5
12832,3,1,44726,44726,44727,0,1,2
12833,5,1,44731,44731,44732,0,1,4
12834,4,1,44735,44735,44736,0,1,3
12835,3,1,44738,44738,44739,0,1,2
12836,1,1,44739,44739,44740,0,1,0
12837,5,1,44744,44744,44745,0,1,4
12838,2,2,44746,44746,44748,0,2,1
12839,2,2,44748,44748,44750,0,2,0
12840,2,3,44750,44750,44753,0,3,0
12841,6,3,44756,44756,44759,0,3,3
12842,3,2,44759,44759,44761,0,2,0
12843,2,2,44761,44761,44763,0,2,0
12844,4,2,44765,44765,44767,0,2,2
12845,4,3,44769,44769,44772,0,3,2
12846,5,2,44774,44774,44776,0,2,2
12847,1,2,44775,44776,44778,1,3,0
12848,2,1,44777,44778,44779,1,2,0
12849,3,1,44780,44780,44781,0,1,1
12850,4,1,44784,44784,44785,0,1,3
12851,2,1,44786,44786,44787,0,1,1
12852,3,1,44789,44789,44790,0,1,2
12853,5,2,44794,44794,44796,0,2,4
12854,2,3,44796,44796,44799,0,3,0
12855,3,3,44799,44799,44802,0,3,0
12856,1,2,44800,44802,44804,2,4,0
12857,5,1,44805,44805,44806,0,1,1
12858,1,2,44806,44806,44808,0,2,0
12859,2,1,44808,44808,44809,0,1,0
12860,4,3,44812,44812,44815,0,3,3
12861,1,2,44813,44815,44817,2,4,0
12862,6,2,44819,44819,44821,0,2,2
12863,6,3,44825,44825,44828,0,3,4
12864,5,2,44830,44830,44832,0,2,2
12865,3,2,44833,44833,44835,0,2,1
12866,4,2,44837,44837,44839,0,2,2
12867,6,1,44843,44843,44844,0,1,4
12868,5,1,44848,44848,44849,0,1,4
12869,1,1,44849,44849,44850,0,1,0
12870,1,3,44850,44850,44853,0,3,0
12871,5,2,44855,44855,44857,0,2,2
12872,1,3,44856,44857,44860,1,4,0
12873,1,1,44857,44860,44861,3,4,0
12874,5,1,44862,44862,44863,0,1,1
12875,1,3,44863,44863,44866,0,3,0
12876,5,2,44868,44868,44870,0,2,2
12877,4,3,44872,44872,44875,0,3,2
12878,1,2,44873,44875,44877,2,4,0
12879,5,1,44878,44878,44879,0,1,1
12880,2,2,44880,44880,44882,0,2,1
12881,6,2,44886,44886,44888,0,2,4
12882,3,2,44889,44889,44891,0,2,1
12883,5,1,44894,44894,44895,0,1,3
12884,1,1,44895,44895,44896,0,1,0
12885,2,3,44897,44897,44900,0,3,1
12886,3,3,44900,44900,44903,0,3,0
12887,1,3,44901,44903,44906,2,5,0
12888,5,2,44906,44906,44908,0,2,0
12889,4,3,44910,44910,44913,0,3,2
12890,6,3,44916,44916,44919,0,3,3
12891,2,1,44918,44919,44920,1,2,0
12892,4,3,44922,44922,44925,0,3,2
12893,5,1,44927,44927,44928,0,1,2
12894,6,1,44933,44933,44934,0,1,5
12895,3,1,44936,44936,44937,0,1,2
12896,3,3,44939,44939,44942,0,3,2
12897,6,3,44945,44945,44948,0,3,3
12898,1,1,44946,44948,44949,2,3,0
12899,2,2,44948,44949,44951,1,3,0
12900,2,1,44950,44951,44952,1,2,0
12901,3,2,44953,44953,44955,0,2,1
12902,3,3,44956,44956,44959,0,3,1
12903,2,1,44958,44959,44960,1,2,0
12904,5,2,44963,44963,44965,0,2,3
12905,6,2,44969,44969,44971,0,2,4
12906,3,2,44972,44972,44974,0,2,1
12907,4,1,44976,44976,44977,0,1,2
12908,6,2,44982,44982,44984,0,2,5
12909,4,1,44986,44986,44987,0,1,2
12910,2,1,44988,44988,44989,0,1,1
12911,5,2,44993,44993,44995,0,2,4
12912,2,3,44995,44995,44998,0,3,0
12913,5,1,45000,45000,45001,0,1,2
12914,6,3,45006,45006,45009,0,3,5
12915,6,3,45012,45012,45015,0,3,3
12916,5,3,45017,45017,45020,0,3,2
12917,3,2,45020,45020,45022,0,2,0
12918,1,2,45021,45022,45024,1,3,0
12919,4,2,45025,45025,45027,0,2,1
12920,2,3,45027,45027,45030,0,3,0
12921,3,3,45030,45030,45033,0,3,0
12922,6,1,45036,45036,45037,0,1,3
12923,6,1,45042,45042,45043,0,1,5
12924,5,2,45047,45047,45049,0,2,4
12925,2,2,45049,45049,45051,0,2,0
12926,5,2,45054,45054,45056,0,2,3
12927,3,1,45057,45057,45058,0,1,1
12928,6,1,45063,45063,45064,0,1,5
12929,1,3,45064,45064,45067,0,3,0
12930,3,2,45067,45067,45069,0,2,0
12931,6,1,45073,45073,45074,0,1,4
12932,6,1,45079,45079,45080,0,1,5
12933,2,1,45081,45081,45082,0,1,1
12934,5,2,45086,45086,45088,0,2,4
12935,2,3,45088,45088,45091,0,3,0
12936,6,1,45094,45094,45095,0,1,3
12937,2,1,45096,45096,45097,0,1,1
12938,5,3,45101,45101,45104,0,3,4
12939,3,1,45104,45104,45105,0,1,0
12940,1,2,45105,45105,45107,0,2,0
12941,6,1,45111,45111,45112,0,1,4
12942,5,2,45116,45116,45118,0,2,4
12943,1,3,45117,45118,45121,1,4,0
12944,1,2,45118,45121,45123,3,5,0
12945,6,3,45124,45124,45127,0,3,1
12946,6,1,45130,45130,45131,0,1,3
12947,4,2,45134,45134,45136,0,2,3
12948,1,3,45135,45136,45139,1,4,0
12949,3,1,45138,45139,45140,1,2,0
12950,5,2,45143,45143,45145,0,2,3
12951,4,2,45147,45147,45149,0,2,2
12952,6,3,45153,45153,45156,0,3,4
12953,5,2,45158,45158,45160,0,2,2
12954,2,2,45160,45160,45162,0,2,0
12955,4,2,45164,45164,45166,0,2,2
12956,5,2,45169,45169,45171,0,2,3
12957,4,1,45173,45173,45174,0,1,2
12958,4,1,45177,45177,45178,0,1,3
12959,4,3,45181,45181,45184,0,3,3
12960,5,2,45186,45186,45188,0,2,2
12961,3,3,45189,45189,45192,0,3,1
12962,4,2,45193,45193,45195,0,2,1
12963,5,1,45198,45198,45199,0,1,3
12964,5,1,45203,45203,45204,0,1,4
12965,4,2,45207,45207,45209,0,2,3
12966,3,3,45210,45210,45213,0,3,1
12967,5,3,45215,45215,45218,0,3,2
12968,5,2,45220,45220,45222,0,2,2
12969,4,2,45224,45224,45226,0,2,2
12970,3,2,45227,45227,45229,0,2,1
12971,1,1,45228,45229,45230,1,2,0
12972,2,3,45230,45230,45233,0,3,0
12973,4,1,45234,45234,45235,0,1,1
12974,5,1,45239,45239,45240,0,1,4
12975,5,2,45244,45244,45246,0,2,4
12976,2,1,45246,45246,45247,0,1,0
12977,1,2,45247,45247,45249,0,2,0
12978,6,2,45253,45253,45255,0,2,4
12979,1,2,45254,45255,45257,1,3,0
12980,4,1,45258,45258,45259,0,1,1
12981,1,3,45259,45259,45262,0,3,0
12982,2,3,45261,45262,45265,1,4,0
12983,3,2,45264,45265,45267,1,3,0
12984,6,2,45270,45270,45272,0,2,3
12985,3,2,45273,45273,45275,0,2,1
12986,6,3,45279,45279,45282,0,3,4
12987,6,1,45285,45285,45286,0,1,3
12988,4,1,45289,45289,45290,0,1,3
12989,4,1,45293,45293,45294,0,1,3
12990,4,1,45297,45297,45298,0,1,3
12991,2,3,45299,45299,45302,0,3,1
12992,3,2,45302,45302,45304,0,2,0
12993,6,2,45308,45308,45310,0,2,4
12994,2,1,45310,45310,45311,0,1,0
12995,6,1,45316,45316,45317,0,1,5
12996,3,1,45319,45319,45320,0,1,2
12997,3,3,45322,45322,45325,0,3,2
12998,5,1,45327,45327,45328,0,1,2
12999,1,1,45328,45328,45329,0,1,0
13000,3,2,45331,45331,45333,0,2,2
13001,5,2,45336,45336,45338,0,2,3
13002,2,3,45338,45338,45341,0,3,0
13003,4,2,45342,45342,45344,0,2,1
13004,2,1,45344,45344,45345,0,1,0
13005,3,3,45347,45347,45350,0,3,2
13006,5,2,45352,45352,45354,0,2,2
13007,2,1,45354,45354,45355,0,1,0
13008,6,3,45360,45360,45363,0,3,5
13009,6,3,45366,45366,45369,0,3,3
13010,6,3,45372,45372,45375,0,3,3
13011,2,3,45374,45375,45378,1,4,0
13012,1,3,45375,45378,45381,3,6,0
13013,5,2,45380,45381,45383,1,3,0
13014,3,3,45383,45383,45386,0,3,0
13015,5,1,45388,45388,45389,0,1,2
13016,5,3,45393,45393,45396,0,3,4
13017,4,1,45397,45397,45398,0,1,1
13018,6,2,45403,45403,45405,0,2,5
13019,6,2,45409,45409,45411,0,2,4
13020,5,2,45414,45414,45416,0,2,3
13021,3,3,45417,45417,45420,0,3,1
13022,5,1,45422,45422,45423,0,1,2
13023,1,1,45423,45423,45424,0,1,0
13024,6,1,45429,45429,45430,0,1,5
13025,4,2,45433,45433,45435,0,2,3
13026,1,3,45434,45435,45438,1,4,0
13027,2,3,45436,45438,45441,2,5,0
13028,3,3,45439,45441,45444,2,5,0
13029,2,2,45441,45444,45446,3,5,0
13030,3,2,45444,45446,45448,2,4,0
13031,3,2,45447,45448,45450,1,3,0
13032,1,2,45448,45450,45452,2,4,0
13033,6,1,45454,45454,45455,0,1,2
13034,3,1,45457,45457,45458,0,1,2
13035,5,1,45462,45462,45463,0,1,4
13036,1,1,45463,45463,45464,0,1,0
13037,4,2,45467,45467,45469,0,2,3
13038,6,3,45473,45473,45476,0,3,4
13039,5,3,45478,45478,45481,0,3,2
13040,5,1,45483,45483,45484,0,1,2
13041,5,1,45488,45488,45489,0,1,4
13042,3,3,45491,45491,45494,0,3,2
13043,1,1,45492,45494,45495,2,3,0
13044,3,1,45495,45495,45496,0,1,0
13045,6,2,45501,45501,45503,0,2,5
13046,4,1,45505,45505,45506,0,1,2
13047,2,2,45507,45507,45509,0,2,1
13048,6,1,45513,45513,45514,0,1,4
13049,3,3,45516,45516,45519,0,3,2
13050,6,1,45522,45522,45523,0,1,3
13051,4,1,45526,45526,45527,0,1,3
13052,4,3,45530,45530,45533,0,3,3
13053,1,1,45531,45533,45534,2,3,0
13054,1,2,45532,45534,45536,2,4,0
13055,1,3,45533,45536,45539,3,6,0
13056,5,1,45538,45539,45540,1,2,0
13057,6,3,45544,45544,45547,0,3,4
13058,1,3,45545,45547,45550,2,5,0
13059,5,1,45550,45550,45551,0,1,0
13060,5,1,45555,45555,45556,0,1,4
13061,4,3,45559,45559,45562,0,3,3
13062,4,3,45563,45563,45566,0,3,1
13063,2,3,45565,45566,45569,1,4,0
13064,1,2,45566,45569,45571,3,5,0
13065,2,3,45568,45571,45574,3,6,0
13066,3,3,45571,45574,45577,3,6,0
13067,1,2,45572,45577,45579,5,7,0
13068,6,3,45578,45579,45582,1,4,0
13069,3,3,45581,45582,45585,1,4,0
13070,1,3,45582,45585,45588,3,6,0
13071,4,2,45586,45588,45590,2,4,0
13072,2,2,45588,45590,45592,2,4,0
13073,6,3,45594,45594,45597,0,3,2
13074,6,1,45600,45600,45601,0,1,3
13075,4,1,45604,45604,45605,0,1,3
13076,6,3,45610,45610,45613,0,3,5
13077,2,1,45612,45613,45614,1,2,0
13078,6,1,45618,45618,45619,0,1,4
13079,3,3,45621,45621,45624,0,3,2
13080,1,3,45622,45624,45627,2,5,0
13081,4,1,45626,45627,45628,1,2,0
13082,5,2,45631,45631,45633,0,2,3
13083,5,2,45636,45636,45638,0,2,3
13084,4,1,45640,45640,45641,0,1,2
13085,1,2,45641,45641,45643,0,2,0
13086,4,2,45645,45645,45647,0,2,2
13087,5,2,45650,45650,45652,0,2,3
13088,6,1,45656,45656,45657,0,1,4
13089,6,3,45662,45662,45665,0,3,5
13090,2,3,45664,45665,45668,1,4,0
13091,3,1,45667,45668,45669,1,2,0
13092,5,1,45672,45672,45673,0,1,3
13093,3,1,45675,45675,45676,0,1,2
13094,2,2,45677,45677,45679,0,2,1
13095,1,1,45678,45679,45680,1,2,0
13096,4,1,45682,45682,45683,0,1,2
13097,4,2,45686,45686,45688,0,2,3
13098,5,2,45691,45691,45693,0,2,3
13099,2,2,45693,45693,45695,0,2,0
13100,6,1,45699,45699,45700,0,1,4
13101,5,3,45704,45704,45707,0,3,4
13102,6,2,45710,45710,45712,0,2,3
13103,1,1,45711,45712,45713,1,2,0
13104,5,3,45716,45716,45719,0,3,3
13105,5,3,45721,45721,45724,0,3,2
13106,4,2,45725,45725,45727,0,2,1
13107,6,2,45731,45731,45733,0,2,4
13108,3,2,45734,45734,45736,0,2,1
13109,3,3,45737,45737,45740,0,3,1
13110,5,3,45742,45742,45745,0,3,2
13111,6,1,45748,45748,45749,0,1,3
13112,2,1,45750,45750,45751,0,1,1
13113,5,2,45755,45755,45757,0,2,4
13114,5,2,45760,45760,45762,0,2,3
13115,1,2,45761,45762,45764,1,3,0
13116,4,1,45765,45765,45766,0,1,1
13117,5,2,45770,45770,45772,0,2,4
13118,3,3,45773,45773,45776,0,3,1
13119,2,1,45775,45776,45777,1,2,0
13120,1,1,45776,45777,45778,1,2,0
13121,1,1,45777,45778,45779,1,2,0
13122,5,1,45782,45782,45783,0,1,3
13123,6,3,45788,45788,45791,0,3,5
13124,4,2,45792,45792,45794,0,2,1
13125,6,2,45798,45798,45800,0,2,4
13126,6,3,45804,45804,45807,0,3,4
13127,1,1,45805,45807,45808,2,3,0
13128,5,2,45810,45810,45812,0,2,2
13129,3,1,45813,45813,45814,0,1,1
13130,3,1,45816,45816,45817,0,1,2
13131,3,1,45819,45819,45820,0,1,2
13132,2,1,45821,45821,45822,0,1,1
13133,6,3,45827,45827,45830,0,3,5
13134,6,1,45833,45833,45834,0,1,3
13135,4,1,45837,45837,45838,0,1,3
13136,5,1,45842,45842,45843,0,1,4
13137,5,1,45847,45847,45848,0,1,4
13138,6,1,45853,45853,45854,0,1,5
13139,6,2,45859,45859,45861,0,2,5
13140,2,2,45861,45861,45863,0,2,0
13141,4,1,45865,45865,45866,0,1,2
13142,4,1,45869,45869,45870,0,1,3
13143,4,1,45873,45873,45874,0,1,3
13144,2,3,45875,45875,45878,0,3,1
13145,2,3,45877,45878,45881,1,4,0
13146,5,1,45882,45882,45883,0,1,1
13147,2,1,45884,45884,45885,0,1,1
13148,2,1,45886,45886,45887,0,1,1
13149,5,3,45891,45891,45894,0,3,4
13150,4,2,45895,45895,45897,0,2,1
13151,6,2,45901,45901,45903,0,2,4
13152,6,2,45907,45907,45909,0,2,4
13153,4,1,45911,45911,45912,0,1,2
13154,3,1,45914,45914,45915,0,1,2
13155,1,1,45915,45915,45916,0,1,0
13156,2,3,45917,45917,45920,0,3,1
13157,1,2,45918,45920,45922,2,4,0
13158,5,1,45923,45923,45924,0,1,1
13159,3,3,45926,45926,45929,0,3,2
13160,3,1,45929,45929,45930,0,1,0
13161,2,3,45931,45931,45934,0,3,1
13162,3,1,45934,45934,45935,0,1,0
13163,6,1,45940,45940,45941,0,1,5
13164,3,1,45943,45943,45944,0,1,2
13165,1,3,45944,45944,45947,0,3,0
13166,3,2,45947,45947,45949,0,2,0
13167,3,2,45950,45950,45952,0,2,1
13168,5,1,45955,45955,45956,0,1,3
13169,3,3,45958,45958,45961,0,3,2
13170,4,2,45962,45962,45964,0,2,1
13171,6,1,45968,45968,45969,0,1,4
13172,1,1,45969,45969,45970,0,1,0
13173,5,2,45974,45974,45976,0,2,4
13174,6,3,45980,45980,45983,0,3,4
13175,4,3,45984,45984,45987,0,3,1
13176,6,2,45990,45990,45992,0,2,3
13177,4,3,45994,45994,45997,0,3,2
13178,4,2,45998,45998,46000,0,2,1
13179,1,3,45999,46000,46003,1,4,0
13180,2,1,46001,46003,46004,2,3,0
13181,6,2,46007,46007,46009,0,2,3
13182,6,3,46013,46013,46016,0,3,4
13183,1,2,46014,46016,46018,2,4,0
13184,2,1,46016,46018,46019,2,3,0
13185,6,3,46022,46022,46025,0,3,3
13186,5,1,46027,46027,46028,0,1,2
13187,4,3,46031,46031,46034,0,3,3
13188,3,3,46034,46034,46037,0,3,0
13189,3,3,46037,46037,46040,0,3,0
13190,2,2,46039,46040,46042,1,3,0
13191,4,3,46043,46043,46046,0,3,1
13192,3,1,46046,46046,46047,0,1,0
13193,6,1,46052,46052,46053,0,1,5
13194,6,3,46058,46058,46061,0,3,5
13195,1,2,46059,46061,46063,2,4,0
13196,6,3,46065,46065,46068,0,3,2
13197,5,2,46070,46070,46072,0,2,2
13198,3,1,46073,46073,46074,0,1,1
13199,1,2,46074,46074,46076,0,2,0
13200,2,2,46076,46076,46078,0,2,0
13201,5,2,46081,46081,46083,0,2,3
13202,3,1,46084,46084,46085,0,1,1
13203,1,3,46085,46085,46088,0,3,0
13204,3,2,46088,46088,46090,0,2,0
13205,5,1,46093,46093,46094,0,1,3
13206,5,1,46098,46098,46099,0,1,4
13207,4,2,46102,46102,46104,0,2,3
13208,6,2,46108,46108,46110,0,2,4
13209,6,1,46114,46114,46115,0,1,4
13210,1,3,46115,46115,46118,0,3,0
13211,2,1,46117,46118,46119,1,2,0
13212,4,2,46121,46121,46123,0,2,2
13213,2,3,46123,46123,46126,0,3,0
13214,4,2,46127,46127,46129,0,2,1
13215,3,1,46130,46130,46131,0,1,1
13216,6,2,46136,46136,46138,0,2,5
13217,4,3,46140,46140,46143,0,3,2
13218,5,2,46145,46145,46147,0,2,2
13219,6,1,46151,46151,46152,0,1,4
13220,5,3,46156,46156,46159,0,3,4
13221,5,1,46161,46161,46162,0,1,2
13222,6,2,46167,46167,46169,0,2,5
13223,1,3,46168,46169,46172,1,4,0
13224,1,3,46169,46172,46175,3,6,0
13225,1,2,46170,46175,46177,5,7,0
13226,6,1,46176,46177,46178,1,2,0
13227,4,3,46180,46180,46183,0,3,2
13228,1,2,46181,46183,46185,2,4,0
13229,5,2,46186,46186,46188,0,2,1
13230,5,1,46191,46191,46192,0,1,3
13231,5,3,46196,46196,46199,0,3,4
13232,5,2,46201,46201,46203,0,2,2
13233,4,2,46205,46205,46207,0,2,2
13234,3,1,46208,46208,46209,0,1,1
13235,4,1,46212,46212,46213,0,1,3
13236,6,2,46218,46218,46220,0,2,5
13237,2,2,46220,46220,46222,0,2,0
13238,6,2,46226,46226,46228,0,2,4
13239,3,2,46229,46229,46231,0,2,1
13240,4,2,46233,46233,46235,0,2,2
13241,4,1,46237,46237,46238,0,1,2
13242,4,1,46241,46241,46242,0,1,3
13243,1,1,46242,46242,46243,0,1,0
13244,1,1,46243,46243,46244,0,1,0
13245,5,2,46248,46248,46250,0,2,4
13246,3,1,46251,46251,46252,0,1,1
13247,6,1,46257,46257,46258,0,1,5
13248,4,2,46261,46261,46263,0,2,3
13249,4,1,46265,46265,46266,0,1,2
13250,3,2,46268,46268,46270,0,2,2
13251,1,2,46269,46270,46272,1,3,0
13252,3,1,46272,46272,46273,0,1,0
13253,6,1,46278,46278,46279,0,1,5
13254,3,2,46281,46281,46283,0,2,2
13255,3,3,46284,46284,46287,0,3,1
13256,6,3,46290,46290,46293,0,3,3
13257,4,3,46294,46294,46297,0,3,1
13258,3,2,46297,46297,46299,0,2,0
13259,2,3,46299,46299,46302,0,3,0
13260,1,2,46300,46302,46304,2,4,0
13261,1,2,46301,46304,46306,3,5,0
13262,4,1,46305,46306,46307,1,2,0
13263,3,2,46308,46308,46310,0,2,1
13264,5,2,46313,46313,46315,0,2,3
13265,1,2,46314,46315,46317,1,3,0
13266,6,3,46320,46320,46323,0,3,3
13267,3,2,46323,46323,46325,0,2,0
13268,4,1,46327,46327,46328,0,1,2
13269,5,1,46332,46332,46333,0,1,4
13270,4,1,46336,46336,46337,0,1,3
13271,3,3,46339,46339,46342,0,3,2
13272,4,2,46343,46343,46345,0,2,1
13273,1,1,46344,46345,46346,1,2,0
13274,3,2,46347,46347,46349,0,2,1
13275,6,2,46353,46353,46355,0,2,4
13276,3,2,46356,46356,46358,0,2,1
13277,2,2,46358,46358,46360,0,2,0
13278,6,3,46364,46364,46367,0,3,4
13279,4,3,46368,46368,46371,0,3,1
13280,2,3,46370,46371,46374,1,4,0
13281,5,2,46375,46375,46377,0,2,1
13282,2,1,46377,46377,46378,0,1,0
13283,2,2,46379,46379,46381,0,2,1
13284,5,3,46384,46384,46387,0,3,3
13285,2,2,46386,46387,46389,1,3,0
13286,2,3,46388,46389,46392,1,4,0
13287,6,3,46394,46394,46397,0,3,2
13288,5,3,46399,46399,46402,0,3,2
13289,3,1,46402,46402,46403,0,1,0
13290,1,1,46403,46403,46404,0,1,0
13291,1,3,46404,46404,46407,0,3,0
13292,3,2,46407,46407,46409,0,2,0
13293,2,1,46409,46409,46410,0,1,0
13294,6,2,46415,46415,46417,0,2,5
13295,3,2,46418,46418,46420,0,2,1
13296,3,2,46421,46421,46423,0,2,1
13297,2,2,46423,46423,46425,0,2,0
13298,6,1,46429,46429,46430,0,1,4
13299,1,2,46430,46430,46432,0,2,0
13300,1,2,46431,46432,46434,1,3,0
13301,5,3,46436,46436,46439,0,3,2
13302,2,3,46438,46439,46442,1,4,0
13303,5,3,46443,46443,46446,0,3,1
13304,2,3,46445,46446,46449,1,4,0
13305,4,2,46449,46449,46451,0,2,0
13306,2,1,46451,46451,46452,0,1,0
13307,3,1,46454,46454,46455,0,1,2
13308,1,2,46455,46455,46457,0,2,0
13309,1,2,46456,46457,46459,1,3,0
13310,6,1,46462,46462,46463,0,1,3
13311,6,1,46468,46468,46469,0,1,5
13312,1,3,46469,46469,46472,0,3,0
13313,1,2,46470,46472,46474,2,4,0
13314,2,3,46472,46474,46477,2,5,0
13315,1,3,46473,46477,46480,4,7,0
13316,6,3,46479,46480,46483,1,4,0
13317,1,2,46480,46483,46485,3,5,0
13318,3,3,46483,46485,46488,2,5,0
13319,5,3,46488,46488,46491,0,3,0
13320,1,1,46489,46491,46492,2,3,0
13321,1,3,46490,46492,46495,2,5,0
13322,2,2,46492,46495,46497,3,5,0
13323,5,3,46497,46497,46500,0,3,0
13324,6,1,46503,46503,46504,0,1,3
13325,3,3,46506,46506,46509,0,3,2
13326,5,2,46511,46511,46513,0,2,2
13327,3,2,46514,46514,46516,0,2,1
13328,1,3,46515,46516,46519,1,4,0
13329,6,1,46521,46521,46522,0,1,2
13330,4,1,46525,46525,46526,0,1,3
13331,2,3,46527,46527,46530,0,3,1
13332,1,1,46528,46530,46531,2,3,0
13333,6,3,46534,46534,46537,0,3,3
13334,3,2,46537,46537,46539,0,2,0
13335,4,3,46541,46541,46544,0,3,2
13336,4,3,46545,46545,46548,0,3,1
13337,1,2,46546,46548,46550,2,4,0
13338,1,1,46547,46550,46551,3,4,0
13339,3,1,46550,46551,46552,1,2,0
13340,1,3,46551,46552,46555,1,4,0
13341,6,1,46557,46557,46558,0,1,2
13342,6,2,46563,46563,46565,0,2,5
13343,1,1,46564,46565,46566,1,2,0
13344,5,3,46569,46569,46572,0,3,3
13345,3,3,46572,46572,46575,0,3,0
13346,5,1,46577,46577,46578,0,1,2
13347,3,3,46580,46580,46583,0,3,2
13348,5,1,46585,46585,46586,0,1,2
13349,2,1,46587,46587,46588,0,1,1
13350,3,2,46590,46590,46592,0,2,2
13351,4,3,46594,46594,46597,0,3,2
13352,2,3,46596,46597,46600,1,4,0
13353,6,1,46602,46602,46603,0,1,2
13354,4,3,46606,46606,46609,0,3,3
13355,5,1,46611,46611,46612,0,1,2
13356,4,1,46615,46615,46616,0,1,3
13357,2,1,46617,46617,46618,0,1,1
13358,6,2,46623,46623,46625,0,2,5
13359,2,1,46625,46625,46626,0,1,0
13360,5,2,46630,46630,46632,0,2,4
13361,3,1,46633,46633,46634,0,1,1
13362,2,1,46635,46635,46636,0,1,1
13363,4,2,46639,46639,46641,0,2,3
13364,6,1,46645,46645,46646,0,1,4
13365,6,3,46651,46651,46654,0,3,5
13366,5,2,46656,46656,46658,0,2,2
13367,3,2,46659,46659,46661,0,2,1
13368,1,1,46660,46661,46662,1,2,0
13369,1,1,46661,46662,46663,1,2,0
13370,6,1,46667,46667,46668,0,1,4
13371,4,2,46671,46671,46673,0,2,3
13372,1,1,46672,46673,46674,1,2,0
13373,6,1,46678,46678,46679,0,1,4
13374,3,3,46681,46681,46684,0,3,2
13375,5,1,46686,46686,46687,0,1,2
13376,3,2,46689,46689,46691,0,2,2
13377,6,2,46695,46695,46697,0,2,4
13378,4,2,46699,46699,46701,0,2,2
13379,1,2,46700,46701,46703,1,3,0
13380,5,2,46705,46705,46707,0,2,2
13381,2,1,46707,46707,46708,0,1,0
13382,1,3,46708,46708,46711,0,3,0
13383,6,1,46714,46714,46715,0,1,3
13384,5,3,46719,46719,46722,0,3,4
13385,5,3,46724,46724,46727,0,3,2
13386,1,1,46725,46727,46728,2,3,0
13387,4,3,46729,46729,46732,0,3,1
13388,6,1,46735,46735,46736,0,1,3
13389,2,2,46737,46737,46739,0,2,1
13390,5,1,46742,46742,46743,0,1,3
13391,5,1,46747,46747,46748,0,1,4
13392,2,1,46749,46749,46750,0,1,1
13393,2,2,46751,46751,46753,0,2,1
13394,4,2,46755,46755,46757,0,2,2
13395,6,3,46761,46761,46764,0,3,4
13396,1,3,46762,46764,46767,2,5,0
13397,2,2,46764,46767,46769,3,5,0
13398,1,2,46765,46769,46771,4,6,0
13399,4,1,46769,46771,46772,2,3,0
13400,2,2,46771,46772,46774,1,3,0
13401,3,2,46774,46774,46776,0,2,0
13402,4,2,46778,46778,46780,0,2,2
13403,3,1,46781,46781,46782,0,1,1
13404,4,1,46785,46785,46786,0,1,3
13405,4,1,46789,46789,46790,0,1,3
13406,6,2,46795,46795,46797,0,2,5
13407,2,1,46797,46797,46798,0,1,0
13408,2,1,46799,46799,46800,0,1,1
13409,3,3,46802,46802,46805,0,3,2
13410,2,3,46804,46805,46808,1,4,0
13411,5,2,46809,46809,46811,0,2,1
13412,3,2,46812,46812,46814,0,2,1
13413,4,2,46816,46816,46818,0,2,2
13414,1,2,46817,46818,46820,1,3,0
13415,4,2,46821,46821,46823,0,2,1
13416,6,1,46827,46827,46828,0,1,4
13417,5,2,46832,46832,46834,0,2,4
13418,4,2,46836,46836,46838,0,2,2
13419,5,2,46841,46841,46843,0,2,3
13420,6,3,46847,46847,46850,0,3,4
13421,6,3,46853,46853,46856,0,3,3
13422,3,1,46856,46856,46857,0,1,0
13423,5,1,46861,46861,46862,0,1,4
13424,5,3,46866,46866,46869,0,3,4
13425,1,2,46867,46869,46871,2,4,0
13426,5,3,46872,46872,46875,0,3,1
13427,4,2,46876,46876,46878,0,2,1
13428,1,1,46877,46878,46879,1,2,0
13429,4,2,46881,46881,46883,0,2,2
13430,4,3,46885,46885,46888,0,3,2
13431,3,3,46888,46888,46891,0,3,0
13432,3,3,46891,46891,46894,0,3,0
13433,6,3,46897,46897,46900,0,3,3
13434,1,3,46898,46900,46903,2,5,0
13435,1,2,46899,46903,46905,4,6,0
13436,3,1,46902,46905,46906,3,4,0
13437,4,1,46906,46906,46907,0,1,0
13438,3,1,46909,46909,46910,0,1,2
13439,1,3,46910,46910,46913,0,3,0
13440,1,1,46911,46913,46914,2,3,0
13441,4,1,46915,46915,46916,0,1,1
13442,2,2,46917,46917,46919,0,2,1
13443,2,2,46919,46919,46921,0,2,0
13444,2,1,46921,46921,46922,0,1,0
13445,5,2,46926,46926,46928,0,2,4
13446,2,3,46928,46928,46931,0,3,0
13447,3,3,46931,46931,46934,0,3,0
13448,4,3,46935,46935,46938,0,3,1
13449,2,2,46937,46938,46940,1,3,0
13450,5,2,46942,46942,46944,0,2,2
13451,5,1,46947,46947,46948,0,1,3
13452,1,1,46948,46948,46949,0,1,0
13453,3,3,46951,46951,46954,0,3,2
13454,4,3,46955,46955,46958,0,3,1
13455,2,2,46957,46958,46960,1,3,0
13456,1,1,46958,46960,46961,2,3,0
13457,5,2,46963,46963,46965,0,2,2
13458,5,1,46968,46968,46969,0,1,3
13459,4,3,46972,46972,46975,0,3,3
13460,2,3,46974,46975,46978,1,4,0
13461,6,3,46980,46980,46983,0,3,2
13462,2,1,46982,46983,46984,1,2,0
13463,2,3,46984,46984,46987,0,3,0
13464,2,2,46986,46987,46989,1,3,0
13465,5,1,46991,46991,46992,0,1,2
13466,4,2,46995,46995,46997,0,2,3
13467,4,2,46999,46999,47001,0,2,2
13468,3,2,47002,47002,47004,0,2,1
13469,3,3,47005,47005,47008,0,3,1
13470,3,3,47008,47008,47011,0,3,0
13471,5,2,47013,47013,47015,0,2,2
13472,4,3,47017,47017,47020,0,3,2
13473,1,2,47018,47020,47022,2,4,0
13474,3,3,47021,47022,47025,1,4,0
13475,1,3,47022,47025,47028,3,6,0
13476,2,3,47024,47028,47031,4,7,0
13477,3,3,47027,47031,47034,4,7,0
13478,4,3,47031,47034,47037,3,6,0
13479,1,3,47032,47037,47040,5,8,0
13480,2,1,47034,47040,47041,6,7,0
13481,2,3,47036,47041,47044,5,8,0
13482,2,3,47038,47044,47047,6,9,0
13483,2,3,47040,47047,47050,7,10,0
13484,3,1,47043,47050,47051,7,8,0
13485,2,2,47045,47051,47053,6,8,0
13486,4,3,47049,47053,47056,4,7,0
13487,3,1,47052,47056,47057,4,5,0
13488,4,1,47056,47057,47058,1,2,0
13489,3,1,47059,47059,47060,0,1,1
13490,4,2,47063,47063,47065,0,2,3
13491,3,1,47066,47066,47067,0,1,1
13492,1,2,47067,47067,47069,0,2,0
13493,2,2,47069,47069,47071,0,2,0
13494,2,3,47071,47071,47074,0,3,0
13495,3,2,47074,47074,47076,0,2,0
13496,6,3,47080,47080,47083,0,3,4
13497,3,3,47083,47083,47086,0,3,0
13498,4,2,47087,47087,47089,0,2,1
13499,5,3,47092,47092,47095,0,3,3
13500,4,2,47096,47096,47098,0,2,1
13501,3,1,47099,47099,47100,0,1,1
13502,4,3,47103,47103,47106,0,3,3
13503,4,2,47107,47107,47109,0,2,1
13504,1,3,47108,47109,47112,1,4,0
13505,5,3,47113,47113,47116,0,3,1
13506,3,1,47116,47116,47117,0,1,0
13507,2,2,47118,47118,47120,0,2,1
13508,1,2,47119,47120,47122,1,3,0
13509,6,3,47125,47125,47128,0,3,3
13510,5,1,47130,47130,47131,0,1,2
13511,2,3,47132,47132,47135,0,3,1
13512,6,2,47138,47138,47140,0,2,3
13513,5,1,47143,47143,47144,0,1,3
13514,1,2,47144,47144,47146,0,2,0
13515,1,2,47145,47146,47148,1,3,0
13516,5,2,47150,47150,47152,0,2,2
13517,6,2,47156,47156,47158,0,2,4
13518,5,2,47161,47161,47163,0,2,3
13519,1,1,47162,47163,47164,1,2,0
13520,1,1,47163,47164,47165,1,2,0
13521,3,3,47166,47166,47169,0,3,1
13522,2,2,47168,47169,47171,1,3,0
13523,1,3,47169,47171,47174,2,5,0
13524,5,2,47174,47174,47176,0,2,0
13525,2,3,47176,47176,47179,0,3,0
13526,3,2,47179,47179,47181,0,2,0
13527,1,2,47180,47181,47183,1,3,0
13528,1,2,47181,47183,47185,2,4,0
13529,4,2,47185,47185,47187,0,2,0
13530,6,2,47191,47191,47193,0,2,4
13531,3,2,47194,47194,47196,0,2,1
13532,2,1,47196,47196,47197,0,1,0
13533,2,3,47198,47198,47201,0,3,1
13534,4,2,47202,47202,47204,0,2,1
13535,2,3,47204,47204,47207,0,3,0
13536,6,2,47210,47210,47212,0,2,3
13537,1,2,47211,47212,47214,1,3,0
13538,3,3,47214,47214,47217,0,3,0
13539,2,3,47216,47217,47220,1,4,0
13540,4,3,47220,47220,47223,0,3,0
13541,3,3,47223,47223,47226,0,3,0
13542,3,3,47226,47226,47229,0,3,0
13543,1,2,47227,47229,47231,2,4,0
13544,2,1,47229,47231,47232,2,3,0
13545,2,3,47231,47232,47235,1,4,0
13546,4,3,47235,47235,47238,0,3,0
13547,2,1,47237,47238,47239,1,2,0
13548,3,3,47240,47240,47243,0,3,1
13549,1,3,47241,47243,47246,2,5,0
13550,2,1,47243,47246,47247,3,4,0
13551,5,2,47248,47248,47250,0,2,1
13552,2,3,47250,47250,47253,0,3,0
13553,1,2,47251,47253,47255,2,4,0
13554,3,1,47254,47255,47256,1,2,0
13555,3,2,47257,47257,47259,0,2,1
13556,6,2,47263,47263,47265,0,2,4
13557,4,1,47267,47267,47268,0,1,2
13558,2,3,47269,47269,47272,0,3,1
13559,3,1,47272,47272,47273,0,1,0
13560,6,1,47278,47278,47279,0,1,5
13561,1,1,47279,47279,47280,0,1,0
13562,6,1,47285,47285,47286,0,1,5
13563,5,3,47290,47290,47293,0,3,4
13564,5,2,47295,47295,47297,0,2,2
13565,4,3,47299,47299,47302,0,3,2
13566,1,1,47300,47302,47303,2,3,0
13567,3,1,47303,47303,47304,0,1,0
13568,2,3,47305,47305,47308,0,3,1
13569,1,1,47306,47308,47309,2,3,0
13570,2,1,47308,47309,47310,1,2,0
13571,5,3,47313,47313,47316,0,3,3
13572,5,3,47318,47318,47321,0,3,2
13573,5,1,47323,47323,47324,0,1,2
13574,1,2,47324,47324,47326,0,2,0
13575,5,3,47329,47329,47332,0,3,3
13576,4,2,47333,47333,47335,0,2,1
13577,3,1,47336,47336,47337,0,1,1
13578,5,3,47341,47341,47344,0,3,4
13579,4,2,47345,47345,47347,0,2,1
13580,3,3,47348,47348,47351,0,3,1
13581,6,3,47354,47354,47357,0,3,3
13582,4,3,47358,47358,47361,0,3,1
13583,3,3,47361,47361,47364,0,3,0
13584,3,2,47364,47364,47366,0,2,0
13585,3,1,47367,47367,47368,0,1,1
13586,3,1,47370,47370,47371,0,1,2
13587,6,2,47376,47376,47378,0,2,5
13588,2,2,47378,47378,47380,0,2,0
13589,4,2,47382,47382,47384,0,2,2
13590,6,3,47388,47388,47391,0,3,4
13591,1,1,47389,47391,47392,2,3,0
13592,1,2,47390,47392,47394,2,4,0
13593,2,2,47392,47394,47396,2,4,0
13594,5,3,47397,47397,47400,0,3,1
13595,1,1,47398,47400,47401,2,3,0
13596,5,2,47403,47403,47405,0,2,2
13597,1,1,47404,47405,47406,1,2,0
13598,3,2,47407,47407,47409,0,2,1
13599,2,1,47409,47409,47410,0,1,0
13600,3,3,47412,47412,47415,0,3,2
13601,2,2,47414,47415,47417,1,3,0
13602,4,1,47418,47418,47419,0,1,1
13603,5,1,47423,47423,47424,0,1,4
13604,5,1,47428,47428,47429,0,1,4
13605,2,2,47430,47430,47432,0,2,1
13606,6,1,47436,47436,47437,0,1,4
13607,1,3,47437,47437,47440,0,3,0
13608,1,1,47438,47440,47441,2,3,0
13609,2,2,47440,47441,47443,1,3,0
13610,3,3,47443,47443,47446,0,3,0
13611,3,1,47446,47446,47447,0,1,0
13612,4,3,47450,47450,47453,0,3,3
13613,2,3,47452,47453,47456,1,4,0
13614,5,3,47457,47457,47460,0,3,1
13615,1,3,47458,47460,47463,2,5,0
13616,6,1,47464,47464,47465,0,1,1
13617,5,3,47469,47469,47472,0,3,4
13618,2,2,47471,47472,47474,1,3,0
13619,1,3,47472,47474,47477,2,5,0
13620,5,3,47477,47477,47480,0,3,0
13621,6,3,47483,47483,47486,0,3,3
13622,1,3,47484,47486,47489,2,5,0
13623,1,3,47485,47489,47492,4,7,0
13624,3,2,47488,47492,47494,4,6,0
13625,5,2,47493,47494,47496,1,3,0
13626,6,2,47499,47499,47501,0,2,3
13627,1,3,47500,47501,47504,1,4,0
13628,6,2,47506,47506,47508,0,2,2
13629,6,3,47512,47512,47515,0,3,4
13630,5,1,47517,47517,47518,0,1,2
13631,6,3,47523,47523,47526,0,3,5
13632,1,3,47524,47526,47529,2,5,0
13633,6,1,47530,47530,47531,0,1,1
13634,2,3,47532,47532,47535,0,3,1
13635,5,3,47537,47537,47540,0,3,2
13636,3,2,47540,47540,47542,0,2,0
13637,1,2,47541,47542,47544,1,3,0
13638,2,3,47543,47544,47547,1,4,0
13639,5,1,47548,47548,47549,0,1,1
13640,5,1,47553,47553,47554,0,1,4
13641,6,2,47559,47559,47561,0,2,5
13642,3,2,47562,47562,47564,0,2,1
13643,1,1,47563,47564,47565,1,2,0
13644,6,1,47569,47569,47570,0,1,4
13645,5,1,47574,47574,47575,0,1,4
13646,3,3,47577,47577,47580,0,3,2
13647,6,1,47583,47583,47584,0,1,3
13648,6,2,47589,47589,47591,0,2,5
13649,4,1,47593,47593,47594,0,1,2
13650,5,1,47598,47598,47599,0,1,4
13651,1,2,47599,47599,47601,0,2,0
13652,3,3,47602,47602,47605,0,3,1
13653,2,2,47604,47605,47607,1,3,0
13654,2,2,47606,47607,47609,1,3,0
13655,3,3,47609,47609,47612,0,3,0
13656,4,2,47613,47613,47615,0,2,1
13657,5,3,47618,47618,47621,0,3,3
13658,2,3,47620,47621,47624,1,4,0
13659,4,2,47624,47624,47626,0,2,0
13660,5,1,47629,47629,47630,0,1,3
13661,3,2,47632,47632,47634,0,2,2
13662,3,2,47635,47635,47637,0,2,1
13663,4,2,47639,47639,47641,0,2,2
13664,2,2,47641,47641,47643,0,2,0
13665,1,1,47642,47643,47644,1,2,0
13666,2,3,47644,47644,47647,0,3,0
13667,2,1,47646,47647,47648,1,2,0
13668,1,1,47647,47648,47649,1,2,0
13669,4,1,47651,47651,47652,0,1,2
13670,6,1,47657,47657,47658,0,1,5
13671,1,3,47658,47658,47661,0,3,0
13672,3,1,47661,47661,47662,0,1,0
13673,6,1,47667,47667,47668,0,1,5
13674,6,3,47673,47673,47676,0,3,5
13675,2,3,47675,47676,47679,1,4,0
13676,5,1,47680,47680,47681,0,1,1
13677,2,2,47682,47682,47684,0,2,1
13678,3,3,47685,47685,47688,0,3,1
13679,2,3,47687,47688,47691,1,4,0
13680,4,3,47691,47691,47694,0,3,0
13681,3,1,47694,47694,47695,0,1,0
13682,1,2,47695,47695,47697,0,2,0
13683,6,2,47701,47701,47703,0,2,4
13684,6,3,47707,47707,47710,0,3,4
13685,3,3,47710,47710,47713,0,3,0
13686,3,1,47713,47713,47714,0,1,0
13687,6,1,47719,47719,47720,0,1,5
13688,4,1,47723,47723,47724,0,1,3
13689,4,2,47727,47727,47729,0,2,3
13690,2,2,47729,47729,47731,0,2,0
13691,3,2,47732,47732,47734,0,2,1
13692,3,1,47735,47735,47736,0,1,1
13693,5,1,47740,47740,47741,0,1,4
13694,2,3,47742,47742,47745,0,3,1
13695,3,3,47745,47745,47748,0,3,0
13696,2,1,47747,47748,47749,1,2,0
13697,4,1,47751,47751,47752,0,1,2
13698,3,2,47754,47754,47756,0,2,2
13699,2,2,47756,47756,47758,0,2,0
13700,5,1,47761,47761,47762,0,1,3
13701,1,3,47762,47762,47765,0,3,0
13702,3,2,47765,47765,47767,0,2,0
13703,1,1,47766,47767,47768,1,2,0
13704,4,2,47770,47770,47772,0,2,2
13705,1,1,47771,47772,47773,1,2,0
13706,6,3,47777,47777,47780,0,3,4
13707,6,1,47783,47783,47784,0,1,3
13708,6,2,47789,47789,47791,0,2,5
13709,6,1,47795,47795,47796,0,1,4
13710,1,1,47796,47796,47797,0,1,0
13711,4,2,47800,47800,47802,0,2,3
13712,3,1,47803,47803,47804,0,1,1
13713,5,3,47808,47808,47811,0,3,4
13714,4,1,47812,47812,47813,0,1,1
13715,4,3,47816,47816,47819,0,3,3
13716,6,2,47822,47822,47824,0,2,3
13717,5,3,47827,47827,47830,0,3,3
13718,2,2,47829,47830,47832,1,3,0
13719,6,3,47835,47835,47838,0,3,3
13720,5,3,47840,47840,47843,0,3,2
13721,3,3,47843,47843,47846,0,3,0
13722,4,2,47847,47847,47849,0,2,1
13723,5,1,47852,47852,47853,0,1,3
13724,4,1,47856,47856,47857,0,1,3
13725,1,1,47857,47857,47858,0,1,0
13726,6,3,47863,47863,47866,0,3,5
13727,5,3,47868,47868,47871,0,3,2
13728,1,1,47869,47871,47872,2,3,0
13729,2,1,47871,47872,47873,1,2,0
13730,2,1,47873,47873,47874,0,1,0
13731,1,1,47874,47874,47875,0,1,0
13732,2,3,47876,47876,47879,0,3,1
13733,5,2,47881,47881,47883,0,2,2
13734,1,3,47882,47883,47886,1,4,0
13735,2,1,47884,47886,47887,2,3,0
13736,6,1,47890,47890,47891,0,1,3
13737,3,1,47893,47893,47894,0,1,2
13738,2,2,47895,47895,47897,0,2,1
13739,6,1,47901,47901,47902,0,1,4
13740,5,3,47906,47906,47909,0,3,4
13741,5,3,47911,47911,47914,0,3,2
13742,2,1,47913,47914,47915,1,2,0
13743,1,3,47914,47915,47918,1,4,0
13744,1,2,47915,47918,47920,3,5,0
13745,5,2,47920,47920,47922,0,2,0
13746,4,1,47924,47924,47925,0,1,2
13747,1,1,47925,47925,47926,0,1,0
13748,6,1,47931,47931,47932,0,1,5
13749,5,1,47936,47936,47937,0,1,4
13750,1,1,47937,47937,47938,0,1,0
13751,1,2,47938,47938,47940,0,2,0
13752,1,3,47939,47940,47943,1,4,0
13753,4,2,47943,47943,47945,0,2,0
13754,1,2,47944,47945,47947,1,3,0
13755,1,3,47945,47947,47950,2,5,0
13756,6,3,47951,47951,47954,0,3,1
13757,4,2,47955,47955,47957,0,2,1
13758,1,3,47956,47957,47960,1,4,0
13759,2,3,47958,47960,47963,2,5,0
13760,3,1,47961,47963,47964,2,3,0
13761,6,2,47967,47967,47969,0,2,3
13762,5,1,47972,47972,47973,0,1,3
13763,2,3,47974,47974,47977,0,3,1
13764,6,3,47980,47980,47983,0,3,3
13765,5,3,47985,47985,47988,0,3,2
13766,1,3,47986,47988,47991,2,5,0
13767,5,1,47991,47991,47992,0,1,0
13768,5,2,47996,47996,47998,0,2,4
13769,5,3,48001,48001,48004,0,3,3
13770,4,3,48005,48005,48008,0,3,1
13771,1,2,48006,48008,48010,2,4,0
13772,3,1,48009,48010,48011,1,2,0
13773,6,3,48015,48015,48018,0,3,4
13774,2,3,48017,48018,48021,1,4,0
13775,1,1,48018,48021,48022,3,4,0
13776,4,3,48022,48022,48025,0,3,0
13777,5,2,48027,48027,48029,0,2,2
13778,2,3,48029,48029,48032,0,3,0
13779,5,3,48034,48034,48037,0,3,2
13780,3,2,48037,48037,48039,0,2,0
13781,2,3,48039,48039,48042,0,3,0
13782,6,1,48045,48045,48046,0,1,3
13783,5,3,48050,48050,48053,0,3,4
13784,2,3,48052,48053,48056,1,4,0
13785,6,3,48058,48058,48061,0,3,2
13786,2,2,48060,48061,48063,1,3,0
13787,3,1,48063,48063,48064,0,1,0
13788,1,2,48064,48064,48066,0,2,0
13789,3,1,48067,48067,48068,0,1,1
13790,4,3,48071,48071,48074,0,3,3
13791,4,1,48075,48075,48076,0,1,1
13792,4,2,48079,48079,48081,0,2,3
13793,3,1,48082,48082,48083,0,1,1
13794,6,2,48088,48088,48090,0,2,5
13795,4,2,48092,48092,48094,0,2,2
13796,1,3,48093,48094,48097,1,4,0
13797,5,1,48098,48098,48099,0,1,1
13798,4,1,48102,48102,48103,0,1,3
13799,5,1,48107,48107,48108,0,1,4
13800,5,2,48112,48112,48114,0,2,4
13801,1,1,48113,48114,48115,1,2,0
13802,6,3,48119,48119,48122,0,3,4
13803,1,3,48120,48122,48125,2,5,0
13804,5,3,48125,48125,48128,0,3,0
13805,5,2,48130,48130,48132,0,2,2
13806,3,2,48133,48133,48135,0,2,1
13807,5,3,48138,48138,48141,0,3,3
13808,4,1,48142,48142,48143,0,1,1
13809,4,3,48146,48146,48149,0,3,3
13810,4,2,48150,48150,48152,0,2,1
13811,6,2,48156,48156,48158,0,2,4
13812,1,3,48157,48158,48161,1,4,0
13813,6,3,48163,48163,48166,0,3,2
13814,4,2,48167,48167,48169,0,2,1
13815,2,1,48169,48169,48170,0,1,0
13816,6,2,48175,48175,48177,0,2,5
13817,5,2,48180,48180,48182,0,2,3
13818,3,2,48183,48183,48185,0,2,1
13819,6,3,48189,48189,48192,0,3,4
13820,4,3,48193,48193,48196,0,3,1
13821,6,3,48199,48199,48202,0,3,3
13822,4,3,48203,48203,48206,0,3,1
13823,6,1,48209,48209,48210,0,1,3
13824,5,3,48214,48214,48217,0,3,4
13825,3,2,48217,48217,48219,0,2,0
13826,5,3,48222,48222,48225,0,3,3
13827,5,2,48227,48227,48229,0,2,2
13828,6,2,48233,48233,48235,0,2,4
13829,3,3,48236,48236,48239,0,3,1
13830,2,2,48238,48239,48241,1,3,0
13831,3,2,48241,48241,48243,0,2,0
13832,4,2,48245,48245,48247,0,2,2
13833,4,2,48249,48249,48251,0,2,2
13834,5,2,48254,48254,48256,0,2,3
13835,5,3,48259,48259,48262,0,3,3
13836,5,2,48264,48264,48266,0,2,2
13837,3,1,48267,48267,48268,0,1,1
13838,5,1,48272,48272,48273,0,1,4
13839,2,1,48274,48274,48275,0,1,1
13840,2,3,48276,48276,48279,0,3,1
13841,1,3,48277,48279,48282,2,5,0
13842,3,1,48280,48282,48283,2,3,0
13843,4,3,48284,48284,48287,0,3,1
13844,2,2,48286,48287,48289,1,3,0
13845,6,2,48292,48292,48294,0,2,3
13846,2,2,48294,48294,48296,0,2,0
13847,2,3,48296,48296,48299,0,3,0
13848,3,1,48299,48299,48300,0,1,0
13849,3,3,48302,48302,48305,0,3,2
13850,3,3,48305,48305,48308,0,3,0
13851,5,1,48310,48310,48311,0,1,2
13852,2,1,48312,48312,48313,0,1,1
13853,5,3,48317,48317,48320,0,3,4
13854,1,3,48318,48320,48323,2,5,0
13855,4,1,48322,48323,48324,1,2,0
13856,1,2,48323,48324,48326,1,3,0
13857,5,3,48328,48328,48331,0,3,2
13858,4,2,48332,48332,48334,0,2,1
13859,6,3,48338,48338,48341,0,3,4
13860,1,3,48339,48341,48344,2,5,0
13861,2,2,48341,48344,48346,3,5,0
13862,3,3,48344,48346,48349,2,5,0
13863,2,3,48346,48349,48352,3,6,0
13864,2,2,48348,48352,48354,4,6,0
13865,2,2,48350,48354,48356,4,6,0
13866,5,1,48355,48356,48357,1,2,0
13867,2,1,48357,48357,48358,0,1,0
13868,4,2,48361,48361,48363,0,2,3
13869,6,3,48367,48367,48370,0,3,4
13870,1,3,48368,48370,48373,2,5,0
13871,6,2,48374,48374,48376,0,2,1
13872,1,2,48375,48376,48378,1,3,0
13873,2,1,48377,48378,48379,1,2,0
13874,4,2,48381,48381,48383,0,2,2
13875,4,2,48385,48385,48387,0,2,2
13876,2,3,48387,48387,48390,0,3,0
13877,4,1,48391,48391,48392,0,1,1
13878,3,2,48394,48394,48396,0,2,2
13879,3,3,48397,48397,48400,0,3,1
13880,1,1,48398,48400,48401,2,3,0
13881,4,3,48402,48402,48405,0,3,1
13882,2,2,48404,48405,48407,1,3,0
13883,6,3,48410,48410,48413,0,3,3
13884,1,2,48411,48413,48415,2,4,0
13885,3,2,48414,48415,48417,1,3,0
13886,1,3,48415,48417,48420,2,5,0
13887,5,1,48420,48420,48421,0,1,0
13888,3,2,48423,48423,48425,0,2,2
13889,3,2,48426,48426,48428,0,2,1
13890,5,3,48431,48431,48434,0,3,3
13891,6,2,48437,48437,48439,0,2,3
13892,3,1,48440,48440,48441,0,1,1
13893,2,1,48442,48442,48443,0,1,1
13894,4,2,48446,48446,48448,0,2,3
13895,3,1,48449,48449,48450,0,1,1
13896,5,2,48454,48454,48456,0,2,4
13897,6,2,48460,48460,48462,0,2,4
13898,4,3,48464,48464,48467,0,3,2
13899,1,2,48465,48467,48469,2,4,0
13900,6,1,48471,48471,48472,0,1,2
13901,4,3,48475,48475,48478,0,3,3
13902,4,2,48479,48479,48481,0,2,1
13903,2,3,48481,48481,48484,0,3,0
13904,5,1,48486,48486,48487,0,1,2
13905,1,1,48487,48487,48488,0,1,0
13906,3,1,48490,48490,48491,0,1,2
13907,5,2,48495,48495,48497,0,2,4
13908,3,3,48498,48498,48501,0,3,1
13909,3,1,48501,48501,48502,0,1,0
13910,5,2,48506,48506,48508,0,2,4
13911,5,3,48511,48511,48514,0,3,3
13912,4,2,48515,48515,48517,0,2,1
13913,1,3,48516,48517,48520,1,4,0
13914,4,3,48520,48520,48523,0,3,0
13915,6,3,48526,48526,48529,0,3,3
13916,4,1,48530,48530,48531,0,1,1
13917,1,1,48531,48531,48532,0,1,0
13918,3,2,48534,48534,48536,0,2,2
13919,6,2,48540,48540,48542,0,2,4
13920,5,2,48545,48545,48547,0,2,3
13921,5,2,48550,48550,48552,0,2,3
13922,6,1,48556,48556,48557,0,1,4
13923,4,3,48560,48560,48563,0,3,3
13924,1,1,48561,48563,48564,2,3,0
13925,1,3,48562,48564,48567,2,5,0
13926,1,3,48563,48567,48570,4,7,0
13927,4,2,48567,48570,48572,3,5,0
13928,2,3,48569,48572,48575,3,6,0
13929,1,1,48570,48575,48576,5,6,0
13930,2,2,48572,48576,48578,4,6,0
13931,4,2,48576,48578,48580,2,4,0
13932,2,1,48578,48580,48581,2,3,0
13933,6,3,48584,48584,48587,0,3,3
13934,5,2,48589,48589,48591,0,2,2
13935,2,2,48591,48591,48593,0,2,0
13936,4,2,48595,48595,48597,0,2,2
13937,4,3,48599,48599,48602,0,3,2
13938,2,2,48601,48602,48604,1,3,0
13939,2,2,48603,48604,48606,1,3,0
13940,1,3,48604,48606,48609,2,5,0
13941,3,1,48607,48609,48610,2,3,0
13942,6,3,48613,48613,48616,0,3,3
13943,5,1,48618,48618,48619,0,1,2
13944,6,2,48624,48624,48626,0,2,5
13945,2,3,48626,48626,48629,0,3,0
13946,4,1,48630,48630,48631,0,1,1
13947,5,2,48635,48635,48637,0,2,4
13948,4,2,48639,48639,48641,0,2,2
13949,4,1,48643,48643,48644,0,1,2
13950,2,1,48645,48645,48646,0,1,1
13951,5,3,48650,48650,48653,0,3,4
13952,1,3,48651,48653,48656,2,5,0
13953,1,1,48652,48656,48657,4,5,0
13954,6,2,48658,48658,48660,0,2,1
13955,6,1,48664,48664,48665,0,1,4
13956,6,1,48670,48670,48671,0,1,5
13957,4,1,48674,48674,48675,0,1,3
13958,4,2,48678,48678,48680,0,2,3
13959,1,3,48679,48680,48683,1,4,0
13960,2,3,48681,48683,48686,2,5,0
13961,6,2,48687,48687,48689,0,2,1
13962,2,3,48689,48689,48692,0,3,0
13963,5,2,48694,48694,48696,0,2,2
13964,1,2,48695,48696,48698,1,3,0
13965,2,3,48697,48698,48701,1,4,0
13966,5,1,48702,48702,48703,0,1,1
13967,5,1,48707,48707,48708,0,1,4
13968,2,2,48709,48709,48711,0,2,1
13969,4,1,48713,48713,48714,0,1,2
13970,6,3,48719,48719,48722,0,3,5
13971,5,3,48724,48724,48727,0,3,2
13972,6,1,48730,48730,48731,0,1,3
13973,6,1,48736,48736,48737,0,1,5
13974,1,1,48737,48737,48738,0,1,0
13975,3,1,48740,48740,48741,0,1,2
13976,4,1,48744,48744,48745,0,1,3
13977,1,2,48745,48745,48747,0,2,0
13978,3,3,48748,48748,48751,0,3,1
13979,2,1,48750,48751,48752,1,2,0
13980,1,1,48751,48752,48753,1,2,0
13981,6,2,48757,48757,48759,0,2,4
13982,6,2,48763,48763,48765,0,2,4
13983,6,2,48769,48769,48771,0,2,4
13984,2,2,48771,48771,48773,0,2,0
13985,2,3,48773,48773,48776,0,3,0
13986,1,3,48774,48776,48779,2,5,0
13987,5,2,48779,48779,48781,0,2,0
13988,4,1,48783,48783,48784,0,1,2
13989,2,3,48785,48785,48788,0,3,1
13990,1,3,48786,48788,48791,2,5,0
13991,5,3,48791,48791,48794,0,3,0
13992,5,3,48796,48796,48799,0,3,2
13993,6,2,48802,48802,48804,0,2,3
13994,3,3,48805,48805,48808,0,3,1
13995,2,3,48807,48808,48811,1,4,0
13996,1,1,48808,48811,48812,3,4,0
13997,5,1,48813,48813,48814,0,1,1
13998,1,1,48814,48814,48815,0,1,0
13999,4,1,48818,48818,48819,0,1,3
14000,3,2,48821,48821,48823,0,2,2
14001,6,1,48827,48827,48828,0,1,4
14002,5,1,48832,48832,48833,0,1,4
14003,4,2,48836,48836,48838,0,2,3
14004,3,2,48839,48839,48841,0,2,1
14005,3,1,48842,48842,48843,0,1,1
14006,2,2,48844,48844,48846,0,2,1
14007,3,1,48847,48847,48848,0,1,1
14008,4,1,48851,48851,48852,0,1,3
14009,1,1,48852,48852,48853,0,1,0
14010,4,2,48856,48856,48858,0,2,3
14011,2,3,48858,48858,48861,0,3,0
14012,1,1,48859,48861,48862,2,3,0
14013,4,2,48863,48863,48865,0,2,1
14014,3,2,48866,48866,48868,0,2,1
14015,2,3,48868,48868,48871,0,3,0
14016,1,3,48869,48871,48874,2,5,0
14017,5,1,48874,48874,48875,0,1,0
14018,2,3,48876,48876,48879,0,3,1
14019,2,1,48878,48879,48880,1,2,0
14020,3,3,48881,48881,48884,0,3,1
14021,4,2,48885,48885,48887,0,2,1
14022,6,3,48891,48891,48894,0,3,4
14023,1,1,48892,48894,48895,2,3,0
14024,1,3,48893,48895,48898,2,5,0
14025,6,1,48899,48899,48900,0,1,1
14026,2,2,48901,48901,48903,0,2,1
14027,5,3,48906,48906,48909,0,3,3
14028,4,1,48910,48910,48911,0,1,1
14029,3,2,48913,48913,48915,0,2,2
14030,2,3,48915,48915,48918,0,3,0
14031,6,3,48921,48921,48924,0,3,3
14032,3,2,48924,48924,48926,0,2,0
14033,3,2,48927,48927,48929,0,2,1
14034,5,2,48932,48932,48934,0,2,3
14035,6,1,48938,48938,48939,0,1,4
14036,2,3,48940,48940,48943,0,3,1
14037,3,1,48943,48943,48944,0,1,0
14038,3,3,48946,48946,48949,0,3,2
14039,3,2,48949,48949,48951,0,2,0
14040,6,2,48955,48955,48957,0,2,4
14041,1,2,48956,48957,48959,1,3,0
14042,5,3,48961,48961,48964,0,3,2
14043,1,2,48962,48964,48966,2,4,0
14044,3,2,48965,48966,48968,1,3,0
14045,6,1,48971,48971,48972,0,1,3
14046,6,1,48977,48977,48978,0,1,5
14047,6,2,48983,48983,48985,0,2,5
14048,3,1,48986,48986,48987,0,1,1
14049,4,3,48990,48990,48993,0,3,3
14050,4,1,48994,48994,48995,0,1,1
14051,3,1,48997,48997,48998,0,1,2
14052,4,3,49001,49001,49004,0,3,3
14053,6,3,49007,49007,49010,0,3,3
14054,1,1,49008,49010,49011,2,3,0
14055,1,1,49009,49011,49012,2,3,0
14056,3,2,49012,49012,49014,0,2,0
14057,1,3,49013,49014,49017,1,4,0
14058,3,1,49016,49017,49018,1,2,0
14059,6,1,49022,49022,49023,0,1,4
14060,3,1,49025,49025,49026,0,1,2
14061,5,1,49030,49030,49031,0,1,4
14062,6,1,49036,49036,49037,0,1,5
14063,5,2,49041,49041,49043,0,2,4
14064,5,3,49046,49046,49049,0,3,3
14065,1,3,49047,49049,49052,2,5,0
14066,3,3,49050,49052,49055,2,5,0
14067,4,3,49054,49055,49058,1,4,0
14068,4,3,49058,49058,49061,0,3,0
14069,6,2,49064,49064,49066,0,2,3
14070,4,1,49068,49068,49069,0,1,2
14071,4,1,49072,49072,49073,0,1,3
14072,4,2,49076,49076,49078,0,2,3
14073,6,2,49082,49082,49084,0,2,4
14074,2,3,49084,49084,49087,0,3,0
14075,1,2,49085,49087,49089,2,4,0
14076,5,3,49090,49090,49093,0,3,1
14077,2,1,49092,49093,49094,1,2,0
14078,6,2,49098,49098,49100,0,2,4
14079,2,3,49100,49100,49103,0,3,0
14080,6,1,49106,49106,49107,0,1,3
14081,1,3,49107,49107,49110,0,3,0
14082,6,2,49113,49113,49115,0,2,3
14083,5,1,49118,49118,49119,0,1,3
14084,3,3,49121,49121,49124,0,3,2
14085,1,1,49122,49124,49125,2,3,0
14086,6,1,49128,49128,49129,0,1,3
14087,3,3,49131,49131,49134,0,3,2
14088,2,3,49133,49134,49137,1,4,0
14089,2,1,49135,49137,49138,2,3,0
14090,2,2,49137,49138,49140,1,3,0
14091,6,3,49143,49143,49146,0,3,3
14092,3,2,49146,49146,49148,0,2,0
14093,4,1,49150,49150,49151,0,1,2
14094,6,2,49156,49156,49158,0,2,5
14095,4,1,49160,49160,49161,0,1,2
14096,5,1,49165,49165,49166,0,1,4
14097,6,2,49171,49171,49173,0,2,5
14098,1,1,49172,49173,49174,1,2,0
14099,6,1,49178,49178,49179,0,1,4
14100,1,3,49179,49179,49182,0,3,0
14101,5,2,49184,49184,49186,0,2,2
14102,1,1,49185,49186,49187,1,2,0
14103,3,3,49188,49188,49191,0,3,1
14104,1,2,49189,49191,49193,2,4,0
14105,1,2,49190,49193,49195,3,5,0
14106,5,1,49195,49195,49196,0,1,0
14107,3,3,49198,49198,49201,0,3,2
14108,3,1,49201,49201,49202,0,1,0
14109,5,2,49206,49206,49208,0,2,4
14110,3,1,49209,49209,49210,0,1,1
14111,6,2,49215,49215,49217,0,2,5
14112,1,3,49216,49217,49220,1,4,0
14113,1,3,49217,49220,49223,3,6,0
14114,6,1,49223,49223,49224,0,1,0
14115,2,1,49225,49225,49226,0,1,1
14116,5,2,49230,49230,49232,0,2,4
14117,1,2,49231,49232,49234,1,3,0
14118,4,1,49235,49235,49236,0,1,1
14119,5,1,49240,49240,49241,0,1,4
14120,6,2,49246,49246,49248,0,2,5
14121,4,1,49250,49250,49251,0,1,2
14122,4,3,49254,49254,49257,0,3,3
14123,3,1,49257,49257,49258,0,1,0
14124,5,1,49262,49262,49263,0,1,4
14125,6,2,49268,49268,49270,0,2,5
14126,4,3,49272,49272,49275,0,3,2
14127,5,3,49277,49277,49280,0,3,2
14128,2,2,49279,49280,49282,1,3,0
14129,3,2,49282,49282,49284,0,2,0
14130,1,3,49283,49284,49287,1,4,0
14131,3,1,49286,49287,49288,1,2,0
14132,2,1,49288,49288,49289,0,1,0
14133,6,3,49294,49294,49297,0,3,5
14134,5,2,49299,49299,49301,0,2,2
14135,6,2,49305,49305,49307,0,2,4
14136,2,2,49307,49307,49309,0,2,0
14137,2,3,49309,49309,49312,0,3,0
14138,1,3,49310,49312,49315,2,5,0
14139,1,1,49311,49315,49316,4,5,0
14140,3,2,49314,49316,49318,2,4,0
14141,1,1,49315,49318,49319,3,4,0
14142,2,2,49317,49319,49321,2,4,0
14143,4,1,49321,49321,49322,0,1,0
14144,6,1,49327,49327,49328,0,1,5
14145,1,2,49328,49328,49330,0,2,0
14146,1,3,49329,49330,49333,1,4,0
14147,3,1,49332,49333,49334,1,2,0
14148,2,3,49334,49334,49337,0,3,0
14149,1,1,49335,49337,49338,2,3,0
14150,1,2,49336,49338,49340,2,4,0
14151,3,3,49339,49340,49343,1,4,0
14152,6,3,49345,49345,49348,0,3,2
14153,6,3,49351,49351,49354,0,3,3
14154,3,2,49354,49354,49356,0,2,0
14155,2,1,49356,49356,49357,0,1,0
14156,4,3,49360,49360,49363,0,3,3
14157,2,3,49362,49363,49366,1,4,0
14158,4,1,49366,49366,49367,0,1,0
14159,2,1,49368,49368,49369,0,1,1
14160,1,3,49369,49369,49372,0,3,0
14161,2,3,49371,49372,49375,1,4,0
14162,4,3,49375,49375,49378,0,3,0
14163,4,1,49379,49379,49380,0,1,1
14164,5,3,49384,49384,49387,0,3,4
14165,2,1,49386,49387,49388,1,2,0
14166,3,2,49389,49389,49391,0,2,1
14167,2,3,49391,49391,49394,0,3,0
14168,1,3,49392,49394,49397,2,5,0
14169,2,3,49394,49397,49400,3,6,0
14170,6,1,49400,49400,49401,0,1,0
14171,1,2,49401,49401,49403,0,2,0
14172,1,1,49402,49403,49404,1,2,0
14173,3,2,49405,49405,49407,0,2,1
14174,3,3,49408,49408,49411,0,3,1
14175,2,1,49410,49411,49412,1,2,0
14176,3,1,49413,49413,49414,0,1,1
14177,4,2,49417,49417,49419,0,2,3
14178,4,1,49421,49421,49422,0,1,2
14179,6,1,49427,49427,49428,0,1,5
14180,4,3,49431,49431,49434,0,3,3
14181,5,1,49436,49436,49437,0,1,2
14182,4,1,49440,49440,49441,0,1,3
14183,2,1,49442,49442,49443,0,1,1
14184,1,1,49443,49443,49444,0,1,0
14185,4,1,49447,49447,49448,0,1,3
14186,6,3,49453,49453,49456,0,3,5
14187,3,1,49456,49456,49457,0,1,0
14188,2,3,49458,49458,49461,0,3,1
14189,6,3,49464,49464,49467,0,3,3
14190,1,3,49465,49467,49470,2,5,0
14191,1,1,49466,49470,49471,4,5,0
14192,5,2,49471,49471,49473,0,2,0
14193,2,1,49473,49473,49474,0,1,0
14194,4,2,49477,49477,49479,0,2,3
14195,1,1,49478,49479,49480,1,2,0
14196,6,3,49484,49484,49487,0,3,4
14197,1,2,49485,49487,49489,2,4,0
14198,1,1,49486,49489,49490,3,4,0
14199,2,1,49488,49490,49491,2,3,0
14200,5,3,49493,49493,49496,0,3,2
14201,3,1,49496,49496,49497,0,1,0
14202,3,3,49499,49499,49502,0,3,2
14203,4,3,49503,49503,49506,0,3,1
14204,6,1,49509,49509,49510,0,1,3
14205,5,3,49514,49514,49517,0,3,4
14206,4,1,49518,49518,49519,0,1,1
14207,1,3,49519,49519,49522,0,3,0
14208,4,3,49523,49523,49526,0,3,1
14209,5,3,49528,49528,49531,0,3,2
14210,5,2,49533,49533,49535,0,2,2
14211,4,1,49537,49537,49538,0,1,2
14212,2,1,49539,49539,49540,0,1,1
14213,4,1,49543,49543,49544,0,1,3
14214,2,2,49545,49545,49547,0,2,1
14215,5,3,49550,49550,49553,0,3,3
14216,5,3,49555,49555,49558,0,3,2
14217,2,1,49557,49558,49559,1,2,0
14218,3,2,49560,49560,49562,0,2,1
14219,2,1,49562,49562,49563,0,1,0
14220,4,1,49566,49566,49567,0,1,3
14221,3,3,49569,49569,49572,0,3,2
14222,5,3,49574,49574,49577,0,3,2
14223,1,2,49575,49577,49579,2,4,0
14224,5,1,49580,49580,49581,0,1,1
14225,4,3,49584,49584,49587,0,3,3
14226,4,3,49588,49588,49591,0,3,1
14227,6,2,49594,49594,49596,0,2,3
14228,2,2,49596,49596,49598,0,2,0
14229,6,3,49602,49602,49605,0,3,4
14230,2,3,49604,49605,49608,1,4,0
14231,2,2,49606,49608,49610,2,4,0
14232,5,3,49611,49611,49614,0,3,1
14233,2,2,49613,49614,49616,1,3,0
14234,5,1,49618,49618,49619,0,1,2
14235,6,3,49624,49624,49627,0,3,5
14236,1,3,49625,49627,49630,2,5,0
14237,6,2,49631,49631,49633,0,2,1
14238,4,2,49635,49635,49637,0,2,2
14239,2,3,49637,49637,49640,0,3,0
14240,1,1,49638,49640,49641,2,3,0
14241,3,2,49641,49641,49643,0,2,0
14242,5,1,49646,49646,49647,0,1,3
14243,1,2,49647,49647,49649,0,2,0
14244,2,1,49649,49649,49650,0,1,0
14245,5,3,49654,49654,49657,0,3,4
14246,4,1,49658,49658,49659,0,1,1
14247,6,3,49664,49664,49667,0,3,5
14248,1,2,49665,49667,49669,2,4,0
14249,1,1,49666,49669,49670,3,4,0
14250,5,1,49671,49671,49672,0,1,1
14251,1,3,49672,49672,49675,0,3,0
14252,2,3,49674,49675,49678,1,4,0
14253,3,3,49677,49678,49681,1,4,0
14254,2,3,49679,49681,49684,2,5,0
14255,4,2,49683,49684,49686,1,3,0
14256,1,3,49684,49686,49689,2,5,0
14257,1,2,49685,49689,49691,4,6,0
14258,3,1,49688,49691,49692,3,4,0
14259,3,3,49691,49692,49695,1,4,0
14260,3,1,49694,49695,49696,1,2,0
14261,1,2,49695,49696,49698,1,3,0
14262,5,1,49700,49700,49701,0,1,2
14263,2,3,49702,49702,49705,0,3,1
14264,1,2,49703,49705,49707,2,4,0
14265,3,3,49706,49707,49710,1,4,0
14266,1,3,49707,49710,49713,3,6,0
14267,2,2,49709,49713,49715,4,6,0
14268,1,2,49710,49715,49717,5,7,0
14269,2,3,49712,49717,49720,5,8,0
14270,5,3,49717,49720,49723,3,6,0
14271,1,3,49718,49723,49726,5,8,0
14272,3,3,49721,49726,49729,5,8,0
14273,4,3,49725,49729,49732,4,7,0
14274,1,3,49726,49732,49735,6,9,0
14275,5,3,49731,49735,49738,4,7,0
14276,6,3,49737,49738,49741,1,4,0
14277,3,3,49740,49741,49744,1,4,0
14278,4,3,49744,49744,49747,0,3,0
14279,2,2,49746,49747,49749,1,3,0
14280,5,1,49751,49751,49752,0,1,2
14281,1,1,49752,49752,49753,0,1,0
14282,3,3,49755,49755,49758,0,3,2
14283,3,3,49758,49758,49761,0,3,0
14284,2,1,49760,49761,49762,1,2,0
14285,5,1,49765,49765,49766,0,1,3
14286,6,1,49771,49771,49772,0,1,5
14287,4,3,49775,49775,49778,0,3,3
14288,4,1,49779,49779,49780,0,1,1
14289,2,2,49781,49781,49783,0,2,1
14290,6,3,49787,49787,49790,0,3,4
14291,1,1,49788,49790,49791,2,3,0
14292,5,2,49793,49793,49795,0,2,2
14293,5,1,49798,49798,49799,0,1,3
14294,4,3,49802,49802,49805,0,3,3
14295,6,3,49808,49808,49811,0,3,3
14296,2,2,49810,49811,49813,1,3,0
14297,6,1,49816,49816,49817,0,1,3
14298,1,1,49817,49817,49818,0,1,0
14299,5,3,49822,49822,49825,0,3,4
14300,3,3,49825,49825,49828,0,3,0
14301,4,1,49829,49829,49830,0,1,1
14302,5,3,49834,49834,49837,0,3,4
14303,2,2,49836,49837,49839,1,3,0
14304,1,3,49837,49839,49842,2,5,0
14305,6,1,49843,49843,49844,0,1,1
14306,6,3,49849,49849,49852,0,3,5
14307,4,2,49853,49853,49855,0,2,1
14308,5,2,49858,49858,49860,0,2,3
14309,1,3,49859,49860,49863,1,4,0
14310,1,1,49860,49863,49864,3,4,0
14311,1,3,49861,49864,49867,3,6,0
14312,2,1,49863,49867,49868,4,5,0
14313,3,3,49866,49868,49871,2,5,0
14314,4,1,49870,49871,49872,1,2,0
14315,5,1,49875,49875,49876,0,1,3
14316,1,3,49876,49876,49879,0,3,0
14317,6,3,49882,49882,49885,0,3,3
14318,5,3,49887,49887,49890,0,3,2
14319,1,1,49888,49890,49891,2,3,0
14320,1,1,49889,49891,49892,2,3,0
14321,6,1,49895,49895,49896,0,1,3
14322,4,3,49899,49899,49902,0,3,3
14323,4,1,49903,49903,49904,0,1,1
14324,4,2,49907,49907,49909,0,2,3
14325,6,2,49913,49913,49915,0,2,4
14326,1,1,49914,49915,49916,1,2,0
14327,6,3,49920,49920,49923,0,3,4
14328,3,2,49923,49923,49925,0,2,0
14329,5,1,49928,49928,49929,0,1,3
14330,3,2,49931,49931,49933,0,2,2
14331,6,2,49937,49937,49939,0,2,4
14332,1,1,49938,49939,49940,1,2,0
14333,2,2,49940,49940,49942,0,2,0
14334,4,2,49944,49944,49946,0,2,2
14335,4,1,49948,49948,49949,0,1,2
14336,3,3,49951,49951,49954,0,3,2
14337,4,3,49955,49955,49958,0,3,1
14338,5,3,49960,49960,49963,0,3,2
14339,5,3,49965,49965,49968,0,3,2
14340,5,3,49970,49970,49973,0,3,2
14341,1,2,49971,49973,49975,2,4,0
14342,1,2,49972,49975,49977,3,5,0
14343,5,3,49977,49977,49980,0,3,0
14344,1,2,49978,49980,49982,2,4,0
14345,5,3,49983,49983,49986,0,3,1
14346,1,3,49984,49986,49989,2,5,0
14347,3,2,49987,49989,49991,2,4,0
14348,1,2,49988,49991,49993,3,5,0
14349,5,1,49993,49993,49994,0,1,0
14350,2,3,49995,49995,49998,0,3,1
14351,2,2,49997,49998,50000,1,3,0
14352,1,3,49998,50000,50003,2,5,0
14353,2,2,50000,50003,50005,3,5,0
14354,1,3,50001,50005,50008,4,7,0
14355,3,1,50004,50008,50009,4,5,0
14356,5,1,50009,50009,50010,0,1,0
14357,3,3,50012,50012,50015,0,3,2
14358,3,3,50015,50015,50018,0,3,0
14359,4,2,50019,50019,50021,0,2,1
14360,5,3,50024,50024,50027,0,3,3
14361,3,2,50027,50027,50029,0,2,0
14362,2,3,50029,50029,50032,0,3,0
14363,5,1,50034,50034,50035,0,1,2
14364,6,1,50040,50040,50041,0,1,5
14365,1,2,50041,50041,50043,0,2,0
14366,1,1,50042,50043,50044,1,2,0
14367,1,3,50043,50044,50047,1,4,0
14368,4,1,50047,50047,50048,0,1,0
14369,4,3,50051,50051,50054,0,3,3
14370,6,3,50057,50057,50060,0,3,3
14371,2,2,50059,50060,50062,1,3,0
14372,2,2,50061,50062,50064,1,3,0
14373,5,2,50066,50066,50068,0,2,2
14374,4,2,50070,50070,50072,0,2,2
14375,5,3,50075,50075,50078,0,3,3
14376,6,1,50081,50081,50082,0,1,3
14377,3,2,50084,50084,50086,0,2,2
14378,3,3,50087,50087,50090,0,3,1
14379,5,3,50092,50092,50095,0,3,2
14380,2,1,50094,50095,50096,1,2,0
14381,6,1,50100,50100,50101,0,1,4
14382,1,3,50101,50101,50104,0,3,0
14383,1,3,50102,50104,50107,2,5,0
14384,1,2,50103,50107,50109,4,6,0
14385,3,3,50106,50109,50112,3,6,0
14386,4,2,50110,50112,50114,2,4,0
14387,2,3,50112,50114,50117,2,5,0
14388,2,3,50114,50117,50120,3,6,0
14389,5,1,50119,50120,50121,1,2,0
14390,1,3,50120,50121,50124,1,4,0
14391,5,1,50125,50125,50126,0,1,1
14392,1,3,50126,50126,50129,0,3,0
14393,5,2,50131,50131,50133,0,2,2
14394,4,3,50135,50135,50138,0,3,2
14395,1,2,50136,50138,50140,2,4,0
14396,3,3,50139,50140,50143,1,4,0
14397,2,1,50141,50143,50144,2,3,0
14398,5,1,50146,50146,50147,0,1,2
14399,3,2,50149,50149,50151,0,2,2
14400,3,3,50152,50152,50155,0,3,1
14401,1,1,50153,50155,50156,2,3,0
14402,3,2,50156,50156,50158,0,2,0
14403,3,3,50159,50159,50162,0,3,1
14404,5,1,50164,50164,50165,0,1,2
14405,4,1,50168,50168,50169,0,1,3
14406,1,2,50169,50169,50171,0,2,0
14407,4,2,50173,50173,50175,0,2,2
14408,6,1,50179,50179,50180,0,1,4
14409,3,3,50182,50182,50185,0,3,2
14410,6,1,50188,50188,50189,0,1,3
14411,6,2,50194,50194,50196,0,2,5
14412,3,1,50197,50197,50198,0,1,1
14413,6,3,50203,50203,50206,0,3,5
14414,2,1,50205,50206,50207,1,2,0
14415,5,2,50210,50210,50212,0,2,3
14416,4,3,50214,50214,50217,0,3,2
14417,4,2,50218,50218,50220,0,2,1
14418,4,2,50222,50222,50224,0,2,2
14419,1,3,50223,50224,50227,1,4,0
14420,5,3,50228,50228,50231,0,3,1
14421,1,3,50229,50231,50234,2,5,0
14422,3,2,50232,50234,50236,2,4,0
14423,4,1,50236,50236,50237,0,1,0
14424,5,2,50241,50241,50243,0,2,4
14425,2,2,50243,50243,50245,0,2,0
14426,5,2,50248,50248,50250,0,2,3
14427,3,2,50251,50251,50253,0,2,1
14428,2,3,50253,50253,50256,0,3,0
14429,4,1,50257,50257,50258,0,1,1
14430,6,2,50263,50263,50265,0,2,5
14431,4,2,50267,50267,50269,0,2,2
14432,5,3,50272,50272,50275,0,3,3
14433,2,1,50274,50275,50276,1,2,0
14434,5,1,50279,50279,50280,0,1,3
14435,5,1,50284,50284,50285,0,1,4
14436,1,1,50285,50285,50286,0,1,0
14437,5,1,50290,50290,50291,0,1,4
14438,1,2,50291,50291,50293,0,2,0
14439,2,3,50293,50293,50296,0,3,0
14440,2,1,50295,50296,50297,1,2,0
14441,5,3,50300,50300,50303,0,3,3
14442,3,1,50303,50303,50304,0,1,0
14443,6,1,50309,50309,50310,0,1,5
14444,1,2,50310,50310,50312,0,2,0
14445,6,3,50316,50316,50319,0,3,4
14446,3,3,50319,50319,50322,0,3,0
14447,2,2,50321,50322,50324,1,3,0
14448,4,1,50325,50325,50326,0,1,1
14449,1,2,50326,50326,50328,0,2,0
14450,2,3,50328,50328,50331,0,3,0
14451,4,1,50332,50332,50333,0,1,1
14452,6,2,50338,50338,50340,0,2,5
14453,6,2,50344,50344,50346,0,2,4
14454,6,1,50350,50350,50351,0,1,4
14455,4,1,50354,50354,50355,0,1,3
14456,1,2,50355,50355,50357,0,2,0
14457,5,2,50360,50360,50362,0,2,3
14458,6,2,50366,50366,50368,0,2,4
14459,6,1,50372,50372,50373,0,1,4
14460,3,2,50375,50375,50377,0,2,2
14461,1,2,50376,50377,50379,1,3,0
14462,1,3,50377,50379,50382,2,5,0
14463,5,1,50382,50382,50383,0,1,0
14464,4,1,50386,50386,50387,0,1,3
14465,3,2,50389,50389,50391,0,2,2
14466,5,3,50394,50394,50397,0,3,3
14467,2,2,50396,50397,50399,1,3,0
14468,5,2,50401,50401,50403,0,2,2
14469,2,2,50403,50403,50405,0,2,0
14470,6,2,50409,50409,50411,0,2,4
14471,3,1,50412,50412,50413,0,1,1
14472,3,2,50415,50415,50417,0,2,2
14473,6,1,50421,50421,50422,0,1,4
14474,6,2,50427,50427,50429,0,2,5
14475,2,2,50429,50429,50431,0,2,0
14476,2,2,50431,50431,50433,0,2,0
14477,4,2,50435,50435,50437,0,2,2
14478,6,1,50441,50441,50442,0,1,4
14479,6,3,50447,50447,50450,0,3,5
14480,3,3,50450,50450,50453,0,3,0
14481,1,2,50451,50453,50455,2,4,0
14482,3,3,50454,50455,50458,1,4,0
14483,3,2,50457,50458,50460,1,3,0
14484,6,2,50463,50463,50465,0,2,3
14485,6,2,50469,50469,50471,0,2,4
14486,2,2,50471,50471,50473,0,2,0
14487,3,2,50474,50474,50476,0,2,1
14488,2,2,50476,50476,50478,0,2,0
14489,1,3,50477,50478,50481,1,4,0
14490,2,3,50479,50481,50484,2,5,0
14491,4,2,50483,50484,50486,1,3,0
14492,5,2,50488,50488,50490,0,2,2
14493,3,2,50491,50491,50493,0,2,1
14494,3,3,50494,50494,50497,0,3,1
14495,3,3,50497,50497,50500,0,3,0
14496,5,3,50502,50502,50505,0,3,2
14497,4,3,50506,50506,50509,0,3,1
14498,3,2,50509,50509,50511,0,2,0
14499,3,1,50512,50512,50513,0,1,1
14500,5,1,50517,50517,50518,0,1,4
14501,2,1,50519,50519,50520,0,1,1
14502,4,1,50523,50523,50524,0,1,3
14503,2,3,50525,50525,50528,0,3,1
14504,6,2,50531,50531,50533,0,2,3
14505,3,3,50534,50534,50537,0,3,1
14506,5,2,50539,50539,50541,0,2,2
14507,6,3,50545,50545,50548,0,3,4
14508,6,2,50551,50551,50553,0,2,3
14509,1,3,50552,50553,50556,1,4,0
14510,6,3,50558,50558,50561,0,3,2
14511,4,3,50562,50562,50565,0,3,1
14512,2,1,50564,50565,50566,1,2,0
14513,6,2,50570,50570,50572,0,2,4
14514,6,1,50576,50576,50577,0,1,4
14515,3,2,50579,50579,50581,0,2,2
14516,6,3,50585,50585,50588,0,3,4
14517,5,1,50590,50590,50591,0,1,2
14518,4,3,50594,50594,50597,0,3,3
14519,1,1,50595,50597,50598,2,3,0
14520,1,2,50596,50598,50600,2,4,0
14521,2,2,50598,50600,50602,2,4,0
14522,2,1,50600,50602,50603,2,3,0
14523,1,3,50601,50603,50606,2,5,0
14524,6,1,50607,50607,50608,0,1,1
14525,3,2,50610,50610,50612,0,2,2
14526,1,2,50611,50612,50614,1,3,0
14527,3,2,50614,50614,50616,0,2,0
14528,3,3,50617,50617,50620,0,3,1
14529,1,1,50618,50620,50621,2,3,0
14530,1,2,50619,50621,50623,2,4,0
14531,3,3,50622,50623,50626,1,4,0
14532,6,1,50628,50628,50629,0,1,2
14533,1,2,50629,50629,50631,0,2,0
14534,4,3,50633,50633,50636,0,3,2
14535,3,2,50636,50636,50638,0,2,0
14536,1,3,50637,50638,50641,1,4,0
14537,2,3,50639,50641,50644,2,5,0
14538,5,2,50644,50644,50646,0,2,0
14539,6,3,50650,50650,50653,0,3,4
14540,4,1,50654,50654,50655,0,1,1
14541,1,2,50655,50655,50657,0,2,0
14542,6,1,50661,50661,50662,0,1,4
14543,6,3,50667,50667,50670,0,3,5
14544,5,1,50672,50672,50673,0,1,2
14545,5,2,50677,50677,50679,0,2,4
14546,4,1,50681,50681,50682,0,1,2
14547,3,3,50684,50684,50687,0,3,2
14548,4,3,50688,50688,50691,0,3,1
14549,5,2,50693,50693,50695,0,2,2
14550,2,1,50695,50695,50696,0,1,0
14551,4,1,50699,50699,50700,0,1,3
14552,3,1,50702,50702,50703,0,1,2
14553,5,3,50707,50707,50710,0,3,4
14554,2,1,50709,50710,50711,1,2,0
14555,1,1,50710,50711,50712,1,2,0
14556,5,3,50715,50715,50718,0,3,3
14557,5,1,50720,50720,50721,0,1,2
14558,1,1,50721,50721,50722,0,1,0
14559,4,1,50725,50725,50726,0,1,3
14560,6,2,50731,50731,50733,0,2,5
14561,3,2,50734,50734,50736,0,2,1
14562,4,3,50738,50738,50741,0,3,2
14563,5,2,50743,50743,50745,0,2,2
14564,5,2,50748,50748,50750,0,2,3
14565,6,3,50754,50754,50757,0,3,4
14566,4,2,50758,50758,50760,0,2,1
14567,3,1,50761,50761,50762,0,1,1
14568,1,1,50762,50762,50763,0,1,0
14569,3,2,50765,50765,50767,0,2,2
14570,1,2,50766,50767,50769,1,3,0
14571,3,1,50769,50769,50770,0,1,0
14572,2,3,50771,50771,50774,0,3,1
14573,1,1,50772,50774,50775,2,3,0
14574,4,2,50776,50776,50778,0,2,1
14575,2,3,50778,50778,50781,0,3,0
14576,1,2,50779,50781,50783,2,4,0
14577,6,2,50785,50785,50787,0,2,2
14578,3,1,50788,50788,50789,0,1,1
14579,4,1,50792,50792,50793,0,1,3
14580,6,2,50798,50798,50800,0,2,5
14581,5,1,50803,50803,50804,0,1,3
14582,4,2,50807,50807,50809,0,2,3
14583,1,2,50808,50809,50811,1,3,0
14584,2,3,50810,50811,50814,1,4,0
14585,1,3,50811,50814,50817,3,6,0
14586,6,1,50817,50817,50818,0,1,0
14587,5,2,50822,50822,50824,0,2,4
14588,4,1,50826,50826,50827,0,1,2
14589,2,2,50828,50828,50830,0,2,1
14590,5,2,50833,50833,50835,0,2,3
14591,1,1,50834,50835,50836,1,2,0
14592,3,3,50837,50837,50840,0,3,1
14593,6,3,50843,50843,50846,0,3,3
14594,2,1,50845,50846,50847,1,2,0
14595,6,1,50851,50851,50852,0,1,4
14596,3,2,50854,50854,50856,0,2,2
14597,4,2,50858,50858,50860,0,2,2
14598,5,2,50863,50863,50865,0,2,3
14599,4,3,50867,50867,50870,0,3,2
14600,2,3,50869,50870,50873,1,4,0
14601,2,1,50871,50873,50874,2,3,0
14602,5,1,50876,50876,50877,0,1,2
14603,6,2,50882,50882,50884,0,2,5
14604,2,1,50884,50884,50885,0,1,0
14605,3,3,50887,50887,50890,0,3,2
14606,2,1,50889,50890,50891,1,2,0
14607,1,1,50890,50891,50892,1,2,0
14608,2,1,50892,50892,50893,0,1,0
14609,1,3,50893,50893,50896,0,3,0
14610,2,3,50895,50896,50899,1,4,0
14611,4,3,50899,50899,50902,0,3,0
14612,3,2,50902,50902,50904,0,2,0
14613,3,1,50905,50905,50906,0,1,1
14614,4,3,50909,50909,50912,0,3,3
14615,6,3,50915,50915,50918,0,3,3
14616,2,1,50917,50918,50919,1,2,0
14617,1,1,50918,50919,50920,1,2,0
14618,6,1,50924,50924,50925,0,1,4
14619,6,2,50930,50930,50932,0,2,5
14620,3,2,50933,50933,50935,0,2,1
14621,1,2,50934,50935,50937,1,3,0
14622,5,1,50939,50939,50940,0,1,2
14623,2,2,50941,50941,50943,0,2,1
14624,4,1,50945,50945,50946,0,1,2
14625,4,2,50949,50949,50951,0,2,3
14626,3,1,50952,50952,50953,0,1,1
14627,4,2,50956,50956,50958,0,2,3
14628,5,2,50961,50961,50963,0,2,3
14629,5,2,50966,50966,50968,0,2,3
14630,5,1,50971,50971,50972,0,1,3
14631,3,1,50974,50974,50975,0,1,2
14632,1,2,50975,50975,50977,0,2,0
14633,1,3,50976,50977,50980,1,4,0
14634,3,3,50979,50980,50983,1,4,0
14635,5,1,50984,50984,50985,0,1,1
14636,4,3,50988,50988,50991,0,3,3
14637,5,1,50993,50993,50994,0,1,2
14638,2,3,50995,50995,50998,0,3,1
14639,4,3,50999,50999,51002,0,3,1
14640,2,3,51001,51002,51005,1,4,0
14641,6,3,51007,51007,51010,0,3,2
14642,2,2,51009,51010,51012,1,3,0
14643,2,3,51011,51012,51015,1,4,0
14644,6,1,51017,51017,51018,0,1,2
14645,6,2,51023,51023,51025,0,2,5
14646,5,3,51028,51028,51031,0,3,3
14647,5,1,51033,51033,51034,0,1,2
14648,2,3,51035,51035,51038,0,3,1
14649,1,2,51036,51038,51040,2,4,0
14650,1,2,51037,51040,51042,3,5,0
14651,6,1,51043,51043,51044,0,1,1
14652,6,1,51049,51049,51050,0,1,5
14653,6,3,51055,51055,51058,0,3,5
14654,2,1,51057,51058,51059,1,2,0
14655,2,2,51059,51059,51061,0,2,0
14656,4,1,51063,51063,51064,0,1,2
14657,1,3,51064,51064,51067,0,3,0
14658,4,2,51068,51068,51070,0,2,1
14659,1,2,51069,51070,51072,1,3,0
14660,2,1,51071,51072,51073,1,2,0
14661,6,2,51077,51077,51079,0,2,4
14662,4,1,51081,51081,51082,0,1,2
14663,1,1,51082,51082,51083,0,1,0
14664,3,1,51085,51085,51086,0,1,2
14665,5,2,51090,51090,51092,0,2,4
14666,5,1,51095,51095,51096,0,1,3
14667,4,1,51099,51099,51100,0,1,3
14668,2,3,51101,51101,51104,0,3,1
14669,1,2,51102,51104,51106,2,4,0
14670,4,3,51106,51106,51109,0,3,0
14671,4,2,51110,51110,51112,0,2,1
14672,1,2,51111,51112,51114,1,3,0
14673,1,3,51112,51114,51117,2,5,0
14674,6,3,51118,51118,51121,0,3,1
14675,5,2,51123,51123,51125,0,2,2
14676,3,2,51126,51126,51128,0,2,1
14677,6,1,51132,51132,51133,0,1,4
14678,6,2,51138,51138,51140,0,2,5
14679,5,3,51143,51143,51146,0,3,3
14680,4,3,51147,51147,51150,0,3,1
14681,5,2,51152,51152,51154,0,2,2
14682,5,1,51157,51157,51158,0,1,3
14683,5,3,51162,51162,51165,0,3,4
14684,2,2,51164,51165,51167,1,3,0
14685,6,1,51170,51170,51171,0,1,3
14686,3,3,51173,51173,51176,0,3,2
14687,4,1,51177,51177,51178,0,1,1
14688,1,2,51178,51178,51180,0,2,0
14689,1,3,51179,51180,51183,1,4,0
14690,3,2,51182,51183,51185,1,3,0
14691,4,2,51186,51186,51188,0,2,1
14692,2,1,51188,51188,51189,0,1,0
14693,5,2,51193,51193,51195,0,2,4
14694,2,1,51195,51195,51196,0,1,0
14695,2,3,51197,51197,51200,0,3,1
14696,6,1,51203,51203,51204,0,1,3
14697,5,2,51208,51208,51210,0,2,4
14698,1,3,51209,51210,51213,1,4,0
14699,3,3,51212,51213,51216,1,4,0
14700,2,3,51214,51216,51219,2,5,0
14701,4,1,51218,51219,51220,1,2,0
14702,4,2,51222,51222,51224,0,2,2
14703,5,2,51227,51227,51229,0,2,3
14704,1,2,51228,51229,51231,1,3,0
14705,5,2,51233,51233,51235,0,2,2
14706,4,2,51237,51237,51239,0,2,2
14707,6,1,51243,51243,51244,0,1,4
14708,2,3,51245,51245,51248,0,3,1
14709,5,1,51250,51250,51251,0,1,2
14710,5,2,51255,51255,51257,0,2,4
14711,2,1,51257,51257,51258,0,1,0
14712,2,2,51259,51259,51261,0,2,1
14713,6,1,51265,51265,51266,0,1,4
14714,3,3,51268,51268,51271,0,3,2
14715,3,2,51271,51271,51273,0,2,0
14716,4,2,51275,51275,51277,0,2,2
14717,3,2,51278,51278,51280,0,2,1
14718,6,2,51284,51284,51286,0,2,4
14719,3,3,51287,51287,51290,0,3,1
14720,6,3,51293,51293,51296,0,3,3
14721,5,1,51298,51298,51299,0,1,2
14722,3,1,51301,51301,51302,0,1,2
14723,6,1,51307,51307,51308,0,1,5
14724,2,1,51309,51309,51310,0,1,1
14725,3,3,51312,51312,51315,0,3,2
14726,1,2,51313,51315,51317,2,4,0
14727,2,1,51315,51317,51318,2,3,0
14728,4,2,51319,51319,51321,0,2,1
14729,5,2,51324,51324,51326,0,2,3
14730,1,3,51325,51326,51329,1,4,0
14731,6,2,51331,51331,51333,0,2,2
14732,4,2,51335,51335,51337,0,2,2
14733,2,1,51337,51337,51338,0,1,0
14734,5,1,51342,51342,51343,0,1,4
14735,5,3,51347,51347,51350,0,3,4
14736,2,1,51349,51350,51351,1,2,0
14737,4,3,51353,51353,51356,0,3,2
14738,6,2,51359,51359,51361,0,2,3
14739,3,2,51362,51362,51364,0,2,1
14740,4,3,51366,51366,51369,0,3,2
14741,1,3,51367,51369,51372,2,5,0
14742,2,1,51369,51372,51373,3,4,0
14743,2,3,51371,51373,51376,2,5,0
14744,6,2,51377,51377,51379,0,2,1
14745,4,1,51381,51381,51382,0,1,2
14746,2,1,51383,51383,51384,0,1,1
14747,6,3,51389,51389,51392,0,3,5
14748,5,2,51394,51394,51396,0,2,2
14749,5,1,51399,51399,51400,0,1,3
14750,1,3,51400,51400,51403,0,3,0
14751,4,2,51404,51404,51406,0,2,1
14752,1,3,51405,51406,51409,1,4,0
14753,5,1,51410,51410,51411,0,1,1
14754,6,1,51416,51416,51417,0,1,5
14755,4,3,51420,51420,51423,0,3,3
14756,3,2,51423,51423,51425,0,2,0
14757,4,3,51427,51427,51430,0,3,2
14758,5,2,51432,51432,51434,0,2,2
14759,6,3,51438,51438,51441,0,3,4
14760,3,2,51441,51441,51443,0,2,0
14761,5,2,51446,51446,51448,0,2,3
14762,6,2,51452,51452,51454,0,2,4
14763,5,2,51457,51457,51459,0,2,3
14764,1,3,51458,51459,51462,1,4,0
14765,5,2,51463,51463,51465,0,2,1
14766,3,2,51466,51466,51468,0,2,1
14767,4,3,51470,51470,51473,0,3,2
14768,4,1,51474,51474,51475,0,1,1
14769,5,2,51479,51479,51481,0,2,4
14770,6,3,51485,51485,51488,0,3,4
14771,5,3,51490,51490,51493,0,3,2
14772,2,1,51492,51493,51494,1,2,0
14773,2,2,51494,51494,51496,0,2,0
14774,5,2,51499,51499,51501,0,2,3
14775,5,3,51504,51504,51507,0,3,3
14776,5,3,51509,51509,51512,0,3,2
14777,4,3,51513,51513,51516,0,3,1
14778,1,2,51514,51516,51518,2,4,0
14779,6,2,51520,51520,51522,0,2,2
14780,5,2,51525,51525,51527,0,2,3
14781,6,3,51531,51531,51534,0,3,4
14782,1,1,51532,51534,51535,2,3,0
14783,2,3,51534,51535,51538,1,4,0
14784,3,3,51537,51538,51541,1,4,0
14785,4,2,51541,51541,51543,0,2,0
14786,3,1,51544,51544,51545,0,1,1
14787,2,1,51546,51546,51547,0,1,1
14788,4,3,51550,51550,51553,0,3,3
14789,5,2,51555,51555,51557,0,2,2
14790,6,1,51561,51561,51562,0,1,4
14791,6,3,51567,51567,51570,0,3,5
14792,5,1,51572,51572,51573,0,1,2
14793,4,1,51576,51576,51577,0,1,3
14794,3,2,51579,51579,51581,0,2,2
14795,3,3,51582,51582,51585,0,3,1
14796,5,3,51587,51587,51590,0,3,2
14797,1,2,51588,51590,51592,2,4,0
14798,3,3,51591,51592,51595,1,4,0
14799,1,1,51592,51595,51596,3,4,0
14800,3,2,51595,51596,51598,1,3,0
14801,6,1,51601,51601,51602,0,1,3
14802,2,3,51603,51603,51606,0,3,1
14803,1,3,51604,51606,51609,2,5,0
14804,4,1,51608,51609,51610,1,2,0
14805,5,1,51613,51613,51614,0,1,3
14806,2,2,51615,51615,51617,0,2,1
14807,1,2,51616,51617,51619,1,3,0
14808,5,3,51621,51621,51624,0,3,2
14809,3,2,51624,51624,51626,0,2,0
14810,4,3,51628,51628,51631,0,3,2
14811,1,3,51629,51631,51634,2,5,0
14812,5,1,51634,51634,51635,0,1,0
14813,6,2,51640,51640,51642,0,2,5
14814,2,1,51642,51642,51643,0,1,0
14815,2,3,51644,51644,51647,0,3,1
14816,2,3,51646,51647,51650,1,4,0
14817,2,1,51648,51650,51651,2,3,0
14818,1,3,51649,51651,51654,2,5,0
14819,1,3,51650,51654,51657,4,7,0
14820,3,1,51653,51657,51658,4,5,0
14821,5,1,51658,51658,51659,0,1,0
14822,2,2,51660,51660,51662,0,2,1
14823,4,2,51664,51664,51666,0,2,2
14824,2,2,51666,51666,51668,0,2,0
14825,6,3,51672,51672,51675,0,3,4
14826,5,2,51677,51677,51679,0,2,2
14827,3,1,51680,51680,51681,0,1,1
14828,6,1,51686,51686,51687,0,1,5
14829,5,3,51691,51691,51694,0,3,4
14830,3,3,51694,51694,51697,0,3,0
14831,6,3,51700,51700,51703,0,3,3
14832,5,1,51705,51705,51706,0,1,2
14833,2,3,51707,51707,51710,0,3,1
14834,3,1,51710,51710,51711,0,1,0
14835,1,1,51711,51711,51712,0,1,0
14836,3,1,51714,51714,51715,0,1,2
14837,6,2,51720,51720,51722,0,2,5
14838,1,2,51721,51722,51724,1,3,0
14839,1,2,51722,51724,51726,2,4,0
14840,6,3,51728,51728,51731,0,3,2
14841,6,3,51734,51734,51737,0,3,3
14842,4,1,51738,51738,51739,0,1,1
14843,1,2,51739,51739,51741,0,2,0
14844,1,3,51740,51741,51744,1,4,0
14845,6,1,51746,51746,51747,0,1,2
14846,4,3,51750,51750,51753,0,3,3
14847,3,1,51753,51753,51754,0,1,0
14848,6,2,51759,51759,51761,0,2,5
14849,6,1,51765,51765,51766,0,1,4
14850,1,2,51766,51766,51768,0,2,0
14851,3,2,51769,51769,51771,0,2,1
14852,1,3,51770,51771,51774,1,4,0
14853,5,3,51775,51775,51778,0,3,1
14854,3,2,51778,51778,51780,0,2,0
14855,5,2,51783,51783,51785,0,2,3
14856,6,3,51789,51789,51792,0,3,4
14857,1,2,51790,51792,51794,2,4,0
14858,6,3,51796,51796,51799,0,3,2
14859,6,2,51802,51802,51804,0,2,3
14860,4,1,51806,51806,51807,0,1,2
14861,2,1,51808,51808,51809,0,1,1
14862,3,2,51811,51811,51813,0,2,2
14863,5,2,51816,51816,51818,0,2,3
14864,4,1,51820,51820,51821,0,1,2
14865,4,3,51824,51824,51827,0,3,3
14866,1,3,51825,51827,51830,2,5,0
14867,1,1,51826,51830,51831,4,5,0
14868,4,1,51830,51831,51832,1,2,0
14869,2,2,51832,51832,51834,0,2,0
14870,4,1,51836,51836,51837,0,1,2
14871,4,2,51840,51840,51842,0,2,3
14872,1,3,51841,51842,51845,1,4,0
14873,6,2,51847,51847,51849,0,2,2
14874,3,1,51850,51850,51851,0,1,1
14875,1,2,51851,51851,51853,0,2,0
14876,1,2,51852,51853,51855,1,3,0
14877,5,1,51857,51857,51858,0,1,2
14878,4,1,51861,51861,51862,0,1,3
14879,2,2,51863,51863,51865,0,2,1
14880,2,3,51865,51865,51868,0,3,0
14881,5,2,51870,51870,51872,0,2,2
14882,5,3,51875,51875,51878,0,3,3
14883,1,1,51876,51878,51879,2,3,0
14884,3,3,51879,51879,51882,0,3,0
14885,6,3,51885,51885,51888,0,3,3
14886,4,2,51889,51889,51891,0,2,1
14887,5,1,51894,51894,51895,0,1,3
14888,3,3,51897,51897,51900,0,3,2
14889,3,3,51900,51900,51903,0,3,0
14890,5,1,51905,51905,51906,0,1,2
14891,2,3,51907,51907,51910,0,3,1
14892,4,1,51911,51911,51912,0,1,1
14893,3,1,51914,51914,51915,0,1,2
14894,4,1,51918,51918,51919,0,1,3
14895,5,1,51923,51923,51924,0,1,4
14896,2,3,51925,51925,51928,0,3,1
14897,4,3,51929,51929,51932,0,3,1
14898,6,3,51935,51935,51938,0,3,3
14899,2,3,51937,51938,51941,1,4,0
14900,3,1,51940,51941,51942,1,2,0
14901,5,2,51945,51945,51947,0,2,3
14902,6,1,51951,51951,51952,0,1,4
14903,3,3,51954,51954,51957,0,3,2
14904,1,3,51955,51957,51960,2,5,0
14905,6,2,51961,51961,51963,0,2,1
14906,5,2,51966,51966,51968,0,2,3
14907,6,2,51972,51972,51974,0,2,4
14908,2,1,51974,51974,51975,0,1,0
14909,4,2,51978,51978,51980,0,2,3
14910,5,2,51983,51983,51985,0,2,3
14911,4,3,51987,51987,51990,0,3,2
14912,1,3,51988,51990,51993,2,5,0
14913,5,2,51993,51993,51995,0,2,0
14914,1,2,51994,51995,51997,1,3,0
14915,5,2,51999,51999,52001,0,2,2
14916,3,2,52002,52002,52004,0,2,1
14917,5,1,52007,52007,52008,0,1,3
14918,5,2,52012,52012,52014,0,2,4
14919,4,3,52016,52016,52019,0,3,2
14920,5,3,52021,52021,52024,0,3,2
14921,2,3,52023,52024,52027,1,4,0
14922,1,1,52024,52027,52028,3,4,0
14923,4,1,52028,52028,52029,0,1,0
14924,6,2,52034,52034,52036,0,2,5
14925,6,3,52040,52040,52043,0,3,4
14926,6,1,52046,52046,52047,0,1,3
14927,5,1,52051,52051,52052,0,1,4
14928,4,2,52055,52055,52057,0,2,3
14929,4,1,52059,52059,52060,0,1,2
14930,1,3,52060,52060,52063,0,3,0
14931,4,3,52064,52064,52067,0,3,1
14932,4,1,52068,52068,52069,0,1,1
14933,5,1,52073,52073,52074,0,1,4
14934,1,2,52074,52074,52076,0,2,0
14935,5,1,52079,52079,52080,0,1,3
14936,5,1,52084,52084,52085,0,1,4
14937,3,2,52087,52087,52089,0,2,2
14938,5,3,52092,52092,52095,0,3,3
14939,1,3,52093,52095,52098,2,5,0
14940,6,1,52099,52099,52100,0,1,1
14941,6,1,52105,52105,52106,0,1,5
14942,4,3,52109,52109,52112,0,3,3
14943,2,1,52111,52112,52113,1,2,0
14944,2,2,52113,52113,52115,0,2,0
14945,2,3,52115,52115,52118,0,3,0
14946,1,3,52116,52118,52121,2,5,0
14947,5,2,52121,52121,52123,0,2,0
14948,4,2,52125,52125,52127,0,2,2
14949,3,1,52128,52128,52129,0,1,1
14950,4,3,52132,52132,52135,0,3,3
14951,4,1,52136,52136,52137,0,1,1
14952,6,1,52142,52142,52143,0,1,5
14953,1,2,52143,52143,52145,0,2,0
14954,3,2,52146,52146,52148,0,2,1
14955,2,1,52148,52148,52149,0,1,0
14956,2,1,52150,52150,52151,0,1,1
14957,6,2,52156,52156,52158,0,2,5
14958,3,2,52159,52159,52161,0,2,1
14959,6,1,52165,52165,52166,0,1,4
14960,3,3,52168,52168,52171,0,3,2
14961,2,3,52170,52171,52174,1,4,0
14962,5,3,52175,52175,52178,0,3,1
14963,4,3,52179,52179,52182,0,3,1
14964,4,1,52183,52183,52184,0,1,1
14965,4,2,52187,52187,52189,0,2,3
14966,2,1,52189,52189,52190,0,1,0
14967,6,3,52195,52195,52198,0,3,5
14968,6,3,52201,52201,52204,0,3,3
14969,4,3,52205,52205,52208,0,3,1
14970,2,2,52207,52208,52210,1,3,0
14971,3,1,52210,52210,52211,0,1,0
14972,2,2,52212,52212,52214,0,2,1
14973,1,1,52213,52214,52215,1,2,0
14974,4,1,52217,52217,52218,0,1,2
14975,2,1,52219,52219,52220,0,1,1
14976,1,2,52220,52220,52222,0,2,0
14977,2,2,52222,52222,52224,0,2,0
14978,2,2,52224,52224,52226,0,2,0
14979,6,2,52230,52230,52232,0,2,4
14980,3,3,52233,52233,52236,0,3,1
14981,4,1,52237,52237,52238,0,1,1
14982,5,3,52242,52242,52245,0,3,4
14983,5,3,52247,52247,52250,0,3,2
14984,5,3,52252,52252,52255,0,3,2
14985,5,3,52257,52257,52260,0,3,2
14986,2,1,52259,52260,52261,1,2,0
14987,5,2,52264,52264,52266,0,2,3
14988,2,2,52266,52266,52268,0,2,0
14989,2,1,52268,52268,52269,0,1,0
14990,2,2,52270,52270,52272,0,2,1
14991,6,2,52276,52276,52278,0,2,4
14992,2,3,52278,52278,52281,0,3,0
14993,3,3,52281,52281,52284,0,3,0
14994,3,3,52284,52284,52287,0,3,0
14995,3,1,52287,52287,52288,0,1,0
14996,3,1,52290,52290,52291,0,1,2
14997,5,2,52295,52295,52297,0,2,4
14998,4,3,52299,52299,52302,0,3,2
14999,6,3,52305,52305,52308,0,3,3
15000,1,2,52306,52308,52310,2,4,0
15001,5,1,52311,52311,52312,0,1,1
15002,1,3,52312,52312,52315,0,3,0
15003,6,1,52318,52318,52319,0,1,3
15004,3,2,52321,52321,52323,0,2,2
15005,6,1,52327,52327,52328,0,1,4
15006,6,2,52333,52333,52335,0,2,5
15007,1,2,52334,52335,52337,1,3,0
15008,6,3,52340,52340,52343,0,3,3
15009,3,1,52343,52343,52344,0,1,0
15010,5,3,52348,52348,52351,0,3,4
15011,3,3,52351,52351,52354,0,3,0
15012,5,2,52356,52356,52358,0,2,2
15013,5,3,52361,52361,52364,0,3,3
15014,6,2,52367,52367,52369,0,2,3
15015,6,1,52373,52373,52374,0,1,4
15016,1,1,52374,52374,52375,0,1,0
15017,2,1,52376,52376,52377,0,1,1
15018,2,2,52378,52378,52380,0,2,1
15019,6,1,52384,52384,52385,0,1,4
15020,2,3,52386,52386,52389,0,3,1
15021,5,1,52391,52391,52392,0,1,2
15022,3,3,52394,52394,52397,0,3,2
15023,1,1,52395,52397,52398,2,3,0
15024,4,3,52399,52399,52402,0,3,1
15025,5,3,52404,52404,52407,0,3,2
15026,4,2,52408,52408,52410,0,2,1
15027,2,2,52410,52410,52412,0,2,0
15028,2,2,52412,52412,52414,0,2,0
15029,3,1,52415,52415,52416,0,1,1
15030,1,1,52416,52416,52417,0,1,0
15031,6,1,52422,52422,52423,0,1,5
15032,6,2,52428,52428,52430,0,2,5
15033,5,1,52433,52433,52434,0,1,3
15034,1,1,52434,52434,52435,0,1,0
15035,6,3,52440,52440,52443,0,3,5
15036,4,1,52444,52444,52445,0,1,1
15037,6,2,52450,52450,52452,0,2,5
15038,6,3,52456,52456,52459,0,3,4
15039,5,3,52461,52461,52464,0,3,2
15040,4,2,52465,52465,52467,0,2,1
15041,6,3,52471,52471,52474,0,3,4
15042,6,3,52477,52477,52480,0,3,3
15043,5,1,52482,52482,52483,0,1,2
15044,1,1,52483,52483,52484,0,1,0
15045,2,3,52485,52485,52488,0,3,1
15046,3,3,52488,52488,52491,0,3,0
15047,4,2,52492,52492,52494,0,2,1
15048,5,3,52497,52497,52500,0,3,3
15049,3,1,52500,52500,52501,0,1,0
15050,4,2,52504,52504,52506,0,2,3
15051,1,3,52505,52506,52509,1,4,0
15052,6,1,52511,52511,52512,0,1,2
15053,3,3,52514,52514,52517,0,3,2
15054,1,1,52515,52517,52518,2,3,0
15055,2,2,52517,52518,52520,1,3,0
15056,1,1,52518,52520,52521,2,3,0
15057,5,2,52523,52523,52525,0,2,2
15058,3,1,52526,52526,52527,0,1,1
15059,6,2,52532,52532,52534,0,2,5
15060,2,3,52534,52534,52537,0,3,0
15061,6,1,52540,52540,52541,0,1,3
15062,2,3,52542,52542,52545,0,3,1
15063,1,2,52543,52545,52547,2,4,0
15064,1,1,52544,52547,52548,3,4,0
15065,2,2,52546,52548,52550,2,4,0
15066,5,3,52551,52551,52554,0,3,1
15067,4,2,52555,52555,52557,0,2,1
15068,4,2,52559,52559,52561,0,2,2
15069,3,3,52562,52562,52565,0,3,1
15070,2,3,52564,52565,52568,1,4,0
15071,2,2,52566,52568,52570,2,4,0
15072,1,1,52567,52570,52571,3,4,0
15073,6,1,52573,52573,52574,0,1,2
15074,1,1,52574,52574,52575,0,1,0
15075,6,3,52580,52580,52583,0,3,5
15076,6,1,52586,52586,52587,0,1,3
15077,6,1,52592,52592,52593,0,1,5
15078,2,1,52594,52594,52595,0,1,1
15079,5,2,52599,52599,52601,0,2,4
15080,4,1,52603,52603,52604,0,1,2
15081,6,2,52609,52609,52611,0,2,5
15082,3,1,52612,52612,52613,0,1,1
15083,6,3,52618,52618,52621,0,3,5
15084,6,1,52624,52624,52625,0,1,3
15085,1,2,52625,52625,52627,0,2,0
15086,4,2,52629,52629,52631,0,2,2
15087,3,1,52632,52632,52633,0,1,1
15088,6,3,52638,52638,52641,0,3,5
15089,3,2,52641,52641,52643,0,2,0
15090,5,3,52646,52646,52649,0,3,3
15091,1,3,52647,52649,52652,2,5,0
15092,6,3,52653,52653,52656,0,3,1
15093,5,1,52658,52658,52659,0,1,2
15094,6,3,52664,52664,52667,0,3,5
15095,2,2,52666,52667,52669,1,3,0
15096,5,2,52671,52671,52673,0,2,2
15097,5,2,52676,52676,52678,0,2,3
15098,5,1,52681,52681,52682,0,1,3
15099,2,3,52683,52683,52686,0,3,1
15100,3,2,52686,52686,52688,0,2,0
15101,4,3,52690,52690,52693,0,3,2
15102,5,2,52695,52695,52697,0,2,2
15103,3,2,52698,52698,52700,0,2,1
15104,5,2,52703,52703,52705,0,2,3
15105,3,3,52706,52706,52709,0,3,1
15106,3,1,52709,52709,52710,0,1,0
15107,1,3,52710,52710,52713,0,3,0
15108,2,2,52712,52713,52715,1,3,0
15109,2,3,52714,52715,52718,1,4,0
15110,5,1,52719,52719,52720,0,1,1
15111,4,2,52723,52723,52725,0,2,3
15112,5,3,52728,52728,52731,0,3,3
15113,5,3,52733,52733,52736,0,3,2
15114,4,1,52737,52737,52738,0,1,1
15115,3,1,52740,52740,52741,0,1,2
15116,3,3,52743,52743,52746,0,3,2
15117,2,3,52745,52746,52749,1,4,0
15118,6,1,52751,52751,52752,0,1,2
15119,1,2,52752,52752,52754,0,2,0
15120,1,3,52753,52754,52757,1,4,0
15121,1,1,52754,52757,52758,3,4,0
15122,6,1,52760,52760,52761,0,1,2
15123,4,2,52764,52764,52766,0,2,3
15124,5,1,52769,52769,52770,0,1,3
15125,4,3,52773,52773,52776,0,3,3
15126,1,2,52774,52776,52778,2,4,0
15127,6,3,52780,52780,52783,0,3,2
15128,3,2,52783,52783,52785,0,2,0
15129,2,2,52785,52785,52787,0,2,0
15130,2,1,52787,52787,52788,0,1,0
15131,3,1,52790,52790,52791,0,1,2
15132,6,3,52796,52796,52799,0,3,5
15133,2,1,52798,52799,52800,1,2,0
15134,1,3,52799,52800,52803,1,4,0
15135,4,1,52803,52803,52804,0,1,0
15136,5,1,52808,52808,52809,0,1,4
15137,3,3,52811,52811,52814,0,3,2
15138,6,2,52817,52817,52819,0,2,3
15139,4,2,52821,52821,52823,0,2,2
15140,3,3,52824,52824,52827,0,3,1
15141,4,3,52828,52828,52831,0,3,1
15142,3,2,52831,52831,52833,0,2,0
15143,5,1,52836,52836,52837,0,1,3
15144,5,2,52841,52841,52843,0,2,4
15145,6,3,52847,52847,52850,0,3,4
15146,3,3,52850,52850,52853,0,3,0
15147,4,3,52854,52854,52857,0,3,1
15148,3,3,52857,52857,52860,0,3,0
15149,4,2,52861,52861,52863,0,2,1
15150,4,2,52865,52865,52867,0,2,2
15151,2,3,52867,52867,52870,0,3,0
15152,2,2,52869,52870,52872,1,3,0
15153,2,1,52871,52872,52873,1,2,0
15154,2,1,52873,52873,52874,0,1,0
15155,5,2,52878,52878,52880,0,2,4
15156,1,2,52879,52880,52882,1,3,0
15157,6,3,52885,52885,52888,0,3,3
15158,4,3,52889,52889,52892,0,3,1
15159,1,2,52890,52892,52894,2,4,0
15160,5,1,52895,52895,52896,0,1,1
15161,5,3,52900,52900,52903,0,3,4
15162,2,2,52902,52903,52905,1,3,0
15163,3,2,52905,52905,52907,0,2,0
15164,2,2,52907,52907,52909,0,2,0
15165,5,3,52912,52912,52915,0,3,3
15166,4,2,52916,52916,52918,0,2,1
15167,3,3,52919,52919,52922,0,3,1
15168,1,1,52920,52922,52923,2,3,0
15169,1,2,52921,52923,52925,2,4,0
15170,1,3,52922,52925,52928,3,6,0
15171,2,3,52924,52928,52931,4,7,0
15172,2,1,52926,52931,52932,5,6,0
15173,5,2,52931,52932,52934,1,3,0
15174,3,2,52934,52934,52936,0,2,0
15175,6,3,52940,52940,52943,0,3,4
15176,1,1,52941,52943,52944,2,3,0
15177,3,1,52944,52944,52945,0,1,0
15178,3,2,52947,52947,52949,0,2,2
15179,6,1,52953,52953,52954,0,1,4
15180,6,2,52959,52959,52961,0,2,5
15181,4,1,52963,52963,52964,0,1,2
15182,5,2,52968,52968,52970,0,2,4
15183,1,1,52969,52970,52971,1,2,0
15184,2,2,52971,52971,52973,0,2,0
15185,4,2,52975,52975,52977,0,2,2
15186,4,2,52979,52979,52981,0,2,2
15187,4,2,52983,52983,52985,0,2,2
15188,2,1,52985,52985,52986,0,1,0
15189,4,2,52989,52989,52991,0,2,3
15190,2,2,52991,52991,52993,0,2,0
15191,1,1,52992,52993,52994,1,2,0
15192,2,2,52994,52994,52996,0,2,0
15193,2,2,52996,52996,52998,0,2,0
15194,6,1,53002,53002,53003,0,1,4
15195,2,1,53004,53004,53005,0,1,1
15196,2,2,53006,53006,53008,0,2,1
15197,2,2,53008,53008,53010,0,2,0
15198,1,2,53009,53010,53012,1,3,0
15199,1,2,53010,53012,53014,2,4,0
15200,6,2,53016,53016,53018,0,2,2
15201,5,3,53021,53021,53024,0,3,3
15202,1,3,53022,53024,53027,2,5,0
15203,6,2,53028,53028,53030,0,2,1
15204,1,3,53029,53030,53033,1,4,0
15205,2,3,53031,53033,53036,2,5,0
15206,6,3,53037,53037,53040,0,3,1
15207,6,2,53043,53043,53045,0,2,3
15208,1,2,53044,53045,53047,1,3,0
15209,3,2,53047,53047,53049,0,2,0
15210,5,3,53052,53052,53055,0,3,3
15211,6,3,53058,53058,53061,0,3,3
15212,3,2,53061,53061,53063,0,2,0
15213,6,1,53067,53067,53068,0,1,4
15214,3,2,53070,53070,53072,0,2,2
15215,3,3,53073,53073,53076,0,3,1
15216,4,1,53077,53077,53078,0,1,1
15217,5,3,53082,53082,53085,0,3,4
15218,3,3,53085,53085,53088,0,3,0
15219,1,3,53086,53088,53091,2,5,0
15220,1,1,53087,53091,53092,4,5,0
15221,2,1,53089,53092,53093,3,4,0
15222,2,2,53091,53093,53095,2,4,0
15223,3,3,53094,53095,53098,1,4,0
15224,4,3,53098,53098,53101,0,3,0
15225,6,1,53104,53104,53105,0,1,3
15226,2,2,53106,53106,53108,0,2,1
15227,5,1,53111,53111,53112,0,1,3
15228,3,1,53114,53114,53115,0,1,2
15229,2,1,53116,53116,53117,0,1,1
15230,2,1,53118,53118,53119,0,1,1
15231,5,2,53123,53123,53125,0,2,4
15232,6,2,53129,53129,53131,0,2,4
15233,6,1,53135,53135,53136,0,1,4
15234,2,2,53137,53137,53139,0,2,1
15235,3,1,53140,53140,53141,0,1,1
15236,1,2,53141,53141,53143,0,2,0
15237,3,1,53144,53144,53145,0,1,1
15238,3,2,53147,53147,53149,0,2,2
15239,1,2,53148,53149,53151,1,3,0
15240,5,1,53153,53153,53154,0,1,2
15241,5,3,53158,53158,53161,0,3,4
15242,2,2,53160,53161,53163,1,3,0
15243,3,2,53163,53163,53165,0,2,0
15244,1,2,53164,53165,53167,1,3,0
15245,4,3,53168,53168,53171,0,3,1
15246,1,3,53169,53171,53174,2,5,0
15247,1,1,53170,53174,53175,4,5,0
15248,1,2,53171,53175,53177,4,6,0
15249,4,1,53175,53177,53178,2,3,0
15250,5,2,53180,53180,53182,0,2,2
15251,2,2,53182,53182,53184,0,2,0
15252,4,2,53186,53186,53188,0,2,2
15253,3,2,53189,53189,53191,0,2,1
15254,6,2,53195,53195,53197,0,2,4
15255,6,2,53201,53201,53203,0,2,4
15256,6,2,53207,53207,53209,0,2,4
15257,3,3,53210,53210,53213,0,3,1
15258,3,3,53213,53213,53216,0,3,0
15259,3,2,53216,53216,53218,0,2,0
15260,6,2,53222,53222,53224,0,2,4
15261,4,2,53226,53226,53228,0,2,2
15262,2,2,53228,53228,53230,0,2,0
15263,6,1,53234,53234,53235,0,1,4
15264,2,2,53236,53236,53238,0,2,1
15265,6,3,53242,53242,53245,0,3,4
15266,3,3,53245,53245,53248,0,3,0
15267,3,3,53248,53248,53251,0,3,0
15268,5,2,53253,53253,53255,0,2,2
15269,5,3,53258,53258,53261,0,3,3
15270,1,3,53259,53261,53264,2,5,0
15271,4,1,53263,53264,53265,1,2,0
15272,2,1,53265,53265,53266,0,1,0
15273,4,3,53269,53269,53272,0,3,3
15274,5,1,53274,53274,53275,0,1,2
15275,4,3,53278,53278,53281,0,3,3
15276,1,2,53279,53281,53283,2,4,0
15277,5,2,53284,53284,53286,0,2,1
15278,5,3,53289,53289,53292,0,3,3
15279,6,2,53295,53295,53297,0,2,3
15280,1,1,53296,53297,53298,1,2,0
15281,2,2,53298,53298,53300,0,2,0
15282,1,3,53299,53300,53303,1,4,0
15283,5,3,53304,53304,53307,0,3,1
15284,2,1,53306,53307,53308,1,2,0
15285,6,1,53312,53312,53313,0,1,4
15286,3,2,53315,53315,53317,0,2,2
15287,2,1,53317,53317,53318,0,1,0
15288,3,3,53320,53320,53323,0,3,2
15289,3,1,53323,53323,53324,0,1,0
15290,6,2,53329,53329,53331,0,2,5
15291,6,1,53335,53335,53336,0,1,4
15292,1,3,53336,53336,53339,0,3,0
15293,4,2,53340,53340,53342,0,2,1
15294,4,1,53344,53344,53345,0,1,2
15295,5,1,53349,53349,53350,0,1,4
15296,1,2,53350,53350,53352,0,2,0
15297,5,2,53355,53355,53357,0,2,3
15298,3,1,53358,53358,53359,0,1,1
15299,6,3,53364,53364,53367,0,3,5
15300,2,1,53366,53367,53368,1,2,0
15301,3,3,53369,53369,53372,0,3,1
15302,5,1,53374,53374,53375,0,1,2
15303,1,2,53375,53375,53377,0,2,0
15304,1,2,53376,53377,53379,1,3,0
15305,4,2,53380,53380,53382,0,2,1
15306,4,2,53384,53384,53386,0,2,2
15307,6,2,53390,53390,53392,0,2,4
15308,1,2,53391,53392,53394,1,3,0
15309,1,3,53392,53394,53397,2,5,0
15310,5,1,53397,53397,53398,0,1,0
15311,4,2,53401,53401,53403,0,2,3
15312,3,3,53404,53404,53407,0,3,1
15313,2,1,53406,53407,53408,1,2,0
15314,6,2,53412,53412,53414,0,2,4
15315,5,1,53417,53417,53418,0,1,3
15316,2,3,53419,53419,53422,0,3,1
15317,4,2,53423,53423,53425,0,2,1
15318,4,2,53427,53427,53429,0,2,2
15319,1,3,53428,53429,53432,1,4,0
15320,2,2,53430,53432,53434,2,4,0
15321,3,1,53433,53434,53435,1,2,0
15322,1,1,53434,53435,53436,1,2,0
15323,4,3,53438,53438,53441,0,3,2
15324,3,1,53441,53441,53442,0,1,0
15325,1,1,53442,53442,53443,0,1,0
15326,2,2,53444,53444,53446,0,2,1
15327,3,2,53447,53447,53449,0,2,1
15328,1,2,53448,53449,53451,1,3,0
15329,1,3,53449,53451,53454,2,5,0
15330,6,2,53455,53455,53457,0,2,1
15331,3,1,53458,53458,53459,0,1,1
15332,3,3,53461,53461,53464,0,3,2
15333,2,2,53463,53464,53466,1,3,0
15334,5,3,53468,53468,53471,0,3,2
15335,4,2,53472,53472,53474,0,2,1
15336,6,3,53478,53478,53481,0,3,4
15337,1,1,53479,53481,53482,2,3,0
15338,2,2,53481,53482,53484,1,3,0
15339,2,2,53483,53484,53486,1,3,0
15340,2,1,53485,53486,53487,1,2,0
15341,4,2,53489,53489,53491,0,2,2
15342,3,3,53492,53492,53495,0,3,1
15343,2,2,53494,53495,53497,1,3,0
15344,6,3,53500,53500,53503,0,3,3
15345,3,1,53503,53503,53504,0,1,0
15346,2,3,53505,53505,53508,0,3,1
15347,4,2,53509,53509,53511,0,2,1
15348,6,1,53515,53515,53516,0,1,4
15349,4,2,53519,53519,53521,0,2,3
15350,1,2,53520,53521,53523,1,3,0
15351,6,3,53526,53526,53529,0,3,3
15352,5,3,53531,53531,53534,0,3,2
15353,3,2,53534,53534,53536,0,2,0
15354,6,1,53540,53540,53541,0,1,4
15355,2,2,53542,53542,53544,0,2,1
15356,2,1,53544,53544,53545,0,1,0
15357,1,3,53545,53545,53548,0,3,0
15358,4,1,53549,53549,53550,0,1,1
15359,2,3,53551,53551,53554,0,3,1
15360,4,3,53555,53555,53558,0,3,1
15361,2,2,53557,53558,53560,1,3,0
15362,6,3,53563,53563,53566,0,3,3
15363,3,1,53566,53566,53567,0,1,0
15364,5,2,53571,53571,53573,0,2,4
15365,2,3,53573,53573,53576,0,3,0
15366,6,1,53579,53579,53580,0,1,3
15367,2,1,53581,53581,53582,0,1,1
15368,4,1,53585,53585,53586,0,1,3
15369,3,1,53588,53588,53589,0,1,2
15370,3,2,53591,53591,53593,0,2,2
15371,6,1,53597,53597,53598,0,1,4
15372,1,2,53598,53598,53600,0,2,0
15373,5,3,53603,53603,53606,0,3,3
15374,3,3,53606,53606,53609,0,3,0
15375,3,2,53609,53609,53611,0,2,0
15376,3,3,53612,53612,53615,0,3,1
15377,6,3,53618,53618,53621,0,3,3
15378,3,2,53621,53621,53623,0,2,0
15379,3,1,53624,53624,53625,0,1,1
15380,1,1,53625,53625,53626,0,1,0
15381,4,1,53629,53629,53630,0,1,3
15382,3,1,53632,53632,53633,0,1,2
15383,6,1,53638,53638,53639,0,1,5
15384,2,2,53640,53640,53642,0,2,1
15385,1,1,53641,53642,53643,1,2,0
15386,1,1,53642,53643,53644,1,2,0
15387,4,3,53646,53646,53649,0,3,2
15388,1,1,53647,53649,53650,2,3,0
15389,6,2,53653,53653,53655,0,2,3
15390,1,3,53654,53655,53658,1,4,0
15391,6,3,53660,53660,53663,0,3,2
15392,2,2,53662,53663,53665,1,3,0
15393,2,2,53664,53665,53667,1,3,0
15394,6,2,53670,53670,53672,0,2,3
15395,5,3,53675,53675,53678,0,3,3
15396,6,2,53681,53681,53683,0,2,3
15397,5,1,53686,53686,53687,0,1,3
15398,6,2,53692,53692,53694,0,2,5
15399,6,2,53698,53698,53700,0,2,4
15400,1,1,53699,53700,53701,1,2,0
15401,6,3,53705,53705,53708,0,3,4
15402,5,2,53710,53710,53712,0,2,2
15403,2,2,53712,53712,53714,0,2,0
15404,2,3,53714,53714,53717,0,3,0
15405,4,3,53718,53718,53721,0,3,1
15406,3,2,53721,53721,53723,0,2,0
15407,6,3,53727,53727,53730,0,3,4
15408,4,1,53731,53731,53732,0,1,1
15409,4,1,53735,53735,53736,0,1,3
15410,1,2,53736,53736,53738,0,2,0
15411,5,1,53741,53741,53742,0,1,3
15412,3,1,53744,53744,53745,0,1,2
15413,4,3,53748,53748,53751,0,3,3
15414,4,3,53752,53752,53755,0,3,1
15415,2,1,53754,53755,53756,1,2,0
15416,1,2,53755,53756,53758,1,3,0
15417,3,1,53758,53758,53759,0,1,0
15418,1,3,53759,53759,53762,0,3,0
15419,2,2,53761,53762,53764,1,3,0
15420,2,2,53763,53764,53766,1,3,0
15421,3,2,53766,53766,53768,0,2,0
15422,2,1,53768,53768,53769,0,1,0
15423,5,2,53773,53773,53775,0,2,4
15424,2,3,53775,53775,53778,0,3,0
15425,3,2,53778,53778,53780,0,2,0
15426,2,3,53780,53780,53783,0,3,0
15427,4,2,53784,53784,53786,0,2,1
15428,3,2,53787,53787,53789,0,2,1
15429,2,1,53789,53789,53790,0,1,0
15430,5,1,53794,53794,53795,0,1,4
15431,5,1,53799,53799,53800,0,1,4
15432,3,2,53802,53802,53804,0,2,2
15433,6,1,53808,53808,53809,0,1,4
15434,1,1,53809,53809,53810,0,1,0
15435,4,1,53813,53813,53814,0,1,3
15436,3,2,53816,53816,53818,0,2,2
15437,3,1,53819,53819,53820,0,1,1
15438,6,1,53825,53825,53826,0,1,5
15439,3,3,53828,53828,53831,0,3,2
15440,2,1,53830,53831,53832,1,2,0
15441,2,1,53832,53832,53833,0,1,0
15442,4,1,53836,53836,53837,0,1,3
15443,2,2,53838,53838,53840,0,2,1
15444,3,3,53841,53841,53844,0,3,1
15445,3,2,53844,53844,53846,0,2,0
15446,6,1,53850,53850,53851,0,1,4
15447,1,3,53851,53851,53854,0,3,0
15448,2,1,53853,53854,53855,1,2,0
15449,6,2,53859,53859,53861,0,2,4
15450,1,3,53860,53861,53864,1,4,0
15451,4,2,53864,53864,53866,0,2,0
15452,2,1,53866,53866,53867,0,1,0
15453,6,3,53872,53872,53875,0,3,5
15454,3,1,53875,53875,53876,0,1,0
15455,1,1,53876,53876,53877,0,1,0
15456,6,3,53882,53882,53885,0,3,5
15457,3,1,53885,53885,53886,0,1,0
15458,6,3,53891,53891,53894,0,3,5
15459,2,2,53893,53894,53896,1,3,0
15460,3,1,53896,53896,53897,0,1,0
15461,2,1,53898,53898,53899,0,1,1
15462,5,2,53903,53903,53905,0,2,4
15463,1,1,53904,53905,53906,1,2,0
15464,4,2,53908,53908,53910,0,2,2
15465,1,1,53909,53910,53911,1,2,0
15466,6,1,53915,53915,53916,0,1,4
15467,5,2,53920,53920,53922,0,2,4
15468,5,1,53925,53925,53926,0,1,3
15469,5,1,53930,53930,53931,0,1,4
15470,5,2,53935,53935,53937,0,2,4
15471,1,3,53936,53937,53940,1,4,0
15472,2,1,53938,53940,53941,2,3,0
15473,4,1,53942,53942,53943,0,1,1
15474,6,1,53948,53948,53949,0,1,5
15475,4,2,53952,53952,53954,0,2,3
15476,6,3,53958,53958,53961,0,3,4
15477,2,1,53960,53961,53962,1,2,0
15478,2,1,53962,53962,53963,0,1,0
15479,3,1,53965,53965,53966,0,1,2
15480,2,3,53967,53967,53970,0,3,1
15481,4,3,53971,53971,53974,0,3,1
15482,3,1,53974,53974,53975,0,1,0
15483,2,2,53976,53976,53978,0,2,1
15484,4,2,53980,53980,53982,0,2,2
15485,6,3,53986,53986,53989,0,3,4
15486,6,1,53992,53992,53993,0,1,3
15487,4,3,53996,53996,53999,0,3,3
15488,1,2,53997,53999,54001,2,4,0
15489,2,3,53999,54001,54004,2,5,0
15490,4,3,54003,54004,54007,1,4,0
15491,4,3,54007,54007,54010,0,3,0
15492,4,1,54011,54011,54012,0,1,1
15493,1,3,54012,54012,54015,0,3,0
15494,6,3,54018,54018,54021,0,3,3
15495,2,1,54020,54021,54022,1,2,0
15496,5,3,54025,54025,54028,0,3,3
15497,2,2,54027,54028,54030,1,3,0
15498,5,2,54032,54032,54034,0,2,2
15499,6,1,54038,54038,54039,0,1,4
15500,5,2,54043,54043,54045,0,2,4
15501,4,2,54047,54047,54049,0,2,2
15502,6,3,54053,54053,54056,0,3,4
15503,6,1,54059,54059,54060,0,1,3
15504,6,3,54065,54065,54068,0,3,5
15505,6,3,54071,54071,54074,0,3,3
15506,5,1,54076,54076,54077,0,1,2
15507,1,2,54077,54077,54079,0,2,0
15508,6,2,54083,54083,54085,0,2,4
15509,4,3,54087,54087,54090,0,3,2
15510,3,3,54090,54090,54093,0,3,0
15511,4,2,54094,54094,54096,0,2,1
15512,3,2,54097,54097,54099,0,2,1
15513,3,2,54100,54100,54102,0,2,1
15514,5,2,54105,54105,54107,0,2,3
15515,5,1,54110,54110,54111,0,1,3
15516,1,2,54111,54111,54113,0,2,0
15517,4,2,54115,54115,54117,0,2,2
15518,6,2,54121,54121,54123,0,2,4
15519,6,2,54127,54127,54129,0,2,4
15520,6,2,54133,54133,54135,0,2,4
15521,5,1,54138,54138,54139,0,1,3
15522,4,3,54142,54142,54145,0,3,3
15523,4,3,54146,54146,54149,0,3,1
15524,3,1,54149,54149,54150,0,1,0
15525,2,2,54151,54151,54153,0,2,1
15526,5,3,54156,54156,54159,0,3,3
15527,1,2,54157,54159,54161,2,4,0
15528,4,3,54161,54161,54164,0,3,0
15529,4,2,54165,54165,54167,0,2,1
15530,6,1,54171,54171,54172,0,1,4
15531,3,1,54174,54174,54175,0,1,2
15532,6,3,54180,54180,54183,0,3,5
15533,5,1,54185,54185,54186,0,1,2
15534,4,3,54189,54189,54192,0,3,3
15535,5,3,54194,54194,54197,0,3,2
15536,2,2,54196,54197,54199,1,3,0
15537,5,1,54201,54201,54202,0,1,2
15538,3,2,54204,54204,54206,0,2,2
15539,3,2,54207,54207,54209,0,2,1
15540,3,2,54210,54210,54212,0,2,1
15541,3,2,54213,54213,54215,0,2,1
15542,4,2,54217,54217,54219,0,2,2
15543,5,1,54222,54222,54223,0,1,3
15544,3,1,54225,54225,54226,0,1,2
15545,6,3,54231,54231,54234,0,3,5
15546,6,3,54237,54237,54240,0,3,3
15547,2,2,54239,54240,54242,1,3,0
15548,1,3,54240,54242,54245,2,5,0
15549,1,1,54241,54245,54246,4,5,0
15550,2,1,54243,54246,54247,3,4,0
15551,2,3,54245,54247,54250,2,5,0
15552,4,3,54249,54250,54253,1,4,0
15553,1,3,54250,54253,54256,3,6,0
15554,3,2,54253,54256,54258,3,5,0
15555,3,2,54256,54258,54260,2,4,0
15556,5,1,54261,54261,54262,0,1,1
15557,2,1,54263,54263,54264,0,1,1
15558,6,1,54269,54269,54270,0,1,5
15559,6,2,54275,54275,54277,0,2,5
15560,2,3,54277,54277,54280,0,3,0
15561,3,1,54280,54280,54281,0,1,0
15562,2,2,54282,54282,54284,0,2,1
15563,3,1,54285,54285,54286,0,1,1
15564,5,3,54290,54290,54293,0,3,4
15565,2,3,54292,54293,54296,1,4,0
15566,3,3,54295,54296,54299,1,4,0
15567,6,2,54301,54301,54303,0,2,2
15568,5,3,54306,54306,54309,0,3,3
15569,2,1,54308,54309,54310,1,2,0
15570,3,1,54311,54311,54312,0,1,1
15571,6,2,54317,54317,54319,0,2,5
15572,5,1,54322,54322,54323,0,1,3
15573,1,3,54323,54323,54326,0,3,0
15574,4,2,54327,54327,54329,0,2,1
15575,4,1,54331,54331,54332,0,1,2
15576,2,2,54333,54333,54335,0,2,1
15577,6,2,54339,54339,54341,0,2,4
15578,3,3,54342,54342,54345,0,3,1
15579,4,3,54346,54346,54349,0,3,1
15580,2,3,54348,54349,54352,1,4,0
15581,5,2,54353,54353,54355,0,2,1
15582,6,1,54359,54359,54360,0,1,4
15583,5,2,54364,54364,54366,0,2,4
15584,5,1,54369,54369,54370,0,1,3
15585,2,2,54371,54371,54373,0,2,1
15586,2,1,54373,54373,54374,0,1,0
15587,2,3,54375,54375,54378,0,3,1
15588,5,3,54380,54380,54383,0,3,2
15589,6,3,54386,54386,54389,0,3,3
15590,1,1,54387,54389,54390,2,3,0
15591,4,1,54391,54391,54392,0,1,1
15592,1,2,54392,54392,54394,0,2,0
15593,5,1,54397,54397,54398,0,1,3
15594,3,1,54400,54400,54401,0,1,2
15595,1,2,54401,54401,54403,0,2,0
15596,5,1,54406,54406,54407,0,1,3
15597,1,3,54407,54407,54410,0,3,0
15598,1,2,54408,54410,54412,2,4,0
15599,2,3,54410,54412,54415,2,5,0
15600,4,2,54414,54415,54417,1,3,0
15601,5,3,54419,54419,54422,0,3,2
15602,2,2,54421,54422,54424,1,3,0
15603,1,3,54422,54424,54427,2,5,0
15604,3,2,54425,54427,54429,2,4,0
15605,3,3,54428,54429,54432,1,4,0
15606,4,2,54432,54432,54434,0,2,0
15607,4,1,54436,54436,54437,0,1,2
15608,3,2,54439,54439,54441,0,2,2
15609,6,3,54445,54445,54448,0,3,4
15610,6,3,54451,54451,54454,0,3,3
15611,1,2,54452,54454,54456,2,4,0
15612,5,1,54457,54457,54458,0,1,1
15613,4,3,54461,54461,54464,0,3,3
15614,3,2,54464,54464,54466,0,2,0
15615,6,2,54470,54470,54472,0,2,4
15616,2,3,54472,54472,54475,0,3,0
15617,5,2,54477,54477,54479,0,2,2
15618,4,1,54481,54481,54482,0,1,2
15619,2,1,54483,54483,54484,0,1,1
15620,5,3,54488,54488,54491,0,3,4
15621,6,3,54494,54494,54497,0,3,3
15622,5,2,54499,54499,54501,0,2,2
15623,5,1,54504,54504,54505,0,1,3
15624,4,3,54508,54508,54511,0,3,3
15625,2,1,54510,54511,54512,1,2,0
15626,2,3,54512,54512,54515,0,3,0
15627,3,3,54515,54515,54518,0,3,0
15628,6,3,54521,54521,54524,0,3,3
15629,5,3,54526,54526,54529,0,3,2
15630,6,2,54532,54532,54534,0,2,3
15631,5,1,54537,54537,54538,0,1,3
15632,6,3,54543,54543,54546,0,3,5
15633,3,2,54546,54546,54548,0,2,0
15634,2,1,54548,54548,54549,0,1,0
15635,6,3,54554,54554,54557,0,3,5
15636,5,3,54559,54559,54562,0,3,2
15637,4,3,54563,54563,54566,0,3,1
15638,6,2,54569,54569,54571,0,2,3
15639,2,1,54571,54571,54572,0,1,0
15640,3,2,54574,54574,54576,0,2,2
15641,6,1,54580,54580,54581,0,1,4
15642,5,1,54585,54585,54586,0,1,4
15643,2,3,54587,54587,54590,0,3,1
15644,6,2,54593,54593,54595,0,2,3
15645,2,1,54595,54595,54596,0,1,0
15646,1,3,54596,54596,54599,0,3,0
15647,4,2,54600,54600,54602,0,2,1
15648,4,3,54604,54604,54607,0,3,2
15649,2,1,54606,54607,54608,1,2,0
15650,3,3,54609,54609,54612,0,3,1
15651,4,2,54613,54613,54615,0,2,1
15652,2,2,54615,54615,54617,0,2,0
15653,4,2,54619,54619,54621,0,2,2
15654,6,2,54625,54625,54627,0,2,4
15655,5,2,54630,54630,54632,0,2,3
15656,4,3,54634,54634,54637,0,3,2
15657,1,2,54635,54637,54639,2,4,0
15658,4,2,54639,54639,54641,0,2,0
15659,3,1,54642,54642,54643,0,1,1
15660,5,2,54647,54647,54649,0,2,4
15661,1,1,54648,54649,54650,1,2,0
15662,1,3,54649,54650,54653,1,4,0
15663,2,1,54651,54653,54654,2,3,0
15664,5,3,54656,54656,54659,0,3,2
15665,1,3,54657,54659,54662,2,5,0
15666,2,3,54659,54662,54665,3,6,0
15667,2,2,54661,54665,54667,4,6,0
15668,3,2,54664,54667,54669,3,5,0
15669,6,2,54670,54670,54672,0,2,1
15670,6,3,54676,54676,54679,0,3,4
15671,3,2,54679,54679,54681,0,2,0
15672,3,1,54682,54682,54683,0,1,1
15673,4,2,54686,54686,54688,0,2,3
15674,6,3,54692,54692,54695,0,3,4
15675,6,3,54698,54698,54701,0,3,3
15676,2,1,54700,54701,54702,1,2,0
15677,1,1,54701,54702,54703,1,2,0
15678,5,1,54706,54706,54707,0,1,3
15679,3,2,54709,54709,54711,0,2,2
15680,2,2,54711,54711,54713,0,2,0
15681,1,1,54712,54713,54714,1,2,0
15682,1,2,54713,54714,54716,1,3,0
15683,6,2,54719,54719,54721,0,2,3
15684,4,3,54723,54723,54726,0,3,2
15685,4,3,54727,54727,54730,0,3,1
15686,4,3,54731,54731,54734,0,3,1
15687,2,1,54733,54734,54735,1,2,0
15688,5,3,54738,54738,54741,0,3,3
15689,6,2,54744,54744,54746,0,2,3
15690,3,1,54747,54747,54748,0,1,1
15691,3,1,54750,54750,54751,0,1,2
15692,2,1,54752,54752,54753,0,1,1
15693,3,1,54755,54755,54756,0,1,2
15694,2,2,54757,54757,54759,0,2,1
15695,5,2,54762,54762,54764,0,2,3
15696,1,2,54763,54764,54766,1,3,0
15697,1,1,54764,54766,54767,2,3,0
15698,3,2,54767,54767,54769,0,2,0
15699,6,1,54773,54773,54774,0,1,4
15700,1,3,54774,54774,54777,0,3,0
15701,3,2,54777,54777,54779,0,2,0
15702,6,2,54783,54783,54785,0,2,4
15703,2,1,54785,54785,54786,0,1,0
15704,6,1,54791,54791,54792,0,1,5
15705,1,3,54792,54792,54795,0,3,0
15706,5,3,54797,54797,54800,0,3,2
15707,2,3,54799,54800,54803,1,4,0
15708,6,3,54805,54805,54808,0,3,2
15709,6,3,54811,54811,54814,0,3,3
15710,2,1,54813,54814,54815,1,2,0
15711,4,3,54817,54817,54820,0,3,2
15712,6,2,54823,54823,54825,0,2,3
15713,3,3,54826,54826,54829,0,3,1
15714,2,3,54828,54829,54832,1,4,0
15715,1,3,54829,54832,54835,3,6,0
15716,4,3,54833,54835,54838,2,5,0
15717,4,2,54837,54838,54840,1,3,0
15718,3,1,54840,54840,54841,0,1,0
15719,3,2,54843,54843,54845,0,2,2
15720,1,1,54844,54845,54846,1,2,0
15721,4,2,54848,54848,54850,0,2,2
15722,4,3,54852,54852,54855,0,3,2
15723,1,2,54853,54855,54857,2,4,0
15724,2,3,54855,54857,54860,2,5,0
15725,3,3,54858,54860,54863,2,5,0
15726,3,2,54861,54863,54865,2,4,0
15727,2,1,54863,54865,54866,2,3,0
15728,1,2,54864,54866,54868,2,4,0
15729,1,2,54865,54868,54870,3,5,0
15730,1,1,54866,54870,54871,4,5,0
15731,6,1,54872,54872,54873,0,1,1
15732,2,2,54874,54874,54876,0,2,1
15733,3,3,54877,54877,54880,0,3,1
15734,1,1,54878,54880,54881,2,3,0
15735,2,1,54880,54881,54882,1,2,0
15736,4,1,54884,54884,54885,0,1,2
15737,6,3,54890,54890,54893,0,3,5
15738,4,2,54894,54894,54896,0,2,1
15739,6,2,54900,54900,54902,0,2,4
15740,4,3,54904,54904,54907,0,3,2
15741,5,2,54909,54909,54911,0,2,2
15742,2,1,54911,54911,54912,0,1,0
15743,2,1,54913,54913,54914,0,1,1
15744,5,1,54918,54918,54919,0,1,4
15745,3,2,54921,54921,54923,0,2,2
15746,6,2,54927,54927,54929,0,2,4
15747,3,2,54930,54930,54932,0,2,1
15748,5,1,54935,54935,54936,0,1,3
15749,3,1,54938,54938,54939,0,1,2
15750,5,1,54943,54943,54944,0,1,4
15751,3,1,54946,54946,54947,0,1,2
15752,1,3,54947,54947,54950,0,3,0
15753,1,1,54948,54950,54951,2,3,0
15754,6,3,54954,54954,54957,0,3,3
15755,4,3,54958,54958,54961,0,3,1
15756,4,3,54962,54962,54965,0,3,1
15757,3,2,54965,54965,54967,0,2,0
15758,2,2,54967,54967,54969,0,2,0
15759,5,2,54972,54972,54974,0,2,3
15760,6,2,54978,54978,54980,0,2,4
15761,6,3,54984,54984,54987,0,3,4
15762,1,1,54985,54987,54988,2,3,0
15763,2,1,54987,54988,54989,1,2,0
15764,3,3,54990,54990,54993,0,3,1
15765,4,3,54994,54994,54997,0,3,1
15766,4,2,54998,54998,55000,0,2,1
15767,4,2,55002,55002,55004,0,2,2
15768,2,2,55004,55004,55006,0,2,0
15769,5,2,55009,55009,55011,0,2,3
15770,1,3,55010,55011,55014,1,4,0
15771,2,1,55012,55014,55015,2,3,0
15772,2,1,55014,55015,55016,1,2,0
15773,3,3,55017,55017,55020,0,3,1
15774,4,2,55021,55021,55023,0,2,1
15775,3,1,55024,55024,55025,0,1,1
15776,4,1,55028,55028,55029,0,1,3
15777,5,3,55033,55033,55036,0,3,4
15778,6,3,55039,55039,55042,0,3,3
15779,6,3,55045,55045,55048,0,3,3
15780,2,1,55047,55048,55049,1,2,0
15781,1,3,55048,55049,55052,1,4,0
15782,4,1,55052,55052,55053,0,1,0
15783,2,2,55054,55054,55056,0,2,1
15784,5,1,55059,55059,55060,0,1,3
15785,1,1,55060,55060,55061,0,1,0
15786,5,2,55065,55065,55067,0,2,4
15787,6,1,55071,55071,55072,0,1,4
15788,5,3,55076,55076,55079,0,3,4
15789,6,3,55082,55082,55085,0,3,3
15790,4,2,55086,55086,55088,0,2,1
15791,5,1,55091,55091,55092,0,1,3
15792,3,2,55094,55094,55096,0,2,2
15793,4,1,55098,55098,55099,0,1,2
15794,6,2,55104,55104,55106,0,2,5
15795,4,2,55108,55108,55110,0,2,2
15796,3,1,55111,55111,55112,0,1,1
15797,6,3,55117,55117,55120,0,3,5
15798,5,2,55122,55122,55124,0,2,2
15799,6,3,55128,55128,55131,0,3,4
15800,5,1,55133,55133,55134,0,1,2
15801,3,3,55136,55136,55139,0,3,2
15802,3,1,55139,55139,55140,0,1,0
15803,6,2,55145,55145,55147,0,2,5
15804,5,1,55150,55150,55151,0,1,3
15805,2,3,55152,55152,55155,0,3,1
15806,6,2,55158,55158,55160,0,2,3
15807,5,3,55163,55163,55166,0,3,3
15808,2,1,55165,55166,55167,1,2,0
15809,1,2,55166,55167,55169,1,3,0
15810,2,2,55168,55169,55171,1,3,0
15811,2,1,55170,55171,55172,1,2,0
15812,4,2,55174,55174,55176,0,2,2
15813,2,3,55176,55176,55179,0,3,0
15814,5,1,55181,55181,55182,0,1,2
15815,1,3,55182,55182,55185,0,3,0
15816,4,2,55186,55186,55188,0,2,1
15817,3,2,55189,55189,55191,0,2,1
15818,4,3,55193,55193,55196,0,3,2
15819,4,1,55197,55197,55198,0,1,1
15820,2,3,55199,55199,55202,0,3,1
15821,5,3,55204,55204,55207,0,3,2
15822,5,1,55209,55209,55210,0,1,2
15823,4,2,55213,55213,55215,0,2,3
15824,3,2,55216,55216,55218,0,2,1
15825,5,3,55221,55221,55224,0,3,3
15826,4,2,55225,55225,55227,0,2,1
15827,6,3,55231,55231,55234,0,3,4
15828,6,3,55237,55237,55240,0,3,3
15829,6,1,55243,55243,55244,0,1,3
15830,6,2,55249,55249,55251,0,2,5
15831,2,2,55251,55251,55253,0,2,0
15832,3,2,55254,55254,55256,0,2,1
15833,4,1,55258,55258,55259,0,1,2
15834,2,2,55260,55260,55262,0,2,1
15835,3,2,55263,55263,55265,0,2,1
15836,2,2,55265,55265,55267,0,2,0
15837,4,1,55269,55269,55270,0,1,2
15838,4,2,55273,55273,55275,0,2,3
15839,5,2,55278,55278,55280,0,2,3
15840,5,3,55283,55283,55286,0,3,3
15841,6,3,55289,55289,55292,0,3,3
15842,2,2,55291,55292,55294,1,3,0
15843,5,2,55296,55296,55298,0,2,2
15844,6,3,55302,55302,55305,0,3,4
15845,2,3,55304,55305,55308,1,4,0
15846,4,3,55308,55308,55311,0,3,0
15847,5,1,55313,55313,55314,0,1,2
15848,2,2,55315,55315,55317,0,2,1
15849,3,2,55318,55318,55320,0,2,1
15850,6,1,55324,55324,55325,0,1,4
15851,4,3,55328,55328,55331,0,3,3
15852,4,3,55332,55332,55335,0,3,1
15853,6,2,55338,55338,55340,0,2,3
15854,4,3,55342,55342,55345,0,3,2
15855,6,2,55348,55348,55350,0,2,3
15856,1,1,55349,55350,55351,1,2,0
15857,2,3,55351,55351,55354,0,3,0
15858,4,2,55355,55355,55357,0,2,1
15859,3,1,55358,55358,55359,0,1,1
15860,4,1,55362,55362,55363,0,1,3
15861,3,3,55365,55365,55368,0,3,2
15862,3,3,55368,55368,55371,0,3,0
15863,3,3,55371,55371,55374,0,3,0
15864,1,1,55372,55374,55375,2,3,0
15865,3,1,55375,55375,55376,0,1,0
15866,2,2,55377,55377,55379,0,2,1
15867,6,3,55383,55383,55386,0,3,4
15868,2,1,55385,55386,55387,1,2,0
15869,6,1,55391,55391,55392,0,1,4
15870,2,1,55393,55393,55394,0,1,1
15871,3,2,55396,55396,55398,0,2,2
15872,6,3,55402,55402,55405,0,3,4
15873,5,2,55407,55407,55409,0,2,2
15874,1,3,55408,55409,55412,1,4,0
15875,2,2,55410,55412,55414,2,4,0
15876,3,2,55413,55414,55416,1,3,0
15877,3,1,55416,55416,55417,0,1,0
15878,3,3,55419,55419,55422,0,3,2
15879,3,3,55422,55422,55425,0,3,0
15880,4,1,55426,55426,55427,0,1,1
15881,6,2,55432,55432,55434,0,2,5
15882,2,3,55434,55434,55437,0,3,0
15883,4,3,55438,55438,55441,0,3,1
15884,3,3,55441,55441,55444,0,3,0
15885,5,3,55446,55446,55449,0,3,2
15886,3,2,55449,55449,55451,0,2,0
15887,3,1,55452,55452,55453,0,1,1
15888,6,2,55458,55458,55460,0,2,5
15889,3,1,55461,55461,55462,0,1,1
15890,5,1,55466,55466,55467,0,1,4
15891,2,1,55468,55468,55469,0,1,1
15892,4,2,55472,55472,55474,0,2,3
15893,3,2,55475,55475,55477,0,2,1
15894,3,3,55478,55478,55481,0,3,1
15895,3,3,55481,55481,55484,0,3,0
15896,1,1,55482,55484,55485,2,3,0
15897,2,3,55484,55485,55488,1,4,0
15898,3,1,55487,55488,55489,1,2,0
15899,1,1,55488,55489,55490,1,2,0
15900,5,1,55493,55493,55494,0,1,3
15901,4,2,55497,55497,55499,0,2,3
15902,6,2,55503,55503,55505,0,2,4
15903,5,2,55508,55508,55510,0,2,3
15904,4,3,55512,55512,55515,0,3,2
15905,4,3,55516,55516,55519,0,3,1
15906,1,1,55517,55519,55520,2,3,0
15907,5,2,55522,55522,55524,0,2,2
15908,5,3,55527,55527,55530,0,3,3
15909,1,1,55528,55530,55531,2,3,0
15910,5,1,55533,55533,55534,0,1,2
15911,3,2,55536,55536,55538,0,2,2
15912,2,2,55538,55538,55540,0,2,0
15913,4,2,55542,55542,55544,0,2,2
15914,6,3,55548,55548,55551,0,3,4
15915,6,1,55554,55554,55555,0,1,3
15916,5,1,55559,55559,55560,0,1,4
15917,5,1,55564,55564,55565,0,1,4
15918,1,2,55565,55565,55567,0,2,0
15919,5,2,55570,55570,55572,0,2,3
15920,6,2,55576,55576,55578,0,2,4
15921,5,2,55581,55581,55583,0,2,3
15922,6,1,55587,55587,55588,0,1,4
15923,6,2,55593,55593,55595,0,2,5
15924,5,3,55598,55598,55601,0,3,3
15925,3,3,55601,55601,55604,0,3,0
15926,3,1,55604,55604,55605,0,1,0
15927,3,2,55607,55607,55609,0,2,2
15928,6,3,55613,55613,55616,0,3,4
15929,5,3,55618,55618,55621,0,3,2
15930,4,3,55622,55622,55625,0,3,1
15931,1,1,55623,55625,55626,2,3,0
15932,3,1,55626,55626,55627,0,1,0
15933,3,2,55629,55629,55631,0,2,2
15934,3,3,55632,55632,55635,0,3,1
15935,6,3,55638,55638,55641,0,3,3
15936,6,2,55644,55644,55646,0,2,3
15937,4,2,55648,55648,55650,0,2,2
15938,1,2,55649,55650,55652,1,3,0
15939,3,1,55652,55652,55653,0,1,0
15940,2,2,55654,55654,55656,0,2,1
15941,4,1,55658,55658,55659,0,1,2
15942,3,2,55661,55661,55663,0,2,2
15943,3,2,55664,55664,55666,0,2,1
15944,3,1,55667,55667,55668,0,1,1
15945,6,2,55673,55673,55675,0,2,5
15946,2,2,55675,55675,55677,0,2,0
15947,1,2,55676,55677,55679,1,3,0
15948,4,3,55680,55680,55683,0,3,1
15949,2,3,55682,55683,55686,1,4,0
15950,6,3,55688,55688,55691,0,3,2
15951,5,2,55693,55693,55695,0,2,2
15952,2,1,55695,55695,55696,0,1,0
15953,4,1,55699,55699,55700,0,1,3
15954,2,1,55701,55701,55702,0,1,1
15955,6,3,55707,55707,55710,0,3,5
15956,2,1,55709,55710,55711,1,2,0
15957,1,3,55710,55711,55714,1,4,0
15958,3,2,55713,55714,55716,1,3,0
15959,1,1,55714,55716,55717,2,3,0
15960,3,2,55717,55717,55719,0,2,0
15961,4,1,55721,55721,55722,0,1,2
15962,4,2,55725,55725,55727,0,2,3
15963,1,2,55726,55727,55729,1,3,0
15964,4,3,55730,55730,55733,0,3,1
15965,4,3,55734,55734,55737,0,3,1
15966,6,1,55740,55740,55741,0,1,3
15967,1,2,55741,55741,55743,0,2,0
15968,3,3,55744,55744,55747,0,3,1
15969,1,2,55745,55747,55749,2,4,0
15970,4,1,55749,55749,55750,0,1,0
15971,3,2,55752,55752,55754,0,2,2
15972,2,2,55754,55754,55756,0,2,0
15973,2,1,55756,55756,55757,0,1,0
15974,5,1,55761,55761,55762,0,1,4
15975,5,3,55766,55766,55769,0,3,4
15976,5,1,55771,55771,55772,0,1,2
15977,5,2,55776,55776,55778,0,2,4
15978,5,1,55781,55781,55782,0,1,3
15979,3,3,55784,55784,55787,0,3,2
15980,5,1,55789,55789,55790,0,1,2
15981,2,1,55791,55791,55792,0,1,1
15982,6,1,55797,55797,55798,0,1,5
15983,2,2,55799,55799,55801,0,2,1
15984,1,1,55800,55801,55802,1,2,0
15985,5,3,55805,55805,55808,0,3,3
15986,5,3,55810,55810,55813,0,3,2
15987,3,1,55813,55813,55814,0,1,0
15988,1,1,55814,55814,55815,0,1,0
15989,1,2,55815,55815,55817,0,2,0
15990,6,3,55821,55821,55824,0,3,4
15991,5,1,55826,55826,55827,0,1,2
15992,1,3,55827,55827,55830,0,3,0
15993,5,2,55832,55832,55834,0,2,2
15994,5,3,55837,55837,55840,0,3,3
15995,3,3,55840,55840,55843,0,3,0
15996,5,3,55845,55845,55848,0,3,2
15997,5,1,55850,55850,55851,0,1,2
15998,6,1,55856,55856,55857,0,1,5
15999,4,3,55860,55860,55863,0,3,3
16000,4,2,55864,55864,55866,0,2,1
16001,4,2,55868,55868,55870,0,2,2
16002,2,1,55870,55870,55871,0,1,0
16003,1,1,55871,55871,55872,0,1,0
16004,6,3,55877,55877,55880,0,3,5
16005,4,1,55881,55881,55882,0,1,1
16006,2,3,55883,55883,55886,0,3,1
16007,2,1,55885,55886,55887,1,2,0
16008,5,2,55890,55890,55892,0,2,3
16009,1,3,55891,55892,55895,1,4,0
16010,3,3,55894,55895,55898,1,4,0
16011,2,2,55896,55898,55900,2,4,0
16012,4,2,55900,55900,55902,0,2,0
16013,6,1,55906,55906,55907,0,1,4
16014,2,2,55908,55908,55910,0,2,1
16015,2,1,55910,55910,55911,0,1,0
16016,2,2,55912,55912,55914,0,2,1
16017,4,1,55916,55916,55917,0,1,2
16018,4,1,55920,55920,55921,0,1,3
16019,5,3,55925,55925,55928,0,3,4
16020,3,1,55928,55928,55929,0,1,0
16021,4,3,55932,55932,55935,0,3,3
16022,3,2,55935,55935,55937,0,2,0
16023,6,1,55941,55941,55942,0,1,4
16024,6,3,55947,55947,55950,0,3,5
16025,5,1,55952,55952,55953,0,1,2
16026,5,2,55957,55957,55959,0,2,4
16027,1,2,55958,55959,55961,1,3,0
16028,6,3,55964,55964,55967,0,3,3
16029,1,2,55965,55967,55969,2,4,0
16030,4,2,55969,55969,55971,0,2,0
16031,3,3,55972,55972,55975,0,3,1
16032,6,1,55978,55978,55979,0,1,3
16033,2,2,55980,55980,55982,0,2,1
16034,6,1,55986,55986,55987,0,1,4
16035,3,1,55989,55989,55990,0,1,2
16036,1,3,55990,55990,55993,0,3,0
16037,3,3,55993,55993,55996,0,3,0
16038,1,3,55994,55996,55999,2,5,0
16039,6,2,56000,56000,56002,0,2,1
16040,5,1,56005,56005,56006,0,1,3
16041,3,1,56008,56008,56009,0,1,2
16042,1,3,56009,56009,56012,0,3,0
16043,6,2,56015,56015,56017,0,2,3
16044,6,3,56021,56021,56024,0,3,4
16045,5,2,56026,56026,56028,0,2,2
16046,3,2,56029,56029,56031,0,2,1
16047,1,1,56030,56031,56032,1,2,0
16048,2,1,56032,56032,56033,0,1,0
16049,3,3,56035,56035,56038,0,3,2
16050,2,2,56037,56038,56040,1,3,0
16051,1,1,56038,56040,56041,2,3,0
16052,2,2,56040,56041,56043,1,3,0
16053,2,2,56042,56043,56045,1,3,0
16054,4,1,56046,56046,56047,0,1,1
16055,1,1,56047,56047,56048,0,1,0
16056,5,1,56052,56052,56053,0,1,4
16057,5,3,56057,56057,56060,0,3,4
16058,3,3,56060,56060,56063,0,3,0
16059,1,2,56061,56063,56065,2,4,0
16060,5,2,56066,56066,56068,0,2,1
16061,1,2,56067,56068,56070,1,3,0
16062,1,1,56068,56070,56071,2,3,0
16063,3,2,56071,56071,56073,0,2,0
16064,6,3,56077,56077,56080,0,3,4
16065,6,1,56083,56083,56084,0,1,3
16066,5,1,56088,56088,56089,0,1,4
16067,6,2,56094,56094,56096,0,2,5
16068,6,3,56100,56100,56103,0,3,4
16069,1,2,56101,56103,56105,2,4,0
16070,1,1,56102,56105,56106,3,4,0
16071,1,1,56103,56106,56107,3,4,0
16072,4,1,56107,56107,56108,0,1,0
16073,4,2,56111,56111,56113,0,2,3
16074,6,1,56117,56117,56118,0,1,4
16075,5,2,56122,56122,56124,0,2,4
16076,5,1,56127,56127,56128,0,1,3
16077,6,1,56133,56133,56134,0,1,5
16078,1,2,56134,56134,56136,0,2,0
16079,1,2,56135,56136,56138,1,3,0
16080,1,1,56136,56138,56139,2,3,0
16081,6,1,56142,56142,56143,0,1,3
16082,2,3,56144,56144,56147,0,3,1
16083,6,1,56150,56150,56151,0,1,3
16084,1,2,56151,56151,56153,0,2,0
16085,5,2,56156,56156,56158,0,2,3
16086,3,3,56159,56159,56162,0,3,1
16087,1,3,56160,56162,56165,2,5,0
16088,4,1,56164,56165,56166,1,2,0
16089,4,1,56168,56168,56169,0,1,2
16090,5,2,56173,56173,56175,0,2,4
16091,5,1,56178,56178,56179,0,1,3
16092,5,1,56183,56183,56184,0,1,4
16093,5,2,56188,56188,56190,0,2,4
16094,4,2,56192,56192,56194,0,2,2
16095,3,2,56195,56195,56197,0,2,1
16096,1,3,56196,56197,56200,1,4,0
16097,1,1,56197,56200,56201,3,4,0
16098,4,1,56201,56201,56202,0,1,0
16099,2,3,56203,56203,56206,0,3,1
16100,2,3,56205,56206,56209,1,4,0
16101,5,2,56210,56210,56212,0,2,1
16102,2,1,56212,56212,56213,0,1,0
16103,5,2,56217,56217,56219,0,2,4
16104,5,1,56222,56222,56223,0,1,3
16105,2,1,56224,56224,56225,0,1,1
16106,4,2,56228,56228,56230,0,2,3
16107,6,3,56234,56234,56237,0,3,4
16108,5,2,56239,56239,56241,0,2,2
16109,1,2,56240,56241,56243,1,3,0
16110,5,2,56245,56245,56247,0,2,2
16111,3,3,56248,56248,56251,0,3,1
16112,1,3,56249,56251,56254,2,5,0
16113,2,2,56251,56254,56256,3,5,0
16114,4,3,56255,56256,56259,1,4,0
16115,6,1,56261,56261,56262,0,1,2
16116,5,1,56266,56266,56267,0,1,4
16117,1,2,56267,56267,56269,0,2,0
16118,2,1,56269,56269,56270,0,1,0
16119,4,3,56273,56273,56276,0,3,3
16120,5,2,56278,56278,56280,0,2,2
16121,3,1,56281,56281,56282,0,1,1
16122,6,2,56287,56287,56289,0,2,5
16123,6,2,56293,56293,56295,0,2,4
16124,4,3,56297,56297,56300,0,3,2
16125,5,1,56302,56302,56303,0,1,2
16126,4,2,56306,56306,56308,0,2,3
16127,6,3,56312,56312,56315,0,3,4
16128,3,1,56315,56315,56316,0,1,0
16129,2,2,56317,56317,56319,0,2,1
16130,5,2,56322,56322,56324,0,2,3
16131,5,1,56327,56327,56328,0,1,3
16132,2,3,56329,56329,56332,0,3,1
16133,4,2,56333,56333,56335,0,2,1
16134,1,1,56334,56335,56336,1,2,0
16135,3,1,56337,56337,56338,0,1,1
16136,4,2,56341,56341,56343,0,2,3
16137,5,2,56346,56346,56348,0,2,3
16138,1,1,56347,56348,56349,1,2,0
16139,3,3,56350,56350,56353,0,3,1
16140,1,1,56351,56353,56354,2,3,0
16141,1,3,56352,56354,56357,2,5,0
16142,2,2,56354,56357,56359,3,5,0
16143,5,1,56359,56359,56360,0,1,0
16144,5,3,56364,56364,56367,0,3,4
16145,6,1,56370,56370,56371,0,1,3
16146,1,1,56371,56371,56372,0,1,0
16147,2,1,56373,56373,56374,0,1,1
16148,6,1,56379,56379,56380,0,1,5
16149,5,1,56384,56384,56385,0,1,4
16150,2,3,56386,56386,56389,0,3,1
16151,3,2,56389,56389,56391,0,2,0
16152,4,2,56393,56393,56395,0,2,2
16153,4,3,56397,56397,56400,0,3,2
16154,4,1,56401,56401,56402,0,1,1
16155,1,1,56402,56402,56403,0,1,0
16156,5,3,56407,56407,56410,0,3,4
16157,2,2,56409,56410,56412,1,3,0
16158,2,2,56411,56412,56414,1,3,0
16159,5,1,56416,56416,56417,0,1,2
16160,2,1,56418,56418,56419,0,1,1
16161,5,1,56423,56423,56424,0,1,4
16162,1,3,56424,56424,56427,0,3,0
16163,3,1,56427,56427,56428,0,1,0
16164,2,1,56429,56429,56430,0,1,1
16165,6,3,56435,56435,56438,0,3,5
16166,1,1,56436,56438,56439,2,3,0
16167,4,3,56440,56440,56443,0,3,1
16168,3,2,56443,56443,56445,0,2,0
16169,6,2,56449,56449,56451,0,2,4
16170,4,1,56453,56453,56454,0,1,2
16171,3,1,56456,56456,56457,0,1,2
16172,6,1,56462,56462,56463,0,1,5
16173,2,1,56464,56464,56465,0,1,1
16174,5,1,56469,56469,56470,0,1,4
16175,5,1,56474,56474,56475,0,1,4
16176,6,1,56480,56480,56481,0,1,5
16177,6,1,56486,56486,56487,0,1,5
16178,6,3,56492,56492,56495,0,3,5
16179,4,2,56496,56496,56498,0,2,1
16180,4,3,56500,56500,56503,0,3,2
16181,6,2,56506,56506,56508,0,2,3
16182,3,2,56509,56509,56511,0,2,1
16183,3,2,56512,56512,56514,0,2,1
16184,3,1,56515,56515,56516,0,1,1
16185,5,2,56520,56520,56522,0,2,4
16186,4,2,56524,56524,56526,0,2,2
16187,6,3,56530,56530,56533,0,3,4
16188,1,2,56531,56533,56535,2,4,0
16189,6,2,56537,56537,56539,0,2,2
16190,3,1,56540,56540,56541,0,1,1
16191,2,1,56542,56542,56543,0,1,1
16192,3,1,56545,56545,56546,0,1,2
16193,2,3,56547,56547,56550,0,3,1
16194,6,2,56553,56553,56555,0,2,3
16195,1,3,56554,56555,56558,1,4,0
16196,1,3,56555,56558,56561,3,6,0
16197,6,3,56561,56561,56564,0,3,0
16198,6,1,56567,56567,56568,0,1,3
16199,4,3,56571,56571,56574,0,3,3
16200,4,2,56575,56575,56577,0,2,1
16201,6,1,56581,56581,56582,0,1,4
16202,2,3,56583,56583,56586,0,3,1
16203,4,1,56587,56587,56588,0,1,1
16204,4,3,56591,56591,56594,0,3,3
16205,1,2,56592,56594,56596,2,4,0
16206,6,1,56598,56598,56599,0,1,2
16207,1,2,56599,56599,56601,0,2,0
16208,6,2,56605,56605,56607,0,2,4
16209,4,1,56609,56609,56610,0,1,2
16210,3,1,56612,56612,56613,0,1,2
16211,1,1,56613,56613,56614,0,1,0
16212,5,1,56618,56618,56619,0,1,4
16213,6,2,56624,56624,56626,0,2,5
16214,5,3,56629,56629,56632,0,3,3
16215,2,3,56631,56632,56635,1,4,0
16216,1,3,56632,56635,56638,3,6,0
16217,3,3,56635,56638,56641,3,6,0
16218,2,1,56637,56641,56642,4,5,0
16219,4,2,56641,56642,56644,1,3,0
16220,1,3,56642,56644,56647,2,5,0
16221,6,2,56648,56648,56650,0,2,1
16222,6,1,56654,56654,56655,0,1,4
16223,1,3,56655,56655,56658,0,3,0
16224,4,1,56659,56659,56660,0,1,1
16225,4,2,56663,56663,56665,0,2,3
16226,6,2,56669,56669,56671,0,2,4
16227,3,2,56672,56672,56674,0,2,1
16228,2,3,56674,56674,56677,0,3,0
16229,6,3,56680,56680,56683,0,3,3
16230,3,3,56683,56683,56686,0,3,0
16231,4,3,56687,56687,56690,0,3,1
16232,2,3,56689,56690,56693,1,4,0
16233,3,3,56692,56693,56696,1,4,0
16234,1,1,56693,56696,56697,3,4,0
16235,3,2,56696,56697,56699,1,3,0
16236,6,3,56702,56702,56705,0,3,3
16237,3,1,56705,56705,56706,0,1,0
16238,3,2,56708,56708,56710,0,2,2
16239,5,2,56713,56713,56715,0,2,3
16240,6,3,56719,56719,56722,0,3,4
16241,3,1,56722,56722,56723,0,1,0
16242,4,1,56726,56726,56727,0,1,3
16243,5,1,56731,56731,56732,0,1,4
16244,5,2,56736,56736,56738,0,2,4
16245,6,2,56742,56742,56744,0,2,4
16246,1,1,56743,56744,56745,1,2,0
16247,2,2,56745,56745,56747,0,2,0
16248,4,2,56749,56749,56751,0,2,2
16249,5,2,56754,56754,56756,0,2,3
16250,6,1,56760,56760,56761,0,1,4
16251,4,2,56764,56764,56766,0,2,3
16252,3,1,56767,56767,56768,0,1,1
16253,4,1,56771,56771,56772,0,1,3
16254,3,1,56774,56774,56775,0,1,2
16255,6,1,56780,56780,56781,0,1,5
16256,2,2,56782,56782,56784,0,2,1
16257,6,2,56788,56788,56790,0,2,4
16258,4,1,56792,56792,56793,0,1,2
16259,3,1,56795,56795,56796,0,1,2
16260,3,1,56798,56798,56799,0,1,2
16261,3,3,56801,56801,56804,0,3,2
16262,4,3,56805,56805,56808,0,3,1
16263,3,1,56808,56808,56809,0,1,0
16264,4,3,56812,56812,56815,0,3,3
16265,6,1,56818,56818,56819,0,1,3
16266,4,2,56822,56822,56824,0,2,3
16267,1,3,56823,56824,56827,1,4,0
16268,2,3,56825,56827,56830,2,5,0
16269,5,3,56830,56830,56833,0,3,0
16270,4,1,56834,56834,56835,0,1,1
16271,2,3,56836,56836,56839,0,3,1
16272,5,3,56841,56841,56844,0,3,2
16273,5,3,56846,56846,56849,0,3,2
16274,3,2,56849,56849,56851,0,2,0
16275,1,3,56850,56851,56854,1,4,0
16276,4,1,56854,56854,56855,0,1,0
16277,1,2,56855,56855,56857,0,2,0
16278,3,2,56858,56858,56860,0,2,1
16279,5,2,56863,56863,56865,0,2,3
16280,3,3,56866,56866,56869,0,3,1
16281,1,2,56867,56869,56871,2,4,0
16282,1,3,56868,56871,56874,3,6,0
16283,1,2,56869,56874,56876,5,7,0
16284,2,3,56871,56876,56879,5,8,0
16285,4,3,56875,56879,56882,4,7,0
16286,6,2,56881,56882,56884,1,3,0
16287,5,3,56886,56886,56889,0,3,2
16288,1,1,56887,56889,56890,2,3,0
16289,4,1,56891,56891,56892,0,1,1
16290,4,3,56895,56895,56898,0,3,3
16291,1,1,56896,56898,56899,2,3,0
16292,2,3,56898,56899,56902,1,4,0
16293,6,1,56904,56904,56905,0,1,2
16294,4,2,56908,56908,56910,0,2,3
16295,6,3,56914,56914,56917,0,3,4
16296,6,2,56920,56920,56922,0,2,3
16297,5,2,56925,56925,56927,0,2,3
16298,3,3,56928,56928,56931,0,3,1
16299,5,2,56933,56933,56935,0,2,2
16300,3,3,56936,56936,56939,0,3,1
16301,5,2,56941,56941,56943,0,2,2
16302,1,2,56942,56943,56945,1,3,0
16303,5,2,56947,56947,56949,0,2,2
16304,6,1,56953,56953,56954,0,1,4
16305,3,1,56956,56956,56957,0,1,2
16306,1,3,56957,56957,56960,0,3,0
16307,5,3,56962,56962,56965,0,3,2
16308,6,2,56968,56968,56970,0,2,3
16309,5,3,56973,56973,56976,0,3,3
16310,4,3,56977,56977,56980,0,3,1
16311,5,3,56982,56982,56985,0,3,2
16312,4,1,56986,56986,56987,0,1,1
16313,4,2,56990,56990,56992,0,2,3
16314,2,3,56992,56992,56995,0,3,0
16315,3,1,56995,56995,56996,0,1,0
16316,6,2,57001,57001,57003,0,2,5
16317,3,2,57004,57004,57006,0,2,1
16318,5,1,57009,57009,57010,0,1,3
16319,1,2,57010,57010,57012,0,2,0
16320,3,1,57013,57013,57014,0,1,1
16321,1,3,57014,57014,57017,0,3,0
16322,5,1,57019,57019,57020,0,1,2
16323,6,2,57025,57025,57027,0,2,5
16324,6,2,57031,57031,57033,0,2,4
16325,5,3,57036,57036,57039,0,3,3
16326,1,2,57037,57039,57041,2,4,0
16327,5,1,57042,57042,57043,0,1,1
16328,1,1,57043,57043,57044,0,1,0
16329,1,3,57044,57044,57047,0,3,0
16330,4,3,57048,57048,57051,0,3,1
16331,5,1,57053,57053,57054,0,1,2
16332,6,1,57059,57059,57060,0,1,5
16333,4,3,57063,57063,57066,0,3,3
16334,3,3,57066,57066,57069,0,3,0
16335,5,1,57071,57071,57072,0,1,2
16336,4,2,57075,57075,57077,0,2,3
16337,4,1,57079,57079,57080,0,1,2
16338,4,2,57083,57083,57085,0,2,3
16339,2,3,57085,57085,57088,0,3,0
16340,4,2,57089,57089,57091,0,2,1
16341,5,1,57094,57094,57095,0,1,3
16342,5,3,57099,57099,57102,0,3,4
16343,1,2,57100,57102,57104,2,4,0
16344,1,2,57101,57104,57106,3,5,0
16345,2,2,57103,57106,57108,3,5,0
16346,5,2,57108,57108,57110,0,2,0
16347,3,2,57111,57111,57113,0,2,1
16348,2,3,57113,57113,57116,0,3,0
16349,5,3,57118,57118,57121,0,3,2
16350,4,3,57122,57122,57125,0,3,1
16351,3,3,57125,57125,57128,0,3,0
16352,1,1,57126,57128,57129,2,3,0
16353,4,3,57130,57130,57133,0,3,1
16354,4,1,57134,57134,57135,0,1,1
16355,3,3,57137,57137,57140,0,3,2
16356,1,1,57138,57140,57141,2,3,0
16357,6,1,57144,57144,57145,0,1,3
16358,3,1,57147,57147,57148,0,1,2
16359,5,2,57152,57152,57154,0,2,4
16360,5,1,57157,57157,57158,0,1,3
16361,2,1,57159,57159,57160,0,1,1
16362,6,1,57165,57165,57166,0,1,5
16363,1,1,57166,57166,57167,0,1,0
16364,4,2,57170,57170,57172,0,2,3
16365,4,3,57174,57174,57177,0,3,2
16366,2,2,57176,57177,57179,1,3,0
16367,3,3,57179,57179,57182,0,3,0
16368,4,3,57183,57183,57186,0,3,1
16369,4,3,57187,57187,57190,0,3,1
16370,6,1,57193,57193,57194,0,1,3
16371,6,1,57199,57199,57200,0,1,5
16372,1,1,57200,57200,57201,0,1,0
16373,5,1,57205,57205,57206,0,1,4
16374,1,1,57206,57206,57207,0,1,0
16375,3,3,57209,57209,57212,0,3,2
16376,6,2,57215,57215,57217,0,2,3
16377,4,2,57219,57219,57221,0,2,2
16378,6,2,57225,57225,57227,0,2,4
16379,1,1,57226,57227,57228,1,2,0
16380,6,1,57232,57232,57233,0,1,4
16381,5,2,57237,57237,57239,0,2,4
16382,2,2,57239,57239,57241,0,2,0
16383,1,1,57240,57241,57242,1,2,0
16384,2,3,57242,57242,57245,0,3,0
16385,5,2,57247,57247,57249,0,2,2
16386,5,1,57252,57252,57253,0,1,3
16387,6,3,57258,57258,57261,0,3,5
16388,5,2,57263,57263,57265,0,2,2
16389,3,1,57266,57266,57267,0,1,1
16390,2,3,57268,57268,57271,0,3,1
16391,5,2,57273,57273,57275,0,2,2
16392,1,3,57274,57275,57278,1,4,0
16393,4,1,57278,57278,57279,0,1,0
16394,5,3,57283,57283,57286,0,3,4
16395,6,1,57289,57289,57290,0,1,3
16396,2,1,57291,57291,57292,0,1,1
16397,6,3,57297,57297,57300,0,3,5
16398,2,3,57299,57300,57303,1,4,0
16399,1,2,57300,57303,57305,3,5,0
16400,5,3,57305,57305,57308,0,3,0
16401,2,2,57307,57308,57310,1,3,0
16402,6,1,57313,57313,57314,0,1,3
16403,3,1,57316,57316,57317,0,1,2
16404,6,2,57322,57322,57324,0,2,5
16405,2,3,57324,57324,57327,0,3,0
16406,3,2,57327,57327,57329,0,2,0
16407,3,1,57330,57330,57331,0,1,1
16408,5,3,57335,57335,57338,0,3,4
16409,3,3,57338,57338,57341,0,3,0
16410,3,1,57341,57341,57342,0,1,0
16411,1,3,57342,57342,57345,0,3,0
16412,2,2,57344,57345,57347,1,3,0
16413,4,1,57348,57348,57349,0,1,1
16414,6,1,57354,57354,57355,0,1,5
16415,6,1,57360,57360,57361,0,1,5
16416,4,2,57364,57364,57366,0,2,3
16417,4,2,57368,57368,57370,0,2,2
16418,6,3,57374,57374,57377,0,3,4
16419,1,1,57375,57377,57378,2,3,0
16420,6,3,57381,57381,57384,0,3,3
16421,2,2,57383,57384,57386,1,3,0
16422,1,3,57384,57386,57389,2,5,0
16423,1,2,57385,57389,57391,4,6,0
16424,6,3,57391,57391,57394,0,3,0
16425,5,3,57396,57396,57399,0,3,2
16426,6,3,57402,57402,57405,0,3,3
16427,3,1,57405,57405,57406,0,1,0
16428,3,1,57408,57408,57409,0,1,2
16429,3,1,57411,57411,57412,0,1,2
16430,3,2,57414,57414,57416,0,2,2
16431,3,2,57417,57417,57419,0,2,1
16432,5,1,57422,57422,57423,0,1,3
16433,2,3,57424,57424,57427,0,3,1
16434,3,3,57427,57427,57430,0,3,0
16435,2,2,57429,57430,57432,1,3,0
16436,4,2,57433,57433,57435,0,2,1
16437,5,1,57438,57438,57439,0,1,3
16438,6,3,57444,57444,57447,0,3,5
16439,6,2,57450,57450,57452,0,2,3
16440,6,3,57456,57456,57459,0,3,4
16441,2,1,57458,57459,57460,1,2,0
16442,3,2,57461,57461,57463,0,2,1
16443,4,3,57465,57465,57468,0,3,2
16444,5,2,57470,57470,57472,0,2,2
16445,1,3,57471,57472,57475,1,4,0
16446,1,3,57472,57475,57478,3,6,0
16447,6,1,57478,57478,57479,0,1,0
16448,1,2,57479,57479,57481,0,2,0
16449,2,1,57481,57481,57482,0,1,0
16450,4,1,57485,57485,57486,0,1,3
16451,5,3,57490,57490,57493,0,3,4
16452,4,1,57494,57494,57495,0,1,1
16453,6,2,57500,57500,57502,0,2,5
16454,5,1,57505,57505,57506,0,1,3
16455,6,3,57511,57511,57514,0,3,5
16456,3,1,57514,57514,57515,0,1,0
16457,6,2,57520,57520,57522,0,2,5
16458,6,3,57526,57526,57529,0,3,4
16459,5,1,57531,57531,57532,0,1,2
16460,2,3,57533,57533,57536,0,3,1
16461,5,1,57538,57538,57539,0,1,2
16462,5,3,57543,57543,57546,0,3,4
16463,1,2,57544,57546,57548,2,4,0
16464,4,1,57548,57548,57549,0,1,0
16465,3,2,57551,57551,57553,0,2,2
16466,1,1,57552,57553,57554,1,2,0
16467,1,1,57553,57554,57555,1,2,0
16468,1,3,57554,57555,57558,1,4,0
16469,3,1,57557,57558,57559,1,2,0
16470,3,3,57560,57560,57563,0,3,1
16471,6,1,57566,57566,57567,0,1,3
16472,5,3,57571,57571,57574,0,3,4
16473,2,3,57573,57574,57577,1,4,0
16474,3,2,57576,57577,57579,1,3,0
16475,2,1,57578,57579,57580,1,2,0
16476,1,2,57579,57580,57582,1,3,0
16477,4,1,57583,57583,57584,0,1,1
16478,3,3,57586,57586,57589,0,3,2
16479,2,1,57588,57589,57590,1,2,0
16480,2,2,57590,57590,57592,0,2,0
16481,3,1,57593,57593,57594,0,1,1
16482,6,2,57599,57599,57601,0,2,5
16483,4,1,57603,57603,57604,0,1,2
16484,5,1,57608,57608,57609,0,1,4
16485,1,1,57609,57609,57610,0,1,0
16486,3,3,57612,57612,57615,0,3,2
16487,5,3,57617,57617,57620,0,3,2
16488,2,3,57619,57620,57623,1,4,0
16489,2,3,57621,57623,57626,2,5,0
16490,3,2,57624,57626,57628,2,4,0
16491,6,3,57630,57630,57633,0,3,2
16492,3,1,57633,57633,57634,0,1,0
16493,2,1,57635,57635,57636,0,1,1
16494,5,2,57640,57640,57642,0,2,4
16495,2,3,57642,57642,57645,0,3,0
16496,6,2,57648,57648,57650,0,2,3
16497,2,1,57650,57650,57651,0,1,0
16498,3,2,57653,57653,57655,0,2,2
16499,3,1,57656,57656,57657,0,1,1
16500,3,3,57659,57659,57662,0,3,2
16501,5,1,57664,57664,57665,0,1,2
16502,3,2,57667,57667,57669,0,2,2
16503,4,1,57671,57671,57672,0,1,2
16504,5,1,57676,57676,57677,0,1,4
16505,6,3,57682,57682,57685,0,3,5
16506,1,1,57683,57685,57686,2,3,0
16507,5,1,57688,57688,57689,0,1,2
16508,4,3,57692,57692,57695,0,3,3
16509,6,3,57698,57698,57701,0,3,3
16510,4,3,57702,57702,57705,0,3,1
16511,1,2,57703,57705,57707,2,4,0
16512,2,2,57705,57707,57709,2,4,0
16513,5,3,57710,57710,57713,0,3,1
16514,4,2,57714,57714,57716,0,2,1
16515,5,1,57719,57719,57720,0,1,3
16516,5,3,57724,57724,57727,0,3,4
16517,4,1,57728,57728,57729,0,1,1
16518,1,3,57729,57729,57732,0,3,0
16519,6,2,57735,57735,57737,0,2,3
16520,5,1,57740,57740,57741,0,1,3
16521,5,1,57745,57745,57746,0,1,4
16522,4,2,57749,57749,57751,0,2,3
16523,5,1,57754,57754,57755,0,1,3
16524,3,2,57757,57757,57759,0,2,2
16525,1,3,57758,57759,57762,1,4,0
16526,3,2,57761,57762,57764,1,3,0
16527,5,2,57766,57766,57768,0,2,2
16528,5,2,57771,57771,57773,0,2,3
16529,4,2,57775,57775,57777,0,2,2
16530,6,3,57781,57781,57784,0,3,4
16531,4,2,57785,57785,57787,0,2,1
16532,4,1,57789,57789,57790,0,1,2
16533,1,3,57790,57790,57793,0,3,0
16534,6,1,57796,57796,57797,0,1,3
16535,6,1,57802,57802,57803,0,1,5
16536,2,2,57804,57804,57806,0,2,1
16537,4,2,57808,57808,57810,0,2,2
16538,1,3,57809,57810,57813,1,4,0
16539,2,1,57811,57813,57814,2,3,0
16540,3,3,57814,57814,57817,0,3,0
16541,1,3,57815,57817,57820,2,5,0
16542,1,3,57816,57820,57823,4,7,0
16543,3,2,57819,57823,57825,4,6,0
16544,3,1,57822,57825,57826,3,4,0
16545,6,2,57828,57828,57830,0,2,2
16546,3,2,57831,57831,57833,0,2,1
16547,2,3,57833,57833,57836,0,3,0
16548,3,1,57836,57836,57837,0,1,0
16549,2,1,57838,57838,57839,0,1,1
16550,3,2,57841,57841,57843,0,2,2
16551,3,2,57844,57844,57846,0,2,1
16552,2,3,57846,57846,57849,0,3,0
16553,6,3,57852,57852,57855,0,3,3
16554,6,1,57858,57858,57859,0,1,3
16555,5,1,57863,57863,57864,0,1,4
16556,4,1,57867,57867,57868,0,1,3
16557,5,2,57872,57872,57874,0,2,4
16558,6,1,57878,57878,57879,0,1,4
16559,2,2,57880,57880,57882,0,2,1
16560,2,3,57882,57882,57885,0,3,0
16561,4,2,57886,57886,57888,0,2,1
16562,3,3,57889,57889,57892,0,3,1
16563,6,2,57895,57895,57897,0,2,3
16564,6,2,57901,57901,57903,0,2,4
16565,5,1,57906,57906,57907,0,1,3
16566,1,3,57907,57907,57910,0,3,0
16567,1,2,57908,57910,57912,2,4,0
16568,6,3,57914,57914,57917,0,3,2
16569,5,2,57919,57919,57921,0,2,2
16570,3,1,57922,57922,57923,0,1,1
16571,5,2,57927,57927,57929,0,2,4
16572,6,3,57933,57933,57936,0,3,4
16573,2,2,57935,57936,57938,1,3,0
16574,3,2,57938,57938,57940,0,2,0
16575,1,3,57939,57940,57943,1,4,0
16576,3,1,57942,57943,57944,1,2,0
16577,3,2,57945,57945,57947,0,2,1
16578,6,1,57951,57951,57952,0,1,4
16579,4,1,57955,57955,57956,0,1,3
16580,6,2,57961,57961,57963,0,2,5
16581,1,1,57962,57963,57964,1,2,0
16582,6,1,57968,57968,57969,0,1,4
16583,6,1,57974,57974,57975,0,1,5
16584,5,1,57979,57979,57980,0,1,4
16585,2,2,57981,57981,57983,0,2,1
16586,1,1,57982,57983,57984,1,2,0
16587,6,3,57988,57988,57991,0,3,4
16588,6,1,57994,57994,57995,0,1,3
16589,6,2,58000,58000,58002,0,2,5
16590,4,2,58004,58004,58006,0,2,2
16591,6,2,58010,58010,58012,0,2,4
16592,2,1,58012,58012,58013,0,1,0
16593,5,3,58017,58017,58020,0,3,4
16594,1,1,58018,58020,58021,2,3,0
16595,2,1,58020,58021,58022,1,2,0
16596,6,3,58026,58026,58029,0,3,4
16597,2,1,58028,58029,58030,1,2,0
16598,6,2,58034,58034,58036,0,2,4
16599,2,3,58036,58036,58039,0,3,0
16600,6,3,58042,58042,58045,0,3,3
16601,1,1,58043,58045,58046,2,3,0
16602,1,2,58044,58046,58048,2,4,0
16603,1,3,58045,58048,58051,3,6,0
16604,1,3,58046,58051,58054,5,8,0
16605,4,3,58050,58054,58057,4,7,0
16606,4,3,58054,58057,58060,3,6,0
16607,1,2,58055,58060,58062,5,7,0
16608,2,3,58057,58062,58065,5,8,0
16609,4,1,58061,58065,58066,4,5,0
16610,4,2,58065,58066,58068,1,3,0
16611,6,1,58071,58071,58072,0,1,3
16612,2,1,58073,58073,58074,0,1,1
16613,6,2,58079,58079,58081,0,2,5
16614,1,1,58080,58081,58082,1,2,0
16615,2,3,58082,58082,58085,0,3,0
16616,1,1,58083,58085,58086,2,3,0
16617,3,1,58086,58086,58087,0,1,0
16618,1,2,58087,58087,58089,0,2,0
16619,5,2,58092,58092,58094,0,2,3
16620,2,3,58094,58094,58097,0,3,0
16621,2,3,58096,58097,58100,1,4,0
16622,2,1,58098,58100,58101,2,3,0
16623,3,1,58101,58101,58102,0,1,0
16624,2,1,58103,58103,58104,0,1,1
16625,4,1,58107,58107,58108,0,1,3
16626,2,3,58109,58109,58112,0,3,1
16627,3,1,58112,58112,58113,0,1,0
16628,5,1,58117,58117,58118,0,1,4
16629,5,3,58122,58122,58125,0,3,4
16630,6,1,58128,58128,58129,0,1,3
16631,6,3,58134,58134,58137,0,3,5
16632,5,2,58139,58139,58141,0,2,2
16633,3,2,58142,58142,58144,0,2,1
16634,1,3,58143,58144,58147,1,4,0
16635,3,3,58146,58147,58150,1,4,0
16636,2,3,58148,58150,58153,2,5,0
16637,1,1,58149,58153,58154,4,5,0
16638,5,2,58154,58154,58156,0,2,0
16639,4,3,58158,58158,58161,0,3,2
16640,5,1,58163,58163,58164,0,1,2
16641,5,3,58168,58168,58171,0,3,4
16642,6,1,58174,58174,58175,0,1,3
16643,3,2,58177,58177,58179,0,2,2
16644,5,3,58182,58182,58185,0,3,3
16645,5,3,58187,58187,58190,0,3,2
16646,6,2,58193,58193,58195,0,2,3
16647,4,2,58197,58197,58199,0,2,2
16648,5,2,58202,58202,58204,0,2,3
16649,4,3,58206,58206,58209,0,3,2
16650,2,2,58208,58209,58211,1,3,0
16651,6,1,58214,58214,58215,0,1,3
16652,1,2,58215,58215,58217,0,2,0
16653,3,2,58218,58218,58220,0,2,1
16654,4,1,58222,58222,58223,0,1,2
16655,5,2,58227,58227,58229,0,2,4
16656,1,3,58228,58229,58232,1,4,0
16657,5,2,58233,58233,58235,0,2,1
16658,5,1,58238,58238,58239,0,1,3
16659,1,2,58239,58239,58241,0,2,0
16660,1,3,58240,58241,58244,1,4,0
16661,4,3,58244,58244,58247,0,3,0
16662,1,2,58245,58247,58249,2,4,0
16663,6,3,58251,58251,58254,0,3,2
16664,4,1,58255,58255,58256,0,1,1
16665,1,3,58256,58256,58259,0,3,0
16666,2,1,58258,58259,58260,1,2,0
16667,1,2,58259,58260,58262,1,3,0
16668,5,2,58264,58264,58266,0,2,2
16669,2,1,58266,58266,58267,0,1,0
16670,3,3,58269,58269,58272,0,3,2
16671,3,3,58272,58272,58275,0,3,0
16672,4,1,58276,58276,58277,0,1,1
16673,1,2,58277,58277,58279,0,2,0
16674,4,2,58281,58281,58283,0,2,2
16675,6,1,58287,58287,58288,0,1,4
16676,2,1,58289,58289,58290,0,1,1
16677,2,3,58291,58291,58294,0,3,1
16678,5,1,58296,58296,58297,0,1,2
16679,2,2,58298,58298,58300,0,2,1
16680,5,1,58303,58303,58304,0,1,3
16681,1,2,58304,58304,58306,0,2,0
16682,5,2,58309,58309,58311,0,2,3
16683,3,3,58312,58312,58315,0,3,1
16684,1,3,58313,58315,58318,2,5,0
16685,2,3,58315,58318,58321,3,6,0
16686,1,3,58316,58321,58324,5,8,0
16687,6,3,58322,58324,58327,2,5,0
16688,1,3,58323,58327,58330,4,7,0
16689,6,1,58329,58330,58331,1,2,0
16690,1,3,58330,58331,58334,1,4,0
16691,2,2,58332,58334,58336,2,4,0
16692,1,3,58333,58336,58339,3,6,0
16693,3,3,58336,58339,58342,3,6,0
16694,5,3,58341,58342,58345,1,4,0
16695,5,2,58346,58346,58348,0,2,1
16696,2,3,58348,58348,58351,0,3,0
16697,1,3,58349,58351,58354,2,5,0
16698,2,3,58351,58354,58357,3,6,0
16699,5,1,58356,58357,58358,1,2,0
16700,6,2,58362,58362,58364,0,2,4
16701,2,1,58364,58364,58365,0,1,0
16702,2,2,58366,58366,58368,0,2,1
16703,5,2,58371,58371,58373,0,2,3
16704,4,2,58375,58375,58377,0,2,2
16705,3,3,58378,58378,58381,0,3,1
16706,2,1,58380,58381,58382,1,2,0
16707,2,2,58382,58382,58384,0,2,0
16708,3,1,58385,58385,58386,0,1,1
16709,2,3,58387,58387,58390,0,3,1
16710,5,1,58392,58392,58393,0,1,2
16711,1,3,58393,58393,58396,0,3,0
16712,2,3,58395,58396,58399,1,4,0
16713,3,1,58398,58399,58400,1,2,0
16714,2,1,58400,58400,58401,0,1,0
16715,5,1,58405,58405,58406,0,1,4
16716,5,2,58410,58410,58412,0,2,4
16717,5,1,58415,58415,58416,0,1,3
16718,2,1,58417,58417,58418,0,1,1
16719,2,3,58419,58419,58422,0,3,1
16720,2,3,58421,58422,58425,1,4,0
16721,6,2,58427,58427,58429,0,2,2
16722,5,1,58432,58432,58433,0,1,3
16723,5,2,58437,58437,58439,0,2,4
16724,2,3,58439,58439,58442,0,3,0
16725,3,1,58442,58442,58443,0,1,0
16726,5,2,58447,58447,58449,0,2,4
16727,1,2,58448,58449,58451,1,3,0
16728,4,1,58452,58452,58453,0,1,1
16729,4,1,58456,58456,58457,0,1,3
16730,3,2,58459,58459,58461,0,2,2
16731,3,3,58462,58462,58465,0,3,1
16732,4,1,58466,58466,58467,0,1,1
16733,3,3,58469,58469,58472,0,3,2
16734,6,1,58475,58475,58476,0,1,3
16735,5,1,58480,58480,58481,0,1,4
16736,3,3,58483,58483,58486,0,3,2
16737,3,3,58486,58486,58489,0,3,0
16738,5,1,58491,58491,58492,0,1,2
16739,4,1,58495,58495,58496,0,1,3
16740,1,1,58496,58496,58497,0,1,0
16741,6,2,58502,58502,58504,0,2,5
16742,4,2,58506,58506,58508,0,2,2
16743,1,2,58507,58508,58510,1,3,0
16744,6,2,58513,58513,58515,0,2,3
16745,6,2,58519,58519,58521,0,2,4
16746,3,1,58522,58522,58523,0,1,1
16747,5,2,58527,58527,58529,0,2,4
16748,3,1,58530,58530,58531,0,1,1
16749,3,2,58533,58533,58535,0,2,2
16750,4,2,58537,58537,58539,0,2,2
16751,6,3,58543,58543,58546,0,3,4
16752,3,1,58546,58546,58547,0,1,0
16753,6,1,58552,58552,58553,0,1,5
16754,3,3,58555,58555,58558,0,3,2
16755,4,1,58559,58559,58560,0,1,1
16756,5,2,58564,58564,58566,0,2,4
16757,5,2,58569,58569,58571,0,2,3
16758,5,1,58574,58574,58575,0,1,3
16759,6,2,58580,58580,58582,0,2,5
16760,2,2,58582,58582,58584,0,2,0
16761,2,2,58584,58584,58586,0,2,0
16762,5,2,58589,58589,58591,0,2,3
16763,6,3,58595,58595,58598,0,3,4
16764,1,1,58596,58598,58599,2,3,0
16765,5,3,58601,58601,58604,0,3,2
16766,4,2,58605,58605,58607,0,2,1
16767,2,1,58607,58607,58608,0,1,0
16768,6,3,58613,58613,58616,0,3,5
16769,3,3,58616,58616,58619,0,3,0
16770,4,3,58620,58620,58623,0,3,1
16771,4,2,58624,58624,58626,0,2,1
16772,6,2,58630,58630,58632,0,2,4
16773,6,1,58636,58636,58637,0,1,4
16774,5,3,58641,58641,58644,0,3,4
16775,3,1,58644,58644,58645,0,1,0
16776,6,1,58650,58650,58651,0,1,5
16777,5,2,58655,58655,58657,0,2,4
16778,5,1,58660,58660,58661,0,1,3
16779,4,2,58664,58664,58666,0,2,3
16780,2,1,58666,58666,58667,0,1,0
16781,4,1,58670,58670,58671,0,1,3
16782,3,1,58673,58673,58674,0,1,2
16783,4,2,58677,58677,58679,0,2,3
16784,2,1,58679,58679,58680,0,1,0
16785,5,2,58684,58684,58686,0,2,4
16786,6,3,58690,58690,58693,0,3,4
16787,6,1,58696,58696,58697,0,1,3
16788,2,2,58698,58698,58700,0,2,1
16789,1,3,58699,58700,58703,1,4,0
16790,2,3,58701,58703,58706,2,5,0
16791,4,1,58705,58706,58707,1,2,0
16792,1,1,58706,58707,58708,1,2,0
16793,3,3,58709,58709,58712,0,3,1
16794,4,2,58713,58713,58715,0,2,1
16795,4,1,58717,58717,58718,0,1,2
16796,6,3,58723,58723,58726,0,3,5
16797,3,1,58726,58726,58727,0,1,0
16798,5,1,58731,58731,58732,0,1,4
16799,3,2,58734,58734,58736,0,2,2
16800,5,1,58739,58739,58740,0,1,3
16801,2,1,58741,58741,58742,0,1,1
16802,2,1,58743,58743,58744,0,1,1
16803,1,2,58744,58744,58746,0,2,0
16804,2,3,58746,58746,58749,0,3,0
16805,4,1,58750,58750,58751,0,1,1
16806,5,1,58755,58755,58756,0,1,4
16807,2,2,58757,58757,58759,0,2,1
16808,2,3,58759,58759,58762,0,3,0
16809,5,3,58764,58764,58767,0,3,2
16810,6,3,58770,58770,58773,0,3,3
16811,4,2,58774,58774,58776,0,2,1
16812,1,3,58775,58776,58779,1,4,0
16813,3,2,58778,58779,58781,1,3,0
16814,2,1,58780,58781,58782,1,2,0
16815,6,1,58786,58786,58787,0,1,4
16816,3,2,58789,58789,58791,0,2,2
16817,5,3,58794,58794,58797,0,3,3
16818,3,3,58797,58797,58800,0,3,0
16819,4,1,58801,58801,58802,0,1,1
16820,5,3,58806,58806,58809,0,3,4
16821,3,1,58809,58809,58810,0,1,0
16822,4,2,58813,58813,58815,0,2,3
16823,2,3,58815,58815,58818,0,3,0
16824,1,1,58816,58818,58819,2,3,0
16825,1,2,58817,58819,58821,2,4,0
16826,3,1,58820,58821,58822,1,2,0
16827,3,1,58823,58823,58824,0,1,1
16828,1,3,58824,58824,58827,0,3,0
16829,3,2,58827,58827,58829,0,2,0
16830,1,3,58828,58829,58832,1,4,0
16831,4,1,58832,58832,58833,0,1,0
16832,6,1,58838,58838,58839,0,1,5
16833,2,3,58840,58840,58843,0,3,1
16834,4,3,58844,58844,58847,0,3,1
16835,3,1,58847,58847,58848,0,1,0
16836,3,1,58850,58850,58851,0,1,2
16837,4,1,58854,58854,58855,0,1,3
16838,5,2,58859,58859,58861,0,2,4
16839,4,2,58863,58863,58865,0,2,2
16840,4,3,58867,58867,58870,0,3,2
16841,5,1,58872,58872,58873,0,1,2
16842,6,2,58878,58878,58880,0,2,5
16843,6,3,58884,58884,58887,0,3,4
16844,6,3,58890,58890,58893,0,3,3
16845,3,2,58893,58893,58895,0,2,0
16846,4,2,58897,58897,58899,0,2,2
16847,2,2,58899,58899,58901,0,2,0
16848,2,2,58901,58901,58903,0,2,0
16849,6,2,58907,58907,58909,0,2,4
16850,4,2,58911,58911,58913,0,2,2
16851,4,2,58915,58915,58917,0,2,2
16852,4,3,58919,58919,58922,0,3,2
16853,5,3,58924,58924,58927,0,3,2
16854,2,3,58926,58927,58930,1,4,0
16855,4,3,58930,58930,58933,0,3,0
16856,3,3,58933,58933,58936,0,3,0
16857,4,2,58937,58937,58939,0,2,1
16858,5,3,58942,58942,58945,0,3,3
16859,2,2,58944,58945,58947,1,3,0
16860,3,2,58947,58947,58949,0,2,0
16861,1,2,58948,58949,58951,1,3,0
16862,4,2,58952,58952,58954,0,2,1
16863,1,1,58953,58954,58955,1,2,0
16864,5,3,58958,58958,58961,0,3,3
16865,5,2,58963,58963,58965,0,2,2
16866,1,1,58964,58965,58966,1,2,0
16867,2,1,58966,58966,58967,0,1,0
16868,1,3,58967,58967,58970,0,3,0
16869,4,3,58971,58971,58974,0,3,1
16870,5,2,58976,58976,58978,0,2,2
16871,3,1,58979,58979,58980,0,1,1
16872,5,3,58984,58984,58987,0,3,4
16873,4,1,58988,58988,58989,0,1,1
16874,4,3,58992,58992,58995,0,3,3
16875,1,3,58993,58995,58998,2,5,0
16876,5,1,58998,58998,58999,0,1,0
16877,2,1,59000,59000,59001,0,1,1
16878,4,2,59004,59004,59006,0,2,3
16879,1,2,59005,59006,59008,1,3,0
16880,6,3,59011,59011,59014,0,3,3
16881,3,1,59014,59014,59015,0,1,0
16882,6,3,59020,59020,59023,0,3,5
16883,5,3,59025,59025,59028,0,3,2
16884,2,1,59027,59028,59029,1,2,0
16885,3,1,59030,59030,59031,0,1,1
16886,5,3,59035,59035,59038,0,3,4
16887,1,2,59036,59038,59040,2,4,0
16888,6,2,59042,59042,59044,0,2,2
16889,3,2,59045,59045,59047,0,2,1
16890,2,1,59047,59047,59048,0,1,0
16891,2,2,59049,59049,59051,0,2,1
16892,2,1,59051,59051,59052,0,1,0
16893,2,3,59053,59053,59056,0,3,1
16894,6,3,59059,59059,59062,0,3,3
16895,4,3,59063,59063,59066,0,3,1
16896,5,1,59068,59068,59069,0,1,2
16897,5,1,59073,59073,59074,0,1,4
16898,3,3,59076,59076,59079,0,3,2
16899,5,1,59081,59081,59082,0,1,2
16900,5,2,59086,59086,59088,0,2,4
16901,6,1,59092,59092,59093,0,1,4
16902,2,2,59094,59094,59096,0,2,1
16903,3,1,59097,59097,59098,0,1,1
16904,1,3,59098,59098,59101,0,3,0
16905,1,3,59099,59101,59104,2,5,0
16906,3,2,59102,59104,59106,2,4,0
16907,2,3,59104,59106,59109,2,5,0
16908,3,1,59107,59109,59110,2,3,0
16909,4,2,59111,59111,59113,0,2,1
16910,6,1,59117,59117,59118,0,1,4
16911,6,2,59123,59123,59125,0,2,5
16912,2,2,59125,59125,59127,0,2,0
16913,1,3,59126,59127,59130,1,4,0
16914,6,3,59132,59132,59135,0,3,2
16915,1,2,59133,59135,59137,2,4,0
16916,6,3,59139,59139,59142,0,3,2
16917,1,1,59140,59142,59143,2,3,0
16918,1,3,59141,59143,59146,2,5,0
16919,4,3,59145,59146,59149,1,4,0
16920,3,2,59148,59149,59151,1,3,0
16921,4,3,59152,59152,59155,0,3,1
16922,1,2,59153,59155,59157,2,4,0
16923,1,1,59154,59157,59158,3,4,0
16924,4,3,59158,59158,59161,0,3,0
16925,5,1,59163,59163,59164,0,1,2
16926,1,1,59164,59164,59165,0,1,0
16927,6,2,59170,59170,59172,0,2,5
16928,1,1,59171,59172,59173,1,2,0
16929,1,1,59172,59173,59174,1,2,0
16930,4,1,59176,59176,59177,0,1,2
16931,6,1,59182,59182,59183,0,1,5
16932,6,1,59188,59188,59189,0,1,5
16933,2,1,59190,59190,59191,0,1,1
16934,5,1,59195,59195,59196,0,1,4
16935,1,1,59196,59196,59197,0,1,0
16936,5,2,59201,59201,59203,0,2,4
16937,5,3,59206,59206,59209,0,3,3
16938,6,2,59212,59212,59214,0,2,3
16939,5,1,59217,59217,59218,0,1,3
16940,2,3,59219,59219,59222,0,3,1
16941,4,1,59223,59223,59224,0,1,1
16942,2,2,59225,59225,59227,0,2,1
16943,3,1,59228,59228,59229,0,1,1
16944,5,2,59233,59233,59235,0,2,4
16945,6,1,59239,59239,59240,0,1,4
16946,4,1,59243,59243,59244,0,1,3
16947,2,1,59245,59245,59246,0,1,1
16948,3,2,59248,59248,59250,0,2,2
16949,4,2,59252,59252,59254,0,2,2
16950,2,2,59254,59254,59256,0,2,0
16951,2,1,59256,59256,59257,0,1,0
16952,5,3,59261,59261,59264,0,3,4
16953,4,1,59265,59265,59266,0,1,1
16954,2,2,59267,59267,59269,0,2,1
16955,6,3,59273,59273,59276,0,3,4
16956,4,1,59277,59277,59278,0,1,1
16957,3,1,59280,59280,59281,0,1,2
16958,2,2,59282,59282,59284,0,2,1
16959,1,2,59283,59284,59286,1,3,0
16960,3,2,59286,59286,59288,0,2,0
16961,6,3,59292,59292,59295,0,3,4
16962,5,3,59297,59297,59300,0,3,2
16963,6,2,59303,59303,59305,0,2,3
16964,2,2,59305,59305,59307,0,2,0
16965,2,3,59307,59307,59310,0,3,0
16966,5,3,59312,59312,59315,0,3,2
16967,4,1,59316,59316,59317,0,1,1
16968,3,3,59319,59319,59322,0,3,2
16969,3,2,59322,59322,59324,0,2,0
16970,6,2,59328,59328,59330,0,2,4
16971,2,2,59330,59330,59332,0,2,0
16972,3,1,59333,59333,59334,0,1,1
16973,4,1,59337,59337,59338,0,1,3
16974,6,2,59343,59343,59345,0,2,5
16975,5,3,59348,59348,59351,0,3,3
16976,4,2,59352,59352,59354,0,2,1
16977,6,2,59358,59358,59360,0,2,4
16978,4,2,59362,59362,59364,0,2,2
16979,3,2,59365,59365,59367,0,2,1
16980,4,2,59369,59369,59371,0,2,2
16981,1,2,59370,59371,59373,1,3,0
16982,1,1,59371,59373,59374,2,3,0
16983,6,1,59377,59377,59378,0,1,3
16984,1,1,59378,59378,59379,0,1,0
16985,5,2,59383,59383,59385,0,2,4
16986,2,2,59385,59385,59387,0,2,0
16987,1,2,59386,59387,59389,1,3,0
16988,2,2,59388,59389,59391,1,3,0
16989,4,3,59392,59392,59395,0,3,1
16990,5,1,59397,59397,59398,0,1,2
16991,2,1,59399,59399,59400,0,1,1
16992,3,2,59402,59402,59404,0,2,2
16993,2,3,59404,59404,59407,0,3,0
16994,4,1,59408,59408,59409,0,1,1
16995,5,2,59413,59413,59415,0,2,4
16996,1,2,59414,59415,59417,1,3,0
16997,4,3,59418,59418,59421,0,3,1
16998,1,3,59419,59421,59424,2,5,0
16999,5,2,59424,59424,59426,0,2,0
17000,3,1,59427,59427,59428,0,1,1
17001,6,1,59433,59433,59434,0,1,5
17002,4,2,59437,59437,59439,0,2,3
17003,4,3,59441,59441,59444,0,3,2
17004,5,2,59446,59446,59448,0,2,2
17005,2,2,59448,59448,59450,0,2,0
17006,3,3,59451,59451,59454,0,3,1
17007,1,2,59452,59454,59456,2,4,0
17008,6,1,59458,59458,59459,0,1,2
17009,4,2,59462,59462,59464,0,2,3
17010,5,3,59467,59467,59470,0,3,3
17011,2,3,59469,59470,59473,1,4,0
17012,6,2,59475,59475,59477,0,2,2
17013,5,3,59480,59480,59483,0,3,3
17014,5,3,59485,59485,59488,0,3,2
17015,5,1,59490,59490,59491,0,1,2
17016,1,3,59491,59491,59494,0,3,0
17017,4,3,59495,59495,59498,0,3,1
17018,3,1,59498,59498,59499,0,1,0
17019,5,2,59503,59503,59505,0,2,4
17020,3,2,59506,59506,59508,0,2,1
17021,4,1,59510,59510,59511,0,1,2
17022,6,2,59516,59516,59518,0,2,5
17023,4,1,59520,59520,59521,0,1,2
17024,4,3,59524,59524,59527,0,3,3
17025,1,3,59525,59527,59530,2,5,0
17026,6,3,59531,59531,59534,0,3,1
17027,4,3,59535,59535,59538,0,3,1
17028,3,3,59538,59538,59541,0,3,0
17029,4,1,59542,59542,59543,0,1,1
17030,4,1,59546,59546,59547,0,1,3
17031,1,2,59547,59547,59549,0,2,0
17032,4,3,59551,59551,59554,0,3,2
17033,6,1,59557,59557,59558,0,1,3
17034,4,2,59561,59561,59563,0,2,3
17035,3,2,59564,59564,59566,0,2,1
17036,1,3,59565,59566,59569,1,4,0
17037,3,1,59568,59569,59570,1,2,0
17038,5,1,59573,59573,59574,0,1,3
17039,6,1,59579,59579,59580,0,1,5
17040,5,3,59584,59584,59587,0,3,4
17041,4,1,59588,59588,59589,0,1,1
17042,2,1,59590,59590,59591,0,1,1
17043,6,3,59596,59596,59599,0,3,5
17044,5,2,59601,59601,59603,0,2,2
17045,1,3,59602,59603,59606,1,4,0
17046,2,3,59604,59606,59609,2,5,0
17047,4,3,59608,59609,59612,1,4,0
17048,3,3,59611,59612,59615,1,4,0
17049,6,3,59617,59617,59620,0,3,2
17050,3,3,59620,59620,59623,0,3,0
17051,2,3,59622,59623,59626,1,4,0
17052,4,3,59626,59626,59629,0,3,0
17053,1,3,59627,59629,59632,2,5,0
17054,2,3,59629,59632,59635,3,6,0
17055,6,3,59635,59635,59638,0,3,0
17056,3,2,59638,59638,59640,0,2,0
17057,2,1,59640,59640,59641,0,1,0
17058,5,1,59645,59645,59646,0,1,4
17059,5,3,59650,59650,59653,0,3,4
17060,5,1,59655,59655,59656,0,1,2
17061,4,1,59659,59659,59660,0,1,3
17062,3,3,59662,59662,59665,0,3,2
17063,1,2,59663,59665,59667,2,4,0
17064,1,1,59664,59667,59668,3,4,0
17065,2,1,59666,59668,59669,2,3,0
17066,4,1,59670,59670,59671,0,1,1
17067,6,2,59676,59676,59678,0,2,5
17068,5,2,59681,59681,59683,0,2,3
17069,2,2,59683,59683,59685,0,2,0
17070,3,2,59686,59686,59688,0,2,1
17071,6,2,59692,59692,59694,0,2,4
17072,3,3,59695,59695,59698,0,3,1
17073,6,1,59701,59701,59702,0,1,3
17074,3,3,59704,59704,59707,0,3,2
17075,6,1,59710,59710,59711,0,1,3
17076,4,2,59714,59714,59716,0,2,3
17077,1,1,59715,59716,59717,1,2,0
17078,2,1,59717,59717,59718,0,1,0
17079,3,3,59720,59720,59723,0,3,2
17080,3,1,59723,59723,59724,0,1,0
17081,3,2,59726,59726,59728,0,2,2
17082,2,2,59728,59728,59730,0,2,0
17083,4,2,59732,59732,59734,0,2,2
17084,6,3,59738,59738,59741,0,3,4
17085,1,2,59739,59741,59743,2,4,0
17086,2,1,59741,59743,59744,2,3,0
17087,2,1,59743,59744,59745,1,2,0
17088,1,1,59744,59745,59746,1,2,0
17089,1,1,59745,59746,59747,1,2,0
17090,1,1,59746,59747,59748,1,2,0
17091,4,3,59750,59750,59753,0,3,2
17092,3,3,59753,59753,59756,0,3,0
17093,4,2,59757,59757,59759,0,2,1
17094,3,1,59760,59760,59761,0,1,1
17095,5,2,59765,59765,59767,0,2,4
17096,3,1,59768,59768,59769,0,1,1
17097,3,1,59771,59771,59772,0,1,2
17098,5,3,59776,59776,59779,0,3,4
17099,4,2,59780,59780,59782,0,2,1
17100,2,1,59782,59782,59783,0,1,0
17101,5,3,59787,59787,59790,0,3,4
17102,6,2,59793,59793,59795,0,2,3
17103,3,2,59796,59796,59798,0,2,1
17104,5,1,59801,59801,59802,0,1,3
17105,2,1,59803,59803,59804,0,1,1
17106,6,3,59809,59809,59812,0,3,5
17107,4,3,59813,59813,59816,0,3,1
17108,5,2,59818,59818,59820,0,2,2
17109,2,2,59820,59820,59822,0,2,0
17110,2,2,59822,59822,59824,0,2,0
17111,5,1,59827,59827,59828,0,1,3
17112,5,2,59832,59832,59834,0,2,4
17113,3,3,59835,59835,59838,0,3,1
17114,6,3,59841,59841,59844,0,3,3
17115,3,2,59844,59844,59846,0,2,0
17116,6,2,59850,59850,59852,0,2,4
17117,5,3,59855,59855,59858,0,3,3
17118,1,2,59856,59858,59860,2,4,0
17119,3,1,59859,59860,59861,1,2,0
17120,5,2,59864,59864,59866,0,2,3
17121,6,3,59870,59870,59873,0,3,4
17122,6,2,59876,59876,59878,0,2,3
17123,2,3,59878,59878,59881,0,3,0
17124,6,1,59884,59884,59885,0,1,3
17125,5,1,59889,59889,59890,0,1,4
17126,4,1,59893,59893,59894,0,1,3
17127,6,1,59899,59899,59900,0,1,5
17128,3,3,59902,59902,59905,0,3,2
17129,1,3,59903,59905,59908,2,5,0
17130,3,1,59906,59908,59909,2,3,0
17131,4,1,59910,59910,59911,0,1,1
17132,2,3,59912,59912,59915,0,3,1
17133,3,3,59915,59915,59918,0,3,0
17134,4,1,59919,59919,59920,0,1,1
17135,5,3,59924,59924,59927,0,3,4
17136,6,3,59930,59930,59933,0,3,3
17137,2,3,59932,59933,59936,1,4,0
17138,4,1,59936,59936,59937,0,1,0
17139,1,3,59937,59937,59940,0,3,0
17140,2,2,59939,59940,59942,1,3,0
17141,2,3,59941,59942,59945,1,4,0
17142,6,2,59947,59947,59949,0,2,2
17143,3,2,59950,59950,59952,0,2,1
17144,6,2,59956,59956,59958,0,2,4
17145,2,1,59958,59958,59959,0,1,0
17146,2,3,59960,59960,59963,0,3,1
17147,5,3,59965,59965,59968,0,3,2
17148,2,2,59967,59968,59970,1,3,0
17149,4,1,59971,59971,59972,0,1,1
17150,6,3,59977,59977,59980,0,3,5
17151,5,1,59982,59982,59983,0,1,2
17152,5,1,59987,59987,59988,0,1,4
17153,3,3,59990,59990,59993,0,3,2
17154,2,1,59992,59993,59994,1,2,0
17155,3,1,59995,59995,59996,0,1,1
17156,2,1,59997,59997,59998,0,1,1
17157,1,2,59998,59998,60000,0,2,0
17158,4,3,60002,60002,60005,0,3,2
17159,5,2,60007,60007,60009,0,2,2
17160,2,2,60009,60009,60011,0,2,0
17161,2,1,60011,60011,60012,0,1,0
17162,2,2,60013,60013,60015,0,2,1
17163,5,1,60018,60018,60019,0,1,3
17164,1,1,60019,60019,60020,0,1,0
17165,2,1,60021,60021,60022,0,1,1
17166,6,2,60027,60027,60029,0,2,5
17167,4,1,60031,60031,60032,0,1,2
17168,4,2,60035,60035,60037,0,2,3
17169,6,3,60041,60041,60044,0,3,4
17170,3,2,60044,60044,60046,0,2,0
17171,4,3,60048,60048,60051,0,3,2
17172,5,3,60053,60053,60056,0,3,2
17173,5,3,60058,60058,60061,0,3,2
17174,6,2,60064,60064,60066,0,2,3
17175,5,2,60069,60069,60071,0,2,3
17176,2,2,60071,60071,60073,0,2,0
17177,1,3,60072,60073,60076,1,4,0
17178,4,1,60076,60076,60077,0,1,0
17179,6,3,60082,60082,60085,0,3,5
17180,6,3,60088,60088,60091,0,3,3
17181,6,3,60094,60094,60097,0,3,3
17182,1,1,60095,60097,60098,2,3,0
17183,2,3,60097,60098,60101,1,4,0
17184,6,1,60103,60103,60104,0,1,2
17185,2,2,60105,60105,60107,0,2,1
17186,5,3,60110,60110,60113,0,3,3
17187,2,3,60112,60113,60116,1,4,0
17188,2,1,60114,60116,60117,2,3,0
17189,1,1,60115,60117,60118,2,3,0
17190,6,3,60121,60121,60124,0,3,3
17191,4,2,60125,60125,60127,0,2,1
17192,2,1,60127,60127,60128,0,1,0
17193,4,3,60131,60131,60134,0,3,3
17194,3,2,60134,60134,60136,0,2,0
17195,2,2,60136,60136,60138,0,2,0
17196,2,3,60138,60138,60141,0,3,0
17197,2,2,60140,60141,60143,1,3,0
17198,5,3,60145,60145,60148,0,3,2
17199,2,1,60147,60148,60149,1,2,0
17200,6,3,60153,60153,60156,0,3,4
17201,6,3,60159,60159,60162,0,3,3
17202,6,3,60165,60165,60168,0,3,3
17203,3,2,60168,60168,60170,0,2,0
17204,1,2,60169,60170,60172,1,3,0
17205,4,3,60173,60173,60176,0,3,1
17206,3,1,60176,60176,60177,0,1,0
17207,5,2,60181,60181,60183,0,2,4
17208,2,2,60183,60183,60185,0,2,0
17209,5,2,60188,60188,60190,0,2,3
17210,5,2,60193,60193,60195,0,2,3
17211,1,1,60194,60195,60196,1,2,0
17212,5,1,60199,60199,60200,0,1,3
17213,1,3,60200,60200,60203,0,3,0
17214,1,1,60201,60203,60204,2,3,0
17215,1,2,60202,60204,60206,2,4,0
17216,3,1,60205,60206,60207,1,2,0
17217,5,3,60210,60210,60213,0,3,3
17218,1,1,60211,60213,60214,2,3,0
17219,1,1,60212,60214,60215,2,3,0
17220,2,1,60214,60215,60216,1,2,0
17221,2,1,60216,60216,60217,0,1,0
17222,4,3,60220,60220,60223,0,3,3
17223,5,2,60225,60225,60227,0,2,2
17224,4,2,60229,60229,60231,0,2,2
17225,5,1,60234,60234,60235,0,1,3
17226,2,2,60236,60236,60238,0,2,1
17227,5,3,60241,60241,60244,0,3,3
17228,4,1,60245,60245,60246,0,1,1
17229,2,3,60247,60247,60250,0,3,1
17230,6,1,60253,60253,60254,0,1,3
17231,2,1,60255,60255,60256,0,1,1
17232,2,1,60257,60257,60258,0,1,1
17233,6,2,60263,60263,60265,0,2,5
17234,6,3,60269,60269,60272,0,3,4
17235,2,3,60271,60272,60275,1,4,0
17236,2,3,60273,60275,60278,2,5,0
17237,5,2,60278,60278,60280,0,2,0
17238,3,1,60281,60281,60282,0,1,1
17239,2,3,60283,60283,60286,0,3,1
17240,6,3,60289,60289,60292,0,3,3
17241,2,2,60291,60292,60294,1,3,0
17242,1,3,60292,60294,60297,2,5,0
17243,1,1,60293,60297,60298,4,5,0
17244,4,1,60297,60298,60299,1,2,0
17245,4,1,60301,60301,60302,0,1,2
17246,3,2,60304,60304,60306,0,2,2
17247,2,1,60306,60306,60307,0,1,0
17248,2,1,60308,60308,60309,0,1,1
17249,4,3,60312,60312,60315,0,3,3
17250,5,3,60317,60317,60320,0,3,2
17251,3,3,60320,60320,60323,0,3,0
17252,4,2,60324,60324,60326,0,2,1
17253,4,1,60328,60328,60329,0,1,2
17254,5,2,60333,60333,60335,0,2,4
17255,1,2,60334,60335,60337,1,3,0
17256,4,3,60338,60338,60341,0,3,1
17257,2,2,60340,60341,60343,1,3,0
17258,1,3,60341,60343,60346,2,5,0
17259,6,2,60347,60347,60349,0,2,1
17260,2,1,60349,60349,60350,0,1,0
17261,1,2,60350,60350,60352,0,2,0
17262,6,3,60356,60356,60359,0,3,4
17263,5,1,60361,60361,60362,0,1,2
17264,3,1,60364,60364,60365,0,1,2
17265,2,3,60366,60366,60369,0,3,1
17266,4,2,60370,60370,60372,0,2,1
17267,4,3,60374,60374,60377,0,3,2
17268,4,2,60378,60378,60380,0,2,1
17269,3,1,60381,60381,60382,0,1,1
17270,6,3,60387,60387,60390,0,3,5
17271,5,3,60392,60392,60395,0,3,2
17272,4,1,60396,60396,60397,0,1,1
17273,5,1,60401,60401,60402,0,1,4
17274,2,1,60403,60403,60404,0,1,1
17275,3,3,60406,60406,60409,0,3,2
17276,3,1,60409,60409,60410,0,1,0
17277,2,1,60411,60411,60412,0,1,1
17278,3,3,60414,60414,60417,0,3,2
17279,6,1,60420,60420,60421,0,1,3
17280,3,1,60423,60423,60424,0,1,2
17281,4,3,60427,60427,60430,0,3,3
17282,6,3,60433,60433,60436,0,3,3
17283,2,2,60435,60436,60438,1,3,0
17284,5,3,60440,60440,60443,0,3,2
17285,2,1,60442,60443,60444,1,2,0
17286,5,1,60447,60447,60448,0,1,3
17287,5,1,60452,60452,60453,0,1,4
17288,2,1,60454,60454,60455,0,1,1
17289,6,1,60460,60460,60461,0,1,5
17290,6,1,60466,60466,60467,0,1,5
17291,5,3,60471,60471,60474,0,3,4
17292,3,3,60474,60474,60477,0,3,0
17293,2,3,60476,60477,60480,1,4,0
17294,5,2,60481,60481,60483,0,2,1
17295,6,3,60487,60487,60490,0,3,4
17296,6,1,60493,60493,60494,0,1,3
17297,4,2,60497,60497,60499,0,2,3
17298,1,3,60498,60499,60502,1,4,0
17299,4,3,60502,60502,60505,0,3,0
17300,1,2,60503,60505,60507,2,4,0
17301,5,2,60508,60508,60510,0,2,1
17302,6,3,60514,60514,60517,0,3,4
17303,6,3,60520,60520,60523,0,3,3
17304,4,2,60524,60524,60526,0,2,1
17305,2,3,60526,60526,60529,0,3,0
17306,5,2,60531,60531,60533,0,2,2
17307,4,3,60535,60535,60538,0,3,2
17308,1,2,60536,60538,60540,2,4,0
17309,4,1,60540,60540,60541,0,1,0
17310,4,2,60544,60544,60546,0,2,3
17311,1,2,60545,60546,60548,1,3,0
17312,6,2,60551,60551,60553,0,2,3
17313,1,2,60552,60553,60555,1,3,0
17314,5,1,60557,60557,60558,0,1,2
17315,3,2,60560,60560,60562,0,2,2
17316,3,1,60563,60563,60564,0,1,1
17317,3,2,60566,60566,60568,0,2,2
17318,5,1,60571,60571,60572,0,1,3
17319,3,3,60574,60574,60577,0,3,2
17320,1,1,60575,60577,60578,2,3,0
17321,6,1,60581,60581,60582,0,1,3
17322,2,1,60583,60583,60584,0,1,1
17323,3,1,60586,60586,60587,0,1,2
17324,2,3,60588,60588,60591,0,3,1
17325,4,3,60592,60592,60595,0,3,1
17326,5,3,60597,60597,60600,0,3,2
17327,5,1,60602,60602,60603,0,1,2
17328,1,3,60603,60603,60606,0,3,0
17329,2,3,60605,60606,60609,1,4,0
17330,3,3,60608,60609,60612,1,4,0
17331,4,1,60612,60612,60613,0,1,0
17332,4,3,60616,60616,60619,0,3,3
17333,4,3,60620,60620,60623,0,3,1
17334,1,1,60621,60623,60624,2,3,0
17335,2,1,60623,60624,60625,1,2,0
17336,5,1,60628,60628,60629,0,1,3
17337,3,1,60631,60631,60632,0,1,2
17338,3,1,60634,60634,60635,0,1,2
17339,6,1,60640,60640,60641,0,1,5
17340,2,1,60642,60642,60643,0,1,1
17341,4,2,60646,60646,60648,0,2,3
17342,5,1,60651,60651,60652,0,1,3
17343,3,1,60654,60654,60655,0,1,2
17344,6,2,60660,60660,60662,0,2,5
17345,4,2,60664,60664,60666,0,2,2
17346,6,3,60670,60670,60673,0,3,4
17347,3,1,60673,60673,60674,0,1,0
17348,3,2,60676,60676,60678,0,2,2
17349,5,3,60681,60681,60684,0,3,3
17350,3,1,60684,60684,60685,0,1,0
17351,6,3,60690,60690,60693,0,3,5
17352,2,2,60692,60693,60695,1,3,0
17353,6,1,60698,60698,60699,0,1,3
17354,2,2,60700,60700,60702,0,2,1
17355,3,2,60703,60703,60705,0,2,1
17356,6,2,60709,60709,60711,0,2,4
17357,4,1,60713,60713,60714,0,1,2
17358,2,2,60715,60715,60717,0,2,1
17359,2,1,60717,60717,60718,0,1,0
17360,1,3,60718,60718,60721,0,3,0
17361,5,2,60723,60723,60725,0,2,2
17362,4,2,60727,60727,60729,0,2,2
17363,6,2,60733,60733,60735,0,2,4
17364,4,2,60737,60737,60739,0,2,2
17365,4,2,60741,60741,60743,0,2,2
17366,4,1,60745,60745,60746,0,1,2
17367,4,2,60749,60749,60751,0,2,3
17368,5,1,60754,60754,60755,0,1,3
17369,1,2,60755,60755,60757,0,2,0
17370,2,1,60757,60757,60758,0,1,0
17371,4,1,60761,60761,60762,0,1,3
17372,3,1,60764,60764,60765,0,1,2
17373,2,3,60766,60766,60769,0,3,1
17374,1,3,60767,60769,60772,2,5,0
17375,3,1,60770,60772,60773,2,3,0
17376,3,3,60773,60773,60776,0,3,0
17377,2,1,60775,60776,60777,1,2,0
17378,5,3,60780,60780,60783,0,3,3
17379,1,1,60781,60783,60784,2,3,0
17380,6,3,60787,60787,60790,0,3,3
17381,2,2,60789,60790,60792,1,3,0
17382,4,3,60793,60793,60796,0,3,1
17383,3,2,60796,60796,60798,0,2,0
17384,4,2,60800,60800,60802,0,2,2
17385,3,1,60803,60803,60804,0,1,1
17386,6,2,60809,60809,60811,0,2,5
17387,2,2,60811,60811,60813,0,2,0
17388,4,2,60815,60815,60817,0,2,2
17389,2,2,60817,60817,60819,0,2,0
17390,1,2,60818,60819,60821,1,3,0
17391,3,3,60821,60821,60824,0,3,0
17392,1,1,60822,60824,60825,2,3,0
17393,2,1,60824,60825,60826,1,2,0
17394,6,3,60830,60830,60833,0,3,4
17395,6,1,60836,60836,60837,0,1,3
17396,3,3,60839,60839,60842,0,3,2
17397,3,2,60842,60842,60844,0,2,0
17398,6,2,60848,60848,60850,0,2,4
17399,4,2,60852,60852,60854,0,2,2
17400,5,3,60857,60857,60860,0,3,3
17401,3,1,60860,60860,60861,0,1,0
17402,5,1,60865,60865,60866,0,1,4
17403,4,2,60869,60869,60871,0,2,3
17404,3,2,60872,60872,60874,0,2,1
17405,3,2,60875,60875,60877,0,2,1
17406,4,1,60879,60879,60880,0,1,2
17407,5,2,60884,60884,60886,0,2,4
17408,1,1,60885,60886,60887,1,2,0
17409,6,1,60891,60891,60892,0,1,4
17410,3,3,60894,60894,60897,0,3,2
17411,3,2,60897,60897,60899,0,2,0
17412,6,1,60903,60903,60904,0,1,4
17413,4,3,60907,60907,60910,0,3,3
17414,6,2,60913,60913,60915,0,2,3
17415,3,3,60916,60916,60919,0,3,1
17416,4,2,60920,60920,60922,0,2,1
17417,4,3,60924,60924,60927,0,3,2
17418,4,3,60928,60928,60931,0,3,1
17419,3,3,60931,60931,60934,0,3,0
17420,2,3,60933,60934,60937,1,4,0
17421,3,2,60936,60937,60939,1,3,0
17422,6,2,60942,60942,60944,0,2,3
17423,3,2,60945,60945,60947,0,2,1
17424,2,1,60947,60947,60948,0,1,0
17425,5,3,60952,60952,60955,0,3,4
17426,3,1,60955,60955,60956,0,1,0
17427,3,3,60958,60958,60961,0,3,2
17428,6,1,60964,60964,60965,0,1,3
17429,4,3,60968,60968,60971,0,3,3
17430,5,3,60973,60973,60976,0,3,2
17431,2,3,60975,60976,60979,1,4,0
17432,1,1,60976,60979,60980,3,4,0
17433,5,2,60981,60981,60983,0,2,1
17434,2,1,60983,60983,60984,0,1,0
17435,2,3,60985,60985,60988,0,3,1
17436,3,3,60988,60988,60991,0,3,0
17437,5,2,60993,60993,60995,0,2,2
17438,3,1,60996,60996,60997,0,1,1
17439,5,3,61001,61001,61004,0,3,4
17440,5,3,61006,61006,61009,0,3,2
17441,6,2,61012,61012,61014,0,2,3
17442,3,1,61015,61015,61016,0,1,1
17443,4,1,61019,61019,61020,0,1,3
17444,4,1,61023,61023,61024,0,1,3
17445,1,3,61024,61024,61027,0,3,0
17446,2,1,61026,61027,61028,1,2,0
17447,3,3,61029,61029,61032,0,3,1
17448,2,1,61031,61032,61033,1,2,0
17449,1,2,61032,61033,61035,1,3,0
17450,5,3,61037,61037,61040,0,3,2
17451,6,3,61043,61043,61046,0,3,3
17452,1,3,61044,61046,61049,2,5,0
17453,1,3,61045,61049,61052,4,7,0
17454,6,2,61051,61052,61054,1,3,0
17455,6,2,61057,61057,61059,0,2,3
17456,4,3,61061,61061,61064,0,3,2
17457,2,1,61063,61064,61065,1,2,0
17458,1,3,61064,61065,61068,1,4,0
17459,2,3,61066,61068,61071,2,5,0
17460,3,2,61069,61071,61073,2,4,0
17461,6,3,61075,61075,61078,0,3,2
17462,4,1,61079,61079,61080,0,1,1
17463,4,1,61083,61083,61084,0,1,3
17464,1,3,61084,61084,61087,0,3,0
17465,4,2,61088,61088,61090,0,2,1
17466,5,3,61093,61093,61096,0,3,3
17467,2,1,61095,61096,61097,1,2,0
17468,3,2,61098,61098,61100,0,2,1
17469,1,1,61099,61100,61101,1,2,0
17470,3,3,61102,61102,61105,0,3,1
17471,4,2,61106,61106,61108,0,2,1
17472,1,2,61107,61108,61110,1,3,0
17473,4,1,61111,61111,61112,0,1,1
17474,3,2,61114,61114,61116,0,2,2
17475,3,3,61117,61117,61120,0,3,1
17476,3,1,61120,61120,61121,0,1,0
17477,5,1,61125,61125,61126,0,1,4
17478,5,1,61130,61130,61131,0,1,4
17479,5,1,61135,61135,61136,0,1,4
17480,4,1,61139,61139,61140,0,1,3
17481,2,2,61141,61141,61143,0,2,1
17482,6,3,61147,61147,61150,0,3,4
17483,2,3,61149,61150,61153,1,4,0
17484,1,1,61150,61153,61154,3,4,0
17485,3,3,61153,61154,61157,1,4,0
17486,5,2,61158,61158,61160,0,2,1
17487,5,2,61163,61163,61165,0,2,3
17488,5,3,61168,61168,61171,0,3,3
17489,4,2,61172,61172,61174,0,2,1
17490,4,3,61176,61176,61179,0,3,2
17491,2,3,61178,61179,61182,1,4,0
17492,4,2,61182,61182,61184,0,2,0
17493,6,2,61188,61188,61190,0,2,4
17494,1,3,61189,61190,61193,1,4,0
17495,2,2,61191,61193,61195,2,4,0
17496,3,1,61194,61195,61196,1,2,0
17497,4,2,61198,61198,61200,0,2,2
17498,4,1,61202,61202,61203,0,1,2
17499,2,3,61204,61204,61207,0,3,1
17500,3,3,61207,61207,61210,0,3,0
17501,5,1,61212,61212,61213,0,1,2
17502,6,3,61218,61218,61221,0,3,5
17503,2,2,61220,61221,61223,1,3,0
17504,1,2,61221,61223,61225,2,4,0
17505,6,2,61227,61227,61229,0,2,2
17506,6,2,61233,61233,61235,0,2,4
17507,4,3,61237,61237,61240,0,3,2
17508,4,1,61241,61241,61242,0,1,1
17509,1,2,61242,61242,61244,0,2,0
17510,2,2,61244,61244,61246,0,2,0
17511,5,1,61249,61249,61250,0,1,3
17512,1,2,61250,61250,61252,0,2,0
17513,6,2,61256,61256,61258,0,2,4
17514,2,2,61258,61258,61260,0,2,0
17515,3,3,61261,61261,61264,0,3,1
17516,5,2,61266,61266,61268,0,2,2
17517,4,1,61270,61270,61271,0,1,2
17518,2,2,61272,61272,61274,0,2,1
17519,4,3,61276,61276,61279,0,3,2
17520,6,1,61282,61282,61283,0,1,3
17521,1,1,61283,61283,61284,0,1,0
17522,3,3,61286,61286,61289,0,3,2
17523,6,3,61292,61292,61295,0,3,3
17524,6,3,61298,61298,61301,0,3,3
17525,2,2,61300,61301,61303,1,3,0
17526,6,1,61306,61306,61307,0,1,3
17527,2,1,61308,61308,61309,0,1,1
17528,6,3,61314,61314,61317,0,3,5
17529,2,1,61316,61317,61318,1,2,0
17530,5,2,61321,61321,61323,0,2,3
17531,1,1,61322,61323,61324,1,2,0
17532,5,1,61327,61327,61328,0,1,3
17533,5,3,61332,61332,61335,0,3,4
17534,4,3,61336,61336,61339,0,3,1
17535,4,1,61340,61340,61341,0,1,1
17536,2,2,61342,61342,61344,0,2,1
17537,4,3,61346,61346,61349,0,3,2
17538,5,1,61351,61351,61352,0,1,2
17539,5,3,61356,61356,61359,0,3,4
17540,5,2,61361,61361,61363,0,2,2
17541,3,3,61364,61364,61367,0,3,1
17542,1,3,61365,61367,61370,2,5,0
17543,2,3,61367,61370,61373,3,6,0
17544,5,3,61372,61373,61376,1,4,0
17545,1,3,61373,61376,61379,3,6,0
17546,5,3,61378,61379,61382,1,4,0
17547,5,3,61383,61383,61386,0,3,1
17548,5,2,61388,61388,61390,0,2,2
17549,6,2,61394,61394,61396,0,2,4
17550,6,3,61400,61400,61403,0,3,4
17551,6,3,61406,61406,61409,0,3,3
17552,5,2,61411,61411,61413,0,2,2
17553,5,1,61416,61416,61417,0,1,3
17554,6,3,61422,61422,61425,0,3,5
17555,4,1,61426,61426,61427,0,1,1
17556,4,3,61430,61430,61433,0,3,3
17557,5,1,61435,61435,61436,0,1,2
17558,5,2,61440,61440,61442,0,2,4
17559,4,2,61444,61444,61446,0,2,2
17560,6,2,61450,61450,61452,0,2,4
17561,6,3,61456,61456,61459,0,3,4
17562,3,2,61459,61459,61461,0,2,0
17563,6,3,61465,61465,61468,0,3,4
17564,5,3,61470,61470,61473,0,3,2
17565,4,3,61474,61474,61477,0,3,1
17566,5,1,61479,61479,61480,0,1,2
17567,2,3,61481,61481,61484,0,3,1
17568,6,1,61487,61487,61488,0,1,3
17569,5,1,61492,61492,61493,0,1,4
17570,2,1,61494,61494,61495,0,1,1
17571,1,2,61495,61495,61497,0,2,0
17572,3,2,61498,61498,61500,0,2,1
17573,4,2,61502,61502,61504,0,2,2
17574,1,1,61503,61504,61505,1,2,0
17575,6,2,61509,61509,61511,0,2,4
17576,1,1,61510,61511,61512,1,2,0
17577,4,3,61514,61514,61517,0,3,2
17578,2,1,61516,61517,61518,1,2,0
17579,1,3,61517,61518,61521,1,4,0
17580,2,2,61519,61521,61523,2,4,0
17581,5,2,61524,61524,61526,0,2,1
17582,5,3,61529,61529,61532,0,3,3
17583,3,3,61532,61532,61535,0,3,0
17584,4,2,61536,61536,61538,0,2,1
17585,6,1,61542,61542,61543,0,1,4
17586,4,2,61546,61546,61548,0,2,3
17587,4,1,61550,61550,61551,0,1,2
17588,3,1,61553,61553,61554,0,1,2
17589,5,2,61558,61558,61560,0,2,4
17590,4,1,61562,61562,61563,0,1,2
17591,3,1,61565,61565,61566,0,1,2
17592,6,3,61571,61571,61574,0,3,5
17593,6,3,61577,61577,61580,0,3,3
17594,1,1,61578,61580,61581,2,3,0
17595,5,2,61583,61583,61585,0,2,2
17596,4,2,61587,61587,61589,0,2,2
17597,6,2,61593,61593,61595,0,2,4
17598,5,3,61598,61598,61601,0,3,3
17599,1,3,61599,61601,61604,2,5,0
17600,5,2,61604,61604,61606,0,2,0
17601,2,2,61606,61606,61608,0,2,0
17602,4,2,61610,61610,61612,0,2,2
17603,3,3,61613,61613,61616,0,3,1
17604,5,3,61618,61618,61621,0,3,2
17605,5,1,61623,61623,61624,0,1,2
17606,6,3,61629,61629,61632,0,3,5
17607,5,1,61634,61634,61635,0,1,2
17608,3,1,61637,61637,61638,0,1,2
17609,1,2,61638,61638,61640,0,2,0
17610,6,1,61644,61644,61645,0,1,4
17611,4,2,61648,61648,61650,0,2,3
17612,3,2,61651,61651,61653,0,2,1
17613,4,1,61655,61655,61656,0,1,2
17614,1,2,61656,61656,61658,0,2,0
17615,4,2,61660,61660,61662,0,2,2
17616,5,1,61665,61665,61666,0,1,3
17617,3,1,61668,61668,61669,0,1,2
17618,4,2,61672,61672,61674,0,2,3
17619,4,3,61676,61676,61679,0,3,2
17620,5,2,61681,61681,61683,0,2,2
17621,1,3,61682,61683,61686,1,4,0
17622,5,3,61687,61687,61690,0,3,1
17623,1,1,61688,61690,61691,2,3,0
17624,3,3,61691,61691,61694,0,3,0
17625,4,2,61695,61695,61697,0,2,1
17626,3,2,61698,61698,61700,0,2,1
17627,5,3,61703,61703,61706,0,3,3
17628,3,1,61706,61706,61707,0,1,0
17629,5,2,61711,61711,61713,0,2,4
17630,5,3,61716,61716,61719,0,3,3
17631,2,3,61718,61719,61722,1,4,0
17632,4,1,61722,61722,61723,0,1,0
17633,6,3,61728,61728,61731,0,3,5
17634,1,2,61729,61731,61733,2,4,0
17635,6,1,61735,61735,61736,0,1,2
17636,1,1,61736,61736,61737,0,1,0
17637,2,1,61738,61738,61739,0,1,1
17638,6,1,61744,61744,61745,0,1,5
17639,1,3,61745,61745,61748,0,3,0
17640,3,2,61748,61748,61750,0,2,0
17641,2,3,61750,61750,61753,0,3,0
17642,1,2,61751,61753,61755,2,4,0
17643,5,3,61756,61756,61759,0,3,1
17644,2,2,61758,61759,61761,1,3,0
17645,5,2,61763,61763,61765,0,2,2
17646,4,3,61767,61767,61770,0,3,2
17647,1,1,61768,61770,61771,2,3,0
17648,2,1,61770,61771,61772,1,2,0
17649,3,1,61773,61773,61774,0,1,1
17650,2,3,61775,61775,61778,0,3,1
17651,6,1,61781,61781,61782,0,1,3
17652,5,2,61786,61786,61788,0,2,4
17653,3,1,61789,61789,61790,0,1,1
17654,4,2,61793,61793,61795,0,2,3
17655,4,1,61797,61797,61798,0,1,2
17656,3,1,61800,61800,61801,0,1,2
17657,1,3,61801,61801,61804,0,3,0
17658,6,2,61807,61807,61809,0,2,3
17659,5,2,61812,61812,61814,0,2,3
17660,3,2,61815,61815,61817,0,2,1
17661,5,1,61820,61820,61821,0,1,3
17662,1,1,61821,61821,61822,0,1,0
17663,3,2,61824,61824,61826,0,2,2
17664,6,3,61830,61830,61833,0,3,4
17665,2,2,61832,61833,61835,1,3,0
17666,6,2,61838,61838,61840,0,2,3
17667,3,1,61841,61841,61842,0,1,1
17668,6,2,61847,61847,61849,0,2,5
17669,3,3,61850,61850,61853,0,3,1
17670,6,2,61856,61856,61858,0,2,3
17671,4,2,61860,61860,61862,0,2,2
17672,1,3,61861,61862,61865,1,4,0
17673,3,2,61864,61865,61867,1,3,0
17674,2,1,61866,61867,61868,1,2,0
17675,6,3,61872,61872,61875,0,3,4
17676,5,1,61877,61877,61878,0,1,2
17677,5,3,61882,61882,61885,0,3,4
17678,6,3,61888,61888,61891,0,3,3
17679,5,1,61893,61893,61894,0,1,2
17680,6,3,61899,61899,61902,0,3,5
17681,1,2,61900,61902,61904,2,4,0
17682,4,3,61904,61904,61907,0,3,0
17683,2,1,61906,61907,61908,1,2,0
17684,4,3,61910,61910,61913,0,3,2
17685,3,2,61913,61913,61915,0,2,0
17686,5,3,61918,61918,61921,0,3,3
17687,6,3,61924,61924,61927,0,3,3
17688,4,3,61928,61928,61931,0,3,1
17689,3,1,61931,61931,61932,0,1,0
17690,6,3,61937,61937,61940,0,3,5
17691,2,1,61939,61940,61941,1,2,0
17692,6,3,61945,61945,61948,0,3,4
17693,5,2,61950,61950,61952,0,2,2
17694,4,3,61954,61954,61957,0,3,2
17695,5,1,61959,61959,61960,0,1,2
17696,2,1,61961,61961,61962,0,1,1
17697,5,3,61966,61966,61969,0,3,4
17698,4,2,61970,61970,61972,0,2,1
17699,5,3,61975,61975,61978,0,3,3
17700,4,1,61979,61979,61980,0,1,1
17701,5,1,61984,61984,61985,0,1,4
17702,6,2,61990,61990,61992,0,2,5
17703,1,1,61991,61992,61993,1,2,0
17704,4,1,61995,61995,61996,0,1,2
17705,2,1,61997,61997,61998,0,1,1
17706,6,2,62003,62003,62005,0,2,5
17707,6,2,62009,62009,62011,0,2,4
17708,6,2,62015,62015,62017,0,2,4
17709,6,1,62021,62021,62022,0,1,4
17710,2,3,62023,62023,62026,0,3,1
17711,1,3,62024,62026,62029,2,5,0
17712,1,2,62025,62029,62031,4,6,0
17713,4,2,62029,62031,62033,2,4,0
17714,3,1,62032,62033,62034,1,2,0
17715,6,3,62038,62038,62041,0,3,4
17716,4,3,62042,62042,62045,0,3,1
17717,5,1,62047,62047,62048,0,1,2
17718,3,1,62050,62050,62051,0,1,2
17719,2,3,62052,62052,62055,0,3,1
17720,6,3,62058,62058,62061,0,3,3
17721,5,2,62063,62063,62065,0,2,2
17722,5,3,62068,62068,62071,0,3,3
17723,5,1,62073,62073,62074,0,1,2
17724,3,1,62076,62076,62077,0,1,2
17725,5,3,62081,62081,62084,0,3,4
17726,5,1,62086,62086,62087,0,1,2
17727,3,3,62089,62089,62092,0,3,2
17728,1,1,62090,62092,62093,2,3,0
17729,1,1,62091,62093,62094,2,3,0
17730,6,3,62097,62097,62100,0,3,3
17731,3,2,62100,62100,62102,0,2,0
17732,3,1,62103,62103,62104,0,1,1
17733,3,1,62106,62106,62107,0,1,2
17734,2,2,62108,62108,62110,0,2,1
17735,6,2,62114,62114,62116,0,2,4
17736,2,3,62116,62116,62119,0,3,0
17737,4,2,62120,62120,62122,0,2,1
17738,4,3,62124,62124,62127,0,3,2
17739,1,2,62125,62127,62129,2,4,0
17740,6,3,62131,62131,62134,0,3,2
17741,5,3,62136,62136,62139,0,3,2
17742,1,2,62137,62139,62141,2,4,0
17743,3,2,62140,62141,62143,1,3,0
17744,5,2,62145,62145,62147,0,2,2
17745,3,1,62148,62148,62149,0,1,1
17746,6,3,62154,62154,62157,0,3,5
17747,6,3,62160,62160,62163,0,3,3
17748,3,2,62163,62163,62165,0,2,0
17749,3,3,62166,62166,62169,0,3,1
17750,6,1,62172,62172,62173,0,1,3
17751,3,3,62175,62175,62178,0,3,2
17752,2,3,62177,62178,62181,1,4,0
17753,2,3,62179,62181,62184,2,5,0
17754,1,2,62180,62184,62186,4,6,0
17755,1,3,62181,62186,62189,5,8,0
17756,5,3,62186,62189,62192,3,6,0
17757,5,3,62191,62192,62195,1,4,0
17758,1,2,62192,62195,62197,3,5,0
17759,4,2,62196,62197,62199,1,3,0
17760,5,2,62201,62201,62203,0,2,2
17761,6,2,62207,62207,62209,0,2,4
17762,3,1,62210,62210,62211,0,1,1
17763,5,3,62215,62215,62218,0,3,4
17764,4,2,62219,62219,62221,0,2,1
17765,4,2,62223,62223,62225,0,2,2
17766,6,3,62229,62229,62232,0,3,4
17767,5,3,62234,62234,62237,0,3,2
17768,2,3,62236,62237,62240,1,4,0
17769,3,1,62239,62240,62241,1,2,0
17770,3,2,62242,62242,62244,0,2,1
17771,2,2,62244,62244,62246,0,2,0
17772,3,2,62247,62247,62249,0,2,1
17773,3,1,62250,62250,62251,0,1,1
17774,4,1,62254,62254,62255,0,1,3
17775,5,3,62259,62259,62262,0,3,4
17776,2,3,62261,62262,62265,1,4,0
17777,1,1,62262,62265,62266,3,4,0
17778,4,1,62266,62266,62267,0,1,0
17779,6,3,62272,62272,62275,0,3,5
17780,4,3,62276,62276,62279,0,3,1
17781,6,2,62282,62282,62284,0,2,3
17782,4,3,62286,62286,62289,0,3,2
17783,4,2,62290,62290,62292,0,2,1
17784,4,3,62294,62294,62297,0,3,2
17785,3,3,62297,62297,62300,0,3,0
17786,2,1,62299,62300,62301,1,2,0
17787,3,2,62302,62302,62304,0,2,1
17788,2,3,62304,62304,62307,0,3,0
17789,1,3,62305,62307,62310,2,5,0
17790,2,2,62307,62310,62312,3,5,0
17791,1,2,62308,62312,62314,4,6,0
17792,5,2,62313,62314,62316,1,3,0
17793,4,2,62317,62317,62319,0,2,1
17794,5,3,62322,62322,62325,0,3,3
17795,2,2,62324,62325,62327,1,3,0
17796,4,1,62328,62328,62329,0,1,1
17797,4,3,62332,62332,62335,0,3,3
17798,3,3,62335,62335,62338,0,3,0
17799,3,1,62338,62338,62339,0,1,0
17800,5,1,62343,62343,62344,0,1,4
17801,6,1,62349,62349,62350,0,1,5
17802,2,1,62351,62351,62352,0,1,1
17803,4,1,62355,62355,62356,0,1,3
17804,5,1,62360,62360,62361,0,1,4
17805,6,1,62366,62366,62367,0,1,5
17806,3,1,62369,62369,62370,0,1,2
17807,4,1,62373,62373,62374,0,1,3
17808,5,1,62378,62378,62379,0,1,4
17809,1,3,62379,62379,62382,0,3,0
17810,1,1,62380,62382,62383,2,3,0
17811,1,2,62381,62383,62385,2,4,0
17812,5,3,62386,62386,62389,0,3,1
17813,1,1,62387,62389,62390,2,3,0
17814,1,3,62388,62390,62393,2,5,0
17815,6,1,62394,62394,62395,0,1,1
17816,2,1,62396,62396,62397,0,1,1
17817,2,3,62398,62398,62401,0,3,1
17818,5,3,62403,62403,62406,0,3,2
17819,4,3,62407,62407,62410,0,3,1
17820,3,3,62410,62410,62413,0,3,0
17821,1,1,62411,62413,62414,2,3,0
17822,5,1,62416,62416,62417,0,1,2
17823,1,1,62417,62417,62418,0,1,0
17824,5,1,62422,62422,62423,0,1,4
17825,4,2,62426,62426,62428,0,2,3
17826,4,1,62430,62430,62431,0,1,2
17827,6,2,62436,62436,62438,0,2,5
17828,2,1,62438,62438,62439,0,1,0
17829,2,3,62440,62440,62443,0,3,1
17830,6,2,62446,62446,62448,0,2,3
17831,1,2,62447,62448,62450,1,3,0
17832,1,1,62448,62450,62451,2,3,0
17833,5,3,62453,62453,62456,0,3,2
17834,1,2,62454,62456,62458,2,4,0
17835,3,1,62457,62458,62459,1,2,0
17836,5,2,62462,62462,62464,0,2,3
17837,1,2,62463,62464,62466,1,3,0
17838,6,1,62469,62469,62470,0,1,3
17839,5,3,62474,62474,62477,0,3,4
17840,6,2,62480,62480,62482,0,2,3
17841,5,1,62485,62485,62486,0,1,3
17842,6,2,62491,62491,62493,0,2,5
17843,1,3,62492,62493,62496,1,4,0
17844,5,2,62497,62497,62499,0,2,1
17845,1,2,62498,62499,62501,1,3,0
17846,5,3,62503,62503,62506,0,3,2
17847,1,1,62504,62506,62507,2,3,0
17848,1,2,62505,62507,62509,2,4,0
17849,2,1,62507,62509,62510,2,3,0
17850,1,3,62508,62510,62513,2,5,0
17851,2,2,62510,62513,62515,3,5,0
17852,3,2,62513,62515,62517,2,4,0
17853,4,1,62517,62517,62518,0,1,0
17854,6,1,62523,62523,62524,0,1,5
17855,1,2,62524,62524,62526,0,2,0
17856,1,1,62525,62526,62527,1,2,0
17857,1,2,62526,62527,62529,1,3,0
17858,5,2,62531,62531,62533,0,2,2
17859,5,3,62536,62536,62539,0,3,3
17860,6,2,62542,62542,62544,0,2,3
17861,2,2,62544,62544,62546,0,2,0
17862,3,3,62547,62547,62550,0,3,1
17863,1,2,62548,62550,62552,2,4,0
17864,6,1,62554,62554,62555,0,1,2
17865,4,2,62558,62558,62560,0,2,3
17866,2,1,62560,62560,62561,0,1,0
17867,3,1,62563,62563,62564,0,1,2
17868,2,1,62565,62565,62566,0,1,1
17869,2,3,62567,62567,62570,0,3,1
17870,4,3,62571,62571,62574,0,3,1
17871,6,3,62577,62577,62580,0,3,3
17872,5,3,62582,62582,62585,0,3,2
17873,6,3,62588,62588,62591,0,3,3
17874,6,1,62594,62594,62595,0,1,3
17875,4,2,62598,62598,62600,0,2,3
17876,5,1,62603,62603,62604,0,1,3
17877,3,1,62606,62606,62607,0,1,2
17878,5,1,62611,62611,62612,0,1,4
17879,2,3,62613,62613,62616,0,3,1
17880,5,3,62618,62618,62621,0,3,2
17881,2,3,62620,62621,62624,1,4,0
17882,5,3,62625,62625,62628,0,3,1
17883,3,3,62628,62628,62631,0,3,0
17884,3,3,62631,62631,62634,0,3,0
17885,5,2,62636,62636,62638,0,2,2
17886,3,2,62639,62639,62641,0,2,1
17887,5,2,62644,62644,62646,0,2,3
17888,3,3,62647,62647,62650,0,3,1
17889,6,1,62653,62653,62654,0,1,3
17890,6,3,62659,62659,62662,0,3,5
17891,6,2,62665,62665,62667,0,2,3
17892,1,3,62666,62667,62670,1,4,0
17893,2,1,62668,62670,62671,2,3,0
17894,4,3,62672,62672,62675,0,3,1
17895,1,1,62673,62675,62676,2,3,0
17896,1,3,62674,62676,62679,2,5,0
17897,5,1,62679,62679,62680,0,1,0
17898,4,3,62683,62683,62686,0,3,3
17899,1,3,62684,62686,62689,2,5,0
17900,5,2,62689,62689,62691,0,2,0
17901,4,3,62693,62693,62696,0,3,2
17902,1,2,62694,62696,62698,2,4,0
17903,1,1,62695,62698,62699,3,4,0
17904,3,2,62698,62699,62701,1,3,0
17905,4,3,62702,62702,62705,0,3,1
17906,2,3,62704,62705,62708,1,4,0
17907,3,3,62707,62708,62711,1,4,0
17908,3,1,62710,62711,62712,1,2,0
17909,4,2,62714,62714,62716,0,2,2
17910,4,1,62718,62718,62719,0,1,2
17911,3,2,62721,62721,62723,0,2,2
17912,5,1,62726,62726,62727,0,1,3
17913,2,1,62728,62728,62729,0,1,1
17914,3,2,62731,62731,62733,0,2,2
17915,4,1,62735,62735,62736,0,1,2
17916,6,3,62741,62741,62744,0,3,5
17917,4,1,62745,62745,62746,0,1,1
17918,5,3,62750,62750,62753,0,3,4
17919,3,3,62753,62753,62756,0,3,0
17920,3,3,62756,62756,62759,0,3,0
17921,6,1,62762,62762,62763,0,1,3
17922,3,2,62765,62765,62767,0,2,2
17923,6,1,62771,62771,62772,0,1,4
17924,5,2,62776,62776,62778,0,2,4
17925,6,2,62782,62782,62784,0,2,4
17926,6,1,62788,62788,62789,0,1,4
17927,1,2,62789,62789,62791,0,2,0
17928,6,1,62795,62795,62796,0,1,4
17929,3,2,62798,62798,62800,0,2,2
17930,3,1,62801,62801,62802,0,1,1
17931,4,2,62805,62805,62807,0,2,3
17932,6,3,62811,62811,62814,0,3,4
17933,5,2,62816,62816,62818,0,2,2
17934,3,1,62819,62819,62820,0,1,1
17935,4,2,62823,62823,62825,0,2,3
17936,4,1,62827,62827,62828,0,1,2
17937,6,1,62833,62833,62834,0,1,5
17938,3,2,62836,62836,62838,0,2,2
17939,6,2,62842,62842,62844,0,2,4
17940,3,3,62845,62845,62848,0,3,1
17941,3,2,62848,62848,62850,0,2,0
17942,4,2,62852,62852,62854,0,2,2
17943,2,1,62854,62854,62855,0,1,0
17944,4,3,62858,62858,62861,0,3,3
17945,4,1,62862,62862,62863,0,1,1
17946,4,3,62866,62866,62869,0,3,3
17947,5,3,62871,62871,62874,0,3,2
17948,2,3,62873,62874,62877,1,4,0
17949,3,2,62876,62877,62879,1,3,0
17950,4,3,62880,62880,62883,0,3,1
17951,3,3,62883,62883,62886,0,3,0
17952,3,1,62886,62886,62887,0,1,0
17953,4,3,62890,62890,62893,0,3,3
17954,3,2,62893,62893,62895,0,2,0
17955,4,1,62897,62897,62898,0,1,2
17956,3,1,62900,62900,62901,0,1,2
17957,6,3,62906,62906,62909,0,3,5
17958,6,3,62912,62912,62915,0,3,3
17959,1,2,62913,62915,62917,2,4,0
17960,1,3,62914,62917,62920,3,6,0
17961,1,1,62915,62920,62921,5,6,0
17962,2,3,62917,62921,62924,4,7,0
17963,6,2,62923,62924,62926,1,3,0
17964,6,1,62929,62929,62930,0,1,3
17965,3,1,62932,62932,62933,0,1,2
17966,6,2,62938,62938,62940,0,2,5
17967,4,3,62942,62942,62945,0,3,2
17968,5,1,62947,62947,62948,0,1,2
17969,5,3,62952,62952,62955,0,3,4
17970,5,3,62957,62957,62960,0,3,2
17971,1,2,62958,62960,62962,2,4,0
17972,4,1,62962,62962,62963,0,1,0
17973,3,1,62965,62965,62966,0,1,2
17974,1,2,62966,62966,62968,0,2,0
17975,2,1,62968,62968,62969,0,1,0
17976,6,1,62974,62974,62975,0,1,5
17977,1,1,62975,62975,62976,0,1,0
17978,3,2,62978,62978,62980,0,2,2
17979,4,1,62982,62982,62983,0,1,2
17980,1,2,62983,62983,62985,0,2,0
17981,6,2,62989,62989,62991,0,2,4
17982,3,3,62992,62992,62995,0,3,1
17983,3,1,62995,62995,62996,0,1,0
17984,2,1,62997,62997,62998,0,1,1
17985,6,1,63003,63003,63004,0,1,5
17986,6,1,63009,63009,63010,0,1,5
17987,6,1,63015,63015,63016,0,1,5
17988,3,3,63018,63018,63021,0,3,2
17989,4,3,63022,63022,63025,0,3,1
17990,5,1,63027,63027,63028,0,1,2
17991,4,1,63031,63031,63032,0,1,3
17992,2,1,63033,63033,63034,0,1,1
17993,3,1,63036,63036,63037,0,1,2
17994,2,1,63038,63038,63039,0,1,1
17995,6,1,63044,63044,63045,0,1,5
17996,1,1,63045,63045,63046,0,1,0
17997,3,2,63048,63048,63050,0,2,2
17998,6,1,63054,63054,63055,0,1,4
17999,1,3,63055,63055,63058,0,3,0
18000,4,3,63059,63059,63062,0,3,1
18001,6,2,63065,63065,63067,0,2,3
18002,1,3,63066,63067,63070,1,4,0
18003,1,3,63067,63070,63073,3,6,0
18004,3,1,63070,63073,63074,3,4,0
18005,3,3,63073,63074,63077,1,4,0
18006,6,2,63079,63079,63081,0,2,2
18007,5,2,63084,63084,63086,0,2,3
18008,3,2,63087,63087,63089,0,2,1
18009,1,3,63088,63089,63092,1,4,0
18010,5,3,63093,63093,63096,0,3,1
18011,5,2,63098,63098,63100,0,2,2
18012,6,3,63104,63104,63107,0,3,4
18013,2,1,63106,63107,63108,1,2,0
18014,5,1,63111,63111,63112,0,1,3
18015,3,1,63114,63114,63115,0,1,2
18016,2,1,63116,63116,63117,0,1,1
18017,3,3,63119,63119,63122,0,3,2
18018,6,2,63125,63125,63127,0,2,3
18019,1,1,63126,63127,63128,1,2,0
18020,4,2,63130,63130,63132,0,2,2
18021,4,3,63134,63134,63137,0,3,2
18022,3,2,63137,63137,63139,0,2,0
18023,1,3,63138,63139,63142,1,4,0
18024,1,3,63139,63142,63145,3,6,0
18025,2,3,63141,63145,63148,4,7,0
18026,1,2,63142,63148,63150,6,8,0
18027,4,3,63146,63150,63153,4,7,0
18028,5,3,63151,63153,63156,2,5,0
18029,5,1,63156,63156,63157,0,1,0
18030,1,1,63157,63157,63158,0,1,0
18031,4,2,63161,63161,63163,0,2,3
18032,6,2,63167,63167,63169,0,2,4
18033,2,3,63169,63169,63172,0,3,0
18034,3,1,63172,63172,63173,0,1,0
18035,1,3,63173,63173,63176,0,3,0
18036,1,2,63174,63176,63178,2,4,0
18037,5,1,63179,63179,63180,0,1,1
18038,3,2,63182,63182,63184,0,2,2
18039,6,1,63188,63188,63189,0,1,4
18040,3,2,63191,63191,63193,0,2,2
18041,2,3,63193,63193,63196,0,3,0
18042,6,2,63199,63199,63201,0,2,3
18043,4,1,63203,63203,63204,0,1,2
18044,1,2,63204,63204,63206,0,2,0
18045,4,2,63208,63208,63210,0,2,2
18046,5,1,63213,63213,63214,0,1,3
18047,3,1,63216,63216,63217,0,1,2
18048,5,3,63221,63221,63224,0,3,4
18049,3,2,63224,63224,63226,0,2,0
18050,5,3,63229,63229,63232,0,3,3
18051,6,3,63235,63235,63238,0,3,3
18052,4,3,63239,63239,63242,0,3,1
18053,2,2,63241,63242,63244,1,3,0
18054,5,1,63246,63246,63247,0,1,2
18055,3,3,63249,63249,63252,0,3,2
18056,3,1,63252,63252,63253,0,1,0
18057,3,1,63255,63255,63256,0,1,2
18058,2,3,63257,63257,63260,0,3,1
18059,1,1,63258,63260,63261,2,3,0
18060,1,2,63259,63261,63263,2,4,0
18061,1,2,63260,63263,63265,3,5,0
18062,1,1,63261,63265,63266,4,5,0
18063,6,3,63267,63267,63270,0,3,1
18064,1,2,63268,63270,63272,2,4,0
18065,1,2,63269,63272,63274,3,5,0
18066,2,1,63271,63274,63275,3,4,0
18067,1,2,63272,63275,63277,3,5,0
18068,5,2,63277,63277,63279,0,2,0
18069,1,1,63278,63279,63280,1,2,0
18070,1,3,63279,63280,63283,1,4,0
18071,3,3,63282,63283,63286,1,4,0
18072,6,1,63288,63288,63289,0,1,2
18073,5,3,63293,63293,63296,0,3,4
18074,6,3,63299,63299,63302,0,3,3
18075,6,2,63305,63305,63307,0,2,3
18076,6,3,63311,63311,63314,0,3,4
18077,5,2,63316,63316,63318,0,2,2
18078,2,3,63318,63318,63321,0,3,0
18079,4,3,63322,63322,63325,0,3,1
18080,6,2,63328,63328,63330,0,2,3
18081,1,1,63329,63330,63331,1,2,0
18082,5,1,63334,63334,63335,0,1,3
18083,4,1,63338,63338,63339,0,1,3
18084,3,3,63341,63341,63344,0,3,2
18085,3,2,63344,63344,63346,0,2,0
18086,6,3,63350,63350,63353,0,3,4
18087,3,3,63353,63353,63356,0,3,0
18088,5,3,63358,63358,63361,0,3,2
18089,5,2,63363,63363,63365,0,2,2
18090,1,1,63364,63365,63366,1,2,0
18091,3,2,63367,63367,63369,0,2,1
18092,6,2,63373,63373,63375,0,2,4
18093,2,3,63375,63375,63378,0,3,0
18094,5,3,63380,63380,63383,0,3,2
18095,1,2,63381,63383,63385,2,4,0
18096,6,1,63387,63387,63388,0,1,2
18097,4,2,63391,63391,63393,0,2,3
18098,5,1,63396,63396,63397,0,1,3
18099,1,1,63397,63397,63398,0,1,0
18100,3,3,63400,63400,63403,0,3,2
18101,2,2,63402,63403,63405,1,3,0
18102,6,1,63408,63408,63409,0,1,3
18103,2,1,63410,63410,63411,0,1,1
18104,5,3,63415,63415,63418,0,3,4
18105,2,1,63417,63418,63419,1,2,0
18106,1,1,63418,63419,63420,1,2,0
18107,1,2,63419,63420,63422,1,3,0
18108,5,2,63424,63424,63426,0,2,2
18109,3,1,63427,63427,63428,0,1,1
18110,5,3,63432,63432,63435,0,3,4
18111,5,1,63437,63437,63438,0,1,2
18112,3,2,63440,63440,63442,0,2,2
18113,4,3,63444,63444,63447,0,3,2
18114,4,1,63448,63448,63449,0,1,1
18115,3,1,63451,63451,63452,0,1,2
18116,4,3,63455,63455,63458,0,3,3
18117,1,3,63456,63458,63461,2,5,0
18118,4,2,63460,63461,63463,1,3,0
18119,4,3,63464,63464,63467,0,3,1
18120,4,3,63468,63468,63471,0,3,1
18121,6,3,63474,63474,63477,0,3,3
18122,3,1,63477,63477,63478,0,1,0
18123,4,1,63481,63481,63482,0,1,3
18124,4,1,63485,63485,63486,0,1,3
18125,2,1,63487,63487,63488,0,1,1
18126,5,3,63492,63492,63495,0,3,4
18127,5,2,63497,63497,63499,0,2,2
18128,6,3,63503,63503,63506,0,3,4
18129,2,1,63505,63506,63507,1,2,0
18130,5,3,63510,63510,63513,0,3,3
18131,1,1,63511,63513,63514,2,3,0
18132,1,2,63512,63514,63516,2,4,0
18133,2,3,63514,63516,63519,2,5,0
18134,2,1,63516,63519,63520,3,4,0
18135,6,3,63522,63522,63525,0,3,2
18136,5,3,63527,63527,63530,0,3,2
18137,3,3,63530,63530,63533,0,3,0
18138,1,2,63531,63533,63535,2,4,0
18139,3,1,63534,63535,63536,1,2,0
18140,6,1,63540,63540,63541,0,1,4
18141,2,1,63542,63542,63543,0,1,1
18142,5,3,63547,63547,63550,0,3,4
18143,5,2,63552,63552,63554,0,2,2
18144,1,2,63553,63554,63556,1,3,0
18145,5,1,63558,63558,63559,0,1,2
18146,3,2,63561,63561,63563,0,2,2
18147,4,3,63565,63565,63568,0,3,2
18148,4,3,63569,63569,63572,0,3,1
18149,1,2,63570,63572,63574,2,4,0
18150,4,1,63574,63574,63575,0,1,0
18151,3,1,63577,63577,63578,0,1,2
18152,6,1,63583,63583,63584,0,1,5
18153,3,2,63586,63586,63588,0,2,2
18154,3,3,63589,63589,63592,0,3,1
18155,4,3,63593,63593,63596,0,3,1
18156,1,3,63594,63596,63599,2,5,0
18157,5,3,63599,63599,63602,0,3,0
18158,3,2,63602,63602,63604,0,2,0
18159,3,2,63605,63605,63607,0,2,1
18160,1,3,63606,63607,63610,1,4,0
18161,4,3,63610,63610,63613,0,3,0
18162,1,1,63611,63613,63614,2,3,0
18163,2,3,63613,63614,63617,1,4,0
18164,5,1,63618,63618,63619,0,1,1
18165,3,2,63621,63621,63623,0,2,2
18166,2,2,63623,63623,63625,0,2,0
18167,1,2,63624,63625,63627,1,3,0
18168,6,2,63630,63630,63632,0,2,3
18169,4,3,63634,63634,63637,0,3,2
18170,4,2,63638,63638,63640,0,2,1
18171,4,3,63642,63642,63645,0,3,2
18172,2,2,63644,63645,63647,1,3,0
18173,4,2,63648,63648,63650,0,2,1
18174,5,3,63653,63653,63656,0,3,3
18175,3,2,63656,63656,63658,0,2,0
18176,4,2,63660,63660,63662,0,2,2
18177,3,2,63663,63663,63665,0,2,1
18178,3,2,63666,63666,63668,0,2,1
18179,2,1,63668,63668,63669,0,1,0
18180,1,2,63669,63669,63671,0,2,0
18181,1,2,63670,63671,63673,1,3,0
18182,4,3,63674,63674,63677,0,3,1
18183,6,1,63680,63680,63681,0,1,3
18184,1,1,63681,63681,63682,0,1,0
18185,6,1,63687,63687,63688,0,1,5
18186,2,2,63689,63689,63691,0,2,1
18187,6,2,63695,63695,63697,0,2,4
18188,2,3,63697,63697,63700,0,3,0
18189,4,1,63701,63701,63702,0,1,1
18190,3,3,63704,63704,63707,0,3,2
18191,6,1,63710,63710,63711,0,1,3
18192,5,1,63715,63715,63716,0,1,4
18193,2,3,63717,63717,63720,0,3,1
18194,4,1,63721,63721,63722,0,1,1
18195,4,1,63725,63725,63726,0,1,3
18196,2,1,63727,63727,63728,0,1,1
18197,1,2,63728,63728,63730,0,2,0
18198,5,3,63733,63733,63736,0,3,3
18199,3,3,63736,63736,63739,0,3,0
18200,4,3,63740,63740,63743,0,3,1
18201,3,1,63743,63743,63744,0,1,0
18202,1,2,63744,63744,63746,0,2,0
18203,2,1,63746,63746,63747,0,1,0
18204,1,3,63747,63747,63750,0,3,0
18205,6,1,63753,63753,63754,0,1,3
18206,6,1,63759,63759,63760,0,1,5
18207,1,2,63760,63760,63762,0,2,0
18208,6,2,63766,63766,63768,0,2,4
18209,1,1,63767,63768,63769,1,2,0
18210,2,2,63769,63769,63771,0,2,0
18211,5,2,63774,63774,63776,0,2,3
18212,1,3,63775,63776,63779,1,4,0
18213,4,1,63779,63779,63780,0,1,0
18214,2,2,63781,63781,63783,0,2,1
18215,5,1,63786,63786,63787,0,1,3
18216,3,2,63789,63789,63791,0,2,2
18217,6,3,63795,63795,63798,0,3,4
18218,4,3,63799,63799,63802,0,3,1
18219,6,3,63805,63805,63808,0,3,3
18220,4,2,63809,63809,63811,0,2,1
18221,3,1,63812,63812,63813,0,1,1
18222,4,2,63816,63816,63818,0,2,3
18223,1,2,63817,63818,63820,1,3,0
18224,5,2,63822,63822,63824,0,2,2
18225,2,1,63824,63824,63825,0,1,0
18226,1,3,63825,63825,63828,0,3,0
18227,3,2,63828,63828,63830,0,2,0
18228,5,3,63833,63833,63836,0,3,3
18229,2,2,63835,63836,63838,1,3,0
18230,4,1,63839,63839,63840,0,1,1
18231,6,1,63845,63845,63846,0,1,5
18232,1,2,63846,63846,63848,0,2,0
18233,6,1,63852,63852,63853,0,1,4
18234,6,1,63858,63858,63859,0,1,5
18235,4,3,63862,63862,63865,0,3,3
18236,6,1,63868,63868,63869,0,1,3
18237,3,3,63871,63871,63874,0,3,2
18238,3,3,63874,63874,63877,0,3,0
18239,6,1,63880,63880,63881,0,1,3
18240,4,3,63884,63884,63887,0,3,3
18241,4,1,63888,63888,63889,0,1,1
18242,1,3,63889,63889,63892,0,3,0
18243,2,2,63891,63892,63894,1,3,0
18244,2,1,63893,63894,63895,1,2,0
18245,1,1,63894,63895,63896,1,2,0
18246,2,3,63896,63896,63899,0,3,0
18247,3,2,63899,63899,63901,0,2,0
18248,5,3,63904,63904,63907,0,3,3
18249,3,2,63907,63907,63909,0,2,0
18250,5,3,63912,63912,63915,0,3,3
18251,3,2,63915,63915,63917,0,2,0
18252,4,1,63919,63919,63920,0,1,2
18253,1,2,63920,63920,63922,0,2,0
18254,1,2,63921,63922,63924,1,3,0
18255,4,1,63925,63925,63926,0,1,1
18256,3,1,63928,63928,63929,0,1,2
18257,2,2,63930,63930,63932,0,2,1
18258,5,1,63935,63935,63936,0,1,3
18259,5,2,63940,63940,63942,0,2,4
18260,5,2,63945,63945,63947,0,2,3
18261,2,3,63947,63947,63950,0,3,0
18262,2,1,63949,63950,63951,1,2,0
18263,6,1,63955,63955,63956,0,1,4
18264,2,2,63957,63957,63959,0,2,1
18265,2,2,63959,63959,63961,0,2,0
18266,3,3,63962,63962,63965,0,3,1
18267,4,3,63966,63966,63969,0,3,1
18268,3,3,63969,63969,63972,0,3,0
18269,4,3,63973,63973,63976,0,3,1
18270,1,2,63974,63976,63978,2,4,0
18271,5,3,63979,63979,63982,0,3,1
18272,5,3,63984,63984,63987,0,3,2
18273,5,1,63989,63989,63990,0,1,2
18274,5,2,63994,63994,63996,0,2,4
18275,6,2,64000,64000,64002,0,2,4
18276,2,3,64002,64002,64005,0,3,0
18277,3,2,64005,64005,64007,0,2,0
18278,2,1,64007,64007,64008,0,1,0
18279,6,3,64013,64013,64016,0,3,5
18280,4,2,64017,64017,64019,0,2,1
18281,4,1,64021,64021,64022,0,1,2
18282,2,2,64023,64023,64025,0,2,1
18283,5,1,64028,64028,64029,0,1,3
18284,6,1,64034,64034,64035,0,1,5
18285,1,1,64035,64035,64036,0,1,0
18286,5,3,64040,64040,64043,0,3,4
18287,4,1,64044,64044,64045,0,1,1
18288,4,3,64048,64048,64051,0,3,3
18289,5,3,64053,64053,64056,0,3,2
18290,2,1,64055,64056,64057,1,2,0
18291,6,1,64061,64061,64062,0,1,4
18292,6,1,64067,64067,64068,0,1,5
18293,6,2,64073,64073,64075,0,2,5
18294,5,2,64078,64078,64080,0,2,3
18295,2,2,64080,64080,64082,0,2,0
18296,6,2,64086,64086,64088,0,2,4
18297,1,1,64087,64088,64089,1,2,0
18298,1,1,64088,64089,64090,1,2,0
18299,2,1,64090,64090,64091,0,1,0
18300,3,2,64093,64093,64095,0,2,2
18301,4,1,64097,64097,64098,0,1,2
18302,5,3,64102,64102,64105,0,3,4
18303,5,3,64107,64107,64110,0,3,2
18304,4,3,64111,64111,64114,0,3,1
18305,1,1,64112,64114,64115,2,3,0
18306,3,1,64115,64115,64116,0,1,0
18307,5,1,64120,64120,64121,0,1,4
18308,6,1,64126,64126,64127,0,1,5
18309,3,1,64129,64129,64130,0,1,2
18310,2,2,64131,64131,64133,0,2,1
18311,2,1,64133,64133,64134,0,1,0
18312,6,3,64139,64139,64142,0,3,5
18313,6,2,64145,64145,64147,0,2,3
18314,6,3,64151,64151,64154,0,3,4
18315,2,2,64153,64154,64156,1,3,0
18316,3,3,64156,64156,64159,0,3,0
18317,2,1,64158,64159,64160,1,2,0
18318,2,2,64160,64160,64162,0,2,0
18319,5,3,64165,64165,64168,0,3,3
18320,6,1,64171,64171,64172,0,1,3
18321,5,1,64176,64176,64177,0,1,4
18322,1,1,64177,64177,64178,0,1,0
18323,2,3,64179,64179,64182,0,3,1
18324,4,3,64183,64183,64186,0,3,1
18325,2,3,64185,64186,64189,1,4,0
18326,1,2,64186,64189,64191,3,5,0
18327,4,1,64190,64191,64192,1,2,0
18328,1,1,64191,64192,64193,1,2,0
18329,2,2,64193,64193,64195,0,2,0
18330,4,3,64197,64197,64200,0,3,2
18331,6,2,64203,64203,64205,0,2,3
18332,1,2,64204,64205,64207,1,3,0
18333,1,1,64205,64207,64208,2,3,0
18334,1,3,64206,64208,64211,2,5,0
18335,5,2,64211,64211,64213,0,2,0
18336,4,1,64215,64215,64216,0,1,2
18337,2,2,64217,64217,64219,0,2,1
18338,5,2,64222,64222,64224,0,2,3
18339,4,1,64226,64226,64227,0,1,2
18340,2,3,64228,64228,64231,0,3,1
18341,6,1,64234,64234,64235,0,1,3
18342,1,2,64235,64235,64237,0,2,0
18343,2,3,64237,64237,64240,0,3,0
18344,5,1,64242,64242,64243,0,1,2
18345,6,1,64248,64248,64249,0,1,5
18346,6,3,64254,64254,64257,0,3,5
18347,5,1,64259,64259,64260,0,1,2
18348,5,1,64264,64264,64265,0,1,4
18349,3,3,64267,64267,64270,0,3,2
18350,6,3,64273,64273,64276,0,3,3
18351,5,3,64278,64278,64281,0,3,2
18352,5,2,64283,64283,64285,0,2,2
18353,6,3,64289,64289,64292,0,3,4
18354,5,3,64294,64294,64297,0,3,2
18355,2,2,64296,64297,64299,1,3,0
18356,3,1,64299,64299,64300,0,1,0
18357,6,3,64305,64305,64308,0,3,5
18358,1,1,64306,64308,64309,2,3,0
18359,6,1,64312,64312,64313,0,1,3
18360,6,3,64318,64318,64321,0,3,5
18361,6,2,64324,64324,64326,0,2,3
18362,2,2,64326,64326,64328,0,2,0
18363,5,1,64331,64331,64332,0,1,3
18364,6,2,64337,64337,64339,0,2,5
18365,2,3,64339,64339,64342,0,3,0
18366,1,2,64340,64342,64344,2,4,0
18367,3,3,64343,64344,64347,1,4,0
18368,1,3,64344,64347,64350,3,6,0
18369,1,2,64345,64350,64352,5,7,0
18370,4,1,64349,64352,64353,3,4,0
18371,1,3,64350,64353,64356,3,6,0
18372,3,1,64353,64356,64357,3,4,0
18373,6,1,64359,64359,64360,0,1,2
18374,1,2,64360,64360,64362,0,2,0
18375,6,3,64366,64366,64369,0,3,4
18376,5,1,64371,64371,64372,0,1,2
18377,4,3,64375,64375,64378,0,3,3
18378,4,2,64379,64379,64381,0,2,1
18379,6,1,64385,64385,64386,0,1,4
18380,3,1,64388,64388,64389,0,1,2
18381,5,3,64393,64393,64396,0,3,4
18382,3,1,64396,64396,64397,0,1,0
18383,4,1,64400,64400,64401,0,1,3
18384,1,3,64401,64401,64404,0,3,0
18385,2,3,64403,64404,64407,1,4,0
18386,2,2,64405,64407,64409,2,4,0
18387,3,3,64408,64409,64412,1,4,0
18388,5,1,64413,64413,64414,0,1,1
18389,2,2,64415,64415,64417,0,2,1
18390,1,1,64416,64417,64418,1,2,0
18391,4,2,64420,64420,64422,0,2,2
18392,3,3,64423,64423,64426,0,3,1
18393,5,1,64428,64428,64429,0,1,2
18394,4,2,64432,64432,64434,0,2,3
18395,5,1,64437,64437,64438,0,1,3
18396,4,2,64441,64441,64443,0,2,3
18397,5,1,64446,64446,64447,0,1,3
18398,4,3,64450,64450,64453,0,3,3
18399,4,2,64454,64454,64456,0,2,1
18400,5,1,64459,64459,64460,0,1,3
18401,3,2,64462,64462,64464,0,2,2
18402,5,3,64467,64467,64470,0,3,3
18403,1,3,64468,64470,64473,2,5,0
18404,3,2,64471,64473,64475,2,4,0
18405,3,2,64474,64475,64477,1,3,0
18406,3,1,64477,64477,64478,0,1,0
18407,5,3,64482,64482,64485,0,3,4
18408,4,2,64486,64486,64488,0,2,1
18409,1,3,64487,64488,64491,1,4,0
18410,1,1,64488,64491,64492,3,4,0
18411,3,2,64491,64492,64494,1,3,0
18412,6,2,64497,64497,64499,0,2,3
18413,3,2,64500,64500,64502,0,2,1
18414,3,2,64503,64503,64505,0,2,1
18415,1,1,64504,64505,64506,1,2,0
18416,2,3,64506,64506,64509,0,3,0
18417,4,1,64510,64510,64511,0,1,1
18418,3,3,64513,64513,64516,0,3,2
18419,2,2,64515,64516,64518,1,3,0
18420,6,2,64521,64521,64523,0,2,3
18421,3,2,64524,64524,64526,0,2,1
18422,4,3,64528,64528,64531,0,3,2
18423,6,1,64534,64534,64535,0,1,3
18424,5,3,64539,64539,64542,0,3,4
18425,1,3,64540,64542,64545,2,5,0
18426,3,3,64543,64545,64548,2,5,0
18427,3,3,64546,64548,64551,2,5,0
18428,2,3,64548,64551,64554,3,6,0
18429,1,3,64549,64554,64557,5,8,0
18430,1,2,64550,64557,64559,7,9,0
18431,2,2,64552,64559,64561,7,9,0
18432,2,1,64554,64561,64562,7,8,0
18433,6,3,64560,64562,64565,2,5,0
18434,2,2,64562,64565,64567,3,5,0
18435,1,1,64563,64567,64568,4,5,0
18436,1,2,64564,64568,64570,4,6,0
18437,4,3,64568,64570,64573,2,5,0
18438,3,3,64571,64573,64576,2,5,0
18439,3,2,64574,64576,64578,2,4,0
18440,6,3,64580,64580,64583,0,3,2
18441,2,2,64582,64583,64585,1,3,0
18442,6,3,64588,64588,64591,0,3,3
18443,3,1,64591,64591,64592,0,1,0
18444,6,3,64597,64597,64600,0,3,5
18445,2,2,64599,64600,64602,1,3,0
18446,3,2,64602,64602,64604,0,2,0
18447,5,1,64607,64607,64608,0,1,3
18448,1,3,64608,64608,64611,0,3,0
18449,1,3,64609,64611,64614,2,5,0
18450,1,1,64610,64614,64615,4,5,0
18451,3,1,64613,64615,64616,2,3,0
18452,6,3,64619,64619,64622,0,3,3
18453,6,3,64625,64625,64628,0,3,3
18454,2,2,64627,64628,64630,1,3,0
18455,4,1,64631,64631,64632,0,1,1
18456,1,1,64632,64632,64633,0,1,0
18457,6,1,64638,64638,64639,0,1,5
18458,2,1,64640,64640,64641,0,1,1
18459,4,2,64644,64644,64646,0,2,3
18460,3,1,64647,64647,64648,0,1,1
18461,4,3,64651,64651,64654,0,3,3
18462,1,1,64652,64654,64655,2,3,0
18463,3,1,64655,64655,64656,0,1,0
18464,3,1,64658,64658,64659,0,1,2
18465,4,2,64662,64662,64664,0,2,3
18466,6,1,64668,64668,64669,0,1,4
18467,2,2,64670,64670,64672,0,2,1
18468,4,3,64674,64674,64677,0,3,2
18469,5,2,64679,64679,64681,0,2,2
18470,1,3,64680,64681,64684,1,4,0
18471,4,3,64684,64684,64687,0,3,0
18472,3,3,64687,64687,64690,0,3,0
18473,1,1,64688,64690,64691,2,3,0
18474,4,3,64692,64692,64695,0,3,1
18475,4,3,64696,64696,64699,0,3,1
18476,4,3,64700,64700,64703,0,3,1
18477,1,3,64701,64703,64706,2,5,0
18478,5,1,64706,64706,64707,0,1,0
18479,6,3,64712,64712,64715,0,3,5
18480,4,3,64716,64716,64719,0,3,1
18481,1,1,64717,64719,64720,2,3,0
18482,1,2,64718,64720,64722,2,4,0
18483,5,1,64723,64723,64724,0,1,1
18484,1,2,64724,64724,64726,0,2,0
18485,2,3,64726,64726,64729,0,3,0
18486,6,1,64732,64732,64733,0,1,3
18487,4,2,64736,64736,64738,0,2,3
18488,6,2,64742,64742,64744,0,2,4
18489,6,1,64748,64748,64749,0,1,4
18490,1,2,64749,64749,64751,0,2,0
18491,1,3,64750,64751,64754,1,4,0
18492,3,1,64753,64754,64755,1,2,0
18493,2,2,64755,64755,64757,0,2,0
18494,2,3,64757,64757,64760,0,3,0
18495,3,1,64760,64760,64761,0,1,0
18496,6,2,64766,64766,64768,0,2,5
18497,1,1,64767,64768,64769,1,2,0
18498,3,3,64770,64770,64773,0,3,1
18499,3,1,64773,64773,64774,0,1,0
18500,4,2,64777,64777,64779,0,2,3
18501,2,2,64779,64779,64781,0,2,0
18502,4,3,64783,64783,64786,0,3,2
18503,3,3,64786,64786,64789,0,3,0
18504,2,2,64788,64789,64791,1,3,0
18505,2,2,64790,64791,64793,1,3,0
18506,2,1,64792,64793,64794,1,2,0
18507,6,3,64798,64798,64801,0,3,4
18508,1,1,64799,64801,64802,2,3,0
18509,1,1,64800,64802,64803,2,3,0
18510,1,3,64801,64803,64806,2,5,0
18511,5,3,64806,64806,64809,0,3,0
18512,4,3,64810,64810,64813,0,3,1
18513,2,3,64812,64813,64816,1,4,0
18514,6,1,64818,64818,64819,0,1,2
18515,4,3,64822,64822,64825,0,3,3
18516,6,1,64828,64828,64829,0,1,3
18517,4,3,64832,64832,64835,0,3,3
18518,3,1,64835,64835,64836,0,1,0
18519,4,1,64839,64839,64840,0,1,3
18520,6,2,64845,64845,64847,0,2,5
18521,4,3,64849,64849,64852,0,3,2
18522,6,3,64855,64855,64858,0,3,3
18523,2,2,64857,64858,64860,1,3,0
18524,2,3,64859,64860,64863,1,4,0
18525,4,1,64863,64863,64864,0,1,0
18526,5,1,64868,64868,64869,0,1,4
18527,1,1,64869,64869,64870,0,1,0
18528,3,2,64872,64872,64874,0,2,2
18529,3,1,64875,64875,64876,0,1,1
18530,6,1,64881,64881,64882,0,1,5
18531,5,2,64886,64886,64888,0,2,4
18532,4,1,64890,64890,64891,0,1,2
18533,4,3,64894,64894,64897,0,3,3
18534,2,2,64896,64897,64899,1,3,0
18535,3,1,64899,64899,64900,0,1,0
18536,3,2,64902,64902,64904,0,2,2
18537,1,1,64903,64904,64905,1,2,0
18538,2,3,64905,64905,64908,0,3,0
18539,1,3,64906,64908,64911,2,5,0
18540,1,1,64907,64911,64912,4,5,0
18541,5,3,64912,64912,64915,0,3,0
18542,4,2,64916,64916,64918,0,2,1
18543,5,2,64921,64921,64923,0,2,3
18544,2,1,64923,64923,64924,0,1,0
18545,1,3,64924,64924,64927,0,3,0
18546,5,2,64929,64929,64931,0,2,2
18547,1,2,64930,64931,64933,1,3,0
18548,5,1,64935,64935,64936,0,1,2
18549,6,1,64941,64941,64942,0,1,5
18550,2,3,64943,64943,64946,0,3,1
18551,1,2,64944,64946,64948,2,4,0
18552,6,1,64950,64950,64951,0,1,2
18553,2,2,64952,64952,64954,0,2,1
18554,1,2,64953,64954,64956,1,3,0
18555,6,3,64959,64959,64962,0,3,3
18556,4,2,64963,64963,64965,0,2,1
18557,4,1,64967,64967,64968,0,1,2
18558,4,3,64971,64971,64974,0,3,3
18559,4,3,64975,64975,64978,0,3,1
18560,1,1,64976,64978,64979,2,3,0
18561,4,2,64980,64980,64982,0,2,1
18562,4,3,64984,64984,64987,0,3,2
18563,2,3,64986,64987,64990,1,4,0
18564,2,2,64988,64990,64992,2,4,0
18565,1,2,64989,64992,64994,3,5,0
18566,2,1,64991,64994,64995,3,4,0
18567,1,2,64992,64995,64997,3,5,0
18568,4,3,64996,64997,65000,1,4,0
18569,6,2,65002,65002,65004,0,2,2
18570,2,3,65004,65004,65007,0,3,0
18571,2,3,65006,65007,65010,1,4,0
18572,3,2,65009,65010,65012,1,3,0
18573,2,1,65011,65012,65013,1,2,0
18574,1,1,65012,65013,65014,1,2,0
18575,2,3,65014,65014,65017,0,3,0
18576,3,1,65017,65017,65018,0,1,0
18577,2,2,65019,65019,65021,0,2,1
18578,3,1,65022,65022,65023,0,1,1
18579,6,1,65028,65028,65029,0,1,5
18580,6,2,65034,65034,65036,0,2,5
18581,4,3,65038,65038,65041,0,3,2
18582,4,1,65042,65042,65043,0,1,1
18583,3,2,65045,65045,65047,0,2,2
18584,6,1,65051,65051,65052,0,1,4
18585,6,2,65057,65057,65059,0,2,5
18586,1,2,65058,65059,65061,1,3,0
18587,1,1,65059,65061,65062,2,3,0
18588,3,1,65062,65062,65063,0,1,0
18589,5,1,65067,65067,65068,0,1,4
18590,5,1,65072,65072,65073,0,1,4
18591,1,3,65073,65073,65076,0,3,0
18592,6,1,65079,65079,65080,0,1,3
18593,3,3,65082,65082,65085,0,3,2
18594,1,2,65083,65085,65087,2,4,0
18595,5,1,65088,65088,65089,0,1,1
18596,1,1,65089,65089,65090,0,1,0
18597,5,3,65094,65094,65097,0,3,4
18598,3,3,65097,65097,65100,0,3,0
18599,6,2,65103,65103,65105,0,2,3
18600,1,3,65104,65105,65108,1,4,0
18601,2,1,65106,65108,65109,2,3,0
18602,5,3,65111,65111,65114,0,3,2
18603,2,2,65113,65114,65116,1,3,0
18604,1,3,65114,65116,65119,2,5,0
18605,6,3,65120,65120,65123,0,3,1
18606,4,2,65124,65124,65126,0,2,1
18607,1,2,65125,65126,65128,1,3,0
18608,3,3,65128,65128,65131,0,3,0
18609,1,3,65129,65131,65134,2,5,0
18610,1,1,65130,65134,65135,4,5,0
18611,2,2,65132,65135,65137,3,5,0
18612,4,1,65136,65137,65138,1,2,0
18613,5,2,65141,65141,65143,0,2,3
18614,1,3,65142,65143,65146,1,4,0
18615,4,3,65146,65146,65149,0,3,0
18616,6,2,65152,65152,65154,0,2,3
18617,3,2,65155,65155,65157,0,2,1
18618,2,1,65157,65157,65158,0,1,0
18619,2,1,65159,65159,65160,0,1,1
18620,6,3,65165,65165,65168,0,3,5
18621,5,3,65170,65170,65173,0,3,2
18622,5,3,65175,65175,65178,0,3,2
18623,5,1,65180,65180,65181,0,1,2
18624,6,3,65186,65186,65189,0,3,5
18625,2,3,65188,65189,65192,1,4,0
18626,1,2,65189,65192,65194,3,5,0
18627,5,1,65194,65194,65195,0,1,0
18628,4,2,65198,65198,65200,0,2,3
18629,1,1,65199,65200,65201,1,2,0
18630,4,3,65203,65203,65206,0,3,2
18631,4,3,65207,65207,65210,0,3,1
18632,1,1,65208,65210,65211,2,3,0
18633,3,1,65211,65211,65212,0,1,0
18634,4,3,65215,65215,65218,0,3,3
18635,4,2,65219,65219,65221,0,2,1
18636,5,3,65224,65224,65227,0,3,3
18637,3,1,65227,65227,65228,0,1,0
18638,6,2,65233,65233,65235,0,2,5
18639,1,2,65234,65235,65237,1,3,0
18640,4,3,65238,65238,65241,0,3,1
18641,5,3,65243,65243,65246,0,3,2
18642,6,3,65249,65249,65252,0,3,3
18643,2,1,65251,65252,65253,1,2,0
18644,1,2,65252,65253,65255,1,3,0
18645,1,1,65253,65255,65256,2,3,0
18646,1,1,65254,65256,65257,2,3,0
18647,2,3,65256,65257,65260,1,4,0
18648,3,2,65259,65260,65262,1,3,0
18649,3,1,65262,65262,65263,0,1,0
18650,4,3,65266,65266,65269,0,3,3
18651,6,3,65272,65272,65275,0,3,3
18652,4,3,65276,65276,65279,0,3,1
18653,6,1,65282,65282,65283,0,1,3
18654,5,2,65287,65287,65289,0,2,4
18655,4,1,65291,65291,65292,0,1,2
18656,1,1,65292,65292,65293,0,1,0
18657,6,1,65298,65298,65299,0,1,5
18658,4,2,65302,65302,65304,0,2,3
18659,5,3,65307,65307,65310,0,3,3
18660,4,1,65311,65311,65312,0,1,1
18661,5,2,65316,65316,65318,0,2,4
18662,2,2,65318,65318,65320,0,2,0
18663,1,1,65319,65320,65321,1,2,0
18664,1,2,65320,65321,65323,1,3,0
18665,5,3,65325,65325,65328,0,3,2
18666,2,3,65327,65328,65331,1,4,0
18667,5,2,65332,65332,65334,0,2,1
18668,5,2,65337,65337,65339,0,2,3
18669,3,2,65340,65340,65342,0,2,1
18670,4,1,65344,65344,65345,0,1,2
18671,4,3,65348,65348,65351,0,3,3
18672,3,3,65351,65351,65354,0,3,0
18673,5,2,65356,65356,65358,0,2,2
18674,3,3,65359,65359,65362,0,3,1
18675,4,1,65363,65363,65364,0,1,1
18676,6,1,65369,65369,65370,0,1,5
18677,5,1,65374,65374,65375,0,1,4
18678,1,3,65375,65375,65378,0,3,0
18679,4,3,65379,65379,65382,0,3,1
18680,3,2,65382,65382,65384,0,2,0
18681,3,1,65385,65385,65386,0,1,1
18682,1,1,65386,65386,65387,0,1,0
18683,5,1,65391,65391,65392,0,1,4
18684,5,2,65396,65396,65398,0,2,4
18685,6,2,65402,65402,65404,0,2,4
18686,4,2,65406,65406,65408,0,2,2
18687,2,3,65408,65408,65411,0,3,0
18688,3,1,65411,65411,65412,0,1,0
18689,4,1,65415,65415,65416,0,1,3
18690,5,3,65420,65420,65423,0,3,4
18691,2,2,65422,65423,65425,1,3,0
18692,4,2,65426,65426,65428,0,2,1
18693,6,2,65432,65432,65434,0,2,4
18694,5,1,65437,65437,65438,0,1,3
18695,2,1,65439,65439,65440,0,1,1
18696,3,1,65442,65442,65443,0,1,2
18697,4,2,65446,65446,65448,0,2,3
18698,2,1,65448,65448,65449,0,1,0
18699,3,1,65451,65451,65452,0,1,2
18700,6,1,65457,65457,65458,0,1,5
18701,5,2,65462,65462,65464,0,2,4
18702,6,3,65468,65468,65471,0,3,4
18703,5,1,65473,65473,65474,0,1,2
18704,5,2,65478,65478,65480,0,2,4
18705,2,3,65480,65480,65483,0,3,0
18706,3,2,65483,65483,65485,0,2,0
18707,3,1,65486,65486,65487,0,1,1
18708,1,1,65487,65487,65488,0,1,0
18709,3,3,65490,65490,65493,0,3,2
18710,2,2,65492,65493,65495,1,3,0
18711,2,2,65494,65495,65497,1,3,0
18712,1,2,65495,65497,65499,2,4,0
18713,3,3,65498,65499,65502,1,4,0
18714,4,2,65502,65502,65504,0,2,0
18715,6,2,65508,65508,65510,0,2,4
18716,4,1,65512,65512,65513,0,1,2
18717,1,3,65513,65513,65516,0,3,0
18718,1,2,65514,65516,65518,2,4,0
18719,1,2,65515,65518,65520,3,5,0
18720,4,2,65519,65520,65522,1,3,0
18721,3,1,65522,65522,65523,0,1,0
18722,4,2,65526,65526,65528,0,2,3
18723,4,1,65530,65530,65531,0,1,2
18724,6,1,65536,65536,65537,0,1,5
18725,2,1,65538,65538,65539,0,1,1
18726,4,1,65542,65542,65543,0,1,3
18727,5,2,65547,65547,65549,0,2,4
18728,6,1,65553,65553,65554,0,1,4
18729,2,1,65555,65555,65556,0,1,1
18730,1,2,65556,65556,65558,0,2,0
18731,5,2,65561,65561,65563,0,2,3
18732,2,1,65563,65563,65564,0,1,0
18733,1,3,65564,65564,65567,0,3,0
18734,5,2,65569,65569,65571,0,2,2
18735,4,2,65573,65573,65575,0,2,2
18736,5,1,65578,65578,65579,0,1,3
18737,1,1,65579,65579,65580,0,1,0
18738,3,1,65582,65582,65583,0,1,2
18739,3,2,65585,65585,65587,0,2,2
18740,5,3,65590,65590,65593,0,3,3
18741,1,3,65591,65593,65596,2,5,0
18742,3,3,65594,65596,65599,2,5,0
18743,5,1,65599,65599,65600,0,1,0
18744,4,3,65603,65603,65606,0,3,3
18745,3,3,65606,65606,65609,0,3,0
18746,2,1,65608,65609,65610,1,2,0
18747,6,1,65614,65614,65615,0,1,4
18748,1,2,65615,65615,65617,0,2,0
18749,3,2,65618,65618,65620,0,2,1
18750,4,2,65622,65622,65624,0,2,2
18751,3,2,65625,65625,65627,0,2,1
18752,6,2,65631,65631,65633,0,2,4
18753,2,2,65633,65633,65635,0,2,0
18754,4,3,65637,65637,65640,0,3,2
18755,2,3,65639,65640,65643,1,4,0
18756,1,1,65640,65643,65644,3,4,0
18757,1,2,65641,65644,65646,3,5,0
18758,6,1,65647,65647,65648,0,1,1
18759,2,1,65649,65649,65650,0,1,1
18760,2,3,65651,65651,65654,0,3,1
18761,3,2,65654,65654,65656,0,2,0
18762,4,1,65658,65658,65659,0,1,2
18763,6,2,65664,65664,65666,0,2,5
18764,1,3,65665,65666,65669,1,4,0
18765,5,1,65670,65670,65671,0,1,1
18766,4,1,65674,65674,65675,0,1,3
18767,5,2,65679,65679,65681,0,2,4
18768,1,3,65680,65681,65684,1,4,0
18769,3,2,65683,65684,65686,1,3,0
18770,2,3,65685,65686,65689,1,4,0
18771,5,3,65690,65690,65693,0,3,1
18772,1,1,65691,65693,65694,2,3,0
18773,2,2,65693,65694,65696,1,3,0
18774,4,1,65697,65697,65698,0,1,1
18775,6,2,65703,65703,65705,0,2,5
18776,6,3,65709,65709,65712,0,3,4
18777,6,1,65715,65715,65716,0,1,3
18778,5,1,65720,65720,65721,0,1,4
18779,3,1,65723,65723,65724,0,1,2
18780,4,1,65727,65727,65728,0,1,3
18781,6,3,65733,65733,65736,0,3,5
18782,5,1,65738,65738,65739,0,1,2
18783,4,1,65742,65742,65743,0,1,3
18784,1,3,65743,65743,65746,0,3,0
18785,1,1,65744,65746,65747,2,3,0
18786,6,3,65750,65750,65753,0,3,3
18787,3,3,65753,65753,65756,0,3,0
18788,3,1,65756,65756,65757,0,1,0
18789,5,3,65761,65761,65764,0,3,4
18790,2,3,65763,65764,65767,1,4,0
18791,5,1,65768,65768,65769,0,1,1
18792,4,3,65772,65772,65775,0,3,3
18793,4,2,65776,65776,65778,0,2,1
18794,2,3,65778,65778,65781,0,3,0
18795,4,2,65782,65782,65784,0,2,1
18796,2,1,65784,65784,65785,0,1,0
18797,5,3,65789,65789,65792,0,3,4
18798,1,3,65790,65792,65795,2,5,0
18799,4,3,65794,65795,65798,1,4,0
18800,1,2,65795,65798,65800,3,5,0
18801,4,3,65799,65800,65803,1,4,0
18802,1,3,65800,65803,65806,3,6,0
18803,2,2,65802,65806,65808,4,6,0
18804,2,1,65804,65808,65809,4,5,0
18805,5,1,65809,65809,65810,0,1,0
18806,6,1,65815,65815,65816,0,1,5
18807,1,3,65816,65816,65819,0,3,0
18808,1,3,65817,65819,65822,2,5,0
18809,4,3,65821,65822,65825,1,4,0
18810,3,1,65824,65825,65826,1,2,0
18811,2,3,65826,65826,65829,0,3,0
18812,6,1,65832,65832,65833,0,1,3
18813,1,3,65833,65833,65836,0,3,0
18814,1,1,65834,65836,65837,2,3,0
18815,1,3,65835,65837,65840,2,5,0
18816,5,2,65840,65840,65842,0,2,0
18817,5,2,65845,65845,65847,0,2,3
18818,3,3,65848,65848,65851,0,3,1
18819,1,2,65849,65851,65853,2,4,0
18820,3,3,65852,65853,65856,1,4,0
18821,4,2,65856,65856,65858,0,2,0
18822,5,2,65861,65861,65863,0,2,3
18823,1,3,65862,65863,65866,1,4,0
18824,2,2,65864,65866,65868,2,4,0
18825,1,3,65865,65868,65871,3,6,0
18826,3,2,65868,65871,65873,3,5,0
18827,6,2,65874,65874,65876,0,2,1
18828,1,3,65875,65876,65879,1,4,0
18829,2,3,65877,65879,65882,2,5,0
18830,2,1,65879,65882,65883,3,4,0
18831,4,3,65883,65883,65886,0,3,0
18832,6,1,65889,65889,65890,0,1,3
18833,3,3,65892,65892,65895,0,3,2
18834,5,2,65897,65897,65899,0,2,2
18835,2,2,65899,65899,65901,0,2,0
18836,6,2,65905,65905,65907,0,2,4
18837,1,1,65906,65907,65908,1,2,0
18838,4,1,65910,65910,65911,0,1,2
18839,5,3,65915,65915,65918,0,3,4
18840,1,2,65916,65918,65920,2,4,0
18841,6,2,65922,65922,65924,0,2,2
18842,2,2,65924,65924,65926,0,2,0
18843,2,2,65926,65926,65928,0,2,0
18844,6,3,65932,65932,65935,0,3,4
18845,3,1,65935,65935,65936,0,1,0
18846,6,2,65941,65941,65943,0,2,5
18847,3,2,65944,65944,65946,0,2,1
18848,3,3,65947,65947,65950,0,3,1
18849,2,1,65949,65950,65951,1,2,0
18850,4,3,65953,65953,65956,0,3,2
18851,2,2,65955,65956,65958,1,3,0
18852,2,2,65957,65958,65960,1,3,0
18853,4,3,65961,65961,65964,0,3,1
18854,5,3,65966,65966,65969,0,3,2
18855,6,1,65972,65972,65973,0,1,3
18856,4,1,65976,65976,65977,0,1,3
18857,5,2,65981,65981,65983,0,2,4
18858,2,2,65983,65983,65985,0,2,0
18859,2,2,65985,65985,65987,0,2,0
18860,5,1,65990,65990,65991,0,1,3
18861,6,2,65996,65996,65998,0,2,5
18862,5,3,66001,66001,66004,0,3,3
18863,2,2,66003,66004,66006,1,3,0
18864,4,3,66007,66007,66010,0,3,1
18865,1,2,66008,66010,66012,2,4,0
18866,2,1,66010,66012,66013,2,3,0
18867,5,1,66015,66015,66016,0,1,2
18868,5,1,66020,66020,66021,0,1,4
18869,1,3,66021,66021,66024,0,3,0
18870,1,2,66022,66024,66026,2,4,0
18871,6,3,66028,66028,66031,0,3,2
18872,6,2,66034,66034,66036,0,2,3
18873,2,3,66036,66036,66039,0,3,0
18874,2,3,66038,66039,66042,1,4,0
18875,6,3,66044,66044,66047,0,3,2
18876,5,2,66049,66049,66051,0,2,2
18877,2,1,66051,66051,66052,0,1,0
18878,1,1,66052,66052,66053,0,1,0
18879,4,1,66056,66056,66057,0,1,3
18880,6,1,66062,66062,66063,0,1,5
18881,2,1,66064,66064,66065,0,1,1
18882,4,1,66068,66068,66069,0,1,3
18883,5,1,66073,66073,66074,0,1,4
18884,1,2,66074,66074,66076,0,2,0
18885,1,2,66075,66076,66078,1,3,0
18886,3,1,66078,66078,66079,0,1,0
18887,5,3,66083,66083,66086,0,3,4
18888,6,1,66089,66089,66090,0,1,3
18889,2,2,66091,66091,66093,0,2,1
18890,4,3,66095,66095,66098,0,3,2
18891,4,3,66099,66099,66102,0,3,1
18892,5,1,66104,66104,66105,0,1,2
18893,4,1,66108,66108,66109,0,1,3
18894,1,3,66109,66109,66112,0,3,0
18895,4,3,66113,66113,66116,0,3,1
18896,3,3,66116,66116,66119,0,3,0
18897,5,1,66121,66121,66122,0,1,2
18898,5,1,66126,66126,66127,0,1,4
18899,2,3,66128,66128,66131,0,3,1
18900,6,3,66134,66134,66137,0,3,3
18901,1,1,66135,66137,66138,2,3,0
18902,1,3,66136,66138,66141,2,5,0
18903,3,3,66139,66141,66144,2,5,0
18904,6,3,66145,66145,66148,0,3,1
18905,3,3,66148,66148,66151,0,3,0
18906,3,2,66151,66151,66153,0,2,0
18907,6,2,66157,66157,66159,0,2,4
18908,6,3,66163,66163,66166,0,3,4
18909,2,3,66165,66166,66169,1,4,0
18910,6,3,66171,66171,66174,0,3,2
18911,6,1,66177,66177,66178,0,1,3
18912,3,1,66180,66180,66181,0,1,2
18913,5,1,66185,66185,66186,0,1,4
18914,1,2,66186,66186,66188,0,2,0
18915,1,2,66187,66188,66190,1,3,0
18916,1,1,66188,66190,66191,2,3,0
18917,3,3,66191,66191,66194,0,3,0
18918,4,3,66195,66195,66198,0,3,1
18919,6,2,66201,66201,66203,0,2,3
18920,6,3,66207,66207,66210,0,3,4
18921,3,1,66210,66210,66211,0,1,0
18922,3,2,66213,66213,66215,0,2,2
18923,2,1,66215,66215,66216,0,1,0
18924,5,3,66220,66220,66223,0,3,4
18925,2,3,66222,66223,66226,1,4,0
18926,1,1,66223,66226,66227,3,4,0
18927,6,3,66229,66229,66232,0,3,2
18928,2,1,66231,66232,66233,1,2,0
18929,5,3,66236,66236,66239,0,3,3
18930,2,2,66238,66239,66241,1,3,0
18931,2,3,66240,66241,66244,1,4,0
18932,3,2,66243,66244,66246,1,3,0
18933,6,3,66249,66249,66252,0,3,3
18934,3,1,66252,66252,66253,0,1,0
18935,3,1,66255,66255,66256,0,1,2
18936,6,1,66261,66261,66262,0,1,5
18937,3,2,66264,66264,66266,0,2,2
18938,5,1,66269,66269,66270,0,1,3
18939,3,2,66272,66272,66274,0,2,2
18940,2,1,66274,66274,66275,0,1,0
18941,1,3,66275,66275,66278,0,3,0
18942,2,3,66277,66278,66281,1,4,0
18943,4,1,66281,66281,66282,0,1,0
18944,1,1,66282,66282,66283,0,1,0
18945,5,3,66287,66287,66290,0,3,4
18946,3,1,66290,66290,66291,0,1,0
18947,2,1,66292,66292,66293,0,1,1
18948,1,2,66293,66293,66295,0,2,0
18949,5,3,66298,66298,66301,0,3,3
18950,3,3,66301,66301,66304,0,3,0
18951,5,2,66306,66306,66308,0,2,2
18952,6,2,66312,66312,66314,0,2,4
18953,2,2,66314,66314,66316,0,2,0
18954,4,1,66318,66318,66319,0,1,2
18955,2,3,66320,66320,66323,0,3,1
18956,4,3,66324,66324,66327,0,3,1
18957,1,2,66325,66327,66329,2,4,0
18958,1,2,66326,66329,66331,3,5,0
18959,4,1,66330,66331,66332,1,2,0
18960,1,1,66331,66332,66333,1,2,0
18961,6,1,66337,66337,66338,0,1,4
18962,4,2,66341,66341,66343,0,2,3
18963,4,1,66345,66345,66346,0,1,2
18964,3,2,66348,66348,66350,0,2,2
18965,2,3,66350,66350,66353,0,3,0
18966,5,1,66355,66355,66356,0,1,2
18967,3,2,66358,66358,66360,0,2,2
18968,4,1,66362,66362,66363,0,1,2
18969,3,1,66365,66365,66366,0,1,2
18970,3,3,66368,66368,66371,0,3,2
18971,5,2,66373,66373,66375,0,2,2
18972,5,3,66378,66378,66381,0,3,3
18973,5,2,66383,66383,66385,0,2,2
18974,1,1,66384,66385,66386,1,2,0
18975,1,1,66385,66386,66387,1,2,0
18976,5,3,66390,66390,66393,0,3,3
18977,6,1,66396,66396,66397,0,1,3
18978,6,3,66402,66402,66405,0,3,5
18979,3,2,66405,66405,66407,0,2,0
18980,5,3,66410,66410,66413,0,3,3
18981,2,3,66412,66413,66416,1,4,0
18982,5,1,66417,66417,66418,0,1,1
18983,1,2,66418,66418,66420,0,2,0
18984,2,3,66420,66420,66423,0,3,0
18985,1,1,66421,66423,66424,2,3,0
18986,5,1,66426,66426,66427,0,1,2
18987,2,2,66428,66428,66430,0,2,1
18988,5,1,66433,66433,66434,0,1,3
18989,2,3,66435,66435,66438,0,3,1
18990,6,3,66441,66441,66444,0,3,3
18991,2,3,66443,66444,66447,1,4,0
18992,6,1,66449,66449,66450,0,1,2
18993,5,1,66454,66454,66455,0,1,4
18994,6,3,66460,66460,66463,0,3,5
18995,6,2,66466,66466,66468,0,2,3
18996,5,3,66471,66471,66474,0,3,3
18997,1,1,66472,66474,66475,2,3,0
18998,6,1,66478,66478,66479,0,1,3
18999,2,3,66480,66480,66483,0,3,1
19000,2,1,66482,66483,66484,1,2,0
19001,1,3,66483,66484,66487,1,4,0
19002,6,1,66489,66489,66490,0,1,2
19003,3,2,66492,66492,66494,0,2,2
19004,3,1,66495,66495,66496,0,1,1
19005,2,1,66497,66497,66498,0,1,1
19006,2,1,66499,66499,66500,0,1,1
19007,6,2,66505,66505,66507,0,2,5
19008,5,2,66510,66510,66512,0,2,3
19009,5,2,66515,66515,66517,0,2,3
19010,1,2,66516,66517,66519,1,3,0
19011,5,1,66521,66521,66522,0,1,2
19012,1,3,66522,66522,66525,0,3,0
19013,6,2,66528,66528,66530,0,2,3
19014,5,2,66533,66533,66535,0,2,3
19015,5,3,66538,66538,66541,0,3,3
19016,1,3,66539,66541,66544,2,5,0
19017,2,2,66541,66544,66546,3,5,0
19018,6,3,66547,66547,66550,0,3,1
19019,6,1,66553,66553,66554,0,1,3
19020,2,3,66555,66555,66558,0,3,1
19021,6,1,66561,66561,66562,0,1,3
19022,2,3,66563,66563,66566,0,3,1
19023,4,1,66567,66567,66568,0,1,1
19024,5,3,66572,66572,66575,0,3,4
19025,6,3,66578,66578,66581,0,3,3
19026,3,2,66581,66581,66583,0,2,0
19027,4,2,66585,66585,66587,0,2,2
19028,3,3,66588,66588,66591,0,3,1
19029,6,2,66594,66594,66596,0,2,3
19030,5,1,66599,66599,66600,0,1,3
19031,6,2,66605,66605,66607,0,2,5
19032,1,1,66606,66607,66608,1,2,0
19033,5,1,66611,66611,66612,0,1,3
19034,4,3,66615,66615,66618,0,3,3
19035,2,1,66617,66618,66619,1,2,0
19036,1,3,66618,66619,66622,1,4,0
19037,6,3,66624,66624,66627,0,3,2
19038,2,3,66626,66627,66630,1,4,0
19039,2,2,66628,66630,66632,2,4,0
19040,2,3,66630,66632,66635,2,5,0
19041,4,3,66634,66635,66638,1,4,0
19042,3,1,66637,66638,66639,1,2,0
19043,3,3,66640,66640,66643,0,3,1
19044,5,3,66645,66645,66648,0,3,2
19045,6,2,66651,66651,66653,0,2,3
19046,6,1,66657,66657,66658,0,1,4
19047,5,1,66662,66662,66663,0,1,4
19048,3,2,66665,66665,66667,0,2,2
19049,2,2,66667,66667,66669,0,2,0
19050,6,3,66673,66673,66676,0,3,4
19051,4,2,66677,66677,66679,0,2,1
19052,1,3,66678,66679,66682,1,4,0
19053,4,3,66682,66682,66685,0,3,0
19054,4,1,66686,66686,66687,0,1,1
19055,2,1,66688,66688,66689,0,1,1
19056,3,1,66691,66691,66692,0,1,2
19057,5,3,66696,66696,66699,0,3,4
19058,4,3,66700,66700,66703,0,3,1
19059,3,1,66703,66703,66704,0,1,0
19060,4,3,66707,66707,66710,0,3,3
19061,1,3,66708,66710,66713,2,5,0
19062,6,1,66714,66714,66715,0,1,1
19063,2,1,66716,66716,66717,0,1,1
19064,1,1,66717,66717,66718,0,1,0
19065,5,3,66722,66722,66725,0,3,4
19066,3,3,66725,66725,66728,0,3,0
19067,6,2,66731,66731,66733,0,2,3
19068,3,2,66734,66734,66736,0,2,1
19069,6,2,66740,66740,66742,0,2,4
19070,6,3,66746,66746,66749,0,3,4
19071,4,2,66750,66750,66752,0,2,1
19072,4,3,66754,66754,66757,0,3,2
19073,5,1,66759,66759,66760,0,1,2
19074,6,2,66765,66765,66767,0,2,5
19075,6,2,66771,66771,66773,0,2,4
19076,6,3,66777,66777,66780,0,3,4
19077,2,1,66779,66780,66781,1,2,0
19078,6,1,66785,66785,66786,0,1,4
19079,6,1,66791,66791,66792,0,1,5
19080,6,3,66797,66797,66800,0,3,5
19081,6,1,66803,66803,66804,0,1,3
19082,6,1,66809,66809,66810,0,1,5
19083,6,1,66815,66815,66816,0,1,5
19084,2,3,66817,66817,66820,0,3,1
19085,2,2,66819,66820,66822,1,3,0
19086,6,3,66825,66825,66828,0,3,3
19087,4,1,66829,66829,66830,0,1,1
19088,3,3,66832,66832,66835,0,3,2
19089,4,2,66836,66836,66838,0,2,1
19090,4,3,66840,66840,66843,0,3,2
19091,3,1,66843,66843,66844,0,1,0
19092,1,3,66844,66844,66847,0,3,0
19093,5,2,66849,66849,66851,0,2,2
19094,1,2,66850,66851,66853,1,3,0
19095,6,2,66856,66856,66858,0,2,3
19096,4,1,66860,66860,66861,0,1,2
19097,1,2,66861,66861,66863,0,2,0
19098,2,2,66863,66863,66865,0,2,0
19099,2,1,66865,66865,66866,0,1,0
19100,6,2,66871,66871,66873,0,2,5
19101,5,1,66876,66876,66877,0,1,3
19102,4,3,66880,66880,66883,0,3,3
19103,4,3,66884,66884,66887,0,3,1
19104,6,1,66890,66890,66891,0,1,3
19105,3,2,66893,66893,66895,0,2,2
19106,2,3,66895,66895,66898,0,3,0
19107,4,1,66899,66899,66900,0,1,1
19108,4,1,66903,66903,66904,0,1,3
19109,2,1,66905,66905,66906,0,1,1
19110,2,1,66907,66907,66908,0,1,1
19111,1,1,66908,66908,66909,0,1,0
19112,6,2,66914,66914,66916,0,2,5
19113,2,2,66916,66916,66918,0,2,0
19114,3,1,66919,66919,66920,0,1,1
19115,1,3,66920,66920,66923,0,3,0
19116,3,3,66923,66923,66926,0,3,0
19117,4,1,66927,66927,66928,0,1,1
19118,2,2,66929,66929,66931,0,2,1
19119,2,2,66931,66931,66933,0,2,0
19120,6,2,66937,66937,66939,0,2,4
19121,2,3,66939,66939,66942,0,3,0
19122,3,3,66942,66942,66945,0,3,0
19123,2,2,66944,66945,66947,1,3,0
19124,3,1,66947,66947,66948,0,1,0
19125,2,3,66949,66949,66952,0,3,1
19126,3,2,66952,66952,66954,0,2,0
19127,1,2,66953,66954,66956,1,3,0
19128,2,3,66955,66956,66959,1,4,0
19129,4,3,66959,66959,66962,0,3,0
19130,2,1,66961,66962,66963,1,2,0
19131,4,1,66965,66965,66966,0,1,2
19132,5,2,66970,66970,66972,0,2,4
19133,3,2,66973,66973,66975,0,2,1
19134,3,3,66976,66976,66979,0,3,1
19135,5,1,66981,66981,66982,0,1,2
19136,6,3,66987,66987,66990,0,3,5
19137,4,2,66991,66991,66993,0,2,1
19138,6,2,66997,66997,66999,0,2,4
19139,3,1,67000,67000,67001,0,1,1
19140,3,3,67003,67003,67006,0,3,2
19141,4,3,67007,67007,67010,0,3,1
19142,4,2,67011,67011,67013,0,2,1
19143,3,2,67014,67014,67016,0,2,1
19144,1,2,67015,67016,67018,1,3,0
19145,4,3,67019,67019,67022,0,3,1
19146,1,1,67020,67022,67023,2,3,0
19147,5,2,67025,67025,67027,0,2,2
19148,6,1,67031,67031,67032,0,1,4
19149,5,2,67036,67036,67038,0,2,4
19150,5,2,67041,67041,67043,0,2,3
19151,5,2,67046,67046,67048,0,2,3
19152,6,1,67052,67052,67053,0,1,4
19153,2,2,67054,67054,67056,0,2,1
19154,4,3,67058,67058,67061,0,3,2
19155,6,2,67064,67064,67066,0,2,3
19156,4,2,67068,67068,67070,0,2,2
19157,2,3,67070,67070,67073,0,3,0
19158,2,2,67072,67073,67075,1,3,0
19159,3,2,67075,67075,67077,0,2,0
19160,2,2,67077,67077,67079,0,2,0
19161,1,1,67078,67079,67080,1,2,0
19162,5,3,67083,67083,67086,0,3,3
19163,4,2,67087,67087,67089,0,2,1
19164,3,3,67090,67090,67093,0,3,1
19165,5,2,67095,67095,67097,0,2,2
19166,2,3,67097,67097,67100,0,3,0
19167,4,1,67101,67101,67102,0,1,1
19168,4,1,67105,67105,67106,0,1,3
19169,6,3,67111,67111,67114,0,3,5
19170,3,3,67114,67114,67117,0,3,0
19171,1,3,67115,67117,67120,2,5,0
19172,1,1,67116,67120,67121,4,5,0
19173,2,3,67118,67121,67124,3,6,0
19174,2,2,67120,67124,67126,4,6,0
19175,4,1,67124,67126,67127,2,3,0
19176,1,3,67125,67127,67130,2,5,0
19177,3,1,67128,67130,67131,2,3,0
19178,5,3,67133,67133,67136,0,3,2
19179,1,3,67134,67136,67139,2,5,0
19180,5,3,67139,67139,67142,0,3,0
19181,3,1,67142,67142,67143,0,1,0
19182,2,2,67144,67144,67146,0,2,1
19183,6,2,67150,67150,67152,0,2,4
19184,3,2,67153,67153,67155,0,2,1
19185,5,3,67158,67158,67161,0,3,3
19186,2,1,67160,67161,67162,1,2,0
19187,3,1,67163,67163,67164,0,1,1
19188,1,1,67164,67164,67165,0,1,0
19189,6,2,67170,67170,67172,0,2,5
19190,2,3,67172,67172,67175,0,3,0
19191,4,3,67176,67176,67179,0,3,1
19192,1,3,67177,67179,67182,2,5,0
19193,4,3,67181,67182,67185,1,4,0
19194,4,3,67185,67185,67188,0,3,0
19195,2,2,67187,67188,67190,1,3,0
19196,5,3,67192,67192,67195,0,3,2
19197,1,1,67193,67195,67196,2,3,0
19198,5,3,67198,67198,67201,0,3,2
19199,6,2,67204,67204,67206,0,2,3
19200,1,2,67205,67206,67208,1,3,0
19201,6,1,67211,67211,67212,0,1,3
19202,4,2,67215,67215,67217,0,2,3
19203,1,2,67216,67217,67219,1,3,0
19204,4,2,67220,67220,67222,0,2,1
19205,4,1,67224,67224,67225,0,1,2
19206,2,2,67226,67226,67228,0,2,1
19207,3,2,67229,67229,67231,0,2,1
19208,4,3,67233,67233,67236,0,3,2
19209,2,3,67235,67236,67239,1,4,0
19210,3,2,67238,67239,67241,1,3,0
19211,2,2,67240,67241,67243,1,3,0
19212,6,1,67246,67246,67247,0,1,3
19213,1,2,67247,67247,67249,0,2,0
19214,6,3,67253,67253,67256,0,3,4
19215,3,2,67256,67256,67258,0,2,0
19216,4,2,67260,67260,67262,0,2,2
19217,2,3,67262,67262,67265,0,3,0
19218,4,1,67266,67266,67267,0,1,1
19219,6,1,67272,67272,67273,0,1,5
19220,6,3,67278,67278,67281,0,3,5
19221,6,3,67284,67284,67287,0,3,3
19222,3,3,67287,67287,67290,0,3,0
19223,4,1,67291,67291,67292,0,1,1
19224,3,3,67294,67294,67297,0,3,2
19225,3,3,67297,67297,67300,0,3,0
19226,5,2,67302,67302,67304,0,2,2
19227,6,2,67308,67308,67310,0,2,4
19228,1,2,67309,67310,67312,1,3,0
19229,2,3,67311,67312,67315,1,4,0
19230,6,3,67317,67317,67320,0,3,2
19231,6,2,67323,67323,67325,0,2,3
19232,5,2,67328,67328,67330,0,2,3
19233,3,2,67331,67331,67333,0,2,1
19234,3,2,67334,67334,67336,0,2,1
19235,2,1,67336,67336,67337,0,1,0
19236,2,2,67338,67338,67340,0,2,1
19237,2,3,67340,67340,67343,0,3,0
19238,5,3,67345,67345,67348,0,3,2
19239,2,1,67347,67348,67349,1,2,0
19240,6,2,67353,67353,67355,0,2,4
19241,3,2,67356,67356,67358,0,2,1
19242,2,2,67358,67358,67360,0,2,0
19243,2,1,67360,67360,67361,0,1,0
19244,6,1,67366,67366,67367,0,1,5
19245,2,2,67368,67368,67370,0,2,1
19246,4,1,67372,67372,67373,0,1,2
19247,5,1,67377,67377,67378,0,1,4
19248,6,3,67383,67383,67386,0,3,5
19249,3,2,67386,67386,67388,0,2,0
19250,4,1,67390,67390,67391,0,1,2
19251,2,2,67392,67392,67394,0,2,1
19252,3,2,67395,67395,67397,0,2,1
19253,6,1,67401,67401,67402,0,1,4
19254,6,2,67407,67407,67409,0,2,5
19255,3,1,67410,67410,67411,0,1,1
19256,3,3,67413,67413,67416,0,3,2
19257,6,1,67419,67419,67420,0,1,3
19258,4,1,67423,67423,67424,0,1,3
19259,2,1,67425,67425,67426,0,1,1
19260,2,1,67427,67427,67428,0,1,1
19261,3,2,67430,67430,67432,0,2,2
19262,4,2,67434,67434,67436,0,2,2
19263,1,3,67435,67436,67439,1,4,0
19264,5,2,67440,67440,67442,0,2,1
19265,1,1,67441,67442,67443,1,2,0
19266,2,3,67443,67443,67446,0,3,0
19267,3,2,67446,67446,67448,0,2,0
19268,6,2,67452,67452,67454,0,2,4
19269,3,1,67455,67455,67456,0,1,1
19270,2,2,67457,67457,67459,0,2,1
19271,6,3,67463,67463,67466,0,3,4
19272,6,2,67469,67469,67471,0,2,3
19273,6,2,67475,67475,67477,0,2,4
19274,1,2,67476,67477,67479,1,3,0
19275,5,3,67481,67481,67484,0,3,2
19276,3,2,67484,67484,67486,0,2,0
19277,5,1,67489,67489,67490,0,1,3
19278,1,1,67490,67490,67491,0,1,0
19279,2,2,67492,67492,67494,0,2,1
19280,4,2,67496,67496,67498,0,2,2
19281,3,2,67499,67499,67501,0,2,1
19282,1,2,67500,67501,67503,1,3,0
19283,2,2,67502,67503,67505,1,3,0
19284,5,1,67507,67507,67508,0,1,2
19285,5,3,67512,67512,67515,0,3,4
19286,2,1,67514,67515,67516,1,2,0
19287,5,3,67519,67519,67522,0,3,3
19288,2,1,67521,67522,67523,1,2,0
19289,2,2,67523,67523,67525,0,2,0
19290,6,2,67529,67529,67531,0,2,4
19291,6,2,67535,67535,67537,0,2,4
19292,5,1,67540,67540,67541,0,1,3
19293,4,1,67544,67544,67545,0,1,3
19294,6,2,67550,67550,67552,0,2,5
19295,5,1,67555,67555,67556,0,1,3
19296,3,3,67558,67558,67561,0,3,2
19297,4,1,67562,67562,67563,0,1,1
19298,3,3,67565,67565,67568,0,3,2
19299,6,2,67571,67571,67573,0,2,3
19300,5,1,67576,67576,67577,0,1,3
19301,6,1,67582,67582,67583,0,1,5
19302,6,3,67588,67588,67591,0,3,5
19303,3,3,67591,67591,67594,0,3,0
19304,4,1,67595,67595,67596,0,1,1
19305,4,2,67599,67599,67601,0,2,3
19306,4,2,67603,67603,67605,0,2,2
19307,4,3,67607,67607,67610,0,3,2
19308,4,2,67611,67611,67613,0,2,1
19309,3,2,67614,67614,67616,0,2,1
19310,3,1,67617,67617,67618,0,1,1
19311,4,2,67621,67621,67623,0,2,3
19312,6,3,67627,67627,67630,0,3,4
19313,3,3,67630,67630,67633,0,3,0
19314,3,1,67633,67633,67634,0,1,0
19315,3,2,67636,67636,67638,0,2,2
19316,4,2,67640,67640,67642,0,2,2
19317,6,1,67646,67646,67647,0,1,4
19318,1,3,67647,67647,67650,0,3,0
19319,3,2,67650,67650,67652,0,2,0
19320,3,1,67653,67653,67654,0,1,1
19321,6,1,67659,67659,67660,0,1,5
19322,2,1,67661,67661,67662,0,1,1
19323,6,2,67667,67667,67669,0,2,5
19324,1,2,67668,67669,67671,1,3,0
19325,6,3,67674,67674,67677,0,3,3
19326,1,3,67675,67677,67680,2,5,0
19327,6,1,67681,67681,67682,0,1,1
19328,6,3,67687,67687,67690,0,3,5
19329,2,1,67689,67690,67691,1,2,0
19330,5,2,67694,67694,67696,0,2,3
19331,2,3,67696,67696,67699,0,3,0
19332,2,2,67698,67699,67701,1,3,0
19333,3,1,67701,67701,67702,0,1,0
19334,5,3,67706,67706,67709,0,3,4
19335,3,3,67709,67709,67712,0,3,0
19336,5,1,67714,67714,67715,0,1,2
19337,6,2,67720,67720,67722,0,2,5
19338,3,3,67723,67723,67726,0,3,1
19339,4,3,67727,67727,67730,0,3,1
19340,6,1,67733,67733,67734,0,1,3
19341,2,1,67735,67735,67736,0,1,1
19342,2,1,67737,67737,67738,0,1,1
19343,2,1,67739,67739,67740,0,1,1
19344,3,2,67742,67742,67744,0,2,2
19345,1,3,67743,67744,67747,1,4,0
19346,6,1,67749,67749,67750,0,1,2
19347,6,1,67755,67755,67756,0,1,5
19348,5,1,67760,67760,67761,0,1,4
19349,4,2,67764,67764,67766,0,2,3
19350,5,2,67769,67769,67771,0,2,3
19351,5,3,67774,67774,67777,0,3,3
19352,5,2,67779,67779,67781,0,2,2
19353,1,1,67780,67781,67782,1,2,0
19354,4,3,67784,67784,67787,0,3,2
19355,1,3,67785,67787,67790,2,5,0
19356,4,3,67789,67790,67793,1,4,0
19357,6,1,67795,67795,67796,0,1,2
19358,1,2,67796,67796,67798,0,2,0
19359,5,2,67801,67801,67803,0,2,3
19360,5,3,67806,67806,67809,0,3,3
19361,3,1,67809,67809,67810,0,1,0
19362,2,2,67811,67811,67813,0,2,1
19363,6,1,67817,67817,67818,0,1,4
19364,3,3,67820,67820,67823,0,3,2
19365,6,2,67826,67826,67828,0,2,3
19366,3,1,67829,67829,67830,0,1,1
19367,2,2,67831,67831,67833,0,2,1
19368,1,3,67832,67833,67836,1,4,0
19369,3,2,67835,67836,67838,1,3,0
19370,1,2,67836,67838,67840,2,4,0
19371,6,3,67842,67842,67845,0,3,2
19372,2,3,67844,67845,67848,1,4,0
19373,2,2,67846,67848,67850,2,4,0
19374,4,1,67850,67850,67851,0,1,0
19375,1,3,67851,67851,67854,0,3,0
19376,2,1,67853,67854,67855,1,2,0
19377,3,2,67856,67856,67858,0,2,1
19378,1,1,67857,67858,67859,1,2,0
19379,4,3,67861,67861,67864,0,3,2
19380,3,2,67864,67864,67866,0,2,0
19381,6,2,67870,67870,67872,0,2,4
19382,6,3,67876,67876,67879,0,3,4
19383,4,3,67880,67880,67883,0,3,1
19384,4,1,67884,67884,67885,0,1,1
19385,4,1,67888,67888,67889,0,1,3
19386,4,3,67892,67892,67895,0,3,3
19387,1,3,67893,67895,67898,2,5,0
19388,6,1,67899,67899,67900,0,1,1
19389,4,2,67903,67903,67905,0,2,3
19390,2,2,67905,67905,67907,0,2,0
19391,3,3,67908,67908,67911,0,3,1
19392,6,2,67914,67914,67916,0,2,3
19393,2,2,67916,67916,67918,0,2,0
19394,5,3,67921,67921,67924,0,3,3
19395,2,1,67923,67924,67925,1,2,0
19396,5,2,67928,67928,67930,0,2,3
19397,1,1,67929,67930,67931,1,2,0
19398,6,1,67935,67935,67936,0,1,4
19399,2,3,67937,67937,67940,0,3,1
19400,4,3,67941,67941,67944,0,3,1
19401,5,2,67946,67946,67948,0,2,2
19402,3,3,67949,67949,67952,0,3,1
19403,1,2,67950,67952,67954,2,4,0
19404,6,3,67956,67956,67959,0,3,2
19405,3,2,67959,67959,67961,0,2,0
19406,6,3,67965,67965,67968,0,3,4
19407,6,2,67971,67971,67973,0,2,3
19408,1,1,67972,67973,67974,1,2,0
19409,6,1,67978,67978,67979,0,1,4
19410,1,2,67979,67979,67981,0,2,0
19411,3,2,67982,67982,67984,0,2,1
19412,6,3,67988,67988,67991,0,3,4
19413,2,1,67990,67991,67992,1,2,0
19414,6,1,67996,67996,67997,0,1,4
19415,3,2,67999,67999,68001,0,2,2
19416,6,2,68005,68005,68007,0,2,4
19417,1,2,68006,68007,68009,1,3,0
19418,1,1,68007,68009,68010,2,3,0
19419,1,3,68008,68010,68013,2,5,0
19420,6,3,68014,68014,68017,0,3,1
19421,6,2,68020,68020,68022,0,2,3
19422,6,3,68026,68026,68029,0,3,4
19423,3,2,68029,68029,68031,0,2,0
19424,1,2,68030,68031,68033,1,3,0
19425,6,1,68036,68036,68037,0,1,3
19426,1,2,68037,68037,68039,0,2,0
19427,3,1,68040,68040,68041,0,1,1
19428,1,2,68041,68041,68043,0,2,0
19429,6,2,68047,68047,68049,0,2,4
19430,5,1,68052,68052,68053,0,1,3
19431,1,3,68053,68053,68056,0,3,0
19432,5,1,68058,68058,68059,0,1,2
19433,5,3,68063,68063,68066,0,3,4
19434,5,3,68068,68068,68071,0,3,2
19435,5,1,68073,68073,68074,0,1,2
19436,3,1,68076,68076,68077,0,1,2
19437,2,1,68078,68078,68079,0,1,1
19438,4,2,68082,68082,68084,0,2,3
19439,1,1,68083,68084,68085,1,2,0
19440,6,2,68089,68089,68091,0,2,4
19441,4,2,68093,68093,68095,0,2,2
19442,2,3,68095,68095,68098,0,3,0
19443,3,2,68098,68098,68100,0,2,0
19444,6,3,68104,68104,68107,0,3,4
19445,3,1,68107,68107,68108,0,1,0
19446,4,2,68111,68111,68113,0,2,3
19447,5,1,68116,68116,68117,0,1,3
19448,4,2,68120,68120,68122,0,2,3
19449,4,3,68124,68124,68127,0,3,2
19450,5,3,68129,68129,68132,0,3,2
19451,6,3,68135,68135,68138,0,3,3
19452,6,1,68141,68141,68142,0,1,3
19453,2,1,68143,68143,68144,0,1,1
19454,2,3,68145,68145,68148,0,3,1
19455,4,2,68149,68149,68151,0,2,1
19456,5,3,68154,68154,68157,0,3,3
19457,2,1,68156,68157,68158,1,2,0
19458,5,2,68161,68161,68163,0,2,3
19459,6,3,68167,68167,68170,0,3,4
19460,5,3,68172,68172,68175,0,3,2
19461,6,2,68178,68178,68180,0,2,3
19462,5,3,68183,68183,68186,0,3,3
19463,6,3,68189,68189,68192,0,3,3
19464,2,1,68191,68192,68193,1,2,0
19465,4,2,68195,68195,68197,0,2,2
19466,6,3,68201,68201,68204,0,3,4
19467,5,3,68206,68206,68209,0,3,2
19468,1,2,68207,68209,68211,2,4,0
19469,1,3,68208,68211,68214,3,6,0
19470,1,1,68209,68214,68215,5,6,0
19471,6,1,68215,68215,68216,0,1,0
19472,4,1,68219,68219,68220,0,1,3
19473,4,2,68223,68223,68225,0,2,3
19474,5,3,68228,68228,68231,0,3,3
19475,2,1,68230,68231,68232,1,2,0
19476,2,1,68232,68232,68233,0,1,0
19477,4,2,68236,68236,68238,0,2,3
19478,6,3,68242,68242,68245,0,3,4
19479,2,1,68244,68245,68246,1,2,0
19480,2,2,68246,68246,68248,0,2,0
19481,4,1,68250,68250,68251,0,1,2
19482,3,2,68253,68253,68255,0,2,2
19483,4,1,68257,68257,68258,0,1,2
19484,1,1,68258,68258,68259,0,1,0
19485,2,3,68260,68260,68263,0,3,1
19486,4,3,68264,68264,68267,0,3,1
19487,2,1,68266,68267,68268,1,2,0
19488,1,1,68267,68268,68269,1,2,0
19489,6,2,68273,68273,68275,0,2,4
19490,3,1,68276,68276,68277,0,1,1
19491,5,3,68281,68281,68284,0,3,4
19492,6,3,68287,68287,68290,0,3,3
19493,1,3,68288,68290,68293,2,5,0
19494,3,1,68291,68293,68294,2,3,0
19495,2,1,68293,68294,68295,1,2,0
19496,2,3,68295,68295,68298,0,3,0
19497,2,2,68297,68298,68300,1,3,0
19498,3,1,68300,68300,68301,0,1,0
19499,1,1,68301,68301,68302,0,1,0
19500,4,1,68305,68305,68306,0,1,3
19501,4,2,68309,68309,68311,0,2,3
19502,2,3,68311,68311,68314,0,3,0
19503,3,2,68314,68314,68316,0,2,0
19504,5,3,68319,68319,68322,0,3,3
19505,4,2,68323,68323,68325,0,2,1
19506,1,2,68324,68325,68327,1,3,0
19507,5,1,68329,68329,68330,0,1,2
19508,2,1,68331,68331,68332,0,1,1
19509,1,2,68332,68332,68334,0,2,0
19510,6,1,68338,68338,68339,0,1,4
19511,3,1,68341,68341,68342,0,1,2
19512,2,1,68343,68343,68344,0,1,1
19513,6,3,68349,68349,68352,0,3,5
19514,2,3,68351,68352,68355,1,4,0
19515,6,1,68357,68357,68358,0,1,2
19516,3,1,68360,68360,68361,0,1,2
19517,2,1,68362,68362,68363,0,1,1
19518,3,3,68365,68365,68368,0,3,2
19519,1,2,68366,68368,68370,2,4,0
19520,1,3,68367,68370,68373,3,6,0
19521,6,3,68373,68373,68376,0,3,0
19522,5,3,68378,68378,68381,0,3,2
19523,1,3,68379,68381,68384,2,5,0
19524,4,1,68383,68384,68385,1,2,0
19525,3,3,68386,68386,68389,0,3,1
19526,2,1,68388,68389,68390,1,2,0
19527,4,2,68392,68392,68394,0,2,2
19528,1,3,68393,68394,68397,1,4,0
19529,1,2,68394,68397,68399,3,5,0
19530,5,1,68399,68399,68400,0,1,0
19531,4,3,68403,68403,68406,0,3,3
19532,5,1,68408,68408,68409,0,1,2
19533,5,3,68413,68413,68416,0,3,4
19534,2,1,68415,68416,68417,1,2,0
19535,5,3,68420,68420,68423,0,3,3
19536,3,2,68423,68423,68425,0,2,0
19537,1,1,68424,68425,68426,1,2,0
19538,2,1,68426,68426,68427,0,1,0
19539,3,3,68429,68429,68432,0,3,2
19540,3,3,68432,68432,68435,0,3,0
19541,6,2,68438,68438,68440,0,2,3
19542,1,1,68439,68440,68441,1,2,0
19543,1,2,68440,68441,68443,1,3,0
19544,1,2,68441,68443,68445,2,4,0
19545,1,2,68442,68445,68447,3,5,0
19546,5,2,68447,68447,68449,0,2,0
19547,6,2,68453,68453,68455,0,2,4
19548,3,3,68456,68456,68459,0,3,1
19549,4,1,68460,68460,68461,0,1,1
19550,3,1,68463,68463,68464,0,1,2
19551,5,2,68468,68468,68470,0,2,4
19552,5,1,68473,68473,68474,0,1,3
19553,3,1,68476,68476,68477,0,1,2
19554,5,2,68481,68481,68483,0,2,4
19555,3,3,68484,68484,68487,0,3,1
19556,4,1,68488,68488,68489,0,1,1
19557,6,3,68494,68494,68497,0,3,5
19558,6,3,68500,68500,68503,0,3,3
19559,6,2,68506,68506,68508,0,2,3
19560,6,2,68512,68512,68514,0,2,4
19561,6,1,68518,68518,68519,0,1,4
19562,6,1,68524,68524,68525,0,1,5
19563,4,2,68528,68528,68530,0,2,3
19564,3,1,68531,68531,68532,0,1,1
19565,4,1,68535,68535,68536,0,1,3
19566,4,2,68539,68539,68541,0,2,3
19567,1,1,68540,68541,68542,1,2,0
19568,3,2,68543,68543,68545,0,2,1
19569,3,2,68546,68546,68548,0,2,1
19570,6,1,68552,68552,68553,0,1,4
19571,6,1,68558,68558,68559,0,1,5
19572,6,3,68564,68564,68567,0,3,5
19573,2,3,68566,68567,68570,1,4,0
19574,6,2,68572,68572,68574,0,2,2
19575,4,2,68576,68576,68578,0,2,2
19576,1,1,68577,68578,68579,1,2,0
19577,3,2,68580,68580,68582,0,2,1
19578,4,2,68584,68584,68586,0,2,2
19579,5,1,68589,68589,68590,0,1,3
19580,4,1,68593,68593,68594,0,1,3
19581,2,2,68595,68595,68597,0,2,1
19582,4,2,68599,68599,68601,0,2,2
19583,3,2,68602,68602,68604,0,2,1
19584,6,3,68608,68608,68611,0,3,4
19585,1,3,68609,68611,68614,2,5,0
19586,3,2,68612,68614,68616,2,4,0
19587,5,1,68617,68617,68618,0,1,1
19588,5,2,68622,68622,68624,0,2,4
19589,6,1,68628,68628,68629,0,1,4
19590,6,3,68634,68634,68637,0,3,5
19591,6,3,68640,68640,68643,0,3,3
19592,1,2,68641,68643,68645,2,4,0
19593,6,3,68647,68647,68650,0,3,2
19594,4,2,68651,68651,68653,0,2,1
19595,6,3,68657,68657,68660,0,3,4
19596,6,3,68663,68663,68666,0,3,3
19597,2,3,68665,68666,68669,1,4,0
19598,3,3,68668,68669,68672,1,4,0
19599,1,2,68669,68672,68674,3,5,0
19600,2,3,68671,68674,68677,3,6,0
19601,1,1,68672,68677,68678,5,6,0
19602,3,3,68675,68678,68681,3,6,0
19603,5,2,68680,68681,68683,1,3,0
19604,3,3,68683,68683,68686,0,3,0
19605,2,2,68685,68686,68688,1,3,0
19606,2,2,68687,68688,68690,1,3,0
19607,1,3,68688,68690,68693,2,5,0
19608,3,1,68691,68693,68694,2,3,0
19609,1,3,68692,68694,68697,2,5,0
19610,4,3,68696,68697,68700,1,4,0
19611,5,1,68701,68701,68702,0,1,1
19612,5,2,68706,68706,68708,0,2,4
19613,6,2,68712,68712,68714,0,2,4
19614,4,1,68716,68716,68717,0,1,2
19615,6,2,68722,68722,68724,0,2,5
19616,1,3,68723,68724,68727,1,4,0
19617,4,2,68727,68727,68729,0,2,0
19618,1,1,68728,68729,68730,1,2,0
19619,4,3,68732,68732,68735,0,3,2
19620,5,2,68737,68737,68739,0,2,2
19621,1,2,68738,68739,68741,1,3,0
19622,5,3,68743,68743,68746,0,3,2
19623,2,2,68745,68746,68748,1,3,0
19624,6,1,68751,68751,68752,0,1,3
19625,1,2,68752,68752,68754,0,2,0
19626,6,1,68758,68758,68759,0,1,4
19627,3,3,68761,68761,68764,0,3,2
19628,2,3,68763,68764,68767,1,4,0
19629,4,1,68767,68767,68768,0,1,0
19630,4,3,68771,68771,68774,0,3,3
19631,3,2,68774,68774,68776,0,2,0
19632,6,2,68780,68780,68782,0,2,4
19633,4,1,68784,68784,68785,0,1,2
19634,4,1,68788,68788,68789,0,1,3
19635,6,3,68794,68794,68797,0,3,5
19636,5,3,68799,68799,68802,0,3,2
19637,6,2,68805,68805,68807,0,2,3
19638,6,2,68811,68811,68813,0,2,4
19639,2,3,68813,68813,68816,0,3,0
19640,6,3,68819,68819,68822,0,3,3
19641,2,3,68821,68822,68825,1,4,0
19642,2,1,68823,68825,68826,2,3,0
19643,5,1,68828,68828,68829,0,1,2
19644,3,3,68831,68831,68834,0,3,2
19645,4,1,68835,68835,68836,0,1,1
19646,3,1,68838,68838,68839,0,1,2
19647,6,3,68844,68844,68847,0,3,5
19648,1,2,68845,68847,68849,2,4,0
19649,5,1,68850,68850,68851,0,1,1
19650,5,1,68855,68855,68856,0,1,4
19651,6,2,68861,68861,68863,0,2,5
19652,1,1,68862,68863,68864,1,2,0
19653,4,2,68866,68866,68868,0,2,2
19654,6,1,68872,68872,68873,0,1,4
19655,6,3,68878,68878,68881,0,3,5
19656,4,1,68882,68882,68883,0,1,1
19657,5,2,68887,68887,68889,0,2,4
19658,1,2,68888,68889,68891,1,3,0
19659,4,2,68892,68892,68894,0,2,1
19660,2,1,68894,68894,68895,0,1,0
19661,6,2,68900,68900,68902,0,2,5
19662,5,3,68905,68905,68908,0,3,3
19663,6,3,68911,68911,68914,0,3,3
19664,2,1,68913,68914,68915,1,2,0
19665,1,1,68914,68915,68916,1,2,0
19666,5,2,68919,68919,68921,0,2,3
19667,3,1,68922,68922,68923,0,1,1
19668,1,1,68923,68923,68924,0,1,0
19669,3,2,68926,68926,68928,0,2,2
19670,4,3,68930,68930,68933,0,3,2
19671,3,1,68933,68933,68934,0,1,0
19672,3,3,68936,68936,68939,0,3,2
19673,6,3,68942,68942,68945,0,3,3
19674,3,2,68945,68945,68947,0,2,0
19675,2,1,68947,68947,68948,0,1,0
19676,4,2,68951,68951,68953,0,2,3
19677,4,2,68955,68955,68957,0,2,2
19678,4,1,68959,68959,68960,0,1,2
19679,4,2,68963,68963,68965,0,2,3
19680,2,3,68965,68965,68968,0,3,0
19681,2,3,68967,68968,68971,1,4,0
19682,1,3,68968,68971,68974,3,6,0
19683,6,1,68974,68974,68975,0,1,0
19684,5,2,68979,68979,68981,0,2,4
19685,3,3,68982,68982,68985,0,3,1
19686,6,3,68988,68988,68991,0,3,3
19687,2,1,68990,68991,68992,1,2,0
19688,2,1,68992,68992,68993,0,1,0
19689,2,1,68994,68994,68995,0,1,1
19690,4,3,68998,68998,69001,0,3,3
19691,1,3,68999,69001,69004,2,5,0
19692,2,3,69001,69004,69007,3,6,0
19693,6,2,69007,69007,69009,0,2,0
19694,3,1,69010,69010,69011,0,1,1
19695,2,1,69012,69012,69013,0,1,1
19696,5,3,69017,69017,69020,0,3,4
19697,3,3,69020,69020,69023,0,3,0
19698,3,3,69023,69023,69026,0,3,0
19699,2,3,69025,69026,69029,1,4,0
19700,2,1,69027,69029,69030,2,3,0
19701,3,2,69030,69030,69032,0,2,0
19702,2,2,69032,69032,69034,0,2,0
19703,4,3,69036,69036,69039,0,3,2
19704,5,3,69041,69041,69044,0,3,2
19705,1,1,69042,69044,69045,2,3,0
19706,4,2,69046,69046,69048,0,2,1
19707,6,1,69052,69052,69053,0,1,4
19708,1,1,69053,69053,69054,0,1,0
19709,3,3,69056,69056,69059,0,3,2
19710,1,2,69057,69059,69061,2,4,0
19711,6,1,69063,69063,69064,0,1,2
19712,5,1,69068,69068,69069,0,1,4
19713,3,2,69071,69071,69073,0,2,2
19714,2,2,69073,69073,69075,0,2,0
19715,3,3,69076,69076,69079,0,3,1
19716,4,1,69080,69080,69081,0,1,1
19717,1,1,69081,69081,69082,0,1,0
19718,1,3,69082,69082,69085,0,3,0
19719,4,2,69086,69086,69088,0,2,1
19720,6,2,69092,69092,69094,0,2,4
19721,3,1,69095,69095,69096,0,1,1
19722,5,3,69100,69100,69103,0,3,4
19723,1,3,69101,69103,69106,2,5,0
19724,6,1,69107,69107,69108,0,1,1
19725,5,2,69112,69112,69114,0,2,4
19726,2,1,69114,69114,69115,0,1,0
19727,6,3,69120,69120,69123,0,3,5
19728,1,1,69121,69123,69124,2,3,0
19729,2,3,69123,69124,69127,1,4,0
19730,6,1,69129,69129,69130,0,1,2
19731,1,1,69130,69130,69131,0,1,0
19732,3,3,69133,69133,69136,0,3,2
19733,3,3,69136,69136,69139,0,3,0
19734,3,1,69139,69139,69140,0,1,0
19735,1,3,69140,69140,69143,0,3,0
19736,4,3,69144,69144,69147,0,3,1
19737,5,2,69149,69149,69151,0,2,2
19738,3,2,69152,69152,69154,0,2,1
19739,6,3,69158,69158,69161,0,3,4
19740,4,1,69162,69162,69163,0,1,1
19741,2,1,69164,69164,69165,0,1,1
19742,4,1,69168,69168,69169,0,1,3
19743,2,3,69170,69170,69173,0,3,1
19744,1,2,69171,69173,69175,2,4,0
19745,6,3,69177,69177,69180,0,3,2
19746,2,3,69179,69180,69183,1,4,0
19747,6,2,69185,69185,69187,0,2,2
19748,1,1,69186,69187,69188,1,2,0
19749,3,2,69189,69189,69191,0,2,1
19750,3,3,69192,69192,69195,0,3,1
19751,4,1,69196,69196,69197,0,1,1
19752,4,3,69200,69200,69203,0,3,3
19753,1,3,69201,69203,69206,2,5,0
19754,5,1,69206,69206,69207,0,1,0
19755,4,3,69210,69210,69213,0,3,3
19756,1,3,69211,69213,69216,2,5,0
19757,4,1,69215,69216,69217,1,2,0
19758,3,3,69218,69218,69221,0,3,1
19759,6,2,69224,69224,69226,0,2,3
19760,1,1,69225,69226,69227,1,2,0
19761,1,1,69226,69227,69228,1,2,0
19762,5,2,69231,69231,69233,0,2,3
19763,1,2,69232,69233,69235,1,3,0
19764,5,1,69237,69237,69238,0,1,2
19765,6,2,69243,69243,69245,0,2,5
19766,3,3,69246,69246,69249,0,3,1
19767,6,1,69252,69252,69253,0,1,3
19768,3,1,69255,69255,69256,0,1,2
19769,6,1,69261,69261,69262,0,1,5
19770,4,1,69265,69265,69266,0,1,3
19771,5,1,69270,69270,69271,0,1,4
19772,3,3,69273,69273,69276,0,3,2
19773,2,3,69275,69276,69279,1,4,0
19774,3,2,69278,69279,69281,1,3,0
19775,2,2,69280,69281,69283,1,3,0
19776,5,2,69285,69285,69287,0,2,2
19777,1,3,69286,69287,69290,1,4,0
19778,4,2,69290,69290,69292,0,2,0
19779,5,3,69295,69295,69298,0,3,3
19780,5,1,69300,69300,69301,0,1,2
19781,5,3,69305,69305,69308,0,3,4
19782,1,3,69306,69308,69311,2,5,0
19783,3,3,69309,69311,69314,2,5,0
19784,5,2,69314,69314,69316,0,2,0
19785,5,3,69319,69319,69322,0,3,3
19786,1,2,69320,69322,69324,2,4,0
19787,6,1,69326,69326,69327,0,1,2
19788,6,2,69332,69332,69334,0,2,5
19789,3,3,69335,69335,69338,0,3,1
19790,2,3,69337,69338,69341,1,4,0
19791,1,1,69338,69341,69342,3,4,0
19792,6,1,69344,69344,69345,0,1,2
19793,1,3,69345,69345,69348,0,3,0
19794,4,1,69349,69349,69350,0,1,1
19795,6,3,69355,69355,69358,0,3,5
19796,1,1,69356,69358,69359,2,3,0
19797,4,2,69360,69360,69362,0,2,1
19798,5,2,69365,69365,69367,0,2,3
19799,3,3,69368,69368,69371,0,3,1
19800,3,1,69371,69371,69372,0,1,0
19801,4,2,69375,69375,69377,0,2,3
19802,5,1,69380,69380,69381,0,1,3
19803,1,2,69381,69381,69383,0,2,0
19804,2,2,69383,69383,69385,0,2,0
19805,6,2,69389,69389,69391,0,2,4
19806,5,2,69394,69394,69396,0,2,3
19807,6,3,69400,69400,69403,0,3,4
19808,5,2,69405,69405,69407,0,2,2
19809,3,3,69408,69408,69411,0,3,1
19810,5,3,69413,69413,69416,0,3,2
19811,1,1,69414,69416,69417,2,3,0
19812,5,3,69419,69419,69422,0,3,2
19813,1,2,69420,69422,69424,2,4,0
19814,5,1,69425,69425,69426,0,1,1
19815,2,2,69427,69427,69429,0,2,1
19816,5,1,69432,69432,69433,0,1,3
19817,5,1,69437,69437,69438,0,1,4
19818,6,1,69443,69443,69444,0,1,5
19819,5,3,69448,69448,69451,0,3,4
19820,2,3,69450,69451,69454,1,4,0
19821,2,3,69452,69454,69457,2,5,0
19822,2,1,69454,69457,69458,3,4,0
19823,2,2,69456,69458,69460,2,4,0
19824,5,2,69461,69461,69463,0,2,1
19825,1,2,69462,69463,69465,1,3,0
19826,1,2,69463,69465,69467,2,4,0
19827,3,1,69466,69467,69468,1,2,0
19828,5,3,69471,69471,69474,0,3,3
19829,6,2,69477,69477,69479,0,2,3
19830,3,2,69480,69480,69482,0,2,1
19831,1,3,69481,69482,69485,1,4,0
19832,6,2,69487,69487,69489,0,2,2
19833,5,2,69492,69492,69494,0,2,3
19834,6,2,69498,69498,69500,0,2,4
19835,3,1,69501,69501,69502,0,1,1
19836,1,2,69502,69502,69504,0,2,0
19837,6,3,69508,69508,69511,0,3,4
19838,2,1,69510,69511,69512,1,2,0
19839,6,1,69516,69516,69517,0,1,4
19840,1,1,69517,69517,69518,0,1,0
19841,6,1,69523,69523,69524,0,1,5
19842,1,2,69524,69524,69526,0,2,0
19843,1,3,69525,69526,69529,1,4,0
19844,6,2,69531,69531,69533,0,2,2
19845,2,3,69533,69533,69536,0,3,0
19846,4,1,69537,69537,69538,0,1,1
19847,3,3,69540,69540,69543,0,3,2
19848,4,1,69544,69544,69545,0,1,1
19849,3,1,69547,69547,69548,0,1,2
19850,5,1,69552,69552,69553,0,1,4
19851,3,2,69555,69555,69557,0,2,2
19852,4,3,69559,69559,69562,0,3,2
19853,2,3,69561,69562,69565,1,4,0
19854,3,1,69564,69565,69566,1,2,0
19855,6,2,69570,69570,69572,0,2,4
19856,2,2,69572,69572,69574,0,2,0
19857,1,1,69573,69574,69575,1,2,0
19858,1,3,69574,69575,69578,1,4,0
19859,1,1,69575,69578,69579,3,4,0
19860,6,2,69581,69581,69583,0,2,2
19861,6,3,69587,69587,69590,0,3,4
19862,1,3,69588,69590,69593,2,5,0
19863,2,2,69590,69593,69595,3,5,0
19864,1,1,69591,69595,69596,4,5,0
19865,2,1,69593,69596,69597,3,4,0
19866,3,2,69596,69597,69599,1,3,0
19867,4,1,69600,69600,69601,0,1,1
19868,1,1,69601,69601,69602,0,1,0
19869,5,3,69606,69606,69609,0,3,4
19870,5,3,69611,69611,69614,0,3,2
19871,2,2,69613,69614,69616,1,3,0
19872,3,1,69616,69616,69617,0,1,0
19873,6,3,69622,69622,69625,0,3,5
19874,2,3,69624,69625,69628,1,4,0
19875,5,2,69629,69629,69631,0,2,1
19876,5,3,69634,69634,69637,0,3,3
19877,6,2,69640,69640,69642,0,2,3
19878,4,1,69644,69644,69645,0,1,2
19879,1,1,69645,69645,69646,0,1,0
19880,1,1,69646,69646,69647,0,1,0
19881,5,2,69651,69651,69653,0,2,4
19882,6,2,69657,69657,69659,0,2,4
19883,3,2,69660,69660,69662,0,2,1
19884,6,3,69666,69666,69669,0,3,4
19885,1,3,69667,69669,69672,2,5,0
19886,1,1,69668,69672,69673,4,5,0
19887,5,2,69673,69673,69675,0,2,0
19888,3,1,69676,69676,69677,0,1,1
19889,4,1,69680,69680,69681,0,1,3
19890,5,1,69685,69685,69686,0,1,4
19891,1,2,69686,69686,69688,0,2,0
19892,3,1,69689,69689,69690,0,1,1
19893,3,3,69692,69692,69695,0,3,2
19894,6,3,69698,69698,69701,0,3,3
19895,2,2,69700,69701,69703,1,3,0
19896,2,1,69702,69703,69704,1,2,0
19897,3,1,69705,69705,69706,0,1,1
19898,2,2,69707,69707,69709,0,2,1
19899,2,2,69709,69709,69711,0,2,0
19900,4,2,69713,69713,69715,0,2,2
19901,3,2,69716,69716,69718,0,2,1
19902,4,1,69720,69720,69721,0,1,2
19903,6,3,69726,69726,69729,0,3,5
19904,3,2,69729,69729,69731,0,2,0
19905,1,2,69730,69731,69733,1,3,0
19906,3,1,69733,69733,69734,0,1,0
19907,4,3,69737,69737,69740,0,3,3
19908,2,3,69739,69740,69743,1,4,0
19909,4,3,69743,69743,69746,0,3,0
19910,4,1,69747,69747,69748,0,1,1
19911,2,3,69749,69749,69752,0,3,1
19912,5,3,69754,69754,69757,0,3,2
19913,6,1,69760,69760,69761,0,1,3
19914,1,2,69761,69761,69763,0,2,0
19915,5,3,69766,69766,69769,0,3,3
19916,2,2,69768,69769,69771,1,3,0
19917,6,3,69774,69774,69777,0,3,3
19918,1,1,69775,69777,69778,2,3,0
19919,3,2,69778,69778,69780,0,2,0
19920,4,3,69782,69782,69785,0,3,2
19921,4,2,69786,69786,69788,0,2,1
19922,2,3,69788,69788,69791,0,3,0
19923,4,1,69792,69792,69793,0,1,1
19924,4,2,69796,69796,69798,0,2,3
19925,1,1,69797,69798,69799,1,2,0
19926,4,1,69801,69801,69802,0,1,2
19927,5,3,69806,69806,69809,0,3,4
19928,1,3,69807,69809,69812,2,5,0
19929,5,3,69812,69812,69815,0,3,0
19930,4,1,69816,69816,69817,0,1,1
19931,1,2,69817,69817,69819,0,2,0
19932,5,1,69822,69822,69823,0,1,3
19933,3,1,69825,69825,69826,0,1,2
19934,1,2,69826,69826,69828,0,2,0
19935,4,2,69830,69830,69832,0,2,2
19936,1,3,69831,69832,69835,1,4,0
19937,2,3,69833,69835,69838,2,5,0
19938,3,1,69836,69838,69839,2,3,0
19939,3,3,69839,69839,69842,0,3,0
19940,3,1,69842,69842,69843,0,1,0
19941,3,1,69845,69845,69846,0,1,2
19942,2,1,69847,69847,69848,0,1,1
19943,1,3,69848,69848,69851,0,3,0
19944,1,2,69849,69851,69853,2,4,0
19945,4,1,69853,69853,69854,0,1,0
19946,3,2,69856,69856,69858,0,2,2
19947,1,2,69857,69858,69860,1,3,0
19948,2,3,69859,69860,69863,1,4,0
19949,6,2,69865,69865,69867,0,2,2
19950,2,3,69867,69867,69870,0,3,0
19951,5,3,69872,69872,69875,0,3,2
19952,3,1,69875,69875,69876,0,1,0
19953,2,3,69877,69877,69880,0,3,1
19954,2,2,69879,69880,69882,1,3,0
19955,1,1,69880,69882,69883,2,3,0
19956,2,3,69882,69883,69886,1,4,0
19957,6,1,69888,69888,69889,0,1,2
19958,5,1,69893,69893,69894,0,1,4
19959,3,2,69896,69896,69898,0,2,2
19960,4,1,69900,69900,69901,0,1,2
19961,2,1,69902,69902,69903,0,1,1
19962,6,2,69908,69908,69910,0,2,5
19963,5,2,69913,69913,69915,0,2,3
19964,5,2,69918,69918,69920,0,2,3
19965,2,3,69920,69920,69923,0,3,0
19966,3,3,69923,69923,69926,0,3,0
19967,6,3,69929,69929,69932,0,3,3
19968,3,1,69932,69932,69933,0,1,0
19969,5,2,69937,69937,69939,0,2,4
19970,4,3,69941,69941,69944,0,3,2
19971,3,2,69944,69944,69946,0,2,0
19972,3,2,69947,69947,69949,0,2,1
19973,6,2,69953,69953,69955,0,2,4
19974,6,2,69959,69959,69961,0,2,4
19975,6,1,69965,69965,69966,0,1,4
19976,5,1,69970,69970,69971,0,1,4
19977,2,2,69972,69972,69974,0,2,1
19978,6,3,69978,69978,69981,0,3,4
19979,5,1,69983,69983,69984,0,1,2
19980,4,2,69987,69987,69989,0,2,3
19981,6,1,69993,69993,69994,0,1,4
19982,5,1,69998,69998,69999,0,1,4
19983,4,1,70002,70002,70003,0,1,3
19984,4,1,70006,70006,70007,0,1,3
19985,4,2,70010,70010,70012,0,2,3
19986,4,1,70014,70014,70015,0,1,2
19987,3,1,70017,70017,70018,0,1,2
19988,3,3,70020,70020,70023,0,3,2
19989,3,3,70023,70023,70026,0,3,0
19990,4,3,70027,70027,70030,0,3,1
19991,2,1,70029,70030,70031,1,2,0
19992,4,2,70033,70033,70035,0,2,2
19993,3,2,70036,70036,70038,0,2,1
19994,5,1,70041,70041,70042,0,1,3
19995,6,3,70047,70047,70050,0,3,5
19996,6,2,70053,70053,70055,0,2,3
19997,6,3,70059,70059,70062,0,3,4
19998,6,2,70065,70065,70067,0,2,3
19999,2,3,70067,70067,70070,0,3,0
20000,3,2,70070,70070,70072,0,2,0
20001,3,1,70073,70073,70074,0,1,1
20002,1,2,70074,70074,70076,0,2,0
20003,3,3,70077,70077,70080,0,3,1
20004,2,2,70079,70080,70082,1,3,0
20005,6,3,70085,70085,70088,0,3,3
20006,4,3,70089,70089,70092,0,3,1
20007,2,3,70091,70092,70095,1,4,0
20008,1,1,70092,70095,70096,3,4,0
20009,2,2,70094,70096,70098,2,4,0
20010,1,2,70095,70098,70100,3,5,0
20011,6,3,70101,70101,70104,0,3,1
20012,6,3,70107,70107,70110,0,3,3
20013,1,1,70108,70110,70111,2,3,0
20014,3,3,70111,70111,70114,0,3,0
20015,1,2,70112,70114,70116,2,4,0
20016,6,2,70118,70118,70120,0,2,2
20017,3,3,70121,70121,70124,0,3,1
20018,4,1,70125,70125,70126,0,1,1
20019,3,1,70128,70128,70129,0,1,2
20020,4,1,70132,70132,70133,0,1,3
20021,4,1,70136,70136,70137,0,1,3
20022,6,2,70142,70142,70144,0,2,5
20023,1,1,70143,70144,70145,1,2,0
20024,2,2,70145,70145,70147,0,2,0
20025,4,1,70149,70149,70150,0,1,2
20026,2,2,70151,70151,70153,0,2,1
20027,5,2,70156,70156,70158,0,2,3
20028,3,2,70159,70159,70161,0,2,1
20029,4,3,70163,70163,70166,0,3,2
20030,5,2,70168,70168,70170,0,2,2
20031,3,2,70171,70171,70173,0,2,1
20032,1,1,70172,70173,70174,1,2,0
20033,5,1,70177,70177,70178,0,1,3
20034,6,2,70183,70183,70185,0,2,5
20035,4,3,70187,70187,70190,0,3,2
20036,6,1,70193,70193,70194,0,1,3
20037,4,2,70197,70197,70199,0,2,3
20038,6,3,70203,70203,70206,0,3,4
20039,2,3,70205,70206,70209,1,4,0
20040,5,3,70210,70210,70213,0,3,1
20041,1,1,70211,70213,70214,2,3,0
20042,4,2,70215,70215,70217,0,2,1
20043,2,2,70217,70217,70219,0,2,0
20044,4,1,70221,70221,70222,0,1,2
20045,5,1,70226,70226,70227,0,1,4
20046,6,1,70232,70232,70233,0,1,5
20047,5,1,70237,70237,70238,0,1,4
20048,4,3,70241,70241,70244,0,3,3
20049,6,3,70247,70247,70250,0,3,3
20050,5,1,70252,70252,70253,0,1,2
20051,4,3,70256,70256,70259,0,3,3
20052,5,3,70261,70261,70264,0,3,2
20053,3,1,70264,70264,70265,0,1,0
20054,5,1,70269,70269,70270,0,1,4
20055,1,2,70270,70270,70272,0,2,0
20056,5,1,70275,70275,70276,0,1,3
20057,1,2,70276,70276,70278,0,2,0
20058,5,1,70281,70281,70282,0,1,3
20059,5,3,70286,70286,70289,0,3,4
20060,6,3,70292,70292,70295,0,3,3
20061,2,1,70294,70295,70296,1,2,0
20062,6,3,70300,70300,70303,0,3,4
20063,1,3,70301,70303,70306,2,5,0
20064,5,1,70306,70306,70307,0,1,0
20065,5,2,70311,70311,70313,0,2,4
20066,3,1,70314,70314,70315,0,1,1
20067,2,3,70316,70316,70319,0,3,1
20068,1,3,70317,70319,70322,2,5,0
20069,5,1,70322,70322,70323,0,1,0
20070,4,2,70326,70326,70328,0,2,3
20071,3,1,70329,70329,70330,0,1,1
20072,6,3,70335,70335,70338,0,3,5
20073,3,3,70338,70338,70341,0,3,0
20074,4,3,70342,70342,70345,0,3,1
20075,1,1,70343,70345,70346,2,3,0
20076,4,2,70347,70347,70349,0,2,1
20077,3,1,70350,70350,70351,0,1,1
20078,3,2,70353,70353,70355,0,2,2
20079,3,3,70356,70356,70359,0,3,1
20080,1,3,70357,70359,70362,2,5,0
20081,6,1,70363,70363,70364,0,1,1
20082,3,3,70366,70366,70369,0,3,2
20083,3,1,70369,70369,70370,0,1,0
20084,2,1,70371,70371,70372,0,1,1
20085,2,3,70373,70373,70376,0,3,1
20086,2,3,70375,70376,70379,1,4,0
20087,2,2,70377,70379,70381,2,4,0
20088,2,3,70379,70381,70384,2,5,0
20089,4,2,70383,70384,70386,1,3,0
20090,6,2,70389,70389,70391,0,2,3
20091,3,1,70392,70392,70393,0,1,1
20092,4,1,70396,70396,70397,0,1,3
20093,3,3,70399,70399,70402,0,3,2
20094,3,3,70402,70402,70405,0,3,0
20095,2,1,70404,70405,70406,1,2,0
20096,5,2,70409,70409,70411,0,2,3
20097,6,1,70415,70415,70416,0,1,4
20098,6,3,70421,70421,70424,0,3,5
20099,5,3,70426,70426,70429,0,3,2
20100,2,1,70428,70429,70430,1,2,0
20101,3,2,70431,70431,70433,0,2,1
20102,6,1,70437,70437,70438,0,1,4
20103,3,2,70440,70440,70442,0,2,2
20104,4,1,70444,70444,70445,0,1,2
20105,1,1,70445,70445,70446,0,1,0
20106,3,1,70448,70448,70449,0,1,2
20107,2,3,70450,70450,70453,0,3,1
20108,4,2,70454,70454,70456,0,2,1
20109,2,1,70456,70456,70457,0,1,0
20110,1,3,70457,70457,70460,0,3,0
20111,4,3,70461,70461,70464,0,3,1
20112,2,2,70463,70464,70466,1,3,0
20113,6,3,70469,70469,70472,0,3,3
20114,2,3,70471,70472,70475,1,4,0
20115,2,2,70473,70475,70477,2,4,0
20116,2,1,70475,70477,70478,2,3,0
20117,2,3,70477,70478,70481,1,4,0
20118,5,1,70482,70482,70483,0,1,1
20119,2,3,70484,70484,70487,0,3,1
20120,3,3,70487,70487,70490,0,3,0
20121,6,1,70493,70493,70494,0,1,3
20122,2,3,70495,70495,70498,0,3,1
20123,5,2,70500,70500,70502,0,2,2
20124,6,3,70506,70506,70509,0,3,4
20125,2,1,70508,70509,70510,1,2,0
20126,5,2,70513,70513,70515,0,2,3
20127,2,3,70515,70515,70518,0,3,0
20128,5,3,70520,70520,70523,0,3,2
20129,5,2,70525,70525,70527,0,2,2
20130,2,2,70527,70527,70529,0,2,0
20131,2,2,70529,70529,70531,0,2,0
20132,1,1,70530,70531,70532,1,2,0
20133,1,2,70531,70532,70534,1,3,0
20134,1,3,70532,70534,70537,2,5,0
20135,4,3,70536,70537,70540,1,4,0
20136,2,1,70538,70540,70541,2,3,0
20137,6,3,70544,70544,70547,0,3,3
20138,6,2,70550,70550,70552,0,2,3
20139,4,1,70554,70554,70555,0,1,2
20140,5,1,70559,70559,70560,0,1,4
20141,3,2,70562,70562,70564,0,2,2
20142,5,1,70567,70567,70568,0,1,3
20143,4,3,70571,70571,70574,0,3,3
20144,6,1,70577,70577,70578,0,1,3
20145,4,1,70581,70581,70582,0,1,3
20146,4,1,70585,70585,70586,0,1,3
20147,6,3,70591,70591,70594,0,3,5
20148,4,2,70595,70595,70597,0,2,1
20149,1,1,70596,70597,70598,1,2,0
20150,3,2,70599,70599,70601,0,2,1
20151,6,3,70605,70605,70608,0,3,4
20152,2,3,70607,70608,70611,1,4,0
20153,6,2,70613,70613,70615,0,2,2
20154,5,2,70618,70618,70620,0,2,3
20155,2,3,70620,70620,70623,0,3,0
20156,3,3,70623,70623,70626,0,3,0
20157,2,1,70625,70626,70627,1,2,0
20158,6,3,70631,70631,70634,0,3,4
20159,1,1,70632,70634,70635,2,3,0
20160,1,1,70633,70635,70636,2,3,0
20161,3,3,70636,70636,70639,0,3,0
20162,4,3,70640,70640,70643,0,3,1
20163,2,1,70642,70643,70644,1,2,0
20164,3,1,70645,70645,70646,0,1,1
20165,2,1,70647,70647,70648,0,1,1
20166,6,1,70653,70653,70654,0,1,5
20167,4,2,70657,70657,70659,0,2,3
20168,5,2,70662,70662,70664,0,2,3
20169,5,3,70667,70667,70670,0,3,3
20170,3,1,70670,70670,70671,0,1,0
20171,3,1,70673,70673,70674,0,1,2
20172,4,1,70677,70677,70678,0,1,3
20173,5,1,70682,70682,70683,0,1,4
20174,4,3,70686,70686,70689,0,3,3
20175,1,2,70687,70689,70691,2,4,0
20176,3,2,70690,70691,70693,1,3,0
20177,1,2,70691,70693,70695,2,4,0
20178,6,1,70697,70697,70698,0,1,2
20179,5,2,70702,70702,70704,0,2,4
20180,5,3,70707,70707,70710,0,3,3
20181,3,1,70710,70710,70711,0,1,0
20182,3,3,70713,70713,70716,0,3,2
20183,5,3,70718,70718,70721,0,3,2
20184,5,2,70723,70723,70725,0,2,2
20185,1,1,70724,70725,70726,1,2,0
20186,1,1,70725,70726,70727,1,2,0
20187,5,3,70730,70730,70733,0,3,3
20188,3,1,70733,70733,70734,0,1,0
20189,5,1,70738,70738,70739,0,1,4
20190,1,1,70739,70739,70740,0,1,0
20191,2,2,70741,70741,70743,0,2,1
20192,5,1,70746,70746,70747,0,1,3
20193,1,3,70747,70747,70750,0,3,0
20194,2,3,70749,70750,70753,1,4,0
20195,2,2,70751,70753,70755,2,4,0
20196,2,1,70753,70755,70756,2,3,0
20197,1,3,70754,70756,70759,2,5,0
20198,1,2,70755,70759,70761,4,6,0
20199,6,2,70761,70761,70763,0,2,0
20200,3,3,70764,70764,70767,0,3,1
20201,5,1,70769,70769,70770,0,1,2
20202,6,3,70775,70775,70778,0,3,5
20203,4,2,70779,70779,70781,0,2,1
20204,5,3,70784,70784,70787,0,3,3
20205,4,3,70788,70788,70791,0,3,1
20206,6,3,70794,70794,70797,0,3,3
20207,3,3,70797,70797,70800,0,3,0
20208,1,3,70798,70800,70803,2,5,0
20209,2,2,70800,70803,70805,3,5,0
20210,5,3,70805,70805,70808,0,3,0
20211,1,1,70806,70808,70809,2,3,0
20212,3,1,70809,70809,70810,0,1,0
20213,3,3,70812,70812,70815,0,3,2
20214,2,1,70814,70815,70816,1,2,0
20215,1,1,70815,70816,70817,1,2,0
20216,6,1,70821,70821,70822,0,1,4
20217,5,2,70826,70826,70828,0,2,4
20218,2,3,70828,70828,70831,0,3,0
20219,3,3,70831,70831,70834,0,3,0
20220,2,1,70833,70834,70835,1,2,0
20221,5,3,70838,70838,70841,0,3,3
20222,6,3,70844,70844,70847,0,3,3
20223,6,3,70850,70850,70853,0,3,3
20224,4,1,70854,70854,70855,0,1,1
20225,2,1,70856,70856,70857,0,1,1
20226,5,1,70861,70861,70862,0,1,4
20227,6,2,70867,70867,70869,0,2,5
20228,6,2,70873,70873,70875,0,2,4
20229,1,2,70874,70875,70877,1,3,0
20230,1,1,70875,70877,70878,2,3,0
20231,6,1,70881,70881,70882,0,1,3
20232,1,1,70882,70882,70883,0,1,0
20233,1,1,70883,70883,70884,0,1,0
20234,4,2,70887,70887,70889,0,2,3
20235,2,3,70889,70889,70892,0,3,0
20236,1,2,70890,70892,70894,2,4,0
20237,1,1,70891,70894,70895,3,4,0
20238,5,3,70896,70896,70899,0,3,1
20239,6,1,70902,70902,70903,0,1,3
20240,1,1,70903,70903,70904,0,1,0
20241,1,2,70904,70904,70906,0,2,0
20242,6,3,70910,70910,70913,0,3,4
20243,1,3,70911,70913,70916,2,5,0
20244,6,2,70917,70917,70919,0,2,1
20245,5,1,70922,70922,70923,0,1,3
20246,3,3,70925,70925,70928,0,3,2
20247,6,3,70931,70931,70934,0,3,3
20248,5,1,70936,70936,70937,0,1,2
20249,5,2,70941,70941,70943,0,2,4
20250,1,1,70942,70943,70944,1,2,0
20251,6,1,70948,70948,70949,0,1,4
20252,4,2,70952,70952,70954,0,2,3
20253,5,3,70957,70957,70960,0,3,3
20254,2,2,70959,70960,70962,1,3,0
20255,4,3,70963,70963,70966,0,3,1
20256,1,3,70964,70966,70969,2,5,0
20257,2,2,70966,70969,70971,3,5,0
20258,5,1,70971,70971,70972,0,1,0
20259,2,2,70973,70973,70975,0,2,1
20260,3,3,70976,70976,70979,0,3,1
20261,2,2,70978,70979,70981,1,3,0
20262,1,3,70979,70981,70984,2,5,0
20263,1,1,70980,70984,70985,4,5,0
20264,5,2,70985,70985,70987,0,2,0
20265,3,3,70988,70988,70991,0,3,1
20266,1,3,70989,70991,70994,2,5,0
20267,6,2,70995,70995,70997,0,2,1
20268,3,2,70998,70998,71000,0,2,1
20269,3,1,71001,71001,71002,0,1,1
20270,4,3,71005,71005,71008,0,3,3
20271,2,3,71007,71008,71011,1,4,0
20272,2,2,71009,71011,71013,2,4,0
20273,4,3,71013,71013,71016,0,3,0
20274,2,2,71015,71016,71018,1,3,0
20275,2,1,71017,71018,71019,1,2,0
20276,6,3,71023,71023,71026,0,3,4
20277,3,3,71026,71026,71029,0,3,0
20278,6,2,71032,71032,71034,0,2,3
20279,2,3,71034,71034,71037,0,3,0
20280,3,2,71037,71037,71039,0,2,0
20281,1,2,71038,71039,71041,1,3,0
20282,2,1,71040,71041,71042,1,2,0
20283,6,2,71046,71046,71048,0,2,4
20284,1,2,71047,71048,71050,1,3,0
20285,4,1,71051,71051,71052,0,1,1
20286,4,2,71055,71055,71057,0,2,3
20287,1,2,71056,71057,71059,1,3,0
20288,6,3,71062,71062,71065,0,3,3
20289,2,1,71064,71065,71066,1,2,0
20290,1,3,71065,71066,71069,1,4,0
20291,2,2,71067,71069,71071,2,4,0
20292,5,3,71072,71072,71075,0,3,1
20293,5,1,71077,71077,71078,0,1,2
20294,6,3,71083,71083,71086,0,3,5
20295,6,1,71089,71089,71090,0,1,3
20296,2,3,71091,71091,71094,0,3,1
20297,4,3,71095,71095,71098,0,3,1
20298,5,2,71100,71100,71102,0,2,2
20299,4,2,71104,71104,71106,0,2,2
20300,5,2,71109,71109,71111,0,2,3
20301,2,2,71111,71111,71113,0,2,0
20302,2,2,71113,71113,71115,0,2,0
20303,3,2,71116,71116,71118,0,2,1
20304,5,3,71121,71121,71124,0,3,3
20305,1,1,71122,71124,71125,2,3,0
20306,2,3,71124,71125,71128,1,4,0
20307,5,3,71129,71129,71132,0,3,1
20308,5,2,71134,71134,71136,0,2,2
20309,1,3,71135,71136,71139,1,4,0
20310,2,3,71137,71139,71142,2,5,0
20311,2,2,71139,71142,71144,3,5,0
20312,2,3,71141,71144,71147,3,6,0
20313,6,2,71147,71147,71149,0,2,0
20314,3,1,71150,71150,71151,0,1,1
20315,6,2,71156,71156,71158,0,2,5
20316,2,2,71158,71158,71160,0,2,0
20317,6,2,71164,71164,71166,0,2,4
20318,4,1,71168,71168,71169,0,1,2
20319,4,1,71172,71172,71173,0,1,3
20320,5,3,71177,71177,71180,0,3,4
20321,4,3,71181,71181,71184,0,3,1
20322,5,3,71186,71186,71189,0,3,2
20323,3,3,71189,71189,71192,0,3,0
20324,2,1,71191,71192,71193,1,2,0
20325,1,3,71192,71193,71196,1,4,0
20326,1,3,71193,71196,71199,3,6,0
20327,2,2,71195,71199,71201,4,6,0
20328,4,1,71199,71201,71202,2,3,0
20329,1,1,71200,71202,71203,2,3,0
20330,2,1,71202,71203,71204,1,2,0
20331,2,2,71204,71204,71206,0,2,0
20332,6,1,71210,71210,71211,0,1,4
20333,6,2,71216,71216,71218,0,2,5
20334,6,1,71222,71222,71223,0,1,4
20335,6,1,71228,71228,71229,0,1,5
20336,4,1,71232,71232,71233,0,1,3
20337,3,2,71235,71235,71237,0,2,2
20338,3,2,71238,71238,71240,0,2,1
20339,5,3,71243,71243,71246,0,3,3
20340,6,1,71249,71249,71250,0,1,3
20341,5,3,71254,71254,71257,0,3,4
20342,1,3,71255,71257,71260,2,5,0
20343,2,1,71257,71260,71261,3,4,0
20344,3,3,71260,71261,71264,1,4,0
20345,2,1,71262,71264,71265,2,3,0
20346,4,2,71266,71266,71268,0,2,1
20347,2,1,71268,71268,71269,0,1,0
20348,2,1,71270,71270,71271,0,1,1
20349,3,3,71273,71273,71276,0,3,2
20350,5,1,71278,71278,71279,0,1,2
20351,3,1,71281,71281,71282,0,1,2
20352,5,2,71286,71286,71288,0,2,4
20353,4,2,71290,71290,71292,0,2,2
20354,1,3,71291,71292,71295,1,4,0
20355,1,2,71292,71295,71297,3,5,0
20356,3,1,71295,71297,71298,2,3,0
20357,1,2,71296,71298,71300,2,4,0
20358,5,3,71301,71301,71304,0,3,1
20359,3,2,71304,71304,71306,0,2,0
20360,6,1,71310,71310,71311,0,1,4
20361,2,1,71312,71312,71313,0,1,1
20362,5,3,71317,71317,71320,0,3,4
20363,5,3,71322,71322,71325,0,3,2
20364,2,2,71324,71325,71327,1,3,0
20365,5,1,71329,71329,71330,0,1,2
20366,5,3,71334,71334,71337,0,3,4
20367,5,2,71339,71339,71341,0,2,2
20368,5,2,71344,71344,71346,0,2,3
20369,2,3,71346,71346,71349,0,3,0
20370,6,1,71352,71352,71353,0,1,3
20371,5,3,71357,71357,71360,0,3,4
20372,6,1,71363,71363,71364,0,1,3
20373,1,2,71364,71364,71366,0,2,0
20374,6,2,71370,71370,71372,0,2,4
20375,6,2,71376,71376,71378,0,2,4
20376,1,3,71377,71378,71381,1,4,0
20377,4,3,71381,71381,71384,0,3,0
20378,3,1,71384,71384,71385,0,1,0
20379,6,3,71390,71390,71393,0,3,5
20380,6,2,71396,71396,71398,0,2,3
20381,5,2,71401,71401,71403,0,2,3
20382,6,2,71407,71407,71409,0,2,4
20383,1,1,71408,71409,71410,1,2,0
20384,3,1,71411,71411,71412,0,1,1
20385,4,3,71415,71415,71418,0,3,3
20386,6,2,71421,71421,71423,0,2,3
20387,6,3,71427,71427,71430,0,3,4
20388,6,3,71433,71433,71436,0,3,3
20389,3,3,71436,71436,71439,0,3,0
20390,1,3,71437,71439,71442,2,5,0
20391,2,2,71439,71442,71444,3,5,0
20392,2,2,71441,71444,71446,3,5,0
20393,1,2,71442,71446,71448,4,6,0
20394,6,2,71448,71448,71450,0,2,0
20395,1,2,71449,71450,71452,1,3,0
20396,1,2,71450,71452,71454,2,4,0
20397,4,2,71454,71454,71456,0,2,0
20398,1,1,71455,71456,71457,1,2,0
20399,3,3,71458,71458,71461,0,3,1
20400,3,2,71461,71461,71463,0,2,0
20401,5,2,71466,71466,71468,0,2,3
20402,3,1,71469,71469,71470,0,1,1
20403,4,3,71473,71473,71476,0,3,3
20404,4,1,71477,71477,71478,0,1,1
20405,4,3,71481,71481,71484,0,3,3
20406,4,2,71485,71485,71487,0,2,1
20407,4,3,71489,71489,71492,0,3,2
20408,4,2,71493,71493,71495,0,2,1
20409,3,2,71496,71496,71498,0,2,1
20410,5,1,71501,71501,71502,0,1,3
20411,1,2,71502,71502,71504,0,2,0
20412,4,3,71506,71506,71509,0,3,2
20413,4,3,71510,71510,71513,0,3,1
20414,5,2,71515,71515,71517,0,2,2
20415,2,3,71517,71517,71520,0,3,0
20416,4,2,71521,71521,71523,0,2,1
20417,5,1,71526,71526,71527,0,1,3
20418,1,3,71527,71527,71530,0,3,0
20419,4,1,71531,71531,71532,0,1,1
20420,5,3,71536,71536,71539,0,3,4
20421,5,3,71541,71541,71544,0,3,2
20422,3,3,71544,71544,71547,0,3,0
20423,3,3,71547,71547,71550,0,3,0
20424,4,2,71551,71551,71553,0,2,1
20425,1,1,71552,71553,71554,1,2,0
20426,3,3,71555,71555,71558,0,3,1
20427,5,2,71560,71560,71562,0,2,2
20428,1,3,71561,71562,71565,1,4,0
20429,4,2,71565,71565,71567,0,2,0
20430,4,2,71569,71569,71571,0,2,2
20431,1,2,71570,71571,71573,1,3,0
20432,2,1,71572,71573,71574,1,2,0
20433,1,3,71573,71574,71577,1,4,0
20434,6,2,71579,71579,71581,0,2,2
20435,6,3,71585,71585,71588,0,3,4
20436,5,3,71590,71590,71593,0,3,2
20437,1,1,71591,71593,71594,2,3,0
20438,6,1,71597,71597,71598,0,1,3
20439,3,3,71600,71600,71603,0,3,2
20440,5,1,71605,71605,71606,0,1,2
20441,5,2,71610,71610,71612,0,2,4
20442,6,2,71616,71616,71618,0,2,4
20443,4,3,71620,71620,71623,0,3,2
20444,3,1,71623,71623,71624,0,1,0
20445,6,2,71629,71629,71631,0,2,5
20446,1,3,71630,71631,71634,1,4,0
20447,2,3,71632,71634,71637,2,5,0
20448,4,3,71636,71637,71640,1,4,0
20449,2,2,71638,71640,71642,2,4,0
20450,4,2,71642,71642,71644,0,2,0
20451,2,3,71644,71644,71647,0,3,0
20452,5,2,71649,71649,71651,0,2,2
20453,4,2,71653,71653,71655,0,2,2
20454,5,3,71658,71658,71661,0,3,3
20455,1,3,71659,71661,71664,2,5,0
20456,5,3,71664,71664,71667,0,3,0
20457,2,3,71666,71667,71670,1,4,0
20458,4,2,71670,71670,71672,0,2,0
20459,4,1,71674,71674,71675,0,1,2
20460,1,2,71675,71675,71677,0,2,0
20461,1,2,71676,71677,71679,1,3,0
20462,3,2,71679,71679,71681,0,2,0
20463,4,1,71683,71683,71684,0,1,2
20464,1,3,71684,71684,71687,0,3,0
20465,5,2,71689,71689,71691,0,2,2
20466,4,2,71693,71693,71695,0,2,2
20467,6,3,71699,71699,71702,0,3,4
20468,1,1,71700,71702,71703,2,3,0
20469,1,1,71701,71703,71704,2,3,0
20470,3,3,71704,71704,71707,0,3,0
20471,5,3,71709,71709,71712,0,3,2
20472,5,3,71714,71714,71717,0,3,2
20473,3,1,71717,71717,71718,0,1,0
20474,1,1,71718,71718,71719,0,1,0
20475,3,3,71721,71721,71724,0,3,2
20476,4,2,71725,71725,71727,0,2,1
20477,2,3,71727,71727,71730,0,3,0
20478,3,3,71730,71730,71733,0,3,0
20479,1,3,71731,71733,71736,2,5,0
20480,1,1,71732,71736,71737,4,5,0
20481,5,3,71737,71737,71740,0,3,0
20482,3,2,71740,71740,71742,0,2,0
20483,4,1,71744,71744,71745,0,1,2
20484,3,1,71747,71747,71748,0,1,2
20485,2,2,71749,71749,71751,0,2,1
20486,4,1,71753,71753,71754,0,1,2
20487,3,2,71756,71756,71758,0,2,2
20488,1,1,71757,71758,71759,1,2,0
20489,4,3,71761,71761,71764,0,3,2
20490,4,2,71765,71765,71767,0,2,1
20491,4,2,71769,71769,71771,0,2,2
20492,1,1,71770,71771,71772,1,2,0
20493,3,3,71773,71773,71776,0,3,1
20494,3,1,71776,71776,71777,0,1,0
20495,1,1,71777,71777,71778,0,1,0
20496,5,1,71782,71782,71783,0,1,4
20497,3,2,71785,71785,71787,0,2,2
20498,6,2,71791,71791,71793,0,2,4
20499,5,3,71796,71796,71799,0,3,3
20500,2,2,71798,71799,71801,1,3,0
20501,3,3,71801,71801,71804,0,3,0
20502,4,2,71805,71805,71807,0,2,1
20503,4,3,71809,71809,71812,0,3,2
20504,4,1,71813,71813,71814,0,1,1
20505,5,2,71818,71818,71820,0,2,4
20506,1,3,71819,71820,71823,1,4,0
20507,2,3,71821,71823,71826,2,5,0
20508,5,3,71826,71826,71829,0,3,0
20509,1,3,71827,71829,71832,2,5,0
20510,3,3,71830,71832,71835,2,5,0
20511,3,2,71833,71835,71837,2,4,0
20512,3,3,71836,71837,71840,1,4,0
20513,6,3,71842,71842,71845,0,3,2
20514,3,2,71845,71845,71847,0,2,0
20515,4,3,71849,71849,71852,0,3,2
20516,2,2,71851,71852,71854,1,3,0
20517,2,1,71853,71854,71855,1,2,0
20518,4,2,71857,71857,71859,0,2,2
20519,5,1,71862,71862,71863,0,1,3
20520,6,3,71868,71868,71871,0,3,5
20521,6,1,71874,71874,71875,0,1,3
20522,2,1,71876,71876,71877,0,1,1
20523,4,2,71880,71880,71882,0,2,3
20524,6,1,71886,71886,71887,0,1,4
20525,4,2,71890,71890,71892,0,2,3
20526,5,3,71895,71895,71898,0,3,3
20527,3,1,71898,71898,71899,0,1,0
20528,5,1,71903,71903,71904,0,1,4
20529,5,2,71908,71908,71910,0,2,4
20530,2,2,71910,71910,71912,0,2,0
20531,2,1,71912,71912,71913,0,1,0
20532,6,3,71918,71918,71921,0,3,5
20533,6,1,71924,71924,71925,0,1,3
20534,2,2,71926,71926,71928,0,2,1
20535,6,3,71932,71932,71935,0,3,4
20536,2,3,71934,71935,71938,1,4,0
20537,3,1,71937,71938,71939,1,2,0
20538,2,1,71939,71939,71940,0,1,0
20539,1,3,71940,71940,71943,0,3,0
20540,6,3,71946,71946,71949,0,3,3
20541,4,2,71950,71950,71952,0,2,1
20542,5,2,71955,71955,71957,0,2,3
20543,1,2,71956,71957,71959,1,3,0
20544,4,2,71960,71960,71962,0,2,1
20545,3,3,71963,71963,71966,0,3,1
20546,5,1,71968,71968,71969,0,1,2
20547,2,3,71970,71970,71973,0,3,1
20548,6,1,71976,71976,71977,0,1,3
20549,6,2,71982,71982,71984,0,2,5
20550,3,3,71985,71985,71988,0,3,1
20551,3,1,71988,71988,71989,0,1,0
20552,5,2,71993,71993,71995,0,2,4
20553,5,3,71998,71998,72001,0,3,3
20554,1,2,71999,72001,72003,2,4,0
20555,6,1,72005,72005,72006,0,1,2
20556,3,1,72008,72008,72009,0,1,2
20557,4,3,72012,72012,72015,0,3,3
20558,5,3,72017,72017,72020,0,3,2
20559,3,2,72020,72020,72022,0,2,0
20560,2,3,72022,72022,72025,0,3,0
20561,4,1,72026,72026,72027,0,1,1
20562,4,3,72030,72030,72033,0,3,3
20563,2,2,72032,72033,72035,1,3,0
20564,6,2,72038,72038,72040,0,2,3
20565,3,2,72041,72041,72043,0,2,1
20566,4,3,72045,72045,72048,0,3,2
20567,6,1,72051,72051,72052,0,1,3
20568,1,1,72052,72052,72053,0,1,0
20569,3,3,72055,72055,72058,0,3,2
20570,5,1,72060,72060,72061,0,1,2
20571,4,2,72064,72064,72066,0,2,3
20572,4,2,72068,72068,72070,0,2,2
20573,4,2,72072,72072,72074,0,2,2
20574,3,2,72075,72075,72077,0,2,1
20575,4,2,72079,72079,72081,0,2,2
20576,3,3,72082,72082,72085,0,3,1
20577,2,1,72084,72085,72086,1,2,0
20578,5,2,72089,72089,72091,0,2,3
20579,3,3,72092,72092,72095,0,3,1
20580,5,3,72097,72097,72100,0,3,2
20581,5,1,72102,72102,72103,0,1,2
20582,4,1,72106,72106,72107,0,1,3
20583,6,2,72112,72112,72114,0,2,5
20584,5,3,72117,72117,72120,0,3,3
20585,5,1,72122,72122,72123,0,1,2
20586,4,1,72126,72126,72127,0,1,3
20587,2,1,72128,72128,72129,0,1,1
20588,5,2,72133,72133,72135,0,2,4
20589,6,1,72139,72139,72140,0,1,4
20590,6,3,72145,72145,72148,0,3,5
20591,6,2,72151,72151,72153,0,2,3
20592,5,2,72156,72156,72158,0,2,3
20593,3,1,72159,72159,72160,0,1,1
20594,6,3,72165,72165,72168,0,3,5
20595,6,2,72171,72171,72173,0,2,3
20596,5,2,72176,72176,72178,0,2,3
20597,6,3,72182,72182,72185,0,3,4
20598,3,3,72185,72185,72188,0,3,0
20599,1,2,72186,72188,72190,2,4,0
20600,4,1,72190,72190,72191,0,1,0
20601,3,2,72193,72193,72195,0,2,2
20602,1,1,72194,72195,72196,1,2,0
20603,2,3,72196,72196,72199,0,3,0
20604,6,3,72202,72202,72205,0,3,3
20605,2,2,72204,72205,72207,1,3,0
20606,3,3,72207,72207,72210,0,3,0
20607,6,3,72213,72213,72216,0,3,3
20608,4,1,72217,72217,72218,0,1,1
20609,6,2,72223,72223,72225,0,2,5
20610,6,1,72229,72229,72230,0,1,4
20611,3,3,72232,72232,72235,0,3,2
20612,2,2,72234,72235,72237,1,3,0
20613,4,2,72238,72238,72240,0,2,1
20614,6,3,72244,72244,72247,0,3,4
20615,3,3,72247,72247,72250,0,3,0
20616,1,1,72248,72250,72251,2,3,0
20617,5,2,72253,72253,72255,0,2,2
20618,4,2,72257,72257,72259,0,2,2
20619,1,2,72258,72259,72261,1,3,0
20620,2,1,72260,72261,72262,1,2,0
20621,3,3,72263,72263,72266,0,3,1
20622,4,3,72267,72267,72270,0,3,1
20623,1,3,72268,72270,72273,2,5,0
20624,5,3,72273,72273,72276,0,3,0
20625,2,2,72275,72276,72278,1,3,0
20626,5,1,72280,72280,72281,0,1,2
20627,5,3,72285,72285,72288,0,3,4
20628,2,3,72287,72288,72291,1,4,0
20629,5,1,72292,72292,72293,0,1,1
20630,5,3,72297,72297,72300,0,3,4
20631,4,2,72301,72301,72303,0,2,1
20632,3,3,72304,72304,72307,0,3,1
20633,6,1,72310,72310,72311,0,1,3
20634,6,3,72316,72316,72319,0,3,5
20635,3,3,72319,72319,72322,0,3,0
20636,4,3,72323,72323,72326,0,3,1
20637,3,2,72326,72326,72328,0,2,0
20638,4,3,72330,72330,72333,0,3,2
20639,1,2,72331,72333,72335,2,4,0
20640,4,3,72335,72335,72338,0,3,0
20641,3,3,72338,72338,72341,0,3,0
20642,5,1,72343,72343,72344,0,1,2
20643,3,1,72346,72346,72347,0,1,2
20644,4,2,72350,72350,72352,0,2,3
20645,6,1,72356,72356,72357,0,1,4
20646,6,3,72362,72362,72365,0,3,5
20647,3,3,72365,72365,72368,0,3,0
20648,1,3,72366,72368,72371,2,5,0
20649,2,1,72368,72371,72372,3,4,0
20650,6,3,72374,72374,72377,0,3,2
20651,6,3,72380,72380,72383,0,3,3
20652,3,1,72383,72383,72384,0,1,0
20653,2,2,72385,72385,72387,0,2,1
20654,5,1,72390,72390,72391,0,1,3
20655,6,1,72396,72396,72397,0,1,5
20656,4,2,72400,72400,72402,0,2,3
20657,5,2,72405,72405,72407,0,2,3
20658,5,2,72410,72410,72412,0,2,3
20659,2,1,72412,72412,72413,0,1,0
20660,1,1,72413,72413,72414,0,1,0
20661,5,2,72418,72418,72420,0,2,4
20662,6,2,72424,72424,72426,0,2,4
20663,5,2,72429,72429,72431,0,2,3
20664,4,3,72433,72433,72436,0,3,2
20665,5,1,72438,72438,72439,0,1,2
20666,3,2,72441,72441,72443,0,2,2
20667,4,2,72445,72445,72447,0,2,2
20668,1,3,72446,72447,72450,1,4,0
20669,2,2,72448,72450,72452,2,4,0
20670,3,2,72451,72452,72454,1,3,0
20671,6,2,72457,72457,72459,0,2,3
20672,6,1,72463,72463,72464,0,1,4
20673,3,3,72466,72466,72469,0,3,2
20674,2,1,72468,72469,72470,1,2,0
20675,6,3,72474,72474,72477,0,3,4
20676,6,2,72480,72480,72482,0,2,3
20677,1,3,72481,72482,72485,1,4,0
20678,2,3,72483,72485,72488,2,5,0
20679,1,3,72484,72488,72491,4,7,0
20680,6,1,72490,72491,72492,1,2,0
20681,5,3,72495,72495,72498,0,3,3
20682,1,1,72496,72498,72499,2,3,0
20683,6,1,72502,72502,72503,0,1,3
20684,5,1,72507,72507,72508,0,1,4
20685,5,2,72512,72512,72514,0,2,4
20686,4,2,72516,72516,72518,0,2,2
20687,2,3,72518,72518,72521,0,3,0
20688,2,1,72520,72521,72522,1,2,0
20689,6,2,72526,72526,72528,0,2,4
20690,1,2,72527,72528,72530,1,3,0
20691,5,2,72532,72532,72534,0,2,2
20692,2,1,72534,72534,72535,0,1,0
20693,5,2,72539,72539,72541,0,2,4
20694,1,2,72540,72541,72543,1,3,0
20695,5,1,72545,72545,72546,0,1,2
20696,3,3,72548,72548,72551,0,3,2
20697,1,3,72549,72551,72554,2,5,0
20698,5,1,72554,72554,72555,0,1,0
20699,1,2,72555,72555,72557,0,2,0
20700,1,3,72556,72557,72560,1,4,0
20701,4,3,72560,72560,72563,0,3,0
20702,2,2,72562,72563,72565,1,3,0
20703,1,3,72563,72565,72568,2,5,0
20704,4,3,72567,72568,72571,1,4,0
20705,6,1,72573,72573,72574,0,1,2
20706,6,3,72579,72579,72582,0,3,5
20707,3,3,72582,72582,72585,0,3,0
20708,5,3,72587,72587,72590,0,3,2
20709,2,1,72589,72590,72591,1,2,0
20710,6,3,72595,72595,72598,0,3,4
20711,1,3,72596,72598,72601,2,5,0
20712,2,2,72598,72601,72603,3,5,0
20713,1,3,72599,72603,72606,4,7,0
20714,5,1,72604,72606,72607,2,3,0
20715,4,1,72608,72608,72609,0,1,1
20716,4,3,72612,72612,72615,0,3,3
20717,3,3,72615,72615,72618,0,3,0
20718,6,1,72621,72621,72622,0,1,3
20719,2,1,72623,72623,72624,0,1,1
20720,5,3,72628,72628,72631,0,3,4
20721,1,3,72629,72631,72634,2,5,0
20722,5,2,72634,72634,72636,0,2,0
20723,5,3,72639,72639,72642,0,3,3
20724,1,1,72640,72642,72643,2,3,0
20725,6,2,72646,72646,72648,0,2,3
20726,5,2,72651,72651,72653,0,2,3
20727,2,2,72653,72653,72655,0,2,0
20728,2,1,72655,72655,72656,0,1,0
20729,4,1,72659,72659,72660,0,1,3
20730,3,3,72662,72662,72665,0,3,2
20731,3,3,72665,72665,72668,0,3,0
20732,4,2,72669,72669,72671,0,2,1
20733,4,3,72673,72673,72676,0,3,2
20734,2,1,72675,72676,72677,1,2,0
20735,6,3,72681,72681,72684,0,3,4
20736,6,3,72687,72687,72690,0,3,3
20737,6,3,72693,72693,72696,0,3,3
20738,2,1,72695,72696,72697,1,2,0
20739,3,1,72698,72698,72699,0,1,1
20740,3,1,72701,72701,72702,0,1,2
20741,2,3,72703,72703,72706,0,3,1
20742,6,3,72709,72709,72712,0,3,3
20743,2,1,72711,72712,72713,1,2,0
20744,4,2,72715,72715,72717,0,2,2
20745,6,3,72721,72721,72724,0,3,4
20746,6,1,72727,72727,72728,0,1,3
20747,2,1,72729,72729,72730,0,1,1
20748,1,3,72730,72730,72733,0,3,0
20749,1,1,72731,72733,72734,2,3,0
20750,4,2,72735,72735,72737,0,2,1
20751,6,1,72741,72741,72742,0,1,4
20752,2,2,72743,72743,72745,0,2,1
20753,2,3,72745,72745,72748,0,3,0
20754,1,3,72746,72748,72751,2,5,0
20755,2,2,72748,72751,72753,3,5,0
20756,1,3,72749,72753,72756,4,7,0
20757,2,1,72751,72756,72757,5,6,0
20758,2,2,72753,72757,72759,4,6,0
20759,6,2,72759,72759,72761,0,2,0
20760,5,3,72764,72764,72767,0,3,3
20761,2,2,72766,72767,72769,1,3,0
20762,1,1,72767,72769,72770,2,3,0
20763,6,3,72773,72773,72776,0,3,3
20764,2,1,72775,72776,72777,1,2,0
20765,6,2,72781,72781,72783,0,2,4
20766,2,1,72783,72783,72784,0,1,0
20767,4,1,72787,72787,72788,0,1,3
20768,4,2,72791,72791,72793,0,2,3
20769,3,2,72794,72794,72796,0,2,1
20770,1,3,72795,72796,72799,1,4,0
20771,4,2,72799,72799,72801,0,2,0
20772,4,1,72803,72803,72804,0,1,2
20773,1,1,72804,72804,72805,0,1,0
20774,6,2,72810,72810,72812,0,2,5
20775,5,1,72815,72815,72816,0,1,3
20776,1,3,72816,72816,72819,0,3,0
20777,3,1,72819,72819,72820,0,1,0
20778,6,2,72825,72825,72827,0,2,5
20779,1,2,72826,72827,72829,1,3,0
20780,5,1,72831,72831,72832,0,1,2
20781,2,3,72833,72833,72836,0,3,1
20782,5,3,72838,72838,72841,0,3,2
20783,5,1,72843,72843,72844,0,1,2
20784,3,1,72846,72846,72847,0,1,2
20785,6,1,72852,72852,72853,0,1,5
20786,6,3,72858,72858,72861,0,3,5
20787,3,1,72861,72861,72862,0,1,0
20788,6,2,72867,72867,72869,0,2,5
20789,2,3,72869,72869,72872,0,3,0
20790,2,1,72871,72872,72873,1,2,0
20791,6,1,72877,72877,72878,0,1,4
20792,2,1,72879,72879,72880,0,1,1
20793,4,1,72883,72883,72884,0,1,3
20794,3,3,72886,72886,72889,0,3,2
20795,4,2,72890,72890,72892,0,2,1
20796,2,3,72892,72892,72895,0,3,0
20797,2,1,72894,72895,72896,1,2,0
20798,2,3,72896,72896,72899,0,3,0
20799,2,2,72898,72899,72901,1,3,0
20800,6,3,72904,72904,72907,0,3,3
20801,2,2,72906,72907,72909,1,3,0
20802,5,3,72911,72911,72914,0,3,2
20803,1,1,72912,72914,72915,2,3,0
20804,2,3,72914,72915,72918,1,4,0
20805,2,3,72916,72918,72921,2,5,0
20806,2,2,72918,72921,72923,3,5,0
20807,4,2,72922,72923,72925,1,3,0
20808,5,2,72927,72927,72929,0,2,2
20809,3,2,72930,72930,72932,0,2,1
20810,1,1,72931,72932,72933,1,2,0
20811,2,3,72933,72933,72936,0,3,0
20812,1,2,72934,72936,72938,2,4,0
20813,3,2,72937,72938,72940,1,3,0
20814,5,3,72942,72942,72945,0,3,2
20815,6,2,72948,72948,72950,0,2,3
20816,4,1,72952,72952,72953,0,1,2
20817,3,1,72955,72955,72956,0,1,2
20818,2,3,72957,72957,72960,0,3,1
20819,4,2,72961,72961,72963,0,2,1
20820,6,2,72967,72967,72969,0,2,4
20821,3,1,72970,72970,72971,0,1,1
20822,2,1,72972,72972,72973,0,1,1
20823,5,3,72977,72977,72980,0,3,4
20824,1,2,72978,72980,72982,2,4,0
20825,5,2,72983,72983,72985,0,2,1
20826,6,1,72989,72989,72990,0,1,4
20827,5,1,72994,72994,72995,0,1,4
20828,4,2,72998,72998,73000,0,2,3
20829,6,3,73004,73004,73007,0,3,4
20830,6,1,73010,73010,73011,0,1,3
20831,3,1,73013,73013,73014,0,1,2
20832,3,1,73016,73016,73017,0,1,2
20833,3,2,73019,73019,73021,0,2,2
20834,4,1,73023,73023,73024,0,1,2
20835,1,1,73024,73024,73025,0,1,0
20836,6,3,73030,73030,73033,0,3,5
20837,3,3,73033,73033,73036,0,3,0
20838,5,3,73038,73038,73041,0,3,2
20839,5,2,73043,73043,73045,0,2,2
20840,4,3,73047,73047,73050,0,3,2
20841,5,1,73052,73052,73053,0,1,2
20842,1,1,73053,73053,73054,0,1,0
20843,4,3,73057,73057,73060,0,3,3
20844,2,1,73059,73060,73061,1,2,0
20845,4,2,73063,73063,73065,0,2,2
20846,1,2,73064,73065,73067,1,3,0
20847,1,2,73065,73067,73069,2,4,0
20848,5,1,73070,73070,73071,0,1,1
20849,1,2,73071,73071,73073,0,2,0
20850,4,2,73075,73075,73077,0,2,2
20851,1,2,73076,73077,73079,1,3,0
20852,4,1,73080,73080,73081,0,1,1
20853,6,3,73086,73086,73089,0,3,5
20854,5,2,73091,73091,73093,0,2,2
20855,3,1,73094,73094,73095,0,1,1
20856,6,1,73100,73100,73101,0,1,5
20857,6,1,73106,73106,73107,0,1,5
20858,5,2,73111,73111,73113,0,2,4
20859,1,2,73112,73113,73115,1,3,0
20860,2,3,73114,73115,73118,1,4,0
20861,1,2,73115,73118,73120,3,5,0
20862,2,2,73117,73120,73122,3,5,0
20863,2,1,73119,73122,73123,3,4,0
20864,5,1,73124,73124,73125,0,1,1
20865,2,1,73126,73126,73127,0,1,1
20866,3,1,73129,73129,73130,0,1,2
20867,3,1,73132,73132,73133,0,1,2
20868,2,2,73134,73134,73136,0,2,1
20869,3,3,73137,73137,73140,0,3,1
20870,2,2,73139,73140,73142,1,3,0
20871,2,2,73141,73142,73144,1,3,0
20872,6,2,73147,73147,73149,0,2,3
20873,4,2,73151,73151,73153,0,2,2
20874,6,1,73157,73157,73158,0,1,4
20875,5,3,73162,73162,73165,0,3,4
20876,3,2,73165,73165,73167,0,2,0
20877,5,3,73170,73170,73173,0,3,3
20878,2,3,73172,73173,73176,1,4,0
20879,5,1,73177,73177,73178,0,1,1
20880,4,2,73181,73181,73183,0,2,3
20881,1,3,73182,73183,73186,1,4,0
20882,2,3,73184,73186,73189,2,5,0
20883,1,3,73185,73189,73192,4,7,0
20884,4,3,73189,73192,73195,3,6,0
20885,3,1,73192,73195,73196,3,4,0
20886,1,3,73193,73196,73199,3,6,0
20887,5,2,73198,73199,73201,1,3,0
20888,4,3,73202,73202,73205,0,3,1
20889,1,3,73203,73205,73208,2,5,0
20890,2,1,73205,73208,73209,3,4,0
20891,3,1,73208,73209,73210,1,2,0
20892,4,3,73212,73212,73215,0,3,2
20893,2,1,73214,73215,73216,1,2,0
20894,6,3,73220,73220,73223,0,3,4
20895,2,1,73222,73223,73224,1,2,0
20896,1,1,73223,73224,73225,1,2,0
20897,5,3,73228,73228,73231,0,3,3
20898,2,1,73230,73231,73232,1,2,0
20899,3,2,73233,73233,73235,0,2,1
20900,5,1,73238,73238,73239,0,1,3
20901,3,1,73241,73241,73242,0,1,2
20902,4,1,73245,73245,73246,0,1,3
20903,4,1,73249,73249,73250,0,1,3
20904,5,1,73254,73254,73255,0,1,4
20905,4,3,73258,73258,73261,0,3,3
20906,4,3,73262,73262,73265,0,3,1
20907,3,3,73265,73265,73268,0,3,0
20908,4,2,73269,73269,73271,0,2,1
20909,1,1,73270,73271,73272,1,2,0
20910,2,1,73272,73272,73273,0,1,0
20911,5,1,73277,73277,73278,0,1,4
20912,2,1,73279,73279,73280,0,1,1
20913,6,2,73285,73285,73287,0,2,5
20914,5,3,73290,73290,73293,0,3,3
20915,5,3,73295,73295,73298,0,3,2
20916,2,2,73297,73298,73300,1,3,0
20917,2,1,73299,73300,73301,1,2,0
20918,3,3,73302,73302,73305,0,3,1
20919,6,2,73308,73308,73310,0,2,3
20920,3,3,73311,73311,73314,0,3,1
20921,5,1,73316,73316,73317,0,1,2
20922,6,3,73322,73322,73325,0,3,5
20923,2,2,73324,73325,73327,1,3,0
20924,2,2,73326,73327,73329,1,3,0
20925,5,1,73331,73331,73332,0,1,2
20926,1,1,73332,73332,73333,0,1,0
20927,5,1,73337,73337,73338,0,1,4
20928,3,2,73340,73340,73342,0,2,2
20929,2,3,73342,73342,73345,0,3,0
20930,5,3,73347,73347,73350,0,3,2
20931,5,2,73352,73352,73354,0,2,2
20932,5,2,73357,73357,73359,0,2,3
20933,2,3,73359,73359,73362,0,3,0
20934,4,2,73363,73363,73365,0,2,1
20935,4,3,73367,73367,73370,0,3,2
20936,4,3,73371,73371,73374,0,3,1
20937,3,2,73374,73374,73376,0,2,0
20938,1,1,73375,73376,73377,1,2,0
20939,5,1,73380,73380,73381,0,1,3
20940,1,1,73381,73381,73382,0,1,0
20941,2,2,73383,73383,73385,0,2,1
20942,2,2,73385,73385,73387,0,2,0
20943,4,2,73389,73389,73391,0,2,2
20944,1,3,73390,73391,73394,1,4,0
20945,2,2,73392,73394,73396,2,4,0
20946,2,3,73394,73396,73399,2,5,0
20947,2,1,73396,73399,73400,3,4,0
20948,4,2,73400,73400,73402,0,2,0
20949,5,2,73405,73405,73407,0,2,3
20950,3,2,73408,73408,73410,0,2,1
20951,5,1,73413,73413,73414,0,1,3
20952,3,1,73416,73416,73417,0,1,2
20953,2,2,73418,73418,73420,0,2,1
20954,3,3,73421,73421,73424,0,3,1
20955,4,1,73425,73425,73426,0,1,1
20956,2,3,73427,73427,73430,0,3,1
20957,2,3,73429,73430,73433,1,4,0
20958,4,1,73433,73433,73434,0,1,0
20959,4,1,73437,73437,73438,0,1,3
20960,6,1,73443,73443,73444,0,1,5
20961,5,2,73448,73448,73450,0,2,4
20962,4,1,73452,73452,73453,0,1,2
20963,2,2,73454,73454,73456,0,2,1
20964,4,3,73458,73458,73461,0,3,2
20965,4,2,73462,73462,73464,0,2,1
20966,1,3,73463,73464,73467,1,4,0
20967,6,1,73469,73469,73470,0,1,2
20968,1,3,73470,73470,73473,0,3,0
20969,1,1,73471,73473,73474,2,3,0
20970,1,1,73472,73474,73475,2,3,0
20971,3,1,73475,73475,73476,0,1,0
20972,1,2,73476,73476,73478,0,2,0
20973,2,1,73478,73478,73479,0,1,0
20974,4,1,73482,73482,73483,0,1,3
20975,5,1,73487,73487,73488,0,1,4
20976,5,3,73492,73492,73495,0,3,4
20977,6,2,73498,73498,73500,0,2,3
20978,4,3,73502,73502,73505,0,3,2
20979,3,1,73505,73505,73506,0,1,0
20980,1,1,73506,73506,73507,0,1,0
20981,1,3,73507,73507,73510,0,3,0
20982,5,2,73512,73512,73514,0,2,2
20983,4,3,73516,73516,73519,0,3,2
20984,1,1,73517,73519,73520,2,3,0
20985,4,3,73521,73521,73524,0,3,1
20986,3,2,73524,73524,73526,0,2,0
20987,1,2,73525,73526,73528,1,3,0
20988,3,3,73528,73528,73531,0,3,0
20989,6,1,73534,73534,73535,0,1,3
20990,4,2,73538,73538,73540,0,2,3
20991,5,3,73543,73543,73546,0,3,3
20992,4,1,73547,73547,73548,0,1,1
20993,2,1,73549,73549,73550,0,1,1
20994,1,3,73550,73550,73553,0,3,0
20995,3,3,73553,73553,73556,0,3,0
20996,4,1,73557,73557,73558,0,1,1
20997,6,2,73563,73563,73565,0,2,5
20998,4,1,73567,73567,73568,0,1,2
20999,6,3,73573,73573,73576,0,3,5
21000,5,2,73578,73578,73580,0,2,2
21001,3,2,73581,73581,73583,0,2,1
21002,6,1,73587,73587,73588,0,1,4
21003,4,2,73591,73591,73593,0,2,3
21004,2,1,73593,73593,73594,0,1,0
21005,3,2,73596,73596,73598,0,2,2
21006,2,3,73598,73598,73601,0,3,0
21007,1,1,73599,73601,73602,2,3,0
21008,5,3,73604,73604,73607,0,3,2
21009,4,1,73608,73608,73609,0,1,1
21010,1,1,73609,73609,73610,0,1,0
21011,4,2,73613,73613,73615,0,2,3
21012,5,2,73618,73618,73620,0,2,3
21013,2,3,73620,73620,73623,0,3,0
21014,6,3,73626,73626,73629,0,3,3
21015,1,3,73627,73629,73632,2,5,0
21016,2,2,73629,73632,73634,3,5,0
21017,5,2,73634,73634,73636,0,2,0
21018,6,2,73640,73640,73642,0,2,4
21019,4,3,73644,73644,73647,0,3,2
21020,3,3,73647,73647,73650,0,3,0
21021,2,3,73649,73650,73653,1,4,0
21022,6,3,73655,73655,73658,0,3,2
21023,2,1,73657,73658,73659,1,2,0
21024,2,1,73659,73659,73660,0,1,0
21025,2,3,73661,73661,73664,0,3,1
21026,1,2,73662,73664,73666,2,4,0
21027,2,2,73664,73666,73668,2,4,0
21028,3,2,73667,73668,73670,1,3,0
21029,3,2,73670,73670,73672,0,2,0
21030,1,3,73671,73672,73675,1,4,0
21031,3,2,73674,73675,73677,1,3,0
21032,2,2,73676,73677,73679,1,3,0
21033,1,1,73677,73679,73680,2,3,0
21034,1,2,73678,73680,73682,2,4,0
21035,1,2,73679,73682,73684,3,5,0
21036,1,2,73680,73684,73686,4,6,0
21037,6,2,73686,73686,73688,0,2,0
21038,4,3,73690,73690,73693,0,3,2
21039,1,1,73691,73693,73694,2,3,0
21040,4,2,73695,73695,73697,0,2,1
21041,5,2,73700,73700,73702,0,2,3
21042,4,1,73704,73704,73705,0,1,2
21043,3,1,73707,73707,73708,0,1,2
21044,2,1,73709,73709,73710,0,1,1
21045,2,2,73711,73711,73713,0,2,1
21046,5,2,73716,73716,73718,0,2,3
21047,5,2,73721,73721,73723,0,2,3
21048,1,3,73722,73723,73726,1,4,0
21049,5,3,73727,73727,73730,0,3,1
21050,2,1,73729,73730,73731,1,2,0
21051,4,2,73733,73733,73735,0,2,2
21052,3,2,73736,73736,73738,0,2,1
21053,4,2,73740,73740,73742,0,2,2
21054,6,2,73746,73746,73748,0,2,4
21055,2,2,73748,73748,73750,0,2,0
21056,3,2,73751,73751,73753,0,2,1
21057,2,3,73753,73753,73756,0,3,0
21058,1,3,73754,73756,73759,2,5,0
21059,5,3,73759,73759,73762,0,3,0
21060,1,1,73760,73762,73763,2,3,0
21061,4,2,73764,73764,73766,0,2,1
21062,3,1,73767,73767,73768,0,1,1
21063,6,3,73773,73773,73776,0,3,5
21064,5,2,73778,73778,73780,0,2,2
21065,6,1,73784,73784,73785,0,1,4
21066,5,1,73789,73789,73790,0,1,4
21067,1,2,73790,73790,73792,0,2,0
21068,2,3,73792,73792,73795,0,3,0
21069,1,1,73793,73795,73796,2,3,0
21070,4,3,73797,73797,73800,0,3,1
21071,5,1,73802,73802,73803,0,1,2
21072,5,2,73807,73807,73809,0,2,4
21073,1,1,73808,73809,73810,1,2,0
21074,3,2,73811,73811,73813,0,2,1
21075,4,1,73815,73815,73816,0,1,2
21076,2,3,73817,73817,73820,0,3,1
21077,2,2,73819,73820,73822,1,3,0
21078,1,2,73820,73822,73824,2,4,0
21079,1,2,73821,73824,73826,3,5,0
21080,6,2,73827,73827,73829,0,2,1
21081,4,1,73831,73831,73832,0,1,2
21082,3,3,73834,73834,73837,0,3,2
21083,2,1,73836,73837,73838,1,2,0
21084,2,3,73838,73838,73841,0,3,0
21085,1,1,73839,73841,73842,2,3,0
21086,5,2,73844,73844,73846,0,2,2
21087,2,1,73846,73846,73847,0,1,0
21088,1,2,73847,73847,73849,0,2,0
21089,5,2,73852,73852,73854,0,2,3
21090,6,1,73858,73858,73859,0,1,4
21091,1,2,73859,73859,73861,0,2,0
21092,4,3,73863,73863,73866,0,3,2
21093,6,2,73869,73869,73871,0,2,3
21094,2,2,73871,73871,73873,0,2,0
21095,6,1,73877,73877,73878,0,1,4
21096,4,2,73881,73881,73883,0,2,3
21097,3,3,73884,73884,73887,0,3,1
21098,5,1,73889,73889,73890,0,1,2
21099,6,3,73895,73895,73898,0,3,5
21100,3,1,73898,73898,73899,0,1,0
21101,5,2,73903,73903,73905,0,2,4
21102,5,3,73908,73908,73911,0,3,3
21103,6,1,73914,73914,73915,0,1,3
21104,4,3,73918,73918,73921,0,3,3
21105,5,3,73923,73923,73926,0,3,2
21106,3,2,73926,73926,73928,0,2,0
21107,1,3,73927,73928,73931,1,4,0
21108,3,3,73930,73931,73934,1,4,0
21109,6,2,73936,73936,73938,0,2,2
21110,4,2,73940,73940,73942,0,2,2
21111,6,3,73946,73946,73949,0,3,4
21112,3,2,73949,73949,73951,0,2,0
21113,6,3,73955,73955,73958,0,3,4
21114,6,3,73961,73961,73964,0,3,3
21115,3,2,73964,73964,73966,0,2,0
21116,2,1,73966,73966,73967,0,1,0
21117,1,3,73967,73967,73970,0,3,0
21118,4,1,73971,73971,73972,0,1,1
21119,1,3,73972,73972,73975,0,3,0
21120,4,3,73976,73976,73979,0,3,1
21121,6,2,73982,73982,73984,0,2,3
21122,1,3,73983,73984,73987,1,4,0
21123,4,1,73987,73987,73988,0,1,0
21124,2,2,73989,73989,73991,0,2,1
21125,4,2,73993,73993,73995,0,2,2
21126,1,3,73994,73995,73998,1,4,0
21127,2,1,73996,73998,73999,2,3,0
21128,1,3,73997,73999,74002,2,5,0
21129,3,1,74000,74002,74003,2,3,0
21130,4,1,74004,74004,74005,0,1,1
21131,4,2,74008,74008,74010,0,2,3
21132,4,3,74012,74012,74015,0,3,2
21133,1,2,74013,74015,74017,2,4,0
21134,2,2,74015,74017,74019,2,4,0
21135,1,2,74016,74019,74021,3,5,0
21136,2,2,74018,74021,74023,3,5,0
21137,6,3,74024,74024,74027,0,3,1
21138,3,1,74027,74027,74028,0,1,0
21139,4,3,74031,74031,74034,0,3,3
21140,6,1,74037,74037,74038,0,1,3
21141,1,2,74038,74038,74040,0,2,0
21142,6,2,74044,74044,74046,0,2,4
21143,5,2,74049,74049,74051,0,2,3
21144,4,2,74053,74053,74055,0,2,2
21145,3,2,74056,74056,74058,0,2,1
21146,4,3,74060,74060,74063,0,3,2
21147,4,3,74064,74064,74067,0,3,1
21148,4,1,74068,74068,74069,0,1,1
21149,4,2,74072,74072,74074,0,2,3
21150,2,1,74074,74074,74075,0,1,0
21151,5,3,74079,74079,74082,0,3,4
21152,4,1,74083,74083,74084,0,1,1
21153,1,1,74084,74084,74085,0,1,0
21154,2,3,74086,74086,74089,0,3,1
21155,1,2,74087,74089,74091,2,4,0
21156,2,3,74089,74091,74094,2,5,0
21157,1,1,74090,74094,74095,4,5,0
21158,4,2,74094,74095,74097,1,3,0
21159,4,1,74098,74098,74099,0,1,1
21160,3,2,74101,74101,74103,0,2,2
21161,3,1,74104,74104,74105,0,1,1
21162,3,3,74107,74107,74110,0,3,2
21163,2,1,74109,74110,74111,1,2,0
21164,3,1,74112,74112,74113,0,1,1
21165,2,1,74114,74114,74115,0,1,1
21166,1,1,74115,74115,74116,0,1,0
21167,5,2,74120,74120,74122,0,2,4
21168,4,1,74124,74124,74125,0,1,2
21169,4,2,74128,74128,74130,0,2,3
21170,2,3,74130,74130,74133,0,3,0
21171,5,2,74135,74135,74137,0,2,2
21172,3,1,74138,74138,74139,0,1,1
21173,3,3,74141,74141,74144,0,3,2
21174,1,1,74142,74144,74145,2,3,0
21175,1,2,74143,74145,74147,2,4,0
21176,1,3,74144,74147,74150,3,6,0
21177,5,2,74149,74150,74152,1,3,0
21178,4,3,74153,74153,74156,0,3,1
21179,4,2,74157,74157,74159,0,2,1
21180,6,1,74163,74163,74164,0,1,4
21181,6,3,74169,74169,74172,0,3,5
21182,4,1,74173,74173,74174,0,1,1
21183,3,1,74176,74176,74177,0,1,2
21184,3,3,74179,74179,74182,0,3,2
21185,1,1,74180,74182,74183,2,3,0
21186,2,2,74182,74183,74185,1,3,0
21187,3,2,74185,74185,74187,0,2,0
21188,5,1,74190,74190,74191,0,1,3
21189,2,1,74192,74192,74193,0,1,1
21190,3,1,74195,74195,74196,0,1,2
21191,4,3,74199,74199,74202,0,3,3
21192,4,2,74203,74203,74205,0,2,1
21193,5,1,74208,74208,74209,0,1,3
21194,3,2,74211,74211,74213,0,2,2
21195,6,2,74217,74217,74219,0,2,4
21196,1,2,74218,74219,74221,1,3,0
21197,6,2,74224,74224,74226,0,2,3
21198,6,1,74230,74230,74231,0,1,4
21199,5,3,74235,74235,74238,0,3,4
21200,2,3,74237,74238,74241,1,4,0
21201,4,1,74241,74241,74242,0,1,0
21202,6,3,74247,74247,74250,0,3,5
21203,4,2,74251,74251,74253,0,2,1
21204,3,1,74254,74254,74255,0,1,1
21205,3,2,74257,74257,74259,0,2,2
21206,1,3,74258,74259,74262,1,4,0
21207,4,3,74262,74262,74265,0,3,0
21208,6,1,74268,74268,74269,0,1,3
21209,2,3,74270,74270,74273,0,3,1
21210,5,2,74275,74275,74277,0,2,2
21211,3,1,74278,74278,74279,0,1,1
21212,4,3,74282,74282,74285,0,3,3
21213,4,2,74286,74286,74288,0,2,1
21214,2,3,74288,74288,74291,0,3,0
21215,2,1,74290,74291,74292,1,2,0
21216,5,2,74295,74295,74297,0,2,3
21217,4,3,74299,74299,74302,0,3,2
21218,6,3,74305,74305,74308,0,3,3
21219,3,3,74308,74308,74311,0,3,0
21220,3,2,74311,74311,74313,0,2,0
21221,5,1,74316,74316,74317,0,1,3
21222,3,1,74319,74319,74320,0,1,2
21223,5,2,74324,74324,74326,0,2,4
21224,1,2,74325,74326,74328,1,3,0
21225,5,3,74330,74330,74333,0,3,2
21226,4,1,74334,74334,74335,0,1,1
21227,5,1,74339,74339,74340,0,1,4
21228,6,3,74345,74345,74348,0,3,5
21229,3,1,74348,74348,74349,0,1,0
21230,5,3,74353,74353,74356,0,3,4
21231,1,3,74354,74356,74359,2,5,0
21232,1,2,74355,74359,74361,4,6,0
21233,5,1,74360,74361,74362,1,2,0
21234,1,2,74361,74362,74364,1,3,0
21235,6,2,74367,74367,74369,0,2,3
21236,1,3,74368,74369,74372,1,4,0
21237,4,1,74372,74372,74373,0,1,0
21238,2,3,74374,74374,74377,0,3,1
21239,1,3,74375,74377,74380,2,5,0
21240,5,3,74380,74380,74383,0,3,0
21241,6,3,74386,74386,74389,0,3,3
21242,6,2,74392,74392,74394,0,2,3
21243,6,1,74398,74398,74399,0,1,4
21244,1,3,74399,74399,74402,0,3,0
21245,2,2,74401,74402,74404,1,3,0
21246,6,2,74407,74407,74409,0,2,3
21247,3,2,74410,74410,74412,0,2,1
21248,2,3,74412,74412,74415,0,3,0
21249,2,3,74414,74415,74418,1,4,0
21250,6,1,74420,74420,74421,0,1,2
21251,1,3,74421,74421,74424,0,3,0
21252,3,2,74424,74424,74426,0,2,0
21253,5,3,74429,74429,74432,0,3,3
21254,6,1,74435,74435,74436,0,1,3
21255,6,3,74441,74441,74444,0,3,5
21256,6,2,74447,74447,74449,0,2,3
21257,2,3,74449,74449,74452,0,3,0
21258,5,2,74454,74454,74456,0,2,2
21259,3,1,74457,74457,74458,0,1,1
21260,1,3,74458,74458,74461,0,3,0
21261,4,2,74462,74462,74464,0,2,1
21262,1,1,74463,74464,74465,1,2,0
21263,3,1,74466,74466,74467,0,1,1
21264,1,1,74467,74467,74468,0,1,0
21265,1,2,74468,74468,74470,0,2,0
21266,6,2,74474,74474,74476,0,2,4
21267,3,1,74477,74477,74478,0,1,1
21268,3,3,74480,74480,74483,0,3,2
21269,5,3,74485,74485,74488,0,3,2
21270,3,2,74488,74488,74490,0,2,0
21271,3,3,74491,74491,74494,0,3,1
21272,2,1,74493,74494,74495,1,2,0
21273,2,2,74495,74495,74497,0,2,0
21274,6,2,74501,74501,74503,0,2,4
21275,2,3,74503,74503,74506,0,3,0
21276,4,3,74507,74507,74510,0,3,1
21277,3,2,74510,74510,74512,0,2,0
21278,4,1,74514,74514,74515,0,1,2
21279,5,3,74519,74519,74522,0,3,4
21280,5,3,74524,74524,74527,0,3,2
21281,1,3,74525,74527,74530,2,5,0
21282,3,3,74528,74530,74533,2,5,0
21283,6,1,74534,74534,74535,0,1,1
21284,2,3,74536,74536,74539,0,3,1
21285,6,1,74542,74542,74543,0,1,3
21286,5,2,74547,74547,74549,0,2,4
21287,1,1,74548,74549,74550,1,2,0
21288,2,2,74550,74550,74552,0,2,0
21289,2,1,74552,74552,74553,0,1,0
21290,1,3,74553,74553,74556,0,3,0
21291,5,3,74558,74558,74561,0,3,2
21292,3,3,74561,74561,74564,0,3,0
21293,5,3,74566,74566,74569,0,3,2
21294,4,1,74570,74570,74571,0,1,1
21295,4,2,74574,74574,74576,0,2,3
21296,5,2,74579,74579,74581,0,2,3
21297,5,1,74584,74584,74585,0,1,3
21298,3,3,74587,74587,74590,0,3,2
21299,4,3,74591,74591,74594,0,3,1
21300,4,2,74595,74595,74597,0,2,1
21301,3,3,74598,74598,74601,0,3,1
21302,1,2,74599,74601,74603,2,4,0
21303,2,3,74601,74603,74606,2,5,0
21304,2,3,74603,74606,74609,3,6,0
21305,6,1,74609,74609,74610,0,1,0
21306,2,1,74611,74611,74612,0,1,1
21307,4,3,74615,74615,74618,0,3,3
21308,2,2,74617,74618,74620,1,3,0
21309,1,3,74618,74620,74623,2,5,0
21310,6,3,74624,74624,74627,0,3,1
21311,3,1,74627,74627,74628,0,1,0
21312,4,3,74631,74631,74634,0,3,3
21313,2,1,74633,74634,74635,1,2,0
21314,2,3,74635,74635,74638,0,3,0
21315,2,2,74637,74638,74640,1,3,0
21316,5,2,74642,74642,74644,0,2,2
21317,3,1,74645,74645,74646,0,1,1
21318,3,1,74648,74648,74649,0,1,2
21319,4,2,74652,74652,74654,0,2,3
21320,2,1,74654,74654,74655,0,1,0
21321,6,2,74660,74660,74662,0,2,5
21322,4,1,74664,74664,74665,0,1,2
21323,1,3,74665,74665,74668,0,3,0
21324,6,2,74671,74671,74673,0,2,3
21325,6,3,74677,74677,74680,0,3,4
21326,2,3,74679,74680,74683,1,4,0
21327,4,2,74683,74683,74685,0,2,0
21328,2,1,74685,74685,74686,0,1,0
21329,5,2,74690,74690,74692,0,2,4
21330,3,1,74693,74693,74694,0,1,1
21331,6,1,74699,74699,74700,0,1,5
21332,4,3,74703,74703,74706,0,3,3
21333,4,2,74707,74707,74709,0,2,1
21334,1,1,74708,74709,74710,1,2,0
21335,6,1,74714,74714,74715,0,1,4
21336,2,2,74716,74716,74718,0,2,1
21337,4,1,74720,74720,74721,0,1,2
21338,5,3,74725,74725,74728,0,3,4
21339,4,3,74729,74729,74732,0,3,1
21340,1,3,74730,74732,74735,2,5,0
21341,1,1,74731,74735,74736,4,5,0
21342,4,1,74735,74736,74737,1,2,0
21343,4,1,74739,74739,74740,0,1,2
21344,4,3,74743,74743,74746,0,3,3
21345,6,3,74749,74749,74752,0,3,3
21346,5,2,74754,74754,74756,0,2,2
21347,6,1,74760,74760,74761,0,1,4
21348,6,3,74766,74766,74769,0,3,5
21349,2,1,74768,74769,74770,1,2,0
21350,6,1,74774,74774,74775,0,1,4
21351,1,2,74775,74775,74777,0,2,0
21352,5,1,74780,74780,74781,0,1,3
21353,5,1,74785,74785,74786,0,1,4
21354,1,2,74786,74786,74788,0,2,0
21355,3,2,74789,74789,74791,0,2,1
21356,2,3,74791,74791,74794,0,3,0
21357,6,3,74797,74797,74800,0,3,3
21358,6,1,74803,74803,74804,0,1,3
21359,6,3,74809,74809,74812,0,3,5
21360,3,2,74812,74812,74814,0,2,0
21361,1,3,74813,74814,74817,1,4,0
21362,6,1,74819,74819,74820,0,1,2
21363,1,3,74820,74820,74823,0,3,0
21364,6,1,74826,74826,74827,0,1,3
21365,5,1,74831,74831,74832,0,1,4
21366,1,2,74832,74832,74834,0,2,0
21367,5,3,74837,74837,74840,0,3,3
21368,6,1,74843,74843,74844,0,1,3
21369,3,3,74846,74846,74849,0,3,2
21370,2,3,74848,74849,74852,1,4,0
21371,1,3,74849,74852,74855,3,6,0
21372,3,1,74852,74855,74856,3,4,0
21373,6,2,74858,74858,74860,0,2,2
21374,2,1,74860,74860,74861,0,1,0
21375,3,3,74863,74863,74866,0,3,2
21376,6,3,74869,74869,74872,0,3,3
21377,5,2,74874,74874,74876,0,2,2
21378,5,2,74879,74879,74881,0,2,3
21379,2,1,74881,74881,74882,0,1,0
21380,4,2,74885,74885,74887,0,2,3
21381,6,1,74891,74891,74892,0,1,4
21382,5,2,74896,74896,74898,0,2,4
21383,4,2,74900,74900,74902,0,2,2
21384,2,3,74902,74902,74905,0,3,0
21385,3,3,74905,74905,74908,0,3,0
21386,6,3,74911,74911,74914,0,3,3
21387,3,2,74914,74914,74916,0,2,0
21388,2,1,74916,74916,74917,0,1,0
21389,1,2,74917,74917,74919,0,2,0
21390,6,1,74923,74923,74924,0,1,4
21391,4,3,74927,74927,74930,0,3,3
21392,1,3,74928,74930,74933,2,5,0
21393,1,3,74929,74933,74936,4,7,0
21394,4,2,74933,74936,74938,3,5,0
21395,1,1,74934,74938,74939,4,5,0
21396,5,1,74939,74939,74940,0,1,0
21397,5,3,74944,74944,74947,0,3,4
21398,6,3,74950,74950,74953,0,3,3
21399,2,3,74952,74953,74956,1,4,0
21400,1,2,74953,74956,74958,3,5,0
21401,3,2,74956,74958,74960,2,4,0
21402,4,3,74960,74960,74963,0,3,0
21403,5,2,74965,74965,74967,0,2,2
21404,3,3,74968,74968,74971,0,3,1
21405,2,2,74970,74971,74973,1,3,0
21406,6,3,74976,74976,74979,0,3,3
21407,4,1,74980,74980,74981,0,1,1
21408,4,2,74984,74984,74986,0,2,3
21409,5,3,74989,74989,74992,0,3,3
21410,3,1,74992,74992,74993,0,1,0
21411,6,1,74998,74998,74999,0,1,5
21412,5,3,75003,75003,75006,0,3,4
21413,3,3,75006,75006,75009,0,3,0
21414,3,1,75009,75009,75010,0,1,0
21415,4,3,75013,75013,75016,0,3,3
21416,3,1,75016,75016,75017,0,1,0
21417,6,1,75022,75022,75023,0,1,5
21418,3,2,75025,75025,75027,0,2,2
21419,1,1,75026,75027,75028,1,2,0
21420,2,3,75028,75028,75031,0,3,0
21421,5,1,75033,75033,75034,0,1,2
21422,6,1,75039,75039,75040,0,1,5
21423,4,2,75043,75043,75045,0,2,3
21424,2,2,75045,75045,75047,0,2,0
21425,6,2,75051,75051,75053,0,2,4
21426,3,1,75054,75054,75055,0,1,1
21427,1,2,75055,75055,75057,0,2,0
21428,1,2,75056,75057,75059,1,3,0
21429,2,1,75058,75059,75060,1,2,0
21430,5,1,75063,75063,75064,0,1,3
21431,3,3,75066,75066,75069,0,3,2
21432,6,1,75072,75072,75073,0,1,3
21433,2,1,75074,75074,75075,0,1,1
21434,6,3,75080,75080,75083,0,3,5
21435,5,2,75085,75085,75087,0,2,2
21436,5,1,75090,75090,75091,0,1,3
21437,4,2,75094,75094,75096,0,2,3
21438,6,1,75100,75100,75101,0,1,4
21439,5,1,75105,75105,75106,0,1,4
21440,1,1,75106,75106,75107,0,1,0
21441,3,2,75109,75109,75111,0,2,2
21442,5,2,75114,75114,75116,0,2,3
21443,3,3,75117,75117,75120,0,3,1
21444,3,1,75120,75120,75121,0,1,0
21445,3,2,75123,75123,75125,0,2,2
21446,3,1,75126,75126,75127,0,1,1
21447,4,3,75130,75130,75133,0,3,3
21448,4,2,75134,75134,75136,0,2,1
21449,4,3,75138,75138,75141,0,3,2
21450,5,1,75143,75143,75144,0,1,2
21451,6,3,75149,75149,75152,0,3,5
21452,1,3,75150,75152,75155,2,5,0
21453,6,3,75156,75156,75159,0,3,1
21454,6,3,75162,75162,75165,0,3,3
21455,5,2,75167,75167,75169,0,2,2
21456,5,1,75172,75172,75173,0,1,3
21457,1,2,75173,75173,75175,0,2,0
21458,6,1,75179,75179,75180,0,1,4
21459,1,1,75180,75180,75181,0,1,0
21460,5,1,75185,75185,75186,0,1,4
21461,6,2,75191,75191,75193,0,2,5
21462,5,2,75196,75196,75198,0,2,3
21463,1,2,75197,75198,75200,1,3,0
21464,3,2,75200,75200,75202,0,2,0
21465,3,1,75203,75203,75204,0,1,1
21466,5,2,75208,75208,75210,0,2,4
21467,5,3,75213,75213,75216,0,3,3
21468,5,2,75218,75218,75220,0,2,2
21469,3,1,75221,75221,75222,0,1,1
21470,6,1,75227,75227,75228,0,1,5
21471,6,2,75233,75233,75235,0,2,5
21472,4,2,75237,75237,75239,0,2,2
21473,5,1,75242,75242,75243,0,1,3
21474,5,3,75247,75247,75250,0,3,4
21475,2,2,75249,75250,75252,1,3,0
21476,5,1,75254,75254,75255,0,1,2
21477,4,3,75258,75258,75261,0,3,3
21478,3,1,75261,75261,75262,0,1,0
21479,1,3,75262,75262,75265,0,3,0
21480,3,3,75265,75265,75268,0,3,0
21481,3,3,75268,75268,75271,0,3,0
21482,5,1,75273,75273,75274,0,1,2
21483,6,2,75279,75279,75281,0,2,5
21484,3,2,75282,75282,75284,0,2,1
21485,6,1,75288,75288,75289,0,1,4
21486,1,2,75289,75289,75291,0,2,0
21487,5,2,75294,75294,75296,0,2,3
21488,3,3,75297,75297,75300,0,3,1
21489,3,3,75300,75300,75303,0,3,0
21490,2,3,75302,75303,75306,1,4,0
21491,4,3,75306,75306,75309,0,3,0
21492,3,3,75309,75309,75312,0,3,0
21493,3,1,75312,75312,75313,0,1,0
21494,5,2,75317,75317,75319,0,2,4
21495,2,1,75319,75319,75320,0,1,0
21496,1,3,75320,75320,75323,0,3,0
21497,6,1,75326,75326,75327,0,1,3
21498,2,1,75328,75328,75329,0,1,1
21499,3,1,75331,75331,75332,0,1,2
21500,3,3,75334,75334,75337,0,3,2
21501,6,1,75340,75340,75341,0,1,3
21502,1,3,75341,75341,75344,0,3,0
21503,4,1,75345,75345,75346,0,1,1
21504,1,2,75346,75346,75348,0,2,0
21505,3,1,75349,75349,75350,0,1,1
21506,1,1,75350,75350,75351,0,1,0
21507,4,2,75354,75354,75356,0,2,3
21508,1,2,75355,75356,75358,1,3,0
21509,5,1,75360,75360,75361,0,1,2
21510,5,2,75365,75365,75367,0,2,4
21511,4,3,75369,75369,75372,0,3,2
21512,2,3,75371,75372,75375,1,4,0
21513,3,2,75374,75375,75377,1,3,0
21514,3,1,75377,75377,75378,0,1,0
21515,3,3,75380,75380,75383,0,3,2
21516,5,1,75385,75385,75386,0,1,2
21517,6,2,75391,75391,75393,0,2,5
21518,2,3,75393,75393,75396,0,3,0
21519,2,3,75395,75396,75399,1,4,0
21520,5,1,75400,75400,75401,0,1,1
21521,4,2,75404,75404,75406,0,2,3
21522,6,1,75410,75410,75411,0,1,4
21523,3,2,75413,75413,75415,0,2,2
21524,6,1,75419,75419,75420,0,1,4
21525,6,2,75425,75425,75427,0,2,5
21526,4,1,75429,75429,75430,0,1,2
21527,5,2,75434,75434,75436,0,2,4
21528,4,3,75438,75438,75441,0,3,2
21529,3,2,75441,75441,75443,0,2,0
21530,4,1,75445,75445,75446,0,1,2
21531,3,1,75448,75448,75449,0,1,2
21532,2,2,75450,75450,75452,0,2,1
21533,2,3,75452,75452,75455,0,3,0
21534,3,1,75455,75455,75456,0,1,0
21535,1,3,75456,75456,75459,0,3,0
21536,6,1,75462,75462,75463,0,1,3
21537,5,2,75467,75467,75469,0,2,4
21538,2,2,75469,75469,75471,0,2,0
21539,1,2,75470,75471,75473,1,3,0
21540,4,2,75474,75474,75476,0,2,1
21541,6,2,75480,75480,75482,0,2,4
21542,5,3,75485,75485,75488,0,3,3
21543,5,1,75490,75490,75491,0,1,2
21544,1,1,75491,75491,75492,0,1,0
21545,4,2,75495,75495,75497,0,2,3
21546,2,1,75497,75497,75498,0,1,0
21547,3,3,75500,75500,75503,0,3,2
21548,6,1,75506,75506,75507,0,1,3
21549,6,2,75512,75512,75514,0,2,5
21550,4,1,75516,75516,75517,0,1,2
21551,3,1,75519,75519,75520,0,1,2
21552,6,3,75525,75525,75528,0,3,5
21553,3,1,75528,75528,75529,0,1,0
21554,3,3,75531,75531,75534,0,3,2
21555,4,1,75535,75535,75536,0,1,1
21556,5,1,75540,75540,75541,0,1,4
21557,3,3,75543,75543,75546,0,3,2
21558,5,1,75548,75548,75549,0,1,2
21559,5,1,75553,75553,75554,0,1,4
21560,4,3,75557,75557,75560,0,3,3
21561,6,3,75563,75563,75566,0,3,3
21562,2,3,75565,75566,75569,1,4,0
21563,1,2,75566,75569,75571,3,5,0
21564,5,2,75571,75571,75573,0,2,0
21565,5,1,75576,75576,75577,0,1,3
21566,1,3,75577,75577,75580,0,3,0
21567,6,1,75583,75583,75584,0,1,3
21568,2,1,75585,75585,75586,0,1,1
21569,1,2,75586,75586,75588,0,2,0
21570,6,3,75592,75592,75595,0,3,4
21571,3,3,75595,75595,75598,0,3,0
21572,1,1,75596,75598,75599,2,3,0
21573,6,1,75602,75602,75603,0,1,3
21574,6,2,75608,75608,75610,0,2,5
21575,3,3,75611,75611,75614,0,3,1
21576,5,2,75616,75616,75618,0,2,2
21577,5,3,75621,75621,75624,0,3,3
21578,5,1,75626,75626,75627,0,1,2
21579,2,2,75628,75628,75630,0,2,1
21580,4,2,75632,75632,75634,0,2,2
21581,4,2,75636,75636,75638,0,2,2
21582,4,2,75640,75640,75642,0,2,2
21583,4,3,75644,75644,75647,0,3,2
21584,5,3,75649,75649,75652,0,3,2
21585,5,3,75654,75654,75657,0,3,2
21586,4,2,75658,75658,75660,0,2,1
21587,1,3,75659,75660,75663,1,4,0
21588,2,3,75661,75663,75666,2,5,0
21589,1,2,75662,75666,75668,4,6,0
21590,6,3,75668,75668,75671,0,3,0
21591,4,2,75672,75672,75674,0,2,1
21592,4,3,75676,75676,75679,0,3,2
21593,5,1,75681,75681,75682,0,1,2
21594,6,2,75687,75687,75689,0,2,5
21595,6,2,75693,75693,75695,0,2,4
21596,5,2,75698,75698,75700,0,2,3
21597,1,1,75699,75700,75701,1,2,0
21598,1,3,75700,75701,75704,1,4,0
21599,6,2,75706,75706,75708,0,2,2
21600,1,2,75707,75708,75710,1,3,0
21601,1,1,75708,75710,75711,2,3,0
21602,3,2,75711,75711,75713,0,2,0
21603,3,1,75714,75714,75715,0,1,1
21604,5,3,75719,75719,75722,0,3,4
21605,1,2,75720,75722,75724,2,4,0
21606,4,3,75724,75724,75727,0,3,0
21607,6,3,75730,75730,75733,0,3,3
21608,2,3,75732,75733,75736,1,4,0
21609,4,2,75736,75736,75738,0,2,0
21610,1,3,75737,75738,75741,1,4,0
21611,4,3,75741,75741,75744,0,3,0
21612,4,3,75745,75745,75748,0,3,1
21613,1,2,75746,75748,75750,2,4,0
21614,6,3,75752,75752,75755,0,3,2
21615,4,1,75756,75756,75757,0,1,1
21616,2,3,75758,75758,75761,0,3,1
21617,1,3,75759,75761,75764,2,5,0
21618,5,3,75764,75764,75767,0,3,0
21619,2,1,75766,75767,75768,1,2,0
21620,1,3,75767,75768,75771,1,4,0
21621,1,1,75768,75771,75772,3,4,0
21622,2,1,75770,75772,75773,2,3,0
21623,4,2,75774,75774,75776,0,2,1
21624,5,3,75779,75779,75782,0,3,3
21625,1,1,75780,75782,75783,2,3,0
21626,5,2,75785,75785,75787,0,2,2
21627,3,2,75788,75788,75790,0,2,1
21628,2,1,75790,75790,75791,0,1,0
21629,6,3,75796,75796,75799,0,3,5
21630,6,3,75802,75802,75805,0,3,3
21631,1,3,75803,75805,75808,2,5,0
21632,4,3,75807,75808,75811,1,4,0
21633,3,1,75810,75811,75812,1,2,0
21634,3,1,75813,75813,75814,0,1,1
21635,6,3,75819,75819,75822,0,3,5
21636,6,2,75825,75825,75827,0,2,3
21637,5,2,75830,75830,75832,0,2,3
21638,4,1,75834,75834,75835,0,1,2
21639,1,3,75835,75835,75838,0,3,0
21640,6,1,75841,75841,75842,0,1,3
21641,1,3,75842,75842,75845,0,3,0
21642,1,2,75843,75845,75847,2,4,0
21643,4,3,75847,75847,75850,0,3,0
21644,6,1,75853,75853,75854,0,1,3
21645,6,2,75859,75859,75861,0,2,5
21646,6,1,75865,75865,75866,0,1,4
21647,5,2,75870,75870,75872,0,2,4
21648,4,1,75874,75874,75875,0,1,2
21649,2,3,75876,75876,75879,0,3,1
21650,5,3,75881,75881,75884,0,3,2
21651,1,1,75882,75884,75885,2,3,0
21652,5,2,75887,75887,75889,0,2,2
21653,5,3,75892,75892,75895,0,3,3
21654,4,3,75896,75896,75899,0,3,1
21655,1,3,75897,75899,75902,2,5,0
21656,3,3,75900,75902,75905,2,5,0
21657,1,1,75901,75905,75906,4,5,0
21658,5,2,75906,75906,75908,0,2,0
21659,1,2,75907,75908,75910,1,3,0
21660,2,1,75909,75910,75911,1,2,0
21661,4,3,75913,75913,75916,0,3,2
21662,4,1,75917,75917,75918,0,1,1
21663,5,3,75922,75922,75925,0,3,4
21664,1,3,75923,75925,75928,2,5,0
21665,2,1,75925,75928,75929,3,4,0
21666,4,3,75929,75929,75932,0,3,0
21667,2,3,75931,75932,75935,1,4,0
21668,1,2,75932,75935,75937,3,5,0
21669,4,2,75936,75937,75939,1,3,0
21670,5,3,75941,75941,75944,0,3,2
21671,5,1,75946,75946,75947,0,1,2
21672,5,2,75951,75951,75953,0,2,4
21673,6,3,75957,75957,75960,0,3,4
21674,4,2,75961,75961,75963,0,2,1
21675,1,3,75962,75963,75966,1,4,0
21676,3,3,75965,75966,75969,1,4,0
21677,2,3,75967,75969,75972,2,5,0
21678,3,3,75970,75972,75975,2,5,0
21679,1,3,75971,75975,75978,4,7,0
21680,4,3,75975,75978,75981,3,6,0
21681,6,1,75981,75981,75982,0,1,0
21682,6,1,75987,75987,75988,0,1,5
21683,6,3,75993,75993,75996,0,3,5
21684,2,3,75995,75996,75999,1,4,0
21685,4,2,75999,75999,76001,0,2,0
21686,4,2,76003,76003,76005,0,2,2
21687,6,2,76009,76009,76011,0,2,4
21688,6,3,76015,76015,76018,0,3,4
21689,6,3,76021,76021,76024,0,3,3
21690,4,1,76025,76025,76026,0,1,1
21691,3,1,76028,76028,76029,0,1,2
21692,2,3,76030,76030,76033,0,3,1
21693,4,3,76034,76034,76037,0,3,1
21694,4,1,76038,76038,76039,0,1,1
21695,4,2,76042,76042,76044,0,2,3
21696,5,1,76047,76047,76048,0,1,3
21697,5,1,76052,76052,76053,0,1,4
21698,6,3,76058,76058,76061,0,3,5
21699,5,3,76063,76063,76066,0,3,2
21700,3,3,76066,76066,76069,0,3,0
21701,1,2,76067,76069,76071,2,4,0
21702,1,1,76068,76071,76072,3,4,0
21703,5,1,76073,76073,76074,0,1,1
21704,1,2,76074,76074,76076,0,2,0
21705,4,1,76078,76078,76079,0,1,2
21706,3,2,76081,76081,76083,0,2,2
21707,4,3,76085,76085,76088,0,3,2
21708,5,2,76090,76090,76092,0,2,2
21709,3,1,76093,76093,76094,0,1,1
21710,5,2,76098,76098,76100,0,2,4
21711,3,2,76101,76101,76103,0,2,1
21712,1,2,76102,76103,76105,1,3,0
21713,1,2,76103,76105,76107,2,4,0
21714,5,1,76108,76108,76109,0,1,1
21715,1,1,76109,76109,76110,0,1,0
21716,5,2,76114,76114,76116,0,2,4
21717,4,3,76118,76118,76121,0,3,2
21718,6,3,76124,76124,76127,0,3,3
21719,5,2,76129,76129,76131,0,2,2
21720,5,3,76134,76134,76137,0,3,3
21721,3,1,76137,76137,76138,0,1,0
21722,4,3,76141,76141,76144,0,3,3
21723,4,2,76145,76145,76147,0,2,1
21724,5,1,76150,76150,76151,0,1,3
21725,2,3,76152,76152,76155,0,3,1
21726,3,2,76155,76155,76157,0,2,0
21727,1,3,76156,76157,76160,1,4,0
21728,6,3,76162,76162,76165,0,3,2
21729,2,1,76164,76165,76166,1,2,0
21730,6,3,76170,76170,76173,0,3,4
21731,5,3,76175,76175,76178,0,3,2
21732,3,3,76178,76178,76181,0,3,0
21733,4,1,76182,76182,76183,0,1,1
21734,3,2,76185,76185,76187,0,2,2
21735,3,1,76188,76188,76189,0,1,1
21736,3,3,76191,76191,76194,0,3,2
21737,6,1,76197,76197,76198,0,1,3
21738,2,1,76199,76199,76200,0,1,1
21739,3,2,76202,76202,76204,0,2,2
21740,5,1,76207,76207,76208,0,1,3
21741,5,2,76212,76212,76214,0,2,4
21742,1,2,76213,76214,76216,1,3,0
21743,1,3,76214,76216,76219,2,5,0
21744,5,1,76219,76219,76220,0,1,0
21745,6,2,76225,76225,76227,0,2,5
21746,4,3,76229,76229,76232,0,3,2
21747,4,1,76233,76233,76234,0,1,1
21748,1,1,76234,76234,76235,0,1,0
21749,6,1,76240,76240,76241,0,1,5
21750,1,2,76241,76241,76243,0,2,0
21751,6,3,76247,76247,76250,0,3,4
21752,2,3,76249,76250,76253,1,4,0
21753,2,1,76251,76253,76254,2,3,0
21754,2,1,76253,76254,76255,1,2,0
21755,2,3,76255,76255,76258,0,3,0
21756,1,1,76256,76258,76259,2,3,0
21757,6,1,76262,76262,76263,0,1,3
21758,3,1,76265,76265,76266,0,1,2
21759,5,3,76270,76270,76273,0,3,4
21760,4,1,76274,76274,76275,0,1,1
21761,5,2,76279,76279,76281,0,2,4
21762,3,2,76282,76282,76284,0,2,1
21763,3,3,76285,76285,76288,0,3,1
21764,4,3,76289,76289,76292,0,3,1
21765,4,1,76293,76293,76294,0,1,1
21766,3,3,76296,76296,76299,0,3,2
21767,4,3,76300,76300,76303,0,3,1
21768,3,3,76303,76303,76306,0,3,0
21769,2,1,76305,76306,76307,1,2,0
21770,3,2,76308,76308,76310,0,2,1
21771,6,1,76314,76314,76315,0,1,4
21772,2,2,76316,76316,76318,0,2,1
21773,6,2,76322,76322,76324,0,2,4
21774,6,3,76328,76328,76331,0,3,4
21775,6,3,76334,76334,76337,0,3,3
21776,3,1,76337,76337,76338,0,1,0
21777,5,1,76342,76342,76343,0,1,4
21778,4,3,76346,76346,76349,0,3,3
21779,3,1,76349,76349,76350,0,1,0
21780,4,2,76353,76353,76355,0,2,3
21781,6,2,76359,76359,76361,0,2,4
21782,1,3,76360,76361,76364,1,4,0
21783,4,1,76364,76364,76365,0,1,0
21784,3,1,76367,76367,76368,0,1,2
21785,3,1,76370,76370,76371,0,1,2
21786,2,2,76372,76372,76374,0,2,1
21787,3,2,76375,76375,76377,0,2,1
21788,6,2,76381,76381,76383,0,2,4
21789,5,3,76386,76386,76389,0,3,3
21790,6,2,76392,76392,76394,0,2,3
21791,5,2,76397,76397,76399,0,2,3
21792,2,1,76399,76399,76400,0,1,0
21793,2,3,76401,76401,76404,0,3,1
21794,2,2,76403,76404,76406,1,3,0
21795,1,1,76404,76406,76407,2,3,0
21796,4,2,76408,76408,76410,0,2,1
21797,4,1,76412,76412,76413,0,1,2
21798,2,3,76414,76414,76417,0,3,1
21799,4,2,76418,76418,76420,0,2,1
21800,2,2,76420,76420,76422,0,2,0
21801,1,3,76421,76422,76425,1,4,0
21802,3,1,76424,76425,76426,1,2,0
21803,3,3,76427,76427,76430,0,3,1
21804,5,1,76432,76432,76433,0,1,2
21805,1,2,76433,76433,76435,0,2,0
21806,5,1,76438,76438,76439,0,1,3
21807,5,2,76443,76443,76445,0,2,4
21808,4,2,76447,76447,76449,0,2,2
21809,3,2,76450,76450,76452,0,2,1
21810,3,3,76453,76453,76456,0,3,1
21811,4,3,76457,76457,76460,0,3,1
21812,1,1,76458,76460,76461,2,3,0
21813,3,2,76461,76461,76463,0,2,0
21814,4,2,76465,76465,76467,0,2,2
21815,6,3,76471,76471,76474,0,3,4
21816,2,3,76473,76474,76477,1,4,0
21817,4,3,76477,76477,76480,0,3,0
21818,3,3,76480,76480,76483,0,3,0
21819,3,2,76483,76483,76485,0,2,0
21820,2,1,76485,76485,76486,0,1,0
21821,2,2,76487,76487,76489,0,2,1
21822,5,1,76492,76492,76493,0,1,3
21823,4,3,76496,76496,76499,0,3,3
21824,4,2,76500,76500,76502,0,2,1
21825,6,1,76506,76506,76507,0,1,4
21826,2,1,76508,76508,76509,0,1,1
21827,1,3,76509,76509,76512,0,3,0
21828,4,1,76513,76513,76514,0,1,1
21829,6,3,76519,76519,76522,0,3,5
21830,2,2,76521,76522,76524,1,3,0
21831,4,1,76525,76525,76526,0,1,1
21832,1,2,76526,76526,76528,0,2,0
21833,5,3,76531,76531,76534,0,3,3
21834,4,2,76535,76535,76537,0,2,1
21835,3,1,76538,76538,76539,0,1,1
21836,3,3,76541,76541,76544,0,3,2
21837,2,2,76543,76544,76546,1,3,0
21838,2,2,76545,76546,76548,1,3,0
21839,3,1,76548,76548,76549,0,1,0
21840,6,2,76554,76554,76556,0,2,5
21841,3,1,76557,76557,76558,0,1,1
21842,2,2,76559,76559,76561,0,2,1
21843,3,3,76562,76562,76565,0,3,1
21844,5,3,76567,76567,76570,0,3,2
21845,1,3,76568,76570,76573,2,5,0
21846,6,1,76574,76574,76575,0,1,1
21847,2,1,76576,76576,76577,0,1,1
21848,5,3,76581,76581,76584,0,3,4
21849,1,3,76582,76584,76587,2,5,0
21850,2,3,76584,76587,76590,3,6,0
21851,6,2,76590,76590,76592,0,2,0
21852,1,2,76591,76592,76594,1,3,0
21853,5,3,76596,76596,76599,0,3,2
21854,1,2,76597,76599,76601,2,4,0
21855,1,2,76598,76601,76603,3,5,0
21856,4,3,76602,76603,76606,1,4,0
21857,6,1,76608,76608,76609,0,1,2
21858,4,1,76612,76612,76613,0,1,3
21859,3,1,76615,76615,76616,0,1,2
21860,1,2,76616,76616,76618,0,2,0
21861,3,1,76619,76619,76620,0,1,1
21862,3,1,76622,76622,76623,0,1,2
21863,1,3,76623,76623,76626,0,3,0
21864,2,1,76625,76626,76627,1,2,0
21865,2,2,76627,76627,76629,0,2,0
21866,2,1,76629,76629,76630,0,1,0
21867,3,2,76632,76632,76634,0,2,2
21868,6,1,76638,76638,76639,0,1,4
21869,6,1,76644,76644,76645,0,1,5
21870,5,2,76649,76649,76651,0,2,4
21871,2,2,76651,76651,76653,0,2,0
21872,6,2,76657,76657,76659,0,2,4
21873,5,3,76662,76662,76665,0,3,3
21874,6,3,76668,76668,76671,0,3,3
21875,4,1,76672,76672,76673,0,1,1
21876,4,1,76676,76676,76677,0,1,3
21877,6,3,76682,76682,76685,0,3,5
21878,2,2,76684,76685,76687,1,3,0
21879,6,3,76690,76690,76693,0,3,3
21880,6,2,76696,76696,76698,0,2,3
21881,2,3,76698,76698,76701,0,3,0
21882,2,3,76700,76701,76704,1,4,0
21883,5,3,76705,76705,76708,0,3,1
21884,3,3,76708,76708,76711,0,3,0
21885,1,3,76709,76711,76714,2,5,0
21886,3,1,76712,76714,76715,2,3,0
21887,5,1,76717,76717,76718,0,1,2
21888,4,2,76721,76721,76723,0,2,3
21889,4,3,76725,76725,76728,0,3,2
21890,4,2,76729,76729,76731,0,2,1
21891,5,3,76734,76734,76737,0,3,3
21892,1,2,76735,76737,76739,2,4,0
21893,3,3,76738,76739,76742,1,4,0
21894,5,3,76743,76743,76746,0,3,1
21895,4,3,76747,76747,76750,0,3,1
21896,6,3,76753,76753,76756,0,3,3
21897,6,2,76759,76759,76761,0,2,3
21898,6,1,76765,76765,76766,0,1,4
21899,4,3,76769,76769,76772,0,3,3
21900,1,3,76770,76772,76775,2,5,0
21901,5,1,76775,76775,76776,0,1,0
21902,4,3,76779,76779,76782,0,3,3
21903,5,2,76784,76784,76786,0,2,2
21904,5,1,76789,76789,76790,0,1,3
21905,4,3,76793,76793,76796,0,3,3
21906,4,2,76797,76797,76799,0,2,1
21907,1,1,76798,76799,76800,1,2,0
21908,5,1,76803,76803,76804,0,1,3
21909,5,1,76808,76808,76809,0,1,4
21910,6,2,76814,76814,76816,0,2,5
21911,4,3,76818,76818,76821,0,3,2
21912,4,2,76822,76822,76824,0,2,1
21913,2,2,76824,76824,76826,0,2,0
21914,1,2,76825,76826,76828,1,3,0
21915,6,3,76831,76831,76834,0,3,3
21916,1,1,76832,76834,76835,2,3,0
21917,2,1,76834,76835,76836,1,2,0
21918,4,3,76838,76838,76841,0,3,2
21919,2,3,76840,76841,76844,1,4,0
21920,1,3,76841,76844,76847,3,6,0
21921,3,3,76844,76847,76850,3,6,0
21922,1,3,76845,76850,76853,5,8,0
21923,3,3,76848,76853,76856,5,8,0
21924,1,2,76849,76856,76858,7,9,0
21925,4,3,76853,76858,76861,5,8,0
21926,6,2,76859,76861,76863,2,4,0
21927,1,2,76860,76863,76865,3,5,0
21928,6,3,76866,76866,76869,0,3,1
21929,5,1,76871,76871,76872,0,1,2
21930,2,3,76873,76873,76876,0,3,1
21931,1,3,76874,76876,76879,2,5,0
21932,5,3,76879,76879,76882,0,3,0
21933,6,1,76885,76885,76886,0,1,3
21934,5,1,76890,76890,76891,0,1,4
21935,1,2,76891,76891,76893,0,2,0
21936,4,2,76895,76895,76897,0,2,2
21937,5,1,76900,76900,76901,0,1,3
21938,4,3,76904,76904,76907,0,3,3
21939,5,3,76909,76909,76912,0,3,2
21940,6,2,76915,76915,76917,0,2,3
21941,6,1,76921,76921,76922,0,1,4
21942,3,3,76924,76924,76927,0,3,2
21943,6,2,76930,76930,76932,0,2,3
21944,4,1,76934,76934,76935,0,1,2
21945,5,3,76939,76939,76942,0,3,4
21946,6,3,76945,76945,76948,0,3,3
21947,6,2,76951,76951,76953,0,2,3
21948,5,3,76956,76956,76959,0,3,3
21949,2,3,76958,76959,76962,1,4,0
21950,4,1,76962,76962,76963,0,1,0
21951,1,2,76963,76963,76965,0,2,0
21952,2,1,76965,76965,76966,0,1,0
21953,1,1,76966,76966,76967,0,1,0
21954,1,2,76967,76967,76969,0,2,0
21955,1,2,76968,76969,76971,1,3,0
21956,3,3,76971,76971,76974,0,3,0
21957,4,1,76975,76975,76976,0,1,1
21958,2,1,76977,76977,76978,0,1,1
21959,5,2,76982,76982,76984,0,2,4
21960,1,2,76983,76984,76986,1,3,0
21961,6,1,76989,76989,76990,0,1,3
21962,4,3,76993,76993,76996,0,3,3
21963,1,1,76994,76996,76997,2,3,0
21964,4,1,76998,76998,76999,0,1,1
21965,2,2,77000,77000,77002,0,2,1
21966,6,3,77006,77006,77009,0,3,4
21967,1,1,77007,77009,77010,2,3,0
21968,2,1,77009,77010,77011,1,2,0
21969,5,1,77014,77014,77015,0,1,3
21970,1,1,77015,77015,77016,0,1,0
21971,1,2,77016,77016,77018,0,2,0
21972,1,1,77017,77018,77019,1,2,0
21973,4,3,77021,77021,77024,0,3,2
21974,6,3,77027,77027,77030,0,3,3
21975,6,2,77033,77033,77035,0,2,3
21976,3,3,77036,77036,77039,0,3,1
21977,1,3,77037,77039,77042,2,5,0
21978,2,3,77039,77042,77045,3,6,0
21979,6,3,77045,77045,77048,0,3,0
21980,4,3,77049,77049,77052,0,3,1
21981,3,1,77052,77052,77053,0,1,0
21982,6,1,77058,77058,77059,0,1,5
21983,2,2,77060,77060,77062,0,2,1
21984,5,2,77065,77065,77067,0,2,3
21985,2,1,77067,77067,77068,0,1,0
21986,5,1,77072,77072,77073,0,1,4
21987,1,2,77073,77073,77075,0,2,0
21988,1,2,77074,77075,77077,1,3,0
21989,3,2,77077,77077,77079,0,2,0
21990,3,1,77080,77080,77081,0,1,1
21991,2,2,77082,77082,77084,0,2,1
21992,5,3,77087,77087,77090,0,3,3
21993,2,2,77089,77090,77092,1,3,0
21994,6,3,77095,77095,77098,0,3,3
21995,5,1,77100,77100,77101,0,1,2
21996,3,1,77103,77103,77104,0,1,2
21997,4,3,77107,77107,77110,0,3,3
21998,3,2,77110,77110,77112,0,2,0
21999,3,1,77113,77113,77114,0,1,1
22000,2,1,77115,77115,77116,0,1,1
22001,4,1,77119,77119,77120,0,1,3
22002,2,3,77121,77121,77124,0,3,1
22003,6,3,77127,77127,77130,0,3,3
22004,3,2,77130,77130,77132,0,2,0
22005,5,1,77135,77135,77136,0,1,3
22006,4,3,77139,77139,77142,0,3,3
22007,3,3,77142,77142,77145,0,3,0
22008,4,2,77146,77146,77148,0,2,1
22009,2,3,77148,77148,77151,0,3,0
22010,1,3,77149,77151,77154,2,5,0
22011,5,1,77154,77154,77155,0,1,0
22012,4,1,77158,77158,77159,0,1,3
22013,5,2,77163,77163,77165,0,2,4
22014,6,2,77169,77169,77171,0,2,4
22015,5,1,77174,77174,77175,0,1,3
22016,2,3,77176,77176,77179,0,3,1
22017,4,1,77180,77180,77181,0,1,1
22018,2,1,77182,77182,77183,0,1,1
22019,4,2,77186,77186,77188,0,2,3
22020,2,3,77188,77188,77191,0,3,0
22021,5,1,77193,77193,77194,0,1,2
22022,1,1,77194,77194,77195,0,1,0
22023,2,2,77196,77196,77198,0,2,1
22024,2,3,77198,77198,77201,0,3,0
22025,6,2,77204,77204,77206,0,2,3
22026,4,2,77208,77208,77210,0,2,2
22027,1,1,77209,77210,77211,1,2,0
22028,5,1,77214,77214,77215,0,1,3
22029,6,1,77220,77220,77221,0,1,5
22030,5,1,77225,77225,77226,0,1,4
22031,2,1,77227,77227,77228,0,1,1
22032,6,1,77233,77233,77234,0,1,5
22033,1,2,77234,77234,77236,0,2,0
22034,4,2,77238,77238,77240,0,2,2
22035,6,3,77244,77244,77247,0,3,4
22036,6,2,77250,77250,77252,0,2,3
22037,5,1,77255,77255,77256,0,1,3
22038,2,1,77257,77257,77258,0,1,1
22039,2,1,77259,77259,77260,0,1,1
22040,4,3,77263,77263,77266,0,3,3
22041,6,3,77269,77269,77272,0,3,3
22042,5,3,77274,77274,77277,0,3,2
22043,5,1,77279,77279,77280,0,1,2
22044,3,2,77282,77282,77284,0,2,2
22045,4,1,77286,77286,77287,0,1,2
22046,4,2,77290,77290,77292,0,2,3
22047,5,1,77295,77295,77296,0,1,3
22048,1,3,77296,77296,77299,0,3,0
22049,2,2,77298,77299,77301,1,3,0
22050,1,1,77299,77301,77302,2,3,0
22051,6,2,77305,77305,77307,0,2,3
22052,5,2,77310,77310,77312,0,2,3
22053,5,2,77315,77315,77317,0,2,3
22054,5,1,77320,77320,77321,0,1,3
22055,1,2,77321,77321,77323,0,2,0
22056,5,2,77326,77326,77328,0,2,3
22057,1,3,77327,77328,77331,1,4,0
22058,2,1,77329,77331,77332,2,3,0
22059,3,2,77332,77332,77334,0,2,0
22060,3,1,77335,77335,77336,0,1,1
22061,5,1,77340,77340,77341,0,1,4
22062,5,1,77345,77345,77346,0,1,4
22063,6,3,77351,77351,77354,0,3,5
22064,2,1,77353,77354,77355,1,2,0
22065,3,3,77356,77356,77359,0,3,1
22066,3,1,77359,77359,77360,0,1,0
22067,1,2,77360,77360,77362,0,2,0
22068,5,2,77365,77365,77367,0,2,3
22069,4,2,77369,77369,77371,0,2,2
22070,4,1,77373,77373,77374,0,1,2
22071,4,1,77377,77377,77378,0,1,3
22072,3,3,77380,77380,77383,0,3,2
22073,3,3,77383,77383,77386,0,3,0
22074,3,2,77386,77386,77388,0,2,0
22075,4,2,77390,77390,77392,0,2,2
22076,2,2,77392,77392,77394,0,2,0
22077,3,1,77395,77395,77396,0,1,1
22078,6,3,77401,77401,77404,0,3,5
22079,4,3,77405,77405,77408,0,3,1
22080,5,2,77410,77410,77412,0,2,2
22081,4,2,77414,77414,77416,0,2,2
22082,1,1,77415,77416,77417,1,2,0
22083,3,1,77418,77418,77419,0,1,1
22084,6,3,77424,77424,77427,0,3,5
22085,6,1,77430,77430,77431,0,1,3
22086,3,2,77433,77433,77435,0,2,2
22087,2,2,77435,77435,77437,0,2,0
22088,6,3,77441,77441,77444,0,3,4
22089,1,3,77442,77444,77447,2,5,0
22090,3,2,77445,77447,77449,2,4,0
22091,3,3,77448,77449,77452,1,4,0
22092,6,2,77454,77454,77456,0,2,2
22093,2,3,77456,77456,77459,0,3,0
22094,6,1,77462,77462,77463,0,1,3
22095,2,1,77464,77464,77465,0,1,1
22096,1,3,77465,77465,77468,0,3,0
22097,2,2,77467,77468,77470,1,3,0
22098,5,3,77472,77472,77475,0,3,2
22099,4,1,77476,77476,77477,0,1,1
22100,6,2,77482,77482,77484,0,2,5
22101,6,1,77488,77488,77489,0,1,4
22102,3,1,77491,77491,77492,0,1,2
22103,2,2,77493,77493,77495,0,2,1
22104,5,3,77498,77498,77501,0,3,3
22105,2,2,77500,77501,77503,1,3,0
22106,3,1,77503,77503,77504,0,1,0
22107,4,3,77507,77507,77510,0,3,3
22108,5,3,77512,77512,77515,0,3,2
22109,5,1,77517,77517,77518,0,1,2
22110,3,3,77520,77520,77523,0,3,2
22111,2,3,77522,77523,77526,1,4,0
22112,5,1,77527,77527,77528,0,1,1
22113,6,3,77533,77533,77536,0,3,5
22114,3,2,77536,77536,77538,0,2,0
22115,6,2,77542,77542,77544,0,2,4
22116,6,1,77548,77548,77549,0,1,4
22117,1,2,77549,77549,77551,0,2,0
22118,2,2,77551,77551,77553,0,2,0
22119,2,3,77553,77553,77556,0,3,0
22120,5,2,77558,77558,77560,0,2,2
22121,4,3,77562,77562,77565,0,3,2
22122,3,1,77565,77565,77566,0,1,0
22123,5,3,77570,77570,77573,0,3,4
22124,6,3,77576,77576,77579,0,3,3
22125,5,1,77581,77581,77582,0,1,2
22126,1,1,77582,77582,77583,0,1,0
22127,2,3,77584,77584,77587,0,3,1
22128,5,2,77589,77589,77591,0,2,2
22129,1,1,77590,77591,77592,1,2,0
22130,2,2,77592,77592,77594,0,2,0
22131,5,2,77597,77597,77599,0,2,3
22132,3,1,77600,77600,77601,0,1,1
22133,5,2,77605,77605,77607,0,2,4
22134,3,1,77608,77608,77609,0,1,1
22135,4,1,77612,77612,77613,0,1,3
22136,6,1,77618,77618,77619,0,1,5
22137,4,2,77622,77622,77624,0,2,3
22138,3,3,77625,77625,77628,0,3,1
22139,2,1,77627,77628,77629,1,2,0
22140,4,3,77631,77631,77634,0,3,2
22141,2,1,77633,77634,77635,1,2,0
22142,4,3,77637,77637,77640,0,3,2
22143,3,1,77640,77640,77641,0,1,0
22144,4,1,77644,77644,77645,0,1,3
22145,3,1,77647,77647,77648,0,1,2
22146,3,1,77650,77650,77651,0,1,2
22147,5,3,77655,77655,77658,0,3,4
22148,2,2,77657,77658,77660,1,3,0
22149,2,1,77659,77660,77661,1,2,0
22150,6,1,77665,77665,77666,0,1,4
22151,5,1,77670,77670,77671,0,1,4
22152,4,2,77674,77674,77676,0,2,3
22153,6,2,77680,77680,77682,0,2,4
22154,4,2,77684,77684,77686,0,2,2
22155,5,2,77689,77689,77691,0,2,3
22156,4,1,77693,77693,77694,0,1,2
22157,3,3,77696,77696,77699,0,3,2
22158,5,1,77701,77701,77702,0,1,2
22159,4,3,77705,77705,77708,0,3,3
22160,6,3,77711,77711,77714,0,3,3
22161,5,2,77716,77716,77718,0,2,2
22162,5,1,77721,77721,77722,0,1,3
22163,3,1,77724,77724,77725,0,1,2
22164,5,3,77729,77729,77732,0,3,4
22165,1,1,77730,77732,77733,2,3,0
22166,5,1,77735,77735,77736,0,1,2
22167,4,1,77739,77739,77740,0,1,3
22168,3,2,77742,77742,77744,0,2,2
22169,1,1,77743,77744,77745,1,2,0
22170,6,1,77749,77749,77750,0,1,4
22171,2,1,77751,77751,77752,0,1,1
22172,2,2,77753,77753,77755,0,2,1
22173,4,1,77757,77757,77758,0,1,2
22174,1,2,77758,77758,77760,0,2,0
22175,6,2,77764,77764,77766,0,2,4
22176,6,1,77770,77770,77771,0,1,4
22177,6,1,77776,77776,77777,0,1,5
22178,5,2,77781,77781,77783,0,2,4
22179,3,1,77784,77784,77785,0,1,1
22180,1,2,77785,77785,77787,0,2,0
22181,3,2,77788,77788,77790,0,2,1
22182,2,2,77790,77790,77792,0,2,0
22183,2,1,77792,77792,77793,0,1,0
22184,4,3,77796,77796,77799,0,3,3
22185,3,1,77799,77799,77800,0,1,0
22186,4,2,77803,77803,77805,0,2,3
22187,3,3,77806,77806,77809,0,3,1
22188,4,3,77810,77810,77813,0,3,1
22189,6,3,77816,77816,77819,0,3,3
22190,2,1,77818,77819,77820,1,2,0
22191,6,3,77824,77824,77827,0,3,4
22192,2,2,77826,77827,77829,1,3,0
22193,4,1,77830,77830,77831,0,1,1
22194,5,1,77835,77835,77836,0,1,4
22195,5,3,77840,77840,77843,0,3,4
22196,1,3,77841,77843,77846,2,5,0
22197,4,2,77845,77846,77848,1,3,0
22198,5,2,77850,77850,77852,0,2,2
22199,3,2,77853,77853,77855,0,2,1
22200,2,2,77855,77855,77857,0,2,0
22201,1,3,77856,77857,77860,1,4,0
22202,6,2,77862,77862,77864,0,2,2
22203,1,3,77863,77864,77867,1,4,0
22204,6,1,77869,77869,77870,0,1,2
22205,1,2,77870,77870,77872,0,2,0
22206,2,2,77872,77872,77874,0,2,0
22207,6,1,77878,77878,77879,0,1,4
22208,5,2,77883,77883,77885,0,2,4
22209,6,1,77889,77889,77890,0,1,4
22210,4,2,77893,77893,77895,0,2,3
22211,3,1,77896,77896,77897,0,1,1
22212,6,1,77902,77902,77903,0,1,5
22213,4,1,77906,77906,77907,0,1,3
22214,4,1,77910,77910,77911,0,1,3
22215,3,1,77913,77913,77914,0,1,2
22216,2,2,77915,77915,77917,0,2,1
22217,1,1,77916,77917,77918,1,2,0
22218,1,2,77917,77918,77920,1,3,0
22219,4,3,77921,77921,77924,0,3,1
22220,2,1,77923,77924,77925,1,2,0
22221,5,1,77928,77928,77929,0,1,3
22222,6,2,77934,77934,77936,0,2,5
22223,4,1,77938,77938,77939,0,1,2
22224,4,1,77942,77942,77943,0,1,3
22225,4,2,77946,77946,77948,0,2,3
22226,1,2,77947,77948,77950,1,3,0
22227,1,1,77948,77950,77951,2,3,0
22228,2,1,77950,77951,77952,1,2,0
22229,1,1,77951,77952,77953,1,2,0
22230,1,1,77952,77953,77954,1,2,0
22231,5,3,77957,77957,77960,0,3,3
22232,2,1,77959,77960,77961,1,2,0
22233,2,1,77961,77961,77962,0,1,0
22234,3,3,77964,77964,77967,0,3,2
22235,2,3,77966,77967,77970,1,4,0
22236,5,1,77971,77971,77972,0,1,1
22237,6,2,77977,77977,77979,0,2,5
22238,6,1,77983,77983,77984,0,1,4
22239,4,2,77987,77987,77989,0,2,3
22240,5,3,77992,77992,77995,0,3,3
22241,6,2,77998,77998,78000,0,2,3
22242,1,2,77999,78000,78002,1,3,0
22243,2,2,78001,78002,78004,1,3,0
22244,4,1,78005,78005,78006,0,1,1
22245,6,1,78011,78011,78012,0,1,5
22246,6,3,78017,78017,78020,0,3,5
22247,1,3,78018,78020,78023,2,5,0
22248,3,2,78021,78023,78025,2,4,0
22249,3,3,78024,78025,78028,1,4,0
22250,2,2,78026,78028,78030,2,4,0
22251,4,2,78030,78030,78032,0,2,0
22252,4,1,78034,78034,78035,0,1,2
22253,4,2,78038,78038,78040,0,2,3
22254,6,2,78044,78044,78046,0,2,4
22255,4,1,78048,78048,78049,0,1,2
22256,1,2,78049,78049,78051,0,2,0
22257,2,1,78051,78051,78052,0,1,0
22258,3,2,78054,78054,78056,0,2,2
22259,2,2,78056,78056,78058,0,2,0
22260,2,2,78058,78058,78060,0,2,0
22261,2,3,78060,78060,78063,0,3,0
22262,6,1,78066,78066,78067,0,1,3
22263,2,2,78068,78068,78070,0,2,1
22264,2,3,78070,78070,78073,0,3,0
22265,2,1,78072,78073,78074,1,2,0
22266,3,2,78075,78075,78077,0,2,1
22267,1,1,78076,78077,78078,1,2,0
22268,2,3,78078,78078,78081,0,3,0
22269,1,1,78079,78081,78082,2,3,0
22270,1,3,78080,78082,78085,2,5,0
22271,3,2,78083,78085,78087,2,4,0
22272,2,3,78085,78087,78090,2,5,0
22273,5,3,78090,78090,78093,0,3,0
22274,4,1,78094,78094,78095,0,1,1
22275,3,1,78097,78097,78098,0,1,2
22276,2,1,78099,78099,78100,0,1,1
22277,4,2,78103,78103,78105,0,2,3
22278,4,2,78107,78107,78109,0,2,2
22279,1,2,78108,78109,78111,1,3,0
22280,5,2,78113,78113,78115,0,2,2
22281,1,2,78114,78115,78117,1,3,0
22282,4,2,78118,78118,78120,0,2,1
22283,2,1,78120,78120,78121,0,1,0
22284,6,1,78126,78126,78127,0,1,5
22285,5,1,78131,78131,78132,0,1,4
22286,3,3,78134,78134,78137,0,3,2
22287,3,2,78137,78137,78139,0,2,0
22288,2,1,78139,78139,78140,0,1,0
22289,4,1,78143,78143,78144,0,1,3
22290,4,2,78147,78147,78149,0,2,3
22291,3,1,78150,78150,78151,0,1,1
22292,5,2,78155,78155,78157,0,2,4
22293,3,1,78158,78158,78159,0,1,1
22294,2,1,78160,78160,78161,0,1,1
22295,4,3,78164,78164,78167,0,3,3
22296,1,2,78165,78167,78169,2,4,0
22297,4,3,78169,78169,78172,0,3,0
22298,6,3,78175,78175,78178,0,3,3
22299,6,3,78181,78181,78184,0,3,3
22300,6,2,78187,78187,78189,0,2,3
22301,3,1,78190,78190,78191,0,1,1
22302,5,3,78195,78195,78198,0,3,4
22303,5,1,78200,78200,78201,0,1,2
22304,6,3,78206,78206,78209,0,3,5
22305,5,3,78211,78211,78214,0,3,2
22306,4,2,78215,78215,78217,0,2,1
22307,5,2,78220,78220,78222,0,2,3
22308,6,1,78226,78226,78227,0,1,4
22309,5,2,78231,78231,78233,0,2,4
22310,5,2,78236,78236,78238,0,2,3
22311,2,2,78238,78238,78240,0,2,0
22312,2,3,78240,78240,78243,0,3,0
22313,1,3,78241,78243,78246,2,5,0
22314,4,2,78245,78246,78248,1,3,0
22315,1,1,78246,78248,78249,2,3,0
22316,1,1,78247,78249,78250,2,3,0
22317,3,3,78250,78250,78253,0,3,0
22318,2,2,78252,78253,78255,1,3,0
22319,6,1,78258,78258,78259,0,1,3
22320,1,2,78259,78259,78261,0,2,0
22321,3,3,78262,78262,78265,0,3,1
22322,3,2,78265,78265,78267,0,2,0
22323,5,1,78270,78270,78271,0,1,3
22324,5,3,78275,78275,78278,0,3,4
22325,5,2,78280,78280,78282,0,2,2
22326,2,3,78282,78282,78285,0,3,0
22327,6,2,78288,78288,78290,0,2,3
22328,2,1,78290,78290,78291,0,1,0
22329,3,2,78293,78293,78295,0,2,2
22330,6,2,78299,78299,78301,0,2,4
22331,5,1,78304,78304,78305,0,1,3
22332,6,1,78310,78310,78311,0,1,5
22333,4,1,78314,78314,78315,0,1,3
22334,5,3,78319,78319,78322,0,3,4
22335,5,1,78324,78324,78325,0,1,2
22336,4,1,78328,78328,78329,0,1,3
22337,4,2,78332,78332,78334,0,2,3
22338,5,2,78337,78337,78339,0,2,3
22339,4,2,78341,78341,78343,0,2,2
22340,6,1,78347,78347,78348,0,1,4
22341,6,3,78353,78353,78356,0,3,5
22342,5,3,78358,78358,78361,0,3,2
22343,1,3,78359,78361,78364,2,5,0
22344,3,2,78362,78364,78366,2,4,0
22345,2,3,78364,78366,78369,2,5,0
22346,3,3,78367,78369,78372,2,5,0
22347,2,1,78369,78372,78373,3,4,0
22348,2,3,78371,78373,78376,2,5,0
22349,4,2,78375,78376,78378,1,3,0
22350,6,1,78381,78381,78382,0,1,3
22351,2,3,78383,78383,78386,0,3,1
22352,5,3,78388,78388,78391,0,3,2
22353,6,2,78394,78394,78396,0,2,3
22354,3,2,78397,78397,78399,0,2,1
22355,2,2,78399,78399,78401,0,2,0
22356,1,2,78400,78401,78403,1,3,0
22357,3,2,78403,78403,78405,0,2,0
22358,6,2,78409,78409,78411,0,2,4
22359,4,3,78413,78413,78416,0,3,2
22360,6,3,78419,78419,78422,0,3,3
22361,6,2,78425,78425,78427,0,2,3
22362,3,1,78428,78428,78429,0,1,1
22363,2,2,78430,78430,78432,0,2,1
22364,4,3,78434,78434,78437,0,3,2
22365,4,1,78438,78438,78439,0,1,1
22366,1,2,78439,78439,78441,0,2,0
22367,4,3,78443,78443,78446,0,3,2
22368,2,1,78445,78446,78447,1,2,0
22369,6,1,78451,78451,78452,0,1,4
22370,2,3,78453,78453,78456,0,3,1
22371,5,3,78458,78458,78461,0,3,2
22372,6,2,78464,78464,78466,0,2,3
22373,2,2,78466,78466,78468,0,2,0
22374,5,1,78471,78471,78472,0,1,3
22375,4,2,78475,78475,78477,0,2,3
22376,4,2,78479,78479,78481,0,2,2
22377,5,2,78484,78484,78486,0,2,3
22378,1,3,78485,78486,78489,1,4,0
22379,4,2,78489,78489,78491,0,2,0
22380,4,2,78493,78493,78495,0,2,2
22381,3,2,78496,78496,78498,0,2,1
22382,4,1,78500,78500,78501,0,1,2
22383,1,3,78501,78501,78504,0,3,0
22384,2,3,78503,78504,78507,1,4,0
22385,4,2,78507,78507,78509,0,2,0
22386,6,3,78513,78513,78516,0,3,4
22387,2,3,78515,78516,78519,1,4,0
22388,5,1,78520,78520,78521,0,1,1
22389,1,2,78521,78521,78523,0,2,0
22390,2,3,78523,78523,78526,0,3,0
22391,5,3,78528,78528,78531,0,3,2
22392,5,1,78533,78533,78534,0,1,2
22393,2,1,78535,78535,78536,0,1,1
22394,3,2,78538,78538,78540,0,2,2
22395,5,2,78543,78543,78545,0,2,3
22396,1,2,78544,78545,78547,1,3,0
22397,6,2,78550,78550,78552,0,2,3
22398,4,3,78554,78554,78557,0,3,2
22399,2,3,78556,78557,78560,1,4,0
22400,6,3,78562,78562,78565,0,3,2
22401,1,3,78563,78565,78568,2,5,0
22402,6,1,78569,78569,78570,0,1,1
22403,1,2,78570,78570,78572,0,2,0
22404,5,2,78575,78575,78577,0,2,3
22405,5,3,78580,78580,78583,0,3,3
22406,1,3,78581,78583,78586,2,5,0
22407,2,3,78583,78586,78589,3,6,0
22408,1,1,78584,78589,78590,5,6,0
22409,4,1,78588,78590,78591,2,3,0
22410,3,3,78591,78591,78594,0,3,0
22411,2,3,78593,78594,78597,1,4,0
22412,1,2,78594,78597,78599,3,5,0
22413,3,1,78597,78599,78600,2,3,0
22414,5,1,78602,78602,78603,0,1,2
22415,3,3,78605,78605,78608,0,3,2
22416,1,2,78606,78608,78610,2,4,0
22417,2,1,78608,78610,78611,2,3,0
22418,1,3,78609,78611,78614,2,5,0
22419,3,2,78612,78614,78616,2,4,0
22420,3,1,78615,78616,78617,1,2,0
22421,6,1,78621,78621,78622,0,1,4
22422,4,3,78625,78625,78628,0,3,3
22423,6,3,78631,78631,78634,0,3,3
22424,6,1,78637,78637,78638,0,1,3
22425,1,3,78638,78638,78641,0,3,0
22426,6,1,78644,78644,78645,0,1,3
22427,3,3,78647,78647,78650,0,3,2
22428,1,1,78648,78650,78651,2,3,0
22429,4,3,78652,78652,78655,0,3,1
22430,4,2,78656,78656,78658,0,2,1
22431,2,2,78658,78658,78660,0,2,0
22432,5,3,78663,78663,78666,0,3,3
22433,5,2,78668,78668,78670,0,2,2
22434,1,1,78669,78670,78671,1,2,0
22435,6,1,78675,78675,78676,0,1,4
22436,5,2,78680,78680,78682,0,2,4
22437,6,1,78686,78686,78687,0,1,4
22438,4,2,78690,78690,78692,0,2,3
22439,3,3,78693,78693,78696,0,3,1
22440,4,3,78697,78697,78700,0,3,1
22441,1,2,78698,78700,78702,2,4,0
22442,5,3,78703,78703,78706,0,3,1
22443,1,1,78704,78706,78707,2,3,0
22444,2,2,78706,78707,78709,1,3,0
22445,4,1,78710,78710,78711,0,1,1
22446,1,2,78711,78711,78713,0,2,0
22447,5,1,78716,78716,78717,0,1,3
22448,5,2,78721,78721,78723,0,2,4
22449,3,1,78724,78724,78725,0,1,1
22450,1,1,78725,78725,78726,0,1,0
22451,1,2,78726,78726,78728,0,2,0
22452,1,1,78727,78728,78729,1,2,0
22453,4,1,78731,78731,78732,0,1,2
22454,2,3,78733,78733,78736,0,3,1
22455,4,1,78737,78737,78738,0,1,1
22456,5,1,78742,78742,78743,0,1,4
22457,4,3,78746,78746,78749,0,3,3
22458,1,2,78747,78749,78751,2,4,0
22459,4,2,78751,78751,78753,0,2,0
22460,6,2,78757,78757,78759,0,2,4
22461,6,2,78763,78763,78765,0,2,4
22462,2,2,78765,78765,78767,0,2,0
22463,2,1,78767,78767,78768,0,1,0
22464,3,1,78770,78770,78771,0,1,2
22465,3,2,78773,78773,78775,0,2,2
22466,2,2,78775,78775,78777,0,2,0
22467,2,2,78777,78777,78779,0,2,0
22468,6,1,78783,78783,78784,0,1,4
22469,6,3,78789,78789,78792,0,3,5
22470,2,3,78791,78792,78795,1,4,0
22471,5,2,78796,78796,78798,0,2,1
22472,5,1,78801,78801,78802,0,1,3
22473,6,3,78807,78807,78810,0,3,5
22474,4,1,78811,78811,78812,0,1,1
22475,4,2,78815,78815,78817,0,2,3
22476,1,3,78816,78817,78820,1,4,0
22477,4,3,78820,78820,78823,0,3,0
22478,4,1,78824,78824,78825,0,1,1
22479,3,1,78827,78827,78828,0,1,2
22480,1,1,78828,78828,78829,0,1,0
22481,6,2,78834,78834,78836,0,2,5
22482,5,1,78839,78839,78840,0,1,3
22483,1,2,78840,78840,78842,0,2,0
22484,3,1,78843,78843,78844,0,1,1
22485,1,1,78844,78844,78845,0,1,0
22486,3,1,78847,78847,78848,0,1,2
22487,4,2,78851,78851,78853,0,2,3
22488,4,3,78855,78855,78858,0,3,2
22489,2,1,78857,78858,78859,1,2,0
22490,2,1,78859,78859,78860,0,1,0
22491,6,1,78865,78865,78866,0,1,5
22492,3,1,78868,78868,78869,0,1,2
22493,5,2,78873,78873,78875,0,2,4
22494,1,2,78874,78875,78877,1,3,0
22495,2,3,78876,78877,78880,1,4,0
22496,5,2,78881,78881,78883,0,2,1
22497,4,2,78885,78885,78887,0,2,2
22498,1,2,78886,78887,78889,1,3,0
22499,3,1,78889,78889,78890,0,1,0
22500,4,3,78893,78893,78896,0,3,3
22501,5,3,78898,78898,78901,0,3,2
22502,5,3,78903,78903,78906,0,3,2
22503,6,3,78909,78909,78912,0,3,3
22504,2,3,78911,78912,78915,1,4,0
22505,2,1,78913,78915,78916,2,3,0
22506,3,3,78916,78916,78919,0,3,0
22507,4,2,78920,78920,78922,0,2,1
22508,6,1,78926,78926,78927,0,1,4
22509,6,1,78932,78932,78933,0,1,5
22510,5,1,78937,78937,78938,0,1,4
22511,1,1,78938,78938,78939,0,1,0
22512,3,1,78941,78941,78942,0,1,2
22513,2,1,78943,78943,78944,0,1,1
22514,6,2,78949,78949,78951,0,2,5
22515,3,3,78952,78952,78955,0,3,1
22516,1,3,78953,78955,78958,2,5,0
22517,2,1,78955,78958,78959,3,4,0
22518,6,3,78961,78961,78964,0,3,2
22519,3,3,78964,78964,78967,0,3,0
22520,6,2,78970,78970,78972,0,2,3
22521,1,1,78971,78972,78973,1,2,0
22522,1,3,78972,78973,78976,1,4,0
22523,4,2,78976,78976,78978,0,2,0
22524,2,3,78978,78978,78981,0,3,0
22525,2,2,78980,78981,78983,1,3,0
22526,4,1,78984,78984,78985,0,1,1
22527,4,3,78988,78988,78991,0,3,3
22528,3,2,78991,78991,78993,0,2,0
22529,1,2,78992,78993,78995,1,3,0
22530,6,2,78998,78998,79000,0,2,3
22531,6,2,79004,79004,79006,0,2,4
22532,3,2,79007,79007,79009,0,2,1
22533,4,2,79011,79011,79013,0,2,2
22534,5,3,79016,79016,79019,0,3,3
22535,4,2,79020,79020,79022,0,2,1
22536,5,3,79025,79025,79028,0,3,3
22537,4,3,79029,79029,79032,0,3,1
22538,2,3,79031,79032,79035,1,4,0
22539,2,1,79033,79035,79036,2,3,0
22540,1,1,79034,79036,79037,2,3,0
22541,3,2,79037,79037,79039,0,2,0
22542,5,2,79042,79042,79044,0,2,3
22543,2,2,79044,79044,79046,0,2,0
22544,1,2,79045,79046,79048,1,3,0
22545,5,2,79050,79050,79052,0,2,2
22546,6,3,79056,79056,79059,0,3,4
22547,2,1,79058,79059,79060,1,2,0
22548,3,1,79061,79061,79062,0,1,1
22549,5,3,79066,79066,79069,0,3,4
22550,6,3,79072,79072,79075,0,3,3
22551,1,2,79073,79075,79077,2,4,0
22552,1,3,79074,79077,79080,3,6,0
22553,6,2,79080,79080,79082,0,2,0
22554,2,3,79082,79082,79085,0,3,0
22555,1,2,79083,79085,79087,2,4,0
22556,1,2,79084,79087,79089,3,5,0
22557,2,1,79086,79089,79090,3,4,0
22558,1,2,79087,79090,79092,3,5,0
22559,1,1,79088,79092,79093,4,5,0
22560,3,3,79091,79093,79096,2,5,0
22561,3,2,79094,79096,79098,2,4,0
22562,4,2,79098,79098,79100,0,2,0
22563,1,3,79099,79100,79103,1,4,0
22564,1,2,79100,79103,79105,3,5,0
22565,1,1,79101,79105,79106,4,5,0
22566,5,1,79106,79106,79107,0,1,0
22567,3,1,79109,79109,79110,0,1,2
22568,3,1,79112,79112,79113,0,1,2
22569,4,3,79116,79116,79119,0,3,3
22570,1,2,79117,79119,79121,2,4,0
22571,1,3,79118,79121,79124,3,6,0
22572,5,1,79123,79124,79125,1,2,0
22573,1,3,79124,79125,79128,1,4,0
22574,6,2,79130,79130,79132,0,2,2
22575,3,1,79133,79133,79134,0,1,1
22576,4,3,79137,79137,79140,0,3,3
22577,2,2,79139,79140,79142,1,3,0
22578,4,1,79143,79143,79144,0,1,1
22579,5,1,79148,79148,79149,0,1,4
22580,1,1,79149,79149,79150,0,1,0
22581,4,3,79153,79153,79156,0,3,3
22582,6,1,79159,79159,79160,0,1,3
22583,5,2,79164,79164,79166,0,2,4
22584,2,2,79166,79166,79168,0,2,0
22585,6,2,79172,79172,79174,0,2,4
22586,3,3,79175,79175,79178,0,3,1
22587,6,3,79181,79181,79184,0,3,3
22588,4,3,79185,79185,79188,0,3,1
22589,2,3,79187,79188,79191,1,4,0
22590,1,3,79188,79191,79194,3,6,0
22591,5,1,79193,79194,79195,1,2,0
22592,5,2,79198,79198,79200,0,2,3
22593,2,3,79200,79200,79203,0,3,0
22594,6,1,79206,79206,79207,0,1,3
22595,3,3,79209,79209,79212,0,3,2
22596,1,3,79210,79212,79215,2,5,0
22597,3,1,79213,79215,79216,2,3,0
22598,2,2,79215,79216,79218,1,3,0
22599,1,1,79216,79218,79219,2,3,0
22600,5,1,79221,79221,79222,0,1,2
22601,2,2,79223,79223,79225,0,2,1
22602,4,1,79227,79227,79228,0,1,2
22603,4,3,79231,79231,79234,0,3,3
22604,6,2,79237,79237,79239,0,2,3
22605,3,1,79240,79240,79241,0,1,1
22606,3,3,79243,79243,79246,0,3,2
22607,1,2,79244,79246,79248,2,4,0
22608,5,3,79249,79249,79252,0,3,1
22609,5,3,79254,79254,79257,0,3,2
22610,1,2,79255,79257,79259,2,4,0
22611,1,1,79256,79259,79260,3,4,0
22612,6,1,79262,79262,79263,0,1,2
22613,5,1,79267,79267,79268,0,1,4
22614,1,1,79268,79268,79269,0,1,0
22615,5,3,79273,79273,79276,0,3,4
22616,2,3,79275,79276,79279,1,4,0
22617,1,3,79276,79279,79282,3,6,0
22618,3,2,79279,79282,79284,3,5,0
22619,6,1,79285,79285,79286,0,1,1
22620,2,1,79287,79287,79288,0,1,1
22621,5,1,79292,79292,79293,0,1,4
22622,6,3,79298,79298,79301,0,3,5
22623,3,2,79301,79301,79303,0,2,0
22624,2,1,79303,79303,79304,0,1,0
22625,6,2,79309,79309,79311,0,2,5
22626,3,1,79312,79312,79313,0,1,1
22627,3,1,79315,79315,79316,0,1,2
22628,1,3,79316,79316,79319,0,3,0
22629,3,2,79319,79319,79321,0,2,0
22630,4,3,79323,79323,79326,0,3,2
22631,4,1,79327,79327,79328,0,1,1
22632,2,1,79329,79329,79330,0,1,1
22633,3,2,79332,79332,79334,0,2,2
22634,6,2,79338,79338,79340,0,2,4
22635,1,3,79339,79340,79343,1,4,0
22636,3,3,79342,79343,79346,1,4,0
22637,2,2,79344,79346,79348,2,4,0
22638,1,1,79345,79348,79349,3,4,0
22639,6,1,79351,79351,79352,0,1,2
22640,6,1,79357,79357,79358,0,1,5
22641,1,1,79358,79358,79359,0,1,0
22642,2,1,79360,79360,79361,0,1,1
22643,5,3,79365,79365,79368,0,3,4
22644,5,1,79370,79370,79371,0,1,2
22645,2,3,79372,79372,79375,0,3,1
22646,5,2,79377,79377,79379,0,2,2
22647,6,1,79383,79383,79384,0,1,4
22648,5,2,79388,79388,79390,0,2,4
22649,3,1,79391,79391,79392,0,1,1
22650,1,1,79392,79392,79393,0,1,0
22651,2,3,79394,79394,79397,0,3,1
22652,3,2,79397,79397,79399,0,2,0
22653,5,1,79402,79402,79403,0,1,3
22654,1,3,79403,79403,79406,0,3,0
22655,4,1,79407,79407,79408,0,1,1
22656,4,2,79411,79411,79413,0,2,3
22657,1,2,79412,79413,79415,1,3,0
22658,4,3,79416,79416,79419,0,3,1
22659,5,1,79421,79421,79422,0,1,2
22660,5,2,79426,79426,79428,0,2,4
22661,2,2,79428,79428,79430,0,2,0
22662,3,1,79431,79431,79432,0,1,1
22663,2,2,79433,79433,79435,0,2,1
22664,2,1,79435,79435,79436,0,1,0
22665,5,3,79440,79440,79443,0,3,4
22666,4,2,79444,79444,79446,0,2,1
22667,1,2,79445,79446,79448,1,3,0
22668,3,3,79448,79448,79451,0,3,0
22669,6,2,79454,79454,79456,0,2,3
22670,1,1,79455,79456,79457,1,2,0
22671,2,1,79457,79457,79458,0,1,0
22672,1,3,79458,79458,79461,0,3,0
22673,2,2,79460,79461,79463,1,3,0
22674,4,3,79464,79464,79467,0,3,1
22675,1,2,79465,79467,79469,2,4,0
22676,2,1,79467,79469,79470,2,3,0
22677,4,3,79471,79471,79474,0,3,1
22678,4,3,79475,79475,79478,0,3,1
22679,1,2,79476,79478,79480,2,4,0
22680,1,2,79477,79480,79482,3,5,0
22681,1,3,79478,79482,79485,4,7,0
22682,2,3,79480,79485,79488,5,8,0
22683,3,1,79483,79488,79489,5,6,0
22684,3,3,79486,79489,79492,3,6,0
22685,6,2,79492,79492,79494,0,2,0
22686,1,1,79493,79494,79495,1,2,0
22687,6,3,79499,79499,79502,0,3,4
22688,5,2,79504,79504,79506,0,2,2
22689,5,2,79509,79509,79511,0,2,3
22690,3,2,79512,79512,79514,0,2,1
22691,4,2,79516,79516,79518,0,2,2
22692,6,1,79522,79522,79523,0,1,4
22693,4,1,79526,79526,79527,0,1,3
22694,6,1,79532,79532,79533,0,1,5
22695,3,1,79535,79535,79536,0,1,2
22696,4,1,79539,79539,79540,0,1,3
22697,3,3,79542,79542,79545,0,3,2
22698,2,3,79544,79545,79548,1,4,0
22699,1,2,79545,79548,79550,3,5,0
22700,3,1,79548,79550,79551,2,3,0
22701,4,3,79552,79552,79555,0,3,1
22702,1,3,79553,79555,79558,2,5,0
22703,5,1,79558,79558,79559,0,1,0
22704,1,2,79559,79559,79561,0,2,0
22705,5,1,79564,79564,79565,0,1,3
22706,3,2,79567,79567,79569,0,2,2
22707,1,2,79568,79569,79571,1,3,0
22708,3,2,79571,79571,79573,0,2,0
22709,3,2,79574,79574,79576,0,2,1
22710,6,1,79580,79580,79581,0,1,4
22711,6,2,79586,79586,79588,0,2,5
22712,2,3,79588,79588,79591,0,3,0
22713,2,2,79590,79591,79593,1,3,0
22714,2,1,79592,79593,79594,1,2,0
22715,3,2,79595,79595,79597,0,2,1
22716,5,3,79600,79600,79603,0,3,3
22717,2,3,79602,79603,79606,1,4,0
22718,3,2,79605,79606,79608,1,3,0
22719,5,2,79610,79610,79612,0,2,2
22720,3,2,79613,79613,79615,0,2,1
22721,4,2,79617,79617,79619,0,2,2
22722,4,3,79621,79621,79624,0,3,2
22723,4,1,79625,79625,79626,0,1,1
22724,3,3,79628,79628,79631,0,3,2
22725,5,3,79633,79633,79636,0,3,2
22726,3,1,79636,79636,79637,0,1,0
22727,3,3,79639,79639,79642,0,3,2
22728,3,1,79642,79642,79643,0,1,0
22729,6,2,79648,79648,79650,0,2,5
22730,4,2,79652,79652,79654,0,2,2
22731,5,3,79657,79657,79660,0,3,3
22732,4,1,79661,79661,79662,0,1,1
22733,6,1,79667,79667,79668,0,1,5
22734,1,2,79668,79668,79670,0,2,0
22735,4,3,79672,79672,79675,0,3,2
22736,1,1,79673,79675,79676,2,3,0
22737,6,2,79679,79679,79681,0,2,3
22738,5,1,79684,79684,79685,0,1,3
22739,6,3,79690,79690,79693,0,3,5
22740,3,3,79693,79693,79696,0,3,0
22741,5,1,79698,79698,79699,0,1,2
22742,2,3,79700,79700,79703,0,3,1
22743,1,2,79701,79703,79705,2,4,0
22744,4,3,79705,79705,79708,0,3,0
22745,4,1,79709,79709,79710,0,1,1
22746,6,1,79715,79715,79716,0,1,5
22747,5,1,79720,79720,79721,0,1,4
22748,1,1,79721,79721,79722,0,1,0
22749,6,3,79727,79727,79730,0,3,5
22750,3,2,79730,79730,79732,0,2,0
22751,4,2,79734,79734,79736,0,2,2
22752,5,1,79739,79739,79740,0,1,3
22753,4,1,79743,79743,79744,0,1,3
22754,5,3,79748,79748,79751,0,3,4
22755,1,3,79749,79751,79754,2,5,0
22756,1,3,79750,79754,79757,4,7,0
22757,2,2,79752,79757,79759,5,7,0
22758,5,1,79757,79759,79760,2,3,0
22759,2,2,79759,79760,79762,1,3,0
22760,1,1,79760,79762,79763,2,3,0
22761,5,2,79765,79765,79767,0,2,2
22762,6,1,79771,79771,79772,0,1,4
22763,2,2,79773,79773,79775,0,2,1
22764,3,2,79776,79776,79778,0,2,1
22765,5,1,79781,79781,79782,0,1,3
22766,6,3,79787,79787,79790,0,3,5
22767,4,1,79791,79791,79792,0,1,1
22768,1,2,79792,79792,79794,0,2,0
22769,3,3,79795,79795,79798,0,3,1
22770,3,1,79798,79798,79799,0,1,0
22771,2,1,79800,79800,79801,0,1,1
22772,4,1,79804,79804,79805,0,1,3
22773,1,3,79805,79805,79808,0,3,0
22774,5,3,79810,79810,79813,0,3,2
22775,1,1,79811,79813,79814,2,3,0
22776,2,1,79813,79814,79815,1,2,0
22777,6,3,79819,79819,79822,0,3,4
22778,2,3,79821,79822,79825,1,4,0
22779,4,3,79825,79825,79828,0,3,0
22780,6,3,79831,79831,79834,0,3,3
22781,3,1,79834,79834,79835,0,1,0
22782,1,3,79835,79835,79838,0,3,0
22783,3,1,79838,79838,79839,0,1,0
22784,5,2,79843,79843,79845,0,2,4
22785,6,2,79849,79849,79851,0,2,4
22786,3,1,79852,79852,79853,0,1,1
22787,4,3,79856,79856,79859,0,3,3
22788,1,2,79857,79859,79861,2,4,0
22789,4,2,79861,79861,79863,0,2,0
22790,2,3,79863,79863,79866,0,3,0
22791,5,1,79868,79868,79869,0,1,2
22792,4,2,79872,79872,79874,0,2,3
22793,6,3,79878,79878,79881,0,3,4
22794,1,3,79879,79881,79884,2,5,0
22795,4,3,79883,79884,79887,1,4,0
22796,6,3,79889,79889,79892,0,3,2
22797,1,3,79890,79892,79895,2,5,0
22798,6,1,79896,79896,79897,0,1,1
22799,5,1,79901,79901,79902,0,1,4
22800,2,1,79903,79903,79904,0,1,1
22801,3,3,79906,79906,79909,0,3,2
22802,6,1,79912,79912,79913,0,1,3
22803,1,3,79913,79913,79916,0,3,0
22804,1,3,79914,79916,79919,2,5,0
22805,2,1,79916,79919,79920,3,4,0
22806,4,1,79920,79920,79921,0,1,0
22807,1,2,79921,79921,79923,0,2,0
22808,6,2,79927,79927,79929,0,2,4
22809,6,2,79933,79933,79935,0,2,4
22810,4,3,79937,79937,79940,0,3,2
22811,2,3,79939,79940,79943,1,4,0
22812,4,3,79943,79943,79946,0,3,0
22813,5,1,79948,79948,79949,0,1,2
22814,2,3,79950,79950,79953,0,3,1
22815,2,1,79952,79953,79954,1,2,0
22816,6,3,79958,79958,79961,0,3,4
22817,6,1,79964,79964,79965,0,1,3
22818,4,2,79968,79968,79970,0,2,3
22819,1,2,79969,79970,79972,1,3,0
22820,4,1,79973,79973,79974,0,1,1
22821,6,2,79979,79979,79981,0,2,5
22822,2,2,79981,79981,79983,0,2,0
22823,2,2,79983,79983,79985,0,2,0
22824,2,1,79985,79985,79986,0,1,0
22825,3,2,79988,79988,79990,0,2,2
22826,2,3,79990,79990,79993,0,3,0
22827,3,2,79993,79993,79995,0,2,0
22828,3,1,79996,79996,79997,0,1,1
22829,5,1,80001,80001,80002,0,1,4
22830,6,2,80007,80007,80009,0,2,5
22831,5,1,80012,80012,80013,0,1,3
22832,5,3,80017,80017,80020,0,3,4
22833,6,3,80023,80023,80026,0,3,3
22834,5,1,80028,80028,80029,0,1,2
22835,6,2,80034,80034,80036,0,2,5
22836,4,1,80038,80038,80039,0,1,2
22837,6,2,80044,80044,80046,0,2,5
22838,5,1,80049,80049,80050,0,1,3
22839,4,1,80053,80053,80054,0,1,3
22840,5,1,80058,80058,80059,0,1,4
22841,4,3,80062,80062,80065,0,3,3
22842,2,1,80064,80065,80066,1,2,0
22843,6,3,80070,80070,80073,0,3,4
22844,6,3,80076,80076,80079,0,3,3
22845,4,2,80080,80080,80082,0,2,1
22846,1,1,80081,80082,80083,1,2,0
22847,2,3,80083,80083,80086,0,3,0
22848,6,2,80089,80089,80091,0,2,3
22849,4,3,80093,80093,80096,0,3,2
22850,2,2,80095,80096,80098,1,3,0
22851,5,3,80100,80100,80103,0,3,2
22852,5,3,80105,80105,80108,0,3,2
22853,2,3,80107,80108,80111,1,4,0
22854,2,3,80109,80111,80114,2,5,0
22855,5,1,80114,80114,80115,0,1,0
22856,5,2,80119,80119,80121,0,2,4
22857,4,3,80123,80123,80126,0,3,2
22858,1,3,80124,80126,80129,2,5,0
22859,2,2,80126,80129,80131,3,5,0
22860,6,3,80132,80132,80135,0,3,1
22861,5,2,80137,80137,80139,0,2,2
22862,4,1,80141,80141,80142,0,1,2
22863,1,3,80142,80142,80145,0,3,0
22864,1,1,80143,80145,80146,2,3,0
22865,1,1,80144,80146,80147,2,3,0
22866,4,2,80148,80148,80150,0,2,1
22867,6,3,80154,80154,80157,0,3,4
22868,2,2,80156,80157,80159,1,3,0
22869,3,1,80159,80159,80160,0,1,0
22870,2,1,80161,80161,80162,0,1,1
22871,6,2,80167,80167,80169,0,2,5
22872,5,3,80172,80172,80175,0,3,3
22873,3,3,80175,80175,80178,0,3,0
22874,1,3,80176,80178,80181,2,5,0
22875,2,2,80178,80181,80183,3,5,0
22876,6,1,80184,80184,80185,0,1,1
22877,3,2,80187,80187,80189,0,2,2
22878,5,1,80192,80192,80193,0,1,3
22879,1,2,80193,80193,80195,0,2,0
22880,3,2,80196,80196,80198,0,2,1
22881,6,3,80202,80202,80205,0,3,4
22882,6,3,80208,80208,80211,0,3,3
22883,6,3,80214,80214,80217,0,3,3
22884,4,1,80218,80218,80219,0,1,1
22885,4,3,80222,80222,80225,0,3,3
22886,1,1,80223,80225,80226,2,3,0
22887,3,3,80226,80226,80229,0,3,0
22888,3,1,80229,80229,80230,0,1,0
22889,4,1,80233,80233,80234,0,1,3
22890,1,2,80234,80234,80236,0,2,0
22891,4,2,80238,80238,80240,0,2,2
22892,4,3,80242,80242,80245,0,3,2
22893,2,3,80244,80245,80248,1,4,0
22894,2,2,80246,80248,80250,2,4,0
22895,3,1,80249,80250,80251,1,2,0
22896,1,2,80250,80251,80253,1,3,0
22897,1,1,80251,80253,80254,2,3,0
22898,4,3,80255,80255,80258,0,3,1
22899,6,3,80261,80261,80264,0,3,3
22900,1,3,80262,80264,80267,2,5,0
22901,3,3,80265,80267,80270,2,5,0
22902,6,2,80271,80271,80273,0,2,1
22903,5,1,80276,80276,80277,0,1,3
22904,6,3,80282,80282,80285,0,3,5
22905,5,1,80287,80287,80288,0,1,2
22906,3,3,80290,80290,80293,0,3,2
22907,6,2,80296,80296,80298,0,2,3
22908,5,1,80301,80301,80302,0,1,3
22909,5,1,80306,80306,80307,0,1,4
22910,3,1,80309,80309,80310,0,1,2
22911,1,1,80310,80310,80311,0,1,0
22912,3,1,80313,80313,80314,0,1,2
22913,3,1,80316,80316,80317,0,1,2
22914,6,2,80322,80322,80324,0,2,5
22915,1,3,80323,80324,80327,1,4,0
22916,2,1,80325,80327,80328,2,3,0
22917,1,2,80326,80328,80330,2,4,0
22918,1,2,80327,80330,80332,3,5,0
22919,5,3,80332,80332,80335,0,3,0
22920,3,2,80335,80335,80337,0,2,0
22921,4,3,80339,80339,80342,0,3,2
22922,2,2,80341,80342,80344,1,3,0
22923,5,3,80346,80346,80349,0,3,2
22924,6,3,80352,80352,80355,0,3,3
22925,5,3,80357,80357,80360,0,3,2
22926,4,3,80361,80361,80364,0,3,1
22927,2,1,80363,80364,80365,1,2,0
22928,3,1,80366,80366,80367,0,1,1
22929,3,1,80369,80369,80370,0,1,2
22930,1,2,80370,80370,80372,0,2,0
22931,3,2,80373,80373,80375,0,2,1
22932,5,1,80378,80378,80379,0,1,3
22933,6,2,80384,80384,80386,0,2,5
22934,3,1,80387,80387,80388,0,1,1
22935,2,1,80389,80389,80390,0,1,1
22936,5,1,80394,80394,80395,0,1,4
22937,4,3,80398,80398,80401,0,3,3
22938,2,3,80400,80401,80404,1,4,0
22939,2,3,80402,80404,80407,2,5,0
22940,3,1,80405,80407,80408,2,3,0
22941,3,3,80408,80408,80411,0,3,0
22942,1,1,80409,80411,80412,2,3,0
22943,5,3,80414,80414,80417,0,3,2
22944,6,2,80420,80420,80422,0,2,3
22945,4,3,80424,80424,80427,0,3,2
22946,2,3,80426,80427,80430,1,4,0
22947,5,1,80431,80431,80432,0,1,1
22948,5,2,80436,80436,80438,0,2,4
22949,6,2,80442,80442,80444,0,2,4
22950,1,2,80443,80444,80446,1,3,0
22951,2,2,80445,80446,80448,1,3,0
22952,5,2,80450,80450,80452,0,2,2
22953,4,1,80454,80454,80455,0,1,2
22954,2,3,80456,80456,80459,0,3,1
22955,3,1,80459,80459,80460,0,1,0
22956,1,1,80460,80460,80461,0,1,0
22957,4,2,80464,80464,80466,0,2,3
22958,4,2,80468,80468,80470,0,2,2
22959,2,2,80470,80470,80472,0,2,0
22960,4,2,80474,80474,80476,0,2,2
22961,5,1,80479,80479,80480,0,1,3
22962,4,1,80483,80483,80484,0,1,3
22963,2,3,80485,80485,80488,0,3,1
22964,4,1,80489,80489,80490,0,1,1
22965,5,3,80494,80494,80497,0,3,4
22966,5,1,80499,80499,80500,0,1,2
22967,1,2,80500,80500,80502,0,2,0
22968,3,2,80503,80503,80505,0,2,1
22969,1,2,80504,80505,80507,1,3,0
22970,5,2,80509,80509,80511,0,2,2
22971,2,3,80511,80511,80514,0,3,0
22972,1,1,80512,80514,80515,2,3,0
22973,1,3,80513,80515,80518,2,5,0
22974,4,2,80517,80518,80520,1,3,0
22975,4,1,80521,80521,80522,0,1,1
22976,4,2,80525,80525,80527,0,2,3
22977,1,2,80526,80527,80529,1,3,0
22978,5,1,80531,80531,80532,0,1,2
22979,5,1,80536,80536,80537,0,1,4
22980,6,2,80542,80542,80544,0,2,5
22981,5,3,80547,80547,80550,0,3,3
22982,5,2,80552,80552,80554,0,2,2
22983,4,3,80556,80556,80559,0,3,2
22984,3,3,80559,80559,80562,0,3,0
22985,5,3,80564,80564,80567,0,3,2
22986,1,3,80565,80567,80570,2,5,0
22987,2,1,80567,80570,80571,3,4,0
22988,3,1,80570,80571,80572,1,2,0
22989,3,1,80573,80573,80574,0,1,1
22990,1,1,80574,80574,80575,0,1,0
22991,5,1,80579,80579,80580,0,1,4
22992,4,1,80583,80583,80584,0,1,3
22993,3,2,80586,80586,80588,0,2,2
22994,2,3,80588,80588,80591,0,3,0
22995,4,2,80592,80592,80594,0,2,1
22996,1,3,80593,80594,80597,1,4,0
22997,4,2,80597,80597,80599,0,2,0
22998,3,2,80600,80600,80602,0,2,1
22999,3,1,80603,80603,80604,0,1,1
23000,5,3,80608,80608,80611,0,3,4
23001,5,2,80613,80613,80615,0,2,2
23002,1,2,80614,80615,80617,1,3,0
23003,4,2,80618,80618,80620,0,2,1
23004,2,3,80620,80620,80623,0,3,0
23005,3,2,80623,80623,80625,0,2,0
23006,5,3,80628,80628,80631,0,3,3
23007,2,2,80630,80631,80633,1,3,0
23008,1,1,80631,80633,80634,2,3,0
23009,5,1,80636,80636,80637,0,1,2
23010,5,3,80641,80641,80644,0,3,4
23011,2,1,80643,80644,80645,1,2,0
23012,2,3,80645,80645,80648,0,3,0
23013,2,2,80647,80648,80650,1,3,0
23014,5,1,80652,80652,80653,0,1,2
23015,6,2,80658,80658,80660,0,2,5
23016,1,3,80659,80660,80663,1,4,0
23017,2,3,80661,80663,80666,2,5,0
23018,4,1,80665,80666,80667,1,2,0
23019,4,3,80669,80669,80672,0,3,2
23020,5,2,80674,80674,80676,0,2,2
23021,5,2,80679,80679,80681,0,2,3
23022,3,3,80682,80682,80685,0,3,1
23023,1,3,80683,80685,80688,2,5,0
23024,1,1,80684,80688,80689,4,5,0
23025,5,1,80689,80689,80690,0,1,0
23026,4,3,80693,80693,80696,0,3,3
23027,2,3,80695,80696,80699,1,4,0
23028,4,3,80699,80699,80702,0,3,0
23029,6,3,80705,80705,80708,0,3,3
23030,4,3,80709,80709,80712,0,3,1
23031,2,1,80711,80712,80713,1,2,0
23032,4,3,80715,80715,80718,0,3,2
23033,6,1,80721,80721,80722,0,1,3
23034,6,3,80727,80727,80730,0,3,5
23035,6,1,80733,80733,80734,0,1,3
23036,4,3,80737,80737,80740,0,3,3
23037,1,1,80738,80740,80741,2,3,0
23038,3,1,80741,80741,80742,0,1,0
23039,4,1,80745,80745,80746,0,1,3
23040,6,1,80751,80751,80752,0,1,5
23041,2,1,80753,80753,80754,0,1,1
23042,3,1,80756,80756,80757,0,1,2
23043,1,3,80757,80757,80760,0,3,0
23044,5,3,80762,80762,80765,0,3,2
23045,1,3,80763,80765,80768,2,5,0
23046,2,3,80765,80768,80771,3,6,0
23047,4,1,80769,80771,80772,2,3,0
23048,1,2,80770,80772,80774,2,4,0
23049,1,2,80771,80774,80776,3,5,0
23050,3,2,80774,80776,80778,2,4,0
23051,3,1,80777,80778,80779,1,2,0
23052,4,1,80781,80781,80782,0,1,2
23053,5,2,80786,80786,80788,0,2,4
23054,5,1,80791,80791,80792,0,1,3
23055,3,2,80794,80794,80796,0,2,2
23056,3,1,80797,80797,80798,0,1,1
23057,3,2,80800,80800,80802,0,2,2
23058,3,1,80803,80803,80804,0,1,1
23059,4,1,80807,80807,80808,0,1,3
23060,2,1,80809,80809,80810,0,1,1
23061,4,2,80813,80813,80815,0,2,3
23062,3,1,80816,80816,80817,0,1,1
23063,1,3,80817,80817,80820,0,3,0
23064,3,3,80820,80820,80823,0,3,0
23065,5,2,80825,80825,80827,0,2,2
23066,1,3,80826,80827,80830,1,4,0
23067,2,3,80828,80830,80833,2,5,0
23068,6,3,80834,80834,80837,0,3,1
23069,5,1,80839,80839,80840,0,1,2
23070,1,2,80840,80840,80842,0,2,0
23071,3,1,80843,80843,80844,0,1,1
23072,5,3,80848,80848,80851,0,3,4
23073,5,1,80853,80853,80854,0,1,2
23074,1,1,80854,80854,80855,0,1,0
23075,4,1,80858,80858,80859,0,1,3
23076,2,2,80860,80860,80862,0,2,1
23077,4,3,80864,80864,80867,0,3,2
23078,5,1,80869,80869,80870,0,1,2
23079,5,2,80874,80874,80876,0,2,4
23080,6,3,80880,80880,80883,0,3,4
23081,3,1,80883,80883,80884,0,1,0
23082,3,1,80886,80886,80887,0,1,2
23083,1,1,80887,80887,80888,0,1,0
23084,3,1,80890,80890,80891,0,1,2
23085,5,2,80895,80895,80897,0,2,4
23086,3,1,80898,80898,80899,0,1,1
23087,4,2,80902,80902,80904,0,2,3
23088,4,3,80906,80906,80909,0,3,2
23089,6,3,80912,80912,80915,0,3,3
23090,6,3,80918,80918,80921,0,3,3
23091,3,1,80921,80921,80922,0,1,0
23092,5,3,80926,80926,80929,0,3,4
23093,4,3,80930,80930,80933,0,3,1
23094,5,3,80935,80935,80938,0,3,2
23095,4,2,80939,80939,80941,0,2,1
23096,1,2,80940,80941,80943,1,3,0
23097,4,3,80944,80944,80947,0,3,1
23098,5,2,80949,80949,80951,0,2,2
23099,2,2,80951,80951,80953,0,2,0
23100,5,3,80956,80956,80959,0,3,3
23101,2,2,80958,80959,80961,1,3,0
23102,6,2,80964,80964,80966,0,2,3
23103,1,1,80965,80966,80967,1,2,0
23104,2,1,80967,80967,80968,0,1,0
23105,2,2,80969,80969,80971,0,2,1
23106,3,1,80972,80972,80973,0,1,1
23107,3,3,80975,80975,80978,0,3,2
23108,4,2,80979,80979,80981,0,2,1
23109,2,1,80981,80981,80982,0,1,0
23110,3,2,80984,80984,80986,0,2,2
23111,2,1,80986,80986,80987,0,1,0
23112,3,1,80989,80989,80990,0,1,2
23113,1,3,80990,80990,80993,0,3,0
23114,6,2,80996,80996,80998,0,2,3
23115,4,1,81000,81000,81001,0,1,2
23116,4,1,81004,81004,81005,0,1,3
23117,4,1,81008,81008,81009,0,1,3
23118,1,2,81009,81009,81011,0,2,0
23119,3,3,81012,81012,81015,0,3,1
23120,1,3,81013,81015,81018,2,5,0
23121,6,1,81019,81019,81020,0,1,1
23122,6,2,81025,81025,81027,0,2,5
23123,6,1,81031,81031,81032,0,1,4
23124,1,2,81032,81032,81034,0,2,0
23125,6,2,81038,81038,81040,0,2,4
23126,1,3,81039,81040,81043,1,4,0
23127,4,1,81043,81043,81044,0,1,0
23128,2,3,81045,81045,81048,0,3,1
23129,4,3,81049,81049,81052,0,3,1
23130,2,2,81051,81052,81054,1,3,0
23131,1,3,81052,81054,81057,2,5,0
23132,1,1,81053,81057,81058,4,5,0
23133,3,2,81056,81058,81060,2,4,0
23134,3,3,81059,81060,81063,1,4,0
23135,2,2,81061,81063,81065,2,4,0
23136,6,1,81067,81067,81068,0,1,2
23137,4,1,81071,81071,81072,0,1,3
23138,2,1,81073,81073,81074,0,1,1
23139,1,1,81074,81074,81075,0,1,0
23140,2,1,81076,81076,81077,0,1,1
23141,4,1,81080,81080,81081,0,1,3
23142,2,3,81082,81082,81085,0,3,1
23143,5,1,81087,81087,81088,0,1,2
23144,6,2,81093,81093,81095,0,2,5
23145,2,2,81095,81095,81097,0,2,0
23146,3,1,81098,81098,81099,0,1,1
23147,3,3,81101,81101,81104,0,3,2
23148,2,2,81103,81104,81106,1,3,0
23149,2,2,81105,81106,81108,1,3,0
23150,1,1,81106,81108,81109,2,3,0
23151,3,1,81109,81109,81110,0,1,0
23152,3,2,81112,81112,81114,0,2,2
23153,6,2,81118,81118,81120,0,2,4
23154,1,2,81119,81120,81122,1,3,0
23155,4,3,81123,81123,81126,0,3,1
23156,1,3,81124,81126,81129,2,5,0
23157,6,3,81130,81130,81133,0,3,1
23158,6,1,81136,81136,81137,0,1,3
23159,3,1,81139,81139,81140,0,1,2
23160,6,1,81145,81145,81146,0,1,5
23161,5,3,81150,81150,81153,0,3,4
23162,1,1,81151,81153,81154,2,3,0
23163,1,1,81152,81154,81155,2,3,0
23164,2,2,81154,81155,81157,1,3,0
23165,1,2,81155,81157,81159,2,4,0
23166,3,2,81158,81159,81161,1,3,0
23167,2,3,81160,81161,81164,1,4,0
23168,4,3,81164,81164,81167,0,3,0
23169,1,3,81165,81167,81170,2,5,0
23170,3,3,81168,81170,81173,2,5,0
23171,3,3,81171,81173,81176,2,5,0
23172,2,1,81173,81176,81177,3,4,0
23173,1,1,81174,81177,81178,3,4,0
23174,5,1,81179,81179,81180,0,1,1
23175,2,2,81181,81181,81183,0,2,1
23176,6,3,81187,81187,81190,0,3,4
23177,2,1,81189,81190,81191,1,2,0
23178,1,1,81190,81191,81192,1,2,0
23179,4,2,81194,81194,81196,0,2,2
23180,3,3,81197,81197,81200,0,3,1
23181,3,2,81200,81200,81202,0,2,0
23182,6,3,81206,81206,81209,0,3,4
23183,6,3,81212,81212,81215,0,3,3
23184,1,1,81213,81215,81216,2,3,0
23185,2,3,81215,81216,81219,1,4,0
23186,1,3,81216,81219,81222,3,6,0
23187,3,3,81219,81222,81225,3,6,0
23188,3,2,81222,81225,81227,3,5,0
23189,6,1,81228,81228,81229,0,1,1
23190,3,3,81231,81231,81234,0,3,2
23191,3,3,81234,81234,81237,0,3,0
23192,3,2,81237,81237,81239,0,2,0
23193,2,3,81239,81239,81242,0,3,0
23194,3,2,81242,81242,81244,0,2,0
23195,5,1,81247,81247,81248,0,1,3
23196,6,2,81253,81253,81255,0,2,5
23197,1,3,81254,81255,81258,1,4,0
23198,3,1,81257,81258,81259,1,2,0
23199,6,2,81263,81263,81265,0,2,4
23200,2,1,81265,81265,81266,0,1,0
23201,1,2,81266,81266,81268,0,2,0
23202,1,1,81267,81268,81269,1,2,0
23203,3,3,81270,81270,81273,0,3,1
23204,1,2,81271,81273,81275,2,4,0
23205,4,1,81275,81275,81276,0,1,0
23206,2,3,81277,81277,81280,0,3,1
23207,4,1,81281,81281,81282,0,1,1
23208,5,2,81286,81286,81288,0,2,4
23209,5,3,81291,81291,81294,0,3,3
23210,4,2,81295,81295,81297,0,2,1
23211,6,3,81301,81301,81304,0,3,4
23212,4,2,81305,81305,81307,0,2,1
23213,6,1,81311,81311,81312,0,1,4
23214,2,2,81313,81313,81315,0,2,1
23215,4,2,81317,81317,81319,0,2,2
23216,5,2,81322,81322,81324,0,2,3
23217,2,2,81324,81324,81326,0,2,0
23218,1,3,81325,81326,81329,1,4,0
23219,5,3,81330,81330,81333,0,3,1
23220,2,2,81332,81333,81335,1,3,0
23221,6,1,81338,81338,81339,0,1,3
23222,2,2,81340,81340,81342,0,2,1
23223,6,1,81346,81346,81347,0,1,4
23224,1,3,81347,81347,81350,0,3,0
23225,6,3,81353,81353,81356,0,3,3
23226,4,3,81357,81357,81360,0,3,1
23227,4,3,81361,81361,81364,0,3,1
23228,5,1,81366,81366,81367,0,1,2
23229,5,3,81371,81371,81374,0,3,4
23230,4,1,81375,81375,81376,0,1,1
23231,5,1,81380,81380,81381,0,1,4
23232,3,3,81383,81383,81386,0,3,2
23233,2,2,81385,81386,81388,1,3,0
23234,6,3,81391,81391,81394,0,3,3
23235,5,3,81396,81396,81399,0,3,2
23236,3,1,81399,81399,81400,0,1,0
23237,1,3,81400,81400,81403,0,3,0
23238,4,3,81404,81404,81407,0,3,1
23239,4,2,81408,81408,81410,0,2,1
23240,1,1,81409,81410,81411,1,2,0
23241,5,3,81414,81414,81417,0,3,3
23242,1,3,81415,81417,81420,2,5,0
23243,5,1,81420,81420,81421,0,1,0
23244,1,2,81421,81421,81423,0,2,0
23245,4,2,81425,81425,81427,0,2,2
23246,5,3,81430,81430,81433,0,3,3
23247,3,3,81433,81433,81436,0,3,0
23248,1,1,81434,81436,81437,2,3,0
23249,1,2,81435,81437,81439,2,4,0
23250,2,2,81437,81439,81441,2,4,0
23251,1,2,81438,81441,81443,3,5,0
23252,5,3,81443,81443,81446,0,3,0
23253,4,1,81447,81447,81448,0,1,1
23254,2,3,81449,81449,81452,0,3,1
23255,2,1,81451,81452,81453,1,2,0
23256,6,2,81457,81457,81459,0,2,4
23257,6,1,81463,81463,81464,0,1,4
23258,2,2,81465,81465,81467,0,2,1
23259,3,3,81468,81468,81471,0,3,1
23260,3,3,81471,81471,81474,0,3,0
23261,3,2,81474,81474,81476,0,2,0
23262,3,1,81477,81477,81478,0,1,1
23263,4,3,81481,81481,81484,0,3,3
23264,1,2,81482,81484,81486,2,4,0
23265,2,3,81484,81486,81489,2,5,0
23266,6,1,81490,81490,81491,0,1,1
23267,4,1,81494,81494,81495,0,1,3
23268,4,1,81498,81498,81499,0,1,3
23269,4,2,81502,81502,81504,0,2,3
23270,1,2,81503,81504,81506,1,3,0
23271,4,3,81507,81507,81510,0,3,1
23272,1,2,81508,81510,81512,2,4,0
23273,4,2,81512,81512,81514,0,2,0
23274,6,2,81518,81518,81520,0,2,4
23275,2,3,81520,81520,81523,0,3,0
23276,5,1,81525,81525,81526,0,1,2
23277,2,3,81527,81527,81530,0,3,1
23278,4,2,81531,81531,81533,0,2,1
23279,1,2,81532,81533,81535,1,3,0
23280,4,3,81536,81536,81539,0,3,1
23281,1,3,81537,81539,81542,2,5,0
23282,3,2,81540,81542,81544,2,4,0
23283,3,1,81543,81544,81545,1,2,0
23284,2,1,81545,81545,81546,0,1,0
23285,2,3,81547,81547,81550,0,3,1
23286,6,3,81553,81553,81556,0,3,3
23287,3,2,81556,81556,81558,0,2,0
23288,5,2,81561,81561,81563,0,2,3
23289,6,3,81567,81567,81570,0,3,4
23290,3,1,81570,81570,81571,0,1,0
23291,6,2,81576,81576,81578,0,2,5
23292,3,1,81579,81579,81580,0,1,1
23293,6,2,81585,81585,81587,0,2,5
23294,3,3,81588,81588,81591,0,3,1
23295,2,1,81590,81591,81592,1,2,0
23296,5,2,81595,81595,81597,0,2,3
23297,5,2,81600,81600,81602,0,2,3
23298,1,3,81601,81602,81605,1,4,0
23299,3,1,81604,81605,81606,1,2,0
23300,4,3,81608,81608,81611,0,3,2
23301,4,1,81612,81612,81613,0,1,1
23302,5,1,81617,81617,81618,0,1,4
23303,3,3,81620,81620,81623,0,3,2
23304,4,3,81624,81624,81627,0,3,1
23305,1,2,81625,81627,81629,2,4,0
23306,4,2,81629,81629,81631,0,2,0
23307,1,2,81630,81631,81633,1,3,0
23308,6,3,81636,81636,81639,0,3,3
23309,6,2,81642,81642,81644,0,2,3
23310,5,1,81647,81647,81648,0,1,3
23311,3,2,81650,81650,81652,0,2,2
23312,5,2,81655,81655,81657,0,2,3
23313,1,3,81656,81657,81660,1,4,0
23314,3,3,81659,81660,81663,1,4,0
23315,1,2,81660,81663,81665,3,5,0
23316,5,2,81665,81665,81667,0,2,0
23317,2,1,81667,81667,81668,0,1,0
23318,6,1,81673,81673,81674,0,1,5
23319,6,1,81679,81679,81680,0,1,5
23320,5,1,81684,81684,81685,0,1,4
23321,2,3,81686,81686,81689,0,3,1
23322,6,1,81692,81692,81693,0,1,3
23323,5,2,81697,81697,81699,0,2,4
23324,6,2,81703,81703,81705,0,2,4
23325,3,3,81706,81706,81709,0,3,1
23326,5,1,81711,81711,81712,0,1,2
23327,6,1,81717,81717,81718,0,1,5
23328,4,3,81721,81721,81724,0,3,3
23329,5,1,81726,81726,81727,0,1,2
23330,3,2,81729,81729,81731,0,2,2
23331,2,2,81731,81731,81733,0,2,0
23332,5,1,81736,81736,81737,0,1,3
23333,3,2,81739,81739,81741,0,2,2
23334,4,1,81743,81743,81744,0,1,2
23335,2,3,81745,81745,81748,0,3,1
23336,1,3,81746,81748,81751,2,5,0
23337,3,1,81749,81751,81752,2,3,0
23338,2,1,81751,81752,81753,1,2,0
23339,6,2,81757,81757,81759,0,2,4
23340,6,3,81763,81763,81766,0,3,4
23341,2,3,81765,81766,81769,1,4,0
23342,4,1,81769,81769,81770,0,1,0
23343,3,3,81772,81772,81775,0,3,2
23344,2,1,81774,81775,81776,1,2,0
23345,4,2,81778,81778,81780,0,2,2
23346,6,2,81784,81784,81786,0,2,4
23347,2,2,81786,81786,81788,0,2,0
23348,3,2,81789,81789,81791,0,2,1
23349,2,2,81791,81791,81793,0,2,0
23350,2,3,81793,81793,81796,0,3,0
23351,5,3,81798,81798,81801,0,3,2
23352,3,3,81801,81801,81804,0,3,0
23353,6,3,81807,81807,81810,0,3,3
23354,4,1,81811,81811,81812,0,1,1
23355,4,3,81815,81815,81818,0,3,3
23356,2,2,81817,81818,81820,1,3,0
23357,4,2,81821,81821,81823,0,2,1
23358,6,3,81827,81827,81830,0,3,4
23359,5,1,81832,81832,81833,0,1,2
23360,1,2,81833,81833,81835,0,2,0
23361,1,3,81834,81835,81838,1,4,0
23362,4,1,81838,81838,81839,0,1,0
23363,2,2,81840,81840,81842,0,2,1
23364,5,2,81845,81845,81847,0,2,3
23365,3,1,81848,81848,81849,0,1,1
23366,4,1,81852,81852,81853,0,1,3
23367,4,2,81856,81856,81858,0,2,3
23368,5,2,81861,81861,81863,0,2,3
23369,6,3,81867,81867,81870,0,3,4
23370,5,1,81872,81872,81873,0,1,2
23371,2,1,81874,81874,81875,0,1,1
23372,4,1,81878,81878,81879,0,1,3
23373,3,3,81881,81881,81884,0,3,2
23374,5,2,81886,81886,81888,0,2,2
23375,1,3,81887,81888,81891,1,4,0
23376,3,3,81890,81891,81894,1,4,0
23377,6,1,81896,81896,81897,0,1,2
23378,1,2,81897,81897,81899,0,2,0
23379,2,1,81899,81899,81900,0,1,0
23380,6,2,81905,81905,81907,0,2,5
23381,4,3,81909,81909,81912,0,3,2
23382,2,1,81911,81912,81913,1,2,0
23383,1,2,81912,81913,81915,1,3,0
23384,3,1,81915,81915,81916,0,1,0
23385,4,1,81919,81919,81920,0,1,3
23386,6,1,81925,81925,81926,0,1,5
23387,1,3,81926,81926,81929,0,3,0
23388,6,2,81932,81932,81934,0,2,3
23389,6,2,81938,81938,81940,0,2,4
23390,1,1,81939,81940,81941,1,2,0
23391,4,2,81943,81943,81945,0,2,2
23392,2,3,81945,81945,81948,0,3,0
23393,3,1,81948,81948,81949,0,1,0
23394,2,2,81950,81950,81952,0,2,1
23395,5,1,81955,81955,81956,0,1,3
23396,1,1,81956,81956,81957,0,1,0
23397,4,2,81960,81960,81962,0,2,3
23398,3,3,81963,81963,81966,0,3,1
23399,2,2,81965,81966,81968,1,3,0
23400,1,2,81966,81968,81970,2,4,0
23401,3,3,81969,81970,81973,1,4,0
23402,5,2,81974,81974,81976,0,2,1
23403,5,2,81979,81979,81981,0,2,3
23404,1,2,81980,81981,81983,1,3,0
23405,4,1,81984,81984,81985,0,1,1
23406,2,2,81986,81986,81988,0,2,1
23407,6,1,81992,81992,81993,0,1,4
23408,2,2,81994,81994,81996,0,2,1
23409,4,1,81998,81998,81999,0,1,2
23410,6,3,82004,82004,82007,0,3,5
23411,5,2,82009,82009,82011,0,2,2
23412,4,2,82013,82013,82015,0,2,2
23413,2,3,82015,82015,82018,0,3,0
23414,5,3,82020,82020,82023,0,3,2
23415,6,1,82026,82026,82027,0,1,3
23416,2,3,82028,82028,82031,0,3,1
23417,3,2,82031,82031,82033,0,2,0
23418,4,2,82035,82035,82037,0,2,2
23419,6,1,82041,82041,82042,0,1,4
23420,1,1,82042,82042,82043,0,1,0
23421,6,1,82048,82048,82049,0,1,5
23422,6,2,82054,82054,82056,0,2,5
23423,1,1,82055,82056,82057,1,2,0
23424,1,2,82056,82057,82059,1,3,0
23425,5,1,82061,82061,82062,0,1,2
23426,2,1,82063,82063,82064,0,1,1
23427,2,3,82065,82065,82068,0,3,1
23428,6,1,82071,82071,82072,0,1,3
23429,3,3,82074,82074,82077,0,3,2
23430,3,1,82077,82077,82078,0,1,0
23431,5,1,82082,82082,82083,0,1,4
23432,4,2,82086,82086,82088,0,2,3
23433,4,1,82090,82090,82091,0,1,2
23434,3,1,82093,82093,82094,0,1,2
23435,6,2,82099,82099,82101,0,2,5
23436,6,3,82105,82105,82108,0,3,4
23437,1,2,82106,82108,82110,2,4,0
23438,3,2,82109,82110,82112,1,3,0
23439,5,1,82114,82114,82115,0,1,2
23440,5,3,82119,82119,82122,0,3,4
23441,5,2,82124,82124,82126,0,2,2
23442,5,2,82129,82129,82131,0,2,3
23443,2,1,82131,82131,82132,0,1,0
23444,1,2,82132,82132,82134,0,2,0
23445,3,3,82135,82135,82138,0,3,1
23446,5,2,82140,82140,82142,0,2,2
23447,5,1,82145,82145,82146,0,1,3
23448,1,2,82146,82146,82148,0,2,0
23449,2,1,82148,82148,82149,0,1,0
23450,6,1,82154,82154,82155,0,1,5
23451,5,2,82159,82159,82161,0,2,4
23452,3,1,82162,82162,82163,0,1,1
23453,3,1,82165,82165,82166,0,1,2
23454,3,3,82168,82168,82171,0,3,2
23455,6,1,82174,82174,82175,0,1,3
23456,2,2,82176,82176,82178,0,2,1
23457,2,3,82178,82178,82181,0,3,0
23458,4,3,82182,82182,82185,0,3,1
23459,3,2,82185,82185,82187,0,2,0
23460,6,1,82191,82191,82192,0,1,4
23461,3,1,82194,82194,82195,0,1,2
23462,2,2,82196,82196,82198,0,2,1
23463,6,2,82202,82202,82204,0,2,4
23464,1,1,82203,82204,82205,1,2,0
23465,3,3,82206,82206,82209,0,3,1
23466,6,2,82212,82212,82214,0,2,3
23467,4,3,82216,82216,82219,0,3,2
23468,4,1,82220,82220,82221,0,1,1
23469,2,3,82222,82222,82225,0,3,1
23470,1,3,82223,82225,82228,2,5,0
23471,3,1,82226,82228,82229,2,3,0
23472,5,2,82231,82231,82233,0,2,2
23473,4,1,82235,82235,82236,0,1,2
23474,5,3,82240,82240,82243,0,3,4
23475,4,3,82244,82244,82247,0,3,1
23476,2,3,82246,82247,82250,1,4,0
23477,4,2,82250,82250,82252,0,2,0
23478,3,1,82253,82253,82254,0,1,1
23479,5,2,82258,82258,82260,0,2,4
23480,2,1,82260,82260,82261,0,1,0
23481,1,3,82261,82261,82264,0,3,0
23482,4,3,82265,82265,82268,0,3,1
23483,1,3,82266,82268,82271,2,5,0
23484,6,3,82272,82272,82275,0,3,1
23485,5,2,82277,82277,82279,0,2,2
23486,6,1,82283,82283,82284,0,1,4
23487,6,2,82289,82289,82291,0,2,5
23488,3,2,82292,82292,82294,0,2,1
23489,2,1,82294,82294,82295,0,1,0
23490,5,2,82299,82299,82301,0,2,4
23491,3,1,82302,82302,82303,0,1,1
23492,6,3,82308,82308,82311,0,3,5
23493,5,3,82313,82313,82316,0,3,2
23494,6,1,82319,82319,82320,0,1,3
23495,3,2,82322,82322,82324,0,2,2
23496,6,2,82328,82328,82330,0,2,4
23497,2,1,82330,82330,82331,0,1,0
23498,3,3,82333,82333,82336,0,3,2
23499,5,1,82338,82338,82339,0,1,2
23500,4,1,82342,82342,82343,0,1,3
23501,3,1,82345,82345,82346,0,1,2
23502,6,1,82351,82351,82352,0,1,5
23503,3,3,82354,82354,82357,0,3,2
23504,4,1,82358,82358,82359,0,1,1
23505,1,3,82359,82359,82362,0,3,0
23506,5,1,82364,82364,82365,0,1,2
23507,4,3,82368,82368,82371,0,3,3
23508,6,3,82374,82374,82377,0,3,3
23509,4,2,82378,82378,82380,0,2,1
23510,4,3,82382,82382,82385,0,3,2
23511,2,3,82384,82385,82388,1,4,0
23512,1,2,82385,82388,82390,3,5,0
23513,2,1,82387,82390,82391,3,4,0
23514,5,3,82392,82392,82395,0,3,1
23515,6,3,82398,82398,82401,0,3,3
23516,3,1,82401,82401,82402,0,1,0
23517,4,2,82405,82405,82407,0,2,3
23518,6,2,82411,82411,82413,0,2,4
23519,3,1,82414,82414,82415,0,1,1
23520,6,2,82420,82420,82422,0,2,5
23521,3,1,82423,82423,82424,0,1,1
23522,1,2,82424,82424,82426,0,2,0
23523,6,2,82430,82430,82432,0,2,4
23524,3,2,82433,82433,82435,0,2,1
23525,6,2,82439,82439,82441,0,2,4
23526,3,2,82442,82442,82444,0,2,1
23527,4,3,82446,82446,82449,0,3,2
23528,2,1,82448,82449,82450,1,2,0
23529,3,3,82451,82451,82454,0,3,1
23530,6,1,82457,82457,82458,0,1,3
23531,1,3,82458,82458,82461,0,3,0
23532,4,2,82462,82462,82464,0,2,1
23533,5,3,82467,82467,82470,0,3,3
23534,2,1,82469,82470,82471,1,2,0
23535,6,2,82475,82475,82477,0,2,4
23536,5,2,82480,82480,82482,0,2,3
23537,5,1,82485,82485,82486,0,1,3
23538,1,3,82486,82486,82489,0,3,0
23539,1,3,82487,82489,82492,2,5,0
23540,2,2,82489,82492,82494,3,5,0
23541,3,3,82492,82494,82497,2,5,0
23542,4,3,82496,82497,82500,1,4,0
23543,5,2,82501,82501,82503,0,2,1
23544,1,3,82502,82503,82506,1,4,0
23545,5,2,82507,82507,82509,0,2,1
23546,6,2,82513,82513,82515,0,2,4
23547,5,1,82518,82518,82519,0,1,3
23548,1,3,82519,82519,82522,0,3,0
23549,1,1,82520,82522,82523,2,3,0
23550,5,2,82525,82525,82527,0,2,2
23551,1,3,82526,82527,82530,1,4,0
23552,2,1,82528,82530,82531,2,3,0
23553,6,3,82534,82534,82537,0,3,3
23554,2,1,82536,82537,82538,1,2,0
23555,4,1,82540,82540,82541,0,1,2
23556,3,1,82543,82543,82544,0,1,2
23557,4,2,82547,82547,82549,0,2,3
23558,1,1,82548,82549,82550,1,2,0
23559,3,1,82551,82551,82552,0,1,1
23560,1,1,82552,82552,82553,0,1,0
23561,1,1,82553,82553,82554,0,1,0
23562,2,1,82555,82555,82556,0,1,1
23563,5,2,82560,82560,82562,0,2,4
23564,2,2,82562,82562,82564,0,2,0
23565,6,3,82568,82568,82571,0,3,4
23566,6,3,82574,82574,82577,0,3,3
23567,5,1,82579,82579,82580,0,1,2
23568,4,1,82583,82583,82584,0,1,3
23569,5,3,82588,82588,82591,0,3,4
23570,5,3,82593,82593,82596,0,3,2
23571,5,1,82598,82598,82599,0,1,2
23572,2,3,82600,82600,82603,0,3,1
23573,5,2,82605,82605,82607,0,2,2
23574,4,3,82609,82609,82612,0,3,2
23575,5,1,82614,82614,82615,0,1,2
23576,1,3,82615,82615,82618,0,3,0
23577,1,3,82616,82618,82621,2,5,0
23578,3,2,82619,82621,82623,2,4,0
23579,4,3,82623,82623,82626,0,3,0
23580,6,2,82629,82629,82631,0,2,3
23581,5,1,82634,82634,82635,0,1,3
23582,6,1,82640,82640,82641,0,1,5
23583,4,3,82644,82644,82647,0,3,3
23584,2,3,82646,82647,82650,1,4,0
23585,3,1,82649,82650,82651,1,2,0
23586,6,3,82655,82655,82658,0,3,4
23587,6,1,82661,82661,82662,0,1,3
23588,4,2,82665,82665,82667,0,2,3
23589,2,3,82667,82667,82670,0,3,0
23590,1,2,82668,82670,82672,2,4,0
23591,1,3,82669,82672,82675,3,6,0
23592,5,2,82674,82675,82677,1,3,0
23593,4,1,82678,82678,82679,0,1,1
23594,4,1,82682,82682,82683,0,1,3
23595,5,1,82687,82687,82688,0,1,4
23596,1,1,82688,82688,82689,0,1,0
23597,5,3,82693,82693,82696,0,3,4
23598,3,1,82696,82696,82697,0,1,0
23599,4,2,82700,82700,82702,0,2,3
23600,6,3,82706,82706,82709,0,3,4
23601,6,2,82712,82712,82714,0,2,3
23602,5,1,82717,82717,82718,0,1,3
23603,3,3,82720,82720,82723,0,3,2
23604,6,1,82726,82726,82727,0,1,3
23605,2,2,82728,82728,82730,0,2,1
23606,6,3,82734,82734,82737,0,3,4
23607,6,3,82740,82740,82743,0,3,3
23608,5,3,82745,82745,82748,0,3,2
23609,3,3,82748,82748,82751,0,3,0
23610,6,3,82754,82754,82757,0,3,3
23611,3,1,82757,82757,82758,0,1,0
23612,4,2,82761,82761,82763,0,2,3
23613,5,3,82766,82766,82769,0,3,3
23614,4,3,82770,82770,82773,0,3,1
23615,2,2,82772,82773,82775,1,3,0
23616,4,3,82776,82776,82779,0,3,1
23617,3,1,82779,82779,82780,0,1,0
23618,6,1,82785,82785,82786,0,1,5
23619,5,3,82790,82790,82793,0,3,4
23620,5,1,82795,82795,82796,0,1,2
23621,1,1,82796,82796,82797,0,1,0
23622,1,1,82797,82797,82798,0,1,0
23623,3,1,82800,82800,82801,0,1,2
23624,4,2,82804,82804,82806,0,2,3
23625,6,1,82810,82810,82811,0,1,4
23626,5,2,82815,82815,82817,0,2,4
23627,2,3,82817,82817,82820,0,3,0
23628,4,1,82821,82821,82822,0,1,1
23629,3,1,82824,82824,82825,0,1,2
23630,2,2,82826,82826,82828,0,2,1
23631,3,3,82829,82829,82832,0,3,1
23632,1,1,82830,82832,82833,2,3,0
23633,3,1,82833,82833,82834,0,1,0
23634,3,2,82836,82836,82838,0,2,2
23635,1,3,82837,82838,82841,1,4,0
23636,2,2,82839,82841,82843,2,4,0
23637,3,1,82842,82843,82844,1,2,0
23638,6,3,82848,82848,82851,0,3,4
23639,4,3,82852,82852,82855,0,3,1
23640,2,3,82854,82855,82858,1,4,0
23641,6,3,82860,82860,82863,0,3,2
23642,5,2,82865,82865,82867,0,2,2
23643,3,1,82868,82868,82869,0,1,1
23644,1,1,82869,82869,82870,0,1,0
23645,6,1,82875,82875,82876,0,1,5
23646,5,2,82880,82880,82882,0,2,4
23647,1,3,82881,82882,82885,1,4,0
23648,3,3,82884,82885,82888,1,4,0
23649,2,1,82886,82888,82889,2,3,0
23650,5,3,82891,82891,82894,0,3,2
23651,4,3,82895,82895,82898,0,3,1
23652,3,1,82898,82898,82899,0,1,0
23653,1,2,82899,82899,82901,0,2,0
23654,4,1,82903,82903,82904,0,1,2
23655,5,2,82908,82908,82910,0,2,4
23656,1,3,82909,82910,82913,1,4,0
23657,3,1,82912,82913,82914,1,2,0
23658,3,2,82915,82915,82917,0,2,1
23659,6,2,82921,82921,82923,0,2,4
23660,6,2,82927,82927,82929,0,2,4
23661,5,2,82932,82932,82934,0,2,3
23662,4,1,82936,82936,82937,0,1,2
23663,2,3,82938,82938,82941,0,3,1
23664,5,1,82943,82943,82944,0,1,2
23665,6,3,82949,82949,82952,0,3,5
23666,3,1,82952,82952,82953,0,1,0
23667,3,1,82955,82955,82956,0,1,2
23668,3,1,82958,82958,82959,0,1,2
23669,1,1,82959,82959,82960,0,1,0
23670,2,2,82961,82961,82963,0,2,1
23671,6,2,82967,82967,82969,0,2,4
23672,4,3,82971,82971,82974,0,3,2
23673,5,1,82976,82976,82977,0,1,2
23674,3,2,82979,82979,82981,0,2,2
23675,3,2,82982,82982,82984,0,2,1
23676,6,3,82988,82988,82991,0,3,4
23677,5,1,82993,82993,82994,0,1,2
23678,3,3,82996,82996,82999,0,3,2
23679,3,2,82999,82999,83001,0,2,0
23680,1,3,83000,83001,83004,1,4,0
23681,2,1,83002,83004,83005,2,3,0
23682,1,3,83003,83005,83008,2,5,0
23683,6,1,83009,83009,83010,0,1,1
23684,2,2,83011,83011,83013,0,2,1
23685,2,2,83013,83013,83015,0,2,0
23686,6,1,83019,83019,83020,0,1,4
23687,5,1,83024,83024,83025,0,1,4
23688,2,1,83026,83026,83027,0,1,1
23689,3,1,83029,83029,83030,0,1,2
23690,3,1,83032,83032,83033,0,1,2
23691,5,3,83037,83037,83040,0,3,4
23692,6,2,83043,83043,83045,0,2,3
23693,5,3,83048,83048,83051,0,3,3
23694,6,3,83054,83054,83057,0,3,3
23695,4,1,83058,83058,83059,0,1,1
23696,6,3,83064,83064,83067,0,3,5
23697,2,3,83066,83067,83070,1,4,0
23698,5,3,83071,83071,83074,0,3,1
23699,6,1,83077,83077,83078,0,1,3
23700,5,2,83082,83082,83084,0,2,4
23701,2,2,83084,83084,83086,0,2,0
23702,4,3,83088,83088,83091,0,3,2
23703,6,3,83094,83094,83097,0,3,3
23704,5,2,83099,83099,83101,0,2,2
23705,2,3,83101,83101,83104,0,3,0
23706,3,2,83104,83104,83106,0,2,0
23707,6,1,83110,83110,83111,0,1,4
23708,5,2,83115,83115,83117,0,2,4
23709,6,1,83121,83121,83122,0,1,4
23710,4,1,83125,83125,83126,0,1,3
23711,3,2,83128,83128,83130,0,2,2
23712,2,2,83130,83130,83132,0,2,0
23713,3,1,83133,83133,83134,0,1,1
23714,5,2,83138,83138,83140,0,2,4
23715,1,3,83139,83140,83143,1,4,0
23716,4,1,83143,83143,83144,0,1,0
23717,3,2,83146,83146,83148,0,2,2
23718,5,2,83151,83151,83153,0,2,3
23719,5,1,83156,83156,83157,0,1,3
23720,3,2,83159,83159,83161,0,2,2
23721,5,3,83164,83164,83167,0,3,3
23722,4,2,83168,83168,83170,0,2,1
23723,5,3,83173,83173,83176,0,3,3
23724,3,1,83176,83176,83177,0,1,0
23725,1,3,83177,83177,83180,0,3,0
23726,5,2,83182,83182,83184,0,2,2
23727,5,2,83187,83187,83189,0,2,3
23728,6,3,83193,83193,83196,0,3,4
23729,6,1,83199,83199,83200,0,1,3
23730,5,3,83204,83204,83207,0,3,4
23731,2,3,83206,83207,83210,1,4,0
23732,5,2,83211,83211,83213,0,2,1
23733,5,1,83216,83216,83217,0,1,3
23734,3,1,83219,83219,83220,0,1,2
23735,1,2,83220,83220,83222,0,2,0
23736,3,1,83223,83223,83224,0,1,1
23737,1,2,83224,83224,83226,0,2,0
23738,2,3,83226,83226,83229,0,3,0
23739,3,2,83229,83229,83231,0,2,0
23740,4,3,83233,83233,83236,0,3,2
23741,5,1,83238,83238,83239,0,1,2
23742,4,3,83242,83242,83245,0,3,3
23743,4,2,83246,83246,83248,0,2,1
23744,2,1,83248,83248,83249,0,1,0
23745,3,1,83251,83251,83252,0,1,2
23746,4,3,83255,83255,83258,0,3,3
23747,2,3,83257,83258,83261,1,4,0
23748,3,1,83260,83261,83262,1,2,0
23749,4,1,83264,83264,83265,0,1,2
23750,2,2,83266,83266,83268,0,2,1
23751,6,1,83272,83272,83273,0,1,4
23752,1,3,83273,83273,83276,0,3,0
23753,2,3,83275,83276,83279,1,4,0
23754,2,3,83277,83279,83282,2,5,0
23755,1,2,83278,83282,83284,4,6,0
23756,2,1,83280,83284,83285,4,5,0
23757,4,3,83284,83285,83288,1,4,0
23758,1,2,83285,83288,83290,3,5,0
23759,1,2,83286,83290,83292,4,6,0
23760,4,2,83290,83292,83294,2,4,0
23761,6,2,83296,83296,83298,0,2,2
23762,2,3,83298,83298,83301,0,3,0
23763,1,2,83299,83301,83303,2,4,0
23764,4,1,83303,83303,83304,0,1,0
23765,6,1,83309,83309,83310,0,1,5
23766,4,3,83313,83313,83316,0,3,3
23767,1,2,83314,83316,83318,2,4,0
23768,4,2,83318,83318,83320,0,2,0
23769,1,1,83319,83320,83321,1,2,0
23770,2,1,83321,83321,83322,0,1,0
23771,3,1,83324,83324,83325,0,1,2
23772,5,1,83329,83329,83330,0,1,4
23773,1,2,83330,83330,83332,0,2,0
23774,2,1,83332,83332,83333,0,1,0
23775,3,2,83335,83335,83337,0,2,2
23776,5,1,83340,83340,83341,0,1,3
23777,4,3,83344,83344,83347,0,3,3
23778,3,3,83347,83347,83350,0,3,0
23779,6,2,83353,83353,83355,0,2,3
23780,5,3,83358,83358,83361,0,3,3
23781,3,2,83361,83361,83363,0,2,0
23782,3,1,83364,83364,83365,0,1,1
23783,6,2,83370,83370,83372,0,2,5
23784,4,1,83374,83374,83375,0,1,2
23785,1,3,83375,83375,83378,0,3,0
23786,3,2,83378,83378,83380,0,2,0
23787,1,3,83379,83380,83383,1,4,0
23788,2,2,83381,83383,83385,2,4,0
23789,1,1,83382,83385,83386,3,4,0
23790,5,1,83387,83387,83388,0,1,1
23791,1,2,83388,83388,83390,0,2,0
23792,2,3,83390,83390,83393,0,3,0
23793,4,2,83394,83394,83396,0,2,1
23794,3,2,83397,83397,83399,0,2,1
23795,5,2,83402,83402,83404,0,2,3
23796,1,3,83403,83404,83407,1,4,0
23797,1,2,83404,83407,83409,3,5,0
23798,4,3,83408,83409,83412,1,4,0
23799,4,3,83412,83412,83415,0,3,0
23800,2,3,83414,83415,83418,1,4,0
23801,5,1,83419,83419,83420,0,1,1
23802,4,3,83423,83423,83426,0,3,3
23803,5,3,83428,83428,83431,0,3,2
23804,5,2,83433,83433,83435,0,2,2
23805,2,3,83435,83435,83438,0,3,0
23806,4,2,83439,83439,83441,0,2,1
23807,3,3,83442,83442,83445,0,3,1
23808,4,1,83446,83446,83447,0,1,1
23809,5,1,83451,83451,83452,0,1,4
23810,1,3,83452,83452,83455,0,3,0
23811,2,3,83454,83455,83458,1,4,0
23812,2,3,83456,83458,83461,2,5,0
23813,5,1,83461,83461,83462,0,1,0
23814,3,1,83464,83464,83465,0,1,2
23815,5,2,83469,83469,83471,0,2,4
23816,5,1,83474,83474,83475,0,1,3
23817,6,1,83480,83480,83481,0,1,5
23818,3,1,83483,83483,83484,0,1,2
23819,2,2,83485,83485,83487,0,2,1
23820,3,3,83488,83488,83491,0,3,1
23821,6,1,83494,83494,83495,0,1,3
23822,5,2,83499,83499,83501,0,2,4
23823,5,2,83504,83504,83506,0,2,3
23824,4,2,83508,83508,83510,0,2,2
23825,3,1,83511,83511,83512,0,1,1
23826,4,1,83515,83515,83516,0,1,3
23827,3,3,83518,83518,83521,0,3,2
23828,4,1,83522,83522,83523,0,1,1
23829,4,1,83526,83526,83527,0,1,3
23830,3,3,83529,83529,83532,0,3,2
23831,2,3,83531,83532,83535,1,4,0
23832,4,3,83535,83535,83538,0,3,0
23833,3,1,83538,83538,83539,0,1,0
23834,3,1,83541,83541,83542,0,1,2
23835,3,2,83544,83544,83546,0,2,2
23836,4,2,83548,83548,83550,0,2,2
23837,1,1,83549,83550,83551,1,2,0
23838,6,2,83555,83555,83557,0,2,4
23839,2,2,83557,83557,83559,0,2,0
23840,1,1,83558,83559,83560,1,2,0
23841,1,3,83559,83560,83563,1,4,0
23842,2,3,83561,83563,83566,2,5,0
23843,3,1,83564,83566,83567,2,3,0
23844,5,3,83569,83569,83572,0,3,2
23845,2,3,83571,83572,83575,1,4,0
23846,3,2,83574,83575,83577,1,3,0
23847,3,1,83577,83577,83578,0,1,0
23848,6,3,83583,83583,83586,0,3,5
23849,1,3,83584,83586,83589,2,5,0
23850,6,3,83590,83590,83593,0,3,1
23851,3,1,83593,83593,83594,0,1,0
23852,6,3,83599,83599,83602,0,3,5
23853,6,3,83605,83605,83608,0,3,3
23854,1,3,83606,83608,83611,2,5,0
23855,2,1,83608,83611,83612,3,4,0
23856,2,1,83610,83612,83613,2,3,0
23857,3,2,83613,83613,83615,0,2,0
23858,5,3,83618,83618,83621,0,3,3
23859,2,3,83620,83621,83624,1,4,0
23860,1,3,83621,83624,83627,3,6,0
23861,1,2,83622,83627,83629,5,7,0
23862,5,2,83627,83629,83631,2,4,0
23863,5,3,83632,83632,83635,0,3,1
23864,2,2,83634,83635,83637,1,3,0
23865,5,3,83639,83639,83642,0,3,2
23866,4,2,83643,83643,83645,0,2,1
23867,5,3,83648,83648,83651,0,3,3
23868,6,1,83654,83654,83655,0,1,3
23869,3,2,83657,83657,83659,0,2,2
23870,3,1,83660,83660,83661,0,1,1
23871,4,2,83664,83664,83666,0,2,3
23872,6,2,83670,83670,83672,0,2,4
23873,1,1,83671,83672,83673,1,2,0
23874,3,1,83674,83674,83675,0,1,1
23875,1,2,83675,83675,83677,0,2,0
23876,5,3,83680,83680,83683,0,3,3
23877,2,2,83682,83683,83685,1,3,0
23878,5,1,83687,83687,83688,0,1,2
23879,5,3,83692,83692,83695,0,3,4
23880,4,3,83696,83696,83699,0,3,1
23881,2,2,83698,83699,83701,1,3,0
23882,1,1,83699,83701,83702,2,3,0
23883,5,2,83704,83704,83706,0,2,2
23884,4,3,83708,83708,83711,0,3,2
23885,3,3,83711,83711,83714,0,3,0
23886,6,2,83717,83717,83719,0,2,3
23887,2,1,83719,83719,83720,0,1,0
23888,1,3,83720,83720,83723,0,3,0
23889,1,3,83721,83723,83726,2,5,0
23890,4,1,83725,83726,83727,1,2,0
23891,4,3,83729,83729,83732,0,3,2
23892,6,1,83735,83735,83736,0,1,3
23893,6,3,83741,83741,83744,0,3,5
23894,1,3,83742,83744,83747,2,5,0
23895,5,3,83747,83747,83750,0,3,0
23896,6,3,83753,83753,83756,0,3,3
23897,1,2,83754,83756,83758,2,4,0
23898,6,3,83760,83760,83763,0,3,2
23899,5,3,83765,83765,83768,0,3,2
23900,2,2,83767,83768,83770,1,3,0
23901,5,2,83772,83772,83774,0,2,2
23902,2,1,83774,83774,83775,0,1,0
23903,2,1,83776,83776,83777,0,1,1
23904,3,3,83779,83779,83782,0,3,2
23905,3,2,83782,83782,83784,0,2,0
23906,2,1,83784,83784,83785,0,1,0
23907,4,1,83788,83788,83789,0,1,3
23908,6,3,83794,83794,83797,0,3,5
23909,3,1,83797,83797,83798,0,1,0
23910,4,1,83801,83801,83802,0,1,3
23911,1,2,83802,83802,83804,0,2,0
23912,3,3,83805,83805,83808,0,3,1
23913,6,3,83811,83811,83814,0,3,3
23914,5,2,83816,83816,83818,0,2,2
23915,3,1,83819,83819,83820,0,1,1
23916,5,1,83824,83824,83825,0,1,4
23917,4,3,83828,83828,83831,0,3,3
23918,1,2,83829,83831,83833,2,4,0
23919,4,2,83833,83833,83835,0,2,0
23920,4,3,83837,83837,83840,0,3,2
23921,4,1,83841,83841,83842,0,1,1
23922,5,2,83846,83846,83848,0,2,4
23923,6,1,83852,83852,83853,0,1,4
23924,1,2,83853,83853,83855,0,2,0
23925,6,1,83859,83859,83860,0,1,4
23926,5,1,83864,83864,83865,0,1,4
23927,3,3,83867,83867,83870,0,3,2
23928,3,2,83870,83870,83872,0,2,0
23929,5,1,83875,83875,83876,0,1,3
23930,3,1,83878,83878,83879,0,1,2
23931,3,3,83881,83881,83884,0,3,2
23932,3,2,83884,83884,83886,0,2,0
23933,2,2,83886,83886,83888,0,2,0
23934,4,3,83890,83890,83893,0,3,2
23935,6,1,83896,83896,83897,0,1,3
23936,1,2,83897,83897,83899,0,2,0
23937,6,1,83903,83903,83904,0,1,4
23938,3,2,83906,83906,83908,0,2,2
23939,6,3,83912,83912,83915,0,3,4
23940,2,2,83914,83915,83917,1,3,0
23941,5,1,83919,83919,83920,0,1,2
23942,5,3,83924,83924,83927,0,3,4
23943,1,2,83925,83927,83929,2,4,0
23944,6,2,83931,83931,83933,0,2,2
23945,1,1,83932,83933,83934,1,2,0
23946,2,3,83934,83934,83937,0,3,0
23947,3,2,83937,83937,83939,0,2,0
23948,5,1,83942,83942,83943,0,1,3
23949,5,3,83947,83947,83950,0,3,4
23950,2,1,83949,83950,83951,1,2,0
23951,5,3,83954,83954,83957,0,3,3
23952,5,3,83959,83959,83962,0,3,2
23953,6,3,83965,83965,83968,0,3,3
23954,2,2,83967,83968,83970,1,3,0
23955,5,3,83972,83972,83975,0,3,2
23956,3,3,83975,83975,83978,0,3,0
23957,5,3,83980,83980,83983,0,3,2
23958,6,1,83986,83986,83987,0,1,3
23959,1,2,83987,83987,83989,0,2,0
23960,3,3,83990,83990,83993,0,3,1
23961,3,3,83993,83993,83996,0,3,0
23962,3,2,83996,83996,83998,0,2,0
23963,3,1,83999,83999,84000,0,1,1
23964,4,2,84003,84003,84005,0,2,3
23965,4,3,84007,84007,84010,0,3,2
23966,3,1,84010,84010,84011,0,1,0
23967,4,1,84014,84014,84015,0,1,3
23968,1,2,84015,84015,84017,0,2,0
23969,2,1,84017,84017,84018,0,1,0
23970,5,1,84022,84022,84023,0,1,4
23971,2,3,84024,84024,84027,0,3,1
23972,4,1,84028,84028,84029,0,1,1
23973,2,1,84030,84030,84031,0,1,1
23974,4,2,84034,84034,84036,0,2,3
23975,6,3,84040,84040,84043,0,3,4
23976,1,1,84041,84043,84044,2,3,0
23977,3,2,84044,84044,84046,0,2,0
23978,3,3,84047,84047,84050,0,3,1
23979,1,2,84048,84050,84052,2,4,0
23980,6,1,84054,84054,84055,0,1,2
23981,4,1,84058,84058,84059,0,1,3
23982,1,1,84059,84059,84060,0,1,0
23983,1,3,84060,84060,84063,0,3,0
23984,6,1,84066,84066,84067,0,1,3
23985,1,1,84067,84067,84068,0,1,0
23986,6,3,84073,84073,84076,0,3,5
23987,3,1,84076,84076,84077,0,1,0
23988,4,2,84080,84080,84082,0,2,3
23989,6,1,84086,84086,84087,0,1,4
23990,6,2,84092,84092,84094,0,2,5
23991,4,1,84096,84096,84097,0,1,2
23992,3,3,84099,84099,84102,0,3,2
23993,1,1,84100,84102,84103,2,3,0
23994,3,1,84103,84103,84104,0,1,0
23995,5,2,84108,84108,84110,0,2,4
23996,1,1,84109,84110,84111,1,2,0
23997,2,2,84111,84111,84113,0,2,0
23998,2,3,84113,84113,84116,0,3,0
23999,5,1,84118,84118,84119,0,1,2
24000,1,1,84119,84119,84120,0,1,0
24001,6,1,84125,84125,84126,0,1,5
24002,6,3,84131,84131,84134,0,3,5
24003,1,1,84132,84134,84135,2,3,0
24004,1,2,84133,84135,84137,2,4,0
24005,2,1,84135,84137,84138,2,3,0
24006,4,3,84139,84139,84142,0,3,1
24007,1,3,84140,84142,84145,2,5,0
24008,5,1,84145,84145,84146,0,1,0
24009,4,2,84149,84149,84151,0,2,3
24010,3,3,84152,84152,84155,0,3,1
24011,2,1,84154,84155,84156,1,2,0
24012,1,1,84155,84156,84157,1,2,0
24013,4,1,84159,84159,84160,0,1,2
24014,6,3,84165,84165,84168,0,3,5
24015,6,2,84171,84171,84173,0,2,3
24016,5,1,84176,84176,84177,0,1,3
24017,3,2,84179,84179,84181,0,2,2
24018,4,2,84183,84183,84185,0,2,2
24019,4,3,84187,84187,84190,0,3,2
24020,4,1,84191,84191,84192,0,1,1
24021,3,2,84194,84194,84196,0,2,2
24022,4,2,84198,84198,84200,0,2,2
24023,6,3,84204,84204,84207,0,3,4
24024,1,2,84205,84207,84209,2,4,0
24025,5,2,84210,84210,84212,0,2,1
24026,3,3,84213,84213,84216,0,3,1
24027,3,1,84216,84216,84217,0,1,0
24028,6,2,84222,84222,84224,0,2,5
24029,6,2,84228,84228,84230,0,2,4
24030,6,2,84234,84234,84236,0,2,4
24031,5,3,84239,84239,84242,0,3,3
24032,6,2,84245,84245,84247,0,2,3
24033,5,2,84250,84250,84252,0,2,3
24034,3,3,84253,84253,84256,0,3,1
24035,5,1,84258,84258,84259,0,1,2
24036,1,1,84259,84259,84260,0,1,0
24037,2,1,84261,84261,84262,0,1,1
24038,2,2,84263,84263,84265,0,2,1
24039,2,1,84265,84265,84266,0,1,0
24040,1,1,84266,84266,84267,0,1,0
24041,5,1,84271,84271,84272,0,1,4
24042,5,3,84276,84276,84279,0,3,4
24043,2,2,84278,84279,84281,1,3,0
24044,2,3,84280,84281,84284,1,4,0
24045,6,1,84286,84286,84287,0,1,2
24046,4,2,84290,84290,84292,0,2,3
24047,2,1,84292,84292,84293,0,1,0
24048,5,1,84297,84297,84298,0,1,4
24049,4,2,84301,84301,84303,0,2,3
24050,3,3,84304,84304,84307,0,3,1
24051,6,3,84310,84310,84313,0,3,3
24052,1,2,84311,84313,84315,2,4,0
24053,2,1,84313,84315,84316,2,3,0
24054,2,3,84315,84316,84319,1,4,0
24055,1,3,84316,84319,84322,3,6,0
24056,1,2,84317,84322,84324,5,7,0
24057,5,2,84322,84324,84326,2,4,0
24058,1,3,84323,84326,84329,3,6,0
24059,6,2,84329,84329,84331,0,2,0
24060,4,2,84333,84333,84335,0,2,2
24061,1,1,84334,84335,84336,1,2,0
24062,4,3,84338,84338,84341,0,3,2
24063,3,1,84341,84341,84342,0,1,0
24064,3,3,84344,84344,84347,0,3,2
24065,6,3,84350,84350,84353,0,3,3
24066,2,1,84352,84353,84354,1,2,0
24067,3,1,84355,84355,84356,0,1,1
24068,6,3,84361,84361,84364,0,3,5
24069,2,2,84363,84364,84366,1,3,0
24070,5,3,84368,84368,84371,0,3,2
24071,6,2,84374,84374,84376,0,2,3
24072,4,2,84378,84378,84380,0,2,2
24073,5,1,84383,84383,84384,0,1,3
24074,6,2,84389,84389,84391,0,2,5
24075,6,2,84395,84395,84397,0,2,4
24076,6,2,84401,84401,84403,0,2,4
24077,6,2,84407,84407,84409,0,2,4
24078,5,3,84412,84412,84415,0,3,3
24079,3,3,84415,84415,84418,0,3,0
24080,2,1,84417,84418,84419,1,2,0
24081,4,2,84421,84421,84423,0,2,2
24082,3,3,84424,84424,84427,0,3,1
24083,1,2,84425,84427,84429,2,4,0
24084,1,3,84426,84429,84432,3,6,0
24085,1,3,84427,84432,84435,5,8,0
24086,2,1,84429,84435,84436,6,7,0
24087,6,3,84435,84436,84439,1,4,0
24088,4,2,84439,84439,84441,0,2,0
24089,5,3,84444,84444,84447,0,3,3
24090,1,2,84445,84447,84449,2,4,0
24091,5,1,84450,84450,84451,0,1,1
24092,1,2,84451,84451,84453,0,2,0
24093,5,2,84456,84456,84458,0,2,3
24094,2,2,84458,84458,84460,0,2,0
24095,4,1,84462,84462,84463,0,1,2
24096,3,2,84465,84465,84467,0,2,2
24097,6,2,84471,84471,84473,0,2,4
24098,6,2,84477,84477,84479,0,2,4
24099,2,3,84479,84479,84482,0,3,0
24100,3,1,84482,84482,84483,0,1,0
24101,5,1,84487,84487,84488,0,1,4
24102,6,2,84493,84493,84495,0,2,5
24103,6,3,84499,84499,84502,0,3,4
24104,3,2,84502,84502,84504,0,2,0
24105,6,3,84508,84508,84511,0,3,4
24106,1,1,84509,84511,84512,2,3,0
24107,5,1,84514,84514,84515,0,1,2
24108,4,2,84518,84518,84520,0,2,3
24109,4,1,84522,84522,84523,0,1,2
24110,2,2,84524,84524,84526,0,2,1
24111,5,1,84529,84529,84530,0,1,3
24112,3,3,84532,84532,84535,0,3,2
24113,2,2,84534,84535,84537,1,3,0
24114,1,1,84535,84537,84538,2,3,0
24115,6,2,84541,84541,84543,0,2,3
24116,4,1,84545,84545,84546,0,1,2
24117,2,3,84547,84547,84550,0,3,1
24118,1,3,84548,84550,84553,2,5,0
24119,6,3,84554,84554,84557,0,3,1
24120,1,3,84555,84557,84560,2,5,0
24121,3,1,84558,84560,84561,2,3,0
24122,3,3,84561,84561,84564,0,3,0
24123,1,3,84562,84564,84567,2,5,0
24124,6,2,84568,84568,84570,0,2,1
24125,6,1,84574,84574,84575,0,1,4
24126,2,1,84576,84576,84577,0,1,1
24127,3,1,84579,84579,84580,0,1,2
24128,3,3,84582,84582,84585,0,3,2
24129,5,3,84587,84587,84590,0,3,2
24130,4,2,84591,84591,84593,0,2,1
24131,3,1,84594,84594,84595,0,1,1
24132,3,2,84597,84597,84599,0,2,2
24133,3,2,84600,84600,84602,0,2,1
24134,2,1,84602,84602,84603,0,1,0
24135,1,1,84603,84603,84604,0,1,0
24136,1,2,84604,84604,84606,0,2,0
24137,5,2,84609,84609,84611,0,2,3
24138,6,1,84615,84615,84616,0,1,4
24139,3,1,84618,84618,84619,0,1,2
24140,3,3,84621,84621,84624,0,3,2
24141,5,1,84626,84626,84627,0,1,2
24142,1,1,84627,84627,84628,0,1,0
24143,1,1,84628,84628,84629,0,1,0
24144,6,3,84634,84634,84637,0,3,5
24145,5,3,84639,84639,84642,0,3,2
24146,1,3,84640,84642,84645,2,5,0
24147,2,2,84642,84645,84647,3,5,0
24148,5,2,84647,84647,84649,0,2,0
24149,3,1,84650,84650,84651,0,1,1
24150,4,3,84654,84654,84657,0,3,3
24151,2,1,84656,84657,84658,1,2,0
24152,4,1,84660,84660,84661,0,1,2
24153,1,2,84661,84661,84663,0,2,0
24154,1,3,84662,84663,84666,1,4,0
24155,2,1,84664,84666,84667,2,3,0
24156,5,1,84669,84669,84670,0,1,2
24157,2,3,84671,84671,84674,0,3,1
24158,4,3,84675,84675,84678,0,3,1
24159,2,3,84677,84678,84681,1,4,0
24160,1,2,84678,84681,84683,3,5,0
24161,5,2,84683,84683,84685,0,2,0
24162,3,1,84686,84686,84687,0,1,1
24163,4,3,84690,84690,84693,0,3,3
24164,4,3,84694,84694,84697,0,3,1
24165,4,3,84698,84698,84701,0,3,1
24166,5,1,84703,84703,84704,0,1,2
24167,4,2,84707,84707,84709,0,2,3
24168,1,1,84708,84709,84710,1,2,0
24169,1,3,84709,84710,84713,1,4,0
24170,5,2,84714,84714,84716,0,2,1
24171,2,1,84716,84716,84717,0,1,0
24172,6,2,84722,84722,84724,0,2,5
24173,1,3,84723,84724,84727,1,4,0
24174,1,3,84724,84727,84730,3,6,0
24175,1,3,84725,84730,84733,5,8,0
24176,6,3,84731,84733,84736,2,5,0
24177,4,1,84735,84736,84737,1,2,0
24178,4,3,84739,84739,84742,0,3,2
24179,4,2,84743,84743,84745,0,2,1
24180,2,1,84745,84745,84746,0,1,0
24181,2,1,84747,84747,84748,0,1,1
24182,2,3,84749,84749,84752,0,3,1
24183,5,3,84754,84754,84757,0,3,2
24184,3,2,84757,84757,84759,0,2,0
24185,1,2,84758,84759,84761,1,3,0
24186,2,3,84760,84761,84764,1,4,0
24187,4,2,84764,84764,84766,0,2,0
24188,2,3,84766,84766,84769,0,3,0
24189,1,2,84767,84769,84771,2,4,0
24190,4,2,84771,84771,84773,0,2,0
24191,3,3,84774,84774,84777,0,3,1
24192,1,1,84775,84777,84778,2,3,0
24193,6,3,84781,84781,84784,0,3,3
24194,2,2,84783,84784,84786,1,3,0
24195,2,3,84785,84786,84789,1,4,0
24196,5,3,84790,84790,84793,0,3,1
24197,1,2,84791,84793,84795,2,4,0
24198,4,3,84795,84795,84798,0,3,0
24199,2,3,84797,84798,84801,1,4,0
24200,4,2,84801,84801,84803,0,2,0
24201,3,3,84804,84804,84807,0,3,1
24202,5,2,84809,84809,84811,0,2,2
24203,5,3,84814,84814,84817,0,3,3
24204,6,2,84820,84820,84822,0,2,3
24205,3,2,84823,84823,84825,0,2,1
24206,4,3,84827,84827,84830,0,3,2
24207,2,1,84829,84830,84831,1,2,0
24208,4,1,84833,84833,84834,0,1,2
24209,3,2,84836,84836,84838,0,2,2
24210,6,2,84842,84842,84844,0,2,4
24211,4,1,84846,84846,84847,0,1,2
24212,5,2,84851,84851,84853,0,2,4
24213,4,1,84855,84855,84856,0,1,2
24214,2,2,84857,84857,84859,0,2,1
24215,5,2,84862,84862,84864,0,2,3
24216,5,2,84867,84867,84869,0,2,3
24217,4,2,84871,84871,84873,0,2,2
24218,5,3,84876,84876,84879,0,3,3
24219,3,3,84879,84879,84882,0,3,0
24220,2,3,84881,84882,84885,1,4,0
24221,6,3,84887,84887,84890,0,3,2
24222,5,3,84892,84892,84895,0,3,2
24223,6,2,84898,84898,84900,0,2,3
24224,1,1,84899,84900,84901,1,2,0
24225,1,2,84900,84901,84903,1,3,0
24226,1,1,84901,84903,84904,2,3,0
24227,2,2,84903,84904,84906,1,3,0
24228,1,1,84904,84906,84907,2,3,0
24229,5,2,84909,84909,84911,0,2,2
24230,4,2,84913,84913,84915,0,2,2
24231,2,3,84915,84915,84918,0,3,0
24232,2,2,84917,84918,84920,1,3,0
24233,1,1,84918,84920,84921,2,3,0
24234,2,2,84920,84921,84923,1,3,0
24235,2,3,84922,84923,84926,1,4,0
24236,3,3,84925,84926,84929,1,4,0
24237,1,2,84926,84929,84931,3,5,0
24238,5,2,84931,84931,84933,0,2,0
24239,1,2,84932,84933,84935,1,3,0
24240,6,3,84938,84938,84941,0,3,3
24241,1,3,84939,84941,84944,2,5,0
24242,4,2,84943,84944,84946,1,3,0
24243,4,3,84947,84947,84950,0,3,1
24244,3,2,84950,84950,84952,0,2,0
24245,4,2,84954,84954,84956,0,2,2
24246,4,1,84958,84958,84959,0,1,2
24247,3,2,84961,84961,84963,0,2,2
24248,5,1,84966,84966,84967,0,1,3
24249,4,3,84970,84970,84973,0,3,3
24250,4,3,84974,84974,84977,0,3,1
24251,1,1,84975,84977,84978,2,3,0
24252,3,1,84978,84978,84979,0,1,0
24253,3,1,84981,84981,84982,0,1,2
24254,3,1,84984,84984,84985,0,1,2
24255,1,3,84985,84985,84988,0,3,0
24256,5,1,84990,84990,84991,0,1,2
24257,1,1,84991,84991,84992,0,1,0
24258,2,1,84993,84993,84994,0,1,1
24259,2,2,84995,84995,84997,0,2,1
24260,4,3,84999,84999,85002,0,3,2
24261,2,3,85001,85002,85005,1,4,0
24262,2,2,85003,85005,85007,2,4,0
24263,3,1,85006,85007,85008,1,2,0
24264,3,2,85009,85009,85011,0,2,1
24265,5,1,85014,85014,85015,0,1,3
24266,6,3,85020,85020,85023,0,3,5
24267,6,1,85026,85026,85027,0,1,3
24268,6,2,85032,85032,85034,0,2,5
24269,1,1,85033,85034,85035,1,2,0
24270,5,3,85038,85038,85041,0,3,3
24271,3,2,85041,85041,85043,0,2,0
24272,6,2,85047,85047,85049,0,2,4
24273,3,2,85050,85050,85052,0,2,1
24274,4,1,85054,85054,85055,0,1,2
24275,4,1,85058,85058,85059,0,1,3
24276,4,1,85062,85062,85063,0,1,3
24277,1,2,85063,85063,85065,0,2,0
24278,5,2,85068,85068,85070,0,2,3
24279,5,1,85073,85073,85074,0,1,3
24280,1,3,85074,85074,85077,0,3,0
24281,5,2,85079,85079,85081,0,2,2
24282,6,1,85085,85085,85086,0,1,4
24283,3,1,85088,85088,85089,0,1,2
24284,4,2,85092,85092,85094,0,2,3
24285,6,2,85098,85098,85100,0,2,4
24286,4,1,85102,85102,85103,0,1,2
24287,2,1,85104,85104,85105,0,1,1
24288,2,2,85106,85106,85108,0,2,1
24289,2,3,85108,85108,85111,0,3,0
24290,1,1,85109,85111,85112,2,3,0
24291,5,2,85114,85114,85116,0,2,2
24292,1,1,85115,85116,85117,1,2,0
24293,2,2,85117,85117,85119,0,2,0
24294,6,2,85123,85123,85125,0,2,4
24295,5,3,85128,85128,85131,0,3,3
24296,4,2,85132,85132,85134,0,2,1
24297,3,1,85135,85135,85136,0,1,1
24298,1,1,85136,85136,85137,0,1,0
24299,2,3,85138,85138,85141,0,3,1
24300,6,2,85144,85144,85146,0,2,3
24301,4,1,85148,85148,85149,0,1,2
24302,5,1,85153,85153,85154,0,1,4
24303,2,3,85155,85155,85158,0,3,1
24304,1,2,85156,85158,85160,2,4,0
24305,4,1,85160,85160,85161,0,1,0
24306,5,3,85165,85165,85168,0,3,4
24307,6,2,85171,85171,85173,0,2,3
24308,2,2,85173,85173,85175,0,2,0
24309,1,1,85174,85175,85176,1,2,0
24310,5,3,85179,85179,85182,0,3,3
24311,2,2,85181,85182,85184,1,3,0
24312,6,2,85187,85187,85189,0,2,3
24313,2,1,85189,85189,85190,0,1,0
24314,1,1,85190,85190,85191,0,1,0
24315,6,3,85196,85196,85199,0,3,5
24316,1,3,85197,85199,85202,2,5,0
24317,6,3,85203,85203,85206,0,3,1
24318,6,3,85209,85209,85212,0,3,3
24319,6,2,85215,85215,85217,0,2,3
24320,5,2,85220,85220,85222,0,2,3
24321,2,1,85222,85222,85223,0,1,0
24322,4,3,85226,85226,85229,0,3,3
24323,4,2,85230,85230,85232,0,2,1
24324,2,3,85232,85232,85235,0,3,0
24325,3,3,85235,85235,85238,0,3,0
24326,5,3,85240,85240,85243,0,3,2
24327,1,2,85241,85243,85245,2,4,0
24328,1,1,85242,85245,85246,3,4,0
24329,4,1,85246,85246,85247,0,1,0
24330,1,2,85247,85247,85249,0,2,0
24331,4,2,85251,85251,85253,0,2,2
24332,4,1,85255,85255,85256,0,1,2
24333,4,2,85259,85259,85261,0,2,3
24334,3,3,85262,85262,85265,0,3,1
24335,2,1,85264,85265,85266,1,2,0
24336,5,1,85269,85269,85270,0,1,3
24337,1,3,85270,85270,85273,0,3,0
24338,1,2,85271,85273,85275,2,4,0
24339,3,2,85274,85275,85277,1,3,0
24340,5,1,85279,85279,85280,0,1,2
24341,1,2,85280,85280,85282,0,2,0
24342,4,1,85284,85284,85285,0,1,2
24343,2,2,85286,85286,85288,0,2,1
24344,4,3,85290,85290,85293,0,3,2
24345,3,3,85293,85293,85296,0,3,0
24346,1,2,85294,85296,85298,2,4,0
24347,5,3,85299,85299,85302,0,3,1
24348,6,3,85305,85305,85308,0,3,3
24349,3,3,85308,85308,85311,0,3,0
24350,6,3,85314,85314,85317,0,3,3
24351,4,2,85318,85318,85320,0,2,1
24352,1,2,85319,85320,85322,1,3,0
24353,3,3,85322,85322,85325,0,3,0
24354,3,2,85325,85325,85327,0,2,0
24355,3,3,85328,85328,85331,0,3,1
24356,1,2,85329,85331,85333,2,4,0
24357,1,2,85330,85333,85335,3,5,0
24358,4,2,85334,85335,85337,1,3,0
24359,1,1,85335,85337,85338,2,3,0
24360,5,2,85340,85340,85342,0,2,2
24361,6,2,85346,85346,85348,0,2,4
24362,2,2,85348,85348,85350,0,2,0
24363,2,1,85350,85350,85351,0,1,0
24364,6,3,85356,85356,85359,0,3,5
24365,4,3,85360,85360,85363,0,3,1
24366,3,3,85363,85363,85366,0,3,0
24367,4,1,85367,85367,85368,0,1,1
24368,6,2,85373,85373,85375,0,2,5
24369,6,3,85379,85379,85382,0,3,4
24370,1,3,85380,85382,85385,2,5,0
24371,6,1,85386,85386,85387,0,1,1
24372,3,2,85389,85389,85391,0,2,2
24373,3,1,85392,85392,85393,0,1,1
24374,3,2,85395,85395,85397,0,2,2
24375,2,3,85397,85397,85400,0,3,0
24376,1,2,85398,85400,85402,2,4,0
24377,5,2,85403,85403,85405,0,2,1
24378,4,3,85407,85407,85410,0,3,2
24379,2,1,85409,85410,85411,1,2,0
24380,6,2,85415,85415,85417,0,2,4
24381,4,1,85419,85419,85420,0,1,2
24382,2,2,85421,85421,85423,0,2,1
24383,6,2,85427,85427,85429,0,2,4
24384,5,2,85432,85432,85434,0,2,3
24385,5,2,85437,85437,85439,0,2,3
24386,5,2,85442,85442,85444,0,2,3
24387,1,2,85443,85444,85446,1,3,0
24388,5,1,85448,85448,85449,0,1,2
24389,3,3,85451,85451,85454,0,3,2
24390,4,2,85455,85455,85457,0,2,1
24391,3,2,85458,85458,85460,0,2,1
24392,1,1,85459,85460,85461,1,2,0
24393,6,1,85465,85465,85466,0,1,4
24394,3,1,85468,85468,85469,0,1,2
24395,1,2,85469,85469,85471,0,2,0
24396,6,3,85475,85475,85478,0,3,4
24397,5,2,85480,85480,85482,0,2,2
24398,4,3,85484,85484,85487,0,3,2
24399,5,3,85489,85489,85492,0,3,2
24400,6,1,85495,85495,85496,0,1,3
24401,2,2,85497,85497,85499,0,2,1
24402,5,2,85502,85502,85504,0,2,3
24403,4,2,85506,85506,85508,0,2,2
24404,5,1,85511,85511,85512,0,1,3
24405,1,2,85512,85512,85514,0,2,0
24406,5,1,85517,85517,85518,0,1,3
24407,4,1,85521,85521,85522,0,1,3
24408,6,3,85527,85527,85530,0,3,5
24409,3,1,85530,85530,85531,0,1,0
24410,3,3,85533,85533,85536,0,3,2
24411,5,3,85538,85538,85541,0,3,2
24412,3,2,85541,85541,85543,0,2,0
24413,4,2,85545,85545,85547,0,2,2
24414,4,3,85549,85549,85552,0,3,2
24415,4,3,85553,85553,85556,0,3,1
24416,3,1,85556,85556,85557,0,1,0
24417,6,2,85562,85562,85564,0,2,5
24418,5,1,85567,85567,85568,0,1,3
24419,1,2,85568,85568,85570,0,2,0
24420,2,1,85570,85570,85571,0,1,0
24421,5,1,85575,85575,85576,0,1,4
24422,6,3,85581,85581,85584,0,3,5
24423,3,2,85584,85584,85586,0,2,0
24424,3,2,85587,85587,85589,0,2,1
24425,2,1,85589,85589,85590,0,1,0
24426,5,2,85594,85594,85596,0,2,4
24427,3,2,85597,85597,85599,0,2,1
24428,6,1,85603,85603,85604,0,1,4
24429,2,2,85605,85605,85607,0,2,1
24430,1,3,85606,85607,85610,1,4,0
24431,3,2,85609,85610,85612,1,3,0
24432,3,1,85612,85612,85613,0,1,0
24433,5,1,85617,85617,85618,0,1,4
24434,6,3,85623,85623,85626,0,3,5
24435,3,2,85626,85626,85628,0,2,0
24436,1,3,85627,85628,85631,1,4,0
24437,4,3,85631,85631,85634,0,3,0
24438,4,2,85635,85635,85637,0,2,1
24439,6,3,85641,85641,85644,0,3,4
24440,4,2,85645,85645,85647,0,2,1
24441,4,3,85649,85649,85652,0,3,2
24442,1,1,85650,85652,85653,2,3,0
24443,4,1,85654,85654,85655,0,1,1
24444,5,2,85659,85659,85661,0,2,4
24445,5,3,85664,85664,85667,0,3,3
24446,2,3,85666,85667,85670,1,4,0
24447,1,3,85667,85670,85673,3,6,0
24448,4,3,85671,85673,85676,2,5,0
24449,1,2,85672,85676,85678,4,6,0
24450,1,2,85673,85678,85680,5,7,0
24451,4,1,85677,85680,85681,3,4,0
24452,2,3,85679,85681,85684,2,5,0
24453,4,1,85683,85684,85685,1,2,0
24454,3,2,85686,85686,85688,0,2,1
24455,4,3,85690,85690,85693,0,3,2
24456,5,3,85695,85695,85698,0,3,2
24457,3,2,85698,85698,85700,0,2,0
24458,3,2,85701,85701,85703,0,2,1
24459,1,3,85702,85703,85706,1,4,0
24460,2,2,85704,85706,85708,2,4,0
24461,2,2,85706,85708,85710,2,4,0
24462,2,1,85708,85710,85711,2,3,0
24463,3,3,85711,85711,85714,0,3,0
24464,2,3,85713,85714,85717,1,4,0
24465,3,3,85716,85717,85720,1,4,0
24466,6,2,85722,85722,85724,0,2,2
24467,6,3,85728,85728,85731,0,3,4
24468,4,1,85732,85732,85733,0,1,1
24469,1,2,85733,85733,85735,0,2,0
24470,2,2,85735,85735,85737,0,2,0
24471,5,3,85740,85740,85743,0,3,3
24472,4,3,85744,85744,85747,0,3,1
24473,2,2,85746,85747,85749,1,3,0
24474,5,2,85751,85751,85753,0,2,2
24475,5,2,85756,85756,85758,0,2,3
24476,4,2,85760,85760,85762,0,2,2
24477,2,1,85762,85762,85763,0,1,0
24478,2,1,85764,85764,85765,0,1,1
24479,3,1,85767,85767,85768,0,1,2
24480,2,1,85769,85769,85770,0,1,1
24481,4,3,85773,85773,85776,0,3,3
24482,3,1,85776,85776,85777,0,1,0
24483,1,3,85777,85777,85780,0,3,0
24484,1,3,85778,85780,85783,2,5,0
24485,1,3,85779,85783,85786,4,7,0
24486,4,3,85783,85786,85789,3,6,0
24487,5,1,85788,85789,85790,1,2,0
24488,1,3,85789,85790,85793,1,4,0
24489,2,3,85791,85793,85796,2,5,0
24490,5,3,85796,85796,85799,0,3,0
24491,3,1,85799,85799,85800,0,1,0
24492,4,2,85803,85803,85805,0,2,3
24493,4,1,85807,85807,85808,0,1,2
24494,5,1,85812,85812,85813,0,1,4
24495,5,2,85817,85817,85819,0,2,4
24496,5,2,85822,85822,85824,0,2,3
24497,2,2,85824,85824,85826,0,2,0
24498,3,3,85827,85827,85830,0,3,1
24499,6,2,85833,85833,85835,0,2,3
24500,6,1,85839,85839,85840,0,1,4
24501,3,3,85842,85842,85845,0,3,2
24502,4,3,85846,85846,85849,0,3,1
24503,3,3,85849,85849,85852,0,3,0
24504,2,3,85851,85852,85855,1,4,0
24505,3,2,85854,85855,85857,1,3,0
24506,2,1,85856,85857,85858,1,2,0
24507,1,1,85857,85858,85859,1,2,0
24508,2,1,85859,85859,85860,0,1,0
24509,5,3,85864,85864,85867,0,3,4
24510,5,1,85869,85869,85870,0,1,2
24511,6,1,85875,85875,85876,0,1,5
24512,5,2,85880,85880,85882,0,2,4
24513,1,2,85881,85882,85884,1,3,0
24514,3,1,85884,85884,85885,0,1,0
24515,3,2,85887,85887,85889,0,2,2
24516,5,1,85892,85892,85893,0,1,3
24517,4,3,85896,85896,85899,0,3,3
24518,1,2,85897,85899,85901,2,4,0
24519,3,1,85900,85901,85902,1,2,0
24520,2,3,85902,85902,85905,0,3,0
24521,2,3,85904,85905,85908,1,4,0
24522,6,2,85910,85910,85912,0,2,2
24523,4,2,85914,85914,85916,0,2,2
24524,3,3,85917,85917,85920,0,3,1
24525,3,1,85920,85920,85921,0,1,0
24526,4,2,85924,85924,85926,0,2,3
24527,4,2,85928,85928,85930,0,2,2
24528,4,1,85932,85932,85933,0,1,2
24529,1,2,85933,85933,85935,0,2,0
24530,6,2,85939,85939,85941,0,2,4
24531,6,3,85945,85945,85948,0,3,4
24532,6,1,85951,85951,85952,0,1,3
24533,1,1,85952,85952,85953,0,1,0
24534,1,3,85953,85953,85956,0,3,0
24535,4,2,85957,85957,85959,0,2,1
24536,1,2,85958,85959,85961,1,3,0
24537,2,3,85960,85961,85964,1,4,0
24538,5,1,85965,85965,85966,0,1,1
24539,5,1,85970,85970,85971,0,1,4
24540,6,3,85976,85976,85979,0,3,5
24541,4,3,85980,85980,85983,0,3,1
24542,2,1,85982,85983,85984,1,2,0
24543,6,1,85988,85988,85989,0,1,4
24544,5,3,85993,85993,85996,0,3,4
24545,1,1,85994,85996,85997,2,3,0
24546,6,2,86000,86000,86002,0,2,3
24547,1,3,86001,86002,86005,1,4,0
24548,4,3,86005,86005,86008,0,3,0
24549,3,1,86008,86008,86009,0,1,0
24550,1,1,86009,86009,86010,0,1,0
24551,3,2,86012,86012,86014,0,2,2
24552,4,3,86016,86016,86019,0,3,2
24553,2,1,86018,86019,86020,1,2,0
24554,2,3,86020,86020,86023,0,3,0
24555,6,1,86026,86026,86027,0,1,3
24556,1,1,86027,86027,86028,0,1,0
24557,1,3,86028,86028,86031,0,3,0
24558,6,3,86034,86034,86037,0,3,3
24559,2,1,86036,86037,86038,1,2,0
24560,4,1,86040,86040,86041,0,1,2
24561,5,3,86045,86045,86048,0,3,4
24562,3,1,86048,86048,86049,0,1,0
24563,5,1,86053,86053,86054,0,1,4
24564,4,1,86057,86057,86058,0,1,3
24565,1,1,86058,86058,86059,0,1,0
24566,4,3,86062,86062,86065,0,3,3
24567,1,1,86063,86065,86066,2,3,0
24568,1,1,86064,86066,86067,2,3,0
24569,4,3,86068,86068,86071,0,3,1
24570,2,3,86070,86071,86074,1,4,0
24571,1,2,86071,86074,86076,3,5,0
24572,4,2,86075,86076,86078,1,3,0
24573,6,1,86081,86081,86082,0,1,3
24574,2,2,86083,86083,86085,0,2,1
24575,1,1,86084,86085,86086,1,2,0
24576,3,2,86087,86087,86089,0,2,1
24577,2,2,86089,86089,86091,0,2,0
24578,6,3,86095,86095,86098,0,3,4
24579,4,3,86099,86099,86102,0,3,1
24580,2,3,86101,86102,86105,1,4,0
24581,4,2,86105,86105,86107,0,2,0
24582,1,2,86106,86107,86109,1,3,0
24583,6,3,86112,86112,86115,0,3,3
24584,4,1,86116,86116,86117,0,1,1
24585,5,1,86121,86121,86122,0,1,4
24586,5,2,86126,86126,86128,0,2,4
24587,4,2,86130,86130,86132,0,2,2
24588,4,3,86134,86134,86137,0,3,2
24589,6,3,86140,86140,86143,0,3,3
24590,3,3,86143,86143,86146,0,3,0
24591,1,3,86144,86146,86149,2,5,0
24592,6,2,86150,86150,86152,0,2,1
24593,5,1,86155,86155,86156,0,1,3
24594,3,2,86158,86158,86160,0,2,2
24595,4,2,86162,86162,86164,0,2,2
24596,2,3,86164,86164,86167,0,3,0
24597,5,1,86169,86169,86170,0,1,2
24598,1,3,86170,86170,86173,0,3,0
24599,5,2,86175,86175,86177,0,2,2
24600,3,1,86178,86178,86179,0,1,1
24601,2,2,86180,86180,86182,0,2,1
24602,3,1,86183,86183,86184,0,1,1
24603,5,1,86188,86188,86189,0,1,4
24604,4,3,86192,86192,86195,0,3,3
24605,2,1,86194,86195,86196,1,2,0
24606,2,3,86196,86196,86199,0,3,0
24607,1,2,86197,86199,86201,2,4,0
24608,3,1,86200,86201,86202,1,2,0
24609,2,1,86202,86202,86203,0,1,0
24610,6,2,86208,86208,86210,0,2,5
24611,6,1,86214,86214,86215,0,1,4
24612,2,1,86216,86216,86217,0,1,1
24613,1,2,86217,86217,86219,0,2,0
24614,2,3,86219,86219,86222,0,3,0
24615,2,1,86221,86222,86223,1,2,0
24616,4,3,86225,86225,86228,0,3,2
24617,5,1,86230,86230,86231,0,1,2
24618,6,2,86236,86236,86238,0,2,5
24619,4,3,86240,86240,86243,0,3,2
24620,6,3,86246,86246,86249,0,3,3
24621,3,2,86249,86249,86251,0,2,0
24622,5,2,86254,86254,86256,0,2,3
24623,4,3,86258,86258,86261,0,3,2
24624,4,3,86262,86262,86265,0,3,1
24625,4,1,86266,86266,86267,0,1,1
24626,6,2,86272,86272,86274,0,2,5
24627,5,2,86277,86277,86279,0,2,3
24628,3,1,86280,86280,86281,0,1,1
24629,1,3,86281,86281,86284,0,3,0
24630,4,3,86285,86285,86288,0,3,1
24631,1,1,86286,86288,86289,2,3,0
24632,5,3,86291,86291,86294,0,3,2
24633,3,2,86294,86294,86296,0,2,0
24634,5,1,86299,86299,86300,0,1,3
24635,2,1,86301,86301,86302,0,1,1
24636,3,2,86304,86304,86306,0,2,2
24637,1,3,86305,86306,86309,1,4,0
24638,5,2,86310,86310,86312,0,2,1
24639,4,3,86314,86314,86317,0,3,2
24640,4,1,86318,86318,86319,0,1,1
24641,2,3,86320,86320,86323,0,3,1
24642,3,1,86323,86323,86324,0,1,0
24643,5,2,86328,86328,86330,0,2,4
24644,4,3,86332,86332,86335,0,3,2
24645,2,1,86334,86335,86336,1,2,0
24646,1,3,86335,86336,86339,1,4,0
24647,4,3,86339,86339,86342,0,3,0
24648,4,1,86343,86343,86344,0,1,1
24649,4,1,86347,86347,86348,0,1,3
24650,1,2,86348,86348,86350,0,2,0
24651,3,3,86351,86351,86354,0,3,1
24652,4,2,86355,86355,86357,0,2,1
24653,3,1,86358,86358,86359,0,1,1
24654,4,1,86362,86362,86363,0,1,3
24655,2,3,86364,86364,86367,0,3,1
24656,3,2,86367,86367,86369,0,2,0
24657,4,1,86371,86371,86372,0,1,2
24658,2,1,86373,86373,86374,0,1,1
24659,5,3,86378,86378,86381,0,3,4
24660,2,1,86380,86381,86382,1,2,0
24661,2,1,86382,86382,86383,0,1,0
24662,4,3,86386,86386,86389,0,3,3
24663,5,2,86391,86391,86393,0,2,2
24664,4,3,86395,86395,86398,0,3,2
24665,1,3,86396,86398,86401,2,5,0
24666,1,2,86397,86401,86403,4,6,0
24667,1,1,86398,86403,86404,5,6,0
24668,4,1,86402,86404,86405,2,3,0
24669,4,3,86406,86406,86409,0,3,1
24670,5,2,86411,86411,86413,0,2,2
24671,3,3,86414,86414,86417,0,3,1
24672,1,2,86415,86417,86419,2,4,0
24673,3,1,86418,86419,86420,1,2,0
24674,3,1,86421,86421,86422,0,1,1
24675,4,3,86425,86425,86428,0,3,3
24676,6,1,86431,86431,86432,0,1,3
24677,6,1,86437,86437,86438,0,1,5
24678,5,1,86442,86442,86443,0,1,4
24679,4,2,86446,86446,86448,0,2,3
24680,6,1,86452,86452,86453,0,1,4
24681,6,3,86458,86458,86461,0,3,5
24682,4,2,86462,86462,86464,0,2,1
24683,5,2,86467,86467,86469,0,2,3
24684,4,1,86471,86471,86472,0,1,2
24685,5,3,86476,86476,86479,0,3,4
24686,5,1,86481,86481,86482,0,1,2
24687,1,1,86482,86482,86483,0,1,0
24688,2,3,86484,86484,86487,0,3,1
24689,3,3,86487,86487,86490,0,3,0
24690,6,2,86493,86493,86495,0,2,3
24691,6,3,86499,86499,86502,0,3,4
24692,5,3,86504,86504,86507,0,3,2
24693,5,2,86509,86509,86511,0,2,2
24694,5,2,86514,86514,86516,0,2,3
24695,1,2,86515,86516,86518,1,3,0
24696,4,2,86519,86519,86521,0,2,1
24697,4,3,86523,86523,86526,0,3,2
24698,5,1,86528,86528,86529,0,1,2
24699,2,2,86530,86530,86532,0,2,1
24700,6,2,86536,86536,86538,0,2,4
24701,4,1,86540,86540,86541,0,1,2
24702,4,2,86544,86544,86546,0,2,3
24703,4,1,86548,86548,86549,0,1,2
24704,4,1,86552,86552,86553,0,1,3
24705,5,1,86557,86557,86558,0,1,4
24706,5,3,86562,86562,86565,0,3,4
24707,1,2,86563,86565,86567,2,4,0
24708,1,3,86564,86567,86570,3,6,0
24709,6,2,86570,86570,86572,0,2,0
24710,6,3,86576,86576,86579,0,3,4
24711,4,1,86580,86580,86581,0,1,1
24712,6,3,86586,86586,86589,0,3,5
24713,5,2,86591,86591,86593,0,2,2
24714,4,3,86595,86595,86598,0,3,2
24715,3,2,86598,86598,86600,0,2,0
24716,6,1,86604,86604,86605,0,1,4
24717,6,2,86610,86610,86612,0,2,5
24718,6,3,86616,86616,86619,0,3,4
24719,2,1,86618,86619,86620,1,2,0
24720,4,1,86622,86622,86623,0,1,2
24721,3,1,86625,86625,86626,0,1,2
24722,3,1,86628,86628,86629,0,1,2
24723,2,2,86630,86630,86632,0,2,1
24724,4,3,86634,86634,86637,0,3,2
24725,2,1,86636,86637,86638,1,2,0
24726,2,1,86638,86638,86639,0,1,0
24727,2,1,86640,86640,86641,0,1,1
24728,2,2,86642,86642,86644,0,2,1
24729,5,3,86647,86647,86650,0,3,3
24730,1,3,86648,86650,86653,2,5,0
24731,5,1,86653,86653,86654,0,1,0
24732,6,1,86659,86659,86660,0,1,5
24733,5,1,86664,86664,86665,0,1,4
24734,6,2,86670,86670,86672,0,2,5
24735,2,2,86672,86672,86674,0,2,0
24736,1,1,86673,86674,86675,1,2,0
24737,2,2,86675,86675,86677,0,2,0
24738,1,1,86676,86677,86678,1,2,0
24739,1,3,86677,86678,86681,1,4,0
24740,2,2,86679,86681,86683,2,4,0
24741,2,3,86681,86683,86686,2,5,0
24742,5,1,86686,86686,86687,0,1,0
24743,5,2,86691,86691,86693,0,2,4
24744,5,2,86696,86696,86698,0,2,3
24745,2,2,86698,86698,86700,0,2,0
24746,5,2,86703,86703,86705,0,2,3
24747,4,3,86707,86707,86710,0,3,2
24748,3,2,86710,86710,86712,0,2,0
24749,1,2,86711,86712,86714,1,3,0
24750,3,2,86714,86714,86716,0,2,0
24751,3,1,86717,86717,86718,0,1,1
24752,3,2,86720,86720,86722,0,2,2
24753,3,2,86723,86723,86725,0,2,1
24754,5,1,86728,86728,86729,0,1,3
24755,4,1,86732,86732,86733,0,1,3
24756,5,2,86737,86737,86739,0,2,4
24757,5,3,86742,86742,86745,0,3,3
24758,5,2,86747,86747,86749,0,2,2
24759,2,3,86749,86749,86752,0,3,0
24760,2,2,86751,86752,86754,1,3,0
24761,2,1,86753,86754,86755,1,2,0
24762,5,2,86758,86758,86760,0,2,3
24763,2,2,86760,86760,86762,0,2,0
24764,5,1,86765,86765,86766,0,1,3
24765,6,1,86771,86771,86772,0,1,5
24766,4,1,86775,86775,86776,0,1,3
24767,5,3,86780,86780,86783,0,3,4
24768,1,3,86781,86783,86786,2,5,0
24769,3,2,86784,86786,86788,2,4,0
24770,6,2,86790,86790,86792,0,2,2
24771,3,2,86793,86793,86795,0,2,1
24772,3,3,86796,86796,86799,0,3,1
24773,4,1,86800,86800,86801,0,1,1
24774,4,3,86804,86804,86807,0,3,3
24775,3,3,86807,86807,86810,0,3,0
24776,5,1,86812,86812,86813,0,1,2
24777,4,3,86816,86816,86819,0,3,3
24778,6,3,86822,86822,86825,0,3,3
24779,3,2,86825,86825,86827,0,2,0
24780,3,3,86828,86828,86831,0,3,1
24781,2,3,86830,86831,86834,1,4,0
24782,3,1,86833,86834,86835,1,2,0
24783,4,3,86837,86837,86840,0,3,2
24784,5,1,86842,86842,86843,0,1,2
24785,4,2,86846,86846,86848,0,2,3
24786,3,2,86849,86849,86851,0,2,1
24787,4,2,86853,86853,86855,0,2,2
24788,3,2,86856,86856,86858,0,2,1
24789,1,1,86857,86858,86859,1,2,0
24790,5,3,86862,86862,86865,0,3,3
24791,2,3,86864,86865,86868,1,4,0
24792,3,1,86867,86868,86869,1,2,0
24793,6,3,86873,86873,86876,0,3,4
24794,5,3,86878,86878,86881,0,3,2
24795,2,2,86880,86881,86883,1,3,0
24796,6,3,86886,86886,86889,0,3,3
24797,5,1,86891,86891,86892,0,1,2
24798,1,1,86892,86892,86893,0,1,0
24799,6,3,86898,86898,86901,0,3,5
24800,4,3,86902,86902,86905,0,3,1
24801,4,2,86906,86906,86908,0,2,1
24802,3,1,86909,86909,86910,0,1,1
24803,1,2,86910,86910,86912,0,2,0
24804,1,1,86911,86912,86913,1,2,0
24805,1,2,86912,86913,86915,1,3,0
24806,3,1,86915,86915,86916,0,1,0
24807,4,3,86919,86919,86922,0,3,3
24808,1,1,86920,86922,86923,2,3,0
24809,4,3,86924,86924,86927,0,3,1
24810,2,3,86926,86927,86930,1,4,0
24811,6,1,86932,86932,86933,0,1,2
24812,4,2,86936,86936,86938,0,2,3
24813,1,3,86937,86938,86941,1,4,0
24814,6,1,86943,86943,86944,0,1,2
24815,3,2,86946,86946,86948,0,2,2
24816,6,2,86952,86952,86954,0,2,4
24817,6,2,86958,86958,86960,0,2,4
24818,5,2,86963,86963,86965,0,2,3
24819,2,2,86965,86965,86967,0,2,0
24820,6,2,86971,86971,86973,0,2,4
24821,3,2,86974,86974,86976,0,2,1
24822,2,1,86976,86976,86977,0,1,0
24823,1,3,86977,86977,86980,0,3,0
24824,5,1,86982,86982,86983,0,1,2
24825,2,3,86984,86984,86987,0,3,1
24826,6,2,86990,86990,86992,0,2,3
24827,3,1,86993,86993,86994,0,1,1
24828,2,1,86995,86995,86996,0,1,1
24829,5,3,87000,87000,87003,0,3,4
24830,6,3,87006,87006,87009,0,3,3
24831,3,2,87009,87009,87011,0,2,0
24832,3,3,87012,87012,87015,0,3,1
24833,3,1,87015,87015,87016,0,1,0
24834,4,3,87019,87019,87022,0,3,3
24835,2,2,87021,87022,87024,1,3,0
24836,3,2,87024,87024,87026,0,2,0
24837,4,3,87028,87028,87031,0,3,2
24838,2,1,87030,87031,87032,1,2,0
24839,1,2,87031,87032,87034,1,3,0
24840,4,1,87035,87035,87036,0,1,1
24841,2,3,87037,87037,87040,0,3,1
24842,2,2,87039,87040,87042,1,3,0
24843,1,3,87040,87042,87045,2,5,0
24844,6,3,87046,87046,87049,0,3,1
24845,2,1,87048,87049,87050,1,2,0
24846,6,3,87054,87054,87057,0,3,4
24847,2,1,87056,87057,87058,1,2,0
24848,2,2,87058,87058,87060,0,2,0
24849,3,1,87061,87061,87062,0,1,1
24850,2,3,87063,87063,87066,0,3,1
24851,4,1,87067,87067,87068,0,1,1
24852,6,1,87073,87073,87074,0,1,5
24853,2,2,87075,87075,87077,0,2,1
24854,4,1,87079,87079,87080,0,1,2
24855,6,1,87085,87085,87086,0,1,5
24856,2,2,87087,87087,87089,0,2,1
24857,3,3,87090,87090,87093,0,3,1
24858,6,3,87096,87096,87099,0,3,3
24859,5,1,87101,87101,87102,0,1,2
24860,1,2,87102,87102,87104,0,2,0
24861,5,3,87107,87107,87110,0,3,3
24862,4,2,87111,87111,87113,0,2,1
24863,2,1,87113,87113,87114,0,1,0
24864,5,2,87118,87118,87120,0,2,4
24865,4,2,87122,87122,87124,0,2,2
24866,3,3,87125,87125,87128,0,3,1
24867,1,1,87126,87128,87129,2,3,0
24868,3,1,87129,87129,87130,0,1,0
24869,4,1,87133,87133,87134,0,1,3
24870,2,1,87135,87135,87136,0,1,1
24871,1,2,87136,87136,87138,0,2,0
24872,2,2,87138,87138,87140,0,2,0
24873,6,2,87144,87144,87146,0,2,4
24874,3,2,87147,87147,87149,0,2,1
24875,5,3,87152,87152,87155,0,3,3
24876,6,1,87158,87158,87159,0,1,3
24877,1,3,87159,87159,87162,0,3,0
24878,5,2,87164,87164,87166,0,2,2
24879,3,1,87167,87167,87168,0,1,1
24880,4,2,87171,87171,87173,0,2,3
24881,4,1,87175,87175,87176,0,1,2
24882,3,1,87178,87178,87179,0,1,2
24883,4,1,87182,87182,87183,0,1,3
24884,4,1,87186,87186,87187,0,1,3
24885,3,1,87189,87189,87190,0,1,2
24886,4,3,87193,87193,87196,0,3,3
24887,1,1,87194,87196,87197,2,3,0
24888,3,3,87197,87197,87200,0,3,0
24889,2,2,87199,87200,87202,1,3,0
24890,5,3,87204,87204,87207,0,3,2
24891,2,3,87206,87207,87210,1,4,0
24892,3,3,87209,87210,87213,1,4,0
24893,2,3,87211,87213,87216,2,5,0
24894,4,2,87215,87216,87218,1,3,0
24895,3,3,87218,87218,87221,0,3,0
24896,6,1,87224,87224,87225,0,1,3
24897,6,3,87230,87230,87233,0,3,5
24898,6,3,87236,87236,87239,0,3,3
24899,3,1,87239,87239,87240,0,1,0
24900,3,1,87242,87242,87243,0,1,2
24901,2,2,87244,87244,87246,0,2,1
24902,4,2,87248,87248,87250,0,2,2
24903,3,3,87251,87251,87254,0,3,1
24904,2,1,87253,87254,87255,1,2,0
24905,2,1,87255,87255,87256,0,1,0
24906,5,2,87260,87260,87262,0,2,4
24907,1,2,87261,87262,87264,1,3,0
24908,4,3,87265,87265,87268,0,3,1
24909,1,1,87266,87268,87269,2,3,0
24910,3,1,87269,87269,87270,0,1,0
24911,6,1,87275,87275,87276,0,1,5
24912,6,3,87281,87281,87284,0,3,5
24913,3,1,87284,87284,87285,0,1,0
24914,3,1,87287,87287,87288,0,1,2
24915,5,1,87292,87292,87293,0,1,4
24916,5,3,87297,87297,87300,0,3,4
24917,4,2,87301,87301,87303,0,2,1
24918,1,2,87302,87303,87305,1,3,0
24919,6,1,87308,87308,87309,0,1,3
24920,2,2,87310,87310,87312,0,2,1
24921,2,2,87312,87312,87314,0,2,0
24922,5,1,87317,87317,87318,0,1,3
24923,1,1,87318,87318,87319,0,1,0
24924,4,2,87322,87322,87324,0,2,3
24925,1,3,87323,87324,87327,1,4,0
24926,5,3,87328,87328,87331,0,3,1
24927,3,3,87331,87331,87334,0,3,0
24928,6,3,87337,87337,87340,0,3,3
24929,6,1,87343,87343,87344,0,1,3
24930,4,3,87347,87347,87350,0,3,3
24931,3,3,87350,87350,87353,0,3,0
24932,6,3,87356,87356,87359,0,3,3
24933,3,3,87359,87359,87362,0,3,0
24934,6,1,87365,87365,87366,0,1,3
24935,1,3,87366,87366,87369,0,3,0
24936,5,1,87371,87371,87372,0,1,2
24937,2,3,87373,87373,87376,0,3,1
24938,3,3,87376,87376,87379,0,3,0
24939,5,2,87381,87381,87383,0,2,2
24940,6,2,87387,87387,87389,0,2,4
24941,1,1,87388,87389,87390,1,2,0
24942,5,1,87393,87393,87394,0,1,3
24943,6,1,87399,87399,87400,0,1,5
24944,4,3,87403,87403,87406,0,3,3
24945,3,1,87406,87406,87407,0,1,0
24946,4,1,87410,87410,87411,0,1,3
24947,4,3,87414,87414,87417,0,3,3
24948,4,2,87418,87418,87420,0,2,1
24949,1,1,87419,87420,87421,1,2,0
24950,1,3,87420,87421,87424,1,4,0
24951,2,1,87422,87424,87425,2,3,0
24952,5,1,87427,87427,87428,0,1,2
24953,3,1,87430,87430,87431,0,1,2
24954,3,1,87433,87433,87434,0,1,2
24955,4,2,87437,87437,87439,0,2,3
24956,5,2,87442,87442,87444,0,2,3
24957,1,1,87443,87444,87445,1,2,0
24958,4,2,87447,87447,87449,0,2,2
24959,6,1,87453,87453,87454,0,1,4
24960,6,1,87459,87459,87460,0,1,5
24961,5,2,87464,87464,87466,0,2,4
24962,4,2,87468,87468,87470,0,2,2
24963,3,3,87471,87471,87474,0,3,1
24964,6,2,87477,87477,87479,0,2,3
24965,4,3,87481,87481,87484,0,3,2
24966,2,3,87483,87484,87487,1,4,0
24967,2,2,87485,87487,87489,2,4,0
24968,2,2,87487,87489,87491,2,4,0
24969,4,3,87491,87491,87494,0,3,0
24970,5,1,87496,87496,87497,0,1,2
24971,4,2,87500,87500,87502,0,2,3
24972,5,3,87505,87505,87508,0,3,3
24973,6,1,87511,87511,87512,0,1,3
24974,5,3,87516,87516,87519,0,3,4
24975,3,3,87519,87519,87522,0,3,0
24976,3,1,87522,87522,87523,0,1,0
24977,6,1,87528,87528,87529,0,1,5
24978,5,2,87533,87533,87535,0,2,4
24979,3,2,87536,87536,87538,0,2,1
24980,4,1,87540,87540,87541,0,1,2
24981,5,2,87545,87545,87547,0,2,4
24982,2,1,87547,87547,87548,0,1,0
24983,3,2,87550,87550,87552,0,2,2
24984,6,3,87556,87556,87559,0,3,4
24985,6,2,87562,87562,87564,0,2,3
24986,1,2,87563,87564,87566,1,3,0
24987,2,1,87565,87566,87567,1,2,0
24988,4,1,87569,87569,87570,0,1,2
24989,4,1,87573,87573,87574,0,1,3
24990,4,1,87577,87577,87578,0,1,3
24991,5,3,87582,87582,87585,0,3,4
24992,2,2,87584,87585,87587,1,3,0
24993,1,1,87585,87587,87588,2,3,0
24994,1,3,87586,87588,87591,2,5,0
24995,6,2,87592,87592,87594,0,2,1
24996,5,1,87597,87597,87598,0,1,3
24997,4,3,87601,87601,87604,0,3,3
24998,4,1,87605,87605,87606,0,1,1
24999,5,2,87610,87610,87612,0,2,4
25000,5,1,87615,87615,87616,0,1,3
25001,3,1,87618,87618,87619,0,1,2
25002,2,3,87620,87620,87623,0,3,1
25003,5,2,87625,87625,87627,0,2,2
25004,1,2,87626,87627,87629,1,3,0
25005,4,1,87630,87630,87631,0,1,1
25006,5,1,87635,87635,87636,0,1,4
25007,6,2,87641,87641,87643,0,2,5
25008,2,2,87643,87643,87645,0,2,0
25009,1,2,87644,87645,87647,1,3,0
25010,3,3,87647,87647,87650,0,3,0
25011,6,2,87653,87653,87655,0,2,3
25012,6,1,87659,87659,87660,0,1,4
25013,1,3,87660,87660,87663,0,3,0
25014,5,1,87665,87665,87666,0,1,2
25015,6,3,87671,87671,87674,0,3,5
25016,1,1,87672,87674,87675,2,3,0
25017,2,3,87674,87675,87678,1,4,0
25018,5,2,87679,87679,87681,0,2,1
25019,5,2,87684,87684,87686,0,2,3
25020,3,1,87687,87687,87688,0,1,1
25021,3,2,87690,87690,87692,0,2,2
25022,1,2,87691,87692,87694,1,3,0
25023,5,2,87696,87696,87698,0,2,2
25024,6,2,87702,87702,87704,0,2,4
25025,4,2,87706,87706,87708,0,2,2
25026,2,2,87708,87708,87710,0,2,0
25027,6,3,87714,87714,87717,0,3,4
25028,2,2,87716,87717,87719,1,3,0
25029,6,2,87722,87722,87724,0,2,3
25030,1,3,87723,87724,87727,1,4,0
25031,3,3,87726,87727,87730,1,4,0
25032,4,1,87730,87730,87731,0,1,0
25033,4,3,87734,87734,87737,0,3,3
25034,1,2,87735,87737,87739,2,4,0
25035,1,1,87736,87739,87740,3,4,0
25036,1,3,87737,87740,87743,3,6,0
25037,3,3,87740,87743,87746,3,6,0
25038,2,1,87742,87746,87747,4,5,0
25039,1,3,87743,87747,87750,4,7,0
25040,3,3,87746,87750,87753,4,7,0
25041,5,1,87751,87753,87754,2,3,0
25042,5,1,87756,87756,87757,0,1,2
25043,3,2,87759,87759,87761,0,2,2
25044,5,3,87764,87764,87767,0,3,3
25045,5,2,87769,87769,87771,0,2,2
25046,1,1,87770,87771,87772,1,2,0
25047,3,3,87773,87773,87776,0,3,1
25048,2,2,87775,87776,87778,1,3,0
25049,4,1,87779,87779,87780,0,1,1
25050,5,3,87784,87784,87787,0,3,4
25051,5,1,87789,87789,87790,0,1,2
25052,4,1,87793,87793,87794,0,1,3
25053,4,3,87797,87797,87800,0,3,3
25054,2,1,87799,87800,87801,1,2,0
25055,1,1,87800,87801,87802,1,2,0
25056,6,3,87806,87806,87809,0,3,4
25057,6,2,87812,87812,87814,0,2,3
25058,2,3,87814,87814,87817,0,3,0
25059,5,3,87819,87819,87822,0,3,2
25060,1,3,87820,87822,87825,2,5,0
25061,3,3,87823,87825,87828,2,5,0
25062,2,2,87825,87828,87830,3,5,0
25063,1,2,87826,87830,87832,4,6,0
25064,1,1,87827,87832,87833,5,6,0
25065,1,1,87828,87833,87834,5,6,0
25066,1,1,87829,87834,87835,5,6,0
25067,6,2,87835,87835,87837,0,2,0
25068,5,1,87840,87840,87841,0,1,3
25069,5,1,87845,87845,87846,0,1,4
25070,1,2,87846,87846,87848,0,2,0
25071,6,2,87852,87852,87854,0,2,4
25072,2,1,87854,87854,87855,0,1,0
25073,5,1,87859,87859,87860,0,1,4
25074,1,3,87860,87860,87863,0,3,0
25075,6,3,87866,87866,87869,0,3,3
25076,1,1,87867,87869,87870,2,3,0
25077,1,1,87868,87870,87871,2,3,0
25078,4,3,87872,87872,87875,0,3,1
25079,6,1,87878,87878,87879,0,1,3
25080,4,2,87882,87882,87884,0,2,3
25081,6,2,87888,87888,87890,0,2,4
25082,3,2,87891,87891,87893,0,2,1
25083,6,1,87897,87897,87898,0,1,4
25084,1,1,87898,87898,87899,0,1,0
25085,4,2,87902,87902,87904,0,2,3
25086,5,3,87907,87907,87910,0,3,3
25087,2,1,87909,87910,87911,1,2,0
25088,3,1,87912,87912,87913,0,1,1
25089,4,1,87916,87916,87917,0,1,3
25090,3,3,87919,87919,87922,0,3,2
25091,6,1,87925,87925,87926,0,1,3
25092,1,1,87926,87926,87927,0,1,0
25093,5,3,87931,87931,87934,0,3,4
25094,4,1,87935,87935,87936,0,1,1
25095,2,3,87937,87937,87940,0,3,1
25096,2,2,87939,87940,87942,1,3,0
25097,2,2,87941,87942,87944,1,3,0
25098,6,1,87947,87947,87948,0,1,3
25099,5,1,87952,87952,87953,0,1,4
25100,5,2,87957,87957,87959,0,2,4
25101,3,3,87960,87960,87963,0,3,1
25102,3,2,87963,87963,87965,0,2,0
25103,2,2,87965,87965,87967,0,2,0
25104,1,1,87966,87967,87968,1,2,0
25105,4,2,87970,87970,87972,0,2,2
25106,2,3,87972,87972,87975,0,3,0
25107,3,1,87975,87975,87976,0,1,0
25108,6,1,87981,87981,87982,0,1,5
25109,4,3,87985,87985,87988,0,3,3
25110,5,1,87990,87990,87991,0,1,2
25111,5,3,87995,87995,87998,0,3,4
25112,5,3,88000,88000,88003,0,3,2
25113,1,3,88001,88003,88006,2,5,0
25114,1,3,88002,88006,88009,4,7,0
25115,4,2,88006,88009,88011,3,5,0
25116,4,2,88010,88011,88013,1,3,0
25117,6,1,88016,88016,88017,0,1,3
25118,4,1,88020,88020,88021,0,1,3
25119,4,2,88024,88024,88026,0,2,3
25120,4,1,88028,88028,88029,0,1,2
25121,5,2,88033,88033,88035,0,2,4
25122,2,3,88035,88035,88038,0,3,0
25123,1,2,88036,88038,88040,2,4,0
25124,3,1,88039,88040,88041,1,2,0
25125,5,2,88044,88044,88046,0,2,3
25126,5,3,88049,88049,88052,0,3,3
25127,5,2,88054,88054,88056,0,2,2
25128,3,3,88057,88057,88060,0,3,1
25129,2,1,88059,88060,88061,1,2,0
25130,1,1,88060,88061,88062,1,2,0
25131,5,2,88065,88065,88067,0,2,3
25132,6,2,88071,88071,88073,0,2,4
25133,1,2,88072,88073,88075,1,3,0
25134,3,2,88075,88075,88077,0,2,0
25135,3,2,88078,88078,88080,0,2,1
25136,6,2,88084,88084,88086,0,2,4
25137,4,1,88088,88088,88089,0,1,2
25138,5,1,88093,88093,88094,0,1,4
25139,4,1,88097,88097,88098,0,1,3
25140,5,1,88102,88102,88103,0,1,4
25141,5,3,88107,88107,88110,0,3,4
25142,4,2,88111,88111,88113,0,2,1
25143,4,2,88115,88115,88117,0,2,2
25144,5,1,88120,88120,88121,0,1,3
25145,5,1,88125,88125,88126,0,1,4
25146,2,2,88127,88127,88129,0,2,1
25147,2,2,88129,88129,88131,0,2,0
25148,3,3,88132,88132,88135,0,3,1
25149,5,3,88137,88137,88140,0,3,2
25150,6,3,88143,88143,88146,0,3,3
25151,6,2,88149,88149,88151,0,2,3
25152,3,3,88152,88152,88155,0,3,1
25153,3,2,88155,88155,88157,0,2,0
25154,2,1,88157,88157,88158,0,1,0
25155,6,2,88163,88163,88165,0,2,5
25156,2,3,88165,88165,88168,0,3,0
25157,3,3,88168,88168,88171,0,3,0
25158,1,3,88169,88171,88174,2,5,0
25159,4,1,88173,88174,88175,1,2,0
25160,3,2,88176,88176,88178,0,2,1
25161,2,1,88178,88178,88179,0,1,0
25162,4,1,88182,88182,88183,0,1,3
25163,6,3,88188,88188,88191,0,3,5
25164,6,2,88194,88194,88196,0,2,3
25165,3,3,88197,88197,88200,0,3,1
25166,6,3,88203,88203,88206,0,3,3
25167,2,1,88205,88206,88207,1,2,0
25168,4,1,88209,88209,88210,0,1,2
25169,4,2,88213,88213,88215,0,2,3
25170,2,1,88215,88215,88216,0,1,0
25171,5,3,88220,88220,88223,0,3,4
25172,6,2,88226,88226,88228,0,2,3
25173,3,1,88229,88229,88230,0,1,1
25174,3,1,88232,88232,88233,0,1,2
25175,4,3,88236,88236,88239,0,3,3
25176,4,2,88240,88240,88242,0,2,1
25177,5,2,88245,88245,88247,0,2,3
25178,2,3,88247,88247,88250,0,3,0
25179,5,3,88252,88252,88255,0,3,2
25180,4,3,88256,88256,88259,0,3,1
25181,4,3,88260,88260,88263,0,3,1
25182,3,2,88263,88263,88265,0,2,0
25183,4,3,88267,88267,88270,0,3,2
25184,2,1,88269,88270,88271,1,2,0
25185,6,2,88275,88275,88277,0,2,4
25186,3,3,88278,88278,88281,0,3,1
25187,2,2,88280,88281,88283,1,3,0
25188,1,1,88281,88283,88284,2,3,0
25189,5,2,88286,88286,88288,0,2,2
25190,4,3,88290,88290,88293,0,3,2
25191,3,3,88293,88293,88296,0,3,0
25192,5,2,88298,88298,88300,0,2,2
25193,4,1,88302,88302,88303,0,1,2
25194,4,2,88306,88306,88308,0,2,3
25195,2,2,88308,88308,88310,0,2,0
25196,1,2,88309,88310,88312,1,3,0
25197,6,3,88315,88315,88318,0,3,3
25198,1,3,88316,88318,88321,2,5,0
25199,2,3,88318,88321,88324,3,6,0
25200,6,1,88324,88324,88325,0,1,0
25201,3,3,88327,88327,88330,0,3,2
25202,6,1,88333,88333,88334,0,1,3
25203,3,1,88336,88336,88337,0,1,2
25204,6,1,88342,88342,88343,0,1,5
25205,5,1,88347,88347,88348,0,1,4
25206,4,3,88351,88351,88354,0,3,3
25207,4,1,88355,88355,88356,0,1,1
25208,3,1,88358,88358,88359,0,1,2
25209,3,2,88361,88361,88363,0,2,2
25210,2,3,88363,88363,88366,0,3,0
25211,1,2,88364,88366,88368,2,4,0
25212,3,3,88367,88368,88371,1,4,0
25213,1,2,88368,88371,88373,3,5,0
25214,2,2,88370,88373,88375,3,5,0
25215,3,1,88373,88375,88376,2,3,0
25216,4,2,88377,88377,88379,0,2,1
25217,4,1,88381,88381,88382,0,1,2
25218,2,3,88383,88383,88386,0,3,1
25219,2,3,88385,88386,88389,1,4,0
25220,6,1,88391,88391,88392,0,1,2
25221,1,3,88392,88392,88395,0,3,0
25222,1,1,88393,88395,88396,2,3,0
25223,4,2,88397,88397,88399,0,2,1
25224,5,1,88402,88402,88403,0,1,3
25225,2,3,88404,88404,88407,0,3,1
25226,4,3,88408,88408,88411,0,3,1
25227,1,2,88409,88411,88413,2,4,0
25228,4,1,88413,88413,88414,0,1,0
25229,1,3,88414,88414,88417,0,3,0
25230,5,2,88419,88419,88421,0,2,2
25231,4,2,88423,88423,88425,0,2,2
25232,2,3,88425,88425,88428,0,3,0
25233,1,3,88426,88428,88431,2,5,0
25234,2,2,88428,88431,88433,3,5,0
25235,2,1,88430,88433,88434,3,4,0
25236,5,3,88435,88435,88438,0,3,1
25237,5,1,88440,88440,88441,0,1,2
25238,1,3,88441,88441,88444,0,3,0
25239,1,3,88442,88444,88447,2,5,0
25240,1,1,88443,88447,88448,4,5,0
25241,5,2,88448,88448,88450,0,2,0
25242,2,1,88450,88450,88451,0,1,0
25243,1,1,88451,88451,88452,0,1,0
25244,6,2,88457,88457,88459,0,2,5
25245,1,3,88458,88459,88462,1,4,0
25246,5,3,88463,88463,88466,0,3,1
25247,2,2,88465,88466,88468,1,3,0
25248,3,3,88468,88468,88471,0,3,0
25249,3,1,88471,88471,88472,0,1,0
25250,5,2,88476,88476,88478,0,2,4
25251,6,1,88482,88482,88483,0,1,4
25252,2,2,88484,88484,88486,0,2,1
25253,1,1,88485,88486,88487,1,2,0
25254,5,2,88490,88490,88492,0,2,3
25255,3,1,88493,88493,88494,0,1,1
25256,3,2,88496,88496,88498,0,2,2
25257,1,3,88497,88498,88501,1,4,0
25258,5,1,88502,88502,88503,0,1,1
25259,5,2,88507,88507,88509,0,2,4
25260,1,2,88508,88509,88511,1,3,0
25261,2,3,88510,88511,88514,1,4,0
25262,3,1,88513,88514,88515,1,2,0
25263,6,3,88519,88519,88522,0,3,4
25264,1,3,88520,88522,88525,2,5,0
25265,4,3,88524,88525,88528,1,4,0
25266,5,3,88529,88529,88532,0,3,1
25267,4,2,88533,88533,88535,0,2,1
25268,3,3,88536,88536,88539,0,3,1
25269,1,3,88537,88539,88542,2,5,0
25270,3,3,88540,88542,88545,2,5,0
25271,1,3,88541,88545,88548,4,7,0
25272,6,2,88547,88548,88550,1,3,0
25273,4,3,88551,88551,88554,0,3,1
25274,4,1,88555,88555,88556,0,1,1
25275,1,2,88556,88556,88558,0,2,0
25276,2,1,88558,88558,88559,0,1,0
25277,1,1,88559,88559,88560,0,1,0
25278,1,2,88560,88560,88562,0,2,0
25279,2,1,88562,88562,88563,0,1,0
25280,6,3,88568,88568,88571,0,3,5
25281,6,1,88574,88574,88575,0,1,3
25282,5,3,88579,88579,88582,0,3,4
25283,1,2,88580,88582,88584,2,4,0
25284,3,2,88583,88584,88586,1,3,0
25285,4,1,88587,88587,88588,0,1,1
25286,3,1,88590,88590,88591,0,1,2
25287,2,3,88592,88592,88595,0,3,1
25288,3,3,88595,88595,88598,0,3,0
25289,1,2,88596,88598,88600,2,4,0
25290,1,1,88597,88600,88601,3,4,0
25291,1,3,88598,88601,88604,3,6,0
25292,1,2,88599,88604,88606,5,7,0
25293,6,3,88605,88606,88609,1,4,0
25294,2,2,88607,88609,88611,2,4,0
25295,6,1,88613,88613,88614,0,1,2
25296,3,2,88616,88616,88618,0,2,2
25297,1,3,88617,88618,88621,1,4,0
25298,2,3,88619,88621,88624,2,5,0
25299,6,1,88625,88625,88626,0,1,1
25300,1,3,88626,88626,88629,0,3,0
25301,1,2,88627,88629,88631,2,4,0
25302,1,1,88628,88631,88632,3,4,0
25303,2,1,88630,88632,88633,2,3,0
25304,3,2,88633,88633,88635,0,2,0
25305,5,3,88638,88638,88641,0,3,3
25306,5,3,88643,88643,88646,0,3,2
25307,5,3,88648,88648,88651,0,3,2
25308,4,3,88652,88652,88655,0,3,1
25309,4,1,88656,88656,88657,0,1,1
25310,1,3,88657,88657,88660,0,3,0
25311,3,1,88660,88660,88661,0,1,0
25312,1,1,88661,88661,88662,0,1,0
25313,5,2,88666,88666,88668,0,2,4
25314,4,3,88670,88670,88673,0,3,2
25315,5,3,88675,88675,88678,0,3,2
25316,3,3,88678,88678,88681,0,3,0
25317,1,3,88679,88681,88684,2,5,0
25318,3,1,88682,88684,88685,2,3,0
25319,1,3,88683,88685,88688,2,5,0
25320,6,2,88689,88689,88691,0,2,1
25321,6,3,88695,88695,88698,0,3,4
25322,2,3,88697,88698,88701,1,4,0
25323,1,2,88698,88701,88703,3,5,0
25324,6,1,88704,88704,88705,0,1,1
25325,2,2,88706,88706,88708,0,2,1
25326,1,3,88707,88708,88711,1,4,0
25327,4,2,88711,88711,88713,0,2,0
25328,6,3,88717,88717,88720,0,3,4
25329,4,1,88721,88721,88722,0,1,1
25330,4,3,88725,88725,88728,0,3,3
25331,2,2,88727,88728,88730,1,3,0
25332,1,3,88728,88730,88733,2,5,0
25333,3,1,88731,88733,88734,2,3,0
25334,3,3,88734,88734,88737,0,3,0
25335,5,2,88739,88739,88741,0,2,2
25336,2,1,88741,88741,88742,0,1,0
25337,4,3,88745,88745,88748,0,3,3
25338,6,2,88751,88751,88753,0,2,3
25339,2,1,88753,88753,88754,0,1,0
25340,2,3,88755,88755,88758,0,3,1
25341,6,1,88761,88761,88762,0,1,3
25342,2,2,88763,88763,88765,0,2,1
25343,5,1,88768,88768,88769,0,1,3
25344,1,1,88769,88769,88770,0,1,0
25345,3,2,88772,88772,88774,0,2,2
25346,4,3,88776,88776,88779,0,3,2
25347,5,1,88781,88781,88782,0,1,2
25348,5,1,88786,88786,88787,0,1,4
25349,3,3,88789,88789,88792,0,3,2
25350,3,3,88792,88792,88795,0,3,0
25351,6,2,88798,88798,88800,0,2,3
25352,2,1,88800,88800,88801,0,1,0
25353,2,3,88802,88802,88805,0,3,1
25354,6,3,88808,88808,88811,0,3,3
25355,4,3,88812,88812,88815,0,3,1
25356,4,2,88816,88816,88818,0,2,1
25357,2,1,88818,88818,88819,0,1,0
25358,6,1,88824,88824,88825,0,1,5
25359,3,3,88827,88827,88830,0,3,2
25360,5,3,88832,88832,88835,0,3,2
25361,6,1,88838,88838,88839,0,1,3
25362,5,2,88843,88843,88845,0,2,4
25363,5,2,88848,88848,88850,0,2,3
25364,1,1,88849,88850,88851,1,2,0
25365,2,2,88851,88851,88853,0,2,0
25366,1,1,88852,88853,88854,1,2,0
25367,4,3,88856,88856,88859,0,3,2
25368,5,1,88861,88861,88862,0,1,2
25369,3,1,88864,88864,88865,0,1,2
25370,2,1,88866,88866,88867,0,1,1
25371,1,1,88867,88867,88868,0,1,0
25372,2,2,88869,88869,88871,0,2,1
25373,5,3,88874,88874,88877,0,3,3
25374,2,1,88876,88877,88878,1,2,0
25375,6,2,88882,88882,88884,0,2,4
25376,2,2,88884,88884,88886,0,2,0
25377,1,3,88885,88886,88889,1,4,0
25378,3,2,88888,88889,88891,1,3,0
25379,1,3,88889,88891,88894,2,5,0
25380,2,3,88891,88894,88897,3,6,0
25381,5,3,88896,88897,88900,1,4,0
25382,6,1,88902,88902,88903,0,1,2
25383,1,3,88903,88903,88906,0,3,0
25384,2,1,88905,88906,88907,1,2,0
25385,1,2,88906,88907,88909,1,3,0
25386,2,1,88908,88909,88910,1,2,0
25387,1,3,88909,88910,88913,1,4,0
25388,1,3,88910,88913,88916,3,6,0
25389,5,3,88915,88916,88919,1,4,0
25390,4,3,88919,88919,88922,0,3,0
25391,3,2,88922,88922,88924,0,2,0
25392,3,2,88925,88925,88927,0,2,1
25393,5,1,88930,88930,88931,0,1,3
25394,4,3,88934,88934,88937,0,3,3
25395,4,3,88938,88938,88941,0,3,1
25396,1,3,88939,88941,88944,2,5,0
25397,2,1,88941,88944,88945,3,4,0
25398,4,3,88945,88945,88948,0,3,0
25399,2,2,88947,88948,88950,1,3,0
25400,3,3,88950,88950,88953,0,3,0
25401,4,2,88954,88954,88956,0,2,1
25402,1,3,88955,88956,88959,1,4,0
25403,6,2,88961,88961,88963,0,2,2
25404,4,3,88965,88965,88968,0,3,2
25405,2,3,88967,88968,88971,1,4,0
25406,1,3,88968,88971,88974,3,6,0
25407,4,3,88972,88974,88977,2,5,0
25408,5,3,88977,88977,88980,0,3,0
25409,1,2,88978,88980,88982,2,4,0
25410,4,2,88982,88982,88984,0,2,0
25411,3,2,88985,88985,88987,0,2,1
25412,2,3,88987,88987,88990,0,3,0
25413,3,1,88990,88990,88991,0,1,0
25414,6,3,88996,88996,88999,0,3,5
25415,6,3,89002,89002,89005,0,3,3
25416,2,2,89004,89005,89007,1,3,0
25417,5,3,89009,89009,89012,0,3,2
25418,4,3,89013,89013,89016,0,3,1
25419,6,2,89019,89019,89021,0,2,3
25420,6,1,89025,89025,89026,0,1,4
25421,6,1,89031,89031,89032,0,1,5
25422,4,1,89035,89035,89036,0,1,3
25423,6,1,89041,89041,89042,0,1,5
25424,1,3,89042,89042,89045,0,3,0
25425,5,3,89047,89047,89050,0,3,2
25426,2,1,89049,89050,89051,1,2,0
25427,4,1,89053,89053,89054,0,1,2
25428,6,2,89059,89059,89061,0,2,5
25429,1,1,89060,89061,89062,1,2,0
25430,3,3,89063,89063,89066,0,3,1
25431,5,2,89068,89068,89070,0,2,2
25432,3,1,89071,89071,89072,0,1,1
25433,1,3,89072,89072,89075,0,3,0
25434,6,1,89078,89078,89079,0,1,3
25435,3,1,89081,89081,89082,0,1,2
25436,5,3,89086,89086,89089,0,3,4
25437,6,3,89092,89092,89095,0,3,3
25438,2,1,89094,89095,89096,1,2,0
25439,1,1,89095,89096,89097,1,2,0
25440,4,2,89099,89099,89101,0,2,2
25441,5,1,89104,89104,89105,0,1,3
25442,1,1,89105,89105,89106,0,1,0
25443,4,1,89109,89109,89110,0,1,3
25444,5,2,89114,89114,89116,0,2,4
25445,5,1,89119,89119,89120,0,1,3
25446,4,1,89123,89123,89124,0,1,3
25447,1,2,89124,89124,89126,0,2,0
25448,6,3,89130,89130,89133,0,3,4
25449,6,2,89136,89136,89138,0,2,3
25450,1,2,89137,89138,89140,1,3,0
25451,6,3,89143,89143,89146,0,3,3
25452,6,1,89149,89149,89150,0,1,3
25453,4,2,89153,89153,89155,0,2,3
25454,2,3,89155,89155,89158,0,3,0
25455,4,3,89159,89159,89162,0,3,1
25456,3,1,89162,89162,89163,0,1,0
25457,6,3,89168,89168,89171,0,3,5
25458,1,3,89169,89171,89174,2,5,0
25459,5,3,89174,89174,89177,0,3,0
25460,5,3,89179,89179,89182,0,3,2
25461,3,3,89182,89182,89185,0,3,0
25462,1,3,89183,89185,89188,2,5,0
25463,5,3,89188,89188,89191,0,3,0
25464,6,2,89194,89194,89196,0,2,3
25465,2,1,89196,89196,89197,0,1,0
25466,2,3,89198,89198,89201,0,3,1
25467,3,1,89201,89201,89202,0,1,0
25468,6,1,89207,89207,89208,0,1,5
25469,3,3,89210,89210,89213,0,3,2
25470,5,2,89215,89215,89217,0,2,2
25471,3,3,89218,89218,89221,0,3,1
25472,3,3,89221,89221,89224,0,3,0
25473,1,2,89222,89224,89226,2,4,0
25474,6,3,89228,89228,89231,0,3,2
25475,4,2,89232,89232,89234,0,2,1
25476,4,1,89236,89236,89237,0,1,2
25477,5,2,89241,89241,89243,0,2,4
25478,6,3,89247,89247,89250,0,3,4
25479,3,2,89250,89250,89252,0,2,0
25480,3,3,89253,89253,89256,0,3,1
25481,5,3,89258,89258,89261,0,3,2
25482,6,1,89264,89264,89265,0,1,3
25483,1,2,89265,89265,89267,0,2,0
25484,2,3,89267,89267,89270,0,3,0
25485,5,2,89272,89272,89274,0,2,2
25486,5,2,89277,89277,89279,0,2,3
25487,4,1,89281,89281,89282,0,1,2
25488,1,3,89282,89282,89285,0,3,0
25489,1,2,89283,89285,89287,2,4,0
25490,2,2,89285,89287,89289,2,4,0
25491,6,3,89291,89291,89294,0,3,2
25492,6,2,89297,89297,89299,0,2,3
25493,2,1,89299,89299,89300,0,1,0
25494,4,3,89303,89303,89306,0,3,3
25495,1,3,89304,89306,89309,2,5,0
25496,5,3,89309,89309,89312,0,3,0
25497,1,2,89310,89312,89314,2,4,0
25498,1,2,89311,89314,89316,3,5,0
25499,4,2,89315,89316,89318,1,3,0
25500,4,1,89319,89319,89320,0,1,1
25501,3,3,89322,89322,89325,0,3,2
25502,6,1,89328,89328,89329,0,1,3
25503,3,2,89331,89331,89333,0,2,2
25504,5,1,89336,89336,89337,0,1,3
25505,1,3,89337,89337,89340,0,3,0
25506,6,2,89343,89343,89345,0,2,3
25507,2,2,89345,89345,89347,0,2,0
25508,6,3,89351,89351,89354,0,3,4
25509,5,1,89356,89356,89357,0,1,2
25510,6,3,89362,89362,89365,0,3,5
25511,5,1,89367,89367,89368,0,1,2
25512,4,1,89371,89371,89372,0,1,3
25513,5,2,89376,89376,89378,0,2,4
25514,6,3,89382,89382,89385,0,3,4
25515,5,1,89387,89387,89388,0,1,2
25516,2,2,89389,89389,89391,0,2,1
25517,1,1,89390,89391,89392,1,2,0
25518,1,2,89391,89392,89394,1,3,0
25519,1,2,89392,89394,89396,2,4,0
25520,4,2,89396,89396,89398,0,2,0
25521,3,2,89399,89399,89401,0,2,1
25522,6,2,89405,89405,89407,0,2,4
25523,4,2,89409,89409,89411,0,2,2
25524,2,3,89411,89411,89414,0,3,0
25525,6,2,89417,89417,89419,0,2,3
25526,5,2,89422,89422,89424,0,2,3
25527,5,3,89427,89427,89430,0,3,3
25528,6,3,89433,89433,89436,0,3,3
25529,5,3,89438,89438,89441,0,3,2
25530,3,2,89441,89441,89443,0,2,0
25531,3,1,89444,89444,89445,0,1,1
25532,2,1,89446,89446,89447,0,1,1
25533,2,1,89448,89448,89449,0,1,1
25534,3,3,89451,89451,89454,0,3,2
25535,6,1,89457,89457,89458,0,1,3
25536,3,1,89460,89460,89461,0,1,2
25537,3,3,89463,89463,89466,0,3,2
25538,5,2,89468,89468,89470,0,2,2
25539,4,3,89472,89472,89475,0,3,2
25540,6,1,89478,89478,89479,0,1,3
25541,1,3,89479,89479,89482,0,3,0
25542,3,3,89482,89482,89485,0,3,0
25543,4,2,89486,89486,89488,0,2,1
25544,6,1,89492,89492,89493,0,1,4
25545,2,2,89494,89494,89496,0,2,1
25546,2,2,89496,89496,89498,0,2,0
25547,6,3,89502,89502,89505,0,3,4
25548,3,2,89505,89505,89507,0,2,0
25549,5,3,89510,89510,89513,0,3,3
25550,4,2,89514,89514,89516,0,2,1
25551,4,1,89518,89518,89519,0,1,2
25552,3,3,89521,89521,89524,0,3,2
25553,5,1,89526,89526,89527,0,1,2
25554,3,2,89529,89529,89531,0,2,2
25555,1,1,89530,89531,89532,1,2,0
25556,6,2,89536,89536,89538,0,2,4
25557,4,2,89540,89540,89542,0,2,2
25558,2,2,89542,89542,89544,0,2,0
25559,1,2,89543,89544,89546,1,3,0
25560,3,2,89546,89546,89548,0,2,0
25561,5,2,89551,89551,89553,0,2,3
25562,3,1,89554,89554,89555,0,1,1
25563,3,3,89557,89557,89560,0,3,2
25564,4,2,89561,89561,89563,0,2,1
25565,3,2,89564,89564,89566,0,2,1
25566,2,2,89566,89566,89568,0,2,0
25567,5,1,89571,89571,89572,0,1,3
25568,4,3,89575,89575,89578,0,3,3
25569,3,3,89578,89578,89581,0,3,0
25570,2,3,89580,89581,89584,1,4,0
25571,1,1,89581,89584,89585,3,4,0
25572,3,1,89584,89585,89586,1,2,0
25573,6,1,89590,89590,89591,0,1,4
25574,6,2,89596,89596,89598,0,2,5
25575,5,2,89601,89601,89603,0,2,3
25576,3,2,89604,89604,89606,0,2,1
25577,4,1,89608,89608,89609,0,1,2
25578,4,3,89612,89612,89615,0,3,3
25579,4,3,89616,89616,89619,0,3,1
25580,6,3,89622,89622,89625,0,3,3
25581,2,3,89624,89625,89628,1,4,0
25582,5,2,89629,89629,89631,0,2,1
25583,1,3,89630,89631,89634,1,4,0
25584,3,3,89633,89634,89637,1,4,0
25585,6,2,89639,89639,89641,0,2,2
25586,6,1,89645,89645,89646,0,1,4
25587,5,2,89650,89650,89652,0,2,4
25588,2,3,89652,89652,89655,0,3,0
25589,4,1,89656,89656,89657,0,1,1
25590,2,3,89658,89658,89661,0,3,1
25591,3,3,89661,89661,89664,0,3,0
25592,3,3,89664,89664,89667,0,3,0
25593,5,1,89669,89669,89670,0,1,2
25594,6,2,89675,89675,89677,0,2,5
25595,5,2,89680,89680,89682,0,2,3
25596,1,2,89681,89682,89684,1,3,0
25597,2,3,89683,89684,89687,1,4,0
25598,4,3,89687,89687,89690,0,3,0
25599,5,3,89692,89692,89695,0,3,2
25600,4,3,89696,89696,89699,0,3,1
25601,3,1,89699,89699,89700,0,1,0
25602,6,2,89705,89705,89707,0,2,5
25603,1,2,89706,89707,89709,1,3,0
25604,4,2,89710,89710,89712,0,2,1
25605,1,3,89711,89712,89715,1,4,0
25606,3,3,89714,89715,89718,1,4,0
25607,1,2,89715,89718,89720,3,5,0
25608,5,3,89720,89720,89723,0,3,0
25609,5,3,89725,89725,89728,0,3,2
25610,2,3,89727,89728,89731,1,4,0
25611,1,3,89728,89731,89734,3,6,0
25612,3,1,89731,89734,89735,3,4,0
25613,5,3,89736,89736,89739,0,3,1
25614,5,2,89741,89741,89743,0,2,2
25615,1,1,89742,89743,89744,1,2,0
25616,3,1,89745,89745,89746,0,1,1
25617,6,3,89751,89751,89754,0,3,5
25618,1,3,89752,89754,89757,2,5,0
25619,3,3,89755,89757,89760,2,5,0
25620,4,1,89759,89760,89761,1,2,0
25621,4,1,89763,89763,89764,0,1,2
25622,1,1,89764,89764,89765,0,1,0
25623,4,2,89768,89768,89770,0,2,3
25624,4,3,89772,89772,89775,0,3,2
25625,1,2,89773,89775,89777,2,4,0
25626,4,3,89777,89777,89780,0,3,0
25627,6,3,89783,89783,89786,0,3,3
25628,1,1,89784,89786,89787,2,3,0
25629,6,3,89790,89790,89793,0,3,3
25630,2,1,89792,89793,89794,1,2,0
25631,2,2,89794,89794,89796,0,2,0
25632,4,3,89798,89798,89801,0,3,2
25633,4,2,89802,89802,89804,0,2,1
25634,3,2,89805,89805,89807,0,2,1
25635,6,1,89811,89811,89812,0,1,4
25636,1,3,89812,89812,89815,0,3,0
25637,2,1,89814,89815,89816,1,2,0
25638,2,3,89816,89816,89819,0,3,0
25639,5,2,89821,89821,89823,0,2,2
25640,5,1,89826,89826,89827,0,1,3
25641,1,3,89827,89827,89830,0,3,0
25642,5,2,89832,89832,89834,0,2,2
25643,2,1,89834,89834,89835,0,1,0
25644,4,2,89838,89838,89840,0,2,3
25645,4,2,89842,89842,89844,0,2,2
25646,6,2,89848,89848,89850,0,2,4
25647,2,3,89850,89850,89853,0,3,0
25648,6,3,89856,89856,89859,0,3,3
25649,5,1,89861,89861,89862,0,1,2
25650,4,1,89865,89865,89866,0,1,3
25651,1,2,89866,89866,89868,0,2,0
25652,2,3,89868,89868,89871,0,3,0
25653,2,1,89870,89871,89872,1,2,0
25654,3,1,89873,89873,89874,0,1,1
25655,1,2,89874,89874,89876,0,2,0
25656,2,2,89876,89876,89878,0,2,0
25657,3,3,89879,89879,89882,0,3,1
25658,1,3,89880,89882,89885,2,5,0
25659,1,2,89881,89885,89887,4,6,0
25660,1,3,89882,89887,89890,5,8,0
25661,3,2,89885,89890,89892,5,7,0
25662,2,3,89887,89892,89895,5,8,0
25663,5,2,89892,89895,89897,3,5,0
25664,6,2,89898,89898,89900,0,2,1
25665,3,1,89901,89901,89902,0,1,1
25666,6,2,89907,89907,89909,0,2,5
25667,4,1,89911,89911,89912,0,1,2
25668,4,2,89915,89915,89917,0,2,3
25669,2,2,89917,89917,89919,0,2,0
25670,1,1,89918,89919,89920,1,2,0
25671,2,3,89920,89920,89923,0,3,0
25672,2,2,89922,89923,89925,1,3,0
25673,1,1,89923,89925,89926,2,3,0
25674,5,3,89928,89928,89931,0,3,2
25675,5,1,89933,89933,89934,0,1,2
25676,6,2,89939,89939,89941,0,2,5
25677,1,2,89940,89941,89943,1,3,0
25678,2,1,89942,89943,89944,1,2,0
25679,3,1,89945,89945,89946,0,1,1
25680,5,2,89950,89950,89952,0,2,4
25681,6,2,89956,89956,89958,0,2,4
25682,5,3,89961,89961,89964,0,3,3
25683,4,1,89965,89965,89966,0,1,1
25684,5,1,89970,89970,89971,0,1,4
25685,4,3,89974,89974,89977,0,3,3
25686,4,2,89978,89978,89980,0,2,1
25687,1,1,89979,89980,89981,1,2,0
25688,1,2,89980,89981,89983,1,3,0
25689,4,1,89984,89984,89985,0,1,1
25690,4,3,89988,89988,89991,0,3,3
25691,4,1,89992,89992,89993,0,1,1
25692,1,2,89993,89993,89995,0,2,0
25693,5,3,89998,89998,90001,0,3,3
25694,4,2,90002,90002,90004,0,2,1
25695,2,1,90004,90004,90005,0,1,0
25696,1,1,90005,90005,90006,0,1,0
25697,5,2,90010,90010,90012,0,2,4
25698,5,2,90015,90015,90017,0,2,3
25699,2,2,90017,90017,90019,0,2,0
25700,3,1,90020,90020,90021,0,1,1
25701,5,3,90025,90025,90028,0,3,4
25702,4,1,90029,90029,90030,0,1,1
25703,6,2,90035,90035,90037,0,2,5
25704,5,1,90040,90040,90041,0,1,3
25705,4,1,90044,90044,90045,0,1,3
25706,4,3,90048,90048,90051,0,3,3
25707,2,2,90050,90051,90053,1,3,0
25708,5,1,90055,90055,90056,0,1,2
25709,3,3,90058,90058,90061,0,3,2
25710,6,2,90064,90064,90066,0,2,3
25711,5,2,90069,90069,90071,0,2,3
25712,6,1,90075,90075,90076,0,1,4
25713,1,3,90076,90076,90079,0,3,0
25714,5,2,90081,90081,90083,0,2,2
25715,4,2,90085,90085,90087,0,2,2
25716,2,3,90087,90087,90090,0,3,0
25717,1,2,90088,90090,90092,2,4,0
25718,2,3,90090,90092,90095,2,5,0
25719,6,3,90096,90096,90099,0,3,1
25720,2,3,90098,90099,90102,1,4,0
25721,6,1,90104,90104,90105,0,1,2
25722,2,1,90106,90106,90107,0,1,1
25723,3,2,90109,90109,90111,0,2,2
25724,6,2,90115,90115,90117,0,2,4
25725,4,1,90119,90119,90120,0,1,2
25726,1,1,90120,90120,90121,0,1,0
25727,2,2,90122,90122,90124,0,2,1
25728,2,1,90124,90124,90125,0,1,0
25729,6,2,90130,90130,90132,0,2,5
25730,2,1,90132,90132,90133,0,1,0
25731,3,3,90135,90135,90138,0,3,2
25732,2,1,90137,90138,90139,1,2,0
25733,1,2,90138,90139,90141,1,3,0
25734,1,1,90139,90141,90142,2,3,0
25735,5,1,90144,90144,90145,0,1,2
25736,4,2,90148,90148,90150,0,2,3
25737,6,2,90154,90154,90156,0,2,4
25738,5,3,90159,90159,90162,0,3,3
25739,6,3,90165,90165,90168,0,3,3
25740,4,2,90169,90169,90171,0,2,1
25741,2,1,90171,90171,90172,0,1,0
25742,3,3,90174,90174,90177,0,3,2
25743,1,1,90175,90177,90178,2,3,0
25744,3,3,90178,90178,90181,0,3,0
25745,6,3,90184,90184,90187,0,3,3
25746,5,3,90189,90189,90192,0,3,2
25747,6,1,90195,90195,90196,0,1,3
25748,2,3,90197,90197,90200,0,3,1
25749,4,1,90201,90201,90202,0,1,1
25750,3,2,90204,90204,90206,0,2,2
25751,5,2,90209,90209,90211,0,2,3
25752,1,1,90210,90211,90212,1,2,0
25753,5,3,90215,90215,90218,0,3,3
25754,1,2,90216,90218,90220,2,4,0
25755,6,3,90222,90222,90225,0,3,2
25756,5,1,90227,90227,90228,0,1,2
25757,6,2,90233,90233,90235,0,2,5
25758,5,2,90238,90238,90240,0,2,3
25759,4,1,90242,90242,90243,0,1,2
25760,6,2,90248,90248,90250,0,2,5
25761,4,3,90252,90252,90255,0,3,2
25762,1,2,90253,90255,90257,2,4,0
25763,1,3,90254,90257,90260,3,6,0
25764,4,2,90258,90260,90262,2,4,0
25765,2,2,90260,90262,90264,2,4,0
25766,6,2,90266,90266,90268,0,2,2
25767,3,3,90269,90269,90272,0,3,1
25768,4,3,90273,90273,90276,0,3,1
25769,4,2,90277,90277,90279,0,2,1
25770,6,2,90283,90283,90285,0,2,4
25771,1,1,90284,90285,90286,1,2,0
25772,4,3,90288,90288,90291,0,3,2
25773,6,3,90294,90294,90297,0,3,3
25774,1,1,90295,90297,90298,2,3,0
25775,2,3,90297,90298,90301,1,4,0
25776,6,3,90303,90303,90306,0,3,2
25777,6,2,90309,90309,90311,0,2,3
25778,3,2,90312,90312,90314,0,2,1
25779,6,2,90318,90318,90320,0,2,4
25780,6,1,90324,90324,90325,0,1,4
25781,3,1,90327,90327,90328,0,1,2
25782,6,3,90333,90333,90336,0,3,5
25783,5,1,90338,90338,90339,0,1,2
25784,2,2,90340,90340,90342,0,2,1
25785,2,3,90342,90342,90345,0,3,0
25786,4,3,90346,90346,90349,0,3,1
25787,2,2,90348,90349,90351,1,3,0
25788,4,2,90352,90352,90354,0,2,1
25789,3,2,90355,90355,90357,0,2,1
25790,4,2,90359,90359,90361,0,2,2
25791,2,3,90361,90361,90364,0,3,0
25792,6,1,90367,90367,90368,0,1,3
25793,5,3,90372,90372,90375,0,3,4
25794,1,1,90373,90375,90376,2,3,0
25795,1,3,90374,90376,90379,2,5,0
25796,5,2,90379,90379,90381,0,2,0
25797,5,1,90384,90384,90385,0,1,3
25798,1,3,90385,90385,90388,0,3,0
25799,1,2,90386,90388,90390,2,4,0
25800,4,2,90390,90390,90392,0,2,0
25801,2,3,90392,90392,90395,0,3,0
25802,5,2,90397,90397,90399,0,2,2
25803,2,2,90399,90399,90401,0,2,0
25804,3,3,90402,90402,90405,0,3,1
25805,5,2,90407,90407,90409,0,2,2
25806,2,2,90409,90409,90411,0,2,0
25807,3,3,90412,90412,90415,0,3,1
25808,6,1,90418,90418,90419,0,1,3
25809,4,2,90422,90422,90424,0,2,3
25810,6,2,90428,90428,90430,0,2,4
25811,3,3,90431,90431,90434,0,3,1
25812,6,1,90437,90437,90438,0,1,3
25813,2,1,90439,90439,90440,0,1,1
25814,5,2,90444,90444,90446,0,2,4
25815,4,1,90448,90448,90449,0,1,2
25816,5,3,90453,90453,90456,0,3,4
25817,1,1,90454,90456,90457,2,3,0
25818,5,2,90459,90459,90461,0,2,2
25819,1,1,90460,90461,90462,1,2,0
25820,3,3,90463,90463,90466,0,3,1
25821,3,2,90466,90466,90468,0,2,0
25822,5,1,90471,90471,90472,0,1,3
25823,2,3,90473,90473,90476,0,3,1
25824,6,2,90479,90479,90481,0,2,3
25825,6,2,90485,90485,90487,0,2,4
25826,2,3,90487,90487,90490,0,3,0
25827,1,1,90488,90490,90491,2,3,0
25828,2,3,90490,90491,90494,1,4,0
25829,5,1,90495,90495,90496,0,1,1
25830,1,1,90496,90496,90497,0,1,0
25831,3,3,90499,90499,90502,0,3,2
25832,5,1,90504,90504,90505,0,1,2
25833,4,1,90508,90508,90509,0,1,3
25834,3,3,90511,90511,90514,0,3,2
25835,6,3,90517,90517,90520,0,3,3
25836,2,3,90519,90520,90523,1,4,0
25837,2,2,90521,90523,90525,2,4,0
25838,3,1,90524,90525,90526,1,2,0
25839,6,2,90530,90530,90532,0,2,4
25840,1,1,90531,90532,90533,1,2,0
25841,2,3,90533,90533,90536,0,3,0
25842,3,1,90536,90536,90537,0,1,0
25843,1,2,90537,90537,90539,0,2,0
25844,5,1,90542,90542,90543,0,1,3
25845,5,2,90547,90547,90549,0,2,4
25846,5,1,90552,90552,90553,0,1,3
25847,1,3,90553,90553,90556,0,3,0
25848,2,2,90555,90556,90558,1,3,0
25849,1,2,90556,90558,90560,2,4,0
25850,4,1,90560,90560,90561,0,1,0
25851,1,1,90561,90561,90562,0,1,0
25852,3,1,90564,90564,90565,0,1,2
25853,5,3,90569,90569,90572,0,3,4
25854,5,2,90574,90574,90576,0,2,2
25855,5,3,90579,90579,90582,0,3,3
25856,6,3,90585,90585,90588,0,3,3
25857,4,3,90589,90589,90592,0,3,1
25858,3,1,90592,90592,90593,0,1,0
25859,1,1,90593,90593,90594,0,1,0
25860,6,1,90599,90599,90600,0,1,5
25861,5,1,90604,90604,90605,0,1,4
25862,2,1,90606,90606,90607,0,1,1
25863,6,1,90612,90612,90613,0,1,5
25864,5,3,90617,90617,90620,0,3,4
25865,4,2,90621,90621,90623,0,2,1
25866,2,1,90623,90623,90624,0,1,0
25867,2,3,90625,90625,90628,0,3,1
25868,1,1,90626,90628,90629,2,3,0
25869,5,1,90631,90631,90632,0,1,2
25870,5,2,90636,90636,90638,0,2,4
25871,4,3,90640,90640,90643,0,3,2
25872,1,1,90641,90643,90644,2,3,0
25873,5,2,90646,90646,90648,0,2,2
25874,6,2,90652,90652,90654,0,2,4
25875,3,1,90655,90655,90656,0,1,1
25876,1,2,90656,90656,90658,0,2,0
25877,4,3,90660,90660,90663,0,3,2
25878,2,2,90662,90663,90665,1,3,0
25879,5,1,90667,90667,90668,0,1,2
25880,3,2,90670,90670,90672,0,2,2
25881,1,2,90671,90672,90674,1,3,0
25882,2,3,90673,90674,90677,1,4,0
25883,1,2,90674,90677,90679,3,5,0
25884,3,1,90677,90679,90680,2,3,0
25885,6,1,90683,90683,90684,0,1,3
25886,4,1,90687,90687,90688,0,1,3
25887,4,1,90691,90691,90692,0,1,3
25888,2,2,90693,90693,90695,0,2,1
25889,3,2,90696,90696,90698,0,2,1
25890,6,2,90702,90702,90704,0,2,4
25891,2,1,90704,90704,90705,0,1,0
25892,4,3,90708,90708,90711,0,3,3
25893,4,3,90712,90712,90715,0,3,1
25894,1,1,90713,90715,90716,2,3,0
25895,5,2,90718,90718,90720,0,2,2
25896,1,2,90719,90720,90722,1,3,0
25897,2,1,90721,90722,90723,1,2,0
25898,4,1,90725,90725,90726,0,1,2
25899,2,2,90727,90727,90729,0,2,1
25900,6,1,90733,90733,90734,0,1,4
25901,4,1,90737,90737,90738,0,1,3
25902,4,3,90741,90741,90744,0,3,3
25903,2,1,90743,90744,90745,1,2,0
25904,3,3,90746,90746,90749,0,3,1
25905,2,3,90748,90749,90752,1,4,0
25906,5,1,90753,90753,90754,0,1,1
25907,4,2,90757,90757,90759,0,2,3
25908,3,3,90760,90760,90763,0,3,1
25909,2,3,90762,90763,90766,1,4,0
25910,4,2,90766,90766,90768,0,2,0
25911,5,3,90771,90771,90774,0,3,3
25912,4,1,90775,90775,90776,0,1,1
25913,5,2,90780,90780,90782,0,2,4
25914,2,3,90782,90782,90785,0,3,0
25915,4,3,90786,90786,90789,0,3,1
25916,4,3,90790,90790,90793,0,3,1
25917,1,2,90791,90793,90795,2,4,0
25918,5,3,90796,90796,90799,0,3,1
25919,2,3,90798,90799,90802,1,4,0
25920,6,1,90804,90804,90805,0,1,2
25921,1,1,90805,90805,90806,0,1,0
25922,5,1,90810,90810,90811,0,1,4
25923,2,2,90812,90812,90814,0,2,1
25924,2,3,90814,90814,90817,0,3,0
25925,3,2,90817,90817,90819,0,2,0
25926,1,3,90818,90819,90822,1,4,0
25927,3,3,90821,90822,90825,1,4,0
25928,5,3,90826,90826,90829,0,3,1
25929,2,3,90828,90829,90832,1,4,0
25930,6,1,90834,90834,90835,0,1,2
25931,2,2,90836,90836,90838,0,2,1
25932,1,3,90837,90838,90841,1,4,0
25933,6,2,90843,90843,90845,0,2,2
25934,4,1,90847,90847,90848,0,1,2
25935,6,2,90853,90853,90855,0,2,5
25936,3,2,90856,90856,90858,0,2,1
25937,5,2,90861,90861,90863,0,2,3
25938,4,3,90865,90865,90868,0,3,2
25939,2,1,90867,90868,90869,1,2,0
25940,1,2,90868,90869,90871,1,3,0
25941,3,3,90871,90871,90874,0,3,0
25942,6,1,90877,90877,90878,0,1,3
25943,4,1,90881,90881,90882,0,1,3
25944,1,2,90882,90882,90884,0,2,0
25945,6,2,90888,90888,90890,0,2,4
25946,3,2,90891,90891,90893,0,2,1
25947,1,3,90892,90893,90896,1,4,0
25948,1,3,90893,90896,90899,3,6,0
25949,4,1,90897,90899,90900,2,3,0
25950,2,3,90899,90900,90903,1,4,0
25951,6,1,90905,90905,90906,0,1,2
25952,6,3,90911,90911,90914,0,3,5
25953,1,2,90912,90914,90916,2,4,0
25954,4,2,90916,90916,90918,0,2,0
25955,2,2,90918,90918,90920,0,2,0
25956,6,1,90924,90924,90925,0,1,4
25957,5,1,90929,90929,90930,0,1,4
25958,6,3,90935,90935,90938,0,3,5
25959,1,3,90936,90938,90941,2,5,0
25960,3,2,90939,90941,90943,2,4,0
25961,4,3,90943,90943,90946,0,3,0
25962,1,2,90944,90946,90948,2,4,0
25963,2,2,90946,90948,90950,2,4,0
25964,4,2,90950,90950,90952,0,2,0
25965,6,2,90956,90956,90958,0,2,4
25966,1,3,90957,90958,90961,1,4,0
25967,1,2,90958,90961,90963,3,5,0
25968,4,3,90962,90963,90966,1,4,0
25969,6,1,90968,90968,90969,0,1,2
25970,3,3,90971,90971,90974,0,3,2
25971,6,3,90977,90977,90980,0,3,3
25972,4,3,90981,90981,90984,0,3,1
25973,1,3,90982,90984,90987,2,5,0
25974,2,1,90984,90987,90988,3,4,0
25975,5,1,90989,90989,90990,0,1,1
25976,2,3,90991,90991,90994,0,3,1
25977,4,1,90995,90995,90996,0,1,1
25978,4,3,90999,90999,91002,0,3,3
25979,4,1,91003,91003,91004,0,1,1
25980,3,3,91006,91006,91009,0,3,2
25981,6,3,91012,91012,91015,0,3,3
25982,5,1,91017,91017,91018,0,1,2
25983,5,2,91022,91022,91024,0,2,4
25984,6,1,91028,91028,91029,0,1,4
25985,1,1,91029,91029,91030,0,1,0
25986,1,1,91030,91030,91031,0,1,0
25987,3,2,91033,91033,91035,0,2,2
25988,1,3,91034,91035,91038,1,4,0
25989,6,2,91040,91040,91042,0,2,2
25990,4,2,91044,91044,91046,0,2,2
25991,4,1,91048,91048,91049,0,1,2
25992,1,1,91049,91049,91050,0,1,0
25993,3,2,91052,91052,91054,0,2,2
25994,6,2,91058,91058,91060,0,2,4
25995,3,1,91061,91061,91062,0,1,1
25996,1,1,91062,91062,91063,0,1,0
25997,2,2,91064,91064,91066,0,2,1
25998,5,1,91069,91069,91070,0,1,3
25999,2,2,91071,91071,91073,0,2,1
26000,6,2,91077,91077,91079,0,2,4
26001,6,3,91083,91083,91086,0,3,4
26002,5,3,91088,91088,91091,0,3,2
26003,2,3,91090,91091,91094,1,4,0
26004,3,1,91093,91094,91095,1,2,0
26005,1,3,91094,91095,91098,1,4,0
26006,3,2,91097,91098,91100,1,3,0
26007,5,2,91102,91102,91104,0,2,2
26008,2,3,91104,91104,91107,0,3,0
26009,4,1,91108,91108,91109,0,1,1
26010,6,2,91114,91114,91116,0,2,5
26011,1,1,91115,91116,91117,1,2,0
26012,6,1,91121,91121,91122,0,1,4
26013,6,2,91127,91127,91129,0,2,5
26014,5,1,91132,91132,91133,0,1,3
26015,4,2,91136,91136,91138,0,2,3
26016,2,3,91138,91138,91141,0,3,0
26017,2,3,91140,91141,91144,1,4,0
26018,5,1,91145,91145,91146,0,1,1
26019,4,2,91149,91149,91151,0,2,3
26020,1,1,91150,91151,91152,1,2,0
26021,3,1,91153,91153,91154,0,1,1
26022,2,3,91155,91155,91158,0,3,1
26023,1,3,91156,91158,91161,2,5,0
26024,5,1,91161,91161,91162,0,1,0
26025,2,3,91163,91163,91166,0,3,1
26026,5,2,91168,91168,91170,0,2,2
26027,5,3,91173,91173,91176,0,3,3
26028,4,1,91177,91177,91178,0,1,1
26029,2,2,91179,91179,91181,0,2,1
26030,5,3,91184,91184,91187,0,3,3
26031,5,1,91189,91189,91190,0,1,2
26032,2,3,91191,91191,91194,0,3,1
26033,1,2,91192,91194,91196,2,4,0
26034,6,2,91198,91198,91200,0,2,2
26035,1,1,91199,91200,91201,1,2,0
26036,2,3,91201,91201,91204,0,3,0
26037,3,1,91204,91204,91205,0,1,0
26038,1,3,91205,91205,91208,0,3,0
26039,4,1,91209,91209,91210,0,1,1
26040,2,2,91211,91211,91213,0,2,1
26041,1,2,91212,91213,91215,1,3,0
26042,6,2,91218,91218,91220,0,2,3
26043,6,1,91224,91224,91225,0,1,4
26044,1,3,91225,91225,91228,0,3,0
26045,6,1,91231,91231,91232,0,1,3
26046,3,1,91234,91234,91235,0,1,2
26047,1,3,91235,91235,91238,0,3,0
26048,1,1,91236,91238,91239,2,3,0
26049,6,2,91242,91242,91244,0,2,3
26050,1,2,91243,91244,91246,1,3,0
26051,1,3,91244,91246,91249,2,5,0
26052,2,3,91246,91249,91252,3,6,0
26053,4,3,91250,91252,91255,2,5,0
26054,5,2,91255,91255,91257,0,2,0
26055,3,2,91258,91258,91260,0,2,1
26056,2,3,91260,91260,91263,0,3,0
26057,4,1,91264,91264,91265,0,1,1
26058,2,1,91266,91266,91267,0,1,1
26059,5,1,91271,91271,91272,0,1,4
26060,2,3,91273,91273,91276,0,3,1
26061,1,3,91274,91276,91279,2,5,0
26062,3,2,91277,91279,91281,2,4,0
26063,5,1,91282,91282,91283,0,1,1
26064,2,3,91284,91284,91287,0,3,1
26065,5,3,91289,91289,91292,0,3,2
26066,6,2,91295,91295,91297,0,2,3
26067,6,1,91301,91301,91302,0,1,4
26068,2,2,91303,91303,91305,0,2,1
26069,3,2,91306,91306,91308,0,2,1
26070,4,3,91310,91310,91313,0,3,2
26071,1,2,91311,91313,91315,2,4,0
26072,1,3,91312,91315,91318,3,6,0
26073,5,3,91317,91318,91321,1,4,0
26074,2,1,91319,91321,91322,2,3,0
26075,5,2,91324,91324,91326,0,2,2
26076,5,2,91329,91329,91331,0,2,3
26077,4,1,91333,91333,91334,0,1,2
26078,1,2,91334,91334,91336,0,2,0
26079,4,2,91338,91338,91340,0,2,2
26080,4,2,91342,91342,91344,0,2,2
26081,5,1,91347,91347,91348,0,1,3
26082,1,1,91348,91348,91349,0,1,0
26083,2,3,91350,91350,91353,0,3,1
26084,5,2,91355,91355,91357,0,2,2
26085,6,3,91361,91361,91364,0,3,4
26086,2,3,91363,91364,91367,1,4,0
26087,2,2,91365,91367,91369,2,4,0
26088,1,2,91366,91369,91371,3,5,0
26089,2,1,91368,91371,91372,3,4,0
26090,3,2,91371,91372,91374,1,3,0
26091,6,1,91377,91377,91378,0,1,3
26092,6,3,91383,91383,91386,0,3,5
26093,1,1,91384,91386,91387,2,3,0
26094,4,2,91388,91388,91390,0,2,1
26095,6,3,91394,91394,91397,0,3,4
26096,4,3,91398,91398,91401,0,3,1
26097,4,2,91402,91402,91404,0,2,1
26098,4,1,91406,91406,91407,0,1,2
26099,3,3,91409,91409,91412,0,3,2
26100,6,3,91415,91415,91418,0,3,3
26101,2,3,91417,91418,91421,1,4,0
26102,1,1,91418,91421,91422,3,4,0
26103,6,2,91424,91424,91426,0,2,2
26104,6,2,91430,91430,91432,0,2,4
26105,5,1,91435,91435,91436,0,1,3
26106,3,2,91438,91438,91440,0,2,2
26107,5,1,91443,91443,91444,0,1,3
26108,5,2,91448,91448,91450,0,2,4
26109,1,3,91449,91450,91453,1,4,0
26110,4,1,91453,91453,91454,0,1,0
26111,1,3,91454,91454,91457,0,3,0
26112,4,3,91458,91458,91461,0,3,1
26113,5,1,91463,91463,91464,0,1,2
26114,1,2,91464,91464,91466,0,2,0
26115,1,1,91465,91466,91467,1,2,0
26116,3,2,91468,91468,91470,0,2,1
26117,1,1,91469,91470,91471,1,2,0
26118,5,2,91474,91474,91476,0,2,3
26119,4,1,91478,91478,91479,0,1,2
26120,1,2,91479,91479,91481,0,2,0
26121,2,1,91481,91481,91482,0,1,0
26122,5,3,91486,91486,91489,0,3,4
26123,5,3,91491,91491,91494,0,3,2
26124,4,2,91495,91495,91497,0,2,1
26125,2,3,91497,91497,91500,0,3,0
26126,1,1,91498,91500,91501,2,3,0
26127,6,1,91504,91504,91505,0,1,3
26128,2,1,91506,91506,91507,0,1,1
26129,6,1,91512,91512,91513,0,1,5
26130,6,1,91518,91518,91519,0,1,5
26131,2,2,91520,91520,91522,0,2,1
26132,4,1,91524,91524,91525,0,1,2
26133,1,1,91525,91525,91526,0,1,0
26134,1,1,91526,91526,91527,0,1,0
26135,4,3,91530,91530,91533,0,3,3
26136,3,3,91533,91533,91536,0,3,0
26137,1,2,91534,91536,91538,2,4,0
26138,5,2,91539,91539,91541,0,2,1
26139,5,2,91544,91544,91546,0,2,3
26140,1,2,91545,91546,91548,1,3,0
26141,5,3,91550,91550,91553,0,3,2
26142,1,2,91551,91553,91555,2,4,0
26143,1,1,91552,91555,91556,3,4,0
26144,5,1,91557,91557,91558,0,1,1
26145,2,3,91559,91559,91562,0,3,1
26146,5,1,91564,91564,91565,0,1,2
26147,1,1,91565,91565,91566,0,1,0
26148,3,3,91568,91568,91571,0,3,2
26149,2,1,91570,91571,91572,1,2,0
26150,6,1,91576,91576,91577,0,1,4
26151,4,3,91580,91580,91583,0,3,3
26152,6,2,91586,91586,91588,0,2,3
26153,4,2,91590,91590,91592,0,2,2
26154,6,1,91596,91596,91597,0,1,4
26155,6,1,91602,91602,91603,0,1,5
26156,1,1,91603,91603,91604,0,1,0
26157,2,2,91605,91605,91607,0,2,1
26158,1,3,91606,91607,91610,1,4,0
26159,4,2,91610,91610,91612,0,2,0
26160,4,1,91614,91614,91615,0,1,2
26161,4,3,91618,91618,91621,0,3,3
26162,1,1,91619,91621,91622,2,3,0
26163,3,2,91622,91622,91624,0,2,0
26164,3,2,91625,91625,91627,0,2,1
26165,6,2,91631,91631,91633,0,2,4
26166,2,2,91633,91633,91635,0,2,0
26167,3,1,91636,91636,91637,0,1,1
26168,5,1,91641,91641,91642,0,1,4
26169,6,2,91647,91647,91649,0,2,5
26170,3,3,91650,91650,91653,0,3,1
26171,1,2,91651,91653,91655,2,4,0
26172,6,2,91657,91657,91659,0,2,2
26173,3,2,91660,91660,91662,0,2,1
26174,4,3,91664,91664,91667,0,3,2
26175,1,2,91665,91667,91669,2,4,0
26176,6,1,91671,91671,91672,0,1,2
26177,2,2,91673,91673,91675,0,2,1
26178,5,3,91678,91678,91681,0,3,3
26179,6,3,91684,91684,91687,0,3,3
26180,4,2,91688,91688,91690,0,2,1
26181,6,1,91694,91694,91695,0,1,4
26182,2,2,91696,91696,91698,0,2,1
26183,3,2,91699,91699,91701,0,2,1
26184,2,1,91701,91701,91702,0,1,0
26185,2,2,91703,91703,91705,0,2,1
26186,5,2,91708,91708,91710,0,2,3
26187,3,1,91711,91711,91712,0,1,1
26188,1,2,91712,91712,91714,0,2,0
26189,3,1,91715,91715,91716,0,1,1
26190,3,3,91718,91718,91721,0,3,2
26191,3,3,91721,91721,91724,0,3,0
26192,4,1,91725,91725,91726,0,1,1
26193,4,1,91729,91729,91730,0,1,3
26194,6,1,91735,91735,91736,0,1,5
26195,1,3,91736,91736,91739,0,3,0
26196,2,2,91738,91739,91741,1,3,0
26197,1,3,91739,91741,91744,2,5,0
26198,3,3,91742,91744,91747,2,5,0
26199,6,2,91748,91748,91750,0,2,1
26200,1,1,91749,91750,91751,1,2,0
26201,1,1,91750,91751,91752,1,2,0
26202,2,3,91752,91752,91755,0,3,0
26203,1,3,91753,91755,91758,2,5,0
26204,2,2,91755,91758,91760,3,5,0
26205,1,2,91756,91760,91762,4,6,0
26206,2,1,91758,91762,91763,4,5,0
26207,5,2,91763,91763,91765,0,2,0
26208,4,3,91767,91767,91770,0,3,2
26209,6,3,91773,91773,91776,0,3,3
26210,3,1,91776,91776,91777,0,1,0
26211,5,2,91781,91781,91783,0,2,4
26212,3,3,91784,91784,91787,0,3,1
26213,1,3,91785,91787,91790,2,5,0
26214,2,3,91787,91790,91793,3,6,0
26215,1,2,91788,91793,91795,5,7,0
26216,1,1,91789,91795,91796,6,7,0
26217,6,3,91795,91796,91799,1,4,0
26218,1,2,91796,91799,91801,3,5,0
26219,3,3,91799,91801,91804,2,5,0
26220,5,2,91804,91804,91806,0,2,0
26221,5,3,91809,91809,91812,0,3,3
26222,4,3,91813,91813,91816,0,3,1
26223,5,3,91818,91818,91821,0,3,2
26224,3,3,91821,91821,91824,0,3,0
26225,4,3,91825,91825,91828,0,3,1
26226,2,3,91827,91828,91831,1,4,0
26227,2,1,91829,91831,91832,2,3,0
26228,1,1,91830,91832,91833,2,3,0
26229,2,2,91832,91833,91835,1,3,0
26230,2,1,91834,91835,91836,1,2,0
26231,2,2,91836,91836,91838,0,2,0
26232,2,2,91838,91838,91840,0,2,0
26233,3,2,91841,91841,91843,0,2,1
26234,4,3,91845,91845,91848,0,3,2
26235,2,3,91847,91848,91851,1,4,0
26236,4,2,91851,91851,91853,0,2,0
26237,5,1,91856,91856,91857,0,1,3
26238,2,3,91858,91858,91861,0,3,1
26239,4,3,91862,91862,91865,0,3,1
26240,5,2,91867,91867,91869,0,2,2
26241,1,1,91868,91869,91870,1,2,0
26242,6,2,91874,91874,91876,0,2,4
26243,4,2,91878,91878,91880,0,2,2
26244,1,3,91879,91880,91883,1,4,0
26245,1,3,91880,91883,91886,3,6,0
26246,1,1,91881,91886,91887,5,6,0
26247,5,3,91886,91887,91890,1,4,0
26248,6,1,91892,91892,91893,0,1,2
26249,3,1,91895,91895,91896,0,1,2
26250,3,2,91898,91898,91900,0,2,2
26251,3,1,91901,91901,91902,0,1,1
26252,6,2,91907,91907,91909,0,2,5
26253,6,1,91913,91913,91914,0,1,4
26254,2,1,91915,91915,91916,0,1,1
26255,5,2,91920,91920,91922,0,2,4
26256,3,3,91923,91923,91926,0,3,1
26257,4,3,91927,91927,91930,0,3,1
26258,1,2,91928,91930,91932,2,4,0
26259,4,3,91932,91932,91935,0,3,0
26260,6,2,91938,91938,91940,0,2,3
26261,2,1,91940,91940,91941,0,1,0
26262,1,1,91941,91941,91942,0,1,0
26263,2,2,91943,91943,91945,0,2,1
26264,3,1,91946,91946,91947,0,1,1
26265,2,2,91948,91948,91950,0,2,1
26266,2,2,91950,91950,91952,0,2,0
26267,5,1,91955,91955,91956,0,1,3
26268,1,3,91956,91956,91959,0,3,0
26269,6,3,91962,91962,91965,0,3,3
26270,1,3,91963,91965,91968,2,5,0
26271,2,1,91965,91968,91969,3,4,0
26272,3,3,91968,91969,91972,1,4,0
26273,1,3,91969,91972,91975,3,6,0
26274,3,3,91972,91975,91978,3,6,0
26275,3,1,91975,91978,91979,3,4,0
26276,6,2,91981,91981,91983,0,2,2
26277,3,3,91984,91984,91987,0,3,1
26278,3,3,91987,91987,91990,0,3,0
26279,2,3,91989,91990,91993,1,4,0
26280,2,3,91991,91993,91996,2,5,0
26281,1,3,91992,91996,91999,4,7,0
26282,3,1,91995,91999,92000,4,5,0
26283,2,1,91997,92000,92001,3,4,0
26284,4,3,92001,92001,92004,0,3,0
26285,2,2,92003,92004,92006,1,3,0
26286,1,1,92004,92006,92007,2,3,0
26287,6,2,92010,92010,92012,0,2,3
26288,6,1,92016,92016,92017,0,1,4
26289,4,2,92020,92020,92022,0,2,3
26290,6,1,92026,92026,92027,0,1,4
26291,5,3,92031,92031,92034,0,3,4
26292,4,1,92035,92035,92036,0,1,1
26293,6,1,92041,92041,92042,0,1,5
26294,4,2,92045,92045,92047,0,2,3
26295,4,2,92049,92049,92051,0,2,2
26296,5,2,92054,92054,92056,0,2,3
26297,2,1,92056,92056,92057,0,1,0
26298,1,3,92057,92057,92060,0,3,0
26299,3,2,92060,92060,92062,0,2,0
26300,6,1,92066,92066,92067,0,1,4
26301,2,3,92068,92068,92071,0,3,1
26302,3,3,92071,92071,92074,0,3,0
26303,6,3,92077,92077,92080,0,3,3
26304,4,3,92081,92081,92084,0,3,1
26305,6,1,92087,92087,92088,0,1,3
26306,1,2,92088,92088,92090,0,2,0
26307,4,1,92092,92092,92093,0,1,2
26308,4,3,92096,92096,92099,0,3,3
26309,1,1,92097,92099,92100,2,3,0
26310,3,2,92100,92100,92102,0,2,0
26311,6,3,92106,92106,92109,0,3,4
26312,3,3,92109,92109,92112,0,3,0
26313,4,2,92113,92113,92115,0,2,1
26314,1,1,92114,92115,92116,1,2,0
26315,1,2,92115,92116,92118,1,3,0
26316,1,1,92116,92118,92119,2,3,0
26317,2,3,92118,92119,92122,1,4,0
26318,4,1,92122,92122,92123,0,1,0
26319,2,1,92124,92124,92125,0,1,1
26320,5,3,92129,92129,92132,0,3,4
26321,5,2,92134,92134,92136,0,2,2
26322,5,1,92139,92139,92140,0,1,3
26323,5,3,92144,92144,92147,0,3,4
26324,1,1,92145,92147,92148,2,3,0
26325,3,1,92148,92148,92149,0,1,0
26326,2,2,92150,92150,92152,0,2,1
26327,6,3,92156,92156,92159,0,3,4
26328,5,3,92161,92161,92164,0,3,2
26329,5,2,92166,92166,92168,0,2,2
26330,6,3,92172,92172,92175,0,3,4
26331,5,1,92177,92177,92178,0,1,2
26332,1,2,92178,92178,92180,0,2,0
26333,3,1,92181,92181,92182,0,1,1
26334,5,1,92186,92186,92187,0,1,4
26335,5,1,92191,92191,92192,0,1,4
26336,1,3,92192,92192,92195,0,3,0
26337,6,1,92198,92198,92199,0,1,3
26338,5,1,92203,92203,92204,0,1,4
26339,4,2,92207,92207,92209,0,2,3
26340,4,3,92211,92211,92214,0,3,2
26341,4,1,92215,92215,92216,0,1,1
26342,5,2,92220,92220,92222,0,2,4
26343,2,2,92222,92222,92224,0,2,0
26344,2,1,92224,92224,92225,0,1,0
26345,3,1,92227,92227,92228,0,1,2
26346,5,2,92232,92232,92234,0,2,4
26347,6,3,92238,92238,92241,0,3,4
26348,5,3,92243,92243,92246,0,3,2
26349,4,1,92247,92247,92248,0,1,1
26350,1,1,92248,92248,92249,0,1,0
26351,6,3,92254,92254,92257,0,3,5
26352,6,1,92260,92260,92261,0,1,3
26353,4,1,92264,92264,92265,0,1,3
26354,5,1,92269,92269,92270,0,1,4
26355,4,3,92273,92273,92276,0,3,3
26356,4,2,92277,92277,92279,0,2,1
26357,5,1,92282,92282,92283,0,1,3
26358,1,2,92283,92283,92285,0,2,0
26359,4,2,92287,92287,92289,0,2,2
26360,4,1,92291,92291,92292,0,1,2
26361,3,3,92294,92294,92297,0,3,2
26362,3,3,92297,92297,92300,0,3,0
26363,5,3,92302,92302,92305,0,3,2
26364,5,3,92307,92307,92310,0,3,2
26365,3,2,92310,92310,92312,0,2,0
26366,1,3,92311,92312,92315,1,4,0
26367,6,1,92317,92317,92318,0,1,2
26368,6,2,92323,92323,92325,0,2,5
26369,6,1,92329,92329,92330,0,1,4
26370,2,3,92331,92331,92334,0,3,1
26371,3,3,92334,92334,92337,0,3,0
26372,4,2,92338,92338,92340,0,2,1
26373,2,1,92340,92340,92341,0,1,0
26374,4,2,92344,92344,92346,0,2,3
26375,6,3,92350,92350,92353,0,3,4
26376,6,2,92356,92356,92358,0,2,3
26377,6,3,92362,92362,92365,0,3,4
26378,2,3,92364,92365,92368,1,4,0
26379,2,3,92366,92368,92371,2,5,0
26380,4,2,92370,92371,92373,1,3,0
26381,6,3,92376,92376,92379,0,3,3
26382,3,1,92379,92379,92380,0,1,0
26383,4,1,92383,92383,92384,0,1,3
26384,5,3,92388,92388,92391,0,3,4
26385,2,1,92390,92391,92392,1,2,0
26386,1,2,92391,92392,92394,1,3,0
26387,5,1,92396,92396,92397,0,1,2
26388,2,3,92398,92398,92401,0,3,1
26389,4,1,92402,92402,92403,0,1,1
26390,6,1,92408,92408,92409,0,1,5
26391,1,2,92409,92409,92411,0,2,0
26392,4,2,92413,92413,92415,0,2,2
26393,3,3,92416,92416,92419,0,3,1
26394,5,3,92421,92421,92424,0,3,2
26395,3,1,92424,92424,92425,0,1,0
26396,1,3,92425,92425,92428,0,3,0
26397,5,3,92430,92430,92433,0,3,2
26398,5,3,92435,92435,92438,0,3,2
26399,3,3,92438,92438,92441,0,3,0
26400,1,2,92439,92441,92443,2,4,0
26401,5,3,92444,92444,92447,0,3,1
26402,1,2,92445,92447,92449,2,4,0
26403,4,1,92449,92449,92450,0,1,0
26404,3,2,92452,92452,92454,0,2,2
26405,5,1,92457,92457,92458,0,1,3
26406,6,3,92463,92463,92466,0,3,5
26407,1,1,92464,92466,92467,2,3,0
26408,2,3,92466,92467,92470,1,4,0
26409,4,3,92470,92470,92473,0,3,0
26410,1,2,92471,92473,92475,2,4,0
26411,2,3,92473,92475,92478,2,5,0
26412,3,3,92476,92478,92481,2,5,0
26413,4,3,92480,92481,92484,1,4,0
26414,1,3,92481,92484,92487,3,6,0
26415,5,2,92486,92487,92489,1,3,0
26416,1,1,92487,92489,92490,2,3,0
26417,6,2,92493,92493,92495,0,2,3
26418,5,2,92498,92498,92500,0,2,3
26419,6,2,92504,92504,92506,0,2,4
26420,1,3,92505,92506,92509,1,4,0
26421,1,3,92506,92509,92512,3,6,0
26422,3,2,92509,92512,92514,3,5,0
26423,5,1,92514,92514,92515,0,1,0
26424,1,2,92515,92515,92517,0,2,0
26425,5,1,92520,92520,92521,0,1,3
26426,4,2,92524,92524,92526,0,2,3
26427,3,2,92527,92527,92529,0,2,1
26428,5,2,92532,92532,92534,0,2,3
26429,5,1,92537,92537,92538,0,1,3
26430,3,1,92540,92540,92541,0,1,2
26431,3,2,92543,92543,92545,0,2,2
26432,6,1,92549,92549,92550,0,1,4
26433,2,1,92551,92551,92552,0,1,1
26434,2,3,92553,92553,92556,0,3,1
26435,4,3,92557,92557,92560,0,3,1
26436,3,1,92560,92560,92561,0,1,0
26437,4,3,92564,92564,92567,0,3,3
26438,3,3,92567,92567,92570,0,3,0
26439,6,1,92573,92573,92574,0,1,3
26440,1,3,92574,92574,92577,0,3,0
26441,3,2,92577,92577,92579,0,2,0
26442,2,2,92579,92579,92581,0,2,0
26443,1,2,92580,92581,92583,1,3,0
26444,3,1,92583,92583,92584,0,1,0
26445,6,1,92589,92589,92590,0,1,5
26446,2,3,92591,92591,92594,0,3,1
26447,1,3,92592,92594,92597,2,5,0
26448,5,1,92597,92597,92598,0,1,0
26449,5,1,92602,92602,92603,0,1,4
26450,1,2,92603,92603,92605,0,2,0
26451,5,2,92608,92608,92610,0,2,3
26452,1,1,92609,92610,92611,1,2,0
26453,4,1,92613,92613,92614,0,1,2
26454,3,2,92616,92616,92618,0,2,2
26455,4,2,92620,92620,92622,0,2,2
26456,1,2,92621,92622,92624,1,3,0
26457,1,1,92622,92624,92625,2,3,0
26458,5,3,92627,92627,92630,0,3,2
26459,3,2,92630,92630,92632,0,2,0
26460,4,2,92634,92634,92636,0,2,2
26461,2,3,92636,92636,92639,0,3,0
26462,1,3,92637,92639,92642,2,5,0
26463,3,3,92640,92642,92645,2,5,0
26464,6,2,92646,92646,92648,0,2,1
26465,4,1,92650,92650,92651,0,1,2
26466,4,1,92654,92654,92655,0,1,3
26467,3,2,92657,92657,92659,0,2,2
26468,2,2,92659,92659,92661,0,2,0
26469,2,1,92661,92661,92662,0,1,0
26470,4,2,92665,92665,92667,0,2,3
26471,1,3,92666,92667,92670,1,4,0
26472,4,1,92670,92670,92671,0,1,0
26473,2,1,92672,92672,92673,0,1,1
26474,6,3,92678,92678,92681,0,3,5
26475,1,2,92679,92681,92683,2,4,0
26476,6,3,92685,92685,92688,0,3,2
26477,3,1,92688,92688,92689,0,1,0
26478,2,2,92690,92690,92692,0,2,1
26479,6,2,92696,92696,92698,0,2,4
26480,6,3,92702,92702,92705,0,3,4
26481,5,1,92707,92707,92708,0,1,2
26482,4,3,92711,92711,92714,0,3,3
26483,3,3,92714,92714,92717,0,3,0
26484,6,2,92720,92720,92722,0,2,3
26485,5,1,92725,92725,92726,0,1,3
26486,4,1,92729,92729,92730,0,1,3
26487,2,1,92731,92731,92732,0,1,1
26488,1,3,92732,92732,92735,0,3,0
26489,3,3,92735,92735,92738,0,3,0
26490,2,1,92737,92738,92739,1,2,0
26491,6,1,92743,92743,92744,0,1,4
26492,3,2,92746,92746,92748,0,2,2
26493,5,1,92751,92751,92752,0,1,3
26494,2,2,92753,92753,92755,0,2,1
26495,6,1,92759,92759,92760,0,1,4
26496,2,3,92761,92761,92764,0,3,1
26497,6,1,92767,92767,92768,0,1,3
26498,1,2,92768,92768,92770,0,2,0
26499,1,1,92769,92770,92771,1,2,0
26500,5,2,92774,92774,92776,0,2,3
26501,3,3,92777,92777,92780,0,3,1
26502,4,2,92781,92781,92783,0,2,1
26503,2,3,92783,92783,92786,0,3,0
26504,1,3,92784,92786,92789,2,5,0
26505,5,3,92789,92789,92792,0,3,0
26506,1,1,92790,92792,92793,2,3,0
26507,6,1,92796,92796,92797,0,1,3
26508,2,3,92798,92798,92801,0,3,1
26509,1,3,92799,92801,92804,2,5,0
26510,1,3,92800,92804,92807,4,7,0
26511,6,2,92806,92807,92809,1,3,0
26512,2,3,92808,92809,92812,1,4,0
26513,5,3,92813,92813,92816,0,3,1
26514,4,2,92817,92817,92819,0,2,1
26515,3,3,92820,92820,92823,0,3,1
26516,4,2,92824,92824,92826,0,2,1
26517,1,2,92825,92826,92828,1,3,0
26518,4,1,92829,92829,92830,0,1,1
26519,5,2,92834,92834,92836,0,2,4
26520,6,2,92840,92840,92842,0,2,4
26521,5,1,92845,92845,92846,0,1,3
26522,6,2,92851,92851,92853,0,2,5
26523,1,1,92852,92853,92854,1,2,0
26524,1,1,92853,92854,92855,1,2,0
26525,3,1,92856,92856,92857,0,1,1
26526,1,1,92857,92857,92858,0,1,0
26527,1,3,92858,92858,92861,0,3,0
26528,4,1,92862,92862,92863,0,1,1
26529,4,1,92866,92866,92867,0,1,3
26530,2,1,92868,92868,92869,0,1,1
26531,6,1,92874,92874,92875,0,1,5
26532,3,2,92877,92877,92879,0,2,2
26533,2,2,92879,92879,92881,0,2,0
26534,5,1,92884,92884,92885,0,1,3
26535,6,1,92890,92890,92891,0,1,5
26536,5,2,92895,92895,92897,0,2,4
26537,1,3,92896,92897,92900,1,4,0
26538,1,1,92897,92900,92901,3,4,0
26539,6,3,92903,92903,92906,0,3,2
26540,5,3,92908,92908,92911,0,3,2
26541,4,3,92912,92912,92915,0,3,1
26542,4,3,92916,92916,92919,0,3,1
26543,5,2,92921,92921,92923,0,2,2
26544,4,1,92925,92925,92926,0,1,2
26545,6,1,92931,92931,92932,0,1,5
26546,6,1,92937,92937,92938,0,1,5
26547,1,2,92938,92938,92940,0,2,0
26548,4,3,92942,92942,92945,0,3,2
26549,6,1,92948,92948,92949,0,1,3
26550,1,2,92949,92949,92951,0,2,0
26551,3,2,92952,92952,92954,0,2,1
26552,4,1,92956,92956,92957,0,1,2
26553,2,3,92958,92958,92961,0,3,1
26554,6,3,92964,92964,92967,0,3,3
26555,4,1,92968,92968,92969,0,1,1
26556,6,1,92974,92974,92975,0,1,5
26557,5,2,92979,92979,92981,0,2,4
26558,3,3,92982,92982,92985,0,3,1
26559,2,3,92984,92985,92988,1,4,0
26560,1,3,92985,92988,92991,3,6,0
26561,2,3,92987,92991,92994,4,7,0
26562,5,3,92992,92994,92997,2,5,0
26563,5,1,92997,92997,92998,0,1,0
26564,5,3,93002,93002,93005,0,3,4
26565,2,2,93004,93005,93007,1,3,0
26566,2,2,93006,93007,93009,1,3,0
26567,4,1,93010,93010,93011,0,1,1
26568,1,3,93011,93011,93014,0,3,0
26569,3,1,93014,93014,93015,0,1,0
26570,2,3,93016,93016,93019,0,3,1
26571,6,3,93022,93022,93025,0,3,3
26572,1,3,93023,93025,93028,2,5,0
26573,6,1,93029,93029,93030,0,1,1
26574,6,3,93035,93035,93038,0,3,5
26575,3,2,93038,93038,93040,0,2,0
26576,5,2,93043,93043,93045,0,2,3
26577,4,1,93047,93047,93048,0,1,2
26578,1,2,93048,93048,93050,0,2,0
26579,3,3,93051,93051,93054,0,3,1
26580,1,2,93052,93054,93056,2,4,0
26581,1,2,93053,93056,93058,3,5,0
26582,2,2,93055,93058,93060,3,5,0
26583,2,1,93057,93060,93061,3,4,0
26584,1,1,93058,93061,93062,3,4,0
26585,1,2,93059,93062,93064,3,5,0
26586,2,2,93061,93064,93066,3,5,0
26587,2,3,93063,93066,93069,3,6,0
26588,4,2,93067,93069,93071,2,4,0
26589,6,2,93073,93073,93075,0,2,2
26590,4,2,93077,93077,93079,0,2,2
26591,3,2,93080,93080,93082,0,2,1
26592,6,2,93086,93086,93088,0,2,4
26593,5,1,93091,93091,93092,0,1,3
26594,2,1,93093,93093,93094,0,1,1
26595,6,3,93099,93099,93102,0,3,5
26596,6,2,93105,93105,93107,0,2,3
26597,4,2,93109,93109,93111,0,2,2
26598,1,1,93110,93111,93112,1,2,0
26599,5,3,93115,93115,93118,0,3,3
26600,6,2,93121,93121,93123,0,2,3
26601,4,3,93125,93125,93128,0,3,2
26602,6,3,93131,93131,93134,0,3,3
26603,5,3,93136,93136,93139,0,3,2
26604,4,2,93140,93140,93142,0,2,1
26605,6,2,93146,93146,93148,0,2,4
26606,5,2,93151,93151,93153,0,2,3
26607,1,3,93152,93153,93156,1,4,0
26608,4,1,93156,93156,93157,0,1,0
26609,5,3,93161,93161,93164,0,3,4
26610,1,1,93162,93164,93165,2,3,0
26611,2,3,93164,93165,93168,1,4,0
26612,6,2,93170,93170,93172,0,2,2
26613,1,1,93171,93172,93173,1,2,0
26614,4,3,93175,93175,93178,0,3,2
26615,2,1,93177,93178,93179,1,2,0
26616,4,2,93181,93181,93183,0,2,2
26617,3,1,93184,93184,93185,0,1,1
26618,1,1,93185,93185,93186,0,1,0
26619,1,3,93186,93186,93189,0,3,0
26620,1,2,93187,93189,93191,2,4,0
26621,5,2,93192,93192,93194,0,2,1
26622,4,3,93196,93196,93199,0,3,2
26623,1,3,93197,93199,93202,2,5,0
26624,1,2,93198,93202,93204,4,6,0
26625,1,1,93199,93204,93205,5,6,0
26626,3,2,93202,93205,93207,3,5,0
26627,6,2,93208,93208,93210,0,2,1
26628,4,2,93212,93212,93214,0,2,2
26629,5,2,93217,93217,93219,0,2,3
26630,2,1,93219,93219,93220,0,1,0
26631,4,1,93223,93223,93224,0,1,3
26632,5,2,93228,93228,93230,0,2,4
26633,4,3,93232,93232,93235,0,3,2
26634,4,1,93236,93236,93237,0,1,1
26635,4,1,93240,93240,93241,0,1,3
26636,6,2,93246,93246,93248,0,2,5
26637,2,3,93248,93248,93251,0,3,0
26638,5,2,93253,93253,93255,0,2,2
26639,4,2,93257,93257,93259,0,2,2
26640,5,2,93262,93262,93264,0,2,3
26641,1,1,93263,93264,93265,1,2,0
26642,3,2,93266,93266,93268,0,2,1
26643,6,3,93272,93272,93275,0,3,4
26644,5,2,93277,93277,93279,0,2,2
26645,6,3,93283,93283,93286,0,3,4
26646,3,1,93286,93286,93287,0,1,0
26647,1,3,93287,93287,93290,0,3,0
26648,1,1,93288,93290,93291,2,3,0
26649,2,3,93290,93291,93294,1,4,0
26650,4,3,93294,93294,93297,0,3,0
26651,2,1,93296,93297,93298,1,2,0
26652,4,3,93300,93300,93303,0,3,2
26653,4,2,93304,93304,93306,0,2,1
26654,3,3,93307,93307,93310,0,3,1
26655,6,1,93313,93313,93314,0,1,3
26656,4,2,93317,93317,93319,0,2,3
26657,3,1,93320,93320,93321,0,1,1
26658,3,1,93323,93323,93324,0,1,2
26659,4,1,93327,93327,93328,0,1,3
26660,1,1,93328,93328,93329,0,1,0
26661,3,1,93331,93331,93332,0,1,2
26662,1,1,93332,93332,93333,0,1,0
26663,3,1,93335,93335,93336,0,1,2
26664,6,2,93341,93341,93343,0,2,5
26665,1,2,93342,93343,93345,1,3,0
26666,6,2,93348,93348,93350,0,2,3
26667,2,3,93350,93350,93353,0,3,0
26668,1,3,93351,93353,93356,2,5,0
26669,2,2,93353,93356,93358,3,5,0
26670,1,1,93354,93358,93359,4,5,0
26671,2,2,93356,93359,93361,3,5,0
26672,3,1,93359,93361,93362,2,3,0
26673,2,3,93361,93362,93365,1,4,0
26674,4,2,93365,93365,93367,0,2,0
26675,3,3,93368,93368,93371,0,3,1
26676,3,3,93371,93371,93374,0,3,0
26677,4,2,93375,93375,93377,0,2,1
26678,2,2,93377,93377,93379,0,2,0
26679,4,3,93381,93381,93384,0,3,2
26680,6,3,93387,93387,93390,0,3,3
26681,3,2,93390,93390,93392,0,2,0
26682,1,1,93391,93392,93393,1,2,0
26683,4,1,93395,93395,93396,0,1,2
26684,5,3,93400,93400,93403,0,3,4
26685,5,3,93405,93405,93408,0,3,2
26686,5,2,93410,93410,93412,0,2,2
26687,5,3,93415,93415,93418,0,3,3
26688,5,1,93420,93420,93421,0,1,2
26689,3,3,93423,93423,93426,0,3,2
26690,5,1,93428,93428,93429,0,1,2
26691,2,3,93430,93430,93433,0,3,1
26692,4,3,93434,93434,93437,0,3,1
26693,5,2,93439,93439,93441,0,2,2
26694,6,1,93445,93445,93446,0,1,4
26695,5,1,93450,93450,93451,0,1,4
26696,3,1,93453,93453,93454,0,1,2
26697,5,2,93458,93458,93460,0,2,4
26698,2,1,93460,93460,93461,0,1,0
26699,6,2,93466,93466,93468,0,2,5
26700,5,2,93471,93471,93473,0,2,3
26701,1,2,93472,93473,93475,1,3,0
26702,6,3,93478,93478,93481,0,3,3
26703,6,3,93484,93484,93487,0,3,3
26704,6,2,93490,93490,93492,0,2,3
26705,6,1,93496,93496,93497,0,1,4
26706,2,1,93498,93498,93499,0,1,1
26707,4,2,93502,93502,93504,0,2,3
26708,5,3,93507,93507,93510,0,3,3
26709,1,1,93508,93510,93511,2,3,0
26710,2,3,93510,93511,93514,1,4,0
26711,6,2,93516,93516,93518,0,2,2
26712,3,2,93519,93519,93521,0,2,1
26713,6,1,93525,93525,93526,0,1,4
26714,6,1,93531,93531,93532,0,1,5
26715,5,2,93536,93536,93538,0,2,4
26716,2,2,93538,93538,93540,0,2,0
26717,1,2,93539,93540,93542,1,3,0
26718,4,1,93543,93543,93544,0,1,1
26719,4,3,93547,93547,93550,0,3,3
26720,3,3,93550,93550,93553,0,3,0
26721,4,1,93554,93554,93555,0,1,1
26722,6,3,93560,93560,93563,0,3,5
26723,6,2,93566,93566,93568,0,2,3
26724,3,1,93569,93569,93570,0,1,1
26725,5,3,93574,93574,93577,0,3,4
26726,6,3,93580,93580,93583,0,3,3
26727,3,3,93583,93583,93586,0,3,0
26728,6,3,93589,93589,93592,0,3,3
26729,5,2,93594,93594,93596,0,2,2
26730,5,1,93599,93599,93600,0,1,3
26731,5,1,93604,93604,93605,0,1,4
26732,3,2,93607,93607,93609,0,2,2
26733,4,3,93611,93611,93614,0,3,2
26734,1,2,93612,93614,93616,2,4,0
26735,5,3,93617,93617,93620,0,3,1
26736,4,2,93621,93621,93623,0,2,1
26737,1,1,93622,93623,93624,1,2,0
26738,4,1,93626,93626,93627,0,1,2
26739,3,3,93629,93629,93632,0,3,2
26740,1,1,93630,93632,93633,2,3,0
26741,3,2,93633,93633,93635,0,2,0
26742,3,3,93636,93636,93639,0,3,1
26743,6,2,93642,93642,93644,0,2,3
26744,6,2,93648,93648,93650,0,2,4
26745,5,1,93653,93653,93654,0,1,3
26746,6,1,93659,93659,93660,0,1,5
26747,1,1,93660,93660,93661,0,1,0
26748,1,2,93661,93661,93663,0,2,0
26749,4,2,93665,93665,93667,0,2,2
26750,5,1,93670,93670,93671,0,1,3
26751,6,3,93676,93676,93679,0,3,5
26752,3,1,93679,93679,93680,0,1,0
26753,4,1,93683,93683,93684,0,1,3
26754,1,1,93684,93684,93685,0,1,0
26755,5,2,93689,93689,93691,0,2,4
26756,2,2,93691,93691,93693,0,2,0
26757,5,2,93696,93696,93698,0,2,3
26758,6,3,93702,93702,93705,0,3,4
26759,2,2,93704,93705,93707,1,3,0
26760,3,2,93707,93707,93709,0,2,0
26761,1,1,93708,93709,93710,1,2,0
26762,1,2,93709,93710,93712,1,3,0
26763,1,1,93710,93712,93713,2,3,0
26764,6,2,93716,93716,93718,0,2,3
26765,2,1,93718,93718,93719,0,1,0
26766,5,3,93723,93723,93726,0,3,4
26767,3,1,93726,93726,93727,0,1,0
26768,5,3,93731,93731,93734,0,3,4
26769,4,2,93735,93735,93737,0,2,1
26770,6,3,93741,93741,93744,0,3,4
26771,4,1,93745,93745,93746,0,1,1
26772,1,2,93746,93746,93748,0,2,0
26773,4,2,93750,93750,93752,0,2,2
26774,2,1,93752,93752,93753,0,1,0
26775,5,1,93757,93757,93758,0,1,4
26776,6,2,93763,93763,93765,0,2,5
26777,1,3,93764,93765,93768,1,4,0
26778,5,3,93769,93769,93772,0,3,1
26779,3,3,93772,93772,93775,0,3,0
26780,6,3,93778,93778,93781,0,3,3
26781,4,3,93782,93782,93785,0,3,1
26782,3,3,93785,93785,93788,0,3,0
26783,6,1,93791,93791,93792,0,1,3
26784,5,3,93796,93796,93799,0,3,4
26785,4,2,93800,93800,93802,0,2,1
26786,5,3,93805,93805,93808,0,3,3
26787,3,3,93808,93808,93811,0,3,0
26788,5,1,93813,93813,93814,0,1,2
26789,5,3,93818,93818,93821,0,3,4
26790,5,1,93823,93823,93824,0,1,2
26791,1,2,93824,93824,93826,0,2,0
26792,5,1,93829,93829,93830,0,1,3
26793,5,2,93834,93834,93836,0,2,4
26794,3,2,93837,93837,93839,0,2,1
26795,4,2,93841,93841,93843,0,2,2
26796,1,2,93842,93843,93845,1,3,0
26797,5,2,93847,93847,93849,0,2,2
26798,2,3,93849,93849,93852,0,3,0
26799,4,2,93853,93853,93855,0,2,1
26800,4,2,93857,93857,93859,0,2,2
26801,1,3,93858,93859,93862,1,4,0
26802,5,3,93863,93863,93866,0,3,1
26803,2,2,93865,93866,93868,1,3,0
26804,1,2,93866,93868,93870,2,4,0
26805,1,2,93867,93870,93872,3,5,0
26806,2,1,93869,93872,93873,3,4,0
26807,3,1,93872,93873,93874,1,2,0
26808,4,1,93876,93876,93877,0,1,2
26809,4,3,93880,93880,93883,0,3,3
26810,4,1,93884,93884,93885,0,1,1
26811,1,2,93885,93885,93887,0,2,0
26812,6,3,93891,93891,93894,0,3,4
26813,5,1,93896,93896,93897,0,1,2
26814,1,3,93897,93897,93900,0,3,0
26815,4,2,93901,93901,93903,0,2,1
26816,5,2,93906,93906,93908,0,2,3
26817,4,1,93910,93910,93911,0,1,2
26818,1,2,93911,93911,93913,0,2,0
26819,5,2,93916,93916,93918,0,2,3
26820,5,1,93921,93921,93922,0,1,3
26821,2,2,93923,93923,93925,0,2,1
26822,1,2,93924,93925,93927,1,3,0
26823,4,2,93928,93928,93930,0,2,1
26824,5,1,93933,93933,93934,0,1,3
26825,4,2,93937,93937,93939,0,2,3
26826,1,3,93938,93939,93942,1,4,0
26827,4,3,93942,93942,93945,0,3,0
26828,3,3,93945,93945,93948,0,3,0
26829,2,2,93947,93948,93950,1,3,0
26830,5,2,93952,93952,93954,0,2,2
26831,3,3,93955,93955,93958,0,3,1
26832,5,2,93960,93960,93962,0,2,2
26833,5,3,93965,93965,93968,0,3,3
26834,1,1,93966,93968,93969,2,3,0
26835,5,2,93971,93971,93973,0,2,2
26836,3,2,93974,93974,93976,0,2,1
26837,6,3,93980,93980,93983,0,3,4
26838,5,3,93985,93985,93988,0,3,2
26839,3,1,93988,93988,93989,0,1,0
26840,3,2,93991,93991,93993,0,2,2
26841,4,3,93995,93995,93998,0,3,2
26842,6,2,94001,94001,94003,0,2,3
26843,3,3,94004,94004,94007,0,3,1
26844,4,3,94008,94008,94011,0,3,1
26845,3,2,94011,94011,94013,0,2,0
26846,1,1,94012,94013,94014,1,2,0
26847,1,1,94013,94014,94015,1,2,0
26848,4,2,94017,94017,94019,0,2,2
26849,4,3,94021,94021,94024,0,3,2
26850,3,3,94024,94024,94027,0,3,0
26851,6,1,94030,94030,94031,0,1,3
26852,5,2,94035,94035,94037,0,2,4
26853,6,3,94041,94041,94044,0,3,4
26854,4,2,94045,94045,94047,0,2,1
26855,1,3,94046,94047,94050,1,4,0
26856,4,1,94050,94050,94051,0,1,0
26857,3,1,94053,94053,94054,0,1,2
26858,4,2,94057,94057,94059,0,2,3
26859,1,2,94058,94059,94061,1,3,0
26860,4,3,94062,94062,94065,0,3,1
26861,3,3,94065,94065,94068,0,3,0
26862,6,3,94071,94071,94074,0,3,3
26863,6,2,94077,94077,94079,0,2,3
26864,3,1,94080,94080,94081,0,1,1
26865,4,3,94084,94084,94087,0,3,3
26866,6,2,94090,94090,94092,0,2,3
26867,6,3,94096,94096,94099,0,3,4
26868,6,1,94102,94102,94103,0,1,3
26869,6,2,94108,94108,94110,0,2,5
26870,4,2,94112,94112,94114,0,2,2
26871,6,3,94118,94118,94121,0,3,4
26872,3,3,94121,94121,94124,0,3,0
26873,3,1,94124,94124,94125,0,1,0
26874,2,2,94126,94126,94128,0,2,1
26875,2,1,94128,94128,94129,0,1,0
26876,4,3,94132,94132,94135,0,3,3
26877,2,2,94134,94135,94137,1,3,0
26878,2,1,94136,94137,94138,1,2,0
26879,5,3,94141,94141,94144,0,3,3
26880,3,3,94144,94144,94147,0,3,0
26881,5,2,94149,94149,94151,0,2,2
26882,2,3,94151,94151,94154,0,3,0
26883,6,1,94157,94157,94158,0,1,3
26884,4,3,94161,94161,94164,0,3,3
26885,1,1,94162,94164,94165,2,3,0
26886,5,1,94167,94167,94168,0,1,2
26887,6,3,94173,94173,94176,0,3,5
26888,6,3,94179,94179,94182,0,3,3
26889,6,3,94185,94185,94188,0,3,3
26890,3,3,94188,94188,94191,0,3,0
26891,4,3,94192,94192,94195,0,3,1
26892,4,1,94196,94196,94197,0,1,1
26893,2,2,94198,94198,94200,0,2,1
26894,6,1,94204,94204,94205,0,1,4
26895,3,2,94207,94207,94209,0,2,2
26896,5,2,94212,94212,94214,0,2,3
26897,3,1,94215,94215,94216,0,1,1
26898,6,3,94221,94221,94224,0,3,5
26899,6,2,94227,94227,94229,0,2,3
26900,2,3,94229,94229,94232,0,3,0
26901,2,2,94231,94232,94234,1,3,0
26902,3,3,94234,94234,94237,0,3,0
26903,1,1,94235,94237,94238,2,3,0
26904,2,1,94237,94238,94239,1,2,0
26905,6,2,94243,94243,94245,0,2,4
26906,4,3,94247,94247,94250,0,3,2
26907,3,3,94250,94250,94253,0,3,0
26908,5,3,94255,94255,94258,0,3,2
26909,4,3,94259,94259,94262,0,3,1
26910,3,2,94262,94262,94264,0,2,0
26911,1,3,94263,94264,94267,1,4,0
26912,2,3,94265,94267,94270,2,5,0
26913,3,2,94268,94270,94272,2,4,0
26914,6,3,94274,94274,94277,0,3,2
26915,2,1,94276,94277,94278,1,2,0
26916,5,2,94281,94281,94283,0,2,3
26917,5,1,94286,94286,94287,0,1,3
26918,3,1,94289,94289,94290,0,1,2
26919,1,1,94290,94290,94291,0,1,0
26920,5,2,94295,94295,94297,0,2,4
26921,3,3,94298,94298,94301,0,3,1
26922,1,3,94299,94301,94304,2,5,0
26923,5,3,94304,94304,94307,0,3,0
26924,4,2,94308,94308,94310,0,2,1
26925,2,1,94310,94310,94311,0,1,0
26926,3,3,94313,94313,94316,0,3,2
26927,1,1,94314,94316,94317,2,3,0
26928,3,2,94317,94317,94319,0,2,0
26929,1,1,94318,94319,94320,1,2,0
26930,3,2,94321,94321,94323,0,2,1
26931,6,2,94327,94327,94329,0,2,4
26932,4,2,94331,94331,94333,0,2,2
26933,4,1,94335,94335,94336,0,1,2
26934,5,2,94340,94340,94342,0,2,4
26935,5,2,94345,94345,94347,0,2,3
26936,4,1,94349,94349,94350,0,1,2
26937,4,2,94353,94353,94355,0,2,3
26938,2,1,94355,94355,94356,0,1,0
26939,6,3,94361,94361,94364,0,3,5
26940,3,3,94364,94364,94367,0,3,0
26941,1,1,94365,94367,94368,2,3,0
26942,1,3,94366,94368,94371,2,5,0
26943,3,1,94369,94371,94372,2,3,0
26944,5,2,94374,94374,94376,0,2,2
26945,6,1,94380,94380,94381,0,1,4
26946,6,1,94386,94386,94387,0,1,5
26947,4,3,94390,94390,94393,0,3,3
26948,3,3,94393,94393,94396,0,3,0
26949,4,1,94397,94397,94398,0,1,1
26950,1,2,94398,94398,94400,0,2,0
26951,2,1,94400,94400,94401,0,1,0
26952,5,3,94405,94405,94408,0,3,4
26953,2,3,94407,94408,94411,1,4,0
26954,5,3,94412,94412,94415,0,3,1
26955,3,1,94415,94415,94416,0,1,0
26956,6,1,94421,94421,94422,0,1,5
26957,5,1,94426,94426,94427,0,1,4
26958,6,1,94432,94432,94433,0,1,5
26959,4,1,94436,94436,94437,0,1,3
26960,3,2,94439,94439,94441,0,2,2
26961,2,1,94441,94441,94442,0,1,0
26962,2,2,94443,94443,94445,0,2,1
26963,5,2,94448,94448,94450,0,2,3
26964,6,3,94454,94454,94457,0,3,4
26965,4,2,94458,94458,94460,0,2,1
26966,2,1,94460,94460,94461,0,1,0
26967,6,3,94466,94466,94469,0,3,5
26968,2,3,94468,94469,94472,1,4,0
26969,6,1,94474,94474,94475,0,1,2
26970,2,1,94476,94476,94477,0,1,1
26971,2,1,94478,94478,94479,0,1,1
26972,3,3,94481,94481,94484,0,3,2
26973,1,2,94482,94484,94486,2,4,0
26974,3,2,94485,94486,94488,1,3,0
26975,6,2,94491,94491,94493,0,2,3
26976,4,2,94495,94495,94497,0,2,2
26977,6,1,94501,94501,94502,0,1,4
26978,6,3,94507,94507,94510,0,3,5
26979,2,2,94509,94510,94512,1,3,0
26980,1,3,94510,94512,94515,2,5,0
26981,2,2,94512,94515,94517,3,5,0
26982,6,3,94518,94518,94521,0,3,1
26983,1,3,94519,94521,94524,2,5,0
26984,1,1,94520,94524,94525,4,5,0
26985,3,3,94523,94525,94528,2,5,0
26986,1,1,94524,94528,94529,4,5,0
26987,2,2,94526,94529,94531,3,5,0
26988,6,3,94532,94532,94535,0,3,1
26989,5,3,94537,94537,94540,0,3,2
26990,5,3,94542,94542,94545,0,3,2
26991,3,1,94545,94545,94546,0,1,0
26992,3,3,94548,94548,94551,0,3,2
26993,4,2,94552,94552,94554,0,2,1
26994,4,2,94556,94556,94558,0,2,2
26995,1,2,94557,94558,94560,1,3,0
26996,3,3,94560,94560,94563,0,3,0
26997,6,1,94566,94566,94567,0,1,3
26998,2,2,94568,94568,94570,0,2,1
26999,2,1,94570,94570,94571,0,1,0
27000,6,1,94576,94576,94577,0,1,5
27001,3,1,94579,94579,94580,0,1,2
27002,5,2,94584,94584,94586,0,2,4
27003,2,1,94586,94586,94587,0,1,0
27004,2,1,94588,94588,94589,0,1,1
27005,1,2,94589,94589,94591,0,2,0
27006,3,3,94592,94592,94595,0,3,1
27007,1,3,94593,94595,94598,2,5,0
27008,6,2,94599,94599,94601,0,2,1
27009,1,3,94600,94601,94604,1,4,0
27010,4,3,94604,94604,94607,0,3,0
27011,1,2,94605,94607,94609,2,4,0
27012,2,1,94607,94609,94610,2,3,0
27013,2,3,94609,94610,94613,1,4,0
27014,5,3,94614,94614,94617,0,3,1
27015,6,3,94620,94620,94623,0,3,3
27016,2,2,94622,94623,94625,1,3,0
27017,6,2,94628,94628,94630,0,2,3
27018,3,2,94631,94631,94633,0,2,1
27019,5,2,94636,94636,94638,0,2,3
27020,4,2,94640,94640,94642,0,2,2
27021,4,1,94644,94644,94645,0,1,2
27022,4,1,94648,94648,94649,0,1,3
27023,3,3,94651,94651,94654,0,3,2
27024,1,1,94652,94654,94655,2,3,0
27025,4,2,94656,94656,94658,0,2,1
27026,4,3,94660,94660,94663,0,3,2
27027,4,2,94664,94664,94666,0,2,1
27028,1,2,94665,94666,94668,1,3,0
27029,3,3,94668,94668,94671,0,3,0
27030,6,1,94674,94674,94675,0,1,3
27031,3,1,94677,94677,94678,0,1,2
27032,6,1,94683,94683,94684,0,1,5
27033,5,1,94688,94688,94689,0,1,4
27034,6,2,94694,94694,94696,0,2,5
27035,5,2,94699,94699,94701,0,2,3
27036,4,1,94703,94703,94704,0,1,2
27037,6,3,94709,94709,94712,0,3,5
27038,3,3,94712,94712,94715,0,3,0
27039,6,1,94718,94718,94719,0,1,3
27040,3,1,94721,94721,94722,0,1,2
27041,3,1,94724,94724,94725,0,1,2
27042,5,1,94729,94729,94730,0,1,4
27043,6,2,94735,94735,94737,0,2,5
27044,6,3,94741,94741,94744,0,3,4
27045,6,1,94747,94747,94748,0,1,3
27046,1,1,94748,94748,94749,0,1,0
27047,6,1,94754,94754,94755,0,1,5
27048,5,2,94759,94759,94761,0,2,4
27049,3,3,94762,94762,94765,0,3,1
27050,3,3,94765,94765,94768,0,3,0
27051,1,1,94766,94768,94769,2,3,0
27052,2,1,94768,94769,94770,1,2,0
27053,6,1,94774,94774,94775,0,1,4
27054,1,2,94775,94775,94777,0,2,0
27055,5,1,94780,94780,94781,0,1,3
27056,4,2,94784,94784,94786,0,2,3
27057,2,3,94786,94786,94789,0,3,0
27058,2,2,94788,94789,94791,1,3,0
27059,3,2,94791,94791,94793,0,2,0
27060,4,2,94795,94795,94797,0,2,2
27061,3,3,94798,94798,94801,0,3,1
27062,6,3,94804,94804,94807,0,3,3
27063,4,1,94808,94808,94809,0,1,1
27064,2,1,94810,94810,94811,0,1,1
27065,6,3,94816,94816,94819,0,3,5
27066,2,3,94818,94819,94822,1,4,0
27067,6,3,94824,94824,94827,0,3,2
27068,6,2,94830,94830,94832,0,2,3
27069,2,1,94832,94832,94833,0,1,0
27070,6,2,94838,94838,94840,0,2,5
27071,2,1,94840,94840,94841,0,1,0
27072,6,3,94846,94846,94849,0,3,5
27073,6,3,94852,94852,94855,0,3,3
27074,4,1,94856,94856,94857,0,1,1
27075,5,2,94861,94861,94863,0,2,4
27076,5,2,94866,94866,94868,0,2,3
27077,5,3,94871,94871,94874,0,3,3
27078,5,2,94876,94876,94878,0,2,2
27079,5,1,94881,94881,94882,0,1,3
27080,1,3,94882,94882,94885,0,3,0
27081,4,1,94886,94886,94887,0,1,1
27082,1,2,94887,94887,94889,0,2,0
27083,1,3,94888,94889,94892,1,4,0
27084,6,1,94894,94894,94895,0,1,2
27085,3,2,94897,94897,94899,0,2,2
27086,1,2,94898,94899,94901,1,3,0
27087,6,3,94904,94904,94907,0,3,3
27088,1,1,94905,94907,94908,2,3,0
27089,6,2,94911,94911,94913,0,2,3
27090,2,1,94913,94913,94914,0,1,0
27091,3,1,94916,94916,94917,0,1,2
27092,1,1,94917,94917,94918,0,1,0
27093,1,3,94918,94918,94921,0,3,0
27094,1,2,94919,94921,94923,2,4,0
27095,5,3,94924,94924,94927,0,3,1
27096,5,3,94929,94929,94932,0,3,2
27097,4,1,94933,94933,94934,0,1,1
27098,4,2,94937,94937,94939,0,2,3
27099,4,2,94941,94941,94943,0,2,2
27100,1,3,94942,94943,94946,1,4,0
27101,4,3,94946,94946,94949,0,3,0
27102,6,2,94952,94952,94954,0,2,3
27103,6,1,94958,94958,94959,0,1,4
27104,4,2,94962,94962,94964,0,2,3
27105,4,1,94966,94966,94967,0,1,2
27106,6,1,94972,94972,94973,0,1,5
27107,3,2,94975,94975,94977,0,2,2
27108,3,1,94978,94978,94979,0,1,1
27109,4,3,94982,94982,94985,0,3,3
27110,3,1,94985,94985,94986,0,1,0
27111,5,3,94990,94990,94993,0,3,4
27112,4,1,94994,94994,94995,0,1,1
27113,3,1,94997,94997,94998,0,1,2
27114,1,1,94998,94998,94999,0,1,0
27115,5,3,95003,95003,95006,0,3,4
27116,5,1,95008,95008,95009,0,1,2
27117,3,3,95011,95011,95014,0,3,2
27118,6,1,95017,95017,95018,0,1,3
27119,3,1,95020,95020,95021,0,1,2
27120,3,2,95023,95023,95025,0,2,2
27121,1,1,95024,95025,95026,1,2,0
27122,6,1,95030,95030,95031,0,1,4
27123,5,3,95035,95035,95038,0,3,4
27124,1,3,95036,95038,95041,2,5,0
27125,4,1,95040,95041,95042,1,2,0
27126,6,2,95046,95046,95048,0,2,4
27127,4,2,95050,95050,95052,0,2,2
27128,1,3,95051,95052,95055,1,4,0
27129,3,1,95054,95055,95056,1,2,0
27130,4,3,95058,95058,95061,0,3,2
27131,4,3,95062,95062,95065,0,3,1
27132,2,1,95064,95065,95066,1,2,0
27133,2,1,95066,95066,95067,0,1,0
27134,6,2,95072,95072,95074,0,2,5
27135,2,3,95074,95074,95077,0,3,0
27136,4,1,95078,95078,95079,0,1,1
27137,4,3,95082,95082,95085,0,3,3
27138,6,3,95088,95088,95091,0,3,3
27139,2,2,95090,95091,95093,1,3,0
27140,6,3,95096,95096,95099,0,3,3
27141,1,1,95097,95099,95100,2,3,0
27142,4,3,95101,95101,95104,0,3,1
27143,5,1,95106,95106,95107,0,1,2
27144,2,3,95108,95108,95111,0,3,1
27145,6,2,95114,95114,95116,0,2,3
27146,3,3,95117,95117,95120,0,3,1
27147,5,3,95122,95122,95125,0,3,2
27148,1,3,95123,95125,95128,2,5,0
27149,3,1,95126,95128,95129,2,3,0
27150,1,2,95127,95129,95131,2,4,0
27151,5,1,95132,95132,95133,0,1,1
27152,2,3,95134,95134,95137,0,3,1
27153,1,1,95135,95137,95138,2,3,0
27154,1,3,95136,95138,95141,2,5,0
27155,6,1,95142,95142,95143,0,1,1
27156,2,3,95144,95144,95147,0,3,1
27157,2,3,95146,95147,95150,1,4,0
27158,4,1,95150,95150,95151,0,1,0
27159,4,1,95154,95154,95155,0,1,3
27160,1,2,95155,95155,95157,0,2,0
27161,5,2,95160,95160,95162,0,2,3
27162,1,2,95161,95162,95164,1,3,0
27163,6,2,95167,95167,95169,0,2,3
27164,2,3,95169,95169,95172,0,3,0
27165,6,3,95175,95175,95178,0,3,3
27166,2,2,95177,95178,95180,1,3,0
27167,1,2,95178,95180,95182,2,4,0
27168,1,1,95179,95182,95183,3,4,0
27169,4,1,95183,95183,95184,0,1,0
27170,5,1,95188,95188,95189,0,1,4
27171,6,1,95194,95194,95195,0,1,5
27172,3,2,95197,95197,95199,0,2,2
27173,3,2,95200,95200,95202,0,2,1
27174,1,2,95201,95202,95204,1,3,0
27175,1,3,95202,95204,95207,2,5,0
27176,4,2,95206,95207,95209,1,3,0
27177,5,3,95211,95211,95214,0,3,2
27178,4,1,95215,95215,95216,0,1,1
27179,2,1,95217,95217,95218,0,1,1
27180,4,3,95221,95221,95224,0,3,3
27181,5,3,95226,95226,95229,0,3,2
27182,6,2,95232,95232,95234,0,2,3
27183,3,1,95235,95235,95236,0,1,1
27184,5,1,95240,95240,95241,0,1,4
27185,1,2,95241,95241,95243,0,2,0
27186,4,2,95245,95245,95247,0,2,2
27187,5,3,95250,95250,95253,0,3,3
27188,4,1,95254,95254,95255,0,1,1
27189,6,3,95260,95260,95263,0,3,5
27190,2,3,95262,95263,95266,1,4,0
27191,1,1,95263,95266,95267,3,4,0
27192,2,3,95265,95267,95270,2,5,0
27193,4,1,95269,95270,95271,1,2,0
27194,6,3,95275,95275,95278,0,3,4
27195,3,1,95278,95278,95279,0,1,0
27196,1,1,95279,95279,95280,0,1,0
27197,2,2,95281,95281,95283,0,2,1
27198,4,3,95285,95285,95288,0,3,2
27199,2,3,95287,95288,95291,1,4,0
27200,1,2,95288,95291,95293,3,5,0
27201,5,3,95293,95293,95296,0,3,0
27202,3,3,95296,95296,95299,0,3,0
27203,1,2,95297,95299,95301,2,4,0
27204,1,3,95298,95301,95304,3,6,0
27205,6,2,95304,95304,95306,0,2,0
27206,6,1,95310,95310,95311,0,1,4
27207,1,1,95311,95311,95312,0,1,0
27208,4,1,95315,95315,95316,0,1,3
27209,3,2,95318,95318,95320,0,2,2
27210,3,2,95321,95321,95323,0,2,1
27211,6,1,95327,95327,95328,0,1,4
27212,6,1,95333,95333,95334,0,1,5
27213,1,2,95334,95334,95336,0,2,0
27214,3,2,95337,95337,95339,0,2,1
27215,4,1,95341,95341,95342,0,1,2
27216,2,3,95343,95343,95346,0,3,1
27217,5,1,95348,95348,95349,0,1,2
27218,5,1,95353,95353,95354,0,1,4
27219,5,3,95358,95358,95361,0,3,4
27220,6,2,95364,95364,95366,0,2,3
27221,1,3,95365,95366,95369,1,4,0
27222,4,2,95369,95369,95371,0,2,0
27223,1,2,95370,95371,95373,1,3,0
27224,4,2,95374,95374,95376,0,2,1
27225,3,2,95377,95377,95379,0,2,1
27226,1,3,95378,95379,95382,1,4,0
27227,5,3,95383,95383,95386,0,3,1
27228,3,1,95386,95386,95387,0,1,0
27229,2,2,95388,95388,95390,0,2,1
27230,3,1,95391,95391,95392,0,1,1
27231,3,1,95394,95394,95395,0,1,2
27232,6,2,95400,95400,95402,0,2,5
27233,2,2,95402,95402,95404,0,2,0
27234,1,1,95403,95404,95405,1,2,0
27235,3,3,95406,95406,95409,0,3,1
27236,1,3,95407,95409,95412,2,5,0
27237,4,1,95411,95412,95413,1,2,0
27238,4,1,95415,95415,95416,0,1,2
27239,3,3,95418,95418,95421,0,3,2
27240,6,3,95424,95424,95427,0,3,3
27241,6,2,95430,95430,95432,0,2,3
27242,5,3,95435,95435,95438,0,3,3
27243,5,2,95440,95440,95442,0,2,2
27244,2,3,95442,95442,95445,0,3,0
27245,5,2,95447,95447,95449,0,2,2
27246,5,1,95452,95452,95453,0,1,3
27247,5,2,95457,95457,95459,0,2,4
27248,1,1,95458,95459,95460,1,2,0
27249,4,3,95462,95462,95465,0,3,2
27250,4,3,95466,95466,95469,0,3,1
27251,1,2,95467,95469,95471,2,4,0
27252,2,3,95469,95471,95474,2,5,0
27253,3,3,95472,95474,95477,2,5,0
27254,3,1,95475,95477,95478,2,3,0
27255,2,3,95477,95478,95481,1,4,0
27256,4,3,95481,95481,95484,0,3,0
27257,2,1,95483,95484,95485,1,2,0
27258,1,1,95484,95485,95486,1,2,0
27259,4,1,95488,95488,95489,0,1,2
27260,4,2,95492,95492,95494,0,2,3
27261,2,3,95494,95494,95497,0,3,0
27262,5,2,95499,95499,95501,0,2,2
27263,5,2,95504,95504,95506,0,2,3
27264,2,1,95506,95506,95507,0,1,0
27265,6,3,95512,95512,95515,0,3,5
27266,3,2,95515,95515,95517,0,2,0
27267,2,3,95517,95517,95520,0,3,0
27268,6,3,95523,95523,95526,0,3,3
27269,5,1,95528,95528,95529,0,1,2
27270,1,1,95529,95529,95530,0,1,0
27271,6,3,95535,95535,95538,0,3,5
27272,2,1,95537,95538,95539,1,2,0
27273,1,2,95538,95539,95541,1,3,0
27274,3,1,95541,95541,95542,0,1,0
27275,1,3,95542,95542,95545,0,3,0
27276,1,2,95543,95545,95547,2,4,0
27277,5,2,95548,95548,95550,0,2,1
27278,3,1,95551,95551,95552,0,1,1
27279,5,2,95556,95556,95558,0,2,4
27280,1,1,95557,95558,95559,1,2,0
27281,4,2,95561,95561,95563,0,2,2
27282,6,3,95567,95567,95570,0,3,4
27283,3,3,95570,95570,95573,0,3,0
27284,2,2,95572,95573,95575,1,3,0
27285,2,1,95574,95575,95576,1,2,0
27286,3,2,95577,95577,95579,0,2,1
27287,3,1,95580,95580,95581,0,1,1
27288,4,2,95584,95584,95586,0,2,3
27289,1,2,95585,95586,95588,1,3,0
27290,3,1,95588,95588,95589,0,1,0
27291,2,3,95590,95590,95593,0,3,1
27292,4,3,95594,95594,95597,0,3,1
27293,3,3,95597,95597,95600,0,3,0
27294,3,2,95600,95600,95602,0,2,0
27295,5,1,95605,95605,95606,0,1,3
27296,3,3,95608,95608,95611,0,3,2
27297,6,3,95614,95614,95617,0,3,3
27298,2,3,95616,95617,95620,1,4,0
27299,2,2,95618,95620,95622,2,4,0
27300,4,1,95622,95622,95623,0,1,0
27301,1,3,95623,95623,95626,0,3,0
27302,1,2,95624,95626,95628,2,4,0
27303,1,1,95625,95628,95629,3,4,0
27304,3,1,95628,95629,95630,1,2,0
27305,1,2,95629,95630,95632,1,3,0
27306,1,2,95630,95632,95634,2,4,0
27307,5,2,95635,95635,95637,0,2,1
27308,5,2,95640,95640,95642,0,2,3
27309,5,2,95645,95645,95647,0,2,3
27310,4,1,95649,95649,95650,0,1,2
27311,4,1,95653,95653,95654,0,1,3
27312,6,1,95659,95659,95660,0,1,5
27313,2,2,95661,95661,95663,0,2,1
27314,3,3,95664,95664,95667,0,3,1
27315,5,3,95669,95669,95672,0,3,2
27316,5,2,95674,95674,95676,0,2,2
27317,6,3,95680,95680,95683,0,3,4
27318,6,3,95686,95686,95689,0,3,3
27319,1,2,95687,95689,95691,2,4,0
27320,2,1,95689,95691,95692,2,3,0
27321,4,3,95693,95693,95696,0,3,1
27322,1,2,95694,95696,95698,2,4,0
27323,4,2,95698,95698,95700,0,2,0
27324,5,2,95703,95703,95705,0,2,3
27325,6,3,95709,95709,95712,0,3,4
27326,6,2,95715,95715,95717,0,2,3
27327,3,1,95718,95718,95719,0,1,1
27328,4,2,95722,95722,95724,0,2,3
27329,1,1,95723,95724,95725,1,2,0
27330,2,3,95725,95725,95728,0,3,0
27331,5,1,95730,95730,95731,0,1,2
27332,4,2,95734,95734,95736,0,2,3
27333,5,1,95739,95739,95740,0,1,3
27334,1,3,95740,95740,95743,0,3,0
27335,1,2,95741,95743,95745,2,4,0
27336,1,1,95742,95745,95746,3,4,0
27337,5,1,95747,95747,95748,0,1,1
27338,3,1,95750,95750,95751,0,1,2
27339,5,3,95755,95755,95758,0,3,4
27340,4,3,95759,95759,95762,0,3,1
27341,6,1,95765,95765,95766,0,1,3
27342,2,1,95767,95767,95768,0,1,1
27343,3,1,95770,95770,95771,0,1,2
27344,6,1,95776,95776,95777,0,1,5
27345,6,3,95782,95782,95785,0,3,5
27346,2,1,95784,95785,95786,1,2,0
27347,3,3,95787,95787,95790,0,3,1
27348,6,2,95793,95793,95795,0,2,3
27349,6,2,95799,95799,95801,0,2,4
27350,4,3,95803,95803,95806,0,3,2
27351,6,1,95809,95809,95810,0,1,3
27352,1,2,95810,95810,95812,0,2,0
27353,5,2,95815,95815,95817,0,2,3
27354,6,3,95821,95821,95824,0,3,4
27355,1,1,95822,95824,95825,2,3,0
27356,3,2,95825,95825,95827,0,2,0
27357,5,2,95830,95830,95832,0,2,3
27358,1,2,95831,95832,95834,1,3,0
27359,5,2,95836,95836,95838,0,2,2
27360,1,2,95837,95838,95840,1,3,0
27361,4,2,95841,95841,95843,0,2,1
27362,5,2,95846,95846,95848,0,2,3
27363,3,1,95849,95849,95850,0,1,1
27364,3,3,95852,95852,95855,0,3,2
27365,1,3,95853,95855,95858,2,5,0
27366,5,3,95858,95858,95861,0,3,0
27367,4,1,95862,95862,95863,0,1,1
27368,5,3,95867,95867,95870,0,3,4
27369,2,1,95869,95870,95871,1,2,0
27370,5,1,95874,95874,95875,0,1,3
27371,1,1,95875,95875,95876,0,1,0
27372,2,3,95877,95877,95880,0,3,1
27373,4,1,95881,95881,95882,0,1,1
27374,3,3,95884,95884,95887,0,3,2
27375,3,3,95887,95887,95890,0,3,0
27376,4,1,95891,95891,95892,0,1,1
27377,3,2,95894,95894,95896,0,2,2
27378,1,3,95895,95896,95899,1,4,0
27379,4,3,95899,95899,95902,0,3,0
27380,3,2,95902,95902,95904,0,2,0
27381,5,3,95907,95907,95910,0,3,3
27382,2,3,95909,95910,95913,1,4,0
27383,1,2,95910,95913,95915,3,5,0
27384,3,3,95913,95915,95918,2,5,0
27385,3,1,95916,95918,95919,2,3,0
27386,3,2,95919,95919,95921,0,2,0
27387,2,3,95921,95921,95924,0,3,0
27388,5,2,95926,95926,95928,0,2,2
27389,1,3,95927,95928,95931,1,4,0
27390,6,2,95933,95933,95935,0,2,2
27391,5,2,95938,95938,95940,0,2,3
27392,1,1,95939,95940,95941,1,2,0
27393,1,3,95940,95941,95944,1,4,0
27394,3,2,95943,95944,95946,1,3,0
27395,2,1,95945,95946,95947,1,2,0
27396,5,2,95950,95950,95952,0,2,3
27397,4,2,95954,95954,95956,0,2,2
27398,2,2,95956,95956,95958,0,2,0
27399,2,1,95958,95958,95959,0,1,0
27400,2,3,95960,95960,95963,0,3,1
27401,2,1,95962,95963,95964,1,2,0
27402,2,2,95964,95964,95966,0,2,0
27403,2,3,95966,95966,95969,0,3,0
27404,6,2,95972,95972,95974,0,2,3
27405,5,3,95977,95977,95980,0,3,3
27406,2,1,95979,95980,95981,1,2,0
27407,5,3,95984,95984,95987,0,3,3
27408,3,1,95987,95987,95988,0,1,0
27409,3,2,95990,95990,95992,0,2,2
27410,3,2,95993,95993,95995,0,2,1
27411,6,2,95999,95999,96001,0,2,4
27412,1,3,96000,96001,96004,1,4,0
27413,6,2,96006,96006,96008,0,2,2
27414,1,1,96007,96008,96009,1,2,0
27415,5,2,96012,96012,96014,0,2,3
27416,4,3,96016,96016,96019,0,3,2
27417,3,2,96019,96019,96021,0,2,0
27418,4,1,96023,96023,96024,0,1,2
27419,5,3,96028,96028,96031,0,3,4
27420,2,3,96030,96031,96034,1,4,0
27421,3,1,96033,96034,96035,1,2,0
27422,1,3,96034,96035,96038,1,4,0
27423,2,2,96036,96038,96040,2,4,0
27424,5,1,96041,96041,96042,0,1,1
27425,6,3,96047,96047,96050,0,3,5
27426,1,1,96048,96050,96051,2,3,0
27427,1,2,96049,96051,96053,2,4,0
27428,4,1,96053,96053,96054,0,1,0
27429,2,2,96055,96055,96057,0,2,1
27430,3,2,96058,96058,96060,0,2,1
27431,2,2,96060,96060,96062,0,2,0
27432,1,3,96061,96062,96065,1,4,0
27433,6,3,96067,96067,96070,0,3,2
27434,6,1,96073,96073,96074,0,1,3
27435,1,3,96074,96074,96077,0,3,0
27436,5,1,96079,96079,96080,0,1,2
27437,2,1,96081,96081,96082,0,1,1
27438,2,2,96083,96083,96085,0,2,1
27439,6,1,96089,96089,96090,0,1,4
27440,1,2,96090,96090,96092,0,2,0
27441,1,3,96091,96092,96095,1,4,0
27442,4,1,96095,96095,96096,0,1,0
27443,4,2,96099,96099,96101,0,2,3
27444,3,1,96102,96102,96103,0,1,1
27445,3,1,96105,96105,96106,0,1,2
27446,1,1,96106,96106,96107,0,1,0
27447,1,2,96107,96107,96109,0,2,0
27448,2,3,96109,96109,96112,0,3,0
27449,5,1,96114,96114,96115,0,1,2
27450,4,1,96118,96118,96119,0,1,3
27451,6,2,96124,96124,96126,0,2,5
27452,5,1,96129,96129,96130,0,1,3
27453,4,1,96133,96133,96134,0,1,3
27454,5,3,96138,96138,96141,0,3,4
27455,4,2,96142,96142,96144,0,2,1
27456,1,2,96143,96144,96146,1,3,0
27457,2,3,96145,96146,96149,1,4,0
27458,5,2,96150,96150,96152,0,2,1
27459,6,3,96156,96156,96159,0,3,4
27460,6,3,96162,96162,96165,0,3,3
27461,4,2,96166,96166,96168,0,2,1
27462,5,3,96171,96171,96174,0,3,3
27463,2,2,96173,96174,96176,1,3,0
27464,3,3,96176,96176,96179,0,3,0
27465,3,2,96179,96179,96181,0,2,0
27466,6,2,96185,96185,96187,0,2,4
27467,3,3,96188,96188,96191,0,3,1
27468,4,3,96192,96192,96195,0,3,1
27469,5,1,96197,96197,96198,0,1,2
27470,3,3,96200,96200,96203,0,3,2
27471,3,2,96203,96203,96205,0,2,0
27472,1,3,96204,96205,96208,1,4,0
27473,5,1,96209,96209,96210,0,1,1
27474,3,2,96212,96212,96214,0,2,2
27475,5,3,96217,96217,96220,0,3,3
27476,3,2,96220,96220,96222,0,2,0
27477,5,2,96225,96225,96227,0,2,3
27478,4,2,96229,96229,96231,0,2,2
27479,6,2,96235,96235,96237,0,2,4
27480,5,2,96240,96240,96242,0,2,3
27481,5,2,96245,96245,96247,0,2,3
27482,5,1,96250,96250,96251,0,1,3
27483,3,1,96253,96253,96254,0,1,2
27484,2,3,96255,96255,96258,0,3,1
27485,4,1,96259,96259,96260,0,1,1
27486,3,2,96262,96262,96264,0,2,2
27487,1,2,96263,96264,96266,1,3,0
27488,2,3,96265,96266,96269,1,4,0
27489,3,3,96268,96269,96272,1,4,0
27490,4,1,96272,96272,96273,0,1,0
27491,4,2,96276,96276,96278,0,2,3
27492,2,3,96278,96278,96281,0,3,0
27493,5,3,96283,96283,96286,0,3,2
27494,3,1,96286,96286,96287,0,1,0
27495,2,3,96288,96288,96291,0,3,1
27496,4,3,96292,96292,96295,0,3,1
27497,5,1,96297,96297,96298,0,1,2
27498,2,3,96299,96299,96302,0,3,1
27499,2,1,96301,96302,96303,1,2,0
27500,5,1,96306,96306,96307,0,1,3
27501,3,3,96309,96309,96312,0,3,2
27502,6,1,96315,96315,96316,0,1,3
27503,5,3,96320,96320,96323,0,3,4
27504,2,1,96322,96323,96324,1,2,0
27505,1,1,96323,96324,96325,1,2,0
27506,3,3,96326,96326,96329,0,3,1
27507,2,3,96328,96329,96332,1,4,0
27508,5,1,96333,96333,96334,0,1,1
27509,4,2,96337,96337,96339,0,2,3
27510,1,3,96338,96339,96342,1,4,0
27511,3,1,96341,96342,96343,1,2,0
27512,3,2,96344,96344,96346,0,2,1
27513,1,3,96345,96346,96349,1,4,0
27514,2,3,96347,96349,96352,2,5,0
27515,4,1,96351,96352,96353,1,2,0
27516,2,3,96353,96353,96356,0,3,0
27517,2,3,96355,96356,96359,1,4,0
27518,2,3,96357,96359,96362,2,5,0
27519,2,1,96359,96362,96363,3,4,0
27520,4,1,96363,96363,96364,0,1,0
27521,1,3,96364,96364,96367,0,3,0
27522,1,3,96365,96367,96370,2,5,0
27523,1,3,96366,96370,96373,4,7,0
27524,1,3,96367,96373,96376,6,9,0
27525,2,2,96369,96376,96378,7,9,0
27526,2,2,96371,96378,96380,7,9,0
27527,3,1,96374,96380,96381,6,7,0
27528,5,2,96379,96381,96383,2,4,0
27529,6,2,96385,96385,96387,0,2,2
27530,6,1,96391,96391,96392,0,1,4
27531,1,2,96392,96392,96394,0,2,0
27532,1,2,96393,96394,96396,1,3,0
27533,2,3,96395,96396,96399,1,4,0
27534,6,3,96401,96401,96404,0,3,2
27535,2,3,96403,96404,96407,1,4,0
27536,6,2,96409,96409,96411,0,2,2
27537,2,1,96411,96411,96412,0,1,0
27538,3,3,96414,96414,96417,0,3,2
27539,5,3,96419,96419,96422,0,3,2
27540,2,2,96421,96422,96424,1,3,0
27541,2,1,96423,96424,96425,1,2,0
27542,2,2,96425,96425,96427,0,2,0
27543,6,2,96431,96431,96433,0,2,4
27544,2,3,96433,96433,96436,0,3,0
27545,6,1,96439,96439,96440,0,1,3
27546,6,1,96445,96445,96446,0,1,5
27547,1,1,96446,96446,96447,0,1,0
27548,2,3,96448,96448,96451,0,3,1
27549,6,3,96454,96454,96457,0,3,3
27550,1,2,96455,96457,96459,2,4,0
27551,3,2,96458,96459,96461,1,3,0
27552,2,1,96460,96461,96462,1,2,0
27553,5,3,96465,96465,96468,0,3,3
27554,2,3,96467,96468,96471,1,4,0
27555,6,2,96473,96473,96475,0,2,2
27556,4,2,96477,96477,96479,0,2,2
27557,4,1,96481,96481,96482,0,1,2
27558,4,1,96485,96485,96486,0,1,3
27559,6,2,96491,96491,96493,0,2,5
27560,2,2,96493,96493,96495,0,2,0
27561,5,3,96498,96498,96501,0,3,3
27562,5,3,96503,96503,96506,0,3,2
27563,6,2,96509,96509,96511,0,2,3
27564,6,3,96515,96515,96518,0,3,4
27565,3,3,96518,96518,96521,0,3,0
27566,6,1,96524,96524,96525,0,1,3
27567,4,3,96528,96528,96531,0,3,3
27568,2,1,96530,96531,96532,1,2,0
27569,6,3,96536,96536,96539,0,3,4
27570,3,2,96539,96539,96541,0,2,0
27571,2,1,96541,96541,96542,0,1,0
27572,6,2,96547,96547,96549,0,2,5
27573,6,2,96553,96553,96555,0,2,4
27574,2,2,96555,96555,96557,0,2,0
27575,2,1,96557,96557,96558,0,1,0
27576,3,1,96560,96560,96561,0,1,2
27577,6,1,96566,96566,96567,0,1,5
27578,3,1,96569,96569,96570,0,1,2
27579,4,2,96573,96573,96575,0,2,3
27580,3,3,96576,96576,96579,0,3,1
27581,4,3,96580,96580,96583,0,3,1
27582,4,2,96584,96584,96586,0,2,1
27583,5,3,96589,96589,96592,0,3,3
27584,6,1,96595,96595,96596,0,1,3
27585,5,2,96600,96600,96602,0,2,4
27586,2,3,96602,96602,96605,0,3,0
27587,1,3,96603,96605,96608,2,5,0
27588,6,2,96609,96609,96611,0,2,1
27589,6,1,96615,96615,96616,0,1,4
27590,3,3,96618,96618,96621,0,3,2
27591,6,3,96624,96624,96627,0,3,3
27592,4,2,96628,96628,96630,0,2,1
27593,1,1,96629,96630,96631,1,2,0
27594,6,2,96635,96635,96637,0,2,4
27595,3,3,96638,96638,96641,0,3,1
27596,5,3,96643,96643,96646,0,3,2
27597,5,3,96648,96648,96651,0,3,2
27598,4,1,96652,96652,96653,0,1,1
27599,2,2,96654,96654,96656,0,2,1
27600,3,3,96657,96657,96660,0,3,1
27601,2,1,96659,96660,96661,1,2,0
27602,2,1,96661,96661,96662,0,1,0
27603,2,2,96663,96663,96665,0,2,1
27604,6,1,96669,96669,96670,0,1,4
27605,5,2,96674,96674,96676,0,2,4
27606,4,1,96678,96678,96679,0,1,2
27607,2,3,96680,96680,96683,0,3,1
27608,5,1,96685,96685,96686,0,1,2
27609,6,3,96691,96691,96694,0,3,5
27610,2,3,96693,96694,96697,1,4,0
27611,1,2,96694,96697,96699,3,5,0
27612,2,2,96696,96699,96701,3,5,0
27613,2,3,96698,96701,96704,3,6,0
27614,1,3,96699,96704,96707,5,8,0
27615,3,1,96702,96707,96708,5,6,0
27616,1,1,96703,96708,96709,5,6,0
27617,1,1,96704,96709,96710,5,6,0
27618,1,1,96705,96710,96711,5,6,0
27619,4,2,96709,96711,96713,2,4,0
27620,2,1,96711,96713,96714,2,3,0
27621,5,3,96716,96716,96719,0,3,2
27622,6,2,96722,96722,96724,0,2,3
27623,5,1,96727,96727,96728,0,1,3
27624,6,2,96733,96733,96735,0,2,5
27625,4,1,96737,96737,96738,0,1,2
27626,1,3,96738,96738,96741,0,3,0
27627,3,3,96741,96741,96744,0,3,0
27628,1,3,96742,96744,96747,2,5,0
27629,2,3,96744,96747,96750,3,6,0
27630,5,3,96749,96750,96753,1,4,0
27631,1,1,96750,96753,96754,3,4,0
27632,4,2,96754,96754,96756,0,2,0
27633,1,3,96755,96756,96759,1,4,0
27634,4,1,96759,96759,96760,0,1,0
27635,3,3,96762,96762,96765,0,3,2
27636,4,1,96766,96766,96767,0,1,1
27637,3,3,96769,96769,96772,0,3,2
27638,3,2,96772,96772,96774,0,2,0
27639,6,1,96778,96778,96779,0,1,4
27640,6,3,96784,96784,96787,0,3,5
27641,6,2,96790,96790,96792,0,2,3
27642,3,3,96793,96793,96796,0,3,1
27643,4,3,96797,96797,96800,0,3,1
27644,6,3,96803,96803,96806,0,3,3
27645,1,2,96804,96806,96808,2,4,0
27646,1,1,96805,96808,96809,3,4,0
27647,4,1,96809,96809,96810,0,1,0
27648,2,3,96811,96811,96814,0,3,1
27649,1,3,96812,96814,96817,2,5,0
27650,6,3,96818,96818,96821,0,3,1
27651,2,3,96820,96821,96824,1,4,0
27652,5,3,96825,96825,96828,0,3,1
27653,6,1,96831,96831,96832,0,1,3
27654,3,3,96834,96834,96837,0,3,2
27655,6,2,96840,96840,96842,0,2,3
27656,6,2,96846,96846,96848,0,2,4
27657,6,1,96852,96852,96853,0,1,4
27658,6,1,96858,96858,96859,0,1,5
27659,3,1,96861,96861,96862,0,1,2
27660,3,3,96864,96864,96867,0,3,2
27661,4,2,96868,96868,96870,0,2,1
27662,2,3,96870,96870,96873,0,3,0
27663,3,1,96873,96873,96874,0,1,0
27664,3,3,96876,96876,96879,0,3,2
27665,5,3,96881,96881,96884,0,3,2
27666,3,3,96884,96884,96887,0,3,0
27667,2,1,96886,96887,96888,1,2,0
27668,1,3,96887,96888,96891,1,4,0
27669,6,2,96893,96893,96895,0,2,2
27670,5,3,96898,96898,96901,0,3,3
27671,5,1,96903,96903,96904,0,1,2
27672,5,1,96908,96908,96909,0,1,4
27673,3,1,96911,96911,96912,0,1,2
27674,2,2,96913,96913,96915,0,2,1
27675,5,3,96918,96918,96921,0,3,3
27676,5,2,96923,96923,96925,0,2,2
27677,5,1,96928,96928,96929,0,1,3
27678,3,2,96931,96931,96933,0,2,2
27679,5,2,96936,96936,96938,0,2,3
27680,1,3,96937,96938,96941,1,4,0
27681,3,3,96940,96941,96944,1,4,0
27682,2,2,96942,96944,96946,2,4,0
27683,1,2,96943,96946,96948,3,5,0
27684,6,2,96949,96949,96951,0,2,1
27685,3,2,96952,96952,96954,0,2,1
27686,6,2,96958,96958,96960,0,2,4
27687,1,1,96959,96960,96961,1,2,0
27688,6,3,96965,96965,96968,0,3,4
27689,3,2,96968,96968,96970,0,2,0
27690,2,2,96970,96970,96972,0,2,0
27691,3,3,96973,96973,96976,0,3,1
27692,5,1,96978,96978,96979,0,1,2
27693,4,3,96982,96982,96985,0,3,3
27694,3,3,96985,96985,96988,0,3,0
27695,5,1,96990,96990,96991,0,1,2
27696,3,2,96993,96993,96995,0,2,2
27697,5,1,96998,96998,96999,0,1,3
27698,3,1,97001,97001,97002,0,1,2
27699,6,2,97007,97007,97009,0,2,5
27700,2,2,97009,97009,97011,0,2,0
27701,3,2,97012,97012,97014,0,2,1
27702,6,3,97018,97018,97021,0,3,4
27703,3,1,97021,97021,97022,0,1,0
27704,2,2,97023,97023,97025,0,2,1
27705,2,2,97025,97025,97027,0,2,0
27706,3,1,97028,97028,97029,0,1,1
27707,1,2,97029,97029,97031,0,2,0
27708,2,3,97031,97031,97034,0,3,0
27709,3,2,97034,97034,97036,0,2,0
27710,6,2,97040,97040,97042,0,2,4
27711,1,1,97041,97042,97043,1,2,0
27712,3,2,97044,97044,97046,0,2,1
27713,5,1,97049,97049,97050,0,1,3
27714,6,3,97055,97055,97058,0,3,5
27715,5,1,97060,97060,97061,0,1,2
27716,3,2,97063,97063,97065,0,2,2
27717,4,2,97067,97067,97069,0,2,2
27718,4,1,97071,97071,97072,0,1,2
27719,5,3,97076,97076,97079,0,3,4
27720,1,1,97077,97079,97080,2,3,0
27721,3,1,97080,97080,97081,0,1,0
27722,1,3,97081,97081,97084,0,3,0
27723,6,1,97087,97087,97088,0,1,3
27724,5,2,97092,97092,97094,0,2,4
27725,5,3,97097,97097,97100,0,3,3
27726,5,3,97102,97102,97105,0,3,2
27727,1,3,97103,97105,97108,2,5,0
27728,4,1,97107,97108,97109,1,2,0
27729,4,1,97111,97111,97112,0,1,2
27730,1,2,97112,97112,97114,0,2,0
27731,4,2,97116,97116,97118,0,2,2
27732,1,2,97117,97118,97120,1,3,0
27733,4,1,97121,97121,97122,0,1,1
27734,1,3,97122,97122,97125,0,3,0
27735,5,3,97127,97127,97130,0,3,2
27736,2,2,97129,97130,97132,1,3,0
27737,3,1,97132,97132,97133,0,1,0
27738,1,3,97133,97133,97136,0,3,0
27739,5,2,97138,97138,97140,0,2,2
27740,4,2,97142,97142,97144,0,2,2
27741,3,2,97145,97145,97147,0,2,1
27742,6,1,97151,97151,97152,0,1,4
27743,3,1,97154,97154,97155,0,1,2
27744,3,2,97157,97157,97159,0,2,2
27745,4,2,97161,97161,97163,0,2,2
27746,5,3,97166,97166,97169,0,3,3
27747,5,3,97171,97171,97174,0,3,2
27748,6,3,97177,97177,97180,0,3,3
27749,2,2,97179,97180,97182,1,3,0
27750,6,3,97185,97185,97188,0,3,3
27751,2,3,97187,97188,97191,1,4,0
27752,4,2,97191,97191,97193,0,2,0
27753,6,3,97197,97197,97200,0,3,4
27754,6,1,97203,97203,97204,0,1,3
27755,6,3,97209,97209,97212,0,3,5
27756,4,2,97213,97213,97215,0,2,1
27757,5,2,97218,97218,97220,0,2,3
27758,1,3,97219,97220,97223,1,4,0
27759,6,2,97225,97225,97227,0,2,2
27760,4,3,97229,97229,97232,0,3,2
27761,5,1,97234,97234,97235,0,1,2
27762,4,3,97238,97238,97241,0,3,3
27763,1,3,97239,97241,97244,2,5,0
27764,5,1,97244,97244,97245,0,1,0
27765,5,3,97249,97249,97252,0,3,4
27766,5,3,97254,97254,97257,0,3,2
27767,2,2,97256,97257,97259,1,3,0
27768,2,3,97258,97259,97262,1,4,0
27769,1,3,97259,97262,97265,3,6,0
27770,6,3,97265,97265,97268,0,3,0
27771,2,2,97267,97268,97270,1,3,0
27772,5,2,97272,97272,97274,0,2,2
27773,2,1,97274,97274,97275,0,1,0
27774,2,2,97276,97276,97278,0,2,1
27775,4,1,97280,97280,97281,0,1,2
27776,6,2,97286,97286,97288,0,2,5
27777,5,2,97291,97291,97293,0,2,3
27778,1,1,97292,97293,97294,1,2,0
27779,5,1,97297,97297,97298,0,1,3
27780,5,1,97302,97302,97303,0,1,4
27781,5,1,97307,97307,97308,0,1,4
27782,3,2,97310,97310,97312,0,2,2
27783,2,3,97312,97312,97315,0,3,0
27784,5,1,97317,97317,97318,0,1,2
27785,2,2,97319,97319,97321,0,2,1
27786,6,2,97325,97325,97327,0,2,4
27787,3,3,97328,97328,97331,0,3,1
27788,5,2,97333,97333,97335,0,2,2
27789,6,3,97339,97339,97342,0,3,4
27790,3,2,97342,97342,97344,0,2,0
27791,1,1,97343,97344,97345,1,2,0
27792,3,3,97346,97346,97349,0,3,1
27793,2,3,97348,97349,97352,1,4,0
27794,5,3,97353,97353,97356,0,3,1
27795,6,3,97359,97359,97362,0,3,3
27796,2,1,97361,97362,97363,1,2,0
27797,6,3,97367,97367,97370,0,3,4
27798,4,1,97371,97371,97372,0,1,1
27799,5,1,97376,97376,97377,0,1,4
27800,5,1,97381,97381,97382,0,1,4
27801,6,1,97387,97387,97388,0,1,5
27802,4,1,97391,97391,97392,0,1,3
27803,3,1,97394,97394,97395,0,1,2
27804,3,2,97397,97397,97399,0,2,2
27805,6,1,97403,97403,97404,0,1,4
27806,6,3,97409,97409,97412,0,3,5
27807,3,3,97412,97412,97415,0,3,0
27808,5,2,97417,97417,97419,0,2,2
27809,4,1,97421,97421,97422,0,1,2
27810,5,2,97426,97426,97428,0,2,4
27811,2,2,97428,97428,97430,0,2,0
27812,3,3,97431,97431,97434,0,3,1
27813,6,3,97437,97437,97440,0,3,3
27814,3,2,97440,97440,97442,0,2,0
27815,6,3,97446,97446,97449,0,3,4
27816,4,3,97450,97450,97453,0,3,1
27817,5,2,97455,97455,97457,0,2,2
27818,4,3,97459,97459,97462,0,3,2
27819,5,2,97464,97464,97466,0,2,2
27820,6,2,97470,97470,97472,0,2,4
27821,1,1,97471,97472,97473,1,2,0
27822,4,1,97475,97475,97476,0,1,2
27823,1,2,97476,97476,97478,0,2,0
27824,3,1,97479,97479,97480,0,1,1
27825,4,3,97483,97483,97486,0,3,3
27826,4,3,97487,97487,97490,0,3,1
27827,1,1,97488,97490,97491,2,3,0
27828,5,1,97493,97493,97494,0,1,2
27829,3,2,97496,97496,97498,0,2,2
27830,4,2,97500,97500,97502,0,2,2
27831,4,3,97504,97504,97507,0,3,2
27832,2,1,97506,97507,97508,1,2,0
27833,5,2,97511,97511,97513,0,2,3
27834,2,1,97513,97513,97514,0,1,0
27835,4,1,97517,97517,97518,0,1,3
27836,4,3,97521,97521,97524,0,3,3
27837,4,3,97525,97525,97528,0,3,1
27838,5,1,97530,97530,97531,0,1,2
27839,1,1,97531,97531,97532,0,1,0
27840,6,3,97537,97537,97540,0,3,5
27841,2,2,97539,97540,97542,1,3,0
27842,4,3,97543,97543,97546,0,3,1
27843,6,3,97549,97549,97552,0,3,3
27844,5,1,97554,97554,97555,0,1,2
27845,2,2,97556,97556,97558,0,2,1
27846,6,3,97562,97562,97565,0,3,4
27847,2,2,97564,97565,97567,1,3,0
27848,3,1,97567,97567,97568,0,1,0
27849,4,3,97571,97571,97574,0,3,3
27850,2,2,97573,97574,97576,1,3,0
27851,4,1,97577,97577,97578,0,1,1
27852,4,3,97581,97581,97584,0,3,3
27853,1,3,97582,97584,97587,2,5,0
27854,2,3,97584,97587,97590,3,6,0
27855,4,2,97588,97590,97592,2,4,0
27856,1,1,97589,97592,97593,3,4,0
27857,6,3,97595,97595,97598,0,3,2
27858,3,3,97598,97598,97601,0,3,0
27859,5,2,97603,97603,97605,0,2,2
27860,1,2,97604,97605,97607,1,3,0
27861,2,2,97606,97607,97609,1,3,0
27862,5,1,97611,97611,97612,0,1,2
27863,1,3,97612,97612,97615,0,3,0
27864,1,3,97613,97615,97618,2,5,0
27865,5,3,97618,97618,97621,0,3,0
27866,1,2,97619,97621,97623,2,4,0
27867,5,1,97624,97624,97625,0,1,1
27868,4,1,97628,97628,97629,0,1,3
27869,4,3,97632,97632,97635,0,3,3
27870,6,3,97638,97638,97641,0,3,3
27871,5,3,97643,97643,97646,0,3,2
27872,5,3,97648,97648,97651,0,3,2
27873,5,2,97653,97653,97655,0,2,2
27874,4,2,97657,97657,97659,0,2,2
27875,4,1,97661,97661,97662,0,1,2
27876,4,1,97665,97665,97666,0,1,3
27877,3,2,97668,97668,97670,0,2,2
27878,4,2,97672,97672,97674,0,2,2
27879,2,3,97674,97674,97677,0,3,0
27880,3,3,97677,97677,97680,0,3,0
27881,6,1,97683,97683,97684,0,1,3
27882,6,2,97689,97689,97691,0,2,5
27883,2,2,97691,97691,97693,0,2,0
27884,5,2,97696,97696,97698,0,2,3
27885,3,1,97699,97699,97700,0,1,1
27886,3,1,97702,97702,97703,0,1,2
27887,4,3,97706,97706,97709,0,3,3
27888,5,2,97711,97711,97713,0,2,2
27889,1,2,97712,97713,97715,1,3,0
27890,4,2,97716,97716,97718,0,2,1
27891,3,3,97719,97719,97722,0,3,1
27892,5,1,97724,97724,97725,0,1,2
27893,4,3,97728,97728,97731,0,3,3
27894,4,1,97732,97732,97733,0,1,1
27895,5,1,97737,97737,97738,0,1,4
27896,6,2,97743,97743,97745,0,2,5
27897,1,2,97744,97745,97747,1,3,0
27898,2,3,97746,97747,97750,1,4,0
27899,2,2,97748,97750,97752,2,4,0
27900,4,1,97752,97752,97753,0,1,0
27901,4,3,97756,97756,97759,0,3,3
27902,1,3,97757,97759,97762,2,5,0
27903,3,2,97760,97762,97764,2,4,0
27904,6,2,97766,97766,97768,0,2,2
27905,4,2,97770,97770,97772,0,2,2
27906,3,1,97773,97773,97774,0,1,1
27907,2,1,97775,97775,97776,0,1,1
27908,4,1,97779,97779,97780,0,1,3
27909,3,1,97782,97782,97783,0,1,2
27910,3,3,97785,97785,97788,0,3,2
27911,4,1,97789,97789,97790,0,1,1
27912,1,2,97790,97790,97792,0,2,0
27913,2,1,97792,97792,97793,0,1,0
27914,1,3,97793,97793,97796,0,3,0
27915,5,1,97798,97798,97799,0,1,2
27916,4,1,97802,97802,97803,0,1,3
27917,6,1,97808,97808,97809,0,1,5
27918,5,2,97813,97813,97815,0,2,4
27919,5,3,97818,97818,97821,0,3,3
27920,2,2,97820,97821,97823,1,3,0
27921,2,1,97822,97823,97824,1,2,0
27922,1,2,97823,97824,97826,1,3,0
27923,4,2,97827,97827,97829,0,2,1
27924,3,1,97830,97830,97831,0,1,1
27925,4,1,97834,97834,97835,0,1,3
27926,5,2,97839,97839,97841,0,2,4
27927,2,3,97841,97841,97844,0,3,0
27928,4,3,97845,97845,97848,0,3,1
27929,1,2,97846,97848,97850,2,4,0
27930,3,3,97849,97850,97853,1,4,0
27931,3,1,97852,97853,97854,1,2,0
27932,6,3,97858,97858,97861,0,3,4
27933,5,2,97863,97863,97865,0,2,2
27934,6,2,97869,97869,97871,0,2,4
27935,4,3,97873,97873,97876,0,3,2
27936,2,1,97875,97876,97877,1,2,0
27937,1,1,97876,97877,97878,1,2,0
27938,1,1,97877,97878,97879,1,2,0
27939,3,1,97880,97880,97881,0,1,1
27940,4,3,97884,97884,97887,0,3,3
27941,1,3,97885,97887,97890,2,5,0
27942,3,2,97888,97890,97892,2,4,0
27943,1,2,97889,97892,97894,3,5,0
27944,1,2,97890,97894,97896,4,6,0
27945,1,3,97891,97896,97899,5,8,0
27946,5,3,97896,97899,97902,3,6,0
27947,3,2,97899,97902,97904,3,5,0
27948,3,3,97902,97904,97907,2,5,0
27949,5,3,97907,97907,97910,0,3,0
27950,6,3,97913,97913,97916,0,3,3
27951,2,2,97915,97916,97918,1,3,0
27952,6,3,97921,97921,97924,0,3,3
27953,5,2,97926,97926,97928,0,2,2
27954,6,2,97932,97932,97934,0,2,4
27955,2,3,97934,97934,97937,0,3,0
27956,3,2,97937,97937,97939,0,2,0
27957,2,3,97939,97939,97942,0,3,0
27958,6,3,97945,97945,97948,0,3,3
27959,1,2,97946,97948,97950,2,4,0
27960,2,2,97948,97950,97952,2,4,0
27961,4,1,97952,97952,97953,0,1,0
27962,6,1,97958,97958,97959,0,1,5
27963,5,3,97963,97963,97966,0,3,4
27964,1,3,97964,97966,97969,2,5,0
27965,4,3,97968,97969,97972,1,4,0
27966,1,3,97969,97972,97975,3,6,0
27967,4,2,97973,97975,97977,2,4,0
27968,3,1,97976,97977,97978,1,2,0
27969,2,2,97978,97978,97980,0,2,0
27970,2,1,97980,97980,97981,0,1,0
27971,2,2,97982,97982,97984,0,2,1
27972,6,1,97988,97988,97989,0,1,4
27973,3,2,97991,97991,97993,0,2,2
27974,6,3,97997,97997,98000,0,3,4
27975,1,2,97998,98000,98002,2,4,0
27976,2,1,98000,98002,98003,2,3,0
27977,6,2,98006,98006,98008,0,2,3
27978,2,2,98008,98008,98010,0,2,0
27979,3,1,98011,98011,98012,0,1,1
27980,5,2,98016,98016,98018,0,2,4
27981,3,1,98019,98019,98020,0,1,1
27982,4,1,98023,98023,98024,0,1,3
27983,5,3,98028,98028,98031,0,3,4
27984,6,2,98034,98034,98036,0,2,3
27985,4,2,98038,98038,98040,0,2,2
27986,5,2,98043,98043,98045,0,2,3
27987,4,1,98047,98047,98048,0,1,2
27988,2,2,98049,98049,98051,0,2,1
27989,3,1,98052,98052,98053,0,1,1
27990,4,3,98056,98056,98059,0,3,3
27991,3,1,98059,98059,98060,0,1,0
27992,3,2,98062,98062,98064,0,2,2
27993,2,3,98064,98064,98067,0,3,0
27994,4,3,98068,98068,98071,0,3,1
27995,2,3,98070,98071,98074,1,4,0
27996,5,1,98075,98075,98076,0,1,1
27997,4,1,98079,98079,98080,0,1,3
27998,3,3,98082,98082,98085,0,3,2
27999,4,2,98086,98086,98088,0,2,1
28000,3,3,98089,98089,98092,0,3,1
28001,4,1,98093,98093,98094,0,1,1
28002,4,1,98097,98097,98098,0,1,3
28003,2,3,98099,98099,98102,0,3,1
28004,1,3,98100,98102,98105,2,5,0
28005,2,3,98102,98105,98108,3,6,0
28006,2,3,98104,98108,98111,4,7,0
28007,2,1,98106,98111,98112,5,6,0
28008,2,2,98108,98112,98114,4,6,0
28009,5,1,98113,98114,98115,1,2,0
28010,3,1,98116,98116,98117,0,1,1
28011,6,1,98122,98122,98123,0,1,5
28012,4,1,98126,98126,98127,0,1,3
28013,4,1,98130,98130,98131,0,1,3
28014,1,3,98131,98131,98134,0,3,0
28015,6,1,98137,98137,98138,0,1,3
28016,5,1,98142,98142,98143,0,1,4
28017,4,1,98146,98146,98147,0,1,3
28018,1,1,98147,98147,98148,0,1,0
28019,1,1,98148,98148,98149,0,1,0
28020,3,1,98151,98151,98152,0,1,2
28021,1,3,98152,98152,98155,0,3,0
28022,4,3,98156,98156,98159,0,3,1
28023,4,3,98160,98160,98163,0,3,1
28024,2,2,98162,98163,98165,1,3,0
28025,4,2,98166,98166,98168,0,2,1
28026,3,3,98169,98169,98172,0,3,1
28027,5,1,98174,98174,98175,0,1,2
28028,2,1,98176,98176,98177,0,1,1
28029,1,2,98177,98177,98179,0,2,0
28030,1,1,98178,98179,98180,1,2,0
28031,6,3,98184,98184,98187,0,3,4
28032,2,3,98186,98187,98190,1,4,0
28033,6,1,98192,98192,98193,0,1,2
28034,5,3,98197,98197,98200,0,3,4
28035,4,1,98201,98201,98202,0,1,1
28036,4,2,98205,98205,98207,0,2,3
28037,5,1,98210,98210,98211,0,1,3
28038,2,1,98212,98212,98213,0,1,1
28039,3,1,98215,98215,98216,0,1,2
28040,1,2,98216,98216,98218,0,2,0
28041,1,2,98217,98218,98220,1,3,0
28042,1,1,98218,98220,98221,2,3,0
28043,4,1,98222,98222,98223,0,1,1
28044,1,3,98223,98223,98226,0,3,0
28045,4,3,98227,98227,98230,0,3,1
28046,5,1,98232,98232,98233,0,1,2
28047,6,1,98238,98238,98239,0,1,5
28048,4,1,98242,98242,98243,0,1,3
28049,1,3,98243,98243,98246,0,3,0
28050,3,3,98246,98246,98249,0,3,0
28051,6,1,98252,98252,98253,0,1,3
28052,6,1,98258,98258,98259,0,1,5
28053,2,3,98260,98260,98263,0,3,1
28054,1,2,98261,98263,98265,2,4,0
28055,5,3,98266,98266,98269,0,3,1
28056,2,2,98268,98269,98271,1,3,0
28057,2,2,98270,98271,98273,1,3,0
28058,6,1,98276,98276,98277,0,1,3
28059,3,1,98279,98279,98280,0,1,2
28060,5,2,98284,98284,98286,0,2,4
28061,5,1,98289,98289,98290,0,1,3
28062,6,2,98295,98295,98297,0,2,5
28063,3,1,98298,98298,98299,0,1,1
28064,2,2,98300,98300,98302,0,2,1
28065,5,1,98305,98305,98306,0,1,3
28066,2,1,98307,98307,98308,0,1,1
28067,5,1,98312,98312,98313,0,1,4
28068,4,2,98316,98316,98318,0,2,3
28069,5,2,98321,98321,98323,0,2,3
28070,6,1,98327,98327,98328,0,1,4
28071,4,3,98331,98331,98334,0,3,3
28072,1,3,98332,98334,98337,2,5,0
28073,1,1,98333,98337,98338,4,5,0
28074,6,3,98339,98339,98342,0,3,1
28075,4,3,98343,98343,98346,0,3,1
28076,4,3,98347,98347,98350,0,3,1
28077,1,3,98348,98350,98353,2,5,0
28078,2,1,98350,98353,98354,3,4,0
28079,2,2,98352,98354,98356,2,4,0
28080,2,2,98354,98356,98358,2,4,0
28081,2,2,98356,98358,98360,2,4,0
28082,5,1,98361,98361,98362,0,1,1
28083,6,2,98367,98367,98369,0,2,5
28084,2,2,98369,98369,98371,0,2,0
28085,4,2,98373,98373,98375,0,2,2
28086,5,1,98378,98378,98379,0,1,3
28087,6,1,98384,98384,98385,0,1,5
28088,3,2,98387,98387,98389,0,2,2
28089,4,2,98391,98391,98393,0,2,2
28090,6,3,98397,98397,98400,0,3,4
28091,5,3,98402,98402,98405,0,3,2
28092,1,3,98403,98405,98408,2,5,0
28093,4,3,98407,98408,98411,1,4,0
28094,4,2,98411,98411,98413,0,2,0
28095,5,3,98416,98416,98419,0,3,3
28096,3,1,98419,98419,98420,0,1,0
28097,3,1,98422,98422,98423,0,1,2
28098,6,2,98428,98428,98430,0,2,5
28099,5,1,98433,98433,98434,0,1,3
28100,5,2,98438,98438,98440,0,2,4
28101,3,3,98441,98441,98444,0,3,1
28102,6,1,98447,98447,98448,0,1,3
28103,3,2,98450,98450,98452,0,2,2
28104,4,2,98454,98454,98456,0,2,2
28105,4,1,98458,98458,98459,0,1,2
28106,1,1,98459,98459,98460,0,1,0
28107,4,1,98463,98463,98464,0,1,3
28108,5,2,98468,98468,98470,0,2,4
28109,4,2,98472,98472,98474,0,2,2
28110,1,1,98473,98474,98475,1,2,0
28111,1,3,98474,98475,98478,1,4,0
28112,4,3,98478,98478,98481,0,3,0
28113,1,1,98479,98481,98482,2,3,0
28114,5,2,98484,98484,98486,0,2,2
28115,3,3,98487,98487,98490,0,3,1
28116,5,1,98492,98492,98493,0,1,2
28117,5,1,98497,98497,98498,0,1,4
28118,4,1,98501,98501,98502,0,1,3
28119,1,1,98502,98502,98503,0,1,0
28120,1,2,98503,98503,98505,0,2,0
28121,6,2,98509,98509,98511,0,2,4
28122,3,1,98512,98512,98513,0,1,1
28123,4,1,98516,98516,98517,0,1,3
28124,2,3,98518,98518,98521,0,3,1
28125,2,1,98520,98521,98522,1,2,0
28126,5,2,98525,98525,98527,0,2,3
28127,3,3,98528,98528,98531,0,3,1
28128,6,2,98534,98534,98536,0,2,3
28129,5,2,98539,98539,98541,0,2,3
28130,2,1,98541,98541,98542,0,1,0
28131,6,2,98547,98547,98549,0,2,5
28132,1,1,98548,98549,98550,1,2,0
28133,3,1,98551,98551,98552,0,1,1
28134,4,2,98555,98555,98557,0,2,3
28135,3,2,98558,98558,98560,0,2,1
28136,2,3,98560,98560,98563,0,3,0
28137,6,3,98566,98566,98569,0,3,3
28138,6,2,98572,98572,98574,0,2,3
28139,6,3,98578,98578,98581,0,3,4
28140,6,3,98584,98584,98587,0,3,3
28141,2,3,98586,98587,98590,1,4,0
28142,3,1,98589,98590,98591,1,2,0
28143,4,3,98593,98593,98596,0,3,2
28144,3,2,98596,98596,98598,0,2,0
28145,4,1,98600,98600,98601,0,1,2
28146,4,3,98604,98604,98607,0,3,3
28147,3,3,98607,98607,98610,0,3,0
28148,2,1,98609,98610,98611,1,2,0
28149,2,1,98611,98611,98612,0,1,0
28150,1,3,98612,98612,98615,0,3,0
28151,2,3,98614,98615,98618,1,4,0
28152,2,1,98616,98618,98619,2,3,0
28153,3,1,98619,98619,98620,0,1,0
28154,5,2,98624,98624,98626,0,2,4
28155,2,1,98626,98626,98627,0,1,0
28156,2,3,98628,98628,98631,0,3,1
28157,1,2,98629,98631,98633,2,4,0
28158,1,2,98630,98633,98635,3,5,0
28159,5,1,98635,98635,98636,0,1,0
28160,6,1,98641,98641,98642,0,1,5
28161,4,1,98645,98645,98646,0,1,3
28162,6,1,98651,98651,98652,0,1,5
28163,3,1,98654,98654,98655,0,1,2
28164,6,1,98660,98660,98661,0,1,5
28165,2,3,98662,98662,98665,0,3,1
28166,5,3,98667,98667,98670,0,3,2
28167,2,3,98669,98670,98673,1,4,0
28168,6,3,98675,98675,98678,0,3,2
28169,4,1,98679,98679,98680,0,1,1
28170,5,2,98684,98684,98686,0,2,4
28171,2,1,98686,98686,98687,0,1,0
28172,2,3,98688,98688,98691,0,3,1
28173,6,2,98694,98694,98696,0,2,3
28174,4,1,98698,98698,98699,0,1,2
28175,1,3,98699,98699,98702,0,3,0
28176,3,3,98702,98702,98705,0,3,0
28177,1,1,98703,98705,98706,2,3,0
28178,4,1,98707,98707,98708,0,1,1
28179,2,2,98709,98709,98711,0,2,1
28180,6,3,98715,98715,98718,0,3,4
28181,4,2,98719,98719,98721,0,2,1
28182,2,1,98721,98721,98722,0,1,0
28183,6,3,98727,98727,98730,0,3,5
28184,4,2,98731,98731,98733,0,2,1
28185,6,3,98737,98737,98740,0,3,4
28186,4,1,98741,98741,98742,0,1,1
28187,2,3,98743,98743,98746,0,3,1
28188,4,3,98747,98747,98750,0,3,1
28189,2,1,98749,98750,98751,1,2,0
28190,1,1,98750,98751,98752,1,2,0
28191,1,3,98751,98752,98755,1,4,0
28192,4,3,98755,98755,98758,0,3,0
28193,4,1,98759,98759,98760,0,1,1
28194,5,3,98764,98764,98767,0,3,4
28195,1,1,98765,98767,98768,2,3,0
28196,3,3,98768,98768,98771,0,3,0
28197,5,1,98773,98773,98774,0,1,2
28198,3,3,98776,98776,98779,0,3,2
28199,2,2,98778,98779,98781,1,3,0
28200,6,2,98784,98784,98786,0,2,3
28201,3,2,98787,98787,98789,0,2,1
28202,4,3,98791,98791,98794,0,3,2
28203,3,3,98794,98794,98797,0,3,0
28204,5,3,98799,98799,98802,0,3,2
28205,4,2,98803,98803,98805,0,2,1
28206,3,1,98806,98806,98807,0,1,1
28207,5,2,98811,98811,98813,0,2,4
28208,6,3,98817,98817,98820,0,3,4
28209,6,3,98823,98823,98826,0,3,3
28210,5,1,98828,98828,98829,0,1,2
28211,5,3,98833,98833,98836,0,3,4
28212,6,3,98839,98839,98842,0,3,3
28213,3,2,98842,98842,98844,0,2,0
28214,1,2,98843,98844,98846,1,3,0
28215,3,2,98846,98846,98848,0,2,0
28216,4,2,98850,98850,98852,0,2,2
28217,6,1,98856,98856,98857,0,1,4
28218,5,2,98861,98861,98863,0,2,4
28219,1,2,98862,98863,98865,1,3,0
28220,6,1,98868,98868,98869,0,1,3
28221,2,2,98870,98870,98872,0,2,1
28222,4,2,98874,98874,98876,0,2,2
28223,6,2,98880,98880,98882,0,2,4
28224,5,2,98885,98885,98887,0,2,3
28225,5,1,98890,98890,98891,0,1,3
28226,1,1,98891,98891,98892,0,1,0
28227,2,2,98893,98893,98895,0,2,1
28228,3,2,98896,98896,98898,0,2,1
28229,2,2,98898,98898,98900,0,2,0
28230,6,3,98904,98904,98907,0,3,4
28231,3,3,98907,98907,98910,0,3,0
28232,5,2,98912,98912,98914,0,2,2
28233,1,2,98913,98914,98916,1,3,0
28234,2,1,98915,98916,98917,1,2,0
28235,1,2,98916,98917,98919,1,3,0
28236,4,2,98920,98920,98922,0,2,1
28237,4,2,98924,98924,98926,0,2,2
28238,6,1,98930,98930,98931,0,1,4
28239,1,2,98931,98931,98933,0,2,0
28240,3,2,98934,98934,98936,0,2,1
28241,3,2,98937,98937,98939,0,2,1
28242,2,2,98939,98939,98941,0,2,0
28243,2,2,98941,98941,98943,0,2,0
28244,4,3,98945,98945,98948,0,3,2
28245,6,3,98951,98951,98954,0,3,3
28246,6,2,98957,98957,98959,0,2,3
28247,4,1,98961,98961,98962,0,1,2
28248,5,2,98966,98966,98968,0,2,4
28249,3,2,98969,98969,98971,0,2,1
28250,1,3,98970,98971,98974,1,4,0
28251,1,2,98971,98974,98976,3,5,0
28252,2,3,98973,98976,98979,3,6,0
28253,4,2,98977,98979,98981,2,4,0
28254,5,3,98982,98982,98985,0,3,1
28255,1,2,98983,98985,98987,2,4,0
28256,6,3,98989,98989,98992,0,3,2
28257,6,3,98995,98995,98998,0,3,3
28258,5,2,99000,99000,99002,0,2,2
28259,4,1,99004,99004,99005,0,1,2
28260,4,1,99008,99008,99009,0,1,3
28261,6,3,99014,99014,99017,0,3,5
28262,6,1,99020,99020,99021,0,1,3
28263,3,1,99023,99023,99024,0,1,2
28264,2,2,99025,99025,99027,0,2,1
28265,6,2,99031,99031,99033,0,2,4
28266,4,1,99035,99035,99036,0,1,2
28267,4,2,99039,99039,99041,0,2,3
28268,5,2,99044,99044,99046,0,2,3
28269,3,3,99047,99047,99050,0,3,1
28270,4,2,99051,99051,99053,0,2,1
28271,6,2,99057,99057,99059,0,2,4
28272,2,2,99059,99059,99061,0,2,0
28273,6,3,99065,99065,99068,0,3,4
28274,1,2,99066,99068,99070,2,4,0
28275,3,1,99069,99070,99071,1,2,0
28276,6,3,99075,99075,99078,0,3,4
28277,1,2,99076,99078,99080,2,4,0
28278,6,3,99082,99082,99085,0,3,2
28279,5,3,99087,99087,99090,0,3,2
28280,4,3,99091,99091,99094,0,3,1
28281,1,1,99092,99094,99095,2,3,0
28282,5,2,99097,99097,99099,0,2,2
28283,5,3,99102,99102,99105,0,3,3
28284,6,2,99108,99108,99110,0,2,3
28285,1,2,99109,99110,99112,1,3,0
28286,2,1,99111,99112,99113,1,2,0
28287,5,3,99116,99116,99119,0,3,3
28288,3,2,99119,99119,99121,0,2,0
28289,5,2,99124,99124,99126,0,2,3
28290,4,3,99128,99128,99131,0,3,2
28291,2,3,99130,99131,99134,1,4,0
28292,2,3,99132,99134,99137,2,5,0
28293,4,2,99136,99137,99139,1,3,0
28294,6,1,99142,99142,99143,0,1,3
28295,3,1,99145,99145,99146,0,1,2
28296,6,3,99151,99151,99154,0,3,5
28297,4,1,99155,99155,99156,0,1,1
28298,2,3,99157,99157,99160,0,3,1
28299,6,2,99163,99163,99165,0,2,3
28300,2,2,99165,99165,99167,0,2,0
28301,1,1,99166,99167,99168,1,2,0
28302,1,2,99167,99168,99170,1,3,0
28303,2,3,99169,99170,99173,1,4,0
28304,1,1,99170,99173,99174,3,4,0
28305,3,2,99173,99174,99176,1,3,0
28306,6,1,99179,99179,99180,0,1,3
28307,5,2,99184,99184,99186,0,2,4
28308,6,3,99190,99190,99193,0,3,4
28309,1,1,99191,99193,99194,2,3,0
28310,5,2,99196,99196,99198,0,2,2
28311,3,3,99199,99199,99202,0,3,1
28312,4,2,99203,99203,99205,0,2,1
28313,3,3,99206,99206,99209,0,3,1
28314,3,1,99209,99209,99210,0,1,0
28315,1,3,99210,99210,99213,0,3,0
28316,2,1,99212,99213,99214,1,2,0
28317,5,3,99217,99217,99220,0,3,3
28318,1,3,99218,99220,99223,2,5,0
28319,6,3,99224,99224,99227,0,3,1
28320,6,1,99230,99230,99231,0,1,3
28321,1,3,99231,99231,99234,0,3,0
28322,1,3,99232,99234,99237,2,5,0
28323,2,2,99234,99237,99239,3,5,0
28324,3,3,99237,99239,99242,2,5,0
28325,2,3,99239,99242,99245,3,6,0
28326,4,1,99243,99245,99246,2,3,0
28327,3,2,99246,99246,99248,0,2,0
28328,2,1,99248,99248,99249,0,1,0
28329,2,3,99250,99250,99253,0,3,1
28330,3,3,99253,99253,99256,0,3,0
28331,5,2,99258,99258,99260,0,2,2
28332,2,1,99260,99260,99261,0,1,0
28333,6,3,99266,99266,99269,0,3,5
28334,2,3,99268,99269,99272,1,4,0
28335,2,1,99270,99272,99273,2,3,0
28336,3,2,99273,99273,99275,0,2,0
28337,1,2,99274,99275,99277,1,3,0
28338,2,1,99276,99277,99278,1,2,0
28339,5,2,99281,99281,99283,0,2,3
28340,1,1,99282,99283,99284,1,2,0
28341,3,1,99285,99285,99286,0,1,1
28342,2,3,99287,99287,99290,0,3,1
28343,4,2,99291,99291,99293,0,2,1
28344,1,1,99292,99293,99294,1,2,0
28345,6,1,99298,99298,99299,0,1,4
28346,5,1,99303,99303,99304,0,1,4
28347,1,2,99304,99304,99306,0,2,0
28348,1,1,99305,99306,99307,1,2,0
28349,6,1,99311,99311,99312,0,1,4
28350,5,1,99316,99316,99317,0,1,4
28351,6,3,99322,99322,99325,0,3,5
28352,6,1,99328,99328,99329,0,1,3
28353,5,1,99333,99333,99334,0,1,4
28354,1,2,99334,99334,99336,0,2,0
28355,5,2,99339,99339,99341,0,2,3
28356,2,2,99341,99341,99343,0,2,0
28357,6,1,99347,99347,99348,0,1,4
28358,4,1,99351,99351,99352,0,1,3
28359,4,1,99355,99355,99356,0,1,3
28360,5,3,99360,99360,99363,0,3,4
28361,1,2,99361,99363,99365,2,4,0
28362,6,3,99367,99367,99370,0,3,2
28363,1,2,99368,99370,99372,2,4,0
28364,1,2,99369,99372,99374,3,5,0
28365,3,3,99372,99374,99377,2,5,0
28366,1,2,99373,99377,99379,4,6,0
28367,6,1,99379,99379,99380,0,1,0
28368,5,1,99384,99384,99385,0,1,4
28369,2,2,99386,99386,99388,0,2,1
28370,3,1,99389,99389,99390,0,1,1
28371,4,2,99393,99393,99395,0,2,3
28372,5,2,99398,99398,99400,0,2,3
28373,2,1,99400,99400,99401,0,1,0
28374,1,1,99401,99401,99402,0,1,0
28375,5,3,99406,99406,99409,0,3,4
28376,4,3,99410,99410,99413,0,3,1
28377,6,1,99416,99416,99417,0,1,3
28378,6,1,99422,99422,99423,0,1,5
28379,3,3,99425,99425,99428,0,3,2
28380,1,3,99426,99428,99431,2,5,0
28381,6,2,99432,99432,99434,0,2,1
28382,2,3,99434,99434,99437,0,3,0
28383,4,1,99438,99438,99439,0,1,1
28384,5,1,99443,99443,99444,0,1,4
28385,1,3,99444,99444,99447,0,3,0
28386,3,2,99447,99447,99449,0,2,0
28387,6,3,99453,99453,99456,0,3,4
28388,3,1,99456,99456,99457,0,1,0
28389,4,1,99460,99460,99461,0,1,3
28390,1,1,99461,99461,99462,0,1,0
28391,1,1,99462,99462,99463,0,1,0
28392,2,3,99464,99464,99467,0,3,1
28393,5,1,99469,99469,99470,0,1,2
28394,5,2,99474,99474,99476,0,2,4
28395,6,2,99480,99480,99482,0,2,4
28396,6,1,99486,99486,99487,0,1,4
28397,6,3,99492,99492,99495,0,3,5
28398,5,1,99497,99497,99498,0,1,2
28399,3,1,99500,99500,99501,0,1,2
28400,6,2,99506,99506,99508,0,2,5
28401,2,2,99508,99508,99510,0,2,0
28402,3,2,99511,99511,99513,0,2,1
28403,4,1,99515,99515,99516,0,1,2
28404,3,2,99518,99518,99520,0,2,2
28405,1,2,99519,99520,99522,1,3,0
28406,2,1,99521,99522,99523,1,2,0
28407,2,3,99523,99523,99526,0,3,0
28408,5,3,99528,99528,99531,0,3,2
28409,6,1,99534,99534,99535,0,1,3
28410,4,3,99538,99538,99541,0,3,3
28411,6,1,99544,99544,99545,0,1,3
28412,5,2,99549,99549,99551,0,2,4
28413,2,3,99551,99551,99554,0,3,0
28414,5,3,99556,99556,99559,0,3,2
28415,5,3,99561,99561,99564,0,3,2
28416,6,3,99567,99567,99570,0,3,3
28417,4,1,99571,99571,99572,0,1,1
28418,1,3,99572,99572,99575,0,3,0
28419,6,2,99578,99578,99580,0,2,3
28420,1,1,99579,99580,99581,1,2,0
28421,6,1,99585,99585,99586,0,1,4
28422,4,2,99589,99589,99591,0,2,3
28423,3,1,99592,99592,99593,0,1,1
28424,5,2,99597,99597,99599,0,2,4
28425,6,2,99603,99603,99605,0,2,4
28426,6,1,99609,99609,99610,0,1,4
28427,6,1,99615,99615,99616,0,1,5
28428,6,3,99621,99621,99624,0,3,5
28429,1,2,99622,99624,99626,2,4,0
28430,4,3,99626,99626,99629,0,3,0
28431,1,3,99627,99629,99632,2,5,0
28432,2,3,99629,99632,99635,3,6,0
28433,5,3,99634,99635,99638,1,4,0
28434,6,2,99640,99640,99642,0,2,2
28435,2,2,99642,99642,99644,0,2,0
28436,1,3,99643,99644,99647,1,4,0
28437,1,1,99644,99647,99648,3,4,0
28438,3,2,99647,99648,99650,1,3,0
28439,1,1,99648,99650,99651,2,3,0
28440,4,3,99652,99652,99655,0,3,1
28441,2,1,99654,99655,99656,1,2,0
28442,2,1,99656,99656,99657,0,1,0
28443,5,2,99661,99661,99663,0,2,4
28444,6,1,99667,99667,99668,0,1,4
28445,3,3,99670,99670,99673,0,3,2
28446,6,3,99676,99676,99679,0,3,3
28447,5,1,99681,99681,99682,0,1,2
28448,3,3,99684,99684,99687,0,3,2
28449,6,2,99690,99690,99692,0,2,3
28450,2,3,99692,99692,99695,0,3,0
28451,3,2,99695,99695,99697,0,2,0
28452,3,3,99698,99698,99701,0,3,1
28453,5,2,99703,99703,99705,0,2,2
28454,5,2,99708,99708,99710,0,2,3
28455,2,3,99710,99710,99713,0,3,0
28456,1,2,99711,99713,99715,2,4,0
28457,2,2,99713,99715,99717,2,4,0
28458,1,1,99714,99717,99718,3,4,0
28459,2,1,99716,99718,99719,2,3,0
28460,1,2,99717,99719,99721,2,4,0
28461,3,3,99720,99721,99724,1,4,0
28462,3,3,99723,99724,99727,1,4,0
28463,2,1,99725,99727,99728,2,3,0
28464,2,3,99727,99728,99731,1,4,0
28465,4,2,99731,99731,99733,0,2,0
28466,3,3,99734,99734,99737,0,3,1
28467,2,3,99736,99737,99740,1,4,0
28468,1,1,99737,99740,99741,3,4,0
28469,3,3,99740,99741,99744,1,4,0
28470,2,2,99742,99744,99746,2,4,0
28471,1,2,99743,99746,99748,3,5,0
28472,2,3,99745,99748,99751,3,6,0
28473,2,1,99747,99751,99752,4,5,0
28474,4,3,99751,99752,99755,1,4,0
28475,5,3,99756,99756,99759,0,3,1
28476,4,3,99760,99760,99763,0,3,1
28477,1,2,99761,99763,99765,2,4,0
28478,2,1,99763,99765,99766,2,3,0
28479,2,1,99765,99766,99767,1,2,0
28480,3,1,99768,99768,99769,0,1,1
28481,1,3,99769,99769,99772,0,3,0
28482,4,3,99773,99773,99776,0,3,1
28483,6,3,99779,99779,99782,0,3,3
28484,6,2,99785,99785,99787,0,2,3
28485,2,1,99787,99787,99788,0,1,0
28486,5,2,99792,99792,99794,0,2,4
28487,5,1,99797,99797,99798,0,1,3
28488,1,2,99798,99798,99800,0,2,0
28489,5,3,99803,99803,99806,0,3,3
28490,3,2,99806,99806,99808,0,2,0
28491,5,3,99811,99811,99814,0,3,3
28492,1,2,99812,99814,99816,2,4,0
28493,3,3,99815,99816,99819,1,4,0
28494,1,1,99816,99819,99820,3,4,0
28495,4,3,99820,99820,99823,0,3,0
28496,3,1,99823,99823,99824,0,1,0
28497,2,1,99825,99825,99826,0,1,1
28498,4,3,99829,99829,99832,0,3,3
28499,3,2,99832,99832,99834,0,2,0
28500,3,3,99835,99835,99838,0,3,1
28501,4,2,99839,99839,99841,0,2,1
28502,2,3,99841,99841,99844,0,3,0
28503,4,1,99845,99845,99846,0,1,1
28504,5,2,99850,99850,99852,0,2,4
28505,3,1,99853,99853,99854,0,1,1
28506,6,2,99859,99859,99861,0,2,5
28507,5,2,99864,99864,99866,0,2,3
28508,2,2,99866,99866,99868,0,2,0
28509,4,3,99870,99870,99873,0,3,2
28510,4,3,99874,99874,99877,0,3,1
28511,1,1,99875,99877,99878,2,3,0
28512,1,2,99876,99878,99880,2,4,0
28513,1,2,99877,99880,99882,3,5,0
28514,4,1,99881,99882,99883,1,2,0
28515,4,3,99885,99885,99888,0,3,2
28516,5,3,99890,99890,99893,0,3,2
28517,3,3,99893,99893,99896,0,3,0
28518,6,3,99899,99899,99902,0,3,3
28519,4,1,99903,99903,99904,0,1,1
28520,5,3,99908,99908,99911,0,3,4
28521,3,2,99911,99911,99913,0,2,0
28522,3,3,99914,99914,99917,0,3,1
28523,3,1,99917,99917,99918,0,1,0
28524,3,2,99920,99920,99922,0,2,2
28525,2,1,99922,99922,99923,0,1,0
28526,1,1,99923,99923,99924,0,1,0
28527,2,3,99925,99925,99928,0,3,1
28528,5,2,99930,99930,99932,0,2,2
28529,2,3,99932,99932,99935,0,3,0
28530,2,3,99934,99935,99938,1,4,0
28531,4,3,99938,99938,99941,0,3,0
28532,3,3,99941,99941,99944,0,3,0
28533,1,2,99942,99944,99946,2,4,0
28534,3,2,99945,99946,99948,1,3,0
28535,6,3,99951,99951,99954,0,3,3
28536,1,2,99952,99954,99956,2,4,0
28537,2,1,99954,99956,99957,2,3,0
28538,5,2,99959,99959,99961,0,2,2
28539,1,3,99960,99961,99964,1,4,0
28540,1,1,99961,99964,99965,3,4,0
28541,4,3,99965,99965,99968,0,3,0
28542,3,3,99968,99968,99971,0,3,0
28543,4,3,99972,99972,99975,0,3,1
28544,4,1,99976,99976,99977,0,1,1
28545,2,1,99978,99978,99979,0,1,1
28546,3,2,99981,99981,99983,0,2,2
28547,3,2,99984,99984,99986,0,2,1
28548,5,1,99989,99989,99990,0,1,3
28549,3,3,99992,99992,99995,0,3,2
28550,4,3,99996,99996,99999,0,3,1
28551,4,3,100000,100000,100003,0,3,1
28552,4,1,100004,100004,100005,0,1,1
28553,1,1,100005,100005,100006,0,1,0
28554,3,1,100008,100008,100009,0,1,2
28555,3,2,100011,100011,100013,0,2,2
28556,4,2,100015,100015,100017,0,2,2
28557,1,2,100016,100017,100019,1,3,0
28558,6,3,100022,100022,100025,0,3,3
28559,2,3,100024,100025,100028,1,4,0
28560,5,3,100029,100029,100032,0,3,1
28561,4,3,100033,100033,100036,0,3,1
28562,1,2,100034,100036,100038,2,4,0
28563,4,2,100038,100038,100040,0,2,0
28564,1,2,100039,100040,100042,1,3,0
28565,4,1,100043,100043,100044,0,1,1
28566,3,2,100046,100046,100048,0,2,2
28567,4,3,100050,100050,100053,0,3,2
28568,5,3,100055,100055,100058,0,3,2
28569,5,3,100060,100060,100063,0,3,2
28570,3,1,100063,100063,100064,0,1,0
28571,1,2,100064,100064,100066,0,2,0
28572,1,2,100065,100066,100068,1,3,0
28573,1,3,100066,100068,100071,2,5,0
28574,4,3,100070,100071,100074,1,4,0
28575,2,1,100072,100074,100075,2,3,0
28576,1,3,100073,100075,100078,2,5,0
28577,1,3,100074,100078,100081,4,7,0
28578,5,3,100079,100081,100084,2,5,0
28579,5,3,100084,100084,100087,0,3,0
28580,6,2,100090,100090,100092,0,2,3
28581,4,2,100094,100094,100096,0,2,2
28582,2,2,100096,100096,100098,0,2,0
28583,1,1,100097,100098,100099,1,2,0
28584,6,3,100103,100103,100106,0,3,4
28585,3,1,100106,100106,100107,0,1,0
28586,6,1,100112,100112,100113,0,1,5
28587,5,3,100117,100117,100120,0,3,4
28588,3,1,100120,100120,100121,0,1,0
28589,6,3,100126,100126,100129,0,3,5
28590,4,1,100130,100130,100131,0,1,1
28591,1,2,100131,100131,100133,0,2,0
28592,3,3,100134,100134,100137,0,3,1
28593,2,1,100136,100137,100138,1,2,0
28594,5,1,100141,100141,100142,0,1,3
28595,1,2,100142,100142,100144,0,2,0
28596,3,3,100145,100145,100148,0,3,1
28597,2,3,100147,100148,100151,1,4,0
28598,1,1,100148,100151,100152,3,4,0
28599,5,2,100153,100153,100155,0,2,1
28600,1,1,100154,100155,100156,1,2,0
28601,2,2,100156,100156,100158,0,2,0
28602,6,1,100162,100162,100163,0,1,4
28603,5,2,100167,100167,100169,0,2,4
28604,4,3,100171,100171,100174,0,3,2
28605,6,3,100177,100177,100180,0,3,3
28606,1,3,100178,100180,100183,2,5,0
28607,4,3,100182,100183,100186,1,4,0
28608,1,1,100183,100186,100187,3,4,0
28609,6,2,100189,100189,100191,0,2,2
28610,5,3,100194,100194,100197,0,3,3
28611,3,3,100197,100197,100200,0,3,0
28612,6,1,100203,100203,100204,0,1,3
28613,6,1,100209,100209,100210,0,1,5
28614,6,1,100215,100215,100216,0,1,5
28615,3,3,100218,100218,100221,0,3,2
28616,4,3,100222,100222,100225,0,3,1
28617,4,1,100226,100226,100227,0,1,1
28618,2,2,100228,100228,100230,0,2,1
28619,6,2,100234,100234,100236,0,2,4
28620,3,3,100237,100237,100240,0,3,1
28621,3,1,100240,100240,100241,0,1,0
28622,4,2,100244,100244,100246,0,2,3
28623,5,3,100249,100249,100252,0,3,3
28624,2,1,100251,100252,100253,1,2,0
28625,1,2,100252,100253,100255,1,3,0
28626,4,3,100256,100256,100259,0,3,1
28627,4,2,100260,100260,100262,0,2,1
28628,2,2,100262,100262,100264,0,2,0
28629,4,1,100266,100266,100267,0,1,2
28630,6,3,100272,100272,100275,0,3,5
28631,4,2,100276,100276,100278,0,2,1
28632,4,3,100280,100280,100283,0,3,2
28633,4,1,100284,100284,100285,0,1,1
28634,3,3,100287,100287,100290,0,3,2
28635,3,2,100290,100290,100292,0,2,0
28636,4,2,100294,100294,100296,0,2,2
28637,1,1,100295,100296,100297,1,2,0
28638,1,1,100296,100297,100298,1,2,0
28639,5,3,100301,100301,100304,0,3,3
28640,3,2,100304,100304,100306,0,2,0
28641,1,2,100305,100306,100308,1,3,0
28642,6,2,100311,100311,100313,0,2,3
28643,1,3,100312,100313,100316,1,4,0
28644,3,3,100315,100316,100319,1,4,0
28645,3,2,100318,100319,100321,1,3,0
28646,1,3,100319,100321,100324,2,5,0
28647,3,2,100322,100324,100326,2,4,0
28648,2,3,100324,100326,100329,2,5,0
28649,4,3,100328,100329,100332,1,4,0
28650,2,3,100330,100332,100335,2,5,0
28651,2,2,100332,100335,100337,3,5,0
28652,2,2,100334,100337,100339,3,5,0
28653,1,1,100335,100339,100340,4,5,0
28654,2,2,100337,100340,100342,3,5,0
28655,6,3,100343,100343,100346,0,3,1
28656,1,1,100344,100346,100347,2,3,0
28657,6,1,100350,100350,100351,0,1,3
28658,6,1,100356,100356,100357,0,1,5
28659,6,1,100362,100362,100363,0,1,5
28660,5,2,100367,100367,100369,0,2,4
28661,3,1,100370,100370,100371,0,1,1
28662,5,2,100375,100375,100377,0,2,4
28663,5,3,100380,100380,100383,0,3,3
28664,5,2,100385,100385,100387,0,2,2
28665,6,1,100391,100391,100392,0,1,4
28666,5,1,100396,100396,100397,0,1,4
28667,4,1,100400,100400,100401,0,1,3
28668,6,2,100406,100406,100408,0,2,5
28669,1,2,100407,100408,100410,1,3,0
28670,1,2,100408,100410,100412,2,4,0
28671,4,1,100412,100412,100413,0,1,0
28672,4,3,100416,100416,100419,0,3,3
28673,2,2,100418,100419,100421,1,3,0
28674,6,1,100424,100424,100425,0,1,3
28675,6,1,100430,100430,100431,0,1,5
28676,4,3,100434,100434,100437,0,3,3
28677,4,2,100438,100438,100440,0,2,1
28678,2,2,100440,100440,100442,0,2,0
28679,6,1,100446,100446,100447,0,1,4
28680,6,1,100452,100452,100453,0,1,5
28681,6,2,100458,100458,100460,0,2,5
28682,3,2,100461,100461,100463,0,2,1
28683,4,2,100465,100465,100467,0,2,2
28684,5,1,100470,100470,100471,0,1,3
28685,1,1,100471,100471,100472,0,1,0
28686,6,3,100477,100477,100480,0,3,5
28687,2,1,100479,100480,100481,1,2,0
28688,6,3,100485,100485,100488,0,3,4
28689,2,1,100487,100488,100489,1,2,0
28690,5,3,100492,100492,100495,0,3,3
28691,6,1,100498,100498,100499,0,1,3
28692,3,1,100501,100501,100502,0,1,2
28693,6,2,100507,100507,100509,0,2,5
28694,5,2,100512,100512,100514,0,2,3
28695,1,2,100513,100514,100516,1,3,0
28696,4,3,100517,100517,100520,0,3,1
28697,3,2,100520,100520,100522,0,2,0
28698,2,2,100522,100522,100524,0,2,0
28699,4,3,100526,100526,100529,0,3,2
28700,3,1,100529,100529,100530,0,1,0
28701,2,1,100531,100531,100532,0,1,1
28702,3,3,100534,100534,100537,0,3,2
28703,1,2,100535,100537,100539,2,4,0
28704,1,3,100536,100539,100542,3,6,0
28705,5,1,100541,100542,100543,1,2,0
28706,4,1,100545,100545,100546,0,1,2
28707,5,2,100550,100550,100552,0,2,4
28708,3,3,100553,100553,100556,0,3,1
28709,2,3,100555,100556,100559,1,4,0
28710,5,3,100560,100560,100563,0,3,1
28711,1,2,100561,100563,100565,2,4,0
28712,6,1,100567,100567,100568,0,1,2
28713,5,3,100572,100572,100575,0,3,4
28714,5,1,100577,100577,100578,0,1,2
28715,1,1,100578,100578,100579,0,1,0
28716,2,1,100580,100580,100581,0,1,1
28717,4,2,100584,100584,100586,0,2,3
28718,4,1,100588,100588,100589,0,1,2
28719,3,3,100591,100591,100594,0,3,2
28720,6,3,100597,100597,100600,0,3,3
28721,6,3,100603,100603,100606,0,3,3
28722,5,1,100608,100608,100609,0,1,2
28723,5,1,100613,100613,100614,0,1,4
28724,3,2,100616,100616,100618,0,2,2
28725,5,3,100621,100621,100624,0,3,3
28726,2,1,100623,100624,100625,1,2,0
28727,6,2,100629,100629,100631,0,2,4
28728,3,3,100632,100632,100635,0,3,1
28729,1,2,100633,100635,100637,2,4,0
28730,3,2,100636,100637,100639,1,3,0
28731,3,3,100639,100639,100642,0,3,0
28732,3,1,100642,100642,100643,0,1,0
28733,5,1,100647,100647,100648,0,1,4
28734,6,1,100653,100653,100654,0,1,5
28735,5,1,100658,100658,100659,0,1,4
28736,5,2,100663,100663,100665,0,2,4
28737,1,3,100664,100665,100668,1,4,0
28738,5,3,100669,100669,100672,0,3,1
28739,1,1,100670,100672,100673,2,3,0
28740,3,2,100673,100673,100675,0,2,0
28741,2,1,100675,100675,100676,0,1,0
28742,4,2,100679,100679,100681,0,2,3
28743,5,1,100684,100684,100685,0,1,3
28744,1,1,100685,100685,100686,0,1,0
28745,2,1,100687,100687,100688,0,1,1
28746,5,2,100692,100692,100694,0,2,4
28747,4,3,100696,100696,100699,0,3,2
28748,4,1,100700,100700,100701,0,1,1
28749,5,1,100705,100705,100706,0,1,4
28750,6,1,100711,100711,100712,0,1,5
28751,3,2,100714,100714,100716,0,2,2
28752,1,3,100715,100716,100719,1,4,0
28753,3,3,100718,100719,100722,1,4,0
28754,1,3,100719,100722,100725,3,6,0
28755,2,1,100721,100725,100726,4,5,0
28756,1,2,100722,100726,100728,4,6,0
28757,4,1,100726,100728,100729,2,3,0
28758,4,2,100730,100730,100732,0,2,1
28759,6,1,100736,100736,100737,0,1,4
28760,5,1,100741,100741,100742,0,1,4
28761,4,3,100745,100745,100748,0,3,3
28762,6,3,100751,100751,100754,0,3,3
28763,2,3,100753,100754,100757,1,4,0
28764,3,3,100756,100757,100760,1,4,0
28765,1,3,100757,100760,100763,3,6,0
28766,4,3,100761,100763,100766,2,5,0
28767,6,1,100767,100767,100768,0,1,1
28768,2,1,100769,100769,100770,0,1,1
28769,6,3,100775,100775,100778,0,3,5
28770,3,2,100778,100778,100780,0,2,0
28771,1,3,100779,100780,100783,1,4,0
28772,4,2,100783,100783,100785,0,2,0
28773,2,2,100785,100785,100787,0,2,0
28774,1,2,100786,100787,100789,1,3,0
28775,5,2,100791,100791,100793,0,2,2
28776,6,3,100797,100797,100800,0,3,4
28777,1,2,100798,100800,100802,2,4,0
28778,1,2,100799,100802,100804,3,5,0
28779,6,2,100805,100805,100807,0,2,1
28780,3,2,100808,100808,100810,0,2,1
28781,4,1,100812,100812,100813,0,1,2
28782,6,1,100818,100818,100819,0,1,5
28783,3,1,100821,100821,100822,0,1,2
28784,5,2,100826,100826,100828,0,2,4
28785,6,3,100832,100832,100835,0,3,4
28786,3,2,100835,100835,100837,0,2,0
28787,6,2,100841,100841,100843,0,2,4
28788,2,1,100843,100843,100844,0,1,0
28789,1,3,100844,100844,100847,0,3,0
28790,1,3,100845,100847,100850,2,5,0
28791,6,2,100851,100851,100853,0,2,1
28792,6,2,100857,100857,100859,0,2,4
28793,6,1,100863,100863,100864,0,1,4
28794,3,1,100866,100866,100867,0,1,2
28795,1,2,100867,100867,100869,0,2,0
28796,5,1,100872,100872,100873,0,1,3
28797,1,3,100873,100873,100876,0,3,0
28798,3,1,100876,100876,100877,0,1,0
28799,6,2,100882,100882,100884,0,2,5
28800,2,2,100884,100884,100886,0,2,0
28801,2,3,100886,100886,100889,0,3,0
28802,3,3,100889,100889,100892,0,3,0
28803,3,3,100892,100892,100895,0,3,0
28804,6,1,100898,100898,100899,0,1,3
28805,3,2,100901,100901,100903,0,2,2
28806,1,3,100902,100903,100906,1,4,0
28807,2,3,100904,100906,100909,2,5,0
28808,2,2,100906,100909,100911,3,5,0
28809,6,2,100912,100912,100914,0,2,1
28810,4,1,100916,100916,100917,0,1,2
28811,2,2,100918,100918,100920,0,2,1
28812,2,3,100920,100920,100923,0,3,0
28813,5,2,100925,100925,100927,0,2,2
28814,3,2,100928,100928,100930,0,2,1
28815,1,2,100929,100930,100932,1,3,0
28816,4,1,100933,100933,100934,0,1,1
28817,4,3,100937,100937,100940,0,3,3
28818,4,3,100941,100941,100944,0,3,1
28819,3,2,100944,100944,100946,0,2,0
28820,4,1,100948,100948,100949,0,1,2
28821,6,1,100954,100954,100955,0,1,5
28822,6,1,100960,100960,100961,0,1,5
28823,2,2,100962,100962,100964,0,2,1
28824,5,2,100967,100967,100969,0,2,3
28825,6,3,100973,100973,100976,0,3,4
28826,5,1,100978,100978,100979,0,1,2
28827,5,3,100983,100983,100986,0,3,4
28828,5,2,100988,100988,100990,0,2,2
28829,6,1,100994,100994,100995,0,1,4
28830,1,1,100995,100995,100996,0,1,0
28831,3,3,100998,100998,101001,0,3,2
28832,4,3,101002,101002,101005,0,3,1
28833,6,1,101008,101008,101009,0,1,3
28834,6,1,101014,101014,101015,0,1,5
28835,5,1,101019,101019,101020,0,1,4
28836,5,1,101024,101024,101025,0,1,4
28837,4,1,101028,101028,101029,0,1,3
28838,4,3,101032,101032,101035,0,3,3
28839,2,1,101034,101035,101036,1,2,0
28840,6,1,101040,101040,101041,0,1,4
28841,1,1,101041,101041,101042,0,1,0
28842,4,3,101045,101045,101048,0,3,3
28843,5,3,101050,101050,101053,0,3,2
28844,6,2,101056,101056,101058,0,2,3
28845,4,3,101060,101060,101063,0,3,2
28846,4,3,101064,101064,101067,0,3,1
28847,1,1,101065,101067,101068,2,3,0
28848,2,1,101067,101068,101069,1,2,0
28849,6,1,101073,101073,101074,0,1,4
28850,1,2,101074,101074,101076,0,2,0
28851,3,2,101077,101077,101079,0,2,1
28852,3,3,101080,101080,101083,0,3,1
28853,4,2,101084,101084,101086,0,2,1
28854,4,2,101088,101088,101090,0,2,2
28855,1,1,101089,101090,101091,1,2,0
28856,3,2,101092,101092,101094,0,2,1
28857,2,2,101094,101094,101096,0,2,0
28858,6,3,101100,101100,101103,0,3,4
28859,2,1,101102,101103,101104,1,2,0
28860,4,2,101106,101106,101108,0,2,2
28861,3,2,101109,101109,101111,0,2,1
28862,1,3,101110,101111,101114,1,4,0
28863,4,2,101114,101114,101116,0,2,0
28864,5,2,101119,101119,101121,0,2,3
28865,3,2,101122,101122,101124,0,2,1
28866,5,2,101127,101127,101129,0,2,3
28867,6,2,101133,101133,101135,0,2,4
28868,2,2,101135,101135,101137,0,2,0
28869,1,1,101136,101137,101138,1,2,0
28870,1,3,101137,101138,101141,1,4,0
28871,4,1,101141,101141,101142,0,1,0
28872,4,1,101145,101145,101146,0,1,3
28873,6,3,101151,101151,101154,0,3,5
28874,5,3,101156,101156,101159,0,3,2
28875,2,2,101158,101159,101161,1,3,0
28876,5,2,101163,101163,101165,0,2,2
28877,3,1,101166,101166,101167,0,1,1
28878,1,3,101167,101167,101170,0,3,0
28879,6,3,101173,101173,101176,0,3,3
28880,6,2,101179,101179,101181,0,2,3
28881,2,2,101181,101181,101183,0,2,0
28882,4,2,101185,101185,101187,0,2,2
28883,3,2,101188,101188,101190,0,2,1
28884,3,3,101191,101191,101194,0,3,1
28885,2,1,101193,101194,101195,1,2,0
28886,4,1,101197,101197,101198,0,1,2
28887,2,2,101199,101199,101201,0,2,1
28888,3,3,101202,101202,101205,0,3,1
28889,3,1,101205,101205,101206,0,1,0
28890,2,1,101207,101207,101208,0,1,1
28891,3,2,101210,101210,101212,0,2,2
28892,5,2,101215,101215,101217,0,2,3
28893,2,3,101217,101217,101220,0,3,0
28894,3,2,101220,101220,101222,0,2,0
28895,4,3,101224,101224,101227,0,3,2
28896,3,1,101227,101227,101228,0,1,0
28897,4,2,101231,101231,101233,0,2,3
28898,1,1,101232,101233,101234,1,2,0
28899,3,2,101235,101235,101237,0,2,1
28900,1,2,101236,101237,101239,1,3,0
28901,2,2,101238,101239,101241,1,3,0
28902,5,2,101243,101243,101245,0,2,2
28903,2,1,101245,101245,101246,0,1,0
28904,5,2,101250,101250,101252,0,2,4
28905,5,1,101255,101255,101256,0,1,3
28906,4,1,101259,101259,101260,0,1,3
28907,3,3,101262,101262,101265,0,3,2
28908,4,1,101266,101266,101267,0,1,1
28909,5,2,101271,101271,101273,0,2,4
28910,5,3,101276,101276,101279,0,3,3
28911,6,2,101282,101282,101284,0,2,3
28912,5,1,101287,101287,101288,0,1,3
28913,6,3,101293,101293,101296,0,3,5
28914,3,1,101296,101296,101297,0,1,0
28915,2,3,101298,101298,101301,0,3,1
28916,1,2,101299,101301,101303,2,4,0
28917,4,1,101303,101303,101304,0,1,0
28918,3,2,101306,101306,101308,0,2,2
28919,4,3,101310,101310,101313,0,3,2
28920,6,3,101316,101316,101319,0,3,3
28921,3,1,101319,101319,101320,0,1,0
28922,5,1,101324,101324,101325,0,1,4
28923,2,3,101326,101326,101329,0,3,1
28924,5,2,101331,101331,101333,0,2,2
28925,4,2,101335,101335,101337,0,2,2
28926,3,2,101338,101338,101340,0,2,1
28927,1,1,101339,101340,101341,1,2,0
28928,5,2,101344,101344,101346,0,2,3
28929,5,3,101349,101349,101352,0,3,3
28930,6,2,101355,101355,101357,0,2,3
28931,5,1,101360,101360,101361,0,1,3
28932,3,2,101363,101363,101365,0,2,2
28933,2,3,101365,101365,101368,0,3,0
28934,3,3,101368,101368,101371,0,3,0
28935,2,1,101370,101371,101372,1,2,0
28936,1,1,101371,101372,101373,1,2,0
28937,3,3,101374,101374,101377,0,3,1
28938,4,3,101378,101378,101381,0,3,1
28939,1,3,101379,101381,101384,2,5,0
28940,2,2,101381,101384,101386,3,5,0
28941,5,2,101386,101386,101388,0,2,0
28942,5,1,101391,101391,101392,0,1,3
28943,6,3,101397,101397,101400,0,3,5
28944,4,3,101401,101401,101404,0,3,1
28945,6,1,101407,101407,101408,0,1,3
28946,2,3,101409,101409,101412,0,3,1
28947,2,1,101411,101412,101413,1,2,0
28948,2,1,101413,101413,101414,0,1,0
28949,5,3,101418,101418,101421,0,3,4
28950,2,1,101420,101421,101422,1,2,0
28951,2,1,101422,101422,101423,0,1,0
28952,5,3,101427,101427,101430,0,3,4
28953,5,1,101432,101432,101433,0,1,2
28954,3,3,101435,101435,101438,0,3,2
28955,3,2,101438,101438,101440,0,2,0
28956,3,3,101441,101441,101444,0,3,1
28957,3,2,101444,101444,101446,0,2,0
28958,6,3,101450,101450,101453,0,3,4
28959,5,1,101455,101455,101456,0,1,2
28960,6,2,101461,101461,101463,0,2,5
28961,6,1,101467,101467,101468,0,1,4
28962,6,2,101473,101473,101475,0,2,5
28963,3,3,101476,101476,101479,0,3,1
28964,3,3,101479,101479,101482,0,3,0
28965,3,3,101482,101482,101485,0,3,0
28966,4,1,101486,101486,101487,0,1,1
28967,6,2,101492,101492,101494,0,2,5
28968,1,1,101493,101494,101495,1,2,0
28969,1,3,101494,101495,101498,1,4,0
28970,2,2,101496,101498,101500,2,4,0
28971,5,2,101501,101501,101503,0,2,1
28972,2,1,101503,101503,101504,0,1,0
28973,5,3,101508,101508,101511,0,3,4
28974,5,2,101513,101513,101515,0,2,2
28975,1,3,101514,101515,101518,1,4,0
28976,5,3,101519,101519,101522,0,3,1
28977,2,2,101521,101522,101524,1,3,0
28978,2,3,101523,101524,101527,1,4,0
28979,6,1,101529,101529,101530,0,1,2
28980,6,3,101535,101535,101538,0,3,5
28981,3,1,101538,101538,101539,0,1,0
28982,5,1,101543,101543,101544,0,1,4
28983,4,2,101547,101547,101549,0,2,3
28984,6,2,101553,101553,101555,0,2,4
28985,3,1,101556,101556,101557,0,1,1
28986,3,1,101559,101559,101560,0,1,2
28987,3,2,101562,101562,101564,0,2,2
28988,5,1,101567,101567,101568,0,1,3
28989,3,1,101570,101570,101571,0,1,2
28990,5,2,101575,101575,101577,0,2,4
28991,5,1,101580,101580,101581,0,1,3
28992,1,1,101581,101581,101582,0,1,0
28993,5,1,101586,101586,101587,0,1,4
28994,5,1,101591,101591,101592,0,1,4
28995,3,1,101594,101594,101595,0,1,2
28996,6,2,101600,101600,101602,0,2,5
28997,1,1,101601,101602,101603,1,2,0
28998,5,3,101606,101606,101609,0,3,3
28999,4,1,101610,101610,101611,0,1,1
29000,1,2,101611,101611,101613,0,2,0
29001,4,3,101615,101615,101618,0,3,2
29002,5,3,101620,101620,101623,0,3,2
29003,6,2,101626,101626,101628,0,2,3
29004,3,2,101629,101629,101631,0,2,1
29005,3,2,101632,101632,101634,0,2,1
29006,6,3,101638,101638,101641,0,3,4
29007,5,2,101643,101643,101645,0,2,2
29008,3,1,101646,101646,101647,0,1,1
29009,1,2,101647,101647,101649,0,2,0
29010,5,3,101652,101652,101655,0,3,3
29011,5,3,101657,101657,101660,0,3,2
29012,4,1,101661,101661,101662,0,1,1
29013,5,1,101666,101666,101667,0,1,4
29014,6,2,101672,101672,101674,0,2,5
29015,4,3,101676,101676,101679,0,3,2
29016,4,3,101680,101680,101683,0,3,1
29017,3,3,101683,101683,101686,0,3,0
29018,3,2,101686,101686,101688,0,2,0
29019,6,3,101692,101692,101695,0,3,4
29020,1,2,101693,101695,101697,2,4,0
29021,2,3,101695,101697,101700,2,5,0
29022,1,3,101696,101700,101703,4,7,0
29023,3,1,101699,101703,101704,4,5,0
29024,5,1,101704,101704,101705,0,1,0
29025,1,1,101705,101705,101706,0,1,0
29026,2,2,101707,101707,101709,0,2,1
29027,4,2,101711,101711,101713,0,2,2
29028,6,3,101717,101717,101720,0,3,4
29029,4,2,101721,101721,101723,0,2,1
29030,5,2,101726,101726,101728,0,2,3
29031,5,2,101731,101731,101733,0,2,3
29032,2,3,101733,101733,101736,0,3,0
29033,2,3,101735,101736,101739,1,4,0
29034,1,1,101736,101739,101740,3,4,0
29035,1,3,101737,101740,101743,3,6,0
29036,2,3,101739,101743,101746,4,7,0
29037,6,2,101745,101746,101748,1,3,0
29038,3,2,101748,101748,101750,0,2,0
29039,2,3,101750,101750,101753,0,3,0
29040,1,2,101751,101753,101755,2,4,0
29041,3,1,101754,101755,101756,1,2,0
29042,5,2,101759,101759,101761,0,2,3
29043,3,3,101762,101762,101765,0,3,1
29044,2,1,101764,101765,101766,1,2,0
29045,6,2,101770,101770,101772,0,2,4
29046,3,1,101773,101773,101774,0,1,1
29047,2,2,101775,101775,101777,0,2,1
29048,1,1,101776,101777,101778,1,2,0
29049,6,1,101782,101782,101783,0,1,4
29050,4,2,101786,101786,101788,0,2,3
29051,2,1,101788,101788,101789,0,1,0
29052,5,2,101793,101793,101795,0,2,4
29053,5,2,101798,101798,101800,0,2,3
29054,1,1,101799,101800,101801,1,2,0
29055,2,3,101801,101801,101804,0,3,0
29056,2,1,101803,101804,101805,1,2,0
29057,5,3,101808,101808,101811,0,3,3
29058,2,3,101810,101811,101814,1,4,0
29059,1,3,101811,101814,101817,3,6,0
29060,2,3,101813,101817,101820,4,7,0
29061,5,1,101818,101820,101821,2,3,0
29062,5,2,101823,101823,101825,0,2,2
29063,4,2,101827,101827,101829,0,2,2
29064,4,1,101831,101831,101832,0,1,2
29065,2,2,101833,101833,101835,0,2,1
29066,5,2,101838,101838,101840,0,2,3
29067,3,1,101841,101841,101842,0,1,1
29068,2,1,101843,101843,101844,0,1,1
29069,6,2,101849,101849,101851,0,2,5
29070,3,3,101852,101852,101855,0,3,1
29071,1,3,101853,101855,101858,2,5,0
29072,1,2,101854,101858,101860,4,6,0
29073,6,2,101860,101860,101862,0,2,0
29074,6,2,101866,101866,101868,0,2,4
29075,4,3,101870,101870,101873,0,3,2
29076,3,1,101873,101873,101874,0,1,0
29077,1,3,101874,101874,101877,0,3,0
29078,1,1,101875,101877,101878,2,3,0
29079,3,2,101878,101878,101880,0,2,0
29080,5,2,101883,101883,101885,0,2,3
29081,1,1,101884,101885,101886,1,2,0
29082,2,3,101886,101886,101889,0,3,0
29083,5,3,101891,101891,101894,0,3,2
29084,5,3,101896,101896,101899,0,3,2
29085,3,2,101899,101899,101901,0,2,0
29086,6,2,101905,101905,101907,0,2,4
29087,6,1,101911,101911,101912,0,1,4
29088,1,1,101912,101912,101913,0,1,0
29089,6,3,101918,101918,101921,0,3,5
29090,3,3,101921,101921,101924,0,3,0
29091,4,3,101925,101925,101928,0,3,1
29092,3,2,101928,101928,101930,0,2,0
29093,2,3,101930,101930,101933,0,3,0
29094,5,3,101935,101935,101938,0,3,2
29095,5,3,101940,101940,101943,0,3,2
29096,2,1,101942,101943,101944,1,2,0
29097,3,2,101945,101945,101947,0,2,1
29098,6,1,101951,101951,101952,0,1,4
29099,2,1,101953,101953,101954,0,1,1
29100,3,1,101956,101956,101957,0,1,2
29101,1,2,101957,101957,101959,0,2,0
29102,6,2,101963,101963,101965,0,2,4
29103,3,3,101966,101966,101969,0,3,1
29104,2,2,101968,101969,101971,1,3,0
29105,6,1,101974,101974,101975,0,1,3
29106,2,2,101976,101976,101978,0,2,1
29107,3,1,101979,101979,101980,0,1,1
29108,5,1,101984,101984,101985,0,1,4
29109,5,2,101989,101989,101991,0,2,4
29110,3,1,101992,101992,101993,0,1,1
29111,4,1,101996,101996,101997,0,1,3
29112,5,2,102001,102001,102003,0,2,4
29113,3,3,102004,102004,102007,0,3,1
29114,2,3,102006,102007,102010,1,4,0
29115,6,3,102012,102012,102015,0,3,2
29116,3,2,102015,102015,102017,0,2,0
29117,4,2,102019,102019,102021,0,2,2
29118,4,3,102023,102023,102026,0,3,2
29119,2,3,102025,102026,102029,1,4,0
29120,6,3,102031,102031,102034,0,3,2
29121,4,1,102035,102035,102036,0,1,1
29122,2,3,102037,102037,102040,0,3,1
29123,4,1,102041,102041,102042,0,1,1
29124,5,2,102046,102046,102048,0,2,4
29125,2,2,102048,102048,102050,0,2,0
29126,4,2,102052,102052,102054,0,2,2
29127,2,3,102054,102054,102057,0,3,0
29128,2,1,102056,102057,102058,1,2,0
29129,3,3,102059,102059,102062,0,3,1
29130,3,3,102062,102062,102065,0,3,0
29131,1,2,102063,102065,102067,2,4,0
29132,6,2,102069,102069,102071,0,2,2
29133,5,3,102074,102074,102077,0,3,3
29134,1,1,102075,102077,102078,2,3,0
29135,4,1,102079,102079,102080,0,1,1
29136,3,2,102082,102082,102084,0,2,2
29137,5,1,102087,102087,102088,0,1,3
29138,6,2,102093,102093,102095,0,2,5
29139,4,2,102097,102097,102099,0,2,2
29140,2,2,102099,102099,102101,0,2,0
29141,6,3,102105,102105,102108,0,3,4
29142,2,2,102107,102108,102110,1,3,0
29143,4,2,102111,102111,102113,0,2,1
29144,2,1,102113,102113,102114,0,1,0
29145,3,3,102116,102116,102119,0,3,2
29146,6,3,102122,102122,102125,0,3,3
29147,2,1,102124,102125,102126,1,2,0
29148,6,2,102130,102130,102132,0,2,4
29149,6,3,102136,102136,102139,0,3,4
29150,6,3,102142,102142,102145,0,3,3
29151,5,2,102147,102147,102149,0,2,2
29152,3,2,102150,102150,102152,0,2,1
29153,5,1,102155,102155,102156,0,1,3
29154,3,3,102158,102158,102161,0,3,2
29155,1,3,102159,102161,102164,2,5,0
29156,5,2,102164,102164,102166,0,2,0
29157,3,1,102167,102167,102168,0,1,1
29158,2,3,102169,102169,102172,0,3,1
29159,6,1,102175,102175,102176,0,1,3
29160,5,3,102180,102180,102183,0,3,4
29161,3,3,102183,102183,102186,0,3,0
29162,1,2,102184,102186,102188,2,4,0
29163,1,2,102185,102188,102190,3,5,0
29164,1,3,102186,102190,102193,4,7,0
29165,2,3,102188,102193,102196,5,8,0
29166,6,2,102194,102196,102198,2,4,0
29167,1,2,102195,102198,102200,3,5,0
29168,1,1,102196,102200,102201,4,5,0
29169,2,3,102198,102201,102204,3,6,0
29170,1,3,102199,102204,102207,5,8,0
29171,1,1,102200,102207,102208,7,8,0
29172,6,2,102206,102208,102210,2,4,0
29173,1,3,102207,102210,102213,3,6,0
29174,3,1,102210,102213,102214,3,4,0
29175,6,2,102216,102216,102218,0,2,2
29176,3,1,102219,102219,102220,0,1,1
29177,1,3,102220,102220,102223,0,3,0
29178,5,2,102225,102225,102227,0,2,2
29179,5,2,102230,102230,102232,0,2,3
29180,6,1,102236,102236,102237,0,1,4
29181,1,2,102237,102237,102239,0,2,0
29182,6,1,102243,102243,102244,0,1,4
29183,3,1,102246,102246,102247,0,1,2
29184,6,2,102252,102252,102254,0,2,5
29185,2,2,102254,102254,102256,0,2,0
29186,5,3,102259,102259,102262,0,3,3
29187,4,2,102263,102263,102265,0,2,1
29188,3,3,102266,102266,102269,0,3,1
29189,5,3,102271,102271,102274,0,3,2
29190,1,1,102272,102274,102275,2,3,0
29191,6,3,102278,102278,102281,0,3,3
29192,1,3,102279,102281,102284,2,5,0
29193,5,3,102284,102284,102287,0,3,0
29194,3,2,102287,102287,102289,0,2,0
29195,6,3,102293,102293,102296,0,3,4
29196,2,1,102295,102296,102297,1,2,0
29197,2,3,102297,102297,102300,0,3,0
29198,1,1,102298,102300,102301,2,3,0
29199,5,3,102303,102303,102306,0,3,2
29200,4,2,102307,102307,102309,0,2,1
29201,1,1,102308,102309,102310,1,2,0
29202,3,2,102311,102311,102313,0,2,1
29203,1,2,102312,102313,102315,1,3,0
29204,3,3,102315,102315,102318,0,3,0
29205,4,1,102319,102319,102320,0,1,1
29206,3,3,102322,102322,102325,0,3,2
29207,6,2,102328,102328,102330,0,2,3
29208,3,1,102331,102331,102332,0,1,1
29209,5,3,102336,102336,102339,0,3,4
29210,2,2,102338,102339,102341,1,3,0
29211,6,3,102344,102344,102347,0,3,3
29212,4,1,102348,102348,102349,0,1,1
29213,2,3,102350,102350,102353,0,3,1
29214,5,3,102355,102355,102358,0,3,2
29215,2,3,102357,102358,102361,1,4,0
29216,1,2,102358,102361,102363,3,5,0
29217,4,3,102362,102363,102366,1,4,0
29218,1,1,102363,102366,102367,3,4,0
29219,4,1,102367,102367,102368,0,1,0
29220,6,3,102373,102373,102376,0,3,5
29221,2,2,102375,102376,102378,1,3,0
29222,4,1,102379,102379,102380,0,1,1
29223,3,3,102382,102382,102385,0,3,2
29224,1,1,102383,102385,102386,2,3,0
29225,4,2,102387,102387,102389,0,2,1
29226,4,2,102391,102391,102393,0,2,2
29227,1,2,102392,102393,102395,1,3,0
29228,4,1,102396,102396,102397,0,1,1
29229,2,1,102398,102398,102399,0,1,1
29230,6,2,102404,102404,102406,0,2,5
29231,1,3,102405,102406,102409,1,4,0
29232,6,1,102411,102411,102412,0,1,2
29233,2,1,102413,102413,102414,0,1,1
29234,5,1,102418,102418,102419,0,1,4
29235,2,1,102420,102420,102421,0,1,1
29236,6,2,102426,102426,102428,0,2,5
29237,6,3,102432,102432,102435,0,3,4
29238,1,3,102433,102435,102438,2,5,0
29239,1,3,102434,102438,102441,4,7,0
29240,3,3,102437,102441,102444,4,7,0
29241,5,1,102442,102444,102445,2,3,0
29242,5,2,102447,102447,102449,0,2,2
29243,6,2,102453,102453,102455,0,2,4
29244,6,2,102459,102459,102461,0,2,4
29245,1,1,102460,102461,102462,1,2,0
29246,2,1,102462,102462,102463,0,1,0
29247,4,3,102466,102466,102469,0,3,3
29248,2,3,102468,102469,102472,1,4,0
29249,6,3,102474,102474,102477,0,3,2
29250,4,2,102478,102478,102480,0,2,1
29251,1,2,102479,102480,102482,1,3,0
29252,3,3,102482,102482,102485,0,3,0
29253,2,1,102484,102485,102486,1,2,0
29254,4,3,102488,102488,102491,0,3,2
29255,6,3,102494,102494,102497,0,3,3
29256,6,2,102500,102500,102502,0,2,3
29257,6,3,102506,102506,102509,0,3,4
29258,6,1,102512,102512,102513,0,1,3
29259,2,1,102514,102514,102515,0,1,1
29260,1,3,102515,102515,102518,0,3,0
29261,5,3,102520,102520,102523,0,3,2
29262,1,3,102521,102523,102526,2,5,0
29263,2,1,102523,102526,102527,3,4,0
29264,4,2,102527,102527,102529,0,2,0
29265,5,2,102532,102532,102534,0,2,3
29266,4,2,102536,102536,102538,0,2,2
29267,4,3,102540,102540,102543,0,3,2
29268,3,1,102543,102543,102544,0,1,0
29269,2,3,102545,102545,102548,0,3,1
29270,6,3,102551,102551,102554,0,3,3
29271,5,1,102556,102556,102557,0,1,2
29272,6,2,102562,102562,102564,0,2,5
29273,5,3,102567,102567,102570,0,3,3
29274,5,1,102572,102572,102573,0,1,2
29275,3,1,102575,102575,102576,0,1,2
29276,1,2,102576,102576,102578,0,2,0
29277,2,2,102578,102578,102580,0,2,0
29278,1,3,102579,102580,102583,1,4,0
29279,2,2,102581,102583,102585,2,4,0
29280,2,3,102583,102585,102588,2,5,0
29281,5,3,102588,102588,102591,0,3,0
29282,5,2,102593,102593,102595,0,2,2
29283,1,2,102594,102595,102597,1,3,0
29284,6,1,102600,102600,102601,0,1,3
29285,2,1,102602,102602,102603,0,1,1
29286,2,2,102604,102604,102606,0,2,1
29287,3,2,102607,102607,102609,0,2,1
29288,3,1,102610,102610,102611,0,1,1
29289,6,3,102616,102616,102619,0,3,5
29290,2,1,102618,102619,102620,1,2,0
29291,1,3,102619,102620,102623,1,4,0
29292,5,3,102624,102624,102627,0,3,1
29293,5,2,102629,102629,102631,0,2,2
29294,6,1,102635,102635,102636,0,1,4
29295,4,1,102639,102639,102640,0,1,3
29296,5,2,102644,102644,102646,0,2,4
29297,5,2,102649,102649,102651,0,2,3
29298,2,3,102651,102651,102654,0,3,0
29299,2,1,102653,102654,102655,1,2,0
29300,2,1,102655,102655,102656,0,1,0
29301,3,3,102658,102658,102661,0,3,2
29302,3,3,102661,102661,102664,0,3,0
29303,5,2,102666,102666,102668,0,2,2
29304,2,1,102668,102668,102669,0,1,0
29305,5,3,102673,102673,102676,0,3,4
29306,2,3,102675,102676,102679,1,4,0
29307,5,2,102680,102680,102682,0,2,1
29308,1,3,102681,102682,102685,1,4,0
29309,2,3,102683,102685,102688,2,5,0
29310,6,1,102689,102689,102690,0,1,1
29311,6,2,102695,102695,102697,0,2,5
29312,3,1,102698,102698,102699,0,1,1
29313,3,1,102701,102701,102702,0,1,2
29314,1,1,102702,102702,102703,0,1,0
29315,1,2,102703,102703,102705,0,2,0
29316,3,1,102706,102706,102707,0,1,1
29317,6,1,102712,102712,102713,0,1,5
29318,1,3,102713,102713,102716,0,3,0
29319,4,1,102717,102717,102718,0,1,1
29320,3,2,102720,102720,102722,0,2,2
29321,6,1,102726,102726,102727,0,1,4
29322,6,1,102732,102732,102733,0,1,5
29323,6,1,102738,102738,102739,0,1,5
29324,4,1,102742,102742,102743,0,1,3
29325,2,2,102744,102744,102746,0,2,1
29326,5,2,102749,102749,102751,0,2,3
29327,2,3,102751,102751,102754,0,3,0
29328,5,3,102756,102756,102759,0,3,2
29329,5,2,102761,102761,102763,0,2,2
29330,5,1,102766,102766,102767,0,1,3
29331,2,1,102768,102768,102769,0,1,1
29332,5,1,102773,102773,102774,0,1,4
29333,3,3,102776,102776,102779,0,3,2
29334,4,2,102780,102780,102782,0,2,1
29335,6,3,102786,102786,102789,0,3,4
29336,4,2,102790,102790,102792,0,2,1
29337,4,1,102794,102794,102795,0,1,2
29338,4,1,102798,102798,102799,0,1,3
29339,6,1,102804,102804,102805,0,1,5
29340,6,3,102810,102810,102813,0,3,5
29341,6,1,102816,102816,102817,0,1,3
29342,1,3,102817,102817,102820,0,3,0
29343,1,3,102818,102820,102823,2,5,0
29344,2,2,102820,102823,102825,3,5,0
29345,4,1,102824,102825,102826,1,2,0
29346,1,1,102825,102826,102827,1,2,0
29347,6,3,102831,102831,102834,0,3,4
29348,5,1,102836,102836,102837,0,1,2
29349,4,1,102840,102840,102841,0,1,3
29350,3,3,102843,102843,102846,0,3,2
29351,5,1,102848,102848,102849,0,1,2
29352,6,2,102854,102854,102856,0,2,5
29353,6,1,102860,102860,102861,0,1,4
29354,1,3,102861,102861,102864,0,3,0
29355,6,1,102867,102867,102868,0,1,3
29356,3,2,102870,102870,102872,0,2,2
29357,1,2,102871,102872,102874,1,3,0
29358,3,3,102874,102874,102877,0,3,0
29359,3,2,102877,102877,102879,0,2,0
29360,4,2,102881,102881,102883,0,2,2
29361,1,3,102882,102883,102886,1,4,0
29362,1,3,102883,102886,102889,3,6,0
29363,3,1,102886,102889,102890,3,4,0
29364,6,2,102892,102892,102894,0,2,2
29365,3,3,102895,102895,102898,0,3,1
29366,2,2,102897,102898,102900,1,3,0
29367,5,3,102902,102902,102905,0,3,2
29368,2,1,102904,102905,102906,1,2,0
29369,1,2,102905,102906,102908,1,3,0
29370,6,3,102911,102911,102914,0,3,3
29371,6,2,102917,102917,102919,0,2,3
29372,4,1,102921,102921,102922,0,1,2
29373,4,1,102925,102925,102926,0,1,3
29374,3,1,102928,102928,102929,0,1,2
29375,5,1,102933,102933,102934,0,1,4
29376,6,1,102939,102939,102940,0,1,5
29377,6,1,102945,102945,102946,0,1,5
29378,5,1,102950,102950,102951,0,1,4
29379,6,3,102956,102956,102959,0,3,5
29380,4,2,102960,102960,102962,0,2,1
29381,3,2,102963,102963,102965,0,2,1
29382,2,1,102965,102965,102966,0,1,0
29383,6,3,102971,102971,102974,0,3,5
29384,6,1,102977,102977,102978,0,1,3
29385,4,2,102981,102981,102983,0,2,3
29386,2,2,102983,102983,102985,0,2,0
29387,2,3,102985,102985,102988,0,3,0
29388,3,3,102988,102988,102991,0,3,0
29389,5,3,102993,102993,102996,0,3,2
29390,5,1,102998,102998,102999,0,1,2
29391,3,2,103001,103001,103003,0,2,2
29392,3,3,103004,103004,103007,0,3,1
29393,3,2,103007,103007,103009,0,2,0
29394,6,2,103013,103013,103015,0,2,4
29395,2,1,103015,103015,103016,0,1,0
29396,5,2,103020,103020,103022,0,2,4
29397,5,2,103025,103025,103027,0,2,3
29398,5,2,103030,103030,103032,0,2,3
29399,3,3,103033,103033,103036,0,3,1
29400,6,2,103039,103039,103041,0,2,3
29401,5,1,103044,103044,103045,0,1,3
29402,5,2,103049,103049,103051,0,2,4
29403,3,1,103052,103052,103053,0,1,1
29404,3,3,103055,103055,103058,0,3,2
29405,5,1,103060,103060,103061,0,1,2
29406,3,2,103063,103063,103065,0,2,2
29407,4,3,103067,103067,103070,0,3,2
29408,4,1,103071,103071,103072,0,1,1
29409,1,1,103072,103072,103073,0,1,0
29410,2,1,103074,103074,103075,0,1,1
29411,6,2,103080,103080,103082,0,2,5
29412,3,2,103083,103083,103085,0,2,1
29413,2,3,103085,103085,103088,0,3,0
29414,6,3,103091,103091,103094,0,3,3
29415,2,3,103093,103094,103097,1,4,0
29416,6,2,103099,103099,103101,0,2,2
29417,4,2,103103,103103,103105,0,2,2
29418,3,1,103106,103106,103107,0,1,1
29419,3,2,103109,103109,103111,0,2,2
29420,1,2,103110,103111,103113,1,3,0
29421,3,3,103113,103113,103116,0,3,0
29422,4,3,103117,103117,103120,0,3,1
29423,5,1,103122,103122,103123,0,1,2
29424,6,3,103128,103128,103131,0,3,5
29425,3,3,103131,103131,103134,0,3,0
29426,6,2,103137,103137,103139,0,2,3
29427,5,3,103142,103142,103145,0,3,3
29428,5,3,103147,103147,103150,0,3,2
29429,6,1,103153,103153,103154,0,1,3
29430,5,2,103158,103158,103160,0,2,4
29431,4,3,103162,103162,103165,0,3,2
29432,6,2,103168,103168,103170,0,2,3
29433,4,3,103172,103172,103175,0,3,2
29434,3,2,103175,103175,103177,0,2,0
29435,2,2,103177,103177,103179,0,2,0
29436,3,3,103180,103180,103183,0,3,1
29437,2,3,103182,103183,103186,1,4,0
29438,2,2,103184,103186,103188,2,4,0
29439,4,2,103188,103188,103190,0,2,0
29440,6,3,103194,103194,103197,0,3,4
29441,1,1,103195,103197,103198,2,3,0
29442,3,1,103198,103198,103199,0,1,0
29443,5,1,103203,103203,103204,0,1,4
29444,6,2,103209,103209,103211,0,2,5
29445,5,1,103214,103214,103215,0,1,3
29446,1,3,103215,103215,103218,0,3,0
29447,5,1,103220,103220,103221,0,1,2
29448,1,2,103221,103221,103223,0,2,0
29449,3,1,103224,103224,103225,0,1,1
29450,2,2,103226,103226,103228,0,2,1
29451,1,1,103227,103228,103229,1,2,0
29452,3,2,103230,103230,103232,0,2,1
29453,6,3,103236,103236,103239,0,3,4
29454,6,3,103242,103242,103245,0,3,3
29455,6,3,103248,103248,103251,0,3,3
29456,3,2,103251,103251,103253,0,2,0
29457,3,3,103254,103254,103257,0,3,1
29458,6,2,103260,103260,103262,0,2,3
29459,4,2,103264,103264,103266,0,2,2
29460,4,3,103268,103268,103271,0,3,2
29461,2,3,103270,103271,103274,1,4,0
29462,2,3,103272,103274,103277,2,5,0
29463,1,3,103273,103277,103280,4,7,0
29464,5,3,103278,103280,103283,2,5,0
29465,1,2,103279,103283,103285,4,6,0
29466,3,2,103282,103285,103287,3,5,0
29467,4,3,103286,103287,103290,1,4,0
29468,4,2,103290,103290,103292,0,2,0
29469,5,1,103295,103295,103296,0,1,3
29470,6,1,103301,103301,103302,0,1,5
29471,1,1,103302,103302,103303,0,1,0
29472,5,3,103307,103307,103310,0,3,4
29473,1,1,103308,103310,103311,2,3,0
29474,2,1,103310,103311,103312,1,2,0
29475,3,1,103313,103313,103314,0,1,1
29476,5,2,103318,103318,103320,0,2,4
29477,5,3,103323,103323,103326,0,3,3
29478,1,2,103324,103326,103328,2,4,0
29479,1,3,103325,103328,103331,3,6,0
29480,3,2,103328,103331,103333,3,5,0
29481,5,3,103333,103333,103336,0,3,0
29482,1,2,103334,103336,103338,2,4,0
29483,2,2,103336,103338,103340,2,4,0
29484,6,2,103342,103342,103344,0,2,2
29485,6,1,103348,103348,103349,0,1,4
29486,4,1,103352,103352,103353,0,1,3
29487,2,1,103354,103354,103355,0,1,1
29488,3,2,103357,103357,103359,0,2,2
29489,2,2,103359,103359,103361,0,2,0
29490,1,3,103360,103361,103364,1,4,0
29491,3,1,103363,103364,103365,1,2,0
29492,6,3,103369,103369,103372,0,3,4
29493,2,3,103371,103372,103375,1,4,0
29494,4,1,103375,103375,103376,0,1,0
29495,5,2,103380,103380,103382,0,2,4
29496,4,1,103384,103384,103385,0,1,2
29497,3,2,103387,103387,103389,0,2,2
29498,4,1,103391,103391,103392,0,1,2
29499,6,3,103397,103397,103400,0,3,5
29500,1,2,103398,103400,103402,2,4,0
29501,6,1,103404,103404,103405,0,1,2
29502,3,1,103407,103407,103408,0,1,2
29503,5,3,103412,103412,103415,0,3,4
29504,2,3,103414,103415,103418,1,4,0
29505,1,1,103415,103418,103419,3,4,0
29506,1,1,103416,103419,103420,3,4,0
29507,2,3,103418,103420,103423,2,5,0
29508,1,1,103419,103423,103424,4,5,0
29509,3,1,103422,103424,103425,2,3,0
29510,1,1,103423,103425,103426,2,3,0
29511,3,1,103426,103426,103427,0,1,0
29512,3,1,103429,103429,103430,0,1,2
29513,1,1,103430,103430,103431,0,1,0
29514,2,1,103432,103432,103433,0,1,1
29515,2,2,103434,103434,103436,0,2,1
29516,4,1,103438,103438,103439,0,1,2
29517,6,3,103444,103444,103447,0,3,5
29518,3,2,103447,103447,103449,0,2,0
29519,2,1,103449,103449,103450,0,1,0
29520,6,3,103455,103455,103458,0,3,5
29521,5,3,103460,103460,103463,0,3,2
29522,4,3,103464,103464,103467,0,3,1
29523,5,2,103469,103469,103471,0,2,2
29524,5,2,103474,103474,103476,0,2,3
29525,2,2,103476,103476,103478,0,2,0
29526,6,1,103482,103482,103483,0,1,4
29527,4,2,103486,103486,103488,0,2,3
29528,1,1,103487,103488,103489,1,2,0
29529,4,1,103491,103491,103492,0,1,2
29530,1,1,103492,103492,103493,0,1,0
29531,4,2,103496,103496,103498,0,2,3
29532,3,3,103499,103499,103502,0,3,1
29533,6,3,103505,103505,103508,0,3,3
29534,5,2,103510,103510,103512,0,2,2
29535,3,2,103513,103513,103515,0,2,1
29536,5,2,103518,103518,103520,0,2,3
29537,2,1,103520,103520,103521,0,1,0
29538,5,1,103525,103525,103526,0,1,4
29539,1,1,103526,103526,103527,0,1,0
29540,3,2,103529,103529,103531,0,2,2
29541,3,2,103532,103532,103534,0,2,1
29542,3,1,103535,103535,103536,0,1,1
29543,6,1,103541,103541,103542,0,1,5
29544,3,1,103544,103544,103545,0,1,2
29545,6,1,103550,103550,103551,0,1,5
29546,2,3,103552,103552,103555,0,3,1
29547,3,2,103555,103555,103557,0,2,0
29548,2,3,103557,103557,103560,0,3,0
29549,1,1,103558,103560,103561,2,3,0
29550,4,3,103562,103562,103565,0,3,1
29551,3,1,103565,103565,103566,0,1,0
29552,2,2,103567,103567,103569,0,2,1
29553,2,2,103569,103569,103571,0,2,0
29554,5,1,103574,103574,103575,0,1,3
29555,6,1,103580,103580,103581,0,1,5
29556,1,1,103581,103581,103582,0,1,0
29557,5,2,103586,103586,103588,0,2,4
29558,4,2,103590,103590,103592,0,2,2
29559,1,1,103591,103592,103593,1,2,0
29560,6,3,103597,103597,103600,0,3,4
29561,3,3,103600,103600,103603,0,3,0
29562,3,1,103603,103603,103604,0,1,0
29563,6,3,103609,103609,103612,0,3,5
29564,4,1,103613,103613,103614,0,1,1
29565,2,1,103615,103615,103616,0,1,1
29566,2,2,103617,103617,103619,0,2,1
29567,3,2,103620,103620,103622,0,2,1
29568,1,3,103621,103622,103625,1,4,0
29569,3,3,103624,103625,103628,1,4,0
29570,6,1,103630,103630,103631,0,1,2
29571,4,1,103634,103634,103635,0,1,3
29572,3,2,103637,103637,103639,0,2,2
29573,2,2,103639,103639,103641,0,2,0
29574,1,1,103640,103641,103642,1,2,0
29575,4,1,103644,103644,103645,0,1,2
29576,4,2,103648,103648,103650,0,2,3
29577,5,2,103653,103653,103655,0,2,3
29578,3,2,103656,103656,103658,0,2,1
29579,6,2,103662,103662,103664,0,2,4
29580,6,1,103668,103668,103669,0,1,4
29581,2,2,103670,103670,103672,0,2,1
29582,3,2,103673,103673,103675,0,2,1
29583,6,3,103679,103679,103682,0,3,4
29584,1,2,103680,103682,103684,2,4,0
29585,6,2,103686,103686,103688,0,2,2
29586,1,1,103687,103688,103689,1,2,0
29587,1,3,103688,103689,103692,1,4,0
29588,5,3,103693,103693,103696,0,3,1
29589,5,3,103698,103698,103701,0,3,2
29590,1,1,103699,103701,103702,2,3,0
29591,3,3,103702,103702,103705,0,3,0
29592,1,1,103703,103705,103706,2,3,0
29593,3,3,103706,103706,103709,0,3,0
29594,1,2,103707,103709,103711,2,4,0
29595,6,2,103713,103713,103715,0,2,2
29596,5,2,103718,103718,103720,0,2,3
29597,4,2,103722,103722,103724,0,2,2
29598,1,3,103723,103724,103727,1,4,0
29599,6,3,103729,103729,103732,0,3,2
29600,2,2,103731,103732,103734,1,3,0
29601,1,1,103732,103734,103735,2,3,0
29602,1,3,103733,103735,103738,2,5,0
29603,6,2,103739,103739,103741,0,2,1
29604,4,3,103743,103743,103746,0,3,2
29605,2,3,103745,103746,103749,1,4,0
29606,5,1,103750,103750,103751,0,1,1
29607,5,3,103755,103755,103758,0,3,4
29608,4,1,103759,103759,103760,0,1,1
29609,6,3,103765,103765,103768,0,3,5
29610,5,3,103770,103770,103773,0,3,2
29611,3,3,103773,103773,103776,0,3,0
29612,6,1,103779,103779,103780,0,1,3
29613,5,3,103784,103784,103787,0,3,4
29614,6,2,103790,103790,103792,0,2,3
29615,3,1,103793,103793,103794,0,1,1
29616,3,2,103796,103796,103798,0,2,2
29617,6,3,103802,103802,103805,0,3,4
29618,5,3,103807,103807,103810,0,3,2
29619,3,3,103810,103810,103813,0,3,0
29620,4,2,103814,103814,103816,0,2,1
29621,5,3,103819,103819,103822,0,3,3
29622,5,3,103824,103824,103827,0,3,2
29623,4,3,103828,103828,103831,0,3,1
29624,3,3,103831,103831,103834,0,3,0
29625,1,1,103832,103834,103835,2,3,0
29626,5,2,103837,103837,103839,0,2,2
29627,4,1,103841,103841,103842,0,1,2
29628,4,1,103845,103845,103846,0,1,3
29629,5,1,103850,103850,103851,0,1,4
29630,4,2,103854,103854,103856,0,2,3
29631,3,2,103857,103857,103859,0,2,1
29632,3,3,103860,103860,103863,0,3,1
29633,6,3,103866,103866,103869,0,3,3
29634,4,3,103870,103870,103873,0,3,1
29635,2,3,103872,103873,103876,1,4,0
29636,1,2,103873,103876,103878,3,5,0
29637,5,2,103878,103878,103880,0,2,0
29638,5,1,103883,103883,103884,0,1,3
29639,6,3,103889,103889,103892,0,3,5
29640,1,1,103890,103892,103893,2,3,0
29641,1,2,103891,103893,103895,2,4,0
29642,2,3,103893,103895,103898,2,5,0
29643,1,2,103894,103898,103900,4,6,0
29644,3,1,103897,103900,103901,3,4,0
29645,6,2,103903,103903,103905,0,2,2
29646,3,2,103906,103906,103908,0,2,1
29647,4,1,103910,103910,103911,0,1,2
29648,1,2,103911,103911,103913,0,2,0
29649,4,3,103915,103915,103918,0,3,2
29650,1,3,103916,103918,103921,2,5,0
29651,4,3,103920,103921,103924,1,4,0
29652,6,2,103926,103926,103928,0,2,2
29653,3,1,103929,103929,103930,0,1,1
29654,3,2,103932,103932,103934,0,2,2
29655,3,2,103935,103935,103937,0,2,1
29656,4,2,103939,103939,103941,0,2,2
29657,3,1,103942,103942,103943,0,1,1
29658,3,1,103945,103945,103946,0,1,2
29659,4,3,103949,103949,103952,0,3,3
29660,1,3,103950,103952,103955,2,5,0
29661,2,1,103952,103955,103956,3,4,0
29662,2,3,103954,103956,103959,2,5,0
29663,6,3,103960,103960,103963,0,3,1
29664,5,1,103965,103965,103966,0,1,2
29665,4,3,103969,103969,103972,0,3,3
29666,6,3,103975,103975,103978,0,3,3
29667,5,1,103980,103980,103981,0,1,2
29668,3,3,103983,103983,103986,0,3,2
29669,5,2,103988,103988,103990,0,2,2
29670,2,2,103990,103990,103992,0,2,0
29671,3,3,103993,103993,103996,0,3,1
29672,4,2,103997,103997,103999,0,2,1
29673,6,1,104003,104003,104004,0,1,4
29674,2,1,104005,104005,104006,0,1,1
29675,6,1,104011,104011,104012,0,1,5
29676,5,3,104016,104016,104019,0,3,4
29677,6,3,104022,104022,104025,0,3,3
29678,5,2,104027,104027,104029,0,2,2
29679,4,1,104031,104031,104032,0,1,2
29680,4,3,104035,104035,104038,0,3,3
29681,4,1,104039,104039,104040,0,1,1
29682,6,2,104045,104045,104047,0,2,5
29683,3,2,104048,104048,104050,0,2,1
29684,3,1,104051,104051,104052,0,1,1
29685,1,3,104052,104052,104055,0,3,0
29686,2,2,104054,104055,104057,1,3,0
29687,4,3,104058,104058,104061,0,3,1
29688,1,3,104059,104061,104064,2,5,0
29689,6,1,104065,104065,104066,0,1,1
29690,2,3,104067,104067,104070,0,3,1
29691,3,2,104070,104070,104072,0,2,0
29692,5,3,104075,104075,104078,0,3,3
29693,6,2,104081,104081,104083,0,2,3
29694,6,1,104087,104087,104088,0,1,4
29695,3,3,104090,104090,104093,0,3,2
29696,4,2,104094,104094,104096,0,2,1
29697,5,3,104099,104099,104102,0,3,3
29698,3,2,104102,104102,104104,0,2,0
29699,6,3,104108,104108,104111,0,3,4
29700,6,3,104114,104114,104117,0,3,3
29701,4,3,104118,104118,104121,0,3,1
29702,2,3,104120,104121,104124,1,4,0
29703,4,2,104124,104124,104126,0,2,0
29704,4,1,104128,104128,104129,0,1,2
29705,5,3,104133,104133,104136,0,3,4
29706,2,2,104135,104136,104138,1,3,0
29707,4,1,104139,104139,104140,0,1,1
29708,1,2,104140,104140,104142,0,2,0
29709,1,3,104141,104142,104145,1,4,0
29710,6,2,104147,104147,104149,0,2,2
29711,2,2,104149,104149,104151,0,2,0
29712,2,2,104151,104151,104153,0,2,0
29713,3,2,104154,104154,104156,0,2,1
29714,6,3,104160,104160,104163,0,3,4
29715,1,2,104161,104163,104165,2,4,0
29716,4,2,104165,104165,104167,0,2,0
29717,1,1,104166,104167,104168,1,2,0
29718,2,3,104168,104168,104171,0,3,0
29719,6,1,104174,104174,104175,0,1,3
29720,1,1,104175,104175,104176,0,1,0
29721,6,3,104181,104181,104184,0,3,5
29722,2,2,104183,104184,104186,1,3,0
29723,2,3,104185,104186,104189,1,4,0
29724,3,2,104188,104189,104191,1,3,0
29725,2,2,104190,104191,104193,1,3,0
29726,3,1,104193,104193,104194,0,1,0
29727,4,1,104197,104197,104198,0,1,3
29728,5,3,104202,104202,104205,0,3,4
29729,2,3,104204,104205,104208,1,4,0
29730,3,1,104207,104208,104209,1,2,0
29731,2,1,104209,104209,104210,0,1,0
29732,2,2,104211,104211,104213,0,2,1
29733,5,2,104216,104216,104218,0,2,3
29734,6,3,104222,104222,104225,0,3,4
29735,1,2,104223,104225,104227,2,4,0
29736,1,1,104224,104227,104228,3,4,0
29737,1,2,104225,104228,104230,3,5,0
29738,4,1,104229,104230,104231,1,2,0
29739,5,2,104234,104234,104236,0,2,3
29740,4,2,104238,104238,104240,0,2,2
29741,4,3,104242,104242,104245,0,3,2
29742,1,1,104243,104245,104246,2,3,0
29743,4,1,104247,104247,104248,0,1,1
29744,6,2,104253,104253,104255,0,2,5
29745,1,2,104254,104255,104257,1,3,0
29746,5,2,104259,104259,104261,0,2,2
29747,2,1,104261,104261,104262,0,1,0
29748,6,3,104267,104267,104270,0,3,5
29749,3,1,104270,104270,104271,0,1,0
29750,2,3,104272,104272,104275,0,3,1
29751,1,2,104273,104275,104277,2,4,0
29752,2,3,104275,104277,104280,2,5,0
29753,2,3,104277,104280,104283,3,6,0
29754,6,2,104283,104283,104285,0,2,0
29755,6,2,104289,104289,104291,0,2,4
29756,5,3,104294,104294,104297,0,3,3
29757,5,2,104299,104299,104301,0,2,2
29758,6,1,104305,104305,104306,0,1,4
29759,6,1,104311,104311,104312,0,1,5
29760,6,1,104317,104317,104318,0,1,5
29761,6,1,104323,104323,104324,0,1,5
29762,5,2,104328,104328,104330,0,2,4
29763,6,2,104334,104334,104336,0,2,4
29764,3,1,104337,104337,104338,0,1,1
29765,6,1,104343,104343,104344,0,1,5
29766,3,3,104346,104346,104349,0,3,2
29767,1,1,104347,104349,104350,2,3,0
29768,5,1,104352,104352,104353,0,1,2
29769,3,1,104355,104355,104356,0,1,2
29770,1,1,104356,104356,104357,0,1,0
29771,2,1,104358,104358,104359,0,1,1
29772,3,1,104361,104361,104362,0,1,2
29773,4,1,104365,104365,104366,0,1,3
29774,5,3,104370,104370,104373,0,3,4
29775,4,2,104374,104374,104376,0,2,1
29776,2,1,104376,104376,104377,0,1,0
29777,1,3,104377,104377,104380,0,3,0
29778,3,3,104380,104380,104383,0,3,0
29779,3,3,104383,104383,104386,0,3,0
29780,1,3,104384,104386,104389,2,5,0
29781,1,2,104385,104389,104391,4,6,0
29782,5,1,104390,104391,104392,1,2,0
29783,6,2,104396,104396,104398,0,2,4
29784,5,2,104401,104401,104403,0,2,3
29785,3,3,104404,104404,104407,0,3,1
29786,1,2,104405,104407,104409,2,4,0
29787,6,2,104411,104411,104413,0,2,2
29788,5,1,104416,104416,104417,0,1,3
29789,2,3,104418,104418,104421,0,3,1
29790,6,1,104424,104424,104425,0,1,3
29791,2,2,104426,104426,104428,0,2,1
29792,3,2,104429,104429,104431,0,2,1
29793,2,3,104431,104431,104434,0,3,0
29794,1,1,104432,104434,104435,2,3,0
29795,5,3,104437,104437,104440,0,3,2
29796,2,3,104439,104440,104443,1,4,0
29797,2,3,104441,104443,104446,2,5,0
29798,5,1,104446,104446,104447,0,1,0
29799,3,2,104449,104449,104451,0,2,2
29800,3,3,104452,104452,104455,0,3,1
29801,5,2,104457,104457,104459,0,2,2
29802,4,1,104461,104461,104462,0,1,2
29803,3,3,104464,104464,104467,0,3,2
29804,1,2,104465,104467,104469,2,4,0
29805,4,1,104469,104469,104470,0,1,0
29806,6,1,104475,104475,104476,0,1,5
29807,3,2,104478,104478,104480,0,2,2
29808,4,2,104482,104482,104484,0,2,2
29809,5,3,104487,104487,104490,0,3,3
29810,4,2,104491,104491,104493,0,2,1
29811,6,2,104497,104497,104499,0,2,4
29812,5,3,104502,104502,104505,0,3,3
29813,3,1,104505,104505,104506,0,1,0
29814,2,2,104507,104507,104509,0,2,1
29815,6,3,104513,104513,104516,0,3,4
29816,4,2,104517,104517,104519,0,2,1
29817,6,2,104523,104523,104525,0,2,4
29818,5,2,104528,104528,104530,0,2,3
29819,5,1,104533,104533,104534,0,1,3
29820,3,2,104536,104536,104538,0,2,2
29821,1,2,104537,104538,104540,1,3,0
29822,6,1,104543,104543,104544,0,1,3
29823,1,1,104544,104544,104545,0,1,0
29824,1,2,104545,104545,104547,0,2,0
29825,6,1,104551,104551,104552,0,1,4
29826,3,3,104554,104554,104557,0,3,2
29827,4,3,104558,104558,104561,0,3,1
29828,2,2,104560,104561,104563,1,3,0
29829,5,2,104565,104565,104567,0,2,2
29830,4,1,104569,104569,104570,0,1,2
29831,4,3,104573,104573,104576,0,3,3
29832,2,2,104575,104576,104578,1,3,0
29833,6,2,104581,104581,104583,0,2,3
29834,5,1,104586,104586,104587,0,1,3
29835,1,1,104587,104587,104588,0,1,0
29836,5,3,104592,104592,104595,0,3,4
29837,2,1,104594,104595,104596,1,2,0
29838,1,1,104595,104596,104597,1,2,0
29839,5,2,104600,104600,104602,0,2,3
29840,2,3,104602,104602,104605,0,3,0
29841,1,1,104603,104605,104606,2,3,0
29842,3,1,104606,104606,104607,0,1,0
29843,6,1,104612,104612,104613,0,1,5
29844,2,2,104614,104614,104616,0,2,1
29845,1,1,104615,104616,104617,1,2,0
29846,1,3,104616,104617,104620,1,4,0
29847,5,2,104621,104621,104623,0,2,1
29848,4,1,104625,104625,104626,0,1,2
29849,2,2,104627,104627,104629,0,2,1
29850,2,3,104629,104629,104632,0,3,0
29851,2,3,104631,104632,104635,1,4,0
29852,4,3,104635,104635,104638,0,3,0
29853,2,1,104637,104638,104639,1,2,0
29854,5,3,104642,104642,104645,0,3,3
29855,1,2,104643,104645,104647,2,4,0
29856,1,3,104644,104647,104650,3,6,0
29857,3,1,104647,104650,104651,3,4,0
29858,2,2,104649,104651,104653,2,4,0
29859,6,1,104655,104655,104656,0,1,2
29860,4,1,104659,104659,104660,0,1,3
29861,5,1,104664,104664,104665,0,1,4
29862,6,1,104670,104670,104671,0,1,5
29863,2,3,104672,104672,104675,0,3,1
29864,5,2,104677,104677,104679,0,2,2
29865,6,1,104683,104683,104684,0,1,4
29866,6,1,104689,104689,104690,0,1,5
29867,1,3,104690,104690,104693,0,3,0
29868,3,3,104693,104693,104696,0,3,0
29869,1,1,104694,104696,104697,2,3,0
29870,6,3,104700,104700,104703,0,3,3
29871,6,3,104706,104706,104709,0,3,3
29872,5,3,104711,104711,104714,0,3,2
29873,4,2,104715,104715,104717,0,2,1
29874,2,3,104717,104717,104720,0,3,0
29875,6,1,104723,104723,104724,0,1,3
29876,3,2,104726,104726,104728,0,2,2
29877,4,3,104730,104730,104733,0,3,2
29878,2,2,104732,104733,104735,1,3,0
29879,1,3,104733,104735,104738,2,5,0
29880,1,2,104734,104738,104740,4,6,0
29881,2,1,104736,104740,104741,4,5,0
29882,6,2,104742,104742,104744,0,2,1
29883,1,3,104743,104744,104747,1,4,0
29884,2,1,104745,104747,104748,2,3,0
29885,3,1,104748,104748,104749,0,1,0
29886,5,3,104753,104753,104756,0,3,4
29887,2,2,104755,104756,104758,1,3,0
29888,4,1,104759,104759,104760,0,1,1
29889,4,1,104763,104763,104764,0,1,3
29890,2,2,104765,104765,104767,0,2,1
29891,4,2,104769,104769,104771,0,2,2
29892,5,1,104774,104774,104775,0,1,3
29893,3,1,104777,104777,104778,0,1,2
29894,2,3,104779,104779,104782,0,3,1
29895,2,1,104781,104782,104783,1,2,0
29896,4,2,104785,104785,104787,0,2,2
29897,4,1,104789,104789,104790,0,1,2
29898,1,2,104790,104790,104792,0,2,0
29899,5,3,104795,104795,104798,0,3,3
29900,4,2,104799,104799,104801,0,2,1
29901,4,1,104803,104803,104804,0,1,2
29902,1,1,104804,104804,104805,0,1,0
29903,3,2,104807,104807,104809,0,2,2
29904,6,1,104813,104813,104814,0,1,4
29905,5,3,104818,104818,104821,0,3,4
29906,5,2,104823,104823,104825,0,2,2
29907,1,1,104824,104825,104826,1,2,0
29908,4,1,104828,104828,104829,0,1,2
29909,4,3,104832,104832,104835,0,3,3
29910,3,1,104835,104835,104836,0,1,0
29911,5,3,104840,104840,104843,0,3,4
29912,4,2,104844,104844,104846,0,2,1
29913,5,1,104849,104849,104850,0,1,3
29914,6,1,104855,104855,104856,0,1,5
29915,2,3,104857,104857,104860,0,3,1
29916,1,2,104858,104860,104862,2,4,0
29917,6,2,104864,104864,104866,0,2,2
29918,2,2,104866,104866,104868,0,2,0
29919,5,2,104871,104871,104873,0,2,3
29920,2,1,104873,104873,104874,0,1,0
29921,5,3,104878,104878,104881,0,3,4
29922,1,3,104879,104881,104884,2,5,0
29923,5,1,104884,104884,104885,0,1,0
29924,1,3,104885,104885,104888,0,3,0
29925,6,2,104891,104891,104893,0,2,3
29926,1,2,104892,104893,104895,1,3,0
29927,2,3,104894,104895,104898,1,4,0
29928,2,1,104896,104898,104899,2,3,0
29929,1,3,104897,104899,104902,2,5,0
29930,2,3,104899,104902,104905,3,6,0
29931,2,3,104901,104905,104908,4,7,0
29932,3,2,104904,104908,104910,4,6,0
29933,4,2,104908,104910,104912,2,4,0
29934,2,2,104910,104912,104914,2,4,0
29935,3,3,104913,104914,104917,1,4,0
29936,2,3,104915,104917,104920,2,5,0
29937,4,2,104919,104920,104922,1,3,0
29938,4,1,104923,104923,104924,0,1,1
29939,4,2,104927,104927,104929,0,2,3
29940,2,2,104929,104929,104931,0,2,0
29941,3,1,104932,104932,104933,0,1,1
29942,3,3,104935,104935,104938,0,3,2
29943,3,3,104938,104938,104941,0,3,0
29944,1,3,104939,104941,104944,2,5,0
29945,6,1,104945,104945,104946,0,1,1
29946,3,3,104948,104948,104951,0,3,2
29947,2,3,104950,104951,104954,1,4,0
29948,1,3,104951,104954,104957,3,6,0
29949,5,2,104956,104957,104959,1,3,0
29950,4,2,104960,104960,104962,0,2,1
29951,4,1,104964,104964,104965,0,1,2
29952,5,3,104969,104969,104972,0,3,4
29953,6,3,104975,104975,104978,0,3,3
29954,2,1,104977,104978,104979,1,2,0
29955,5,2,104982,104982,104984,0,2,3
29956,6,1,104988,104988,104989,0,1,4
29957,5,2,104993,104993,104995,0,2,4
29958,2,1,104995,104995,104996,0,1,0
29959,6,2,105001,105001,105003,0,2,5
29960,6,3,105007,105007,105010,0,3,4
29961,1,1,105008,105010,105011,2,3,0
29962,5,1,105013,105013,105014,0,1,2
29963,2,1,105015,105015,105016,0,1,1
29964,4,1,105019,105019,105020,0,1,3
29965,2,2,105021,105021,105023,0,2,1
29966,6,2,105027,105027,105029,0,2,4
29967,3,3,105030,105030,105033,0,3,1
29968,3,2,105033,105033,105035,0,2,0
29969,1,2,105034,105035,105037,1,3,0
29970,1,3,105035,105037,105040,2,5,0
29971,3,2,105038,105040,105042,2,4,0
29972,4,2,105042,105042,105044,0,2,0
29973,6,3,105048,105048,105051,0,3,4
29974,5,3,105053,105053,105056,0,3,2
29975,6,2,105059,105059,105061,0,2,3
29976,1,2,105060,105061,105063,1,3,0
29977,3,3,105063,105063,105066,0,3,0
29978,3,2,105066,105066,105068,0,2,0
29979,5,3,105071,105071,105074,0,3,3
29980,4,2,105075,105075,105077,0,2,1
29981,5,2,105080,105080,105082,0,2,3
29982,2,1,105082,105082,105083,0,1,0
29983,4,3,105086,105086,105089,0,3,3
29984,5,3,105091,105091,105094,0,3,2
29985,3,2,105094,105094,105096,0,2,0
29986,3,1,105097,105097,105098,0,1,1
29987,4,2,105101,105101,105103,0,2,3
29988,5,2,105106,105106,105108,0,2,3
29989,1,2,105107,105108,105110,1,3,0
29990,5,1,105112,105112,105113,0,1,2
29991,3,3,105115,105115,105118,0,3,2
29992,3,1,105118,105118,105119,0,1,0
29993,6,1,105124,105124,105125,0,1,5
29994,4,3,105128,105128,105131,0,3,3
29995,3,2,105131,105131,105133,0,2,0
29996,6,1,105137,105137,105138,0,1,4
29997,6,1,105143,105143,105144,0,1,5
29998,5,2,105148,105148,105150,0,2,4
29999,2,1,105150,105150,105151,0,1,0
30000,1,1,105151,105151,105152,0,1,0
30001,3,3,105154,105154,105157,0,3,2
30002,4,3,105158,105158,105161,0,3,1
30003,6,1,105164,105164,105165,0,1,3
30004,3,1,105167,105167,105168,0,1,2
30005,6,2,105173,105173,105175,0,2,5
30006,3,3,105176,105176,105179,0,3,1
30007,3,2,105179,105179,105181,0,2,0
30008,2,2,105181,105181,105183,0,2,0
30009,5,3,105186,105186,105189,0,3,3
30010,1,2,105187,105189,105191,2,4,0
30011,2,2,105189,105191,105193,2,4,0
30012,6,2,105195,105195,105197,0,2,2
30013,4,1,105199,105199,105200,0,1,2
30014,1,1,105200,105200,105201,0,1,0
30015,2,1,105202,105202,105203,0,1,1
30016,3,3,105205,105205,105208,0,3,2
30017,5,2,105210,105210,105212,0,2,2
30018,3,2,105213,105213,105215,0,2,1
30019,6,2,105219,105219,105221,0,2,4
30020,5,2,105224,105224,105226,0,2,3
30021,2,3,105226,105226,105229,0,3,0
30022,5,3,105231,105231,105234,0,3,2
30023,4,3,105235,105235,105238,0,3,1
30024,5,1,105240,105240,105241,0,1,2
30025,4,3,105244,105244,105247,0,3,3
30026,2,3,105246,105247,105250,1,4,0
30027,1,2,105247,105250,105252,3,5,0
30028,1,2,105248,105252,105254,4,6,0
30029,6,2,105254,105254,105256,0,2,0
30030,5,2,105259,105259,105261,0,2,3
30031,2,2,105261,105261,105263,0,2,0
30032,6,1,105267,105267,105268,0,1,4
30033,6,2,105273,105273,105275,0,2,5
30034,4,3,105277,105277,105280,0,3,2
30035,2,1,105279,105280,105281,1,2,0
30036,2,3,105281,105281,105284,0,3,0
30037,1,3,105282,105284,105287,2,5,0
30038,4,1,105286,105287,105288,1,2,0
30039,3,1,105289,105289,105290,0,1,1
30040,4,3,105293,105293,105296,0,3,3
30041,5,3,105298,105298,105301,0,3,2
30042,3,2,105301,105301,105303,0,2,0
30043,1,1,105302,105303,105304,1,2,0
30044,6,1,105308,105308,105309,0,1,4
30045,1,3,105309,105309,105312,0,3,0
30046,5,1,105314,105314,105315,0,1,2
30047,5,1,105319,105319,105320,0,1,4
30048,1,2,105320,105320,105322,0,2,0
30049,6,2,105326,105326,105328,0,2,4
30050,4,1,105330,105330,105331,0,1,2
30051,6,1,105336,105336,105337,0,1,5
30052,2,2,105338,105338,105340,0,2,1
30053,1,2,105339,105340,105342,1,3,0
30054,2,3,105341,105342,105345,1,4,0
30055,1,2,105342,105345,105347,3,5,0
30056,2,1,105344,105347,105348,3,4,0
30057,1,2,105345,105348,105350,3,5,0
30058,2,3,105347,105350,105353,3,6,0
30059,2,3,105349,105353,105356,4,7,0
30060,2,3,105351,105356,105359,5,8,0
30061,1,2,105352,105359,105361,7,9,0
30062,6,1,105358,105361,105362,3,4,0
30063,6,3,105364,105364,105367,0,3,2
30064,4,2,105368,105368,105370,0,2,1
30065,6,2,105374,105374,105376,0,2,4
30066,2,3,105376,105376,105379,0,3,0
30067,5,3,105381,105381,105384,0,3,2
30068,1,2,105382,105384,105386,2,4,0
30069,5,1,105387,105387,105388,0,1,1
30070,1,2,105388,105388,105390,0,2,0
30071,5,2,105393,105393,105395,0,2,3
30072,3,3,105396,105396,105399,0,3,1
30073,2,1,105398,105399,105400,1,2,0
30074,3,3,105401,105401,105404,0,3,1
30075,2,1,105403,105404,105405,1,2,0
30076,2,2,105405,105405,105407,0,2,0
30077,3,1,105408,105408,105409,0,1,1
30078,2,3,105410,105410,105413,0,3,1
30079,6,3,105416,105416,105419,0,3,3
30080,2,1,105418,105419,105420,1,2,0
30081,2,2,105420,105420,105422,0,2,0
30082,6,1,105426,105426,105427,0,1,4
30083,1,2,105427,105427,105429,0,2,0
30084,6,2,105433,105433,105435,0,2,4
30085,5,2,105438,105438,105440,0,2,3
30086,6,2,105444,105444,105446,0,2,4
30087,2,1,105446,105446,105447,0,1,0
30088,4,3,105450,105450,105453,0,3,3
30089,4,1,105454,105454,105455,0,1,1
30090,6,3,105460,105460,105463,0,3,5
30091,3,1,105463,105463,105464,0,1,0
30092,4,1,105467,105467,105468,0,1,3
30093,3,1,105470,105470,105471,0,1,2
30094,1,3,105471,105471,105474,0,3,0
30095,2,2,105473,105474,105476,1,3,0
30096,1,3,105474,105476,105479,2,5,0
30097,5,1,105479,105479,105480,0,1,0
30098,2,2,105481,105481,105483,0,2,1
30099,3,1,105484,105484,105485,0,1,1
30100,4,3,105488,105488,105491,0,3,3
30101,2,2,105490,105491,105493,1,3,0
30102,2,3,105492,105493,105496,1,4,0
30103,1,2,105493,105496,105498,3,5,0
30104,1,2,105494,105498,105500,4,6,0
30105,1,2,105495,105500,105502,5,7,0
30106,3,1,105498,105502,105503,4,5,0
30107,2,1,105500,105503,105504,3,4,0
30108,2,3,105502,105504,105507,2,5,0
30109,1,1,105503,105507,105508,4,5,0
30110,1,1,105504,105508,105509,4,5,0
30111,1,3,105505,105509,105512,4,7,0
30112,2,1,105507,105512,105513,5,6,0
30113,4,1,105511,105513,105514,2,3,0
30114,1,1,105512,105514,105515,2,3,0
30115,6,2,105518,105518,105520,0,2,3
30116,2,2,105520,105520,105522,0,2,0
30117,4,3,105524,105524,105527,0,3,2
30118,3,3,105527,105527,105530,0,3,0
30119,2,3,105529,105530,105533,1,4,0
30120,6,3,105535,105535,105538,0,3,2
30121,6,1,105541,105541,105542,0,1,3
30122,1,3,105542,105542,105545,0,3,0
30123,1,3,105543,105545,105548,2,5,0
30124,3,1,105546,105548,105549,2,3,0
30125,2,2,105548,105549,105551,1,3,0
30126,6,2,105554,105554,105556,0,2,3
30127,4,2,105558,105558,105560,0,2,2
30128,1,2,105559,105560,105562,1,3,0
30129,2,3,105561,105562,105565,1,4,0
30130,1,2,105562,105565,105567,3,5,0
30131,4,2,105566,105567,105569,1,3,0
30132,5,3,105571,105571,105574,0,3,2
30133,3,3,105574,105574,105577,0,3,0
30134,6,2,105580,105580,105582,0,2,3
30135,5,3,105585,105585,105588,0,3,3
30136,2,3,105587,105588,105591,1,4,0
30137,3,2,105590,105591,105593,1,3,0
30138,4,1,105594,105594,105595,0,1,1
30139,5,1,105599,105599,105600,0,1,4
30140,2,2,105601,105601,105603,0,2,1
30141,4,3,105605,105605,105608,0,3,2
30142,4,3,105609,105609,105612,0,3,1
30143,2,3,105611,105612,105615,1,4,0
30144,1,2,105612,105615,105617,3,5,0
30145,1,1,105613,105617,105618,4,5,0
30146,1,2,105614,105618,105620,4,6,0
30147,1,2,105615,105620,105622,5,7,0
30148,1,3,105616,105622,105625,6,9,0
30149,1,2,105617,105625,105627,8,10,0
30150,2,3,105619,105627,105630,8,11,0
30151,6,1,105625,105630,105631,5,6,0
30152,2,2,105627,105631,105633,4,6,0
30153,3,3,105630,105633,105636,3,6,0
30154,3,1,105633,105636,105637,3,4,0
30155,1,3,105634,105637,105640,3,6,0
30156,1,1,105635,105640,105641,5,6,0
30157,6,3,105641,105641,105644,0,3,0
30158,6,1,105647,105647,105648,0,1,3
30159,3,2,105650,105650,105652,0,2,2
30160,1,1,105651,105652,105653,1,2,0
30161,2,3,105653,105653,105656,0,3,0
30162,5,3,105658,105658,105661,0,3,2
30163,3,2,105661,105661,105663,0,2,0
30164,5,1,105666,105666,105667,0,1,3
30165,6,3,105672,105672,105675,0,3,5
30166,5,3,105677,105677,105680,0,3,2
30167,2,3,105679,105680,105683,1,4,0
30168,4,2,105683,105683,105685,0,2,0
30169,5,2,105688,105688,105690,0,2,3
30170,5,2,105693,105693,105695,0,2,3
30171,1,3,105694,105695,105698,1,4,0
30172,6,3,105700,105700,105703,0,3,2
30173,5,2,105705,105705,105707,0,2,2
30174,2,2,105707,105707,105709,0,2,0
30175,2,2,105709,105709,105711,0,2,0
30176,1,2,105710,105711,105713,1,3,0
30177,3,3,105713,105713,105716,0,3,0
30178,4,3,105717,105717,105720,0,3,1
30179,2,2,105719,105720,105722,1,3,0
30180,6,2,105725,105725,105727,0,2,3
30181,1,1,105726,105727,105728,1,2,0
30182,6,1,105732,105732,105733,0,1,4
30183,5,2,105737,105737,105739,0,2,4
30184,5,1,105742,105742,105743,0,1,3
30185,2,1,105744,105744,105745,0,1,1
30186,4,3,105748,105748,105751,0,3,3
30187,4,3,105752,105752,105755,0,3,1
30188,3,3,105755,105755,105758,0,3,0
30189,6,1,105761,105761,105762,0,1,3
30190,1,1,105762,105762,105763,0,1,0
30191,3,1,105765,105765,105766,0,1,2
30192,5,1,105770,105770,105771,0,1,4
30193,5,2,105775,105775,105777,0,2,4
30194,5,1,105780,105780,105781,0,1,3
30195,6,2,105786,105786,105788,0,2,5
30196,5,2,105791,105791,105793,0,2,3
30197,3,2,105794,105794,105796,0,2,1
30198,5,3,105799,105799,105802,0,3,3
30199,5,2,105804,105804,105806,0,2,2
30200,4,1,105808,105808,105809,0,1,2
30201,1,2,105809,105809,105811,0,2,0
30202,4,2,105813,105813,105815,0,2,2
30203,2,3,105815,105815,105818,0,3,0
30204,5,3,105820,105820,105823,0,3,2
30205,6,1,105826,105826,105827,0,1,3
30206,1,3,105827,105827,105830,0,3,0
30207,3,3,105830,105830,105833,0,3,0
30208,5,2,105835,105835,105837,0,2,2
30209,6,3,105841,105841,105844,0,3,4
30210,1,1,105842,105844,105845,2,3,0
30211,1,2,105843,105845,105847,2,4,0
30212,5,1,105848,105848,105849,0,1,1
30213,5,1,105853,105853,105854,0,1,4
30214,3,1,105856,105856,105857,0,1,2
30215,4,1,105860,105860,105861,0,1,3
30216,2,2,105862,105862,105864,0,2,1
30217,5,2,105867,105867,105869,0,2,3
30218,2,1,105869,105869,105870,0,1,0
30219,2,2,105871,105871,105873,0,2,1
30220,6,2,105877,105877,105879,0,2,4
30221,2,2,105879,105879,105881,0,2,0
30222,1,2,105880,105881,105883,1,3,0
30223,2,3,105882,105883,105886,1,4,0
30224,6,3,105888,105888,105891,0,3,2
30225,1,1,105889,105891,105892,2,3,0
30226,5,1,105894,105894,105895,0,1,2
30227,5,2,105899,105899,105901,0,2,4
30228,2,2,105901,105901,105903,0,2,0
30229,2,2,105903,105903,105905,0,2,0
30230,1,2,105904,105905,105907,1,3,0
30231,1,2,105905,105907,105909,2,4,0
30232,6,1,105911,105911,105912,0,1,2
30233,6,3,105917,105917,105920,0,3,5
30234,3,2,105920,105920,105922,0,2,0
30235,1,3,105921,105922,105925,1,4,0
30236,3,3,105924,105925,105928,1,4,0
30237,3,1,105927,105928,105929,1,2,0
30238,6,3,105933,105933,105936,0,3,4
30239,6,2,105939,105939,105941,0,2,3
30240,3,3,105942,105942,105945,0,3,1
30241,1,1,105943,105945,105946,2,3,0
30242,2,3,105945,105946,105949,1,4,0
30243,5,1,105950,105950,105951,0,1,1
30244,2,2,105952,105952,105954,0,2,1
30245,6,1,105958,105958,105959,0,1,4
30246,6,2,105964,105964,105966,0,2,5
30247,6,2,105970,105970,105972,0,2,4
30248,4,1,105974,105974,105975,0,1,2
30249,3,2,105977,105977,105979,0,2,2
30250,4,3,105981,105981,105984,0,3,2
30251,3,3,105984,105984,105987,0,3,0
30252,3,2,105987,105987,105989,0,2,0
30253,6,1,105993,105993,105994,0,1,4
30254,4,1,105997,105997,105998,0,1,3
30255,4,1,106001,106001,106002,0,1,3
30256,6,2,106007,106007,106009,0,2,5
30257,2,2,106009,106009,106011,0,2,0
30258,3,3,106012,106012,106015,0,3,1
30259,1,2,106013,106015,106017,2,4,0
30260,3,1,106016,106017,106018,1,2,0
30261,2,1,106018,106018,106019,0,1,0
30262,3,2,106021,106021,106023,0,2,2
30263,3,3,106024,106024,106027,0,3,1
30264,4,3,106028,106028,106031,0,3,1
30265,6,1,106034,106034,106035,0,1,3
30266,4,2,106038,106038,106040,0,2,3
30267,6,1,106044,106044,106045,0,1,4
30268,4,1,106048,106048,106049,0,1,3
30269,3,1,106051,106051,106052,0,1,2
30270,5,2,106056,106056,106058,0,2,4
30271,2,3,106058,106058,106061,0,3,0
30272,6,2,106064,106064,106066,0,2,3
30273,4,2,106068,106068,106070,0,2,2
30274,1,3,106069,106070,106073,1,4,0
30275,1,3,106070,106073,106076,3,6,0
30276,2,1,106072,106076,106077,4,5,0
30277,6,3,106078,106078,106081,0,3,1
30278,2,2,106080,106081,106083,1,3,0
30279,5,2,106085,106085,106087,0,2,2
30280,1,1,106086,106087,106088,1,2,0
30281,6,1,106092,106092,106093,0,1,4
30282,1,1,106093,106093,106094,0,1,0
30283,1,3,106094,106094,106097,0,3,0
30284,2,2,106096,106097,106099,1,3,0
30285,4,3,106100,106100,106103,0,3,1
30286,2,2,106102,106103,106105,1,3,0
30287,2,1,106104,106105,106106,1,2,0
30288,5,2,106109,106109,106111,0,2,3
30289,3,3,106112,106112,106115,0,3,1
30290,3,1,106115,106115,106116,0,1,0
30291,4,2,106119,106119,106121,0,2,3
30292,5,2,106124,106124,106126,0,2,3
30293,5,2,106129,106129,106131,0,2,3
30294,5,2,106134,106134,106136,0,2,3
30295,5,1,106139,106139,106140,0,1,3
30296,6,1,106145,106145,106146,0,1,5
30297,5,2,106150,106150,106152,0,2,4
30298,1,2,106151,106152,106154,1,3,0
30299,1,1,106152,106154,106155,2,3,0
30300,6,1,106158,106158,106159,0,1,3
30301,4,2,106162,106162,106164,0,2,3
30302,4,2,106166,106166,106168,0,2,2
30303,2,3,106168,106168,106171,0,3,0
30304,4,1,106172,106172,106173,0,1,1
30305,3,1,106175,106175,106176,0,1,2
30306,3,1,106178,106178,106179,0,1,2
30307,4,2,106182,106182,106184,0,2,3
30308,5,2,106187,106187,106189,0,2,3
30309,6,2,106193,106193,106195,0,2,4
30310,2,2,106195,106195,106197,0,2,0
30311,2,1,106197,106197,106198,0,1,0
30312,3,2,106200,106200,106202,0,2,2
30313,4,1,106204,106204,106205,0,1,2
30314,5,1,106209,106209,106210,0,1,4
30315,3,1,106212,106212,106213,0,1,2
30316,3,3,106215,106215,106218,0,3,2
30317,4,1,106219,106219,106220,0,1,1
30318,2,3,106221,106221,106224,0,3,1
30319,3,2,106224,106224,106226,0,2,0
30320,2,3,106226,106226,106229,0,3,0
30321,4,1,106230,106230,106231,0,1,1
30322,4,1,106234,106234,106235,0,1,3
30323,3,1,106237,106237,106238,0,1,2
30324,3,1,106240,106240,106241,0,1,2
30325,4,2,106244,106244,106246,0,2,3
30326,6,3,106250,106250,106253,0,3,4
30327,6,2,106256,106256,106258,0,2,3
30328,3,3,106259,106259,106262,0,3,1
30329,1,2,106260,106262,106264,2,4,0
30330,1,2,106261,106264,106266,3,5,0
30331,1,1,106262,106266,106267,4,5,0
30332,1,3,106263,106267,106270,4,7,0
30333,1,1,106264,106270,106271,6,7,0
30334,2,3,106266,106271,106274,5,8,0
30335,6,2,106272,106274,106276,2,4,0
30336,5,1,106277,106277,106278,0,1,1
30337,5,3,106282,106282,106285,0,3,4
30338,1,2,106283,106285,106287,2,4,0
30339,6,2,106289,106289,106291,0,2,2
30340,2,1,106291,106291,106292,0,1,0
30341,6,2,106297,106297,106299,0,2,5
30342,6,1,106303,106303,106304,0,1,4
30343,3,1,106306,106306,106307,0,1,2
30344,2,2,106308,106308,106310,0,2,1
30345,4,1,106312,106312,106313,0,1,2
30346,6,1,106318,106318,106319,0,1,5
30347,1,1,106319,106319,106320,0,1,0
30348,5,2,106324,106324,106326,0,2,4
30349,6,1,106330,106330,106331,0,1,4
30350,1,2,106331,106331,106333,0,2,0
30351,6,1,106337,106337,106338,0,1,4
30352,2,1,106339,106339,106340,0,1,1
30353,2,3,106341,106341,106344,0,3,1
30354,5,1,106346,106346,106347,0,1,2
30355,3,1,106349,106349,106350,0,1,2
30356,1,3,106350,106350,106353,0,3,0
30357,5,2,106355,106355,106357,0,2,2
30358,2,1,106357,106357,106358,0,1,0
30359,4,2,106361,106361,106363,0,2,3
30360,4,3,106365,106365,106368,0,3,2
30361,6,2,106371,106371,106373,0,2,3
30362,4,2,106375,106375,106377,0,2,2
30363,3,1,106378,106378,106379,0,1,1
30364,5,1,106383,106383,106384,0,1,4
30365,5,3,106388,106388,106391,0,3,4
30366,2,2,106390,106391,106393,1,3,0
30367,1,3,106391,106393,106396,2,5,0
30368,1,2,106392,106396,106398,4,6,0
30369,5,1,106397,106398,106399,1,2,0
30370,6,3,106403,106403,106406,0,3,4
30371,2,3,106405,106406,106409,1,4,0
30372,2,2,106407,106409,106411,2,4,0
30373,2,3,106409,106411,106414,2,5,0
30374,1,1,106410,106414,106415,4,5,0
30375,4,1,106414,106415,106416,1,2,0
30376,1,1,106415,106416,106417,1,2,0
30377,6,1,106421,106421,106422,0,1,4
30378,2,2,106423,106423,106425,0,2,1
30379,4,3,106427,106427,106430,0,3,2
30380,6,3,106433,106433,106436,0,3,3
30381,3,3,106436,106436,106439,0,3,0
30382,2,1,106438,106439,106440,1,2,0
30383,2,2,106440,106440,106442,0,2,0
30384,6,3,106446,106446,106449,0,3,4
30385,2,3,106448,106449,106452,1,4,0
30386,4,3,106452,106452,106455,0,3,0
30387,2,1,106454,106455,106456,1,2,0
30388,3,3,106457,106457,106460,0,3,1
30389,3,3,106460,106460,106463,0,3,0
30390,2,2,106462,106463,106465,1,3,0
30391,5,2,106467,106467,106469,0,2,2
30392,5,1,106472,106472,106473,0,1,3
30393,5,3,106477,106477,106480,0,3,4
30394,4,2,106481,106481,106483,0,2,1
30395,4,1,106485,106485,106486,0,1,2
30396,3,2,106488,106488,106490,0,2,2
30397,2,1,106490,106490,106491,0,1,0
30398,1,2,106491,106491,106493,0,2,0
30399,3,3,106494,106494,106497,0,3,1
30400,4,1,106498,106498,106499,0,1,1
30401,5,3,106503,106503,106506,0,3,4
30402,1,1,106504,106506,106507,2,3,0
30403,6,2,106510,106510,106512,0,2,3
30404,4,3,106514,106514,106517,0,3,2
30405,3,2,106517,106517,106519,0,2,0
30406,2,3,106519,106519,106522,0,3,0
30407,4,1,106523,106523,106524,0,1,1
30408,6,3,106529,106529,106532,0,3,5
30409,5,3,106534,106534,106537,0,3,2
30410,4,3,106538,106538,106541,0,3,1
30411,6,1,106544,106544,106545,0,1,3
30412,4,1,106548,106548,106549,0,1,3
30413,3,1,106551,106551,106552,0,1,2
30414,1,2,106552,106552,106554,0,2,0
30415,4,3,106556,106556,106559,0,3,2
30416,3,3,106559,106559,106562,0,3,0
30417,5,3,106564,106564,106567,0,3,2
30418,1,2,106565,106567,106569,2,4,0
30419,2,2,106567,106569,106571,2,4,0
30420,1,2,106568,106571,106573,3,5,0
30421,5,3,106573,106573,106576,0,3,0
30422,1,3,106574,106576,106579,2,5,0
30423,5,2,106579,106579,106581,0,2,0
30424,1,1,106580,106581,106582,1,2,0
30425,4,3,106584,106584,106587,0,3,2
30426,4,3,106588,106588,106591,0,3,1
30427,2,2,106590,106591,106593,1,3,0
30428,6,3,106596,106596,106599,0,3,3
30429,6,2,106602,106602,106604,0,2,3
30430,3,3,106605,106605,106608,0,3,1
30431,6,1,106611,106611,106612,0,1,3
30432,4,2,106615,106615,106617,0,2,3
30433,2,2,106617,106617,106619,0,2,0
30434,1,2,106618,106619,106621,1,3,0
30435,2,1,106620,106621,106622,1,2,0
30436,3,1,106623,106623,106624,0,1,1
30437,2,2,106625,106625,106627,0,2,1
30438,1,2,106626,106627,106629,1,3,0
30439,5,2,106631,106631,106633,0,2,2
30440,2,2,106633,106633,106635,0,2,0
30441,6,1,106639,106639,106640,0,1,4
30442,5,2,106644,106644,106646,0,2,4
30443,3,2,106647,106647,106649,0,2,1
30444,3,1,106650,106650,106651,0,1,1
30445,6,1,106656,106656,106657,0,1,5
30446,3,1,106659,106659,106660,0,1,2
30447,6,2,106665,106665,106667,0,2,5
30448,4,3,106669,106669,106672,0,3,2
30449,3,2,106672,106672,106674,0,2,0
30450,6,1,106678,106678,106679,0,1,4
30451,3,1,106681,106681,106682,0,1,2
30452,5,2,106686,106686,106688,0,2,4
30453,1,1,106687,106688,106689,1,2,0
30454,4,1,106691,106691,106692,0,1,2
30455,2,3,106693,106693,106696,0,3,1
30456,6,1,106699,106699,106700,0,1,3
30457,3,2,106702,106702,106704,0,2,2
30458,2,2,106704,106704,106706,0,2,0
30459,1,1,106705,106706,106707,1,2,0
30460,6,1,106711,106711,106712,0,1,4
30461,4,2,106715,106715,106717,0,2,3
30462,5,1,106720,106720,106721,0,1,3
30463,1,1,106721,106721,106722,0,1,0
30464,5,3,106726,106726,106729,0,3,4
30465,4,3,106730,106730,106733,0,3,1
30466,1,1,106731,106733,106734,2,3,0
30467,1,2,106732,106734,106736,2,4,0
30468,2,1,106734,106736,106737,2,3,0
30469,5,1,106739,106739,106740,0,1,2
30470,3,2,106742,106742,106744,0,2,2
30471,5,2,106747,106747,106749,0,2,3
30472,1,2,106748,106749,106751,1,3,0
30473,2,2,106750,106751,106753,1,3,0
30474,3,3,106753,106753,106756,0,3,0
30475,5,2,106758,106758,106760,0,2,2
30476,2,1,106760,106760,106761,0,1,0
30477,2,1,106762,106762,106763,0,1,1
30478,5,3,106767,106767,106770,0,3,4
30479,2,1,106769,106770,106771,1,2,0
30480,6,1,106775,106775,106776,0,1,4
30481,5,3,106780,106780,106783,0,3,4
30482,2,2,106782,106783,106785,1,3,0
30483,1,3,106783,106785,106788,2,5,0
30484,1,1,106784,106788,106789,4,5,0
30485,1,2,106785,106789,106791,4,6,0
30486,3,1,106788,106791,106792,3,4,0
30487,2,1,106790,106792,106793,2,3,0
30488,4,2,106794,106794,106796,0,2,1
30489,5,2,106799,106799,106801,0,2,3
30490,6,2,106805,106805,106807,0,2,4
30491,6,3,106811,106811,106814,0,3,4
30492,5,2,106816,106816,106818,0,2,2
30493,6,2,106822,106822,106824,0,2,4
30494,3,1,106825,106825,106826,0,1,1
30495,1,1,106826,106826,106827,0,1,0
30496,6,1,106832,106832,106833,0,1,5
30497,1,2,106833,106833,106835,0,2,0
30498,4,3,106837,106837,106840,0,3,2
30499,2,2,106839,106840,106842,1,3,0
30500,2,1,106841,106842,106843,1,2,0
30501,2,3,106843,106843,106846,0,3,0
30502,1,3,106844,106846,106849,2,5,0
30503,6,1,106850,106850,106851,0,1,1
30504,3,2,106853,106853,106855,0,2,2
30505,4,1,106857,106857,106858,0,1,2
30506,2,2,106859,106859,106861,0,2,1
30507,3,2,106862,106862,106864,0,2,1
30508,6,2,106868,106868,106870,0,2,4
30509,1,1,106869,106870,106871,1,2,0
30510,5,2,106874,106874,106876,0,2,3
30511,2,3,106876,106876,106879,0,3,0
30512,4,2,106880,106880,106882,0,2,1
30513,2,3,106882,106882,106885,0,3,0
30514,5,3,106887,106887,106890,0,3,2
30515,4,1,106891,106891,106892,0,1,1
30516,3,3,106894,106894,106897,0,3,2
30517,4,1,106898,106898,106899,0,1,1
30518,1,3,106899,106899,106902,0,3,0
30519,2,2,106901,106902,106904,1,3,0
30520,4,2,106905,106905,106907,0,2,1
30521,6,2,106911,106911,106913,0,2,4
30522,3,1,106914,106914,106915,0,1,1
30523,6,3,106920,106920,106923,0,3,5
30524,6,2,106926,106926,106928,0,2,3
30525,2,1,106928,106928,106929,0,1,0
30526,6,3,106934,106934,106937,0,3,5
30527,6,2,106940,106940,106942,0,2,3
30528,3,1,106943,106943,106944,0,1,1
30529,1,3,106944,106944,106947,0,3,0
30530,3,3,106947,106947,106950,0,3,0
30531,3,1,106950,106950,106951,0,1,0
30532,1,1,106951,106951,106952,0,1,0
30533,6,1,106957,106957,106958,0,1,5
30534,2,2,106959,106959,106961,0,2,1
30535,5,2,106964,106964,106966,0,2,3
30536,2,3,106966,106966,106969,0,3,0
30537,2,3,106968,106969,106972,1,4,0
30538,4,2,106972,106972,106974,0,2,0
30539,6,1,106978,106978,106979,0,1,4
30540,5,3,106983,106983,106986,0,3,4
30541,2,3,106985,106986,106989,1,4,0
30542,6,3,106991,106991,106994,0,3,2
30543,6,3,106997,106997,107000,0,3,3
30544,2,3,106999,107000,107003,1,4,0
30545,6,2,107005,107005,107007,0,2,2
30546,4,1,107009,107009,107010,0,1,2
30547,2,3,107011,107011,107014,0,3,1
30548,1,3,107012,107014,107017,2,5,0
30549,1,1,107013,107017,107018,4,5,0
30550,1,3,107014,107018,107021,4,7,0
30551,6,3,107020,107021,107024,1,4,0
30552,4,3,107024,107024,107027,0,3,0
30553,3,3,107027,107027,107030,0,3,0
30554,1,1,107028,107030,107031,2,3,0
30555,1,3,107029,107031,107034,2,5,0
30556,2,1,107031,107034,107035,3,4,0
30557,1,3,107032,107035,107038,3,6,0
30558,5,3,107037,107038,107041,1,4,0
30559,6,2,107043,107043,107045,0,2,2
30560,6,2,107049,107049,107051,0,2,4
30561,6,2,107055,107055,107057,0,2,4
30562,3,3,107058,107058,107061,0,3,1
30563,5,2,107063,107063,107065,0,2,2
30564,4,2,107067,107067,107069,0,2,2
30565,3,1,107070,107070,107071,0,1,1
30566,5,1,107075,107075,107076,0,1,4
30567,1,3,107076,107076,107079,0,3,0
30568,5,3,107081,107081,107084,0,3,2
30569,6,1,107087,107087,107088,0,1,3
30570,4,2,107091,107091,107093,0,2,3
30571,2,3,107093,107093,107096,0,3,0
30572,4,2,107097,107097,107099,0,2,1
30573,2,3,107099,107099,107102,0,3,0
30574,1,3,107100,107102,107105,2,5,0
30575,5,2,107105,107105,107107,0,2,0
30576,1,3,107106,107107,107110,1,4,0
30577,3,1,107109,107110,107111,1,2,0
30578,3,1,107112,107112,107113,0,1,1
30579,1,2,107113,107113,107115,0,2,0
30580,3,3,107116,107116,107119,0,3,1
30581,2,2,107118,107119,107121,1,3,0
30582,5,2,107123,107123,107125,0,2,2
30583,1,1,107124,107125,107126,1,2,0
30584,1,2,107125,107126,107128,1,3,0
30585,2,2,107127,107128,107130,1,3,0
30586,3,3,107130,107130,107133,0,3,0
30587,4,1,107134,107134,107135,0,1,1
30588,2,1,107136,107136,107137,0,1,1
30589,4,2,107140,107140,107142,0,2,3
30590,5,3,107145,107145,107148,0,3,3
30591,5,2,107150,107150,107152,0,2,2
30592,5,3,107155,107155,107158,0,3,3
30593,3,1,107158,107158,107159,0,1,0
30594,6,1,107164,107164,107165,0,1,5
30595,2,3,107166,107166,107169,0,3,1
30596,5,2,107171,107171,107173,0,2,2
30597,5,1,107176,107176,107177,0,1,3
30598,4,2,107180,107180,107182,0,2,3
30599,2,2,107182,107182,107184,0,2,0
30600,5,2,107187,107187,107189,0,2,3
30601,5,3,107192,107192,107195,0,3,3
30602,1,3,107193,107195,107198,2,5,0
30603,2,1,107195,107198,107199,3,4,0
30604,6,1,107201,107201,107202,0,1,2
30605,1,3,107202,107202,107205,0,3,0
30606,2,1,107204,107205,107206,1,2,0
30607,3,3,107207,107207,107210,0,3,1
30608,2,3,107209,107210,107213,1,4,0
30609,5,3,107214,107214,107217,0,3,1
30610,4,1,107218,107218,107219,0,1,1
30611,4,3,107222,107222,107225,0,3,3
30612,6,1,107228,107228,107229,0,1,3
30613,3,2,107231,107231,107233,0,2,2
30614,1,2,107232,107233,107235,1,3,0
30615,3,1,107235,107235,107236,0,1,0
30616,5,3,107240,107240,107243,0,3,4
30617,6,1,107246,107246,107247,0,1,3
30618,2,2,107248,107248,107250,0,2,1
30619,3,3,107251,107251,107254,0,3,1
30620,4,2,107255,107255,107257,0,2,1
30621,5,2,107260,107260,107262,0,2,3
30622,6,2,107266,107266,107268,0,2,4
30623,2,1,107268,107268,107269,0,1,0
30624,6,3,107274,107274,107277,0,3,5
30625,4,3,107278,107278,107281,0,3,1
30626,2,1,107280,107281,107282,1,2,0
30627,6,1,107286,107286,107287,0,1,4
30628,3,1,107289,107289,107290,0,1,2
30629,4,2,107293,107293,107295,0,2,3
30630,2,1,107295,107295,107296,0,1,0
30631,5,1,107300,107300,107301,0,1,4
30632,1,3,107301,107301,107304,0,3,0
30633,3,2,107304,107304,107306,0,2,0
30634,2,1,107306,107306,107307,0,1,0
30635,6,1,107312,107312,107313,0,1,5
30636,6,1,107318,107318,107319,0,1,5
30637,1,2,107319,107319,107321,0,2,0
30638,6,2,107325,107325,107327,0,2,4
30639,4,3,107329,107329,107332,0,3,2
30640,2,1,107331,107332,107333,1,2,0
30641,4,3,107335,107335,107338,0,3,2
30642,3,1,107338,107338,107339,0,1,0
30643,1,1,107339,107339,107340,0,1,0
30644,1,2,107340,107340,107342,0,2,0
30645,1,1,107341,107342,107343,1,2,0
30646,2,1,107343,107343,107344,0,1,0
30647,1,1,107344,107344,107345,0,1,0
30648,5,1,107349,107349,107350,0,1,4
30649,4,2,107353,107353,107355,0,2,3
30650,2,2,107355,107355,107357,0,2,0
30651,5,2,107360,107360,107362,0,2,3
30652,4,3,107364,107364,107367,0,3,2
30653,5,2,107369,107369,107371,0,2,2
30654,2,2,107371,107371,107373,0,2,0
30655,1,1,107372,107373,107374,1,2,0
30656,4,3,107376,107376,107379,0,3,2
30657,4,1,107380,107380,107381,0,1,1
30658,1,1,107381,107381,107382,0,1,0
30659,1,3,107382,107382,107385,0,3,0
30660,6,3,107388,107388,107391,0,3,3
30661,4,2,107392,107392,107394,0,2,1
30662,4,1,107396,107396,107397,0,1,2
30663,2,3,107398,107398,107401,0,3,1
30664,1,2,107399,107401,107403,2,4,0
30665,5,2,107404,107404,107406,0,2,1
30666,5,1,107409,107409,107410,0,1,3
30667,6,2,107415,107415,107417,0,2,5
30668,2,1,107417,107417,107418,0,1,0
30669,1,3,107418,107418,107421,0,3,0
30670,1,2,107419,107421,107423,2,4,0
30671,6,1,107425,107425,107426,0,1,2
30672,3,1,107428,107428,107429,0,1,2
30673,5,1,107433,107433,107434,0,1,4
30674,6,1,107439,107439,107440,0,1,5
30675,2,2,107441,107441,107443,0,2,1
30676,5,3,107446,107446,107449,0,3,3
30677,4,2,107450,107450,107452,0,2,1
30678,6,1,107456,107456,107457,0,1,4
30679,1,2,107457,107457,107459,0,2,0
30680,6,3,107463,107463,107466,0,3,4
30681,3,2,107466,107466,107468,0,2,0
30682,2,1,107468,107468,107469,0,1,0
30683,4,1,107472,107472,107473,0,1,3
30684,3,2,107475,107475,107477,0,2,2
30685,5,1,107480,107480,107481,0,1,3
30686,1,3,107481,107481,107484,0,3,0
30687,3,3,107484,107484,107487,0,3,0
30688,1,1,107485,107487,107488,2,3,0
30689,1,3,107486,107488,107491,2,5,0
30690,6,1,107492,107492,107493,0,1,1
30691,5,3,107497,107497,107500,0,3,4
30692,4,2,107501,107501,107503,0,2,1
30693,2,1,107503,107503,107504,0,1,0
30694,2,1,107505,107505,107506,0,1,1
30695,1,2,107506,107506,107508,0,2,0
30696,3,2,107509,107509,107511,0,2,1
30697,4,2,107513,107513,107515,0,2,2
30698,4,1,107517,107517,107518,0,1,2
30699,6,2,107523,107523,107525,0,2,5
30700,6,3,107529,107529,107532,0,3,4
30701,6,1,107535,107535,107536,0,1,3
30702,5,3,107540,107540,107543,0,3,4
30703,6,2,107546,107546,107548,0,2,3
30704,4,3,107550,107550,107553,0,3,2
30705,2,3,107552,107553,107556,1,4,0
30706,3,3,107555,107556,107559,1,4,0
30707,1,3,107556,107559,107562,3,6,0
30708,4,1,107560,107562,107563,2,3,0
30709,6,3,107566,107566,107569,0,3,3
30710,3,3,107569,107569,107572,0,3,0
30711,2,3,107571,107572,107575,1,4,0
30712,4,1,107575,107575,107576,0,1,0
30713,3,1,107578,107578,107579,0,1,2
30714,4,3,107582,107582,107585,0,3,3
30715,6,3,107588,107588,107591,0,3,3
30716,2,1,107590,107591,107592,1,2,0
30717,3,2,107593,107593,107595,0,2,1
30718,3,3,107596,107596,107599,0,3,1
30719,3,1,107599,107599,107600,0,1,0
30720,4,3,107603,107603,107606,0,3,3
30721,4,1,107607,107607,107608,0,1,1
30722,2,3,107609,107609,107612,0,3,1
30723,3,1,107612,107612,107613,0,1,0
30724,5,2,107617,107617,107619,0,2,4
30725,3,3,107620,107620,107623,0,3,1
30726,3,2,107623,107623,107625,0,2,0
30727,4,3,107627,107627,107630,0,3,2
30728,2,2,107629,107630,107632,1,3,0
30729,5,2,107634,107634,107636,0,2,2
30730,5,1,107639,107639,107640,0,1,3
30731,3,1,107642,107642,107643,0,1,2
30732,2,3,107644,107644,107647,0,3,1
30733,3,3,107647,107647,107650,0,3,0
30734,5,1,107652,107652,107653,0,1,2
30735,5,1,107657,107657,107658,0,1,4
30736,2,2,107659,107659,107661,0,2,1
30737,4,1,107663,107663,107664,0,1,2
30738,2,3,107665,107665,107668,0,3,1
30739,2,1,107667,107668,107669,1,2,0
30740,6,1,107673,107673,107674,0,1,4
30741,2,3,107675,107675,107678,0,3,1
30742,4,2,107679,107679,107681,0,2,1
30743,4,1,107683,107683,107684,0,1,2
30744,5,1,107688,107688,107689,0,1,4
30745,4,2,107692,107692,107694,0,2,3
30746,3,2,107695,107695,107697,0,2,1
30747,4,1,107699,107699,107700,0,1,2
30748,4,1,107703,107703,107704,0,1,3
30749,5,1,107708,107708,107709,0,1,4
30750,5,2,107713,107713,107715,0,2,4
30751,2,1,107715,107715,107716,0,1,0
30752,1,1,107716,107716,107717,0,1,0
30753,3,1,107719,107719,107720,0,1,2
30754,1,1,107720,107720,107721,0,1,0
30755,2,3,107722,107722,107725,0,3,1
30756,2,2,107724,107725,107727,1,3,0
30757,2,3,107726,107727,107730,1,4,0
30758,2,3,107728,107730,107733,2,5,0
30759,3,2,107731,107733,107735,2,4,0
30760,5,1,107736,107736,107737,0,1,1
30761,3,2,107739,107739,107741,0,2,2
30762,2,1,107741,107741,107742,0,1,0
30763,6,1,107747,107747,107748,0,1,5
30764,5,1,107752,107752,107753,0,1,4
30765,2,3,107754,107754,107757,0,3,1
30766,6,1,107760,107760,107761,0,1,3
30767,6,2,107766,107766,107768,0,2,5
30768,4,2,107770,107770,107772,0,2,2
30769,6,3,107776,107776,107779,0,3,4
30770,2,3,107778,107779,107782,1,4,0
30771,5,3,107783,107783,107786,0,3,1
30772,6,1,107789,107789,107790,0,1,3
30773,5,2,107794,107794,107796,0,2,4
30774,2,2,107796,107796,107798,0,2,0
30775,4,2,107800,107800,107802,0,2,2
30776,4,1,107804,107804,107805,0,1,2
30777,2,3,107806,107806,107809,0,3,1
30778,6,1,107812,107812,107813,0,1,3
30779,5,1,107817,107817,107818,0,1,4
30780,5,1,107822,107822,107823,0,1,4
30781,3,2,107825,107825,107827,0,2,2
30782,2,3,107827,107827,107830,0,3,0
30783,1,2,107828,107830,107832,2,4,0
30784,2,3,107830,107832,107835,2,5,0
30785,5,2,107835,107835,107837,0,2,0
30786,5,1,107840,107840,107841,0,1,3
30787,3,2,107843,107843,107845,0,2,2
30788,2,3,107845,107845,107848,0,3,0
30789,1,3,107846,107848,107851,2,5,0
30790,2,2,107848,107851,107853,3,5,0
30791,5,3,107853,107853,107856,0,3,0
30792,2,1,107855,107856,107857,1,2,0
30793,4,1,107859,107859,107860,0,1,2
30794,3,3,107862,107862,107865,0,3,2
30795,1,3,107863,107865,107868,2,5,0
30796,5,2,107868,107868,107870,0,2,0
30797,3,3,107871,107871,107874,0,3,1
30798,6,3,107877,107877,107880,0,3,3
30799,5,1,107882,107882,107883,0,1,2
30800,5,2,107887,107887,107889,0,2,4
30801,1,1,107888,107889,107890,1,2,0
30802,4,3,107892,107892,107895,0,3,2
30803,6,2,107898,107898,107900,0,2,3
30804,4,1,107902,107902,107903,0,1,2
30805,1,2,107903,107903,107905,0,2,0
30806,6,3,107909,107909,107912,0,3,4
30807,6,1,107915,107915,107916,0,1,3
30808,5,1,107920,107920,107921,0,1,4
30809,6,3,107926,107926,107929,0,3,5
30810,5,2,107931,107931,107933,0,2,2
30811,6,2,107937,107937,107939,0,2,4
30812,3,1,107940,107940,107941,0,1,1
30813,5,2,107945,107945,107947,0,2,4
30814,5,3,107950,107950,107953,0,3,3
30815,5,2,107955,107955,107957,0,2,2
30816,1,3,107956,107957,107960,1,4,0
30817,6,1,107962,107962,107963,0,1,2
30818,1,1,107963,107963,107964,0,1,0
30819,2,1,107965,107965,107966,0,1,1
30820,5,3,107970,107970,107973,0,3,4
30821,2,1,107972,107973,107974,1,2,0
30822,1,2,107973,107974,107976,1,3,0
30823,6,1,107979,107979,107980,0,1,3
30824,5,2,107984,107984,107986,0,2,4
30825,6,2,107990,107990,107992,0,2,4
30826,3,2,107993,107993,107995,0,2,1
30827,1,2,107994,107995,107997,1,3,0
30828,5,2,107999,107999,108001,0,2,2
30829,3,2,108002,108002,108004,0,2,1
30830,1,3,108003,108004,108007,1,4,0
30831,2,1,108005,108007,108008,2,3,0
30832,4,3,108009,108009,108012,0,3,1
30833,1,1,108010,108012,108013,2,3,0
30834,2,2,108012,108013,108015,1,3,0
30835,5,3,108017,108017,108020,0,3,2
30836,6,2,108023,108023,108025,0,2,3
30837,1,2,108024,108025,108027,1,3,0
30838,6,2,108030,108030,108032,0,2,3
30839,5,2,108035,108035,108037,0,2,3
30840,3,1,108038,108038,108039,0,1,1
30841,1,3,108039,108039,108042,0,3,0
30842,4,2,108043,108043,108045,0,2,1
30843,1,3,108044,108045,108048,1,4,0
30844,1,2,108045,108048,108050,3,5,0
30845,1,2,108046,108050,108052,4,6,0
30846,2,2,108048,108052,108054,4,6,0
30847,5,1,108053,108054,108055,1,2,0
30848,4,3,108057,108057,108060,0,3,2
30849,1,1,108058,108060,108061,2,3,0
30850,4,2,108062,108062,108064,0,2,1
30851,5,1,108067,108067,108068,0,1,3
30852,4,2,108071,108071,108073,0,2,3
30853,4,3,108075,108075,108078,0,3,2
30854,4,1,108079,108079,108080,0,1,1
30855,2,3,108081,108081,108084,0,3,1
30856,5,1,108086,108086,108087,0,1,2
30857,4,2,108090,108090,108092,0,2,3
30858,2,1,108092,108092,108093,0,1,0
30859,6,2,108098,108098,108100,0,2,5
30860,2,1,108100,108100,108101,0,1,0
30861,6,1,108106,108106,108107,0,1,5
30862,6,2,108112,108112,108114,0,2,5
30863,2,2,108114,108114,108116,0,2,0
30864,6,1,108120,108120,108121,0,1,4
30865,1,3,108121,108121,108124,0,3,0
30866,4,2,108125,108125,108127,0,2,1
30867,4,1,108129,108129,108130,0,1,2
30868,2,3,108131,108131,108134,0,3,1
30869,5,3,108136,108136,108139,0,3,2
30870,4,2,108140,108140,108142,0,2,1
30871,6,2,108146,108146,108148,0,2,4
30872,5,2,108151,108151,108153,0,2,3
30873,1,3,108152,108153,108156,1,4,0
30874,1,1,108153,108156,108157,3,4,0
30875,5,2,108158,108158,108160,0,2,1
30876,5,2,108163,108163,108165,0,2,3
30877,4,1,108167,108167,108168,0,1,2
30878,4,2,108171,108171,108173,0,2,3
30879,4,2,108175,108175,108177,0,2,2
30880,1,3,108176,108177,108180,1,4,0
30881,5,3,108181,108181,108184,0,3,1
30882,1,3,108182,108184,108187,2,5,0
30883,1,3,108183,108187,108190,4,7,0
30884,1,3,108184,108190,108193,6,9,0
30885,5,1,108189,108193,108194,4,5,0
30886,4,3,108193,108194,108197,1,4,0
30887,5,1,108198,108198,108199,0,1,1
30888,1,1,108199,108199,108200,0,1,0
30889,2,1,108201,108201,108202,0,1,1
30890,5,2,108206,108206,108208,0,2,4
30891,5,1,108211,108211,108212,0,1,3
30892,3,2,108214,108214,108216,0,2,2
30893,3,2,108217,108217,108219,0,2,1
30894,5,1,108222,108222,108223,0,1,3
30895,4,3,108226,108226,108229,0,3,3
30896,4,2,108230,108230,108232,0,2,1
30897,6,2,108236,108236,108238,0,2,4
30898,3,1,108239,108239,108240,0,1,1
30899,1,1,108240,108240,108241,0,1,0
30900,1,2,108241,108241,108243,0,2,0
30901,3,3,108244,108244,108247,0,3,1
30902,3,1,108247,108247,108248,0,1,0
30903,1,3,108248,108248,108251,0,3,0
30904,1,3,108249,108251,108254,2,5,0
30905,4,2,108253,108254,108256,1,3,0
30906,6,3,108259,108259,108262,0,3,3
30907,4,2,108263,108263,108265,0,2,1
30908,5,2,108268,108268,108270,0,2,3
30909,2,1,108270,108270,108271,0,1,0
30910,1,3,108271,108271,108274,0,3,0
30911,2,2,108273,108274,108276,1,3,0
30912,6,1,108279,108279,108280,0,1,3
30913,6,2,108285,108285,108287,0,2,5
30914,4,1,108289,108289,108290,0,1,2
30915,6,1,108295,108295,108296,0,1,5
30916,5,1,108300,108300,108301,0,1,4
30917,1,3,108301,108301,108304,0,3,0
30918,2,2,108303,108304,108306,1,3,0
30919,1,3,108304,108306,108309,2,5,0
30920,6,1,108310,108310,108311,0,1,1
30921,3,1,108313,108313,108314,0,1,2
30922,4,2,108317,108317,108319,0,2,3
30923,6,3,108323,108323,108326,0,3,4
30924,4,2,108327,108327,108329,0,2,1
30925,6,3,108333,108333,108336,0,3,4
30926,4,3,108337,108337,108340,0,3,1
30927,1,2,108338,108340,108342,2,4,0
30928,1,2,108339,108342,108344,3,5,0
30929,1,1,108340,108344,108345,4,5,0
30930,3,2,108343,108345,108347,2,4,0
30931,2,3,108345,108347,108350,2,5,0
30932,4,2,108349,108350,108352,1,3,0
30933,1,3,108350,108352,108355,2,5,0
30934,3,3,108353,108355,108358,2,5,0
30935,1,2,108354,108358,108360,4,6,0
30936,6,2,108360,108360,108362,0,2,0
30937,3,1,108363,108363,108364,0,1,1
30938,3,2,108366,108366,108368,0,2,2
30939,1,3,108367,108368,108371,1,4,0
30940,5,3,108372,108372,108375,0,3,1
30941,4,3,108376,108376,108379,0,3,1
30942,5,1,108381,108381,108382,0,1,2
30943,2,1,108383,108383,108384,0,1,1
30944,3,2,108386,108386,108388,0,2,2
30945,1,2,108387,108388,108390,1,3,0
30946,6,3,108393,108393,108396,0,3,3
30947,4,3,108397,108397,108400,0,3,1
30948,3,2,108400,108400,108402,0,2,0
30949,6,1,108406,108406,108407,0,1,4
30950,2,3,108408,108408,108411,0,3,1
30951,1,3,108409,108411,108414,2,5,0
30952,4,2,108413,108414,108416,1,3,0
30953,2,1,108415,108416,108417,1,2,0
30954,1,1,108416,108417,108418,1,2,0
30955,6,1,108422,108422,108423,0,1,4
30956,5,1,108427,108427,108428,0,1,4
30957,6,1,108433,108433,108434,0,1,5
30958,1,3,108434,108434,108437,0,3,0
30959,5,1,108439,108439,108440,0,1,2
30960,1,3,108440,108440,108443,0,3,0
30961,6,3,108446,108446,108449,0,3,3
30962,5,1,108451,108451,108452,0,1,2
30963,1,2,108452,108452,108454,0,2,0
30964,5,2,108457,108457,108459,0,2,3
30965,1,2,108458,108459,108461,1,3,0
30966,4,1,108462,108462,108463,0,1,1
30967,3,2,108465,108465,108467,0,2,2
30968,5,2,108470,108470,108472,0,2,3
30969,3,1,108473,108473,108474,0,1,1
30970,6,3,108479,108479,108482,0,3,5
30971,5,3,108484,108484,108487,0,3,2
30972,5,1,108489,108489,108490,0,1,2
30973,5,2,108494,108494,108496,0,2,4
30974,5,2,108499,108499,108501,0,2,3
30975,6,3,108505,108505,108508,0,3,4
30976,5,3,108510,108510,108513,0,3,2
30977,4,1,108514,108514,108515,0,1,1
30978,1,3,108515,108515,108518,0,3,0
30979,4,1,108519,108519,108520,0,1,1
30980,6,3,108525,108525,108528,0,3,5
30981,2,1,108527,108528,108529,1,2,0
30982,3,1,108530,108530,108531,0,1,1
30983,2,3,108532,108532,108535,0,3,1
30984,4,3,108536,108536,108539,0,3,1
30985,5,3,108541,108541,108544,0,3,2
30986,1,3,108542,108544,108547,2,5,0
30987,2,3,108544,108547,108550,3,6,0
30988,1,1,108545,108550,108551,5,6,0
30989,6,3,108551,108551,108554,0,3,0
30990,1,2,108552,108554,108556,2,4,0
30991,4,3,108556,108556,108559,0,3,0
30992,2,2,108558,108559,108561,1,3,0
30993,2,3,108560,108561,108564,1,4,0
30994,3,2,108563,108564,108566,1,3,0
30995,6,3,108569,108569,108572,0,3,3
30996,5,1,108574,108574,108575,0,1,2
30997,6,1,108580,108580,108581,0,1,5
30998,3,2,108583,108583,108585,0,2,2
30999,6,3,108589,108589,108592,0,3,4
31000,1,3,108590,108592,108595,2,5,0
31001,6,2,108596,108596,108598,0,2,1
31002,4,2,108600,108600,108602,0,2,2
31003,2,3,108602,108602,108605,0,3,0
31004,1,1,108603,108605,108606,2,3,0
31005,5,2,108608,108608,108610,0,2,2
31006,1,3,108609,108610,108613,1,4,0
31007,2,1,108611,108613,108614,2,3,0
31008,3,3,108614,108614,108617,0,3,0
31009,4,1,108618,108618,108619,0,1,1
31010,4,3,108622,108622,108625,0,3,3
31011,4,2,108626,108626,108628,0,2,1
31012,5,1,108631,108631,108632,0,1,3
31013,3,3,108634,108634,108637,0,3,2
31014,3,2,108637,108637,108639,0,2,0
31015,1,1,108638,108639,108640,1,2,0
31016,1,2,108639,108640,108642,1,3,0
31017,4,3,108643,108643,108646,0,3,1
31018,4,1,108647,108647,108648,0,1,1
31019,4,1,108651,108651,108652,0,1,3
31020,1,2,108652,108652,108654,0,2,0
31021,4,2,108656,108656,108658,0,2,2
31022,3,3,108659,108659,108662,0,3,1
31023,4,2,108663,108663,108665,0,2,1
31024,2,1,108665,108665,108666,0,1,0
31025,1,3,108666,108666,108669,0,3,0
31026,1,1,108667,108669,108670,2,3,0
31027,5,2,108672,108672,108674,0,2,2
31028,3,3,108675,108675,108678,0,3,1
31029,3,3,108678,108678,108681,0,3,0
31030,3,2,108681,108681,108683,0,2,0
31031,2,3,108683,108683,108686,0,3,0
31032,1,1,108684,108686,108687,2,3,0
31033,4,3,108688,108688,108691,0,3,1
31034,3,2,108691,108691,108693,0,2,0
31035,4,2,108695,108695,108697,0,2,2
31036,1,2,108696,108697,108699,1,3,0
31037,6,1,108702,108702,108703,0,1,3
31038,5,1,108707,108707,108708,0,1,4
31039,4,2,108711,108711,108713,0,2,3
31040,2,1,108713,108713,108714,0,1,0
31041,2,3,108715,108715,108718,0,3,1
31042,2,3,108717,108718,108721,1,4,0
31043,2,2,108719,108721,108723,2,4,0
31044,5,3,108724,108724,108727,0,3,1
31045,6,2,108730,108730,108732,0,2,3
31046,6,1,108736,108736,108737,0,1,4
31047,5,1,108741,108741,108742,0,1,4
31048,1,1,108742,108742,108743,0,1,0
31049,3,2,108745,108745,108747,0,2,2
31050,1,2,108746,108747,108749,1,3,0
31051,6,1,108752,108752,108753,0,1,3
31052,2,3,108754,108754,108757,0,3,1
31053,2,3,108756,108757,108760,1,4,0
31054,3,2,108759,108760,108762,1,3,0
31055,3,1,108762,108762,108763,0,1,0
31056,4,1,108766,108766,108767,0,1,3
31057,2,3,108768,108768,108771,0,3,1
31058,2,3,108770,108771,108774,1,4,0
31059,3,3,108773,108774,108777,1,4,0
31060,3,2,108776,108777,108779,1,3,0
31061,1,1,108777,108779,108780,2,3,0
31062,2,1,108779,108780,108781,1,2,0
31063,3,3,108782,108782,108785,0,3,1
31064,6,2,108788,108788,108790,0,2,3
31065,5,1,108793,108793,108794,0,1,3
31066,5,1,108798,108798,108799,0,1,4
31067,2,1,108800,108800,108801,0,1,1
31068,3,2,108803,108803,108805,0,2,2
31069,1,1,108804,108805,108806,1,2,0
31070,5,2,108809,108809,108811,0,2,3
31071,2,1,108811,108811,108812,0,1,0
31072,5,3,108816,108816,108819,0,3,4
31073,1,1,108817,108819,108820,2,3,0
31074,1,2,108818,108820,108822,2,4,0
31075,5,1,108823,108823,108824,0,1,1
31076,1,2,108824,108824,108826,0,2,0
31077,3,3,108827,108827,108830,0,3,1
31078,4,3,108831,108831,108834,0,3,1
31079,3,2,108834,108834,108836,0,2,0
31080,4,3,108838,108838,108841,0,3,2
31081,6,3,108844,108844,108847,0,3,3
31082,3,3,108847,108847,108850,0,3,0
31083,5,1,108852,108852,108853,0,1,2
31084,4,2,108856,108856,108858,0,2,3
31085,5,1,108861,108861,108862,0,1,3
31086,2,3,108863,108863,108866,0,3,1
31087,3,3,108866,108866,108869,0,3,0
31088,5,2,108871,108871,108873,0,2,2
31089,5,1,108876,108876,108877,0,1,3
31090,6,1,108882,108882,108883,0,1,5
31091,4,1,108886,108886,108887,0,1,3
31092,5,1,108891,108891,108892,0,1,4
31093,1,3,108892,108892,108895,0,3,0
31094,6,3,108898,108898,108901,0,3,3
31095,2,3,108900,108901,108904,1,4,0
31096,3,3,108903,108904,108907,1,4,0
31097,3,1,108906,108907,108908,1,2,0
31098,3,2,108909,108909,108911,0,2,1
31099,2,3,108911,108911,108914,0,3,0
31100,1,2,108912,108914,108916,2,4,0
31101,1,1,108913,108916,108917,3,4,0
31102,6,1,108919,108919,108920,0,1,2
31103,3,1,108922,108922,108923,0,1,2
31104,1,1,108923,108923,108924,0,1,0
31105,2,2,108925,108925,108927,0,2,1
31106,2,3,108927,108927,108930,0,3,0
31107,2,1,108929,108930,108931,1,2,0
31108,2,1,108931,108931,108932,0,1,0
31109,2,2,108933,108933,108935,0,2,1
31110,4,2,108937,108937,108939,0,2,2
31111,2,3,108939,108939,108942,0,3,0
31112,6,2,108945,108945,108947,0,2,3
31113,2,1,108947,108947,108948,0,1,0
31114,1,1,108948,108948,108949,0,1,0
31115,2,3,108950,108950,108953,0,3,1
31116,5,1,108955,108955,108956,0,1,2
31117,2,3,108957,108957,108960,0,3,1
31118,5,1,108962,108962,108963,0,1,2
31119,3,2,108965,108965,108967,0,2,2
31120,4,2,108969,108969,108971,0,2,2
31121,1,2,108970,108971,108973,1,3,0
31122,5,3,108975,108975,108978,0,3,2
31123,5,1,108980,108980,108981,0,1,2
31124,1,1,108981,108981,108982,0,1,0
31125,1,2,108982,108982,108984,0,2,0
31126,1,2,108983,108984,108986,1,3,0
31127,5,1,108988,108988,108989,0,1,2
31128,1,3,108989,108989,108992,0,3,0
31129,6,2,108995,108995,108997,0,2,3
31130,2,3,108997,108997,109000,0,3,0
31131,3,3,109000,109000,109003,0,3,0
31132,1,1,109001,109003,109004,2,3,0
31133,4,3,109005,109005,109008,0,3,1
31134,6,1,109011,109011,109012,0,1,3
31135,3,2,109014,109014,109016,0,2,2
31136,3,2,109017,109017,109019,0,2,1
31137,5,1,109022,109022,109023,0,1,3
31138,5,1,109027,109027,109028,0,1,4
31139,6,1,109033,109033,109034,0,1,5
31140,1,1,109034,109034,109035,0,1,0
31141,1,3,109035,109035,109038,0,3,0
31142,5,3,109040,109040,109043,0,3,2
31143,5,2,109045,109045,109047,0,2,2
31144,4,3,109049,109049,109052,0,3,2
31145,4,2,109053,109053,109055,0,2,1
31146,3,3,109056,109056,109059,0,3,1
31147,3,3,109059,109059,109062,0,3,0
31148,1,1,109060,109062,109063,2,3,0
31149,2,3,109062,109063,109066,1,4,0
31150,4,3,109066,109066,109069,0,3,0
31151,4,3,109070,109070,109073,0,3,1
31152,1,3,109071,109073,109076,2,5,0
31153,2,1,109073,109076,109077,3,4,0
31154,4,1,109077,109077,109078,0,1,0
31155,2,2,109079,109079,109081,0,2,1
31156,5,3,109084,109084,109087,0,3,3
31157,1,3,109085,109087,109090,2,5,0
31158,1,2,109086,109090,109092,4,6,0
31159,1,1,109087,109092,109093,5,6,0
31160,6,2,109093,109093,109095,0,2,0
31161,5,2,109098,109098,109100,0,2,3
31162,6,2,109104,109104,109106,0,2,4
31163,4,1,109108,109108,109109,0,1,2
31164,1,3,109109,109109,109112,0,3,0
31165,3,2,109112,109112,109114,0,2,0
31166,3,1,109115,109115,109116,0,1,1
31167,2,2,109117,109117,109119,0,2,1
31168,4,3,109121,109121,109124,0,3,2
31169,1,2,109122,109124,109126,2,4,0
31170,1,2,109123,109126,109128,3,5,0
31171,2,1,109125,109128,109129,3,4,0
31172,2,1,109127,109129,109130,2,3,0
31173,6,1,109133,109133,109134,0,1,3
31174,4,1,109137,109137,109138,0,1,3
31175,5,1,109142,109142,109143,0,1,4
31176,5,3,109147,109147,109150,0,3,4
31177,1,3,109148,109150,109153,2,5,0
31178,4,1,109152,109153,109154,1,2,0
31179,2,1,109154,109154,109155,0,1,0
31180,1,2,109155,109155,109157,0,2,0
31181,6,2,109161,109161,109163,0,2,4
31182,6,2,109167,109167,109169,0,2,4
31183,3,1,109170,109170,109171,0,1,1
31184,5,1,109175,109175,109176,0,1,4
31185,3,1,109178,109178,109179,0,1,2
31186,2,3,109180,109180,109183,0,3,1
31187,6,2,109186,109186,109188,0,2,3
31188,6,2,109192,109192,109194,0,2,4
31189,3,3,109195,109195,109198,0,3,1
31190,1,2,109196,109198,109200,2,4,0
31191,6,3,109202,109202,109205,0,3,2
31192,3,2,109205,109205,109207,0,2,0
31193,6,2,109211,109211,109213,0,2,4
31194,5,1,109216,109216,109217,0,1,3
31195,5,3,109221,109221,109224,0,3,4
31196,3,1,109224,109224,109225,0,1,0
31197,2,1,109226,109226,109227,0,1,1
31198,5,2,109231,109231,109233,0,2,4
31199,6,3,109237,109237,109240,0,3,4
31200,4,2,109241,109241,109243,0,2,1
31201,6,1,109247,109247,109248,0,1,4
31202,1,1,109248,109248,109249,0,1,0
31203,3,3,109251,109251,109254,0,3,2
31204,6,2,109257,109257,109259,0,2,3
31205,5,2,109262,109262,109264,0,2,3
31206,3,1,109265,109265,109266,0,1,1
31207,5,1,109270,109270,109271,0,1,4
31208,1,1,109271,109271,109272,0,1,0
31209,1,2,109272,109272,109274,0,2,0
31210,1,3,109273,109274,109277,1,4,0
31211,6,3,109279,109279,109282,0,3,2
31212,6,3,109285,109285,109288,0,3,3
31213,3,3,109288,109288,109291,0,3,0
31214,6,2,109294,109294,109296,0,2,3
31215,3,1,109297,109297,109298,0,1,1
31216,5,1,109302,109302,109303,0,1,4
31217,5,3,109307,109307,109310,0,3,4
31218,1,1,109308,109310,109311,2,3,0
31219,5,1,109313,109313,109314,0,1,2
31220,3,3,109316,109316,109319,0,3,2
31221,3,2,109319,109319,109321,0,2,0
31222,2,2,109321,109321,109323,0,2,0
31223,2,1,109323,109323,109324,0,1,0
31224,6,2,109329,109329,109331,0,2,5
31225,4,2,109333,109333,109335,0,2,2
31226,6,3,109339,109339,109342,0,3,4
31227,5,3,109344,109344,109347,0,3,2
31228,5,1,109349,109349,109350,0,1,2
31229,1,1,109350,109350,109351,0,1,0
31230,1,2,109351,109351,109353,0,2,0
31231,5,1,109356,109356,109357,0,1,3
31232,4,3,109360,109360,109363,0,3,3
31233,6,3,109366,109366,109369,0,3,3
31234,3,3,109369,109369,109372,0,3,0
31235,6,1,109375,109375,109376,0,1,3
31236,5,3,109380,109380,109383,0,3,4
31237,6,3,109386,109386,109389,0,3,3
31238,6,1,109392,109392,109393,0,1,3
31239,3,3,109395,109395,109398,0,3,2
31240,3,3,109398,109398,109401,0,3,0
31241,6,1,109404,109404,109405,0,1,3
31242,2,1,109406,109406,109407,0,1,1
31243,1,3,109407,109407,109410,0,3,0
31244,1,3,109408,109410,109413,2,5,0
31245,3,2,109411,109413,109415,2,4,0
31246,4,3,109415,109415,109418,0,3,0
31247,6,1,109421,109421,109422,0,1,3
31248,3,1,109424,109424,109425,0,1,2
31249,5,1,109429,109429,109430,0,1,4
31250,5,3,109434,109434,109437,0,3,4
31251,2,1,109436,109437,109438,1,2,0
31252,3,3,109439,109439,109442,0,3,1
31253,4,1,109443,109443,109444,0,1,1
31254,6,1,109449,109449,109450,0,1,5
31255,4,1,109453,109453,109454,0,1,3
31256,6,2,109459,109459,109461,0,2,5
31257,1,3,109460,109461,109464,1,4,0
31258,4,3,109464,109464,109467,0,3,0
31259,3,3,109467,109467,109470,0,3,0
31260,3,3,109470,109470,109473,0,3,0
31261,6,2,109476,109476,109478,0,2,3
31262,5,1,109481,109481,109482,0,1,3
31263,6,2,109487,109487,109489,0,2,5
31264,2,1,109489,109489,109490,0,1,0
31265,1,3,109490,109490,109493,0,3,0
31266,3,2,109493,109493,109495,0,2,0
31267,3,1,109496,109496,109497,0,1,1
31268,6,2,109502,109502,109504,0,2,5
31269,1,2,109503,109504,109506,1,3,0
31270,5,2,109508,109508,109510,0,2,2
31271,3,1,109511,109511,109512,0,1,1
31272,4,3,109515,109515,109518,0,3,3
31273,3,1,109518,109518,109519,0,1,0
31274,6,1,109524,109524,109525,0,1,5
31275,1,3,109525,109525,109528,0,3,0
31276,5,3,109530,109530,109533,0,3,2
31277,3,3,109533,109533,109536,0,3,0
31278,6,1,109539,109539,109540,0,1,3
31279,3,3,109542,109542,109545,0,3,2
31280,4,3,109546,109546,109549,0,3,1
31281,6,3,109552,109552,109555,0,3,3
31282,5,1,109557,109557,109558,0,1,2
31283,3,1,109560,109560,109561,0,1,2
31284,4,2,109564,109564,109566,0,2,3
31285,4,3,109568,109568,109571,0,3,2
31286,6,3,109574,109574,109577,0,3,3
31287,6,1,109580,109580,109581,0,1,3
31288,5,3,109585,109585,109588,0,3,4
31289,2,2,109587,109588,109590,1,3,0
31290,6,1,109593,109593,109594,0,1,3
31291,3,1,109596,109596,109597,0,1,2
31292,5,1,109601,109601,109602,0,1,4
31293,2,2,109603,109603,109605,0,2,1
31294,2,1,109605,109605,109606,0,1,0
31295,1,2,109606,109606,109608,0,2,0
31296,2,3,109608,109608,109611,0,3,0
31297,5,1,109613,109613,109614,0,1,2
31298,4,3,109617,109617,109620,0,3,3
31299,3,2,109620,109620,109622,0,2,0
31300,6,2,109626,109626,109628,0,2,4
31301,6,3,109632,109632,109635,0,3,4
31302,2,1,109634,109635,109636,1,2,0
31303,1,3,109635,109636,109639,1,4,0
31304,1,3,109636,109639,109642,3,6,0
31305,6,2,109642,109642,109644,0,2,0
31306,5,1,109647,109647,109648,0,1,3
31307,1,2,109648,109648,109650,0,2,0
31308,2,2,109650,109650,109652,0,2,0
31309,5,1,109655,109655,109656,0,1,3
31310,3,1,109658,109658,109659,0,1,2
31311,6,2,109664,109664,109666,0,2,5
31312,3,2,109667,109667,109669,0,2,1
31313,6,2,109673,109673,109675,0,2,4
31314,2,1,109675,109675,109676,0,1,0
31315,2,2,109677,109677,109679,0,2,1
31316,1,2,109678,109679,109681,1,3,0
31317,6,2,109684,109684,109686,0,2,3
31318,4,3,109688,109688,109691,0,3,2
31319,6,3,109694,109694,109697,0,3,3
31320,2,3,109696,109697,109700,1,4,0
31321,2,2,109698,109700,109702,2,4,0
31322,6,1,109704,109704,109705,0,1,2
31323,2,3,109706,109706,109709,0,3,1
31324,2,2,109708,109709,109711,1,3,0
31325,2,2,109710,109711,109713,1,3,0
31326,1,2,109711,109713,109715,2,4,0
31327,1,1,109712,109715,109716,3,4,0
31328,5,1,109717,109717,109718,0,1,1
31329,3,1,109720,109720,109721,0,1,2
31330,1,1,109721,109721,109722,0,1,0
31331,3,3,109724,109724,109727,0,3,2
31332,1,3,109725,109727,109730,2,5,0
31333,4,2,109729,109730,109732,1,3,0
31334,5,1,109734,109734,109735,0,1,2
31335,6,2,109740,109740,109742,0,2,5
31336,2,3,109742,109742,109745,0,3,0
31337,3,1,109745,109745,109746,0,1,0
31338,4,2,109749,109749,109751,0,2,3
31339,2,3,109751,109751,109754,0,3,0
31340,4,3,109755,109755,109758,0,3,1
31341,2,3,109757,109758,109761,1,4,0
31342,1,2,109758,109761,109763,3,5,0
31343,3,2,109761,109763,109765,2,4,0
31344,2,3,109763,109765,109768,2,5,0
31345,1,1,109764,109768,109769,4,5,0
31346,2,1,109766,109769,109770,3,4,0
31347,2,1,109768,109770,109771,2,3,0
31348,4,2,109772,109772,109774,0,2,1
31349,6,2,109778,109778,109780,0,2,4
31350,5,3,109783,109783,109786,0,3,3
31351,6,3,109789,109789,109792,0,3,3
31352,1,3,109790,109792,109795,2,5,0
31353,2,3,109792,109795,109798,3,6,0
31354,1,1,109793,109798,109799,5,6,0
31355,3,3,109796,109799,109802,3,6,0
31356,2,1,109798,109802,109803,4,5,0
31357,6,3,109804,109804,109807,0,3,1
31358,5,3,109809,109809,109812,0,3,2
31359,5,2,109814,109814,109816,0,2,2
31360,1,3,109815,109816,109819,1,4,0
31361,3,3,109818,109819,109822,1,4,0
31362,2,2,109820,109822,109824,2,4,0
31363,6,2,109826,109826,109828,0,2,2
31364,3,2,109829,109829,109831,0,2,1
31365,2,3,109831,109831,109834,0,3,0
31366,1,2,109832,109834,109836,2,4,0
31367,2,3,109834,109836,109839,2,5,0
31368,1,3,109835,109839,109842,4,7,0
31369,6,3,109841,109842,109845,1,4,0
31370,1,1,109842,109845,109846,3,4,0
31371,3,2,109845,109846,109848,1,3,0
31372,4,3,109849,109849,109852,0,3,1
31373,3,3,109852,109852,109855,0,3,0
31374,3,1,109855,109855,109856,0,1,0
31375,4,2,109859,109859,109861,0,2,3
31376,3,2,109862,109862,109864,0,2,1
31377,1,3,109863,109864,109867,1,4,0
31378,2,1,109865,109867,109868,2,3,0
31379,2,2,109867,109868,109870,1,3,0
31380,2,2,109869,109870,109872,1,3,0
31381,3,3,109872,109872,109875,0,3,0
31382,5,2,109877,109877,109879,0,2,2
31383,1,2,109878,109879,109881,1,3,0
31384,4,1,109882,109882,109883,0,1,1
31385,5,2,109887,109887,109889,0,2,4
31386,3,1,109890,109890,109891,0,1,1
31387,5,1,109895,109895,109896,0,1,4
31388,1,1,109896,109896,109897,0,1,0
31389,5,3,109901,109901,109904,0,3,4
31390,3,2,109904,109904,109906,0,2,0
31391,2,3,109906,109906,109909,0,3,0
31392,4,3,109910,109910,109913,0,3,1
31393,1,1,109911,109913,109914,2,3,0
31394,4,2,109915,109915,109917,0,2,1
31395,6,1,109921,109921,109922,0,1,4
31396,4,1,109925,109925,109926,0,1,3
31397,3,1,109928,109928,109929,0,1,2
31398,1,1,109929,109929,109930,0,1,0
31399,6,3,109935,109935,109938,0,3,5
31400,4,3,109939,109939,109942,0,3,1
31401,4,3,109943,109943,109946,0,3,1
31402,2,3,109945,109946,109949,1,4,0
31403,3,3,109948,109949,109952,1,4,0
31404,1,2,109949,109952,109954,3,5,0
31405,2,1,109951,109954,109955,3,4,0
31406,1,1,109952,109955,109956,3,4,0
31407,6,1,109958,109958,109959,0,1,2
31408,6,3,109964,109964,109967,0,3,5
31409,4,2,109968,109968,109970,0,2,1
31410,1,2,109969,109970,109972,1,3,0
31411,1,2,109970,109972,109974,2,4,0
31412,3,3,109973,109974,109977,1,4,0
31413,1,1,109974,109977,109978,3,4,0
31414,2,3,109976,109978,109981,2,5,0
31415,1,2,109977,109981,109983,4,6,0
31416,6,3,109983,109983,109986,0,3,0
31417,4,1,109987,109987,109988,0,1,1
31418,3,2,109990,109990,109992,0,2,2
31419,3,1,109993,109993,109994,0,1,1
31420,3,1,109996,109996,109997,0,1,2
31421,5,3,110001,110001,110004,0,3,4
31422,4,3,110005,110005,110008,0,3,1
31423,6,1,110011,110011,110012,0,1,3
31424,6,3,110017,110017,110020,0,3,5
31425,6,3,110023,110023,110026,0,3,3
31426,2,3,110025,110026,110029,1,4,0
31427,4,2,110029,110029,110031,0,2,0
31428,2,3,110031,110031,110034,0,3,0
31429,2,1,110033,110034,110035,1,2,0
31430,2,1,110035,110035,110036,0,1,0
31431,4,2,110039,110039,110041,0,2,3
31432,5,1,110044,110044,110045,0,1,3
31433,5,1,110049,110049,110050,0,1,4
31434,1,3,110050,110050,110053,0,3,0
31435,2,1,110052,110053,110054,1,2,0
31436,5,3,110057,110057,110060,0,3,3
31437,2,2,110059,110060,110062,1,3,0
31438,2,1,110061,110062,110063,1,2,0
31439,2,2,110063,110063,110065,0,2,0
31440,4,2,110067,110067,110069,0,2,2
31441,2,3,110069,110069,110072,0,3,0
31442,1,3,110070,110072,110075,2,5,0
31443,4,1,110074,110075,110076,1,2,0
31444,6,1,110080,110080,110081,0,1,4
31445,2,2,110082,110082,110084,0,2,1
31446,5,3,110087,110087,110090,0,3,3
31447,2,3,110089,110090,110093,1,4,0
31448,5,3,110094,110094,110097,0,3,1
31449,6,1,110100,110100,110101,0,1,3
31450,3,1,110103,110103,110104,0,1,2
31451,4,2,110107,110107,110109,0,2,3
31452,2,1,110109,110109,110110,0,1,0
31453,3,1,110112,110112,110113,0,1,2
31454,4,3,110116,110116,110119,0,3,3
31455,1,1,110117,110119,110120,2,3,0
31456,6,1,110123,110123,110124,0,1,3
31457,1,3,110124,110124,110127,0,3,0
31458,1,1,110125,110127,110128,2,3,0
31459,5,1,110130,110130,110131,0,1,2
31460,2,2,110132,110132,110134,0,2,1
31461,5,3,110137,110137,110140,0,3,3
31462,3,3,110140,110140,110143,0,3,0
31463,5,2,110145,110145,110147,0,2,2
31464,3,2,110148,110148,110150,0,2,1
31465,6,3,110154,110154,110157,0,3,4
31466,6,2,110160,110160,110162,0,2,3
31467,3,1,110163,110163,110164,0,1,1
31468,6,1,110169,110169,110170,0,1,5
31469,3,2,110172,110172,110174,0,2,2
31470,3,3,110175,110175,110178,0,3,1
31471,3,2,110178,110178,110180,0,2,0
31472,1,1,110179,110180,110181,1,2,0
31473,3,3,110182,110182,110185,0,3,1
31474,4,3,110186,110186,110189,0,3,1
31475,2,1,110188,110189,110190,1,2,0
31476,4,1,110192,110192,110193,0,1,2
31477,1,3,110193,110193,110196,0,3,0
31478,4,2,110197,110197,110199,0,2,1
31479,1,1,110198,110199,110200,1,2,0
31480,2,3,110200,110200,110203,0,3,0
31481,3,2,110203,110203,110205,0,2,0
31482,6,1,110209,110209,110210,0,1,4
31483,6,2,110215,110215,110217,0,2,5
31484,6,2,110221,110221,110223,0,2,4
31485,2,1,110223,110223,110224,0,1,0
31486,1,3,110224,110224,110227,0,3,0
31487,3,3,110227,110227,110230,0,3,0
31488,1,1,110228,110230,110231,2,3,0
31489,2,3,110230,110231,110234,1,4,0
31490,3,2,110233,110234,110236,1,3,0
31491,4,1,110237,110237,110238,0,1,1
31492,6,3,110243,110243,110246,0,3,5
31493,6,2,110249,110249,110251,0,2,3
31494,6,3,110255,110255,110258,0,3,4
31495,1,1,110256,110258,110259,2,3,0
31496,1,3,110257,110259,110262,2,5,0
31497,2,3,110259,110262,110265,3,6,0
31498,3,3,110262,110265,110268,3,6,0
31499,4,3,110266,110268,110271,2,5,0
31500,6,2,110272,110272,110274,0,2,1
31501,2,2,110274,110274,110276,0,2,0
31502,2,2,110276,110276,110278,0,2,0
31503,1,1,110277,110278,110279,1,2,0
31504,2,2,110279,110279,110281,0,2,0
31505,2,3,110281,110281,110284,0,3,0
31506,5,2,110286,110286,110288,0,2,2
31507,4,1,110290,110290,110291,0,1,2
31508,2,1,110292,110292,110293,0,1,1
31509,1,2,110293,110293,110295,0,2,0
31510,4,1,110297,110297,110298,0,1,2
31511,3,1,110300,110300,110301,0,1,2
31512,4,1,110304,110304,110305,0,1,3
31513,4,3,110308,110308,110311,0,3,3
31514,2,2,110310,110311,110313,1,3,0
31515,6,3,110316,110316,110319,0,3,3
31516,5,1,110321,110321,110322,0,1,2
31517,2,3,110323,110323,110326,0,3,1
31518,3,2,110326,110326,110328,0,2,0
31519,5,2,110331,110331,110333,0,2,3
31520,5,1,110336,110336,110337,0,1,3
31521,1,3,110337,110337,110340,0,3,0
31522,5,3,110342,110342,110345,0,3,2
31523,6,2,110348,110348,110350,0,2,3
31524,2,1,110350,110350,110351,0,1,0
31525,3,1,110353,110353,110354,0,1,2
31526,6,3,110359,110359,110362,0,3,5
31527,3,2,110362,110362,110364,0,2,0
31528,3,1,110365,110365,110366,0,1,1
31529,6,3,110371,110371,110374,0,3,5
31530,1,1,110372,110374,110375,2,3,0
31531,5,2,110377,110377,110379,0,2,2
31532,3,2,110380,110380,110382,0,2,1
31533,1,1,110381,110382,110383,1,2,0
31534,6,1,110387,110387,110388,0,1,4
31535,1,3,110388,110388,110391,0,3,0
31536,6,3,110394,110394,110397,0,3,3
31537,4,2,110398,110398,110400,0,2,1
31538,3,1,110401,110401,110402,0,1,1
31539,5,3,110406,110406,110409,0,3,4
31540,6,1,110412,110412,110413,0,1,3
31541,3,3,110415,110415,110418,0,3,2
31542,5,2,110420,110420,110422,0,2,2
31543,1,2,110421,110422,110424,1,3,0
31544,5,2,110426,110426,110428,0,2,2
31545,6,3,110432,110432,110435,0,3,4
31546,5,2,110437,110437,110439,0,2,2
31547,4,2,110441,110441,110443,0,2,2
31548,4,2,110445,110445,110447,0,2,2
31549,5,2,110450,110450,110452,0,2,3
31550,5,1,110455,110455,110456,0,1,3
31551,3,2,110458,110458,110460,0,2,2
31552,2,1,110460,110460,110461,0,1,0
31553,5,1,110465,110465,110466,0,1,4
31554,6,1,110471,110471,110472,0,1,5
31555,1,3,110472,110472,110475,0,3,0
31556,6,2,110478,110478,110480,0,2,3
31557,5,3,110483,110483,110486,0,3,3
31558,4,1,110487,110487,110488,0,1,1
31559,6,2,110493,110493,110495,0,2,5
31560,2,1,110495,110495,110496,0,1,0
31561,5,2,110500,110500,110502,0,2,4
31562,6,3,110506,110506,110509,0,3,4
31563,1,2,110507,110509,110511,2,4,0
31564,1,3,110508,110511,110514,3,6,0
31565,2,3,110510,110514,110517,4,7,0
31566,4,1,110514,110517,110518,3,4,0
31567,3,3,110517,110518,110521,1,4,0
31568,2,2,110519,110521,110523,2,4,0
31569,6,3,110525,110525,110528,0,3,2
31570,5,1,110530,110530,110531,0,1,2
31571,2,2,110532,110532,110534,0,2,1
31572,3,2,110535,110535,110537,0,2,1
31573,1,1,110536,110537,110538,1,2,0
31574,4,1,110540,110540,110541,0,1,2
31575,4,1,110544,110544,110545,0,1,3
31576,3,2,110547,110547,110549,0,2,2
31577,3,1,110550,110550,110551,0,1,1
31578,1,2,110551,110551,110553,0,2,0
31579,6,1,110557,110557,110558,0,1,4
31580,4,1,110561,110561,110562,0,1,3
31581,2,3,110563,110563,110566,0,3,1
31582,5,2,110568,110568,110570,0,2,2
31583,5,2,110573,110573,110575,0,2,3
31584,2,1,110575,110575,110576,0,1,0
31585,1,2,110576,110576,110578,0,2,0
31586,3,2,110579,110579,110581,0,2,1
31587,1,1,110580,110581,110582,1,2,0
31588,2,2,110582,110582,110584,0,2,0
31589,1,2,110583,110584,110586,1,3,0
31590,5,3,110588,110588,110591,0,3,2
31591,5,2,110593,110593,110595,0,2,2
31592,2,2,110595,110595,110597,0,2,0
31593,1,3,110596,110597,110600,1,4,0
31594,5,3,110601,110601,110604,0,3,1
31595,5,1,110606,110606,110607,0,1,2
31596,4,3,110610,110610,110613,0,3,3
31597,4,1,110614,110614,110615,0,1,1
31598,4,2,110618,110618,110620,0,2,3
31599,3,2,110621,110621,110623,0,2,1
31600,6,2,110627,110627,110629,0,2,4
31601,3,1,110630,110630,110631,0,1,1
31602,1,2,110631,110631,110633,0,2,0
31603,2,3,110633,110633,110636,0,3,0
31604,6,3,110639,110639,110642,0,3,3
31605,5,2,110644,110644,110646,0,2,2
31606,2,2,110646,110646,110648,0,2,0
31607,5,2,110651,110651,110653,0,2,3
31608,5,3,110656,110656,110659,0,3,3
31609,3,2,110659,110659,110661,0,2,0
31610,1,3,110660,110661,110664,1,4,0
31611,2,2,110662,110664,110666,2,4,0
31612,6,1,110668,110668,110669,0,1,2
31613,1,2,110669,110669,110671,0,2,0
31614,5,3,110674,110674,110677,0,3,3
31615,1,3,110675,110677,110680,2,5,0
31616,2,3,110677,110680,110683,3,6,0
31617,5,2,110682,110683,110685,1,3,0
31618,4,3,110686,110686,110689,0,3,1
31619,2,2,110688,110689,110691,1,3,0
31620,1,1,110689,110691,110692,2,3,0
31621,5,1,110694,110694,110695,0,1,2
31622,5,3,110699,110699,110702,0,3,4
31623,5,2,110704,110704,110706,0,2,2
31624,5,3,110709,110709,110712,0,3,3
31625,4,2,110713,110713,110715,0,2,1
31626,6,2,110719,110719,110721,0,2,4
31627,1,2,110720,110721,110723,1,3,0
31628,2,2,110722,110723,110725,1,3,0
31629,3,1,110725,110725,110726,0,1,0
31630,3,3,110728,110728,110731,0,3,2
31631,3,3,110731,110731,110734,0,3,0
31632,2,2,110733,110734,110736,1,3,0
31633,6,1,110739,110739,110740,0,1,3
31634,1,2,110740,110740,110742,0,2,0
31635,5,3,110745,110745,110748,0,3,3
31636,3,1,110748,110748,110749,0,1,0
31637,5,2,110753,110753,110755,0,2,4
31638,1,1,110754,110755,110756,1,2,0
31639,4,2,110758,110758,110760,0,2,2
31640,4,1,110762,110762,110763,0,1,2
31641,3,2,110765,110765,110767,0,2,2
31642,2,3,110767,110767,110770,0,3,0
31643,4,3,110771,110771,110774,0,3,1
31644,4,1,110775,110775,110776,0,1,1
31645,6,1,110781,110781,110782,0,1,5
31646,2,2,110783,110783,110785,0,2,1
31647,3,3,110786,110786,110789,0,3,1
31648,2,2,110788,110789,110791,1,3,0
31649,6,3,110794,110794,110797,0,3,3
31650,3,2,110797,110797,110799,0,2,0
31651,4,3,110801,110801,110804,0,3,2
31652,3,2,110804,110804,110806,0,2,0
31653,6,3,110810,110810,110813,0,3,4
31654,4,2,110814,110814,110816,0,2,1
31655,1,1,110815,110816,110817,1,2,0
31656,3,3,110818,110818,110821,0,3,1
31657,5,3,110823,110823,110826,0,3,2
31658,2,1,110825,110826,110827,1,2,0
31659,5,2,110830,110830,110832,0,2,3
31660,2,3,110832,110832,110835,0,3,0
31661,6,2,110838,110838,110840,0,2,3
31662,1,3,110839,110840,110843,1,4,0
31663,5,1,110844,110844,110845,0,1,1
31664,4,1,110848,110848,110849,0,1,3
31665,5,1,110853,110853,110854,0,1,4
31666,5,1,110858,110858,110859,0,1,4
31667,1,2,110859,110859,110861,0,2,0
31668,6,1,110865,110865,110866,0,1,4
31669,5,2,110870,110870,110872,0,2,4
31670,6,3,110876,110876,110879,0,3,4
31671,2,2,110878,110879,110881,1,3,0
31672,4,3,110882,110882,110885,0,3,1
31673,1,3,110883,110885,110888,2,5,0
31674,4,2,110887,110888,110890,1,3,0
31675,4,3,110891,110891,110894,0,3,1
31676,4,2,110895,110895,110897,0,2,1
31677,3,1,110898,110898,110899,0,1,1
31678,2,3,110900,110900,110903,0,3,1
31679,2,1,110902,110903,110904,1,2,0
31680,6,3,110908,110908,110911,0,3,4
31681,3,1,110911,110911,110912,0,1,0
31682,2,1,110913,110913,110914,0,1,1
31683,4,2,110917,110917,110919,0,2,3
31684,3,3,110920,110920,110923,0,3,1
31685,2,1,110922,110923,110924,1,2,0
31686,2,3,110924,110924,110927,0,3,0
31687,1,3,110925,110927,110930,2,5,0
31688,4,3,110929,110930,110933,1,4,0
31689,1,1,110930,110933,110934,3,4,0
31690,3,2,110933,110934,110936,1,3,0
31691,5,3,110938,110938,110941,0,3,2
31692,2,1,110940,110941,110942,1,2,0
31693,2,2,110942,110942,110944,0,2,0
31694,2,1,110944,110944,110945,0,1,0
31695,3,1,110947,110947,110948,0,1,2
31696,3,2,110950,110950,110952,0,2,2
31697,1,1,110951,110952,110953,1,2,0
31698,1,2,110952,110953,110955,1,3,0
31699,4,2,110956,110956,110958,0,2,1
31700,5,1,110961,110961,110962,0,1,3
31701,6,1,110967,110967,110968,0,1,5
31702,5,3,110972,110972,110975,0,3,4
31703,6,3,110978,110978,110981,0,3,3
31704,3,2,110981,110981,110983,0,2,0
31705,2,3,110983,110983,110986,0,3,0
31706,6,3,110989,110989,110992,0,3,3
31707,5,1,110994,110994,110995,0,1,2
31708,2,2,110996,110996,110998,0,2,1
31709,1,1,110997,110998,110999,1,2,0
31710,1,1,110998,110999,111000,1,2,0
31711,6,3,111004,111004,111007,0,3,4
31712,3,3,111007,111007,111010,0,3,0
31713,3,3,111010,111010,111013,0,3,0
31714,6,3,111016,111016,111019,0,3,3
31715,2,3,111018,111019,111022,1,4,0
31716,6,3,111024,111024,111027,0,3,2
31717,5,3,111029,111029,111032,0,3,2
31718,6,2,111035,111035,111037,0,2,3
31719,2,1,111037,111037,111038,0,1,0
31720,6,2,111043,111043,111045,0,2,5
31721,6,1,111049,111049,111050,0,1,4
31722,6,1,111055,111055,111056,0,1,5
31723,5,1,111060,111060,111061,0,1,4
31724,5,2,111065,111065,111067,0,2,4
31725,5,2,111070,111070,111072,0,2,3
31726,6,1,111076,111076,111077,0,1,4
31727,2,1,111078,111078,111079,0,1,1
31728,4,1,111082,111082,111083,0,1,3
31729,3,2,111085,111085,111087,0,2,2
31730,5,3,111090,111090,111093,0,3,3
31731,1,3,111091,111093,111096,2,5,0
31732,2,3,111093,111096,111099,3,6,0
31733,1,3,111094,111099,111102,5,8,0
31734,1,2,111095,111102,111104,7,9,0
31735,1,1,111096,111104,111105,8,9,0
31736,5,2,111101,111105,111107,4,6,0
31737,5,2,111106,111107,111109,1,3,0
31738,2,1,111108,111109,111110,1,2,0
31739,1,1,111109,111110,111111,1,2,0
31740,4,2,111113,111113,111115,0,2,2
31741,2,2,111115,111115,111117,0,2,0
31742,5,1,111120,111120,111121,0,1,3
31743,3,3,111123,111123,111126,0,3,2
31744,2,3,111125,111126,111129,1,4,0
31745,3,1,111128,111129,111130,1,2,0
31746,5,3,111133,111133,111136,0,3,3
31747,3,1,111136,111136,111137,0,1,0
31748,6,1,111142,111142,111143,0,1,5
31749,4,2,111146,111146,111148,0,2,3
31750,6,1,111152,111152,111153,0,1,4
31751,3,3,111155,111155,111158,0,3,2
31752,1,3,111156,111158,111161,2,5,0
31753,5,2,111161,111161,111163,0,2,0
31754,6,1,111167,111167,111168,0,1,4
31755,5,1,111172,111172,111173,0,1,4
31756,2,1,111174,111174,111175,0,1,1
31757,6,2,111180,111180,111182,0,2,5
31758,4,2,111184,111184,111186,0,2,2
31759,4,3,111188,111188,111191,0,3,2
31760,2,1,111190,111191,111192,1,2,0
31761,1,1,111191,111192,111193,1,2,0
31762,6,1,111197,111197,111198,0,1,4
31763,3,3,111200,111200,111203,0,3,2
31764,5,1,111205,111205,111206,0,1,2
31765,6,3,111211,111211,111214,0,3,5
31766,6,3,111217,111217,111220,0,3,3
31767,5,1,111222,111222,111223,0,1,2
31768,4,2,111226,111226,111228,0,2,3
31769,2,2,111228,111228,111230,0,2,0
31770,3,2,111231,111231,111233,0,2,1
31771,1,3,111232,111233,111236,1,4,0
31772,5,2,111237,111237,111239,0,2,1
31773,1,1,111238,111239,111240,1,2,0
31774,3,3,111241,111241,111244,0,3,1
31775,4,3,111245,111245,111248,0,3,1
31776,6,2,111251,111251,111253,0,2,3
31777,2,1,111253,111253,111254,0,1,0
31778,5,1,111258,111258,111259,0,1,4
31779,3,1,111261,111261,111262,0,1,2
31780,5,1,111266,111266,111267,0,1,4
31781,2,2,111268,111268,111270,0,2,1
31782,6,3,111274,111274,111277,0,3,4
31783,4,2,111278,111278,111280,0,2,1
31784,2,2,111280,111280,111282,0,2,0
31785,3,1,111283,111283,111284,0,1,1
31786,4,1,111287,111287,111288,0,1,3
31787,4,3,111291,111291,111294,0,3,3
31788,3,2,111294,111294,111296,0,2,0
31789,3,2,111297,111297,111299,0,2,1
31790,1,3,111298,111299,111302,1,4,0
31791,3,2,111301,111302,111304,1,3,0
31792,2,3,111303,111304,111307,1,4,0
31793,4,3,111307,111307,111310,0,3,0
31794,2,1,111309,111310,111311,1,2,0
31795,2,2,111311,111311,111313,0,2,0
31796,5,1,111316,111316,111317,0,1,3
31797,6,2,111322,111322,111324,0,2,5
31798,6,1,111328,111328,111329,0,1,4
31799,6,2,111334,111334,111336,0,2,5
31800,5,1,111339,111339,111340,0,1,3
31801,4,1,111343,111343,111344,0,1,3
31802,2,2,111345,111345,111347,0,2,1
31803,1,2,111346,111347,111349,1,3,0
31804,6,2,111352,111352,111354,0,2,3
31805,6,1,111358,111358,111359,0,1,4
31806,6,3,111364,111364,111367,0,3,5
31807,3,2,111367,111367,111369,0,2,0
31808,4,1,111371,111371,111372,0,1,2
31809,3,3,111374,111374,111377,0,3,2
31810,1,2,111375,111377,111379,2,4,0
31811,3,1,111378,111379,111380,1,2,0
31812,6,1,111384,111384,111385,0,1,4
31813,4,3,111388,111388,111391,0,3,3
31814,6,3,111394,111394,111397,0,3,3
31815,3,3,111397,111397,111400,0,3,0
31816,4,1,111401,111401,111402,0,1,1
31817,4,3,111405,111405,111408,0,3,3
31818,6,3,111411,111411,111414,0,3,3
31819,2,2,111413,111414,111416,1,3,0
31820,3,2,111416,111416,111418,0,2,0
31821,1,2,111417,111418,111420,1,3,0
31822,2,3,111419,111420,111423,1,4,0
31823,6,2,111425,111425,111427,0,2,2
31824,1,2,111426,111427,111429,1,3,0
31825,2,1,111428,111429,111430,1,2,0
31826,6,3,111434,111434,111437,0,3,4
31827,1,3,111435,111437,111440,2,5,0
31828,1,2,111436,111440,111442,4,6,0
31829,5,2,111441,111442,111444,1,3,0
31830,3,1,111444,111444,111445,0,1,0
31831,1,3,111445,111445,111448,0,3,0
31832,5,1,111450,111450,111451,0,1,2
31833,6,2,111456,111456,111458,0,2,5
31834,4,1,111460,111460,111461,0,1,2
31835,5,3,111465,111465,111468,0,3,4
31836,5,1,111470,111470,111471,0,1,2
31837,2,1,111472,111472,111473,0,1,1
31838,4,1,111476,111476,111477,0,1,3
31839,1,1,111477,111477,111478,0,1,0
31840,5,2,111482,111482,111484,0,2,4
31841,5,2,111487,111487,111489,0,2,3
31842,6,2,111493,111493,111495,0,2,4
31843,4,3,111497,111497,111500,0,3,2
31844,2,3,111499,111500,111503,1,4,0
31845,6,1,111505,111505,111506,0,1,2
31846,6,1,111511,111511,111512,0,1,5
31847,5,2,111516,111516,111518,0,2,4
31848,1,1,111517,111518,111519,1,2,0
31849,3,1,111520,111520,111521,0,1,1
31850,6,1,111526,111526,111527,0,1,5
31851,6,1,111532,111532,111533,0,1,5
31852,4,2,111536,111536,111538,0,2,3
31853,3,3,111539,111539,111542,0,3,1
31854,2,3,111541,111542,111545,1,4,0
31855,5,3,111546,111546,111549,0,3,1
31856,2,3,111548,111549,111552,1,4,0
31857,5,1,111553,111553,111554,0,1,1
31858,2,2,111555,111555,111557,0,2,1
31859,5,3,111560,111560,111563,0,3,3
31860,3,2,111563,111563,111565,0,2,0
31861,3,3,111566,111566,111569,0,3,1
31862,6,2,111572,111572,111574,0,2,3
31863,2,2,111574,111574,111576,0,2,0
31864,5,3,111579,111579,111582,0,3,3
31865,1,1,111580,111582,111583,2,3,0
31866,6,1,111586,111586,111587,0,1,3
31867,3,2,111589,111589,111591,0,2,2
31868,5,2,111594,111594,111596,0,2,3
31869,5,3,111599,111599,111602,0,3,3
31870,6,2,111605,111605,111607,0,2,3
31871,1,3,111606,111607,111610,1,4,0
31872,3,1,111609,111610,111611,1,2,0
31873,5,1,111614,111614,111615,0,1,3
31874,5,1,111619,111619,111620,0,1,4
31875,5,2,111624,111624,111626,0,2,4
31876,4,3,111628,111628,111631,0,3,2
31877,6,2,111634,111634,111636,0,2,3
31878,4,3,111638,111638,111641,0,3,2
31879,1,3,111639,111641,111644,2,5,0
31880,4,1,111643,111644,111645,1,2,0
31881,3,1,111646,111646,111647,0,1,1
31882,5,1,111651,111651,111652,0,1,4
31883,1,2,111652,111652,111654,0,2,0
31884,2,3,111654,111654,111657,0,3,0
31885,4,3,111658,111658,111661,0,3,1
31886,6,2,111664,111664,111666,0,2,3
31887,6,1,111670,111670,111671,0,1,4
31888,5,3,111675,111675,111678,0,3,4
31889,4,2,111679,111679,111681,0,2,1
31890,1,1,111680,111681,111682,1,2,0
31891,4,2,111684,111684,111686,0,2,2
31892,2,1,111686,111686,111687,0,1,0
31893,6,1,111692,111692,111693,0,1,5
31894,3,2,111695,111695,111697,0,2,2
31895,6,3,111701,111701,111704,0,3,4
31896,5,2,111706,111706,111708,0,2,2
31897,5,3,111711,111711,111714,0,3,3
31898,3,2,111714,111714,111716,0,2,0
31899,1,2,111715,111716,111718,1,3,0
31900,1,2,111716,111718,111720,2,4,0
31901,1,2,111717,111720,111722,3,5,0
31902,4,2,111721,111722,111724,1,3,0
31903,4,2,111725,111725,111727,0,2,1
31904,5,2,111730,111730,111732,0,2,3
31905,6,1,111736,111736,111737,0,1,4
31906,6,3,111742,111742,111745,0,3,5
31907,1,1,111743,111745,111746,2,3,0
31908,6,2,111749,111749,111751,0,2,3
31909,6,2,111755,111755,111757,0,2,4
31910,1,1,111756,111757,111758,1,2,0
31911,5,2,111761,111761,111763,0,2,3
31912,6,1,111767,111767,111768,0,1,4
31913,2,1,111769,111769,111770,0,1,1
31914,5,1,111774,111774,111775,0,1,4
31915,2,1,111776,111776,111777,0,1,1
31916,6,2,111782,111782,111784,0,2,5
31917,2,2,111784,111784,111786,0,2,0
31918,1,3,111785,111786,111789,1,4,0
31919,4,3,111789,111789,111792,0,3,0
31920,6,1,111795,111795,111796,0,1,3
31921,5,3,111800,111800,111803,0,3,4
31922,5,2,111805,111805,111807,0,2,2
31923,3,2,111808,111808,111810,0,2,1
31924,4,3,111812,111812,111815,0,3,2
31925,3,3,111815,111815,111818,0,3,0
31926,1,2,111816,111818,111820,2,4,0
31927,2,3,111818,111820,111823,2,5,0
31928,6,2,111824,111824,111826,0,2,1
31929,4,1,111828,111828,111829,0,1,2
31930,5,1,111833,111833,111834,0,1,4
31931,3,3,111836,111836,111839,0,3,2
31932,2,1,111838,111839,111840,1,2,0
31933,6,1,111844,111844,111845,0,1,4
31934,3,2,111847,111847,111849,0,2,2
31935,5,2,111852,111852,111854,0,2,3
31936,2,2,111854,111854,111856,0,2,0
31937,6,2,111860,111860,111862,0,2,4
31938,1,1,111861,111862,111863,1,2,0
31939,5,1,111866,111866,111867,0,1,3
31940,3,3,111869,111869,111872,0,3,2
31941,1,2,111870,111872,111874,2,4,0
31942,3,1,111873,111874,111875,1,2,0
31943,1,1,111874,111875,111876,1,2,0
31944,6,3,111880,111880,111883,0,3,4
31945,2,2,111882,111883,111885,1,3,0
31946,6,3,111888,111888,111891,0,3,3
31947,1,2,111889,111891,111893,2,4,0
31948,3,1,111892,111893,111894,1,2,0
31949,6,1,111898,111898,111899,0,1,4
31950,2,3,111900,111900,111903,0,3,1
31951,1,1,111901,111903,111904,2,3,0
31952,2,3,111903,111904,111907,1,4,0
31953,4,3,111907,111907,111910,0,3,0
31954,4,2,111911,111911,111913,0,2,1
31955,1,3,111912,111913,111916,1,4,0
31956,4,3,111916,111916,111919,0,3,0
31957,4,1,111920,111920,111921,0,1,1
31958,3,1,111923,111923,111924,0,1,2
31959,2,3,111925,111925,111928,0,3,1
31960,6,1,111931,111931,111932,0,1,3
31961,1,1,111932,111932,111933,0,1,0
31962,4,3,111936,111936,111939,0,3,3
31963,1,3,111937,111939,111942,2,5,0
31964,5,3,111942,111942,111945,0,3,0
31965,1,1,111943,111945,111946,2,3,0
31966,2,2,111945,111946,111948,1,3,0
31967,2,3,111947,111948,111951,1,4,0
31968,4,2,111951,111951,111953,0,2,0
31969,3,1,111954,111954,111955,0,1,1
31970,1,3,111955,111955,111958,0,3,0
31971,4,2,111959,111959,111961,0,2,1
31972,2,2,111961,111961,111963,0,2,0
31973,4,1,111965,111965,111966,0,1,2
31974,3,1,111968,111968,111969,0,1,2
31975,2,2,111970,111970,111972,0,2,1
31976,6,3,111976,111976,111979,0,3,4
31977,2,3,111978,111979,111982,1,4,0
31978,5,1,111983,111983,111984,0,1,1
31979,5,1,111988,111988,111989,0,1,4
31980,6,3,111994,111994,111997,0,3,5
31981,2,3,111996,111997,112000,1,4,0
31982,6,1,112002,112002,112003,0,1,2
31983,2,2,112004,112004,112006,0,2,1
31984,2,1,112006,112006,112007,0,1,0
31985,6,1,112012,112012,112013,0,1,5
31986,4,2,112016,112016,112018,0,2,3
31987,2,2,112018,112018,112020,0,2,0
31988,6,3,112024,112024,112027,0,3,4
31989,3,2,112027,112027,112029,0,2,0
31990,6,2,112033,112033,112035,0,2,4
31991,5,1,112038,112038,112039,0,1,3
31992,3,2,112041,112041,112043,0,2,2
31993,6,3,112047,112047,112050,0,3,4
31994,6,1,112053,112053,112054,0,1,3
31995,2,3,112055,112055,112058,0,3,1
31996,2,2,112057,112058,112060,1,3,0
31997,2,2,112059,112060,112062,1,3,0
31998,6,3,112065,112065,112068,0,3,3
31999,6,3,112071,112071,112074,0,3,3
32000,1,1,112072,112074,112075,2,3,0
32001,6,2,112078,112078,112080,0,2,3
32002,3,2,112081,112081,112083,0,2,1
32003,3,1,112084,112084,112085,0,1,1
32004,2,1,112086,112086,112087,0,1,1
32005,6,3,112092,112092,112095,0,3,5
32006,6,1,112098,112098,112099,0,1,3
32007,1,2,112099,112099,112101,0,2,0
32008,2,2,112101,112101,112103,0,2,0
32009,5,1,112106,112106,112107,0,1,3
32010,3,1,112109,112109,112110,0,1,2
32011,4,2,112113,112113,112115,0,2,3
32012,6,1,112119,112119,112120,0,1,4
32013,5,3,112124,112124,112127,0,3,4
32014,5,3,112129,112129,112132,0,3,2
32015,5,1,112134,112134,112135,0,1,2
32016,4,2,112138,112138,112140,0,2,3
32017,5,1,112143,112143,112144,0,1,3
32018,6,2,112149,112149,112151,0,2,5
32019,4,3,112153,112153,112156,0,3,2
32020,1,3,112154,112156,112159,2,5,0
32021,5,3,112159,112159,112162,0,3,0
32022,6,2,112165,112165,112167,0,2,3
32023,4,2,112169,112169,112171,0,2,2
32024,4,1,112173,112173,112174,0,1,2
32025,5,3,112178,112178,112181,0,3,4
32026,2,3,112180,112181,112184,1,4,0
32027,1,3,112181,112184,112187,3,6,0
32028,2,2,112183,112187,112189,4,6,0
32029,3,1,112186,112189,112190,3,4,0
32030,2,1,112188,112190,112191,2,3,0
32031,5,1,112193,112193,112194,0,1,2
32032,3,3,112196,112196,112199,0,3,2
32033,5,3,112201,112201,112204,0,3,2
32034,5,3,112206,112206,112209,0,3,2
32035,3,1,112209,112209,112210,0,1,0
32036,6,2,112215,112215,112217,0,2,5
32037,4,3,112219,112219,112222,0,3,2
32038,1,3,112220,112222,112225,2,5,0
32039,2,3,112222,112225,112228,3,6,0
32040,5,2,112227,112228,112230,1,3,0
32041,3,2,112230,112230,112232,0,2,0
32042,2,3,112232,112232,112235,0,3,0
32043,5,2,112237,112237,112239,0,2,2
32044,3,3,112240,112240,112243,0,3,1
32045,4,1,112244,112244,112245,0,1,1
32046,1,3,112245,112245,112248,0,3,0
32047,1,3,112246,112248,112251,2,5,0
32048,2,3,112248,112251,112254,3,6,0
32049,1,2,112249,112254,112256,5,7,0
32050,1,2,112250,112256,112258,6,8,0
32051,5,2,112255,112258,112260,3,5,0
32052,3,3,112258,112260,112263,2,5,0
32053,4,2,112262,112263,112265,1,3,0
32054,5,1,112267,112267,112268,0,1,2
32055,2,2,112269,112269,112271,0,2,1
32056,1,3,112270,112271,112274,1,4,0
32057,1,1,112271,112274,112275,3,4,0
32058,3,3,112274,112275,112278,1,4,0
32059,6,2,112280,112280,112282,0,2,2
32060,3,2,112283,112283,112285,0,2,1
32061,2,3,112285,112285,112288,0,3,0
32062,1,2,112286,112288,112290,2,4,0
32063,1,2,112287,112290,112292,3,5,0
32064,4,3,112291,112292,112295,1,4,0
32065,5,1,112296,112296,112297,0,1,1
32066,4,1,112300,112300,112301,0,1,3
32067,2,1,112302,112302,112303,0,1,1
32068,6,1,112308,112308,112309,0,1,5
32069,1,3,112309,112309,112312,0,3,0
32070,5,2,112314,112314,112316,0,2,2
32071,4,1,112318,112318,112319,0,1,2
32072,6,3,112324,112324,112327,0,3,5
32073,6,1,112330,112330,112331,0,1,3
32074,5,1,112335,112335,112336,0,1,4
32075,4,2,112339,112339,112341,0,2,3
32076,6,1,112345,112345,112346,0,1,4
32077,1,2,112346,112346,112348,0,2,0
32078,6,2,112352,112352,112354,0,2,4
32079,3,2,112355,112355,112357,0,2,1
32080,5,2,112360,112360,112362,0,2,3
32081,6,3,112366,112366,112369,0,3,4
32082,1,3,112367,112369,112372,2,5,0
32083,6,2,112373,112373,112375,0,2,1
32084,3,3,112376,112376,112379,0,3,1
32085,3,2,112379,112379,112381,0,2,0
32086,6,3,112385,112385,112388,0,3,4
32087,6,1,112391,112391,112392,0,1,3
32088,1,2,112392,112392,112394,0,2,0
32089,2,1,112394,112394,112395,0,1,0
32090,3,1,112397,112397,112398,0,1,2
32091,1,3,112398,112398,112401,0,3,0
32092,5,2,112403,112403,112405,0,2,2
32093,3,1,112406,112406,112407,0,1,1
32094,1,2,112407,112407,112409,0,2,0
32095,5,2,112412,112412,112414,0,2,3
32096,3,2,112415,112415,112417,0,2,1
32097,3,2,112418,112418,112420,0,2,1
32098,6,3,112424,112424,112427,0,3,4
32099,3,3,112427,112427,112430,0,3,0
32100,3,1,112430,112430,112431,0,1,0
32101,6,2,112436,112436,112438,0,2,5
32102,6,1,112442,112442,112443,0,1,4
32103,4,2,112446,112446,112448,0,2,3
32104,1,1,112447,112448,112449,1,2,0
32105,5,3,112452,112452,112455,0,3,3
32106,1,3,112453,112455,112458,2,5,0
32107,1,2,112454,112458,112460,4,6,0
32108,4,2,112458,112460,112462,2,4,0
32109,5,3,112463,112463,112466,0,3,1
32110,5,3,112468,112468,112471,0,3,2
32111,4,3,112472,112472,112475,0,3,1
32112,2,1,112474,112475,112476,1,2,0
32113,2,1,112476,112476,112477,0,1,0
32114,2,1,112478,112478,112479,0,1,1
32115,2,2,112480,112480,112482,0,2,1
32116,6,3,112486,112486,112489,0,3,4
32117,5,2,112491,112491,112493,0,2,2
32118,4,2,112495,112495,112497,0,2,2
32119,6,3,112501,112501,112504,0,3,4
32120,5,2,112506,112506,112508,0,2,2
32121,5,1,112511,112511,112512,0,1,3
32122,5,1,112516,112516,112517,0,1,4
32123,5,3,112521,112521,112524,0,3,4
32124,2,1,112523,112524,112525,1,2,0
32125,6,1,112529,112529,112530,0,1,4
32126,5,3,112534,112534,112537,0,3,4
32127,1,3,112535,112537,112540,2,5,0
32128,6,1,112541,112541,112542,0,1,1
32129,5,3,112546,112546,112549,0,3,4
32130,5,3,112551,112551,112554,0,3,2
32131,2,1,112553,112554,112555,1,2,0
32132,3,2,112556,112556,112558,0,2,1
32133,3,3,112559,112559,112562,0,3,1
32134,5,2,112564,112564,112566,0,2,2
32135,5,3,112569,112569,112572,0,3,3
32136,5,2,112574,112574,112576,0,2,2
32137,4,2,112578,112578,112580,0,2,2
32138,1,2,112579,112580,112582,1,3,0
32139,5,1,112584,112584,112585,0,1,2
32140,4,3,112588,112588,112591,0,3,3
32141,2,3,112590,112591,112594,1,4,0
32142,1,3,112591,112594,112597,3,6,0
32143,1,1,112592,112597,112598,5,6,0
32144,3,1,112595,112598,112599,3,4,0
32145,4,1,112599,112599,112600,0,1,0
32146,5,1,112604,112604,112605,0,1,4
32147,1,3,112605,112605,112608,0,3,0
32148,5,2,112610,112610,112612,0,2,2
32149,4,1,112614,112614,112615,0,1,2
32150,1,3,112615,112615,112618,0,3,0
32151,2,2,112617,112618,112620,1,3,0
32152,3,1,112620,112620,112621,0,1,0
32153,2,2,112622,112622,112624,0,2,1
32154,4,1,112626,112626,112627,0,1,2
32155,1,1,112627,112627,112628,0,1,0
32156,6,1,112633,112633,112634,0,1,5
32157,5,3,112638,112638,112641,0,3,4
32158,6,3,112644,112644,112647,0,3,3
32159,2,2,112646,112647,112649,1,3,0
32160,3,1,112649,112649,112650,0,1,0
32161,3,2,112652,112652,112654,0,2,2
32162,2,1,112654,112654,112655,0,1,0
32163,1,1,112655,112655,112656,0,1,0
32164,3,2,112658,112658,112660,0,2,2
32165,2,1,112660,112660,112661,0,1,0
32166,5,1,112665,112665,112666,0,1,4
32167,2,3,112667,112667,112670,0,3,1
32168,5,2,112672,112672,112674,0,2,2
32169,4,3,112676,112676,112679,0,3,2
32170,1,2,112677,112679,112681,2,4,0
32171,4,2,112681,112681,112683,0,2,0
32172,2,1,112683,112683,112684,0,1,0
32173,4,2,112687,112687,112689,0,2,3
32174,4,3,112691,112691,112694,0,3,2
32175,5,3,112696,112696,112699,0,3,2
32176,1,1,112697,112699,112700,2,3,0
32177,3,1,112700,112700,112701,0,1,0
32178,3,2,112703,112703,112705,0,2,2
32179,4,1,112707,112707,112708,0,1,2
32180,2,1,112709,112709,112710,0,1,1
32181,4,1,112713,112713,112714,0,1,3
32182,2,3,112715,112715,112718,0,3,1
32183,2,2,112717,112718,112720,1,3,0
32184,2,2,112719,112720,112722,1,3,0
32185,6,3,112725,112725,112728,0,3,3
32186,2,2,112727,112728,112730,1,3,0
32187,2,3,112729,112730,112733,1,4,0
32188,5,2,112734,112734,112736,0,2,1
32189,5,1,112739,112739,112740,0,1,3
32190,6,2,112745,112745,112747,0,2,5
32191,1,1,112746,112747,112748,1,2,0
32192,6,3,112752,112752,112755,0,3,4
32193,5,2,112757,112757,112759,0,2,2
32194,3,3,112760,112760,112763,0,3,1
32195,4,3,112764,112764,112767,0,3,1
32196,2,1,112766,112767,112768,1,2,0
32197,1,2,112767,112768,112770,1,3,0
32198,4,2,112771,112771,112773,0,2,1
32199,5,2,112776,112776,112778,0,2,3
32200,6,3,112782,112782,112785,0,3,4
32201,5,2,112787,112787,112789,0,2,2
32202,3,3,112790,112790,112793,0,3,1
32203,5,2,112795,112795,112797,0,2,2
32204,1,3,112796,112797,112800,1,4,0
32205,2,1,112798,112800,112801,2,3,0
32206,2,1,112800,112801,112802,1,2,0
32207,2,3,112802,112802,112805,0,3,0
32208,6,1,112808,112808,112809,0,1,3
32209,4,2,112812,112812,112814,0,2,3
32210,5,2,112817,112817,112819,0,2,3
32211,2,3,112819,112819,112822,0,3,0
32212,3,1,112822,112822,112823,0,1,0
32213,1,1,112823,112823,112824,0,1,0
32214,2,2,112825,112825,112827,0,2,1
32215,6,3,112831,112831,112834,0,3,4
32216,5,2,112836,112836,112838,0,2,2
32217,1,2,112837,112838,112840,1,3,0
32218,5,1,112842,112842,112843,0,1,2
32219,5,2,112847,112847,112849,0,2,4
32220,3,2,112850,112850,112852,0,2,1
32221,5,1,112855,112855,112856,0,1,3
32222,1,2,112856,112856,112858,0,2,0
32223,5,2,112861,112861,112863,0,2,3
32224,4,1,112865,112865,112866,0,1,2
32225,1,1,112866,112866,112867,0,1,0
32226,5,1,112871,112871,112872,0,1,4
32227,4,3,112875,112875,112878,0,3,3
32228,4,2,112879,112879,112881,0,2,1
32229,4,2,112883,112883,112885,0,2,2
32230,6,3,112889,112889,112892,0,3,4
32231,3,1,112892,112892,112893,0,1,0
32232,4,1,112896,112896,112897,0,1,3
32233,4,1,112900,112900,112901,0,1,3
32234,2,2,112902,112902,112904,0,2,1
32235,5,2,112907,112907,112909,0,2,3
32236,4,2,112911,112911,112913,0,2,2
32237,5,3,112916,112916,112919,0,3,3
32238,5,1,112921,112921,112922,0,1,2
32239,3,3,112924,112924,112927,0,3,2
32240,3,2,112927,112927,112929,0,2,0
32241,5,1,112932,112932,112933,0,1,3
32242,6,3,112938,112938,112941,0,3,5
32243,5,1,112943,112943,112944,0,1,2
32244,5,1,112948,112948,112949,0,1,4
32245,6,3,112954,112954,112957,0,3,5
32246,5,2,112959,112959,112961,0,2,2
32247,4,1,112963,112963,112964,0,1,2
32248,1,1,112964,112964,112965,0,1,0
32249,4,1,112968,112968,112969,0,1,3
32250,6,2,112974,112974,112976,0,2,5
32251,5,2,112979,112979,112981,0,2,3
32252,3,1,112982,112982,112983,0,1,1
32253,1,1,112983,112983,112984,0,1,0
32254,2,1,112985,112985,112986,0,1,1
32255,5,2,112990,112990,112992,0,2,4
32256,6,1,112996,112996,112997,0,1,4
32257,1,1,112997,112997,112998,0,1,0
32258,5,1,113002,113002,113003,0,1,4
32259,3,1,113005,113005,113006,0,1,2
32260,2,3,113007,113007,113010,0,3,1
32261,3,3,113010,113010,113013,0,3,0
32262,5,2,113015,113015,113017,0,2,2
32263,4,3,113019,113019,113022,0,3,2
32264,5,1,113024,113024,113025,0,1,2
32265,6,2,113030,113030,113032,0,2,5
32266,4,2,113034,113034,113036,0,2,2
32267,4,1,113038,113038,113039,0,1,2
32268,1,3,113039,113039,113042,0,3,0
32269,5,2,113044,113044,113046,0,2,2
32270,5,2,113049,113049,113051,0,2,3
32271,3,2,113052,113052,113054,0,2,1
32272,2,3,113054,113054,113057,0,3,0
32273,6,1,113060,113060,113061,0,1,3
32274,1,1,113061,113061,113062,0,1,0
32275,2,2,113063,113063,113065,0,2,1
32276,5,3,113068,113068,113071,0,3,3
32277,1,1,113069,113071,113072,2,3,0
32278,3,1,113072,113072,113073,0,1,0
32279,5,3,113077,113077,113080,0,3,4
32280,6,2,113083,113083,113085,0,2,3
32281,4,2,113087,113087,113089,0,2,2
32282,3,3,113090,113090,113093,0,3,1
32283,3,1,113093,113093,113094,0,1,0
32284,6,2,113099,113099,113101,0,2,5
32285,2,1,113101,113101,113102,0,1,0
32286,1,2,113102,113102,113104,0,2,0
32287,3,1,113105,113105,113106,0,1,1
32288,6,2,113111,113111,113113,0,2,5
32289,4,3,113115,113115,113118,0,3,2
32290,5,2,113120,113120,113122,0,2,2
32291,3,2,113123,113123,113125,0,2,1
32292,4,3,113127,113127,113130,0,3,2
32293,4,3,113131,113131,113134,0,3,1
32294,5,2,113136,113136,113138,0,2,2
32295,3,2,113139,113139,113141,0,2,1
32296,6,2,113145,113145,113147,0,2,4
32297,5,1,113150,113150,113151,0,1,3
32298,1,1,113151,113151,113152,0,1,0
32299,5,1,113156,113156,113157,0,1,4
32300,3,1,113159,113159,113160,0,1,2
32301,4,1,113163,113163,113164,0,1,3
32302,1,1,113164,113164,113165,0,1,0
32303,4,2,113168,113168,113170,0,2,3
32304,4,3,113172,113172,113175,0,3,2
32305,3,3,113175,113175,113178,0,3,0
32306,3,3,113178,113178,113181,0,3,0
32307,2,2,113180,113181,113183,1,3,0
32308,4,1,113184,113184,113185,0,1,1
32309,1,3,113185,113185,113188,0,3,0
32310,2,1,113187,113188,113189,1,2,0
32311,2,3,113189,113189,113192,0,3,0
32312,2,2,113191,113192,113194,1,3,0
32313,6,3,113197,113197,113200,0,3,3
32314,1,1,113198,113200,113201,2,3,0
32315,3,1,113201,113201,113202,0,1,0
32316,5,2,113206,113206,113208,0,2,4
32317,3,3,113209,113209,113212,0,3,1
32318,6,2,113215,113215,113217,0,2,3
32319,1,3,113216,113217,113220,1,4,0
32320,2,3,113218,113220,113223,2,5,0
32321,5,1,113223,113223,113224,0,1,0
32322,3,1,113226,113226,113227,0,1,2
32323,5,3,113231,113231,113234,0,3,4
32324,5,2,113236,113236,113238,0,2,2
32325,4,3,113240,113240,113243,0,3,2
32326,1,1,113241,113243,113244,2,3,0
32327,4,1,113245,113245,113246,0,1,1
32328,4,2,113249,113249,113251,0,2,3
32329,2,1,113251,113251,113252,0,1,0
32330,6,2,113257,113257,113259,0,2,5
32331,4,2,113261,113261,113263,0,2,2
32332,6,3,113267,113267,113270,0,3,4
32333,3,1,113270,113270,113271,0,1,0
32334,2,2,113272,113272,113274,0,2,1
32335,5,3,113277,113277,113280,0,3,3
32336,6,2,113283,113283,113285,0,2,3
32337,3,3,113286,113286,113289,0,3,1
32338,1,1,113287,113289,113290,2,3,0
32339,2,1,113289,113290,113291,1,2,0
32340,4,1,113293,113293,113294,0,1,2
32341,4,1,113297,113297,113298,0,1,3
32342,3,2,113300,113300,113302,0,2,2
32343,2,3,113302,113302,113305,0,3,0
32344,4,1,113306,113306,113307,0,1,1
32345,2,2,113308,113308,113310,0,2,1
32346,6,3,113314,113314,113317,0,3,4
32347,4,1,113318,113318,113319,0,1,1
32348,1,1,113319,113319,113320,0,1,0
32349,6,3,113325,113325,113328,0,3,5
32350,4,2,113329,113329,113331,0,2,1
32351,3,3,113332,113332,113335,0,3,1
32352,6,2,113338,113338,113340,0,2,3
32353,5,3,113343,113343,113346,0,3,3
32354,1,3,113344,113346,113349,2,5,0
32355,5,1,113349,113349,113350,0,1,0
32356,6,2,113355,113355,113357,0,2,5
32357,2,3,113357,113357,113360,0,3,0
32358,2,3,113359,113360,113363,1,4,0
32359,2,1,113361,113363,113364,2,3,0
32360,5,2,113366,113366,113368,0,2,2
32361,6,2,113372,113372,113374,0,2,4
32362,3,2,113375,113375,113377,0,2,1
32363,3,2,113378,113378,113380,0,2,1
32364,5,1,113383,113383,113384,0,1,3
32365,6,1,113389,113389,113390,0,1,5
32366,1,2,113390,113390,113392,0,2,0
32367,3,1,113393,113393,113394,0,1,1
32368,2,2,113395,113395,113397,0,2,1
32369,5,1,113400,113400,113401,0,1,3
32370,5,1,113405,113405,113406,0,1,4
32371,4,2,113409,113409,113411,0,2,3
32372,6,3,113415,113415,113418,0,3,4
32373,2,2,113417,113418,113420,1,3,0
32374,3,1,113420,113420,113421,0,1,0
32375,5,3,113425,113425,113428,0,3,4
32376,6,3,113431,113431,113434,0,3,3
32377,4,1,113435,113435,113436,0,1,1
32378,2,1,113437,113437,113438,0,1,1
32379,1,2,113438,113438,113440,0,2,0
32380,5,2,113443,113443,113445,0,2,3
32381,6,2,113449,113449,113451,0,2,4
32382,4,1,113453,113453,113454,0,1,2
32383,1,3,113454,113454,113457,0,3,0
32384,2,1,113456,113457,113458,1,2,0
32385,6,2,113462,113462,113464,0,2,4
32386,5,3,113467,113467,113470,0,3,3
32387,4,3,113471,113471,113474,0,3,1
32388,6,1,113477,113477,113478,0,1,3
32389,2,2,113479,113479,113481,0,2,1
32390,4,1,113483,113483,113484,0,1,2
32391,4,2,113487,113487,113489,0,2,3
32392,6,2,113493,113493,113495,0,2,4
32393,5,2,113498,113498,113500,0,2,3
32394,5,1,113503,113503,113504,0,1,3
32395,5,3,113508,113508,113511,0,3,4
32396,3,2,113511,113511,113513,0,2,0
32397,3,2,113514,113514,113516,0,2,1
32398,6,2,113520,113520,113522,0,2,4
32399,1,2,113521,113522,113524,1,3,0
32400,2,2,113523,113524,113526,1,3,0
32401,4,1,113527,113527,113528,0,1,1
32402,5,2,113532,113532,113534,0,2,4
32403,4,2,113536,113536,113538,0,2,2
32404,4,1,113540,113540,113541,0,1,2
32405,1,1,113541,113541,113542,0,1,0
32406,5,3,113546,113546,113549,0,3,4
32407,2,1,113548,113549,113550,1,2,0
32408,5,1,113553,113553,113554,0,1,3
32409,4,2,113557,113557,113559,0,2,3
32410,5,3,113562,113562,113565,0,3,3
32411,5,1,113567,113567,113568,0,1,2
32412,1,1,113568,113568,113569,0,1,0
32413,5,2,113573,113573,113575,0,2,4
32414,1,1,113574,113575,113576,1,2,0
32415,5,1,113579,113579,113580,0,1,3
32416,1,1,113580,113580,113581,0,1,0
32417,1,1,113581,113581,113582,0,1,0
32418,4,2,113585,113585,113587,0,2,3
32419,6,3,113591,113591,113594,0,3,4
32420,3,1,113594,113594,113595,0,1,0
32421,1,2,113595,113595,113597,0,2,0
32422,3,2,113598,113598,113600,0,2,1
32423,1,2,113599,113600,113602,1,3,0
32424,1,3,113600,113602,113605,2,5,0
32425,3,3,113603,113605,113608,2,5,0
32426,2,3,113605,113608,113611,3,6,0
32427,5,2,113610,113611,113613,1,3,0
32428,2,2,113612,113613,113615,1,3,0
32429,2,1,113614,113615,113616,1,2,0
32430,4,1,113618,113618,113619,0,1,2
32431,3,1,113621,113621,113622,0,1,2
32432,6,2,113627,113627,113629,0,2,5
32433,5,2,113632,113632,113634,0,2,3
32434,5,2,113637,113637,113639,0,2,3
32435,4,2,113641,113641,113643,0,2,2
32436,1,2,113642,113643,113645,1,3,0
32437,5,1,113647,113647,113648,0,1,2
32438,1,3,113648,113648,113651,0,3,0
32439,1,1,113649,113651,113652,2,3,0
32440,2,1,113651,113652,113653,1,2,0
32441,3,3,113654,113654,113657,0,3,1
32442,6,1,113660,113660,113661,0,1,3
32443,2,3,113662,113662,113665,0,3,1
32444,4,2,113666,113666,113668,0,2,1
32445,2,2,113668,113668,113670,0,2,0
32446,4,1,113672,113672,113673,0,1,2
32447,6,3,113678,113678,113681,0,3,5
32448,2,1,113680,113681,113682,1,2,0
32449,3,1,113683,113683,113684,0,1,1
32450,4,2,113687,113687,113689,0,2,3
32451,5,1,113692,113692,113693,0,1,3
32452,5,1,113697,113697,113698,0,1,4
32453,5,3,113702,113702,113705,0,3,4
32454,1,1,113703,113705,113706,2,3,0
32455,1,2,113704,113706,113708,2,4,0
32456,6,2,113710,113710,113712,0,2,2
32457,3,2,113713,113713,113715,0,2,1
32458,2,3,113715,113715,113718,0,3,0
32459,6,1,113721,113721,113722,0,1,3
32460,4,1,113725,113725,113726,0,1,3
32461,1,1,113726,113726,113727,0,1,0
32462,4,2,113730,113730,113732,0,2,3
32463,4,2,113734,113734,113736,0,2,2
32464,6,3,113740,113740,113743,0,3,4
32465,1,2,113741,113743,113745,2,4,0
32466,5,3,113746,113746,113749,0,3,1
32467,3,3,113749,113749,113752,0,3,0
32468,6,1,113755,113755,113756,0,1,3
32469,2,1,113757,113757,113758,0,1,1
32470,2,2,113759,113759,113761,0,2,1
32471,2,1,113761,113761,113762,0,1,0
32472,2,1,113763,113763,113764,0,1,1
32473,4,3,113767,113767,113770,0,3,3
32474,1,3,113768,113770,113773,2,5,0
32475,1,2,113769,113773,113775,4,6,0
32476,6,1,113775,113775,113776,0,1,0
32477,4,1,113779,113779,113780,0,1,3
32478,4,2,113783,113783,113785,0,2,3
32479,5,3,113788,113788,113791,0,3,3
32480,3,3,113791,113791,113794,0,3,0
32481,5,2,113796,113796,113798,0,2,2
32482,4,2,113800,113800,113802,0,2,2
32483,6,1,113806,113806,113807,0,1,4
32484,2,3,113808,113808,113811,0,3,1
32485,6,2,113814,113814,113816,0,2,3
32486,6,2,113820,113820,113822,0,2,4
32487,5,1,113825,113825,113826,0,1,3
32488,5,3,113830,113830,113833,0,3,4
32489,3,2,113833,113833,113835,0,2,0
32490,5,1,113838,113838,113839,0,1,3
32491,6,2,113844,113844,113846,0,2,5
32492,4,3,113848,113848,113851,0,3,2
32493,1,2,113849,113851,113853,2,4,0
32494,5,3,113854,113854,113857,0,3,1
32495,2,2,113856,113857,113859,1,3,0
32496,5,3,113861,113861,113864,0,3,2
32497,5,2,113866,113866,113868,0,2,2
32498,1,3,113867,113868,113871,1,4,0
32499,3,1,113870,113871,113872,1,2,0
32500,1,3,113871,113872,113875,1,4,0
32501,6,2,113877,113877,113879,0,2,2
32502,1,3,113878,113879,113882,1,4,0
32503,4,3,113882,113882,113885,0,3,0
32504,5,1,113887,113887,113888,0,1,2
32505,6,2,113893,113893,113895,0,2,5
32506,4,1,113897,113897,113898,0,1,2
32507,3,3,113900,113900,113903,0,3,2
32508,3,3,113903,113903,113906,0,3,0
32509,4,2,113907,113907,113909,0,2,1
32510,2,2,113909,113909,113911,0,2,0
32511,6,1,113915,113915,113916,0,1,4
32512,6,3,113921,113921,113924,0,3,5
32513,4,3,113925,113925,113928,0,3,1
32514,6,2,113931,113931,113933,0,2,3
32515,3,3,113934,113934,113937,0,3,1
32516,5,1,113939,113939,113940,0,1,2
32517,5,1,113944,113944,113945,0,1,4
32518,3,3,113947,113947,113950,0,3,2
32519,1,2,113948,113950,113952,2,4,0
32520,6,3,113954,113954,113957,0,3,2
32521,2,3,113956,113957,113960,1,4,0
32522,5,2,113961,113961,113963,0,2,1
32523,1,2,113962,113963,113965,1,3,0
32524,4,2,113966,113966,113968,0,2,1
32525,5,1,113971,113971,113972,0,1,3
32526,2,1,113973,113973,113974,0,1,1
32527,2,3,113975,113975,113978,0,3,1
32528,6,2,113981,113981,113983,0,2,3
32529,4,1,113985,113985,113986,0,1,2
32530,1,3,113986,113986,113989,0,3,0
32531,4,1,113990,113990,113991,0,1,1
32532,1,2,113991,113991,113993,0,2,0
32533,2,3,113993,113993,113996,0,3,0
32534,1,2,113994,113996,113998,2,4,0
32535,1,1,113995,113998,113999,3,4,0
32536,2,1,113997,113999,114000,2,3,0
32537,6,2,114003,114003,114005,0,2,3
32538,3,3,114006,114006,114009,0,3,1
32539,6,1,114012,114012,114013,0,1,3
32540,1,2,114013,114013,114015,0,2,0
32541,3,1,114016,114016,114017,0,1,1
32542,4,3,114020,114020,114023,0,3,3
32543,3,1,114023,114023,114024,0,1,0
32544,3,3,114026,114026,114029,0,3,2
32545,5,3,114031,114031,114034,0,3,2
32546,6,2,114037,114037,114039,0,2,3
32547,2,2,114039,114039,114041,0,2,0
32548,5,3,114044,114044,114047,0,3,3
32549,2,3,114046,114047,114050,1,4,0
32550,6,3,114052,114052,114055,0,3,2
32551,3,3,114055,114055,114058,0,3,0
32552,5,1,114060,114060,114061,0,1,2
32553,3,1,114063,114063,114064,0,1,2
32554,1,2,114064,114064,114066,0,2,0
32555,6,1,114070,114070,114071,0,1,4
32556,4,3,114074,114074,114077,0,3,3
32557,1,3,114075,114077,114080,2,5,0
32558,4,3,114079,114080,114083,1,4,0
32559,2,1,114081,114083,114084,2,3,0
32560,6,1,114087,114087,114088,0,1,3
32561,3,1,114090,114090,114091,0,1,2
32562,2,2,114092,114092,114094,0,2,1
32563,6,1,114098,114098,114099,0,1,4
32564,4,1,114102,114102,114103,0,1,3
32565,5,3,114107,114107,114110,0,3,4
32566,4,3,114111,114111,114114,0,3,1
32567,5,2,114116,114116,114118,0,2,2
32568,6,3,114122,114122,114125,0,3,4
32569,3,3,114125,114125,114128,0,3,0
32570,1,1,114126,114128,114129,2,3,0
32571,4,1,114130,114130,114131,0,1,1
32572,2,3,114132,114132,114135,0,3,1
32573,1,2,114133,114135,114137,2,4,0
32574,6,2,114139,114139,114141,0,2,2
32575,5,1,114144,114144,114145,0,1,3
32576,1,3,114145,114145,114148,0,3,0
32577,4,2,114149,114149,114151,0,2,1
32578,4,1,114153,114153,114154,0,1,2
32579,3,1,114156,114156,114157,0,1,2
32580,4,3,114160,114160,114163,0,3,3
32581,2,1,114162,114163,114164,1,2,0
32582,1,3,114163,114164,114167,1,4,0
32583,6,2,114169,114169,114171,0,2,2
32584,2,3,114171,114171,114174,0,3,0
32585,4,1,114175,114175,114176,0,1,1
32586,6,2,114181,114181,114183,0,2,5
32587,6,2,114187,114187,114189,0,2,4
32588,3,1,114190,114190,114191,0,1,1
32589,6,3,114196,114196,114199,0,3,5
32590,3,1,114199,114199,114200,0,1,0
32591,2,2,114201,114201,114203,0,2,1
32592,3,1,114204,114204,114205,0,1,1
32593,5,2,114209,114209,114211,0,2,4
32594,6,3,114215,114215,114218,0,3,4
32595,5,2,114220,114220,114222,0,2,2
32596,1,3,114221,114222,114225,1,4,0
32597,6,2,114227,114227,114229,0,2,2
32598,3,1,114230,114230,114231,0,1,1
32599,3,2,114233,114233,114235,0,2,2
32600,4,3,114237,114237,114240,0,3,2
32601,5,1,114242,114242,114243,0,1,2
32602,5,2,114247,114247,114249,0,2,4
32603,5,3,114252,114252,114255,0,3,3
32604,6,3,114258,114258,114261,0,3,3
32605,3,3,114261,114261,114264,0,3,0
32606,3,1,114264,114264,114265,0,1,0
32607,6,1,114270,114270,114271,0,1,5
32608,4,2,114274,114274,114276,0,2,3
32609,6,3,114280,114280,114283,0,3,4
32610,3,1,114283,114283,114284,0,1,0
32611,6,1,114289,114289,114290,0,1,5
32612,3,2,114292,114292,114294,0,2,2
32613,4,2,114296,114296,114298,0,2,2
32614,2,1,114298,114298,114299,0,1,0
32615,2,1,114300,114300,114301,0,1,1
32616,6,3,114306,114306,114309,0,3,5
32617,1,3,114307,114309,114312,2,5,0
32618,2,1,114309,114312,114313,3,4,0
32619,1,3,114310,114313,114316,3,6,0
32620,3,2,114313,114316,114318,3,5,0
32621,6,3,114319,114319,114322,0,3,1
32622,5,3,114324,114324,114327,0,3,2
32623,4,3,114328,114328,114331,0,3,1
32624,3,3,114331,114331,114334,0,3,0
32625,4,2,114335,114335,114337,0,2,1
32626,1,3,114336,114337,114340,1,4,0
32627,6,3,114342,114342,114345,0,3,2
32628,4,2,114346,114346,114348,0,2,1
32629,2,2,114348,114348,114350,0,2,0
32630,6,2,114354,114354,114356,0,2,4
32631,4,1,114358,114358,114359,0,1,2
32632,4,3,114362,114362,114365,0,3,3
32633,5,3,114367,114367,114370,0,3,2
32634,3,2,114370,114370,114372,0,2,0
32635,4,3,114374,114374,114377,0,3,2
32636,4,2,114378,114378,114380,0,2,1
32637,2,1,114380,114380,114381,0,1,0
32638,4,1,114384,114384,114385,0,1,3
32639,2,3,114386,114386,114389,0,3,1
32640,4,3,114390,114390,114393,0,3,1
32641,2,3,114392,114393,114396,1,4,0
32642,4,3,114396,114396,114399,0,3,0
32643,3,3,114399,114399,114402,0,3,0
32644,5,3,114404,114404,114407,0,3,2
32645,1,2,114405,114407,114409,2,4,0
32646,6,3,114411,114411,114414,0,3,2
32647,3,1,114414,114414,114415,0,1,0
32648,4,3,114418,114418,114421,0,3,3
32649,1,2,114419,114421,114423,2,4,0
32650,5,3,114424,114424,114427,0,3,1
32651,4,2,114428,114428,114430,0,2,1
32652,4,2,114432,114432,114434,0,2,2
32653,2,2,114434,114434,114436,0,2,0
32654,6,2,114440,114440,114442,0,2,4
32655,5,2,114445,114445,114447,0,2,3
32656,4,3,114449,114449,114452,0,3,2
32657,3,1,114452,114452,114453,0,1,0
32658,2,3,114454,114454,114457,0,3,1
32659,3,1,114457,114457,114458,0,1,0
32660,4,3,114461,114461,114464,0,3,3
32661,4,3,114465,114465,114468,0,3,1
32662,5,2,114470,114470,114472,0,2,2
32663,6,3,114476,114476,114479,0,3,4
32664,5,1,114481,114481,114482,0,1,2
32665,4,3,114485,114485,114488,0,3,3
32666,2,1,114487,114488,114489,1,2,0
32667,1,2,114488,114489,114491,1,3,0
32668,6,2,114494,114494,114496,0,2,3
32669,2,3,114496,114496,114499,0,3,0
32670,3,1,114499,114499,114500,0,1,0
32671,3,3,114502,114502,114505,0,3,2
32672,4,1,114506,114506,114507,0,1,1
32673,1,3,114507,114507,114510,0,3,0
32674,1,3,114508,114510,114513,2,5,0
32675,1,1,114509,114513,114514,4,5,0
32676,2,1,114511,114514,114515,3,4,0
32677,5,2,114516,114516,114518,0,2,1
32678,5,1,114521,114521,114522,0,1,3
32679,5,1,114526,114526,114527,0,1,4
32680,4,1,114530,114530,114531,0,1,3
32681,1,1,114531,114531,114532,0,1,0
32682,6,3,114537,114537,114540,0,3,5
32683,5,3,114542,114542,114545,0,3,2
32684,5,2,114547,114547,114549,0,2,2
32685,3,2,114550,114550,114552,0,2,1
32686,5,1,114555,114555,114556,0,1,3
32687,6,1,114561,114561,114562,0,1,5
32688,5,3,114566,114566,114569,0,3,4
32689,4,3,114570,114570,114573,0,3,1
32690,3,3,114573,114573,114576,0,3,0
32691,1,3,114574,114576,114579,2,5,0
32692,6,2,114580,114580,114582,0,2,1
32693,2,1,114582,114582,114583,0,1,0
32694,1,2,114583,114583,114585,0,2,0
32695,5,2,114588,114588,114590,0,2,3
32696,5,3,114593,114593,114596,0,3,3
32697,4,1,114597,114597,114598,0,1,1
32698,5,1,114602,114602,114603,0,1,4
32699,6,2,114608,114608,114610,0,2,5
32700,5,2,114613,114613,114615,0,2,3
32701,6,2,114619,114619,114621,0,2,4
32702,2,1,114621,114621,114622,0,1,0
32703,1,3,114622,114622,114625,0,3,0
32704,4,1,114626,114626,114627,0,1,1
32705,4,2,114630,114630,114632,0,2,3
32706,1,3,114631,114632,114635,1,4,0
32707,6,3,114637,114637,114640,0,3,2
32708,6,1,114643,114643,114644,0,1,3
32709,1,2,114644,114644,114646,0,2,0
32710,1,1,114645,114646,114647,1,2,0
32711,1,2,114646,114647,114649,1,3,0
32712,6,3,114652,114652,114655,0,3,3
32713,1,1,114653,114655,114656,2,3,0
32714,2,1,114655,114656,114657,1,2,0
32715,1,3,114656,114657,114660,1,4,0
32716,6,1,114662,114662,114663,0,1,2
32717,5,1,114667,114667,114668,0,1,4
32718,5,2,114672,114672,114674,0,2,4
32719,5,1,114677,114677,114678,0,1,3
32720,6,1,114683,114683,114684,0,1,5
32721,4,2,114687,114687,114689,0,2,3
32722,6,1,114693,114693,114694,0,1,4
32723,5,3,114698,114698,114701,0,3,4
32724,3,2,114701,114701,114703,0,2,0
32725,1,2,114702,114703,114705,1,3,0
32726,6,1,114708,114708,114709,0,1,3
32727,1,3,114709,114709,114712,0,3,0
32728,3,3,114712,114712,114715,0,3,0
32729,4,1,114716,114716,114717,0,1,1
32730,1,3,114717,114717,114720,0,3,0
32731,1,1,114718,114720,114721,2,3,0
32732,6,1,114724,114724,114725,0,1,3
32733,2,1,114726,114726,114727,0,1,1
32734,3,3,114729,114729,114732,0,3,2
32735,4,2,114733,114733,114735,0,2,1
32736,3,3,114736,114736,114739,0,3,1
32737,1,1,114737,114739,114740,2,3,0
32738,5,1,114742,114742,114743,0,1,2
32739,6,1,114748,114748,114749,0,1,5
32740,3,3,114751,114751,114754,0,3,2
32741,3,2,114754,114754,114756,0,2,0
32742,6,3,114760,114760,114763,0,3,4
32743,1,1,114761,114763,114764,2,3,0
32744,2,1,114763,114764,114765,1,2,0
32745,3,2,114766,114766,114768,0,2,1
32746,3,3,114769,114769,114772,0,3,1
32747,6,3,114775,114775,114778,0,3,3
32748,2,1,114777,114778,114779,1,2,0
32749,3,2,114780,114780,114782,0,2,1
32750,4,2,114784,114784,114786,0,2,2
32751,6,2,114790,114790,114792,0,2,4
32752,1,3,114791,114792,114795,1,4,0
32753,1,2,114792,114795,114797,3,5,0
32754,3,3,114795,114797,114800,2,5,0
32755,2,2,114797,114800,114802,3,5,0
32756,4,3,114801,114802,114805,1,4,0
32757,1,3,114802,114805,114808,3,6,0
32758,5,2,114807,114808,114810,1,3,0
32759,2,2,114809,114810,114812,1,3,0
32760,6,3,114815,114815,114818,0,3,3
32761,1,3,114816,114818,114821,2,5,0
32762,3,1,114819,114821,114822,2,3,0
32763,6,3,114825,114825,114828,0,3,3
32764,6,2,114831,114831,114833,0,2,3
32765,5,1,114836,114836,114837,0,1,3
32766,2,1,114838,114838,114839,0,1,1
32767,2,1,114840,114840,114841,0,1,1
32768,4,1,114844,114844,114845,0,1,3
32769,6,2,114850,114850,114852,0,2,5
32770,5,1,114855,114855,114856,0,1,3
32771,1,1,114856,114856,114857,0,1,0
32772,4,3,114860,114860,114863,0,3,3
32773,3,2,114863,114863,114865,0,2,0
32774,3,3,114866,114866,114869,0,3,1
32775,5,2,114871,114871,114873,0,2,2
32776,6,1,114877,114877,114878,0,1,4
32777,5,1,114882,114882,114883,0,1,4
32778,6,1,114888,114888,114889,0,1,5
32779,1,3,114889,114889,114892,0,3,0
32780,5,2,114894,114894,114896,0,2,2
32781,6,1,114900,114900,114901,0,1,4
32782,2,3,114902,114902,114905,0,3,1
32783,1,3,114903,114905,114908,2,5,0
32784,2,1,114905,114908,114909,3,4,0
32785,3,2,114908,114909,114911,1,3,0
32786,2,3,114910,114911,114914,1,4,0
32787,2,2,114912,114914,114916,2,4,0
32788,5,1,114917,114917,114918,0,1,1
32789,2,2,114919,114919,114921,0,2,1
32790,1,2,114920,114921,114923,1,3,0
32791,2,1,114922,114923,114924,1,2,0
32792,5,2,114927,114927,114929,0,2,3
32793,2,3,114929,114929,114932,0,3,0
32794,1,2,114930,114932,114934,2,4,0
32795,4,2,114934,114934,114936,0,2,0
32796,4,3,114938,114938,114941,0,3,2
32797,3,1,114941,114941,114942,0,1,0
32798,1,1,114942,114942,114943,0,1,0
32799,2,1,114944,114944,114945,0,1,1
32800,6,2,114950,114950,114952,0,2,5
32801,4,2,114954,114954,114956,0,2,2
32802,4,2,114958,114958,114960,0,2,2
32803,3,2,114961,114961,114963,0,2,1
32804,5,1,114966,114966,114967,0,1,3
32805,3,1,114969,114969,114970,0,1,2
32806,3,1,114972,114972,114973,0,1,2
32807,4,1,114976,114976,114977,0,1,3
32808,2,3,114978,114978,114981,0,3,1
32809,4,3,114982,114982,114985,0,3,1
32810,5,1,114987,114987,114988,0,1,2
32811,5,3,114992,114992,114995,0,3,4
32812,4,1,114996,114996,114997,0,1,1
32813,2,2,114998,114998,115000,0,2,1
32814,5,1,115003,115003,115004,0,1,3
32815,1,1,115004,115004,115005,0,1,0
32816,6,3,115010,115010,115013,0,3,5
32817,1,3,115011,115013,115016,2,5,0
32818,5,2,115016,115016,115018,0,2,0
32819,4,1,115020,115020,115021,0,1,2
32820,2,3,115022,115022,115025,0,3,1
32821,3,3,115025,115025,115028,0,3,0
32822,1,2,115026,115028,115030,2,4,0
32823,5,3,115031,115031,115034,0,3,1
32824,3,2,115034,115034,115036,0,2,0
32825,5,1,115039,115039,115040,0,1,3
32826,2,2,115041,115041,115043,0,2,1
32827,1,1,115042,115043,115044,1,2,0
32828,5,2,115047,115047,115049,0,2,3
32829,1,1,115048,115049,115050,1,2,0
32830,2,1,115050,115050,115051,0,1,0
32831,3,2,115053,115053,115055,0,2,2
32832,1,2,115054,115055,115057,1,3,0
32833,2,2,115056,115057,115059,1,3,0
32834,6,3,115062,115062,115065,0,3,3
32835,5,2,115067,115067,115069,0,2,2
32836,1,1,115068,115069,115070,1,2,0
32837,5,1,115073,115073,115074,0,1,3
32838,6,2,115079,115079,115081,0,2,5
32839,3,1,115082,115082,115083,0,1,1
32840,6,1,115088,115088,115089,0,1,5
32841,5,2,115093,115093,115095,0,2,4
32842,2,3,115095,115095,115098,0,3,0
32843,6,2,115101,115101,115103,0,2,3
32844,2,1,115103,115103,115104,0,1,0
32845,1,2,115104,115104,115106,0,2,0
32846,6,1,115110,115110,115111,0,1,4
32847,6,1,115116,115116,115117,0,1,5
32848,6,3,115122,115122,115125,0,3,5
32849,6,2,115128,115128,115130,0,2,3
32850,2,3,115130,115130,115133,0,3,0
32851,6,2,115136,115136,115138,0,2,3
32852,1,3,115137,115138,115141,1,4,0
32853,1,1,115138,115141,115142,3,4,0
32854,6,2,115144,115144,115146,0,2,2
32855,1,3,115145,115146,115149,1,4,0
32856,6,3,115151,115151,115154,0,3,2
32857,5,3,115156,115156,115159,0,3,2
32858,4,3,115160,115160,115163,0,3,1
32859,3,3,115163,115163,115166,0,3,0
32860,6,3,115169,115169,115172,0,3,3
32861,6,3,115175,115175,115178,0,3,3
32862,5,3,115180,115180,115183,0,3,2
32863,2,2,115182,115183,115185,1,3,0
32864,2,3,115184,115185,115188,1,4,0
32865,1,2,115185,115188,115190,3,5,0
32866,2,1,115187,115190,115191,3,4,0
32867,6,3,115193,115193,115196,0,3,2
32868,1,3,115194,115196,115199,2,5,0
32869,2,2,115196,115199,115201,3,5,0
32870,1,3,115197,115201,115204,4,7,0
32871,6,2,115203,115204,115206,1,3,0
32872,6,1,115209,115209,115210,0,1,3
32873,5,3,115214,115214,115217,0,3,4
32874,4,3,115218,115218,115221,0,3,1
32875,1,2,115219,115221,115223,2,4,0
32876,3,3,115222,115223,115226,1,4,0
32877,5,1,115227,115227,115228,0,1,1
32878,1,2,115228,115228,115230,0,2,0
32879,4,1,115232,115232,115233,0,1,2
32880,3,3,115235,115235,115238,0,3,2
32881,4,2,115239,115239,115241,0,2,1
32882,1,2,115240,115241,115243,1,3,0
32883,3,1,115243,115243,115244,0,1,0
32884,4,3,115247,115247,115250,0,3,3
32885,2,1,115249,115250,115251,1,2,0
32886,2,3,115251,115251,115254,0,3,0
32887,1,3,115252,115254,115257,2,5,0
32888,2,1,115254,115257,115258,3,4,0
32889,5,1,115259,115259,115260,0,1,1
32890,1,2,115260,115260,115262,0,2,0
32891,5,3,115265,115265,115268,0,3,3
32892,6,2,115271,115271,115273,0,2,3
32893,1,3,115272,115273,115276,1,4,0
32894,2,1,115274,115276,115277,2,3,0
32895,1,1,115275,115277,115278,2,3,0
32896,1,3,115276,115278,115281,2,5,0
32897,5,3,115281,115281,115284,0,3,0
32898,2,1,115283,115284,115285,1,2,0
32899,3,1,115286,115286,115287,0,1,1
32900,2,2,115288,115288,115290,0,2,1
32901,5,2,115293,115293,115295,0,2,3
32902,5,2,115298,115298,115300,0,2,3
32903,1,1,115299,115300,115301,1,2,0
32904,4,3,115303,115303,115306,0,3,2
32905,6,3,115309,115309,115312,0,3,3
32906,6,3,115315,115315,115318,0,3,3
32907,6,3,115321,115321,115324,0,3,3
32908,2,1,115323,115324,115325,1,2,0
32909,1,1,115324,115325,115326,1,2,0
32910,5,2,115329,115329,115331,0,2,3
32911,2,3,115331,115331,115334,0,3,0
32912,6,1,115337,115337,115338,0,1,3
32913,1,1,115338,115338,115339,0,1,0
32914,6,3,115344,115344,115347,0,3,5
32915,4,2,115348,115348,115350,0,2,1
32916,6,2,115354,115354,115356,0,2,4
32917,4,3,115358,115358,115361,0,3,2
32918,6,3,115364,115364,115367,0,3,3
32919,1,1,115365,115367,115368,2,3,0
32920,4,1,115369,115369,115370,0,1,1
32921,2,1,115371,115371,115372,0,1,1
32922,3,2,115374,115374,115376,0,2,2
32923,2,2,115376,115376,115378,0,2,0
32924,4,3,115380,115380,115383,0,3,2
32925,1,1,115381,115383,115384,2,3,0
32926,6,1,115387,115387,115388,0,1,3
32927,2,3,115389,115389,115392,0,3,1
32928,1,2,115390,115392,115394,2,4,0
32929,4,3,115394,115394,115397,0,3,0
32930,6,1,115400,115400,115401,0,1,3
32931,2,3,115402,115402,115405,0,3,1
32932,5,2,115407,115407,115409,0,2,2
32933,2,2,115409,115409,115411,0,2,0
32934,6,3,115415,115415,115418,0,3,4
32935,5,2,115420,115420,115422,0,2,2
32936,4,3,115424,115424,115427,0,3,2
32937,5,3,115429,115429,115432,0,3,2
32938,2,3,115431,115432,115435,1,4,0
32939,4,1,115435,115435,115436,0,1,0
32940,6,3,115441,115441,115444,0,3,5
32941,4,1,115445,115445,115446,0,1,1
32942,4,1,115449,115449,115450,0,1,3
32943,1,2,115450,115450,115452,0,2,0
32944,1,1,115451,115452,115453,1,2,0
32945,6,2,115457,115457,115459,0,2,4
32946,5,1,115462,115462,115463,0,1,3
32947,6,1,115468,115468,115469,0,1,5
32948,2,3,115470,115470,115473,0,3,1
32949,4,3,115474,115474,115477,0,3,1
32950,4,3,115478,115478,115481,0,3,1
32951,1,3,115479,115481,115484,2,5,0
32952,6,1,115485,115485,115486,0,1,1
32953,5,2,115490,115490,115492,0,2,4
32954,4,2,115494,115494,115496,0,2,2
32955,6,1,115500,115500,115501,0,1,4
32956,6,1,115506,115506,115507,0,1,5
32957,2,1,115508,115508,115509,0,1,1
32958,4,1,115512,115512,115513,0,1,3
32959,6,2,115518,115518,115520,0,2,5
32960,5,3,115523,115523,115526,0,3,3
32961,2,3,115525,115526,115529,1,4,0
32962,4,3,115529,115529,115532,0,3,0
32963,4,2,115533,115533,115535,0,2,1
32964,1,3,115534,115535,115538,1,4,0
32965,1,2,115535,115538,115540,3,5,0
32966,5,3,115540,115540,115543,0,3,0
32967,2,2,115542,115543,115545,1,3,0
32968,3,3,115545,115545,115548,0,3,0
32969,1,2,115546,115548,115550,2,4,0
32970,4,1,115550,115550,115551,0,1,0
32971,3,3,115553,115553,115556,0,3,2
32972,3,2,115556,115556,115558,0,2,0
32973,2,1,115558,115558,115559,0,1,0
32974,1,2,115559,115559,115561,0,2,0
32975,1,1,115560,115561,115562,1,2,0
32976,6,3,115566,115566,115569,0,3,4
32977,2,2,115568,115569,115571,1,3,0
32978,4,2,115572,115572,115574,0,2,1
32979,6,1,115578,115578,115579,0,1,4
32980,2,3,115580,115580,115583,0,3,1
32981,2,2,115582,115583,115585,1,3,0
32982,1,1,115583,115585,115586,2,3,0
32983,2,2,115585,115586,115588,1,3,0
32984,1,2,115586,115588,115590,2,4,0
32985,1,2,115587,115590,115592,3,5,0
32986,3,3,115590,115592,115595,2,5,0
32987,1,2,115591,115595,115597,4,6,0
32988,4,1,115595,115597,115598,2,3,0
32989,5,3,115600,115600,115603,0,3,2
32990,5,2,115605,115605,115607,0,2,2
32991,3,1,115608,115608,115609,0,1,1
32992,5,3,115613,115613,115616,0,3,4
32993,2,3,115615,115616,115619,1,4,0
32994,6,2,115621,115621,115623,0,2,2
32995,3,3,115624,115624,115627,0,3,1
32996,4,1,115628,115628,115629,0,1,1
32997,5,3,115633,115633,115636,0,3,4
32998,6,2,115639,115639,115641,0,2,3
32999,1,2,115640,115641,115643,1,3,0
33000,3,1,115643,115643,115644,0,1,0
33001,6,1,115649,115649,115650,0,1,5
33002,3,1,115652,115652,115653,0,1,2
33003,3,1,115655,115655,115656,0,1,2
33004,5,1,115660,115660,115661,0,1,4
33005,2,2,115662,115662,115664,0,2,1
33006,4,2,115666,115666,115668,0,2,2
33007,5,3,115671,115671,115674,0,3,3
33008,5,2,115676,115676,115678,0,2,2
33009,6,3,115682,115682,115685,0,3,4
33010,3,1,115685,115685,115686,0,1,0
33011,2,1,115687,115687,115688,0,1,1
33012,5,2,115692,115692,115694,0,2,4
33013,2,1,115694,115694,115695,0,1,0
33014,2,3,115696,115696,115699,0,3,1
33015,2,1,115698,115699,115700,1,2,0
33016,2,2,115700,115700,115702,0,2,0
33017,1,3,115701,115702,115705,1,4,0
33018,5,2,115706,115706,115708,0,2,1
33019,1,1,115707,115708,115709,1,2,0
33020,6,2,115713,115713,115715,0,2,4
33021,1,3,115714,115715,115718,1,4,0
33022,1,2,115715,115718,115720,3,5,0
33023,5,1,115720,115720,115721,0,1,0
33024,2,2,115722,115722,115724,0,2,1
33025,2,3,115724,115724,115727,0,3,0
33026,2,2,115726,115727,115729,1,3,0
33027,1,3,115727,115729,115732,2,5,0
33028,4,3,115731,115732,115735,1,4,0
33029,3,3,115734,115735,115738,1,4,0
33030,4,3,115738,115738,115741,0,3,0
33031,3,1,115741,115741,115742,0,1,0
33032,3,3,115744,115744,115747,0,3,2
33033,4,3,115748,115748,115751,0,3,1
33034,3,1,115751,115751,115752,0,1,0
33035,6,1,115757,115757,115758,0,1,5
33036,3,3,115760,115760,115763,0,3,2
33037,5,1,115765,115765,115766,0,1,2
33038,6,1,115771,115771,115772,0,1,5
33039,2,3,115773,115773,115776,0,3,1
33040,5,3,115778,115778,115781,0,3,2
33041,4,1,115782,115782,115783,0,1,1
33042,3,2,115785,115785,115787,0,2,2
33043,1,3,115786,115787,115790,1,4,0
33044,2,2,115788,115790,115792,2,4,0
33045,2,2,115790,115792,115794,2,4,0
33046,3,2,115793,115794,115796,1,3,0
33047,3,1,115796,115796,115797,0,1,0
33048,2,3,115798,115798,115801,0,3,1
33049,4,1,115802,115802,115803,0,1,1
33050,4,2,115806,115806,115808,0,2,3
33051,5,3,115811,115811,115814,0,3,3
33052,2,1,115813,115814,115815,1,2,0
33053,6,3,115819,115819,115822,0,3,4
33054,1,3,115820,115822,115825,2,5,0
33055,4,1,115824,115825,115826,1,2,0
33056,4,3,115828,115828,115831,0,3,2
33057,1,2,115829,115831,115833,2,4,0
33058,3,3,115832,115833,115836,1,4,0
33059,6,1,115838,115838,115839,0,1,2
33060,4,1,115842,115842,115843,0,1,3
33061,4,3,115846,115846,115849,0,3,3
33062,3,1,115849,115849,115850,0,1,0
33063,2,3,115851,115851,115854,0,3,1
33064,1,1,115852,115854,115855,2,3,0
33065,5,3,115857,115857,115860,0,3,2
33066,3,1,115860,115860,115861,0,1,0
33067,1,1,115861,115861,115862,0,1,0
33068,5,1,115866,115866,115867,0,1,4
33069,4,3,115870,115870,115873,0,3,3
33070,2,1,115872,115873,115874,1,2,0
33071,6,3,115878,115878,115881,0,3,4
33072,6,1,115884,115884,115885,0,1,3
33073,3,1,115887,115887,115888,0,1,2
33074,1,2,115888,115888,115890,0,2,0
33075,4,2,115892,115892,115894,0,2,2
33076,6,3,115898,115898,115901,0,3,4
33077,3,1,115901,115901,115902,0,1,0
33078,2,3,115903,115903,115906,0,3,1
33079,3,3,115906,115906,115909,0,3,0
33080,2,3,115908,115909,115912,1,4,0
33081,1,1,115909,115912,115913,3,4,0
33082,5,3,115914,115914,115917,0,3,1
33083,5,1,115919,115919,115920,0,1,2
33084,4,2,115923,115923,115925,0,2,3
33085,5,1,115928,115928,115929,0,1,3
33086,4,3,115932,115932,115935,0,3,3
33087,3,2,115935,115935,115937,0,2,0
33088,1,2,115936,115937,115939,1,3,0
33089,2,1,115938,115939,115940,1,2,0
33090,6,1,115944,115944,115945,0,1,4
33091,1,2,115945,115945,115947,0,2,0
33092,3,2,115948,115948,115950,0,2,1
33093,2,2,115950,115950,115952,0,2,0
33094,4,1,115954,115954,115955,0,1,2
33095,4,3,115958,115958,115961,0,3,3
33096,4,1,115962,115962,115963,0,1,1
33097,5,2,115967,115967,115969,0,2,4
33098,1,3,115968,115969,115972,1,4,0
33099,5,2,115973,115973,115975,0,2,1
33100,4,3,115977,115977,115980,0,3,2
33101,6,3,115983,115983,115986,0,3,3
33102,3,3,115986,115986,115989,0,3,0
33103,1,3,115987,115989,115992,2,5,0
33104,2,2,115989,115992,115994,3,5,0
33105,6,2,115995,115995,115997,0,2,1
33106,1,3,115996,115997,116000,1,4,0
33107,2,2,115998,116000,116002,2,4,0
33108,2,1,116000,116002,116003,2,3,0
33109,4,2,116004,116004,116006,0,2,1
33110,6,2,116010,116010,116012,0,2,4
33111,2,2,116012,116012,116014,0,2,0
33112,4,1,116016,116016,116017,0,1,2
33113,1,1,116017,116017,116018,0,1,0
33114,2,1,116019,116019,116020,0,1,1
33115,6,1,116025,116025,116026,0,1,5
33116,6,2,116031,116031,116033,0,2,5
33117,4,1,116035,116035,116036,0,1,2
33118,4,3,116039,116039,116042,0,3,3
33119,6,3,116045,116045,116048,0,3,3
33120,1,2,116046,116048,116050,2,4,0
33121,2,1,116048,116050,116051,2,3,0
33122,5,2,116053,116053,116055,0,2,2
33123,5,1,116058,116058,116059,0,1,3
33124,3,3,116061,116061,116064,0,3,2
33125,2,1,116063,116064,116065,1,2,0
33126,2,2,116065,116065,116067,0,2,0
33127,6,3,116071,116071,116074,0,3,4
33128,6,2,116077,116077,116079,0,2,3
33129,3,2,116080,116080,116082,0,2,1
33130,6,1,116086,116086,116087,0,1,4
33131,1,2,116087,116087,116089,0,2,0
33132,2,1,116089,116089,116090,0,1,0
33133,1,3,116090,116090,116093,0,3,0
33134,6,2,116096,116096,116098,0,2,3
33135,2,3,116098,116098,116101,0,3,0
33136,6,2,116104,116104,116106,0,2,3
33137,6,2,116110,116110,116112,0,2,4
33138,5,1,116115,116115,116116,0,1,3
33139,6,1,116121,116121,116122,0,1,5
33140,1,2,116122,116122,116124,0,2,0
33141,5,2,116127,116127,116129,0,2,3
33142,2,2,116129,116129,116131,0,2,0
33143,1,2,116130,116131,116133,1,3,0
33144,2,2,116132,116133,116135,1,3,0
33145,6,3,116138,116138,116141,0,3,3
33146,2,2,116140,116141,116143,1,3,0
33147,3,3,116143,116143,116146,0,3,0
33148,5,1,116148,116148,116149,0,1,2
33149,5,3,116153,116153,116156,0,3,4
33150,2,2,116155,116156,116158,1,3,0
33151,2,2,116157,116158,116160,1,3,0
33152,5,2,116162,116162,116164,0,2,2
33153,6,2,116168,116168,116170,0,2,4
33154,6,2,116174,116174,116176,0,2,4
33155,5,3,116179,116179,116182,0,3,3
33156,1,1,116180,116182,116183,2,3,0
33157,4,1,116184,116184,116185,0,1,1
33158,6,3,116190,116190,116193,0,3,5
33159,5,2,116195,116195,116197,0,2,2
33160,4,1,116199,116199,116200,0,1,2
33161,5,1,116204,116204,116205,0,1,4
33162,6,3,116210,116210,116213,0,3,5
33163,6,3,116216,116216,116219,0,3,3
33164,6,2,116222,116222,116224,0,2,3
33165,5,3,116227,116227,116230,0,3,3
33166,2,2,116229,116230,116232,1,3,0
33167,3,2,116232,116232,116234,0,2,0
33168,6,3,116238,116238,116241,0,3,4
33169,3,2,116241,116241,116243,0,2,0
33170,2,1,116243,116243,116244,0,1,0
33171,6,1,116249,116249,116250,0,1,5
33172,4,2,116253,116253,116255,0,2,3
33173,6,1,116259,116259,116260,0,1,4
33174,6,3,116265,116265,116268,0,3,5
33175,1,2,116266,116268,116270,2,4,0
33176,3,2,116269,116270,116272,1,3,0
33177,2,3,116271,116272,116275,1,4,0
33178,4,3,116275,116275,116278,0,3,0
33179,1,2,116276,116278,116280,2,4,0
33180,1,2,116277,116280,116282,3,5,0
33181,4,1,116281,116282,116283,1,2,0
33182,2,2,116283,116283,116285,0,2,0
33183,4,1,116287,116287,116288,0,1,2
33184,2,2,116289,116289,116291,0,2,1
33185,3,2,116292,116292,116294,0,2,1
33186,5,1,116297,116297,116298,0,1,3
33187,4,2,116301,116301,116303,0,2,3
33188,3,2,116304,116304,116306,0,2,1
33189,5,2,116309,116309,116311,0,2,3
33190,1,2,116310,116311,116313,1,3,0
33191,6,1,116316,116316,116317,0,1,3
33192,2,3,116318,116318,116321,0,3,1
33193,5,3,116323,116323,116326,0,3,2
33194,1,3,116324,116326,116329,2,5,0
33195,5,3,116329,116329,116332,0,3,0
33196,5,1,116334,116334,116335,0,1,2
33197,6,1,116340,116340,116341,0,1,5
33198,2,3,116342,116342,116345,0,3,1
33199,6,3,116348,116348,116351,0,3,3
33200,6,1,116354,116354,116355,0,1,3
33201,5,1,116359,116359,116360,0,1,4
33202,1,2,116360,116360,116362,0,2,0
33203,1,3,116361,116362,116365,1,4,0
33204,2,3,116363,116365,116368,2,5,0
33205,3,3,116366,116368,116371,2,5,0
33206,3,3,116369,116371,116374,2,5,0
33207,4,3,116373,116374,116377,1,4,0
33208,3,3,116376,116377,116380,1,4,0
33209,6,1,116382,116382,116383,0,1,2
33210,4,1,116386,116386,116387,0,1,3
33211,1,1,116387,116387,116388,0,1,0
33212,5,2,116392,116392,116394,0,2,4
33213,3,2,116395,116395,116397,0,2,1
33214,6,1,116401,116401,116402,0,1,4
33215,4,1,116405,116405,116406,0,1,3
33216,4,3,116409,116409,116412,0,3,3
33217,1,1,116410,116412,116413,2,3,0
33218,5,2,116415,116415,116417,0,2,2
33219,5,1,116420,116420,116421,0,1,3
33220,5,2,116425,116425,116427,0,2,4
33221,6,3,116431,116431,116434,0,3,4
33222,3,3,116434,116434,116437,0,3,0
33223,6,1,116440,116440,116441,0,1,3
33224,4,3,116444,116444,116447,0,3,3
33225,6,3,116450,116450,116453,0,3,3
33226,4,2,116454,116454,116456,0,2,1
33227,1,1,116455,116456,116457,1,2,0
33228,6,2,116461,116461,116463,0,2,4
33229,3,2,116464,116464,116466,0,2,1
33230,4,3,116468,116468,116471,0,3,2
33231,5,1,116473,116473,116474,0,1,2
33232,2,1,116475,116475,116476,0,1,1
33233,4,3,116479,116479,116482,0,3,3
33234,4,1,116483,116483,116484,0,1,1
33235,1,1,116484,116484,116485,0,1,0
33236,6,3,116490,116490,116493,0,3,5
33237,1,3,116491,116493,116496,2,5,0
33238,6,2,116497,116497,116499,0,2,1
33239,1,3,116498,116499,116502,1,4,0
33240,6,3,116504,116504,116507,0,3,2
33241,6,3,116510,116510,116513,0,3,3
33242,2,2,116512,116513,116515,1,3,0
33243,3,2,116515,116515,116517,0,2,0
33244,3,3,116518,116518,116521,0,3,1
33245,4,2,116522,116522,116524,0,2,1
33246,2,3,116524,116524,116527,0,3,0
33247,3,1,116527,116527,116528,0,1,0
33248,5,3,116532,116532,116535,0,3,4
33249,1,2,116533,116535,116537,2,4,0
33250,6,3,116539,116539,116542,0,3,2
33251,6,2,116545,116545,116547,0,2,3
33252,1,3,116546,116547,116550,1,4,0
33253,6,3,116552,116552,116555,0,3,2
33254,4,1,116556,116556,116557,0,1,1
33255,3,3,116559,116559,116562,0,3,2
33256,6,2,116565,116565,116567,0,2,3
33257,4,3,116569,116569,116572,0,3,2
33258,5,2,116574,116574,116576,0,2,2
33259,2,1,116576,116576,116577,0,1,0
33260,6,1,116582,116582,116583,0,1,5
33261,5,2,116587,116587,116589,0,2,4
33262,5,3,116592,116592,116595,0,3,3
33263,3,3,116595,116595,116598,0,3,0
33264,3,1,116598,116598,116599,0,1,0
33265,6,3,116604,116604,116607,0,3,5
33266,1,1,116605,116607,116608,2,3,0
33267,2,1,116607,116608,116609,1,2,0
33268,2,2,116609,116609,116611,0,2,0
33269,4,2,116613,116613,116615,0,2,2
33270,5,1,116618,116618,116619,0,1,3
33271,2,2,116620,116620,116622,0,2,1
33272,4,3,116624,116624,116627,0,3,2
33273,4,2,116628,116628,116630,0,2,1
33274,5,1,116633,116633,116634,0,1,3
33275,6,2,116639,116639,116641,0,2,5
33276,1,3,116640,116641,116644,1,4,0
33277,4,2,116644,116644,116646,0,2,0
33278,6,3,116650,116650,116653,0,3,4
33279,5,1,116655,116655,116656,0,1,2
33280,6,1,116661,116661,116662,0,1,5
33281,2,1,116663,116663,116664,0,1,1
33282,4,1,116667,116667,116668,0,1,3
33283,4,1,116671,116671,116672,0,1,3
33284,2,3,116673,116673,116676,0,3,1
33285,4,3,116677,116677,116680,0,3,1
33286,5,2,116682,116682,116684,0,2,2
33287,6,3,116688,116688,116691,0,3,4
33288,5,2,116693,116693,116695,0,2,2
33289,5,1,116698,116698,116699,0,1,3
33290,3,3,116701,116701,116704,0,3,2
33291,5,1,116706,116706,116707,0,1,2
33292,3,3,116709,116709,116712,0,3,2
33293,4,2,116713,116713,116715,0,2,1
33294,6,2,116719,116719,116721,0,2,4
33295,3,2,116722,116722,116724,0,2,1
33296,6,1,116728,116728,116729,0,1,4
33297,5,3,116733,116733,116736,0,3,4
33298,6,2,116739,116739,116741,0,2,3
33299,1,1,116740,116741,116742,1,2,0
33300,2,1,116742,116742,116743,0,1,0
33301,5,2,116747,116747,116749,0,2,4
33302,3,3,116750,116750,116753,0,3,1
33303,2,1,116752,116753,116754,1,2,0
33304,2,2,116754,116754,116756,0,2,0
33305,1,2,116755,116756,116758,1,3,0
33306,5,3,116760,116760,116763,0,3,2
33307,4,2,116764,116764,116766,0,2,1
33308,6,1,116770,116770,116771,0,1,4
33309,3,3,116773,116773,116776,0,3,2
33310,6,3,116779,116779,116782,0,3,3
33311,2,2,116781,116782,116784,1,3,0
33312,4,3,116785,116785,116788,0,3,1
33313,2,3,116787,116788,116791,1,4,0
33314,5,3,116792,116792,116795,0,3,1
33315,4,1,116796,116796,116797,0,1,1
33316,1,3,116797,116797,116800,0,3,0
33317,2,2,116799,116800,116802,1,3,0
33318,2,1,116801,116802,116803,1,2,0
33319,3,2,116804,116804,116806,0,2,1
33320,5,1,116809,116809,116810,0,1,3
33321,4,3,116813,116813,116816,0,3,3
33322,6,2,116819,116819,116821,0,2,3
33323,3,3,116822,116822,116825,0,3,1
33324,5,2,116827,116827,116829,0,2,2
33325,3,1,116830,116830,116831,0,1,1
33326,1,1,116831,116831,116832,0,1,0
33327,3,1,116834,116834,116835,0,1,2
33328,3,2,116837,116837,116839,0,2,2
33329,5,3,116842,116842,116845,0,3,3
33330,4,1,116846,116846,116847,0,1,1
33331,4,1,116850,116850,116851,0,1,3
33332,3,1,116853,116853,116854,0,1,2
33333,5,2,116858,116858,116860,0,2,4
33334,1,1,116859,116860,116861,1,2,0
33335,4,1,116863,116863,116864,0,1,2
33336,2,3,116865,116865,116868,0,3,1
33337,5,3,116870,116870,116873,0,3,2
33338,3,3,116873,116873,116876,0,3,0
33339,2,3,116875,116876,116879,1,4,0
33340,6,1,116881,116881,116882,0,1,2
33341,1,2,116882,116882,116884,0,2,0
33342,4,1,116886,116886,116887,0,1,2
33343,3,2,116889,116889,116891,0,2,2
33344,6,3,116895,116895,116898,0,3,4
33345,3,1,116898,116898,116899,0,1,0
33346,5,3,116903,116903,116906,0,3,4
33347,5,1,116908,116908,116909,0,1,2
33348,3,2,116911,116911,116913,0,2,2
33349,6,1,116917,116917,116918,0,1,4
33350,6,2,116923,116923,116925,0,2,5
33351,2,2,116925,116925,116927,0,2,0
33352,5,1,116930,116930,116931,0,1,3
33353,1,3,116931,116931,116934,0,3,0
33354,1,2,116932,116934,116936,2,4,0
33355,1,3,116933,116936,116939,3,6,0
33356,2,2,116935,116939,116941,4,6,0
33357,2,2,116937,116941,116943,4,6,0
33358,3,3,116940,116943,116946,3,6,0
33359,6,2,116946,116946,116948,0,2,0
33360,2,2,116948,116948,116950,0,2,0
33361,1,1,116949,116950,116951,1,2,0
33362,6,2,116955,116955,116957,0,2,4
33363,6,3,116961,116961,116964,0,3,4
33364,4,1,116965,116965,116966,0,1,1
33365,1,1,116966,116966,116967,0,1,0
33366,1,2,116967,116967,116969,0,2,0
33367,3,3,116970,116970,116973,0,3,1
33368,5,3,116975,116975,116978,0,3,2
33369,5,1,116980,116980,116981,0,1,2
33370,6,3,116986,116986,116989,0,3,5
33371,5,3,116991,116991,116994,0,3,2
33372,2,2,116993,116994,116996,1,3,0
33373,3,2,116996,116996,116998,0,2,0
33374,5,3,117001,117001,117004,0,3,3
33375,4,1,117005,117005,117006,0,1,1
33376,4,1,117009,117009,117010,0,1,3
33377,5,2,117014,117014,117016,0,2,4
33378,4,1,117018,117018,117019,0,1,2
33379,1,1,117019,117019,117020,0,1,0
33380,6,3,117025,117025,117028,0,3,5
33381,3,2,117028,117028,117030,0,2,0
33382,3,1,117031,117031,117032,0,1,1
33383,3,2,117034,117034,117036,0,2,2
33384,4,3,117038,117038,117041,0,3,2
33385,3,3,117041,117041,117044,0,3,0
33386,2,1,117043,117044,117045,1,2,0
33387,4,1,117047,117047,117048,0,1,2
33388,4,1,117051,117051,117052,0,1,3
33389,2,2,117053,117053,117055,0,2,1
33390,5,1,117058,117058,117059,0,1,3
33391,3,1,117061,117061,117062,0,1,2
33392,2,1,117063,117063,117064,0,1,1
33393,5,2,117068,117068,117070,0,2,4
33394,6,2,117074,117074,117076,0,2,4
33395,1,3,117075,117076,117079,1,4,0
33396,5,1,117080,117080,117081,0,1,1
33397,5,3,117085,117085,117088,0,3,4
33398,4,2,117089,117089,117091,0,2,1
33399,4,3,117093,117093,117096,0,3,2
33400,6,2,117099,117099,117101,0,2,3
33401,1,2,117100,117101,117103,1,3,0
33402,3,3,117103,117103,117106,0,3,0
33403,2,3,117105,117106,117109,1,4,0
33404,3,3,117108,117109,117112,1,4,0
33405,4,3,117112,117112,117115,0,3,0
33406,3,2,117115,117115,117117,0,2,0
33407,1,2,117116,117117,117119,1,3,0
33408,6,2,117122,117122,117124,0,2,3
33409,4,2,117126,117126,117128,0,2,2
33410,6,3,117132,117132,117135,0,3,4
33411,1,1,117133,117135,117136,2,3,0
33412,1,3,117134,117136,117139,2,5,0
33413,6,2,117140,117140,117142,0,2,1
33414,2,1,117142,117142,117143,0,1,0
33415,6,1,117148,117148,117149,0,1,5
33416,2,1,117150,117150,117151,0,1,1
33417,4,3,117154,117154,117157,0,3,3
33418,6,1,117160,117160,117161,0,1,3
33419,4,3,117164,117164,117167,0,3,3
33420,1,3,117165,117167,117170,2,5,0
33421,2,3,117167,117170,117173,3,6,0
33422,2,3,117169,117173,117176,4,7,0
33423,2,1,117171,117176,117177,5,6,0
33424,4,3,117175,117177,117180,2,5,0
33425,1,1,117176,117180,117181,4,5,0
33426,6,3,117182,117182,117185,0,3,1
33427,3,3,117185,117185,117188,0,3,0
33428,1,2,117186,117188,117190,2,4,0
33429,6,1,117192,117192,117193,0,1,2
33430,5,1,117197,117197,117198,0,1,4
33431,2,2,117199,117199,117201,0,2,1
33432,6,3,117205,117205,117208,0,3,4
33433,5,3,117210,117210,117213,0,3,2
33434,1,1,117211,117213,117214,2,3,0
33435,5,2,117216,117216,117218,0,2,2
33436,1,1,117217,117218,117219,1,2,0
33437,3,2,117220,117220,117222,0,2,1
33438,5,2,117225,117225,117227,0,2,3
33439,5,1,117230,117230,117231,0,1,3
33440,5,1,117235,117235,117236,0,1,4
33441,6,1,117241,117241,117242,0,1,5
33442,1,2,117242,117242,117244,0,2,0
33443,3,3,117245,117245,117248,0,3,1
33444,3,3,117248,117248,117251,0,3,0
33445,6,3,117254,117254,117257,0,3,3
33446,6,3,117260,117260,117263,0,3,3
33447,4,3,117264,117264,117267,0,3,1
33448,3,2,117267,117267,117269,0,2,0
33449,4,2,117271,117271,117273,0,2,2
33450,3,1,117274,117274,117275,0,1,1
33451,5,3,117279,117279,117282,0,3,4
33452,3,2,117282,117282,117284,0,2,0
33453,3,2,117285,117285,117287,0,2,1
33454,3,1,117288,117288,117289,0,1,1
33455,2,1,117290,117290,117291,0,1,1
33456,1,2,117291,117291,117293,0,2,0
33457,2,1,117293,117293,117294,0,1,0
33458,3,3,117296,117296,117299,0,3,2
33459,5,2,117301,117301,117303,0,2,2
33460,3,3,117304,117304,117307,0,3,1
33461,1,3,117305,117307,117310,2,5,0
33462,3,3,117308,117310,117313,2,5,0
33463,1,3,117309,117313,117316,4,7,0
33464,1,3,117310,117316,117319,6,9,0
33465,5,2,117315,117319,117321,4,6,0
33466,4,2,117319,117321,117323,2,4,0
33467,2,3,117321,117323,117326,2,5,0
33468,4,2,117325,117326,117328,1,3,0
33469,4,2,117329,117329,117331,0,2,1
33470,5,1,117334,117334,117335,0,1,3
33471,4,2,117338,117338,117340,0,2,3
33472,6,3,117344,117344,117347,0,3,4
33473,2,1,117346,117347,117348,1,2,0
33474,6,1,117352,117352,117353,0,1,4
33475,4,2,117356,117356,117358,0,2,3
33476,5,2,117361,117361,117363,0,2,3
33477,2,2,117363,117363,117365,0,2,0
33478,1,2,117364,117365,117367,1,3,0
33479,6,3,117370,117370,117373,0,3,3
33480,6,2,117376,117376,117378,0,2,3
33481,4,1,117380,117380,117381,0,1,2
33482,6,3,117386,117386,117389,0,3,5
33483,1,1,117387,117389,117390,2,3,0
33484,1,3,117388,117390,117393,2,5,0
33485,2,2,117390,117393,117395,3,5,0
33486,1,3,117391,117395,117398,4,7,0
33487,2,3,117393,117398,117401,5,8,0
33488,5,1,117398,117401,117402,3,4,0
33489,4,3,117402,117402,117405,0,3,0
33490,6,2,117408,117408,117410,0,2,3
33491,1,3,117409,117410,117413,1,4,0
33492,5,1,117414,117414,117415,0,1,1
33493,1,1,117415,117415,117416,0,1,0
33494,4,2,117419,117419,117421,0,2,3
33495,4,3,117423,117423,117426,0,3,2
33496,5,3,117428,117428,117431,0,3,2
33497,5,1,117433,117433,117434,0,1,2
33498,2,2,117435,117435,117437,0,2,1
33499,6,3,117441,117441,117444,0,3,4
33500,6,2,117447,117447,117449,0,2,3
33501,1,2,117448,117449,117451,1,3,0
33502,1,1,117449,117451,117452,2,3,0
33503,6,1,117455,117455,117456,0,1,3
33504,4,1,117459,117459,117460,0,1,3
33505,6,3,117465,117465,117468,0,3,5
33506,5,3,117470,117470,117473,0,3,2
33507,3,2,117473,117473,117475,0,2,0
33508,2,1,117475,117475,117476,0,1,0
33509,2,2,117477,117477,117479,0,2,1
33510,3,3,117480,117480,117483,0,3,1
33511,2,1,117482,117483,117484,1,2,0
33512,5,2,117487,117487,117489,0,2,3
33513,4,3,117491,117491,117494,0,3,2
33514,2,2,117493,117494,117496,1,3,0
33515,4,1,117497,117497,117498,0,1,1
33516,2,3,117499,117499,117502,0,3,1
33517,2,3,117501,117502,117505,1,4,0
33518,4,1,117505,117505,117506,0,1,0
33519,5,2,117510,117510,117512,0,2,4
33520,3,2,117513,117513,117515,0,2,1
33521,6,2,117519,117519,117521,0,2,4
33522,2,2,117521,117521,117523,0,2,0
33523,1,2,117522,117523,117525,1,3,0
33524,2,3,117524,117525,117528,1,4,0
33525,1,3,117525,117528,117531,3,6,0
33526,6,1,117531,117531,117532,0,1,0
33527,2,2,117533,117533,117535,0,2,1
33528,4,1,117537,117537,117538,0,1,2
33529,1,2,117538,117538,117540,0,2,0
33530,4,1,117542,117542,117543,0,1,2
33531,3,2,117545,117545,117547,0,2,2
33532,5,3,117550,117550,117553,0,3,3
33533,4,2,117554,117554,117556,0,2,1
33534,4,2,117558,117558,117560,0,2,2
33535,1,2,117559,117560,117562,1,3,0
33536,1,1,117560,117562,117563,2,3,0
33537,1,1,117561,117563,117564,2,3,0
33538,5,3,117566,117566,117569,0,3,2
33539,3,2,117569,117569,117571,0,2,0
33540,3,3,117572,117572,117575,0,3,1
33541,3,2,117575,117575,117577,0,2,0
33542,3,1,117578,117578,117579,0,1,1
33543,2,3,117580,117580,117583,0,3,1
33544,2,3,117582,117583,117586,1,4,0
33545,3,2,117585,117586,117588,1,3,0
33546,1,2,117586,117588,117590,2,4,0
33547,3,3,117589,117590,117593,1,4,0
33548,3,1,117592,117593,117594,1,2,0
33549,3,1,117595,117595,117596,0,1,1
33550,1,3,117596,117596,117599,0,3,0
33551,4,2,117600,117600,117602,0,2,1
33552,1,3,117601,117602,117605,1,4,0
33553,2,2,117603,117605,117607,2,4,0
33554,4,3,117607,117607,117610,0,3,0
33555,5,2,117612,117612,117614,0,2,2
33556,4,1,117616,117616,117617,0,1,2
33557,4,2,117620,117620,117622,0,2,3
33558,4,3,117624,117624,117627,0,3,2
33559,6,3,117630,117630,117633,0,3,3
33560,2,2,117632,117633,117635,1,3,0
33561,6,2,117638,117638,117640,0,2,3
33562,3,3,117641,117641,117644,0,3,1
33563,5,1,117646,117646,117647,0,1,2
33564,2,2,117648,117648,117650,0,2,1
33565,1,2,117649,117650,117652,1,3,0
33566,3,1,117652,117652,117653,0,1,0
33567,3,1,117655,117655,117656,0,1,2
33568,1,3,117656,117656,117659,0,3,0
33569,2,2,117658,117659,117661,1,3,0
33570,1,3,117659,117661,117664,2,5,0
33571,3,2,117662,117664,117666,2,4,0
33572,5,3,117667,117667,117670,0,3,1
33573,4,1,117671,117671,117672,0,1,1
33574,2,2,117673,117673,117675,0,2,1
33575,6,2,117679,117679,117681,0,2,4
33576,5,3,117684,117684,117687,0,3,3
33577,4,3,117688,117688,117691,0,3,1
33578,2,3,117690,117691,117694,1,4,0
33579,1,2,117691,117694,117696,3,5,0
33580,5,1,117696,117696,117697,0,1,0
33581,2,1,117698,117698,117699,0,1,1
33582,3,2,117701,117701,117703,0,2,2
33583,3,2,117704,117704,117706,0,2,1
33584,6,3,117710,117710,117713,0,3,4
33585,3,1,117713,117713,117714,0,1,0
33586,2,1,117715,117715,117716,0,1,1
33587,5,1,117720,117720,117721,0,1,4
33588,4,3,117724,117724,117727,0,3,3
33589,3,2,117727,117727,117729,0,2,0
33590,4,2,117731,117731,117733,0,2,2
33591,1,2,117732,117733,117735,1,3,0
33592,6,1,117738,117738,117739,0,1,3
33593,6,1,117744,117744,117745,0,1,5
33594,4,3,117748,117748,117751,0,3,3
33595,2,2,117750,117751,117753,1,3,0
33596,6,2,117756,117756,117758,0,2,3
33597,5,2,117761,117761,117763,0,2,3
33598,1,3,117762,117763,117766,1,4,0
33599,2,2,117764,117766,117768,2,4,0
33600,4,1,117768,117768,117769,0,1,0
33601,1,1,117769,117769,117770,0,1,0
33602,3,3,117772,117772,117775,0,3,2
33603,4,2,117776,117776,117778,0,2,1
33604,5,2,117781,117781,117783,0,2,3
33605,1,2,117782,117783,117785,1,3,0
33606,6,3,117788,117788,117791,0,3,3
33607,4,2,117792,117792,117794,0,2,1
33608,4,3,117796,117796,117799,0,3,2
33609,2,2,117798,117799,117801,1,3,0
33610,3,3,117801,117801,117804,0,3,0
33611,6,3,117807,117807,117810,0,3,3
33612,5,3,117812,117812,117815,0,3,2
33613,2,1,117814,117815,117816,1,2,0
33614,4,1,117818,117818,117819,0,1,2
33615,4,1,117822,117822,117823,0,1,3
33616,4,1,117826,117826,117827,0,1,3
33617,1,1,117827,117827,117828,0,1,0
33618,6,1,117833,117833,117834,0,1,5
33619,6,3,117839,117839,117842,0,3,5
33620,5,1,117844,117844,117845,0,1,2
33621,3,3,117847,117847,117850,0,3,2
33622,6,2,117853,117853,117855,0,2,3
33623,3,3,117856,117856,117859,0,3,1
33624,1,1,117857,117859,117860,2,3,0
33625,5,1,117862,117862,117863,0,1,2
33626,4,2,117866,117866,117868,0,2,3
33627,5,2,117871,117871,117873,0,2,3
33628,2,1,117873,117873,117874,0,1,0
33629,1,1,117874,117874,117875,0,1,0
33630,4,2,117878,117878,117880,0,2,3
33631,6,1,117884,117884,117885,0,1,4
33632,2,3,117886,117886,117889,0,3,1
33633,4,3,117890,117890,117893,0,3,1
33634,2,3,117892,117893,117896,1,4,0
33635,5,1,117897,117897,117898,0,1,1
33636,2,3,117899,117899,117902,0,3,1
33637,1,3,117900,117902,117905,2,5,0
33638,6,1,117906,117906,117907,0,1,1
33639,4,3,117910,117910,117913,0,3,3
33640,4,2,117914,117914,117916,0,2,1
33641,5,1,117919,117919,117920,0,1,3
33642,5,3,117924,117924,117927,0,3,4
33643,3,1,117927,117927,117928,0,1,0
33644,6,2,117933,117933,117935,0,2,5
33645,1,3,117934,117935,117938,1,4,0
33646,5,2,117939,117939,117941,0,2,1
33647,3,3,117942,117942,117945,0,3,1
33648,6,3,117948,117948,117951,0,3,3
33649,5,3,117953,117953,117956,0,3,2
33650,5,3,117958,117958,117961,0,3,2
33651,3,3,117961,117961,117964,0,3,0
33652,3,1,117964,117964,117965,0,1,0
33653,2,3,117966,117966,117969,0,3,1
33654,5,2,117971,117971,117973,0,2,2
33655,1,2,117972,117973,117975,1,3,0
33656,5,2,117977,117977,117979,0,2,2
33657,4,3,117981,117981,117984,0,3,2
33658,2,3,117983,117984,117987,1,4,0
33659,2,2,117985,117987,117989,2,4,0
33660,3,1,117988,117989,117990,1,2,0
33661,2,1,117990,117990,117991,0,1,0
33662,6,2,117996,117996,117998,0,2,5
33663,3,3,117999,117999,118002,0,3,1
33664,1,3,118000,118002,118005,2,5,0
33665,1,1,118001,118005,118006,4,5,0
33666,1,3,118002,118006,118009,4,7,0
33667,3,1,118005,118009,118010,4,5,0
33668,2,2,118007,118010,118012,3,5,0
33669,6,1,118013,118013,118014,0,1,1
33670,4,2,118017,118017,118019,0,2,3
33671,3,1,118020,118020,118021,0,1,1
33672,4,2,118024,118024,118026,0,2,3
33673,3,2,118027,118027,118029,0,2,1
33674,1,1,118028,118029,118030,1,2,0
33675,4,2,118032,118032,118034,0,2,2
33676,3,2,118035,118035,118037,0,2,1
33677,3,1,118038,118038,118039,0,1,1
33678,4,3,118042,118042,118045,0,3,3
33679,1,1,118043,118045,118046,2,3,0
33680,5,1,118048,118048,118049,0,1,2
33681,3,3,118051,118051,118054,0,3,2
33682,4,3,118055,118055,118058,0,3,1
33683,5,1,118060,118060,118061,0,1,2
33684,2,2,118062,118062,118064,0,2,1
33685,5,2,118067,118067,118069,0,2,3
33686,6,3,118073,118073,118076,0,3,4
33687,4,3,118077,118077,118080,0,3,1
33688,1,2,118078,118080,118082,2,4,0
33689,4,1,118082,118082,118083,0,1,0
33690,2,2,118084,118084,118086,0,2,1
33691,1,2,118085,118086,118088,1,3,0
33692,4,1,118089,118089,118090,0,1,1
33693,1,3,118090,118090,118093,0,3,0
33694,3,1,118093,118093,118094,0,1,0
33695,1,1,118094,118094,118095,0,1,0
33696,4,2,118098,118098,118100,0,2,3
33697,4,1,118102,118102,118103,0,1,2
33698,6,3,118108,118108,118111,0,3,5
33699,2,3,118110,118111,118114,1,4,0
33700,5,3,118115,118115,118118,0,3,1
33701,3,1,118118,118118,118119,0,1,0
33702,4,2,118122,118122,118124,0,2,3
33703,2,3,118124,118124,118127,0,3,0
33704,2,3,118126,118127,118130,1,4,0
33705,6,3,118132,118132,118135,0,3,2
33706,5,1,118137,118137,118138,0,1,2
33707,2,2,118139,118139,118141,0,2,1
33708,3,3,118142,118142,118145,0,3,1
33709,5,2,118147,118147,118149,0,2,2
33710,1,3,118148,118149,118152,1,4,0
33711,2,1,118150,118152,118153,2,3,0
33712,6,1,118156,118156,118157,0,1,3
33713,1,1,118157,118157,118158,0,1,0
33714,6,3,118163,118163,118166,0,3,5
33715,4,3,118167,118167,118170,0,3,1
33716,2,3,118169,118170,118173,1,4,0
33717,6,3,118175,118175,118178,0,3,2
33718,3,3,118178,118178,118181,0,3,0
33719,5,3,118183,118183,118186,0,3,2
33720,1,1,118184,118186,118187,2,3,0
33721,1,1,118185,118187,118188,2,3,0
33722,1,3,118186,118188,118191,2,5,0
33723,3,1,118189,118191,118192,2,3,0
33724,6,3,118195,118195,118198,0,3,3
33725,3,3,118198,118198,118201,0,3,0
33726,1,2,118199,118201,118203,2,4,0
33727,2,3,118201,118203,118206,2,5,0
33728,2,3,118203,118206,118209,3,6,0
33729,4,3,118207,118209,118212,2,5,0
33730,6,3,118213,118213,118216,0,3,1
33731,1,3,118214,118216,118219,2,5,0
33732,1,2,118215,118219,118221,4,6,0
33733,6,3,118221,118221,118224,0,3,0
33734,2,3,118223,118224,118227,1,4,0
33735,4,3,118227,118227,118230,0,3,0
33736,2,3,118229,118230,118233,1,4,0
33737,3,3,118232,118233,118236,1,4,0
33738,3,2,118235,118236,118238,1,3,0
33739,5,1,118240,118240,118241,0,1,2
33740,4,3,118244,118244,118247,0,3,3
33741,6,1,118250,118250,118251,0,1,3
33742,6,3,118256,118256,118259,0,3,5
33743,5,1,118261,118261,118262,0,1,2
33744,4,2,118265,118265,118267,0,2,3
33745,4,2,118269,118269,118271,0,2,2
33746,5,1,118274,118274,118275,0,1,3
33747,1,1,118275,118275,118276,0,1,0
33748,2,1,118277,118277,118278,0,1,1
33749,3,3,118280,118280,118283,0,3,2
33750,2,2,118282,118283,118285,1,3,0
33751,3,2,118285,118285,118287,0,2,0
33752,5,2,118290,118290,118292,0,2,3
33753,1,1,118291,118292,118293,1,2,0
33754,1,2,118292,118293,118295,1,3,0
33755,4,3,118296,118296,118299,0,3,1
33756,1,1,118297,118299,118300,2,3,0
33757,2,1,118299,118300,118301,1,2,0
33758,2,1,118301,118301,118302,0,1,0
33759,3,2,118304,118304,118306,0,2,2
33760,6,2,118310,118310,118312,0,2,4
33761,6,2,118316,118316,118318,0,2,4
33762,5,1,118321,118321,118322,0,1,3
33763,5,2,118326,118326,118328,0,2,4
33764,1,3,118327,118328,118331,1,4,0
33765,1,3,118328,118331,118334,3,6,0
33766,2,3,118330,118334,118337,4,7,0
33767,5,2,118335,118337,118339,2,4,0
33768,6,2,118341,118341,118343,0,2,2
33769,4,2,118345,118345,118347,0,2,2
33770,3,1,118348,118348,118349,0,1,1
33771,4,2,118352,118352,118354,0,2,3
33772,2,2,118354,118354,118356,0,2,0
33773,3,3,118357,118357,118360,0,3,1
33774,5,1,118362,118362,118363,0,1,2
33775,6,1,118368,118368,118369,0,1,5
33776,1,3,118369,118369,118372,0,3,0
33777,6,1,118375,118375,118376,0,1,3
33778,1,3,118376,118376,118379,0,3,0
33779,3,2,118379,118379,118381,0,2,0
33780,2,1,118381,118381,118382,0,1,0
33781,3,3,118384,118384,118387,0,3,2
33782,6,3,118390,118390,118393,0,3,3
33783,6,1,118396,118396,118397,0,1,3
33784,2,1,118398,118398,118399,0,1,1
33785,1,3,118399,118399,118402,0,3,0
33786,5,1,118404,118404,118405,0,1,2
33787,3,2,118407,118407,118409,0,2,2
33788,6,2,118413,118413,118415,0,2,4
33789,6,2,118419,118419,118421,0,2,4
33790,3,2,118422,118422,118424,0,2,1
33791,5,1,118427,118427,118428,0,1,3
33792,3,3,118430,118430,118433,0,3,2
33793,5,1,118435,118435,118436,0,1,2
33794,1,2,118436,118436,118438,0,2,0
33795,3,3,118439,118439,118442,0,3,1
33796,6,3,118445,118445,118448,0,3,3
33797,1,3,118446,118448,118451,2,5,0
33798,4,3,118450,118451,118454,1,4,0
33799,2,3,118452,118454,118457,2,5,0
33800,3,1,118455,118457,118458,2,3,0
33801,6,2,118461,118461,118463,0,2,3
33802,2,3,118463,118463,118466,0,3,0
33803,4,3,118467,118467,118470,0,3,1
33804,1,2,118468,118470,118472,2,4,0
33805,2,3,118470,118472,118475,2,5,0
33806,2,1,118472,118475,118476,3,4,0
33807,1,1,118473,118476,118477,3,4,0
33808,3,3,118476,118477,118480,1,4,0
33809,3,2,118479,118480,118482,1,3,0
33810,5,3,118484,118484,118487,0,3,2
33811,5,1,118489,118489,118490,0,1,2
33812,4,3,118493,118493,118496,0,3,3
33813,6,3,118499,118499,118502,0,3,3
33814,4,3,118503,118503,118506,0,3,1
33815,5,2,118508,118508,118510,0,2,2
33816,5,1,118513,118513,118514,0,1,3
33817,3,1,118516,118516,118517,0,1,2
33818,3,2,118519,118519,118521,0,2,2
33819,3,2,118522,118522,118524,0,2,1
33820,2,3,118524,118524,118527,0,3,0
33821,2,1,118526,118527,118528,1,2,0
33822,1,2,118527,118528,118530,1,3,0
33823,4,2,118531,118531,118533,0,2,1
33824,3,3,118534,118534,118537,0,3,1
33825,1,1,118535,118537,118538,2,3,0
33826,5,1,118540,118540,118541,0,1,2
33827,5,3,118545,118545,118548,0,3,4
33828,2,3,118547,118548,118551,1,4,0
33829,5,2,118552,118552,118554,0,2,1
33830,4,3,118556,118556,118559,0,3,2
33831,3,3,118559,118559,118562,0,3,0
33832,3,2,118562,118562,118564,0,2,0
33833,2,3,118564,118564,118567,0,3,0
33834,1,2,118565,118567,118569,2,4,0
33835,5,1,118570,118570,118571,0,1,1
33836,3,3,118573,118573,118576,0,3,2
33837,5,1,118578,118578,118579,0,1,2
33838,2,2,118580,118580,118582,0,2,1
33839,6,3,118586,118586,118589,0,3,4
33840,3,1,118589,118589,118590,0,1,0
33841,6,3,118595,118595,118598,0,3,5
33842,1,1,118596,118598,118599,2,3,0
33843,1,3,118597,118599,118602,2,5,0
33844,2,2,118599,118602,118604,3,5,0
33845,5,3,118604,118604,118607,0,3,0
33846,2,3,118606,118607,118610,1,4,0
33847,1,1,118607,118610,118611,3,4,0
33848,6,1,118613,118613,118614,0,1,2
33849,5,2,118618,118618,118620,0,2,4
33850,6,2,118624,118624,118626,0,2,4
33851,4,3,118628,118628,118631,0,3,2
33852,2,2,118630,118631,118633,1,3,0
33853,3,3,118633,118633,118636,0,3,0
33854,4,3,118637,118637,118640,0,3,1
33855,1,2,118638,118640,118642,2,4,0
33856,5,3,118643,118643,118646,0,3,1
33857,3,3,118646,118646,118649,0,3,0
33858,2,2,118648,118649,118651,1,3,0
33859,6,2,118654,118654,118656,0,2,3
33860,4,3,118658,118658,118661,0,3,2
33861,4,2,118662,118662,118664,0,2,1
33862,3,1,118665,118665,118666,0,1,1
33863,4,2,118669,118669,118671,0,2,3
33864,3,2,118672,118672,118674,0,2,1
33865,1,1,118673,118674,118675,1,2,0
33866,5,2,118678,118678,118680,0,2,3
33867,3,2,118681,118681,118683,0,2,1
33868,3,3,118684,118684,118687,0,3,1
33869,6,1,118690,118690,118691,0,1,3
33870,6,2,118696,118696,118698,0,2,5
33871,3,1,118699,118699,118700,0,1,1
33872,3,2,118702,118702,118704,0,2,2
33873,1,2,118703,118704,118706,1,3,0
33874,3,1,118706,118706,118707,0,1,0
33875,2,1,118708,118708,118709,0,1,1
33876,6,3,118714,118714,118717,0,3,5
33877,5,3,118719,118719,118722,0,3,2
33878,1,1,118720,118722,118723,2,3,0
33879,3,1,118723,118723,118724,0,1,0
33880,4,1,118727,118727,118728,0,1,3
33881,5,1,118732,118732,118733,0,1,4
33882,2,1,118734,118734,118735,0,1,1
33883,3,2,118737,118737,118739,0,2,2
33884,2,2,118739,118739,118741,0,2,0
33885,3,2,118742,118742,118744,0,2,1
33886,6,1,118748,118748,118749,0,1,4
33887,1,3,118749,118749,118752,0,3,0
33888,1,3,118750,118752,118755,2,5,0
33889,2,2,118752,118755,118757,3,5,0
33890,5,2,118757,118757,118759,0,2,0
33891,4,3,118761,118761,118764,0,3,2
33892,4,2,118765,118765,118767,0,2,1
33893,1,3,118766,118767,118770,1,4,0
33894,6,3,118772,118772,118775,0,3,2
33895,5,3,118777,118777,118780,0,3,2
33896,4,3,118781,118781,118784,0,3,1
33897,3,1,118784,118784,118785,0,1,0
33898,3,3,118787,118787,118790,0,3,2
33899,1,2,118788,118790,118792,2,4,0
33900,2,1,118790,118792,118793,2,3,0
33901,2,2,118792,118793,118795,1,3,0
33902,6,1,118798,118798,118799,0,1,3
33903,3,3,118801,118801,118804,0,3,2
33904,1,3,118802,118804,118807,2,5,0
33905,6,1,118808,118808,118809,0,1,1
33906,1,3,118809,118809,118812,0,3,0
33907,3,2,118812,118812,118814,0,2,0
33908,3,1,118815,118815,118816,0,1,1
33909,1,1,118816,118816,118817,0,1,0
33910,4,1,118820,118820,118821,0,1,3
33911,1,2,118821,118821,118823,0,2,0
33912,3,1,118824,118824,118825,0,1,1
33913,6,2,118830,118830,118832,0,2,5
33914,1,3,118831,118832,118835,1,4,0
33915,2,1,118833,118835,118836,2,3,0
33916,3,3,118836,118836,118839,0,3,0
33917,6,3,118842,118842,118845,0,3,3
33918,1,1,118843,118845,118846,2,3,0
33919,1,2,118844,118846,118848,2,4,0
33920,5,1,118849,118849,118850,0,1,1
33921,3,2,118852,118852,118854,0,2,2
33922,2,3,118854,118854,118857,0,3,0
33923,1,2,118855,118857,118859,2,4,0
33924,1,2,118856,118859,118861,3,5,0
33925,1,1,118857,118861,118862,4,5,0
33926,6,3,118863,118863,118866,0,3,1
33927,5,3,118868,118868,118871,0,3,2
33928,5,3,118873,118873,118876,0,3,2
33929,6,2,118879,118879,118881,0,2,3
33930,2,1,118881,118881,118882,0,1,0
33931,3,2,118884,118884,118886,0,2,2
33932,4,1,118888,118888,118889,0,1,2
33933,4,3,118892,118892,118895,0,3,3
33934,5,2,118897,118897,118899,0,2,2
33935,2,2,118899,118899,118901,0,2,0
33936,3,1,118902,118902,118903,0,1,1
33937,1,1,118903,118903,118904,0,1,0
33938,4,3,118907,118907,118910,0,3,3
33939,5,2,118912,118912,118914,0,2,2
33940,1,2,118913,118914,118916,1,3,0
33941,5,1,118918,118918,118919,0,1,2
33942,6,1,118924,118924,118925,0,1,5
33943,4,3,118928,118928,118931,0,3,3
33944,5,3,118933,118933,118936,0,3,2
33945,6,1,118939,118939,118940,0,1,3
33946,4,3,118943,118943,118946,0,3,3
33947,4,1,118947,118947,118948,0,1,1
33948,3,3,118950,118950,118953,0,3,2
33949,6,3,118956,118956,118959,0,3,3
33950,6,1,118962,118962,118963,0,1,3
33951,4,3,118966,118966,118969,0,3,3
33952,1,1,118967,118969,118970,2,3,0
33953,2,2,118969,118970,118972,1,3,0
33954,1,2,118970,118972,118974,2,4,0
33955,5,1,118975,118975,118976,0,1,1
33956,5,2,118980,118980,118982,0,2,4
33957,5,2,118985,118985,118987,0,2,3
33958,1,2,118986,118987,118989,1,3,0
33959,1,1,118987,118989,118990,2,3,0
33960,2,2,118989,118990,118992,1,3,0
33961,5,1,118994,118994,118995,0,1,2
33962,6,3,119000,119000,119003,0,3,5
33963,3,3,119003,119003,119006,0,3,0
33964,4,2,119007,119007,119009,0,2,1
33965,4,2,119011,119011,119013,0,2,2
33966,3,1,119014,119014,119015,0,1,1
33967,3,3,119017,119017,119020,0,3,2
33968,2,1,119019,119020,119021,1,2,0
33969,6,2,119025,119025,119027,0,2,4
33970,5,2,119030,119030,119032,0,2,3
33971,3,1,119033,119033,119034,0,1,1
33972,3,3,119036,119036,119039,0,3,2
33973,1,1,119037,119039,119040,2,3,0
33974,6,3,119043,119043,119046,0,3,3
33975,2,1,119045,119046,119047,1,2,0
33976,6,2,119051,119051,119053,0,2,4
33977,3,1,119054,119054,119055,0,1,1
33978,2,1,119056,119056,119057,0,1,1
33979,4,3,119060,119060,119063,0,3,3
33980,5,3,119065,119065,119068,0,3,2
33981,4,3,119069,119069,119072,0,3,1
33982,5,3,119074,119074,119077,0,3,2
33983,2,3,119076,119077,119080,1,4,0
33984,1,3,119077,119080,119083,3,6,0
33985,3,2,119080,119083,119085,3,5,0
33986,4,1,119084,119085,119086,1,2,0
33987,4,1,119088,119088,119089,0,1,2
33988,6,1,119094,119094,119095,0,1,5
33989,3,1,119097,119097,119098,0,1,2
33990,3,1,119100,119100,119101,0,1,2
33991,4,2,119104,119104,119106,0,2,3
33992,2,2,119106,119106,119108,0,2,0
33993,1,3,119107,119108,119111,1,4,0
33994,3,1,119110,119111,119112,1,2,0
33995,4,1,119114,119114,119115,0,1,2
33996,4,3,119118,119118,119121,0,3,3
33997,4,2,119122,119122,119124,0,2,1
33998,3,1,119125,119125,119126,0,1,1
33999,1,3,119126,119126,119129,0,3,0
34000,2,1,119128,119129,119130,1,2,0
34001,3,3,119131,119131,119134,0,3,1
34002,5,1,119136,119136,119137,0,1,2
34003,5,1,119141,119141,119142,0,1,4
34004,5,3,119146,119146,119149,0,3,4
34005,5,1,119151,119151,119152,0,1,2
34006,5,3,119156,119156,119159,0,3,4
34007,2,2,119158,119159,119161,1,3,0
34008,2,3,119160,119161,119164,1,4,0
34009,4,2,119164,119164,119166,0,2,0
34010,2,1,119166,119166,119167,0,1,0
34011,6,2,119172,119172,119174,0,2,5
34012,2,1,119174,119174,119175,0,1,0
34013,1,1,119175,119175,119176,0,1,0
34014,1,2,119176,119176,119178,0,2,0
34015,2,3,119178,119178,119181,0,3,0
34016,4,2,119182,119182,119184,0,2,1
34017,4,2,119186,119186,119188,0,2,2
34018,5,2,119191,119191,119193,0,2,3
34019,5,1,119196,119196,119197,0,1,3
34020,2,2,119198,119198,119200,0,2,1
34021,3,2,119201,119201,119203,0,2,1
34022,3,2,119204,119204,119206,0,2,1
34023,3,3,119207,119207,119210,0,3,1
34024,4,2,119211,119211,119213,0,2,1
34025,1,3,119212,119213,119216,1,4,0
34026,3,3,119215,119216,119219,1,4,0
34027,6,3,119221,119221,119224,0,3,2
34028,6,1,119227,119227,119228,0,1,3
34029,3,3,119230,119230,119233,0,3,2
34030,2,3,119232,119233,119236,1,4,0
34031,6,1,119238,119238,119239,0,1,2
34032,4,1,119242,119242,119243,0,1,3
34033,1,1,119243,119243,119244,0,1,0
34034,3,1,119246,119246,119247,0,1,2
34035,1,1,119247,119247,119248,0,1,0
34036,3,2,119250,119250,119252,0,2,2
34037,5,2,119255,119255,119257,0,2,3
34038,6,2,119261,119261,119263,0,2,4
34039,5,2,119266,119266,119268,0,2,3
34040,4,1,119270,119270,119271,0,1,2
34041,1,1,119271,119271,119272,0,1,0
34042,5,1,119276,119276,119277,0,1,4
34043,3,2,119279,119279,119281,0,2,2
34044,4,1,119283,119283,119284,0,1,2
34045,2,3,119285,119285,119288,0,3,1
34046,3,3,119288,119288,119291,0,3,0
34047,3,3,119291,119291,119294,0,3,0
34048,2,2,119293,119294,119296,1,3,0
34049,2,2,119295,119296,119298,1,3,0
34050,1,2,119296,119298,119300,2,4,0
34051,6,2,119302,119302,119304,0,2,2
34052,6,2,119308,119308,119310,0,2,4
34053,6,3,119314,119314,119317,0,3,4
34054,3,3,119317,119317,119320,0,3,0
34055,1,2,119318,119320,119322,2,4,0
34056,6,1,119324,119324,119325,0,1,2
34057,2,1,119326,119326,119327,0,1,1
34058,5,2,119331,119331,119333,0,2,4
34059,1,1,119332,119333,119334,1,2,0
34060,4,3,119336,119336,119339,0,3,2
34061,5,3,119341,119341,119344,0,3,2
34062,6,3,119347,119347,119350,0,3,3
34063,4,1,119351,119351,119352,0,1,1
34064,6,1,119357,119357,119358,0,1,5
34065,6,2,119363,119363,119365,0,2,5
34066,1,3,119364,119365,119368,1,4,0
34067,5,2,119369,119369,119371,0,2,1
34068,6,1,119375,119375,119376,0,1,4
34069,2,3,119377,119377,119380,0,3,1
34070,3,3,119380,119380,119383,0,3,0
34071,4,1,119384,119384,119385,0,1,1
34072,3,2,119387,119387,119389,0,2,2
34073,3,3,119390,119390,119393,0,3,1
34074,4,2,119394,119394,119396,0,2,1
34075,6,3,119400,119400,119403,0,3,4
34076,6,1,119406,119406,119407,0,1,3
34077,3,1,119409,119409,119410,0,1,2
34078,3,2,119412,119412,119414,0,2,2
34079,4,3,119416,119416,119419,0,3,2
34080,3,3,119419,119419,119422,0,3,0
34081,1,1,119420,119422,119423,2,3,0
34082,1,1,119421,119423,119424,2,3,0
34083,3,1,119424,119424,119425,0,1,0
34084,5,2,119429,119429,119431,0,2,4
34085,3,2,119432,119432,119434,0,2,1
34086,6,2,119438,119438,119440,0,2,4
34087,4,3,119442,119442,119445,0,3,2
34088,3,2,119445,119445,119447,0,2,0
34089,4,2,119449,119449,119451,0,2,2
34090,2,2,119451,119451,119453,0,2,0
34091,2,3,119453,119453,119456,0,3,0
34092,6,2,119459,119459,119461,0,2,3
34093,2,2,119461,119461,119463,0,2,0
34094,6,1,119467,119467,119468,0,1,4
34095,2,1,119469,119469,119470,0,1,1
34096,4,2,119473,119473,119475,0,2,3
34097,3,3,119476,119476,119479,0,3,1
34098,6,1,119482,119482,119483,0,1,3
34099,5,2,119487,119487,119489,0,2,4
34100,6,1,119493,119493,119494,0,1,4
34101,5,3,119498,119498,119501,0,3,4
34102,2,3,119500,119501,119504,1,4,0
34103,2,3,119502,119504,119507,2,5,0
34104,6,2,119508,119508,119510,0,2,1
34105,4,3,119512,119512,119515,0,3,2
34106,3,2,119515,119515,119517,0,2,0
34107,4,3,119519,119519,119522,0,3,2
34108,6,1,119525,119525,119526,0,1,3
34109,1,3,119526,119526,119529,0,3,0
34110,1,3,119527,119529,119532,2,5,0
34111,4,2,119531,119532,119534,1,3,0
34112,4,3,119535,119535,119538,0,3,1
34113,1,1,119536,119538,119539,2,3,0
34114,1,2,119537,119539,119541,2,4,0
34115,4,2,119541,119541,119543,0,2,0
34116,4,1,119545,119545,119546,0,1,2
34117,5,1,119550,119550,119551,0,1,4
34118,4,2,119554,119554,119556,0,2,3
34119,4,3,119558,119558,119561,0,3,2
34120,1,1,119559,119561,119562,2,3,0
34121,6,3,119565,119565,119568,0,3,3
34122,3,3,119568,119568,119571,0,3,0
34123,6,3,119574,119574,119577,0,3,3
34124,4,2,119578,119578,119580,0,2,1
34125,6,3,119584,119584,119587,0,3,4
34126,2,3,119586,119587,119590,1,4,0
34127,2,2,119588,119590,119592,2,4,0
34128,5,2,119593,119593,119595,0,2,1
34129,5,1,119598,119598,119599,0,1,3
34130,4,2,119602,119602,119604,0,2,3
34131,2,3,119604,119604,119607,0,3,0
34132,1,2,119605,119607,119609,2,4,0
34133,2,1,119607,119609,119610,2,3,0
34134,2,3,119609,119610,119613,1,4,0
34135,2,2,119611,119613,119615,2,4,0
34136,4,3,119615,119615,119618,0,3,0
34137,4,3,119619,119619,119622,0,3,1
34138,2,1,119621,119622,119623,1,2,0
34139,4,2,119625,119625,119627,0,2,2
34140,5,3,119630,119630,119633,0,3,3
34141,6,3,119636,119636,119639,0,3,3
34142,2,1,119638,119639,119640,1,2,0
34143,1,3,119639,119640,119643,1,4,0
34144,6,2,119645,119645,119647,0,2,2
34145,1,2,119646,119647,119649,1,3,0
34146,2,1,119648,119649,119650,1,2,0
34147,6,2,119654,119654,119656,0,2,4
34148,4,3,119658,119658,119661,0,3,2
34149,4,3,119662,119662,119665,0,3,1
34150,3,3,119665,119665,119668,0,3,0
34151,6,1,119671,119671,119672,0,1,3
34152,4,1,119675,119675,119676,0,1,3
34153,1,3,119676,119676,119679,0,3,0
34154,6,3,119682,119682,119685,0,3,3
34155,4,2,119686,119686,119688,0,2,1
34156,4,3,119690,119690,119693,0,3,2
34157,6,1,119696,119696,119697,0,1,3
34158,3,2,119699,119699,119701,0,2,2
34159,4,1,119703,119703,119704,0,1,2
34160,3,2,119706,119706,119708,0,2,2
34161,4,3,119710,119710,119713,0,3,2
34162,4,2,119714,119714,119716,0,2,1
34163,1,3,119715,119716,119719,1,4,0
34164,4,1,119719,119719,119720,0,1,0
34165,4,2,119723,119723,119725,0,2,3
34166,1,2,119724,119725,119727,1,3,0
34167,1,2,119725,119727,119729,2,4,0
34168,2,3,119727,119729,119732,2,5,0
34169,3,1,119730,119732,119733,2,3,0
34170,4,1,119734,119734,119735,0,1,1
34171,6,2,119740,119740,119742,0,2,5
34172,5,3,119745,119745,119748,0,3,3
34173,5,1,119750,119750,119751,0,1,2
34174,6,3,119756,119756,119759,0,3,5
34175,6,3,119762,119762,119765,0,3,3
34176,3,2,119765,119765,119767,0,2,0
34177,6,1,119771,119771,119772,0,1,4
34178,5,3,119776,119776,119779,0,3,4
34179,4,1,119780,119780,119781,0,1,1
34180,2,3,119782,119782,119785,0,3,1
34181,1,2,119783,119785,119787,2,4,0
34182,4,2,119787,119787,119789,0,2,0
34183,2,2,119789,119789,119791,0,2,0
34184,2,2,119791,119791,119793,0,2,0
34185,4,2,119795,119795,119797,0,2,2
34186,3,3,119798,119798,119801,0,3,1
34187,4,1,119802,119802,119803,0,1,1
34188,4,2,119806,119806,119808,0,2,3
34189,6,2,119812,119812,119814,0,2,4
34190,4,3,119816,119816,119819,0,3,2
34191,3,1,119819,119819,119820,0,1,0
34192,2,2,119821,119821,119823,0,2,1
34193,1,2,119822,119823,119825,1,3,0
34194,2,3,119824,119825,119828,1,4,0
34195,4,3,119828,119828,119831,0,3,0
34196,3,3,119831,119831,119834,0,3,0
34197,2,1,119833,119834,119835,1,2,0
34198,6,2,119839,119839,119841,0,2,4
34199,1,2,119840,119841,119843,1,3,0
34200,5,1,119845,119845,119846,0,1,2
34201,2,3,119847,119847,119850,0,3,1
34202,5,1,119852,119852,119853,0,1,2
34203,2,1,119854,119854,119855,0,1,1
34204,3,2,119857,119857,119859,0,2,2
34205,5,2,119862,119862,119864,0,2,3
34206,2,1,119864,119864,119865,0,1,0
34207,4,3,119868,119868,119871,0,3,3
34208,4,1,119872,119872,119873,0,1,1
34209,5,3,119877,119877,119880,0,3,4
34210,3,3,119880,119880,119883,0,3,0
34211,2,3,119882,119883,119886,1,4,0
34212,2,2,119884,119886,119888,2,4,0
34213,2,1,119886,119888,119889,2,3,0
34214,1,2,119887,119889,119891,2,4,0
34215,4,1,119891,119891,119892,0,1,0
34216,2,1,119893,119893,119894,0,1,1
34217,2,3,119895,119895,119898,0,3,1
34218,6,1,119901,119901,119902,0,1,3
34219,1,2,119902,119902,119904,0,2,0
34220,4,1,119906,119906,119907,0,1,2
34221,2,2,119908,119908,119910,0,2,1
34222,6,2,119914,119914,119916,0,2,4
34223,3,1,119917,119917,119918,0,1,1
34224,6,3,119923,119923,119926,0,3,5
34225,3,2,119926,119926,119928,0,2,0
34226,5,2,119931,119931,119933,0,2,3
34227,5,1,119936,119936,119937,0,1,3
34228,3,3,119939,119939,119942,0,3,2
34229,5,1,119944,119944,119945,0,1,2
34230,4,1,119948,119948,119949,0,1,3
34231,1,1,119949,119949,119950,0,1,0
34232,2,1,119951,119951,119952,0,1,1
34233,6,2,119957,119957,119959,0,2,5
34234,1,1,119958,119959,119960,1,2,0
34235,5,3,119963,119963,119966,0,3,3
34236,4,3,119967,119967,119970,0,3,1
34237,6,3,119973,119973,119976,0,3,3
34238,2,3,119975,119976,119979,1,4,0
34239,6,3,119981,119981,119984,0,3,2
34240,1,1,119982,119984,119985,2,3,0
34241,4,2,119986,119986,119988,0,2,1
34242,3,3,119989,119989,119992,0,3,1
34243,3,2,119992,119992,119994,0,2,0
34244,3,1,119995,119995,119996,0,1,1
34245,1,3,119996,119996,119999,0,3,0
34246,6,1,120002,120002,120003,0,1,3
34247,5,3,120007,120007,120010,0,3,4
34248,4,2,120011,120011,120013,0,2,1
34249,3,2,120014,120014,120016,0,2,1
34250,2,2,120016,120016,120018,0,2,0
34251,5,2,120021,120021,120023,0,2,3
34252,4,3,120025,120025,120028,0,3,2
34253,1,2,120026,120028,120030,2,4,0
34254,1,3,120027,120030,120033,3,6,0
34255,6,1,120033,120033,120034,0,1,0
34256,4,2,120037,120037,120039,0,2,3
34257,5,2,120042,120042,120044,0,2,3
34258,4,1,120046,120046,120047,0,1,2
34259,4,1,120050,120050,120051,0,1,3
34260,5,2,120055,120055,120057,0,2,4
34261,6,3,120061,120061,120064,0,3,4
34262,2,3,120063,120064,120067,1,4,0
34263,1,2,120064,120067,120069,3,5,0
34264,6,3,120070,120070,120073,0,3,1
34265,5,3,120075,120075,120078,0,3,2
34266,3,2,120078,120078,120080,0,2,0
34267,3,1,120081,120081,120082,0,1,1
34268,1,3,120082,120082,120085,0,3,0
34269,4,3,120086,120086,120089,0,3,1
34270,3,3,120089,120089,120092,0,3,0
34271,3,1,120092,120092,120093,0,1,0
34272,6,3,120098,120098,120101,0,3,5
34273,3,3,120101,120101,120104,0,3,0
34274,6,1,120107,120107,120108,0,1,3
34275,2,2,120109,120109,120111,0,2,1
34276,5,3,120114,120114,120117,0,3,3
34277,3,1,120117,120117,120118,0,1,0
34278,1,2,120118,120118,120120,0,2,0
34279,5,2,120123,120123,120125,0,2,3
34280,4,2,120127,120127,120129,0,2,2
34281,5,1,120132,120132,120133,0,1,3
34282,1,1,120133,120133,120134,0,1,0
34283,5,3,120138,120138,120141,0,3,4
34284,2,2,120140,120141,120143,1,3,0
34285,3,3,120143,120143,120146,0,3,0
34286,4,2,120147,120147,120149,0,2,1
34287,3,3,120150,120150,120153,0,3,1
34288,6,3,120156,120156,120159,0,3,3
34289,2,2,120158,120159,120161,1,3,0
34290,2,3,120160,120161,120164,1,4,0
34291,2,3,120162,120164,120167,2,5,0
34292,3,1,120165,120167,120168,2,3,0
34293,1,1,120166,120168,120169,2,3,0
34294,3,2,120169,120169,120171,0,2,0
34295,6,2,120175,120175,120177,0,2,4
34296,3,1,120178,120178,120179,0,1,1
34297,3,2,120181,120181,120183,0,2,2
34298,2,2,120183,120183,120185,0,2,0
34299,6,1,120189,120189,120190,0,1,4
34300,4,3,120193,120193,120196,0,3,3
34301,1,3,120194,120196,120199,2,5,0
34302,1,2,120195,120199,120201,4,6,0
34303,1,3,120196,120201,120204,5,8,0
34304,1,3,120197,120204,120207,7,10,0
34305,4,2,120201,120207,120209,6,8,0
34306,2,3,120203,120209,120212,6,9,0
34307,2,2,120205,120212,120214,7,9,0
34308,1,3,120206,120214,120217,8,11,0
34309,5,3,120211,120217,120220,6,9,0
34310,6,2,120217,120220,120222,3,5,0
34311,2,2,120219,120222,120224,3,5,0
34312,2,3,120221,120224,120227,3,6,0
34313,4,3,120225,120227,120230,2,5,0
34314,3,3,120228,120230,120233,2,5,0
34315,3,3,120231,120233,120236,2,5,0
34316,6,1,120237,120237,120238,0,1,1
34317,4,2,120241,120241,120243,0,2,3
34318,1,3,120242,120243,120246,1,4,0
34319,2,3,120244,120246,120249,2,5,0
34320,4,1,120248,120249,120250,1,2,0
34321,1,2,120249,120250,120252,1,3,0
34322,2,2,120251,120252,120254,1,3,0
34323,6,1,120257,120257,120258,0,1,3
34324,6,1,120263,120263,120264,0,1,5
34325,2,3,120265,120265,120268,0,3,1
34326,4,3,120269,120269,120272,0,3,1
34327,2,1,120271,120272,120273,1,2,0
34328,6,2,120277,120277,120279,0,2,4
34329,1,2,120278,120279,120281,1,3,0
34330,6,1,120284,120284,120285,0,1,3
34331,3,1,120287,120287,120288,0,1,2
34332,4,1,120291,120291,120292,0,1,3
34333,2,1,120293,120293,120294,0,1,1
34334,3,2,120296,120296,120298,0,2,2
34335,3,3,120299,120299,120302,0,3,1
34336,4,2,120303,120303,120305,0,2,1
34337,3,1,120306,120306,120307,0,1,1
34338,6,3,120312,120312,120315,0,3,5
34339,1,1,120313,120315,120316,2,3,0
34340,6,2,120319,120319,120321,0,2,3
34341,6,2,120325,120325,120327,0,2,4
34342,6,1,120331,120331,120332,0,1,4
34343,1,2,120332,120332,120334,0,2,0
34344,6,1,120338,120338,120339,0,1,4
34345,4,3,120342,120342,120345,0,3,3
34346,1,3,120343,120345,120348,2,5,0
34347,5,2,120348,120348,120350,0,2,0
34348,6,3,120354,120354,120357,0,3,4
34349,4,1,120358,120358,120359,0,1,1
34350,3,2,120361,120361,120363,0,2,2
34351,4,3,120365,120365,120368,0,3,2
34352,5,2,120370,120370,120372,0,2,2
34353,1,2,120371,120372,120374,1,3,0
34354,3,3,120374,120374,120377,0,3,0
34355,5,2,120379,120379,120381,0,2,2
34356,2,2,120381,120381,120383,0,2,0
34357,3,2,120384,120384,120386,0,2,1
34358,6,2,120390,120390,120392,0,2,4
34359,4,3,120394,120394,120397,0,3,2
34360,6,3,120400,120400,120403,0,3,3
34361,4,2,120404,120404,120406,0,2,1
34362,4,2,120408,120408,120410,0,2,2
34363,4,3,120412,120412,120415,0,3,2
34364,5,3,120417,120417,120420,0,3,2
34365,2,2,120419,120420,120422,1,3,0
34366,6,1,120425,120425,120426,0,1,3
34367,6,3,120431,120431,120434,0,3,5
34368,5,1,120436,120436,120437,0,1,2
34369,6,2,120442,120442,120444,0,2,5
34370,3,3,120445,120445,120448,0,3,1
34371,6,2,120451,120451,120453,0,2,3
34372,2,3,120453,120453,120456,0,3,0
34373,3,2,120456,120456,120458,0,2,0
34374,1,1,120457,120458,120459,1,2,0
34375,2,3,120459,120459,120462,0,3,0
34376,4,3,120463,120463,120466,0,3,1
34377,4,3,120467,120467,120470,0,3,1
34378,6,2,120473,120473,120475,0,2,3
34379,5,2,120478,120478,120480,0,2,3
34380,6,1,120484,120484,120485,0,1,4
34381,4,2,120488,120488,120490,0,2,3
34382,1,2,120489,120490,120492,1,3,0
34383,2,1,120491,120492,120493,1,2,0
34384,3,2,120494,120494,120496,0,2,1
34385,5,3,120499,120499,120502,0,3,3
34386,6,2,120505,120505,120507,0,2,3
34387,6,1,120511,120511,120512,0,1,4
34388,3,1,120514,120514,120515,0,1,2
34389,4,3,120518,120518,120521,0,3,3
34390,5,3,120523,120523,120526,0,3,2
34391,4,2,120527,120527,120529,0,2,1
34392,5,3,120532,120532,120535,0,3,3
34393,2,3,120534,120535,120538,1,4,0
34394,2,2,120536,120538,120540,2,4,0
34395,4,1,120540,120540,120541,0,1,0
34396,1,1,120541,120541,120542,0,1,0
34397,3,3,120544,120544,120547,0,3,2
34398,5,2,120549,120549,120551,0,2,2
34399,3,3,120552,120552,120555,0,3,1
34400,1,1,120553,120555,120556,2,3,0
34401,4,3,120557,120557,120560,0,3,1
34402,5,3,120562,120562,120565,0,3,2
34403,2,3,120564,120565,120568,1,4,0
34404,1,1,120565,120568,120569,3,4,0
34405,5,1,120570,120570,120571,0,1,1
34406,2,1,120572,120572,120573,0,1,1
34407,1,3,120573,120573,120576,0,3,0
34408,3,3,120576,120576,120579,0,3,0
34409,2,3,120578,120579,120582,1,4,0
34410,2,1,120580,120582,120583,2,3,0
34411,2,1,120582,120583,120584,1,2,0
34412,5,3,120587,120587,120590,0,3,3
34413,6,1,120593,120593,120594,0,1,3
34414,1,2,120594,120594,120596,0,2,0
34415,3,2,120597,120597,120599,0,2,1
34416,6,3,120603,120603,120606,0,3,4
34417,3,2,120606,120606,120608,0,2,0
34418,2,1,120608,120608,120609,0,1,0
34419,4,2,120612,120612,120614,0,2,3
34420,6,1,120618,120618,120619,0,1,4
34421,2,2,120620,120620,120622,0,2,1
34422,1,2,120621,120622,120624,1,3,0
34423,4,1,120625,120625,120626,0,1,1
34424,6,2,120631,120631,120633,0,2,5
34425,3,1,120634,120634,120635,0,1,1
34426,4,3,120638,120638,120641,0,3,3
34427,6,2,120644,120644,120646,0,2,3
34428,2,2,120646,120646,120648,0,2,0
34429,2,2,120648,120648,120650,0,2,0
34430,3,1,120651,120651,120652,0,1,1
34431,1,3,120652,120652,120655,0,3,0
34432,6,1,120658,120658,120659,0,1,3
34433,4,1,120662,120662,120663,0,1,3
34434,6,3,120668,120668,120671,0,3,5
34435,3,3,120671,120671,120674,0,3,0
34436,3,2,120674,120674,120676,0,2,0
34437,4,2,120678,120678,120680,0,2,2
34438,5,1,120683,120683,120684,0,1,3
34439,2,1,120685,120685,120686,0,1,1
34440,1,1,120686,120686,120687,0,1,0
34441,4,1,120690,120690,120691,0,1,3
34442,4,3,120694,120694,120697,0,3,3
34443,1,2,120695,120697,120699,2,4,0
34444,6,2,120701,120701,120703,0,2,2
34445,6,2,120707,120707,120709,0,2,4
34446,5,2,120712,120712,120714,0,2,3
34447,1,1,120713,120714,120715,1,2,0
34448,1,2,120714,120715,120717,1,3,0
34449,2,1,120716,120717,120718,1,2,0
34450,3,3,120719,120719,120722,0,3,1
34451,5,2,120724,120724,120726,0,2,2
34452,1,2,120725,120726,120728,1,3,0
34453,2,1,120727,120728,120729,1,2,0
34454,2,2,120729,120729,120731,0,2,0
34455,6,2,120735,120735,120737,0,2,4
34456,1,1,120736,120737,120738,1,2,0
34457,5,3,120741,120741,120744,0,3,3
34458,3,3,120744,120744,120747,0,3,0
34459,4,3,120748,120748,120751,0,3,1
34460,5,2,120753,120753,120755,0,2,2
34461,5,3,120758,120758,120761,0,3,3
34462,3,3,120761,120761,120764,0,3,0
34463,6,1,120767,120767,120768,0,1,3
34464,4,3,120771,120771,120774,0,3,3
34465,4,3,120775,120775,120778,0,3,1
34466,3,3,120778,120778,120781,0,3,0
34467,4,2,120782,120782,120784,0,2,1
34468,6,1,120788,120788,120789,0,1,4
34469,3,1,120791,120791,120792,0,1,2
34470,2,1,120793,120793,120794,0,1,1
34471,5,2,120798,120798,120800,0,2,4
34472,3,3,120801,120801,120804,0,3,1
34473,4,3,120805,120805,120808,0,3,1
34474,5,1,120810,120810,120811,0,1,2
34475,3,1,120813,120813,120814,0,1,2
34476,3,3,120816,120816,120819,0,3,2
34477,4,3,120820,120820,120823,0,3,1
34478,4,2,120824,120824,120826,0,2,1
34479,6,2,120830,120830,120832,0,2,4
34480,6,3,120836,120836,120839,0,3,4
34481,2,2,120838,120839,120841,1,3,0
34482,3,2,120841,120841,120843,0,2,0
34483,6,3,120847,120847,120850,0,3,4
34484,1,2,120848,120850,120852,2,4,0
34485,1,2,120849,120852,120854,3,5,0
34486,2,1,120851,120854,120855,3,4,0
34487,2,3,120853,120855,120858,2,5,0
34488,3,3,120856,120858,120861,2,5,0
34489,1,1,120857,120861,120862,4,5,0
34490,5,1,120862,120862,120863,0,1,0
34491,2,1,120864,120864,120865,0,1,1
34492,3,3,120867,120867,120870,0,3,2
34493,5,3,120872,120872,120875,0,3,2
34494,6,1,120878,120878,120879,0,1,3
34495,1,1,120879,120879,120880,0,1,0
34496,4,1,120883,120883,120884,0,1,3
34497,6,1,120889,120889,120890,0,1,5
34498,5,1,120894,120894,120895,0,1,4
34499,4,1,120898,120898,120899,0,1,3
34500,6,2,120904,120904,120906,0,2,5
34501,3,3,120907,120907,120910,0,3,1
34502,4,1,120911,120911,120912,0,1,1
34503,2,1,120913,120913,120914,0,1,1
34504,3,3,120916,120916,120919,0,3,2
34505,6,3,120922,120922,120925,0,3,3
34506,3,2,120925,120925,120927,0,2,0
34507,6,1,120931,120931,120932,0,1,4
34508,2,1,120933,120933,120934,0,1,1
34509,6,1,120939,120939,120940,0,1,5
34510,1,1,120940,120940,120941,0,1,0
34511,2,3,120942,120942,120945,0,3,1
34512,5,3,120947,120947,120950,0,3,2
34513,5,1,120952,120952,120953,0,1,2
34514,1,1,120953,120953,120954,0,1,0
34515,4,3,120957,120957,120960,0,3,3
34516,6,2,120963,120963,120965,0,2,3
34517,2,1,120965,120965,120966,0,1,0
34518,3,1,120968,120968,120969,0,1,2
34519,2,2,120970,120970,120972,0,2,1
34520,6,1,120976,120976,120977,0,1,4
34521,3,1,120979,120979,120980,0,1,2
34522,1,2,120980,120980,120982,0,2,0
34523,1,2,120981,120982,120984,1,3,0
34524,3,1,120984,120984,120985,0,1,0
34525,1,2,120985,120985,120987,0,2,0
34526,6,1,120991,120991,120992,0,1,4
34527,5,3,120996,120996,120999,0,3,4
34528,3,3,120999,120999,121002,0,3,0
34529,2,1,121001,121002,121003,1,2,0
34530,1,2,121002,121003,121005,1,3,0
34531,2,3,121004,121005,121008,1,4,0
34532,4,1,121008,121008,121009,0,1,0
34533,5,1,121013,121013,121014,0,1,4
34534,1,3,121014,121014,121017,0,3,0
34535,6,1,121020,121020,121021,0,1,3
34536,5,1,121025,121025,121026,0,1,4
34537,4,1,121029,121029,121030,0,1,3
34538,3,2,121032,121032,121034,0,2,2
34539,1,3,121033,121034,121037,1,4,0
34540,3,1,121036,121037,121038,1,2,0
34541,5,1,121041,121041,121042,0,1,3
34542,6,2,121047,121047,121049,0,2,5
34543,4,2,121051,121051,121053,0,2,2
34544,6,3,121057,121057,121060,0,3,4
34545,1,1,121058,121060,121061,2,3,0
34546,3,1,121061,121061,121062,0,1,0
34547,6,1,121067,121067,121068,0,1,5
34548,4,2,121071,121071,121073,0,2,3
34549,5,1,121076,121076,121077,0,1,3
34550,4,2,121080,121080,121082,0,2,3
34551,2,3,121082,121082,121085,0,3,0
34552,5,1,121087,121087,121088,0,1,2
34553,3,3,121090,121090,121093,0,3,2
34554,4,3,121094,121094,121097,0,3,1
34555,3,2,121097,121097,121099,0,2,0
34556,2,1,121099,121099,121100,0,1,0
34557,6,2,121105,121105,121107,0,2,5
34558,2,1,121107,121107,121108,0,1,0
34559,6,1,121113,121113,121114,0,1,5
34560,3,1,121116,121116,121117,0,1,2
34561,2,2,121118,121118,121120,0,2,1
34562,3,1,121121,121121,121122,0,1,1
34563,4,2,121125,121125,121127,0,2,3
34564,1,1,121126,121127,121128,1,2,0
34565,3,3,121129,121129,121132,0,3,1
34566,2,1,121131,121132,121133,1,2,0
34567,2,1,121133,121133,121134,0,1,0
34568,5,3,121138,121138,121141,0,3,4
34569,3,2,121141,121141,121143,0,2,0
34570,6,3,121147,121147,121150,0,3,4
34571,4,2,121151,121151,121153,0,2,1
34572,1,3,121152,121153,121156,1,4,0
34573,4,2,121156,121156,121158,0,2,0
34574,2,2,121158,121158,121160,0,2,0
34575,3,3,121161,121161,121164,0,3,1
34576,6,3,121167,121167,121170,0,3,3
34577,6,3,121173,121173,121176,0,3,3
34578,6,3,121179,121179,121182,0,3,3
34579,5,3,121184,121184,121187,0,3,2
34580,6,3,121190,121190,121193,0,3,3
34581,3,3,121193,121193,121196,0,3,0
34582,3,1,121196,121196,121197,0,1,0
34583,2,2,121198,121198,121200,0,2,1
34584,2,1,121200,121200,121201,0,1,0
34585,6,3,121206,121206,121209,0,3,5
34586,3,1,121209,121209,121210,0,1,0
34587,4,3,121213,121213,121216,0,3,3
34588,1,3,121214,121216,121219,2,5,0
34589,3,2,121217,121219,121221,2,4,0
34590,4,2,121221,121221,121223,0,2,0
34591,3,3,121224,121224,121227,0,3,1
34592,6,2,121230,121230,121232,0,2,3
34593,2,3,121232,121232,121235,0,3,0
34594,1,3,121233,121235,121238,2,5,0
34595,1,2,121234,121238,121240,4,6,0
34596,1,1,121235,121240,121241,5,6,0
34597,4,2,121239,121241,121243,2,4,0
34598,6,1,121245,121245,121246,0,1,2
34599,6,1,121251,121251,121252,0,1,5
34600,5,2,121256,121256,121258,0,2,4
34601,4,3,121260,121260,121263,0,3,2
34602,4,3,121264,121264,121267,0,3,1
34603,1,3,121265,121267,121270,2,5,0
34604,3,2,121268,121270,121272,2,4,0
34605,6,2,121274,121274,121276,0,2,2
34606,1,3,121275,121276,121279,1,4,0
34607,6,3,121281,121281,121284,0,3,2
34608,6,3,121287,121287,121290,0,3,3
34609,4,1,121291,121291,121292,0,1,1
34610,6,3,121297,121297,121300,0,3,5
34611,6,3,121303,121303,121306,0,3,3
34612,4,3,121307,121307,121310,0,3,1
34613,4,3,121311,121311,121314,0,3,1
34614,1,2,121312,121314,121316,2,4,0
34615,1,1,121313,121316,121317,3,4,0
34616,6,1,121319,121319,121320,0,1,2
34617,2,2,121321,121321,121323,0,2,1
34618,3,1,121324,121324,121325,0,1,1
34619,3,2,121327,121327,121329,0,2,2
34620,1,2,121328,121329,121331,1,3,0
34621,2,2,121330,121331,121333,1,3,0
34622,6,2,121336,121336,121338,0,2,3
34623,5,2,121341,121341,121343,0,2,3
34624,5,2,121346,121346,121348,0,2,3
34625,4,2,121350,121350,121352,0,2,2
34626,1,3,121351,121352,121355,1,4,0
34627,2,3,121353,121355,121358,2,5,0
34628,2,3,121355,121358,121361,3,6,0
34629,6,1,121361,121361,121362,0,1,0
34630,2,1,121363,121363,121364,0,1,1
34631,3,2,121366,121366,121368,0,2,2
34632,4,1,121370,121370,121371,0,1,2
34633,6,3,121376,121376,121379,0,3,5
34634,5,3,121381,121381,121384,0,3,2
34635,1,1,121382,121384,121385,2,3,0
34636,4,3,121386,121386,121389,0,3,1
34637,2,2,121388,121389,121391,1,3,0
34638,6,1,121394,121394,121395,0,1,3
34639,4,2,121398,121398,121400,0,2,3
34640,1,2,121399,121400,121402,1,3,0
34641,2,2,121401,121402,121404,1,3,0
34642,1,3,121402,121404,121407,2,5,0
34643,5,3,121407,121407,121410,0,3,0
34644,4,1,121411,121411,121412,0,1,1
34645,3,1,121414,121414,121415,0,1,2
34646,2,3,121416,121416,121419,0,3,1
34647,1,3,121417,121419,121422,2,5,0
34648,4,3,121421,121422,121425,1,4,0
34649,3,1,121424,121425,121426,1,2,0
34650,2,2,121426,121426,121428,0,2,0
34651,2,3,121428,121428,121431,0,3,0
34652,5,3,121433,121433,121436,0,3,2
34653,4,2,121437,121437,121439,0,2,1
34654,3,2,121440,121440,121442,0,2,1
34655,2,2,121442,121442,121444,0,2,0
34656,4,2,121446,121446,121448,0,2,2
34657,5,2,121451,121451,121453,0,2,3
34658,3,3,121454,121454,121457,0,3,1
34659,4,3,121458,121458,121461,0,3,1
34660,2,1,121460,121461,121462,1,2,0
34661,6,2,121466,121466,121468,0,2,4
34662,1,3,121467,121468,121471,1,4,0
34663,5,2,121472,121472,121474,0,2,1
34664,1,2,121473,121474,121476,1,3,0
34665,2,2,121475,121476,121478,1,3,0
34666,3,3,121478,121478,121481,0,3,0
34667,3,3,121481,121481,121484,0,3,0
34668,4,2,121485,121485,121487,0,2,1
34669,2,3,121487,121487,121490,0,3,0
34670,1,2,121488,121490,121492,2,4,0
34671,1,3,121489,121492,121495,3,6,0
34672,6,2,121495,121495,121497,0,2,0
34673,2,1,121497,121497,121498,0,1,0
34674,2,2,121499,121499,121501,0,2,1
34675,3,1,121502,121502,121503,0,1,1
34676,4,1,121506,121506,121507,0,1,3
34677,4,3,121510,121510,121513,0,3,3
34678,1,3,121511,121513,121516,2,5,0
34679,5,1,121516,121516,121517,0,1,0
34680,2,1,121518,121518,121519,0,1,1
34681,3,2,121521,121521,121523,0,2,2
34682,2,1,121523,121523,121524,0,1,0
34683,6,3,121529,121529,121532,0,3,5
34684,5,2,121534,121534,121536,0,2,2
34685,4,2,121538,121538,121540,0,2,2
34686,4,3,121542,121542,121545,0,3,2
34687,1,1,121543,121545,121546,2,3,0
34688,2,3,121545,121546,121549,1,4,0
34689,2,1,121547,121549,121550,2,3,0
34690,3,3,121550,121550,121553,0,3,0
34691,3,3,121553,121553,121556,0,3,0
34692,6,3,121559,121559,121562,0,3,3
34693,3,3,121562,121562,121565,0,3,0
34694,2,1,121564,121565,121566,1,2,0
34695,6,2,121570,121570,121572,0,2,4
34696,6,2,121576,121576,121578,0,2,4
34697,1,2,121577,121578,121580,1,3,0
34698,3,2,121580,121580,121582,0,2,0
34699,1,3,121581,121582,121585,1,4,0
34700,1,1,121582,121585,121586,3,4,0
34701,4,2,121586,121586,121588,0,2,0
34702,1,3,121587,121588,121591,1,4,0
34703,1,2,121588,121591,121593,3,5,0
34704,4,2,121592,121593,121595,1,3,0
34705,1,2,121593,121595,121597,2,4,0
34706,2,1,121595,121597,121598,2,3,0
34707,1,3,121596,121598,121601,2,5,0
34708,6,3,121602,121602,121605,0,3,1
34709,5,3,121607,121607,121610,0,3,2
34710,1,1,121608,121610,121611,2,3,0
34711,6,1,121614,121614,121615,0,1,3
34712,2,3,121616,121616,121619,0,3,1
34713,5,3,121621,121621,121624,0,3,2
34714,5,3,121626,121626,121629,0,3,2
34715,5,1,121631,121631,121632,0,1,2
34716,1,2,121632,121632,121634,0,2,0
34717,1,2,121633,121634,121636,1,3,0
34718,1,2,121634,121636,121638,2,4,0
34719,2,2,121636,121638,121640,2,4,0
34720,1,3,121637,121640,121643,3,6,0
34721,3,1,121640,121643,121644,3,4,0
34722,3,2,121643,121644,121646,1,3,0
34723,1,1,121644,121646,121647,2,3,0
34724,5,3,121649,121649,121652,0,3,2
34725,4,1,121653,121653,121654,0,1,1
34726,6,3,121659,121659,121662,0,3,5
34727,2,2,121661,121662,121664,1,3,0
34728,4,2,121665,121665,121667,0,2,1
34729,4,3,121669,121669,121672,0,3,2
34730,1,1,121670,121672,121673,2,3,0
34731,4,1,121674,121674,121675,0,1,1
34732,5,3,121679,121679,121682,0,3,4
34733,2,3,121681,121682,121685,1,4,0
34734,3,2,121684,121685,121687,1,3,0
34735,5,2,121689,121689,121691,0,2,2
34736,6,3,121695,121695,121698,0,3,4
34737,3,2,121698,121698,121700,0,2,0
34738,2,2,121700,121700,121702,0,2,0
34739,6,2,121706,121706,121708,0,2,4
34740,6,3,121712,121712,121715,0,3,4
34741,6,3,121718,121718,121721,0,3,3
34742,6,1,121724,121724,121725,0,1,3
34743,5,3,121729,121729,121732,0,3,4
34744,3,3,121732,121732,121735,0,3,0
34745,4,3,121736,121736,121739,0,3,1
34746,3,3,121739,121739,121742,0,3,0
34747,6,1,121745,121745,121746,0,1,3
34748,4,3,121749,121749,121752,0,3,3
34749,6,2,121755,121755,121757,0,2,3
34750,2,1,121757,121757,121758,0,1,0
34751,2,2,121759,121759,121761,0,2,1
34752,4,1,121763,121763,121764,0,1,2
34753,4,1,121767,121767,121768,0,1,3
34754,4,1,121771,121771,121772,0,1,3
34755,2,1,121773,121773,121774,0,1,1
34756,1,1,121774,121774,121775,0,1,0
34757,3,1,121777,121777,121778,0,1,2
34758,2,2,121779,121779,121781,0,2,1
34759,6,2,121785,121785,121787,0,2,4
34760,2,3,121787,121787,121790,0,3,0
34761,1,3,121788,121790,121793,2,5,0
34762,3,1,121791,121793,121794,2,3,0
34763,2,3,121793,121794,121797,1,4,0
34764,6,1,121799,121799,121800,0,1,2
34765,2,2,121801,121801,121803,0,2,1
34766,6,3,121807,121807,121810,0,3,4
34767,5,2,121812,121812,121814,0,2,2
34768,3,3,121815,121815,121818,0,3,1
34769,4,1,121819,121819,121820,0,1,1
34770,2,1,121821,121821,121822,0,1,1
34771,1,1,121822,121822,121823,0,1,0
34772,2,3,121824,121824,121827,0,3,1
34773,6,3,121830,121830,121833,0,3,3
34774,5,1,121835,121835,121836,0,1,2
34775,6,3,121841,121841,121844,0,3,5
34776,5,2,121846,121846,121848,0,2,2
34777,6,3,121852,121852,121855,0,3,4
34778,6,1,121858,121858,121859,0,1,3
34779,2,1,121860,121860,121861,0,1,1
34780,1,1,121861,121861,121862,0,1,0
34781,5,1,121866,121866,121867,0,1,4
34782,5,2,121871,121871,121873,0,2,4
34783,2,1,121873,121873,121874,0,1,0
34784,4,3,121877,121877,121880,0,3,3
34785,6,2,121883,121883,121885,0,2,3
34786,6,2,121889,121889,121891,0,2,4
34787,2,3,121891,121891,121894,0,3,0
34788,6,2,121897,121897,121899,0,2,3
34789,1,1,121898,121899,121900,1,2,0
34790,6,1,121904,121904,121905,0,1,4
34791,5,2,121909,121909,121911,0,2,4
34792,1,1,121910,121911,121912,1,2,0
34793,1,3,121911,121912,121915,1,4,0
34794,4,3,121915,121915,121918,0,3,0
34795,1,3,121916,121918,121921,2,5,0
34796,1,3,121917,121921,121924,4,7,0
34797,4,3,121921,121924,121927,3,6,0
34798,6,1,121927,121927,121928,0,1,0
34799,4,1,121931,121931,121932,0,1,3
34800,5,1,121936,121936,121937,0,1,4
34801,2,3,121938,121938,121941,0,3,1
34802,4,1,121942,121942,121943,0,1,1
34803,1,1,121943,121943,121944,0,1,0
34804,4,2,121947,121947,121949,0,2,3
34805,6,2,121953,121953,121955,0,2,4
34806,2,1,121955,121955,121956,0,1,0
34807,1,2,121956,121956,121958,0,2,0
34808,2,1,121958,121958,121959,0,1,0
34809,4,1,121962,121962,121963,0,1,3
34810,6,1,121968,121968,121969,0,1,5
34811,6,3,121974,121974,121977,0,3,5
34812,5,3,121979,121979,121982,0,3,2
34813,1,3,121980,121982,121985,2,5,0
34814,5,2,121985,121985,121987,0,2,0
34815,5,1,121990,121990,121991,0,1,3
34816,6,1,121996,121996,121997,0,1,5
34817,4,3,122000,122000,122003,0,3,3
34818,5,2,122005,122005,122007,0,2,2
34819,2,1,122007,122007,122008,0,1,0
34820,5,2,122012,122012,122014,0,2,4
34821,1,3,122013,122014,122017,1,4,0
34822,2,1,122015,122017,122018,2,3,0
34823,3,3,122018,122018,122021,0,3,0
34824,5,3,122023,122023,122026,0,3,2
34825,4,3,122027,122027,122030,0,3,1
34826,6,3,122033,122033,122036,0,3,3
34827,1,1,122034,122036,122037,2,3,0
34828,3,1,122037,122037,122038,0,1,0
34829,2,2,122039,122039,122041,0,2,1
34830,5,1,122044,122044,122045,0,1,3
34831,3,3,122047,122047,122050,0,3,2
34832,4,2,122051,122051,122053,0,2,1
34833,5,2,122056,122056,122058,0,2,3
34834,3,1,122059,122059,122060,0,1,1
34835,4,2,122063,122063,122065,0,2,3
34836,1,3,122064,122065,122068,1,4,0
34837,1,1,122065,122068,122069,3,4,0
34838,4,3,122069,122069,122072,0,3,0
34839,6,3,122075,122075,122078,0,3,3
34840,3,3,122078,122078,122081,0,3,0
34841,5,1,122083,122083,122084,0,1,2
34842,1,1,122084,122084,122085,0,1,0
34843,4,1,122088,122088,122089,0,1,3
34844,4,2,122092,122092,122094,0,2,3
34845,5,1,122097,122097,122098,0,1,3
34846,6,2,122103,122103,122105,0,2,5
34847,2,3,122105,122105,122108,0,3,0
34848,2,1,122107,122108,122109,1,2,0
34849,3,3,122110,122110,122113,0,3,1
34850,2,2,122112,122113,122115,1,3,0
34851,3,1,122115,122115,122116,0,1,0
34852,6,1,122121,122121,122122,0,1,5
34853,1,1,122122,122122,122123,0,1,0
34854,1,3,122123,122123,122126,0,3,0
34855,6,2,122129,122129,122131,0,2,3
34856,1,3,122130,122131,122134,1,4,0
34857,6,1,122136,122136,122137,0,1,2
34858,2,1,122138,122138,122139,0,1,1
34859,5,3,122143,122143,122146,0,3,4
34860,4,2,122147,122147,122149,0,2,1
34861,2,3,122149,122149,122152,0,3,0
34862,1,3,122150,122152,122155,2,5,0
34863,6,2,122156,122156,122158,0,2,1
34864,6,1,122162,122162,122163,0,1,4
34865,3,3,122165,122165,122168,0,3,2
34866,2,3,122167,122168,122171,1,4,0
34867,5,3,122172,122172,122175,0,3,1
34868,1,3,122173,122175,122178,2,5,0
34869,4,3,122177,122178,122181,1,4,0
34870,3,1,122180,122181,122182,1,2,0
34871,6,2,122186,122186,122188,0,2,4
34872,3,1,122189,122189,122190,0,1,1
34873,3,2,122192,122192,122194,0,2,2
34874,5,1,122197,122197,122198,0,1,3
34875,2,3,122199,122199,122202,0,3,1
34876,2,2,122201,122202,122204,1,3,0
34877,4,1,122205,122205,122206,0,1,1
34878,3,3,122208,122208,122211,0,3,2
34879,3,1,122211,122211,122212,0,1,0
34880,6,1,122217,122217,122218,0,1,5
34881,4,1,122221,122221,122222,0,1,3
34882,5,3,122226,122226,122229,0,3,4
34883,3,3,122229,122229,122232,0,3,0
34884,1,2,122230,122232,122234,2,4,0
34885,3,2,122233,122234,122236,1,3,0
34886,5,3,122238,122238,122241,0,3,2
34887,5,3,122243,122243,122246,0,3,2
34888,4,2,122247,122247,122249,0,2,1
34889,3,3,122250,122250,122253,0,3,1
34890,6,3,122256,122256,122259,0,3,3
34891,2,1,122258,122259,122260,1,2,0
34892,3,1,122261,122261,122262,0,1,1
34893,2,2,122263,122263,122265,0,2,1
34894,1,2,122264,122265,122267,1,3,0
34895,4,2,122268,122268,122270,0,2,1
34896,3,2,122271,122271,122273,0,2,1
34897,1,2,122272,122273,122275,1,3,0
34898,5,1,122277,122277,122278,0,1,2
34899,5,3,122282,122282,122285,0,3,4
34900,4,3,122286,122286,122289,0,3,1
34901,3,3,122289,122289,122292,0,3,0
34902,6,3,122295,122295,122298,0,3,3
34903,2,1,122297,122298,122299,1,2,0
34904,5,3,122302,122302,122305,0,3,3
34905,6,1,122308,122308,122309,0,1,3
34906,4,1,122312,122312,122313,0,1,3
34907,2,2,122314,122314,122316,0,2,1
34908,1,1,122315,122316,122317,1,2,0
34909,4,1,122319,122319,122320,0,1,2
34910,2,2,122321,122321,122323,0,2,1
34911,1,1,122322,122323,122324,1,2,0
34912,5,3,122327,122327,122330,0,3,3
34913,3,1,122330,122330,122331,0,1,0
34914,1,3,122331,122331,122334,0,3,0
34915,4,3,122335,122335,122338,0,3,1
34916,6,2,122341,122341,122343,0,2,3
34917,3,2,122344,122344,122346,0,2,1
34918,1,2,122345,122346,122348,1,3,0
34919,1,2,122346,122348,122350,2,4,0
34920,5,2,122351,122351,122353,0,2,1
34921,2,2,122353,122353,122355,0,2,0
34922,1,2,122354,122355,122357,1,3,0
34923,2,1,122356,122357,122358,1,2,0
34924,5,1,122361,122361,122362,0,1,3
34925,5,3,122366,122366,122369,0,3,4
34926,3,1,122369,122369,122370,0,1,0
34927,3,3,122372,122372,122375,0,3,2
34928,5,1,122377,122377,122378,0,1,2
34929,3,3,122380,122380,122383,0,3,2
34930,6,1,122386,122386,122387,0,1,3
34931,3,2,122389,122389,122391,0,2,2
34932,5,2,122394,122394,122396,0,2,3
34933,3,3,122397,122397,122400,0,3,1
34934,4,1,122401,122401,122402,0,1,1
34935,3,1,122404,122404,122405,0,1,2
34936,3,2,122407,122407,122409,0,2,2
34937,2,3,122409,122409,122412,0,3,0
34938,2,1,122411,122412,122413,1,2,0
34939,3,2,122414,122414,122416,0,2,1
34940,6,3,122420,122420,122423,0,3,4
34941,2,3,122422,122423,122426,1,4,0
34942,6,3,122428,122428,122431,0,3,2
34943,3,2,122431,122431,122433,0,2,0
34944,3,3,122434,122434,122437,0,3,1
34945,6,1,122440,122440,122441,0,1,3
34946,4,1,122444,122444,122445,0,1,3
34947,4,2,122448,122448,122450,0,2,3
34948,3,3,122451,122451,122454,0,3,1
34949,5,3,122456,122456,122459,0,3,2
34950,5,1,122461,122461,122462,0,1,2
34951,6,1,122467,122467,122468,0,1,5
34952,5,1,122472,122472,122473,0,1,4
34953,2,2,122474,122474,122476,0,2,1
34954,5,3,122479,122479,122482,0,3,3
34955,6,1,122485,122485,122486,0,1,3
34956,3,3,122488,122488,122491,0,3,2
34957,4,2,122492,122492,122494,0,2,1
34958,2,2,122494,122494,122496,0,2,0
34959,3,1,122497,122497,122498,0,1,1
34960,4,3,122501,122501,122504,0,3,3
34961,2,3,122503,122504,122507,1,4,0
34962,4,1,122507,122507,122508,0,1,0
34963,3,2,122510,122510,122512,0,2,2
34964,2,2,122512,122512,122514,0,2,0
34965,6,2,122518,122518,122520,0,2,4
34966,6,2,122524,122524,122526,0,2,4
34967,2,3,122526,122526,122529,0,3,0
34968,2,2,122528,122529,122531,1,3,0
34969,2,2,122530,122531,122533,1,3,0
34970,3,1,122533,122533,122534,0,1,0
34971,1,2,122534,122534,122536,0,2,0
34972,3,3,122537,122537,122540,0,3,1
34973,6,2,122543,122543,122545,0,2,3
34974,5,1,122548,122548,122549,0,1,3
34975,5,2,122553,122553,122555,0,2,4
34976,4,1,122557,122557,122558,0,1,2
34977,2,1,122559,122559,122560,0,1,1
34978,6,1,122565,122565,122566,0,1,5
34979,2,2,122567,122567,122569,0,2,1
34980,2,3,122569,122569,122572,0,3,0
34981,2,2,122571,122572,122574,1,3,0
34982,1,1,122572,122574,122575,2,3,0
34983,3,3,122575,122575,122578,0,3,0
34984,2,1,122577,122578,122579,1,2,0
34985,1,3,122578,122579,122582,1,4,0
34986,3,2,122581,122582,122584,1,3,0
34987,4,3,122585,122585,122588,0,3,1
34988,5,2,122590,122590,122592,0,2,2
34989,2,3,122592,122592,122595,0,3,0
34990,6,1,122598,122598,122599,0,1,3
34991,1,3,122599,122599,122602,0,3,0
34992,6,1,122605,122605,122606,0,1,3
34993,4,2,122609,122609,122611,0,2,3
34994,2,1,122611,122611,122612,0,1,0
34995,4,3,122615,122615,122618,0,3,3
34996,1,1,122616,122618,122619,2,3,0
34997,2,3,122618,122619,122622,1,4,0
34998,5,3,122623,122623,122626,0,3,1
34999,2,2,122625,122626,122628,1,3,0
35000,6,1,122631,122631,122632,0,1,3
35001,6,1,122637,122637,122638,0,1,5
35002,4,2,122641,122641,122643,0,2,3
35003,5,3,122646,122646,122649,0,3,3
35004,3,2,122649,122649,122651,0,2,0
35005,2,2,122651,122651,122653,0,2,0
35006,2,3,122653,122653,122656,0,3,0
35007,1,1,122654,122656,122657,2,3,0
35008,4,3,122658,122658,122661,0,3,1
35009,2,1,122660,122661,122662,1,2,0
35010,5,3,122665,122665,122668,0,3,3
35011,5,2,122670,122670,122672,0,2,2
35012,4,3,122674,122674,122677,0,3,2
35013,5,1,122679,122679,122680,0,1,2
35014,2,2,122681,122681,122683,0,2,1
35015,2,2,122683,122683,122685,0,2,0
35016,3,1,122686,122686,122687,0,1,1
35017,2,2,122688,122688,122690,0,2,1
35018,6,2,122694,122694,122696,0,2,4
35019,5,3,122699,122699,122702,0,3,3
35020,3,1,122702,122702,122703,0,1,0
35021,4,3,122706,122706,122709,0,3,3
35022,3,2,122709,122709,122711,0,2,0
35023,5,1,122714,122714,122715,0,1,3
35024,1,2,122715,122715,122717,0,2,0
35025,5,2,122720,122720,122722,0,2,3
35026,5,1,122725,122725,122726,0,1,3
35027,1,3,122726,122726,122729,0,3,0
35028,2,1,122728,122729,122730,1,2,0
35029,3,3,122731,122731,122734,0,3,1
35030,1,3,122732,122734,122737,2,5,0
35031,2,3,122734,122737,122740,3,6,0
35032,6,1,122740,122740,122741,0,1,0
35033,5,2,122745,122745,122747,0,2,4
35034,2,1,122747,122747,122748,0,1,0
35035,3,3,122750,122750,122753,0,3,2
35036,2,3,122752,122753,122756,1,4,0
35037,2,2,122754,122756,122758,2,4,0
35038,6,2,122760,122760,122762,0,2,2
35039,2,1,122762,122762,122763,0,1,0
35040,1,3,122763,122763,122766,0,3,0
35041,2,3,122765,122766,122769,1,4,0
35042,6,1,122771,122771,122772,0,1,2
35043,5,3,122776,122776,122779,0,3,4
35044,3,3,122779,122779,122782,0,3,0
35045,5,1,122784,122784,122785,0,1,2
35046,2,2,122786,122786,122788,0,2,1
35047,6,3,122792,122792,122795,0,3,4
35048,1,3,122793,122795,122798,2,5,0
35049,4,1,122797,122798,122799,1,2,0
35050,4,3,122801,122801,122804,0,3,2
35051,2,3,122803,122804,122807,1,4,0
35052,6,1,122809,122809,122810,0,1,2
35053,2,2,122811,122811,122813,0,2,1
35054,5,2,122816,122816,122818,0,2,3
35055,6,3,122822,122822,122825,0,3,4
35056,1,2,122823,122825,122827,2,4,0
35057,4,1,122827,122827,122828,0,1,0
35058,6,2,122833,122833,122835,0,2,5
35059,5,3,122838,122838,122841,0,3,3
35060,5,3,122843,122843,122846,0,3,2
35061,3,3,122846,122846,122849,0,3,0
35062,5,3,122851,122851,122854,0,3,2
35063,4,1,122855,122855,122856,0,1,1
35064,3,2,122858,122858,122860,0,2,2
35065,5,3,122863,122863,122866,0,3,3
35066,6,3,122869,122869,122872,0,3,3
35067,4,3,122873,122873,122876,0,3,1
35068,4,1,122877,122877,122878,0,1,1
35069,1,2,122878,122878,122880,0,2,0
35070,3,2,122881,122881,122883,0,2,1
35071,2,1,122883,122883,122884,0,1,0
35072,1,2,122884,122884,122886,0,2,0
35073,3,1,122887,122887,122888,0,1,1
35074,4,2,122891,122891,122893,0,2,3
35075,3,1,122894,122894,122895,0,1,1
35076,2,2,122896,122896,122898,0,2,1
35077,6,1,122902,122902,122903,0,1,4
35078,1,2,122903,122903,122905,0,2,0
35079,6,3,122909,122909,122912,0,3,4
35080,4,3,122913,122913,122916,0,3,1
35081,6,2,122919,122919,122921,0,2,3
35082,4,3,122923,122923,122926,0,3,2
35083,2,2,122925,122926,122928,1,3,0
35084,6,2,122931,122931,122933,0,2,3
35085,6,3,122937,122937,122940,0,3,4
35086,6,2,122943,122943,122945,0,2,3
35087,4,3,122947,122947,122950,0,3,2
35088,2,3,122949,122950,122953,1,4,0
35089,4,1,122953,122953,122954,0,1,0
35090,1,3,122954,122954,122957,0,3,0
35091,4,3,122958,122958,122961,0,3,1
35092,1,1,122959,122961,122962,2,3,0
35093,2,2,122961,122962,122964,1,3,0
35094,6,1,122967,122967,122968,0,1,3
35095,2,1,122969,122969,122970,0,1,1
35096,6,1,122975,122975,122976,0,1,5
35097,2,1,122977,122977,122978,0,1,1
35098,2,3,122979,122979,122982,0,3,1
35099,5,2,122984,122984,122986,0,2,2
35100,1,2,122985,122986,122988,1,3,0
35101,4,3,122989,122989,122992,0,3,1
35102,1,2,122990,122992,122994,2,4,0
35103,6,3,122996,122996,122999,0,3,2
35104,4,3,123000,123000,123003,0,3,1
35105,1,2,123001,123003,123005,2,4,0
35106,1,3,123002,123005,123008,3,6,0
35107,1,3,123003,123008,123011,5,8,0
35108,6,3,123009,123011,123014,2,5,0
35109,4,3,123013,123014,123017,1,4,0
35110,1,2,123014,123017,123019,3,5,0
35111,4,3,123018,123019,123022,1,4,0
35112,2,3,123020,123022,123025,2,5,0
35113,3,3,123023,123025,123028,2,5,0
35114,1,3,123024,123028,123031,4,7,0
35115,3,2,123027,123031,123033,4,6,0
35116,5,1,123032,123033,123034,1,2,0
35117,6,1,123038,123038,123039,0,1,4
35118,6,1,123044,123044,123045,0,1,5
35119,3,3,123047,123047,123050,0,3,2
35120,2,1,123049,123050,123051,1,2,0
35121,3,3,123052,123052,123055,0,3,1
35122,3,3,123055,123055,123058,0,3,0
35123,2,3,123057,123058,123061,1,4,0
35124,4,1,123061,123061,123062,0,1,0
35125,3,3,123064,123064,123067,0,3,2
35126,5,2,123069,123069,123071,0,2,2
35127,6,3,123075,123075,123078,0,3,4
35128,2,2,123077,123078,123080,1,3,0
35129,1,2,123078,123080,123082,2,4,0
35130,4,1,123082,123082,123083,0,1,0
35131,6,3,123088,123088,123091,0,3,5
35132,1,1,123089,123091,123092,2,3,0
35133,6,2,123095,123095,123097,0,2,3
35134,3,1,123098,123098,123099,0,1,1
35135,1,3,123099,123099,123102,0,3,0
35136,5,2,123104,123104,123106,0,2,2
35137,2,1,123106,123106,123107,0,1,0
35138,4,2,123110,123110,123112,0,2,3
35139,1,1,123111,123112,123113,1,2,0
35140,1,2,123112,123113,123115,1,3,0
35141,1,1,123113,123115,123116,2,3,0
35142,6,2,123119,123119,123121,0,2,3
35143,4,2,123123,123123,123125,0,2,2
35144,5,2,123128,123128,123130,0,2,3
35145,6,2,123134,123134,123136,0,2,4
35146,2,3,123136,123136,123139,0,3,0
35147,3,3,123139,123139,123142,0,3,0
35148,2,1,123141,123142,123143,1,2,0
35149,3,1,123144,123144,123145,0,1,1
35150,1,2,123145,123145,123147,0,2,0
35151,1,3,123146,123147,123150,1,4,0
35152,5,2,123151,123151,123153,0,2,1
35153,6,2,123157,123157,123159,0,2,4
35154,4,3,123161,123161,123164,0,3,2
35155,1,3,123162,123164,123167,2,5,0
35156,3,1,123165,123167,123168,2,3,0
35157,1,1,123166,123168,123169,2,3,0
35158,1,3,123167,123169,123172,2,5,0
35159,3,3,123170,123172,123175,2,5,0
35160,1,3,123171,123175,123178,4,7,0
35161,1,2,123172,123178,123180,6,8,0
35162,2,2,123174,123180,123182,6,8,0
35163,5,3,123179,123182,123185,3,6,0
35164,5,3,123184,123185,123188,1,4,0
35165,6,1,123190,123190,123191,0,1,2
35166,6,1,123196,123196,123197,0,1,5
35167,2,2,123198,123198,123200,0,2,1
35168,1,3,123199,123200,123203,1,4,0
35169,6,1,123205,123205,123206,0,1,2
35170,5,2,123210,123210,123212,0,2,4
35171,6,2,123216,123216,123218,0,2,4
35172,1,1,123217,123218,123219,1,2,0
35173,1,3,123218,123219,123222,1,4,0
35174,4,3,123222,123222,123225,0,3,0
35175,1,1,123223,123225,123226,2,3,0
35176,6,3,123229,123229,123232,0,3,3
35177,4,1,123233,123233,123234,0,1,1
35178,2,2,123235,123235,123237,0,2,1
35179,1,3,123236,123237,123240,1,4,0
35180,5,1,123241,123241,123242,0,1,1
35181,3,3,123244,123244,123247,0,3,2
35182,6,3,123250,123250,123253,0,3,3
35183,3,2,123253,123253,123255,0,2,0
35184,6,2,123259,123259,123261,0,2,4
35185,6,2,123265,123265,123267,0,2,4
35186,6,1,123271,123271,123272,0,1,4
35187,1,2,123272,123272,123274,0,2,0
35188,6,3,123278,123278,123281,0,3,4
35189,4,2,123282,123282,123284,0,2,1
35190,4,2,123286,123286,123288,0,2,2
35191,3,2,123289,123289,123291,0,2,1
35192,4,2,123293,123293,123295,0,2,2
35193,3,3,123296,123296,123299,0,3,1
35194,1,3,123297,123299,123302,2,5,0
35195,2,3,123299,123302,123305,3,6,0
35196,2,3,123301,123305,123308,4,7,0
35197,1,3,123302,123308,123311,6,9,0
35198,6,2,123308,123311,123313,3,5,0
35199,3,3,123311,123313,123316,2,5,0
35200,3,3,123314,123316,123319,2,5,0
35201,4,2,123318,123319,123321,1,3,0
35202,1,3,123319,123321,123324,2,5,0
35203,4,1,123323,123324,123325,1,2,0
35204,6,2,123329,123329,123331,0,2,4
35205,4,3,123333,123333,123336,0,3,2
35206,2,1,123335,123336,123337,1,2,0
35207,6,2,123341,123341,123343,0,2,4
35208,6,2,123347,123347,123349,0,2,4
35209,4,2,123351,123351,123353,0,2,2
35210,5,2,123356,123356,123358,0,2,3
35211,2,2,123358,123358,123360,0,2,0
35212,3,3,123361,123361,123364,0,3,1
35213,6,1,123367,123367,123368,0,1,3
35214,1,1,123368,123368,123369,0,1,0
35215,4,2,123372,123372,123374,0,2,3
35216,2,2,123374,123374,123376,0,2,0
35217,3,2,123377,123377,123379,0,2,1
35218,5,2,123382,123382,123384,0,2,3
35219,4,2,123386,123386,123388,0,2,2
35220,2,3,123388,123388,123391,0,3,0
35221,5,2,123393,123393,123395,0,2,2
35222,3,1,123396,123396,123397,0,1,1
35223,1,1,123397,123397,123398,0,1,0
35224,6,2,123403,123403,123405,0,2,5
35225,6,1,123409,123409,123410,0,1,4
35226,4,3,123413,123413,123416,0,3,3
35227,6,1,123419,123419,123420,0,1,3
35228,6,3,123425,123425,123428,0,3,5
35229,3,2,123428,123428,123430,0,2,0
35230,6,1,123434,123434,123435,0,1,4
35231,4,2,123438,123438,123440,0,2,3
35232,1,1,123439,123440,123441,1,2,0
35233,1,2,123440,123441,123443,1,3,0
35234,6,1,123446,123446,123447,0,1,3
35235,3,1,123449,123449,123450,0,1,2
35236,1,2,123450,123450,123452,0,2,0
35237,6,2,123456,123456,123458,0,2,4
35238,1,2,123457,123458,123460,1,3,0
35239,4,1,123461,123461,123462,0,1,1
35240,6,2,123467,123467,123469,0,2,5
35241,2,2,123469,123469,123471,0,2,0
35242,1,1,123470,123471,123472,1,2,0
35243,5,3,123475,123475,123478,0,3,3
35244,4,2,123479,123479,123481,0,2,1
35245,2,1,123481,123481,123482,0,1,0
35246,2,2,123483,123483,123485,0,2,1
35247,6,1,123489,123489,123490,0,1,4
35248,3,1,123492,123492,123493,0,1,2
35249,2,2,123494,123494,123496,0,2,1
35250,4,3,123498,123498,123501,0,3,2
35251,3,3,123501,123501,123504,0,3,0
35252,2,3,123503,123504,123507,1,4,0
35253,2,1,123505,123507,123508,2,3,0
35254,3,1,123508,123508,123509,0,1,0
35255,2,2,123510,123510,123512,0,2,1
35256,4,2,123514,123514,123516,0,2,2
35257,2,1,123516,123516,123517,0,1,0
35258,2,1,123518,123518,123519,0,1,1
35259,5,1,123523,123523,123524,0,1,4
35260,1,2,123524,123524,123526,0,2,0
35261,6,2,123530,123530,123532,0,2,4
35262,6,2,123536,123536,123538,0,2,4
35263,1,1,123537,123538,123539,1,2,0
35264,5,3,123542,123542,123545,0,3,3
35265,6,3,123548,123548,123551,0,3,3
35266,3,1,123551,123551,123552,0,1,0
35267,5,3,123556,123556,123559,0,3,4
35268,5,2,123561,123561,123563,0,2,2
35269,4,3,123565,123565,123568,0,3,2
35270,3,1,123568,123568,123569,0,1,0
35271,1,1,123569,123569,123570,0,1,0
35272,1,1,123570,123570,123571,0,1,0
35273,3,1,123573,123573,123574,0,1,2
35274,1,2,123574,123574,123576,0,2,0
35275,6,2,123580,123580,123582,0,2,4
35276,3,1,123583,123583,123584,0,1,1
35277,4,2,123587,123587,123589,0,2,3
35278,6,1,123593,123593,123594,0,1,4
35279,6,2,123599,123599,123601,0,2,5
35280,1,3,123600,123601,123604,1,4,0
35281,4,1,123604,123604,123605,0,1,0
35282,3,2,123607,123607,123609,0,2,2
35283,6,2,123613,123613,123615,0,2,4
35284,1,3,123614,123615,123618,1,4,0
35285,4,2,123618,123618,123620,0,2,0
35286,5,3,123623,123623,123626,0,3,3
35287,3,1,123626,123626,123627,0,1,0
35288,4,2,123630,123630,123632,0,2,3
35289,2,1,123632,123632,123633,0,1,0
35290,6,1,123638,123638,123639,0,1,5
35291,1,3,123639,123639,123642,0,3,0
35292,4,2,123643,123643,123645,0,2,1
35293,2,1,123645,123645,123646,0,1,0
35294,2,1,123647,123647,123648,0,1,1
35295,2,2,123649,123649,123651,0,2,1
35296,6,3,123655,123655,123658,0,3,4
35297,5,2,123660,123660,123662,0,2,2
35298,3,3,123663,123663,123666,0,3,1
35299,2,3,123665,123666,123669,1,4,0
35300,1,3,123666,123669,123672,3,6,0
35301,1,3,123667,123672,123675,5,8,0
35302,1,1,123668,123675,123676,7,8,0
35303,2,2,123670,123676,123678,6,8,0
35304,4,2,123674,123678,123680,4,6,0
35305,3,3,123677,123680,123683,3,6,0
35306,6,1,123683,123683,123684,0,1,0
35307,1,3,123684,123684,123687,0,3,0
35308,2,2,123686,123687,123689,1,3,0
35309,2,3,123688,123689,123692,1,4,0
35310,1,1,123689,123692,123693,3,4,0
35311,5,1,123694,123694,123695,0,1,1
35312,1,2,123695,123695,123697,0,2,0
35313,4,2,123699,123699,123701,0,2,2
35314,1,3,123700,123701,123704,1,4,0
35315,2,1,123702,123704,123705,2,3,0
35316,3,3,123705,123705,123708,0,3,0
35317,2,3,123707,123708,123711,1,4,0
35318,1,3,123708,123711,123714,3,6,0
35319,4,3,123712,123714,123717,2,5,0
35320,3,2,123715,123717,123719,2,4,0
35321,1,2,123716,123719,123721,3,5,0
35322,2,1,123718,123721,123722,3,4,0
35323,3,1,123721,123722,123723,1,2,0
35324,6,2,123727,123727,123729,0,2,4
35325,1,3,123728,123729,123732,1,4,0
35326,3,3,123731,123732,123735,1,4,0
35327,5,3,123736,123736,123739,0,3,1
35328,5,1,123741,123741,123742,0,1,2
35329,1,1,123742,123742,123743,0,1,0
35330,4,2,123746,123746,123748,0,2,3
35331,1,2,123747,123748,123750,1,3,0
35332,5,3,123752,123752,123755,0,3,2
35333,5,2,123757,123757,123759,0,2,2
35334,4,1,123761,123761,123762,0,1,2
35335,3,1,123764,123764,123765,0,1,2
35336,3,3,123767,123767,123770,0,3,2
35337,4,2,123771,123771,123773,0,2,1
35338,1,3,123772,123773,123776,1,4,0
35339,4,3,123776,123776,123779,0,3,0
35340,5,2,123781,123781,123783,0,2,2
35341,2,2,123783,123783,123785,0,2,0
35342,1,1,123784,123785,123786,1,2,0
35343,6,1,123790,123790,123791,0,1,4
35344,2,2,123792,123792,123794,0,2,1
35345,5,1,123797,123797,123798,0,1,3
35346,6,3,123803,123803,123806,0,3,5
35347,6,2,123809,123809,123811,0,2,3
35348,5,2,123814,123814,123816,0,2,3
35349,4,1,123818,123818,123819,0,1,2
35350,5,2,123823,123823,123825,0,2,4
35351,2,1,123825,123825,123826,0,1,0
35352,6,3,123831,123831,123834,0,3,5
35353,6,2,123837,123837,123839,0,2,3
35354,2,3,123839,123839,123842,0,3,0
35355,2,1,123841,123842,123843,1,2,0
35356,3,2,123844,123844,123846,0,2,1
35357,1,2,123845,123846,123848,1,3,0
35358,2,3,123847,123848,123851,1,4,0
35359,5,1,123852,123852,123853,0,1,1
35360,5,1,123857,123857,123858,0,1,4
35361,1,2,123858,123858,123860,0,2,0
35362,1,3,123859,123860,123863,1,4,0
35363,4,2,123863,123863,123865,0,2,0
35364,2,1,123865,123865,123866,0,1,0
35365,5,2,123870,123870,123872,0,2,4
35366,1,2,123871,123872,123874,1,3,0
35367,1,3,123872,123874,123877,2,5,0
35368,5,3,123877,123877,123880,0,3,0
35369,3,1,123880,123880,123881,0,1,0
35370,2,1,123882,123882,123883,0,1,1
35371,1,3,123883,123883,123886,0,3,0
35372,6,1,123889,123889,123890,0,1,3
35373,5,3,123894,123894,123897,0,3,4
35374,6,1,123900,123900,123901,0,1,3
35375,5,1,123905,123905,123906,0,1,4
35376,4,1,123909,123909,123910,0,1,3
35377,6,3,123915,123915,123918,0,3,5
35378,5,3,123920,123920,123923,0,3,2
35379,3,3,123923,123923,123926,0,3,0
35380,2,1,123925,123926,123927,1,2,0
35381,5,3,123930,123930,123933,0,3,3
35382,4,1,123934,123934,123935,0,1,1
35383,4,3,123938,123938,123941,0,3,3
35384,5,3,123943,123943,123946,0,3,2
35385,6,3,123949,123949,123952,0,3,3
35386,4,3,123953,123953,123956,0,3,1
35387,4,3,123957,123957,123960,0,3,1
35388,6,1,123963,123963,123964,0,1,3
35389,6,1,123969,123969,123970,0,1,5
35390,4,1,123973,123973,123974,0,1,3
35391,2,3,123975,123975,123978,0,3,1
35392,3,1,123978,123978,123979,0,1,0
35393,2,3,123980,123980,123983,0,3,1
35394,6,2,123986,123986,123988,0,2,3
35395,2,2,123988,123988,123990,0,2,0
35396,1,3,123989,123990,123993,1,4,0
35397,4,2,123993,123993,123995,0,2,0
35398,5,3,123998,123998,124001,0,3,3
35399,2,1,124000,124001,124002,1,2,0
35400,1,3,124001,124002,124005,1,4,0
35401,3,1,124004,124005,124006,1,2,0
35402,3,2,124007,124007,124009,0,2,1
35403,2,1,124009,124009,124010,0,1,0
35404,4,2,124013,124013,124015,0,2,3
35405,5,2,124018,124018,124020,0,2,3
35406,3,2,124021,124021,124023,0,2,1
35407,5,3,124026,124026,124029,0,3,3
35408,5,2,124031,124031,124033,0,2,2
35409,4,2,124035,124035,124037,0,2,2
35410,4,2,124039,124039,124041,0,2,2
35411,6,1,124045,124045,124046,0,1,4
35412,4,1,124049,124049,124050,0,1,3
35413,1,3,124050,124050,124053,0,3,0
35414,3,3,124053,124053,124056,0,3,0
35415,5,2,124058,124058,124060,0,2,2
35416,3,2,124061,124061,124063,0,2,1
35417,1,2,124062,124063,124065,1,3,0
35418,2,3,124064,124065,124068,1,4,0
35419,1,3,124065,124068,124071,3,6,0
35420,1,3,124066,124071,124074,5,8,0
35421,6,2,124072,124074,124076,2,4,0
35422,2,3,124074,124076,124079,2,5,0
35423,6,2,124080,124080,124082,0,2,1
35424,4,2,124084,124084,124086,0,2,2
35425,5,2,124089,124089,124091,0,2,3
35426,3,1,124092,124092,124093,0,1,1
35427,5,1,124097,124097,124098,0,1,4
35428,1,1,124098,124098,124099,0,1,0
35429,5,1,124103,124103,124104,0,1,4
35430,3,2,124106,124106,124108,0,2,2
35431,2,1,124108,124108,124109,0,1,0
35432,5,1,124113,124113,124114,0,1,4
35433,2,3,124115,124115,124118,0,3,1
35434,1,3,124116,124118,124121,2,5,0
35435,1,2,124117,124121,124123,4,6,0
35436,2,1,124119,124123,124124,4,5,0
35437,2,3,124121,124124,124127,3,6,0
35438,2,2,124123,124127,124129,4,6,0
35439,6,3,124129,124129,124132,0,3,0
35440,3,3,124132,124132,124135,0,3,0
35441,6,2,124138,124138,124140,0,2,3
35442,4,3,124142,124142,124145,0,3,2
35443,2,3,124144,124145,124148,1,4,0
35444,3,1,124147,124148,124149,1,2,0
35445,6,2,124153,124153,124155,0,2,4
35446,4,2,124157,124157,124159,0,2,2
35447,3,1,124160,124160,124161,0,1,1
35448,1,1,124161,124161,124162,0,1,0
35449,5,1,124166,124166,124167,0,1,4
35450,3,2,124169,124169,124171,0,2,2
35451,3,3,124172,124172,124175,0,3,1
35452,5,3,124177,124177,124180,0,3,2
35453,6,2,124183,124183,124185,0,2,3
35454,4,2,124187,124187,124189,0,2,2
35455,3,3,124190,124190,124193,0,3,1
35456,1,2,124191,124193,124195,2,4,0
35457,2,1,124193,124195,124196,2,3,0
35458,6,3,124199,124199,124202,0,3,3
35459,6,2,124205,124205,124207,0,2,3
35460,1,3,124206,124207,124210,1,4,0
35461,3,3,124209,124210,124213,1,4,0
35462,3,2,124212,124213,124215,1,3,0
35463,6,3,124218,124218,124221,0,3,3
35464,3,1,124221,124221,124222,0,1,0
35465,1,1,124222,124222,124223,0,1,0
35466,3,3,124225,124225,124228,0,3,2
35467,3,2,124228,124228,124230,0,2,0
35468,2,3,124230,124230,124233,0,3,0
35469,3,3,124233,124233,124236,0,3,0
35470,5,1,124238,124238,124239,0,1,2
35471,5,3,124243,124243,124246,0,3,4
35472,6,2,124249,124249,124251,0,2,3
35473,6,3,124255,124255,124258,0,3,4
35474,5,3,124260,124260,124263,0,3,2
35475,6,2,124266,124266,124268,0,2,3
35476,5,1,124271,124271,124272,0,1,3
35477,5,1,124276,124276,124277,0,1,4
35478,1,1,124277,124277,124278,0,1,0
35479,1,3,124278,124278,124281,0,3,0
35480,2,1,124280,124281,124282,1,2,0
35481,2,1,124282,124282,124283,0,1,0
35482,4,1,124286,124286,124287,0,1,3
35483,3,2,124289,124289,124291,0,2,2
35484,3,2,124292,124292,124294,0,2,1
35485,4,1,124296,124296,124297,0,1,2
35486,6,3,124302,124302,124305,0,3,5
35487,2,3,124304,124305,124308,1,4,0
35488,4,2,124308,124308,124310,0,2,0
35489,1,1,124309,124310,124311,1,2,0
35490,4,3,124313,124313,124316,0,3,2
35491,6,1,124319,124319,124320,0,1,3
35492,1,1,124320,124320,124321,0,1,0
35493,3,2,124323,124323,124325,0,2,2
35494,6,3,124329,124329,124332,0,3,4
35495,4,2,124333,124333,124335,0,2,1
35496,2,1,124335,124335,124336,0,1,0
35497,1,3,124336,124336,124339,0,3,0
35498,1,3,124337,124339,124342,2,5,0
35499,4,1,124341,124342,124343,1,2,0
35500,6,2,124347,124347,124349,0,2,4
35501,5,2,124352,124352,124354,0,2,3
35502,5,2,124357,124357,124359,0,2,3
35503,5,2,124362,124362,124364,0,2,3
35504,6,3,124368,124368,124371,0,3,4
35505,1,2,124369,124371,124373,2,4,0
35506,5,1,124374,124374,124375,0,1,1
35507,6,3,124380,124380,124383,0,3,5
35508,4,3,124384,124384,124387,0,3,1
35509,1,3,124385,124387,124390,2,5,0
35510,1,1,124386,124390,124391,4,5,0
35511,4,2,124390,124391,124393,1,3,0
35512,5,2,124395,124395,124397,0,2,2
35513,1,1,124396,124397,124398,1,2,0
35514,5,3,124401,124401,124404,0,3,3
35515,5,3,124406,124406,124409,0,3,2
35516,4,3,124410,124410,124413,0,3,1
35517,2,3,124412,124413,124416,1,4,0
35518,4,1,124416,124416,124417,0,1,0
35519,3,3,124419,124419,124422,0,3,2
35520,5,2,124424,124424,124426,0,2,2
35521,2,2,124426,124426,124428,0,2,0
35522,6,3,124432,124432,124435,0,3,4
35523,3,2,124435,124435,124437,0,2,0
35524,3,2,124438,124438,124440,0,2,1
35525,2,1,124440,124440,124441,0,1,0
35526,5,2,124445,124445,124447,0,2,4
35527,3,2,124448,124448,124450,0,2,1
35528,4,2,124452,124452,124454,0,2,2
35529,1,2,124453,124454,124456,1,3,0
35530,4,3,124457,124457,124460,0,3,1
35531,3,1,124460,124460,124461,0,1,0
35532,3,1,124463,124463,124464,0,1,2
35533,4,1,124467,124467,124468,0,1,3
35534,3,3,124470,124470,124473,0,3,2
35535,6,1,124476,124476,124477,0,1,3
35536,3,3,124479,124479,124482,0,3,2
35537,4,2,124483,124483,124485,0,2,1
35538,3,3,124486,124486,124489,0,3,1
35539,3,3,124489,124489,124492,0,3,0
35540,3,3,124492,124492,124495,0,3,0
35541,5,3,124497,124497,124500,0,3,2
35542,6,1,124503,124503,124504,0,1,3
35543,4,3,124507,124507,124510,0,3,3
35544,1,1,124508,124510,124511,2,3,0
35545,6,1,124514,124514,124515,0,1,3
35546,4,2,124518,124518,124520,0,2,3
35547,3,3,124521,124521,124524,0,3,1
35548,6,2,124527,124527,124529,0,2,3
35549,4,2,124531,124531,124533,0,2,2
35550,4,1,124535,124535,124536,0,1,2
35551,4,1,124539,124539,124540,0,1,3
35552,6,2,124545,124545,124547,0,2,5
35553,3,3,124548,124548,124551,0,3,1
35554,6,3,124554,124554,124557,0,3,3
35555,1,1,124555,124557,124558,2,3,0
35556,6,3,124561,124561,124564,0,3,3
35557,6,3,124567,124567,124570,0,3,3
35558,3,1,124570,124570,124571,0,1,0
35559,2,2,124572,124572,124574,0,2,1
35560,4,1,124576,124576,124577,0,1,2
35561,2,3,124578,124578,124581,0,3,1
35562,6,3,124584,124584,124587,0,3,3
35563,6,2,124590,124590,124592,0,2,3
35564,4,1,124594,124594,124595,0,1,2
35565,6,1,124600,124600,124601,0,1,5
35566,6,2,124606,124606,124608,0,2,5
35567,1,3,124607,124608,124611,1,4,0
35568,4,2,124611,124611,124613,0,2,0
35569,1,2,124612,124613,124615,1,3,0
35570,2,2,124614,124615,124617,1,3,0
35571,1,3,124615,124617,124620,2,5,0
35572,1,2,124616,124620,124622,4,6,0
35573,1,2,124617,124622,124624,5,7,0
35574,1,2,124618,124624,124626,6,8,0
35575,6,2,124624,124626,124628,2,4,0
35576,3,2,124627,124628,124630,1,3,0
35577,5,1,124632,124632,124633,0,1,2
35578,6,1,124638,124638,124639,0,1,5
35579,3,2,124641,124641,124643,0,2,2
35580,5,3,124646,124646,124649,0,3,3
35581,6,1,124652,124652,124653,0,1,3
35582,1,3,124653,124653,124656,0,3,0
35583,2,3,124655,124656,124659,1,4,0
35584,3,2,124658,124659,124661,1,3,0
35585,2,2,124660,124661,124663,1,3,0
35586,1,1,124661,124663,124664,2,3,0
35587,2,3,124663,124664,124667,1,4,0
35588,6,1,124669,124669,124670,0,1,2
35589,1,3,124670,124670,124673,0,3,0
35590,5,2,124675,124675,124677,0,2,2
35591,5,1,124680,124680,124681,0,1,3
35592,5,2,124685,124685,124687,0,2,4
35593,5,2,124690,124690,124692,0,2,3
35594,5,3,124695,124695,124698,0,3,3
35595,2,3,124697,124698,124701,1,4,0
35596,5,2,124702,124702,124704,0,2,1
35597,4,2,124706,124706,124708,0,2,2
35598,1,3,124707,124708,124711,1,4,0
35599,3,1,124710,124711,124712,1,2,0
35600,3,2,124713,124713,124715,0,2,1
35601,1,3,124714,124715,124718,1,4,0
35602,3,2,124717,124718,124720,1,3,0
35603,4,1,124721,124721,124722,0,1,1
35604,6,2,124727,124727,124729,0,2,5
35605,6,1,124733,124733,124734,0,1,4
35606,3,1,124736,124736,124737,0,1,2
35607,3,2,124739,124739,124741,0,2,2
35608,2,2,124741,124741,124743,0,2,0
35609,3,2,124744,124744,124746,0,2,1
35610,4,3,124748,124748,124751,0,3,2
35611,5,2,124753,124753,124755,0,2,2
35612,1,2,124754,124755,124757,1,3,0
35613,4,1,124758,124758,124759,0,1,1
35614,6,3,124764,124764,124767,0,3,5
35615,4,1,124768,124768,124769,0,1,1
35616,4,2,124772,124772,124774,0,2,3
35617,6,2,124778,124778,124780,0,2,4
35618,5,1,124783,124783,124784,0,1,3
35619,4,1,124787,124787,124788,0,1,3
35620,1,1,124788,124788,124789,0,1,0
35621,5,3,124793,124793,124796,0,3,4
35622,5,1,124798,124798,124799,0,1,2
35623,3,2,124801,124801,124803,0,2,2
35624,6,2,124807,124807,124809,0,2,4
35625,1,1,124808,124809,124810,1,2,0
35626,6,2,124814,124814,124816,0,2,4
35627,3,1,124817,124817,124818,0,1,1
35628,2,1,124819,124819,124820,0,1,1
35629,5,3,124824,124824,124827,0,3,4
35630,6,3,124830,124830,124833,0,3,3
35631,3,1,124833,124833,124834,0,1,0
35632,5,2,124838,124838,124840,0,2,4
35633,4,1,124842,124842,124843,0,1,2
35634,6,3,124848,124848,124851,0,3,5
35635,5,3,124853,124853,124856,0,3,2
35636,6,1,124859,124859,124860,0,1,3
35637,6,1,124865,124865,124866,0,1,5
35638,6,1,124871,124871,124872,0,1,5
35639,6,3,124877,124877,124880,0,3,5
35640,2,3,124879,124880,124883,1,4,0
35641,3,3,124882,124883,124886,1,4,0
35642,6,1,124888,124888,124889,0,1,2
35643,6,1,124894,124894,124895,0,1,5
35644,4,3,124898,124898,124901,0,3,3
35645,2,2,124900,124901,124903,1,3,0
35646,5,1,124905,124905,124906,0,1,2
35647,1,2,124906,124906,124908,0,2,0
35648,6,2,124912,124912,124914,0,2,4
35649,3,1,124915,124915,124916,0,1,1
35650,6,1,124921,124921,124922,0,1,5
35651,6,3,124927,124927,124930,0,3,5
35652,2,3,124929,124930,124933,1,4,0
35653,3,3,124932,124933,124936,1,4,0
35654,3,3,124935,124936,124939,1,4,0
35655,6,3,124941,124941,124944,0,3,2
35656,1,3,124942,124944,124947,2,5,0
35657,4,1,124946,124947,124948,1,2,0
35658,4,3,124950,124950,124953,0,3,2
35659,3,1,124953,124953,124954,0,1,0
35660,4,3,124957,124957,124960,0,3,3
35661,4,2,124961,124961,124963,0,2,1
35662,5,1,124966,124966,124967,0,1,3
35663,6,1,124972,124972,124973,0,1,5
35664,1,1,124973,124973,124974,0,1,0
35665,3,1,124976,124976,124977,0,1,2
35666,5,1,124981,124981,124982,0,1,4
35667,6,2,124987,124987,124989,0,2,5
35668,5,1,124992,124992,124993,0,1,3
35669,6,2,124998,124998,125000,0,2,5
35670,6,2,125004,125004,125006,0,2,4
35671,1,3,125005,125006,125009,1,4,0
35672,3,3,125008,125009,125012,1,4,0
35673,6,3,125014,125014,125017,0,3,2
35674,2,3,125016,125017,125020,1,4,0
35675,4,3,125020,125020,125023,0,3,0
35676,3,3,125023,125023,125026,0,3,0
35677,2,2,125025,125026,125028,1,3,0
35678,6,2,125031,125031,125033,0,2,3
35679,4,2,125035,125035,125037,0,2,2
35680,3,3,125038,125038,125041,0,3,1
35681,2,3,125040,125041,125044,1,4,0
35682,2,3,125042,125044,125047,2,5,0
35683,1,1,125043,125047,125048,4,5,0
35684,3,3,125046,125048,125051,2,5,0
35685,2,2,125048,125051,125053,3,5,0
35686,4,1,125052,125053,125054,1,2,0
35687,2,3,125054,125054,125057,0,3,0
35688,3,1,125057,125057,125058,0,1,0
35689,6,2,125063,125063,125065,0,2,5
35690,3,2,125066,125066,125068,0,2,1
35691,6,1,125072,125072,125073,0,1,4
35692,1,1,125073,125073,125074,0,1,0
35693,2,1,125075,125075,125076,0,1,1
35694,2,3,125077,125077,125080,0,3,1
35695,3,3,125080,125080,125083,0,3,0
35696,1,2,125081,125083,125085,2,4,0
35697,3,3,125084,125085,125088,1,4,0
35698,2,1,125086,125088,125089,2,3,0
35699,4,2,125090,125090,125092,0,2,1
35700,4,3,125094,125094,125097,0,3,2
35701,5,3,125099,125099,125102,0,3,2
35702,1,2,125100,125102,125104,2,4,0
35703,6,2,125106,125106,125108,0,2,2
35704,4,1,125110,125110,125111,0,1,2
35705,6,1,125116,125116,125117,0,1,5
35706,1,3,125117,125117,125120,0,3,0
35707,4,1,125121,125121,125122,0,1,1
35708,6,3,125127,125127,125130,0,3,5
35709,3,1,125130,125130,125131,0,1,0
35710,2,2,125132,125132,125134,0,2,1
35711,2,3,125134,125134,125137,0,3,0
35712,5,3,125139,125139,125142,0,3,2
35713,1,3,125140,125142,125145,2,5,0
35714,1,1,125141,125145,125146,4,5,0
35715,1,3,125142,125146,125149,4,7,0
35716,3,3,125145,125149,125152,4,7,0
35717,4,2,125149,125152,125154,3,5,0
35718,6,1,125155,125155,125156,0,1,1
35719,2,2,125157,125157,125159,0,2,1
35720,3,2,125160,125160,125162,0,2,1
35721,2,1,125162,125162,125163,0,1,0
35722,4,1,125166,125166,125167,0,1,3
35723,5,1,125171,125171,125172,0,1,4
35724,5,3,125176,125176,125179,0,3,4
35725,4,3,125180,125180,125183,0,3,1
35726,1,3,125181,125183,125186,2,5,0
35727,5,3,125186,125186,125189,0,3,0
35728,4,2,125190,125190,125192,0,2,1
35729,1,2,125191,125192,125194,1,3,0
35730,1,1,125192,125194,125195,2,3,0
35731,1,3,125193,125195,125198,2,5,0
35732,1,1,125194,125198,125199,4,5,0
35733,2,2,125196,125199,125201,3,5,0
35734,2,1,125198,125201,125202,3,4,0
35735,1,1,125199,125202,125203,3,4,0
35736,3,1,125202,125203,125204,1,2,0
35737,1,2,125203,125204,125206,1,3,0
35738,3,1,125206,125206,125207,0,1,0
35739,4,1,125210,125210,125211,0,1,3
35740,1,1,125211,125211,125212,0,1,0
35741,2,1,125213,125213,125214,0,1,1
35742,1,2,125214,125214,125216,0,2,0
35743,6,3,125220,125220,125223,0,3,4
35744,5,3,125225,125225,125228,0,3,2
35745,3,2,125228,125228,125230,0,2,0
35746,5,2,125233,125233,125235,0,2,3
35747,3,3,125236,125236,125239,0,3,1
35748,4,3,125240,125240,125243,0,3,1
35749,6,3,125246,125246,125249,0,3,3
35750,2,3,125248,125249,125252,1,4,0
35751,1,3,125249,125252,125255,3,6,0
35752,6,3,125255,125255,125258,0,3,0
35753,6,3,125261,125261,125264,0,3,3
35754,6,3,125267,125267,125270,0,3,3
35755,1,1,125268,125270,125271,2,3,0
35756,2,2,125270,125271,125273,1,3,0
35757,5,2,125275,125275,125277,0,2,2
35758,6,3,125281,125281,125284,0,3,4
35759,4,2,125285,125285,125287,0,2,1
35760,3,1,125288,125288,125289,0,1,1
35761,2,2,125290,125290,125292,0,2,1
35762,6,1,125296,125296,125297,0,1,4
35763,3,2,125299,125299,125301,0,2,2
35764,1,3,125300,125301,125304,1,4,0
35765,2,1,125302,125304,125305,2,3,0
35766,4,2,125306,125306,125308,0,2,1
35767,6,2,125312,125312,125314,0,2,4
35768,4,1,125316,125316,125317,0,1,2
35769,6,3,125322,125322,125325,0,3,5
35770,2,3,125324,125325,125328,1,4,0
35771,6,2,125330,125330,125332,0,2,2
35772,4,3,125334,125334,125337,0,3,2
35773,5,2,125339,125339,125341,0,2,2
35774,1,1,125340,125341,125342,1,2,0
35775,5,2,125345,125345,125347,0,2,3
35776,1,1,125346,125347,125348,1,2,0
35777,2,3,125348,125348,125351,0,3,0
35778,2,1,125350,125351,125352,1,2,0
35779,6,1,125356,125356,125357,0,1,4
35780,2,1,125358,125358,125359,0,1,1
35781,5,2,125363,125363,125365,0,2,4
35782,2,3,125365,125365,125368,0,3,0
35783,5,3,125370,125370,125373,0,3,2
35784,1,3,125371,125373,125376,2,5,0
35785,3,2,125374,125376,125378,2,4,0
35786,3,1,125377,125378,125379,1,2,0
35787,6,2,125383,125383,125385,0,2,4
35788,3,2,125386,125386,125388,0,2,1
35789,6,3,125392,125392,125395,0,3,4
35790,6,3,125398,125398,125401,0,3,3
35791,3,3,125401,125401,125404,0,3,0
35792,4,1,125405,125405,125406,0,1,1
35793,2,2,125407,125407,125409,0,2,1
35794,5,1,125412,125412,125413,0,1,3
35795,3,3,125415,125415,125418,0,3,2
35796,3,1,125418,125418,125419,0,1,0
35797,2,2,125420,125420,125422,0,2,1
35798,2,2,125422,125422,125424,0,2,0
35799,6,3,125428,125428,125431,0,3,4
35800,5,3,125433,125433,125436,0,3,2
35801,6,1,125439,125439,125440,0,1,3
35802,1,1,125440,125440,125441,0,1,0
35803,6,2,125446,125446,125448,0,2,5
35804,5,3,125451,125451,125454,0,3,3
35805,4,2,125455,125455,125457,0,2,1
35806,6,2,125461,125461,125463,0,2,4
35807,5,2,125466,125466,125468,0,2,3
35808,3,2,125469,125469,125471,0,2,1
35809,1,1,125470,125471,125472,1,2,0
35810,2,2,125472,125472,125474,0,2,0
35811,4,2,125476,125476,125478,0,2,2
35812,2,3,125478,125478,125481,0,3,0
35813,3,2,125481,125481,125483,0,2,0
35814,3,1,125484,125484,125485,0,1,1
35815,1,3,125485,125485,125488,0,3,0
35816,3,2,125488,125488,125490,0,2,0
35817,4,3,125492,125492,125495,0,3,2
35818,3,3,125495,125495,125498,0,3,0
35819,6,1,125501,125501,125502,0,1,3
35820,5,2,125506,125506,125508,0,2,4
35821,3,1,125509,125509,125510,0,1,1
35822,6,3,125515,125515,125518,0,3,5
35823,2,2,125517,125518,125520,1,3,0
35824,4,3,125521,125521,125524,0,3,1
35825,4,3,125525,125525,125528,0,3,1
35826,6,3,125531,125531,125534,0,3,3
35827,4,3,125535,125535,125538,0,3,1
35828,6,2,125541,125541,125543,0,2,3
35829,6,3,125547,125547,125550,0,3,4
35830,1,3,125548,125550,125553,2,5,0
35831,4,3,125552,125553,125556,1,4,0
35832,3,2,125555,125556,125558,1,3,0
35833,5,1,125560,125560,125561,0,1,2
35834,1,3,125561,125561,125564,0,3,0
35835,1,1,125562,125564,125565,2,3,0
35836,6,1,125568,125568,125569,0,1,3
35837,3,1,125571,125571,125572,0,1,2
35838,4,2,125575,125575,125577,0,2,3
35839,1,1,125576,125577,125578,1,2,0
35840,2,3,125578,125578,125581,0,3,0
35841,3,2,125581,125581,125583,0,2,0
35842,1,2,125582,125583,125585,1,3,0
35843,3,2,125585,125585,125587,0,2,0
35844,6,2,125591,125591,125593,0,2,4
35845,3,1,125594,125594,125595,0,1,1
35846,4,1,125598,125598,125599,0,1,3
35847,3,3,125601,125601,125604,0,3,2
35848,6,2,125607,125607,125609,0,2,3
35849,5,1,125612,125612,125613,0,1,3
35850,1,2,125613,125613,125615,0,2,0
35851,3,1,125616,125616,125617,0,1,1
35852,5,2,125621,125621,125623,0,2,4
35853,3,2,125624,125624,125626,0,2,1
35854,4,3,125628,125628,125631,0,3,2
35855,5,2,125633,125633,125635,0,2,2
35856,4,3,125637,125637,125640,0,3,2
35857,4,1,125641,125641,125642,0,1,1
35858,1,2,125642,125642,125644,0,2,0
35859,6,2,125648,125648,125650,0,2,4
35860,1,3,125649,125650,125653,1,4,0
35861,1,3,125650,125653,125656,3,6,0
35862,2,2,125652,125656,125658,4,6,0
35863,5,2,125657,125658,125660,1,3,0
35864,1,1,125658,125660,125661,2,3,0
35865,1,2,125659,125661,125663,2,4,0
35866,1,2,125660,125663,125665,3,5,0
35867,2,1,125662,125665,125666,3,4,0
35868,5,3,125667,125667,125670,0,3,1
35869,6,2,125673,125673,125675,0,2,3
35870,5,3,125678,125678,125681,0,3,3
35871,1,1,125679,125681,125682,2,3,0
35872,6,2,125685,125685,125687,0,2,3
35873,3,2,125688,125688,125690,0,2,1
35874,1,1,125689,125690,125691,1,2,0
35875,2,2,125691,125691,125693,0,2,0
35876,6,2,125697,125697,125699,0,2,4
35877,1,1,125698,125699,125700,1,2,0
35878,4,1,125702,125702,125703,0,1,2
35879,1,3,125703,125703,125706,0,3,0
35880,5,2,125708,125708,125710,0,2,2
35881,4,3,125712,125712,125715,0,3,2
35882,1,2,125713,125715,125717,2,4,0
35883,5,1,125718,125718,125719,0,1,1
35884,6,3,125724,125724,125727,0,3,5
35885,1,1,125725,125727,125728,2,3,0
35886,5,3,125730,125730,125733,0,3,2
35887,2,3,125732,125733,125736,1,4,0
35888,2,1,125734,125736,125737,2,3,0
35889,2,1,125736,125737,125738,1,2,0
35890,1,3,125737,125738,125741,1,4,0
35891,5,3,125742,125742,125745,0,3,1
35892,6,2,125748,125748,125750,0,2,3
35893,6,2,125754,125754,125756,0,2,4
35894,2,2,125756,125756,125758,0,2,0
35895,2,3,125758,125758,125761,0,3,0
35896,3,3,125761,125761,125764,0,3,0
35897,1,2,125762,125764,125766,2,4,0
35898,2,1,125764,125766,125767,2,3,0
35899,1,3,125765,125767,125770,2,5,0
35900,1,1,125766,125770,125771,4,5,0
35901,1,3,125767,125771,125774,4,7,0
35902,4,1,125771,125774,125775,3,4,0
35903,6,3,125777,125777,125780,0,3,2
35904,2,2,125779,125780,125782,1,3,0
35905,5,3,125784,125784,125787,0,3,2
35906,3,1,125787,125787,125788,0,1,0
35907,5,2,125792,125792,125794,0,2,4
35908,2,3,125794,125794,125797,0,3,0
35909,5,3,125799,125799,125802,0,3,2
35910,1,2,125800,125802,125804,2,4,0
35911,4,1,125804,125804,125805,0,1,0
35912,2,2,125806,125806,125808,0,2,1
35913,3,3,125809,125809,125812,0,3,1
35914,6,3,125815,125815,125818,0,3,3
35915,1,1,125816,125818,125819,2,3,0
35916,2,3,125818,125819,125822,1,4,0
35917,3,1,125821,125822,125823,1,2,0
35918,5,3,125826,125826,125829,0,3,3
35919,2,2,125828,125829,125831,1,3,0
35920,3,2,125831,125831,125833,0,2,0
35921,1,1,125832,125833,125834,1,2,0
35922,6,2,125838,125838,125840,0,2,4
35923,4,1,125842,125842,125843,0,1,2
35924,4,2,125846,125846,125848,0,2,3
35925,3,2,125849,125849,125851,0,2,1
35926,5,1,125854,125854,125855,0,1,3
35927,2,1,125856,125856,125857,0,1,1
35928,1,1,125857,125857,125858,0,1,0
35929,2,2,125859,125859,125861,0,2,1
35930,3,1,125862,125862,125863,0,1,1
35931,2,3,125864,125864,125867,0,3,1
35932,6,1,125870,125870,125871,0,1,3
35933,2,1,125872,125872,125873,0,1,1
35934,3,1,125875,125875,125876,0,1,2
35935,4,3,125879,125879,125882,0,3,3
35936,1,2,125880,125882,125884,2,4,0
35937,2,2,125882,125884,125886,2,4,0
35938,1,3,125883,125886,125889,3,6,0
35939,2,3,125885,125889,125892,4,7,0
35940,5,2,125890,125892,125894,2,4,0
35941,3,1,125893,125894,125895,1,2,0
35942,4,3,125897,125897,125900,0,3,2
35943,3,1,125900,125900,125901,0,1,0
35944,3,1,125903,125903,125904,0,1,2
35945,5,1,125908,125908,125909,0,1,4
35946,4,1,125912,125912,125913,0,1,3
35947,5,1,125917,125917,125918,0,1,4
35948,4,1,125921,125921,125922,0,1,3
35949,3,3,125924,125924,125927,0,3,2
35950,3,3,125927,125927,125930,0,3,0
35951,5,2,125932,125932,125934,0,2,2
35952,4,3,125936,125936,125939,0,3,2
35953,6,2,125942,125942,125944,0,2,3
35954,3,3,125945,125945,125948,0,3,1
35955,6,1,125951,125951,125952,0,1,3
35956,6,2,125957,125957,125959,0,2,5
35957,4,1,125961,125961,125962,0,1,2
35958,6,2,125967,125967,125969,0,2,5
35959,6,2,125973,125973,125975,0,2,4
35960,3,2,125976,125976,125978,0,2,1
35961,1,1,125977,125978,125979,1,2,0
35962,6,3,125983,125983,125986,0,3,4
35963,6,1,125989,125989,125990,0,1,3
35964,1,2,125990,125990,125992,0,2,0
35965,2,3,125992,125992,125995,0,3,0
35966,5,2,125997,125997,125999,0,2,2
35967,1,2,125998,125999,126001,1,3,0
35968,4,2,126002,126002,126004,0,2,1
35969,5,2,126007,126007,126009,0,2,3
35970,2,3,126009,126009,126012,0,3,0
35971,4,3,126013,126013,126016,0,3,1
35972,2,2,126015,126016,126018,1,3,0
35973,3,1,126018,126018,126019,0,1,0
35974,5,2,126023,126023,126025,0,2,4
35975,4,3,126027,126027,126030,0,3,2
35976,2,3,126029,126030,126033,1,4,0
35977,3,1,126032,126033,126034,1,2,0
35978,3,2,126035,126035,126037,0,2,1
35979,5,2,126040,126040,126042,0,2,3
35980,2,3,126042,126042,126045,0,3,0
35981,1,3,126043,126045,126048,2,5,0
35982,4,2,126047,126048,126050,1,3,0
35983,4,2,126051,126051,126053,0,2,1
35984,5,3,126056,126056,126059,0,3,3
35985,1,2,126057,126059,126061,2,4,0
35986,3,3,126060,126061,126064,1,4,0
35987,2,1,126062,126064,126065,2,3,0
35988,6,3,126068,126068,126071,0,3,3
35989,2,1,126070,126071,126072,1,2,0
35990,1,1,126071,126072,126073,1,2,0
35991,4,1,126075,126075,126076,0,1,2
35992,6,3,126081,126081,126084,0,3,5
35993,3,1,126084,126084,126085,0,1,0
35994,6,3,126090,126090,126093,0,3,5
35995,3,3,126093,126093,126096,0,3,0
35996,2,1,126095,126096,126097,1,2,0
35997,2,1,126097,126097,126098,0,1,0
35998,2,2,126099,126099,126101,0,2,1
35999,1,2,126100,126101,126103,1,3,0
36000,3,1,126103,126103,126104,0,1,0
36001,4,2,126107,126107,126109,0,2,3
36002,3,3,126110,126110,126113,0,3,1
36003,3,1,126113,126113,126114,0,1,0
36004,4,3,126117,126117,126120,0,3,3
36005,4,3,126121,126121,126124,0,3,1
36006,1,1,126122,126124,126125,2,3,0
36007,5,3,126127,126127,126130,0,3,2
36008,5,3,126132,126132,126135,0,3,2
36009,5,1,126137,126137,126138,0,1,2
36010,4,2,126141,126141,126143,0,2,3
36011,2,1,126143,126143,126144,0,1,0
36012,2,1,126145,126145,126146,0,1,1
36013,5,2,126150,126150,126152,0,2,4
36014,5,3,126155,126155,126158,0,3,3
36015,3,2,126158,126158,126160,0,2,0
36016,1,1,126159,126160,126161,1,2,0
36017,5,1,126164,126164,126165,0,1,3
36018,5,2,126169,126169,126171,0,2,4
36019,6,1,126175,126175,126176,0,1,4
36020,6,3,126181,126181,126184,0,3,5
36021,3,3,126184,126184,126187,0,3,0
36022,3,1,126187,126187,126188,0,1,0
36023,5,3,126192,126192,126195,0,3,4
36024,5,2,126197,126197,126199,0,2,2
36025,1,2,126198,126199,126201,1,3,0
36026,2,2,126200,126201,126203,1,3,0
36027,4,2,126204,126204,126206,0,2,1
36028,2,3,126206,126206,126209,0,3,0
36029,4,2,126210,126210,126212,0,2,1
36030,4,1,126214,126214,126215,0,1,2
36031,1,2,126215,126215,126217,0,2,0
36032,5,3,126220,126220,126223,0,3,3
36033,2,2,126222,126223,126225,1,3,0
36034,2,1,126224,126225,126226,1,2,0
36035,5,3,126229,126229,126232,0,3,3
36036,3,2,126232,126232,126234,0,2,0
36037,5,1,126237,126237,126238,0,1,3
36038,4,1,126241,126241,126242,0,1,3
36039,5,3,126246,126246,126249,0,3,4
36040,2,2,126248,126249,126251,1,3,0
36041,1,3,126249,126251,126254,2,5,0
36042,1,2,126250,126254,126256,4,6,0
36043,2,1,126252,126256,126257,4,5,0
36044,5,3,126257,126257,126260,0,3,0
36045,6,2,126263,126263,126265,0,2,3
36046,4,1,126267,126267,126268,0,1,2
36047,1,1,126268,126268,126269,0,1,0
36048,2,3,126270,126270,126273,0,3,1
36049,3,3,126273,126273,126276,0,3,0
36050,3,2,126276,126276,126278,0,2,0
36051,5,1,126281,126281,126282,0,1,3
36052,1,1,126282,126282,126283,0,1,0
36053,3,2,126285,126285,126287,0,2,2
36054,2,1,126287,126287,126288,0,1,0
36055,5,3,126292,126292,126295,0,3,4
36056,4,1,126296,126296,126297,0,1,1
36057,5,1,126301,126301,126302,0,1,4
36058,2,1,126303,126303,126304,0,1,1
36059,3,3,126306,126306,126309,0,3,2
36060,6,3,126312,126312,126315,0,3,3
36061,5,1,126317,126317,126318,0,1,2
36062,1,3,126318,126318,126321,0,3,0
36063,1,3,126319,126321,126324,2,5,0
36064,2,2,126321,126324,126326,3,5,0
36065,1,3,126322,126326,126329,4,7,0
36066,3,2,126325,126329,126331,4,6,0
36067,3,1,126328,126331,126332,3,4,0
36068,3,3,126331,126332,126335,1,4,0
36069,2,3,126333,126335,126338,2,5,0
36070,2,2,126335,126338,126340,3,5,0
36071,3,1,126338,126340,126341,2,3,0
36072,4,3,126342,126342,126345,0,3,1
36073,4,2,126346,126346,126348,0,2,1
36074,1,2,126347,126348,126350,1,3,0
36075,1,2,126348,126350,126352,2,4,0
36076,5,1,126353,126353,126354,0,1,1
36077,6,3,126359,126359,126362,0,3,5
36078,3,2,126362,126362,126364,0,2,0
36079,5,3,126367,126367,126370,0,3,3
36080,6,2,126373,126373,126375,0,2,3
36081,2,2,126375,126375,126377,0,2,0
36082,3,3,126378,126378,126381,0,3,1
36083,4,3,126382,126382,126385,0,3,1
36084,6,1,126388,126388,126389,0,1,3
36085,5,2,126393,126393,126395,0,2,4
36086,5,2,126398,126398,126400,0,2,3
36087,4,2,126402,126402,126404,0,2,2
36088,5,1,126407,126407,126408,0,1,3
36089,3,2,126410,126410,126412,0,2,2
36090,4,3,126414,126414,126417,0,3,2
36091,5,1,126419,126419,126420,0,1,2
36092,5,3,126424,126424,126427,0,3,4
36093,6,3,126430,126430,126433,0,3,3
36094,4,2,126434,126434,126436,0,2,1
36095,1,2,126435,126436,126438,1,3,0
36096,4,1,126439,126439,126440,0,1,1
36097,4,3,126443,126443,126446,0,3,3
36098,3,2,126446,126446,126448,0,2,0
36099,3,2,126449,126449,126451,0,2,1
36100,5,2,126454,126454,126456,0,2,3
36101,2,3,126456,126456,126459,0,3,0
36102,6,2,126462,126462,126464,0,2,3
36103,5,3,126467,126467,126470,0,3,3
36104,3,1,126470,126470,126471,0,1,0
36105,3,3,126473,126473,126476,0,3,2
36106,6,3,126479,126479,126482,0,3,3
36107,2,2,126481,126482,126484,1,3,0
36108,1,2,126482,126484,126486,2,4,0
36109,5,2,126487,126487,126489,0,2,1
36110,6,3,126493,126493,126496,0,3,4
36111,3,3,126496,126496,126499,0,3,0
36112,6,3,126502,126502,126505,0,3,3
36113,1,3,126503,126505,126508,2,5,0
36114,5,3,126508,126508,126511,0,3,0
36115,1,2,126509,126511,126513,2,4,0
36116,3,2,126512,126513,126515,1,3,0
36117,4,2,126516,126516,126518,0,2,1
36118,6,1,126522,126522,126523,0,1,4
36119,1,1,126523,126523,126524,0,1,0
36120,2,3,126525,126525,126528,0,3,1
36121,5,1,126530,126530,126531,0,1,2
36122,2,2,126532,126532,126534,0,2,1
36123,1,3,126533,126534,126537,1,4,0
36124,2,1,126535,126537,126538,2,3,0
36125,3,1,126538,126538,126539,0,1,0
36126,6,1,126544,126544,126545,0,1,5
36127,3,1,126547,126547,126548,0,1,2
36128,1,3,126548,126548,126551,0,3,0
36129,1,1,126549,126551,126552,2,3,0
36130,3,2,126552,126552,126554,0,2,0
36131,4,2,126556,126556,126558,0,2,2
36132,2,3,126558,126558,126561,0,3,0
36133,3,2,126561,126561,126563,0,2,0
36134,6,2,126567,126567,126569,0,2,4
36135,3,2,126570,126570,126572,0,2,1
36136,3,2,126573,126573,126575,0,2,1
36137,6,1,126579,126579,126580,0,1,4
36138,1,2,126580,126580,126582,0,2,0
36139,5,1,126585,126585,126586,0,1,3
36140,1,1,126586,126586,126587,0,1,0
36141,2,1,126588,126588,126589,0,1,1
36142,5,2,126593,126593,126595,0,2,4
36143,6,3,126599,126599,126602,0,3,4
36144,6,3,126605,126605,126608,0,3,3
36145,3,1,126608,126608,126609,0,1,0
36146,6,1,126614,126614,126615,0,1,5
36147,1,3,126615,126615,126618,0,3,0
36148,4,3,126619,126619,126622,0,3,1
36149,1,3,126620,126622,126625,2,5,0
36150,1,2,126621,126625,126627,4,6,0
36151,3,2,126624,126627,126629,3,5,0
36152,2,2,126626,126629,126631,3,5,0
36153,2,3,126628,126631,126634,3,6,0
36154,2,1,126630,126634,126635,4,5,0
36155,1,3,126631,126635,126638,4,7,0
36156,2,1,126633,126638,126639,5,6,0
36157,1,3,126634,126639,126642,5,8,0
36158,5,1,126639,126642,126643,3,4,0
36159,4,1,126643,126643,126644,0,1,0
36160,3,1,126646,126646,126647,0,1,2
36161,3,3,126649,126649,126652,0,3,2
36162,1,2,126650,126652,126654,2,4,0
36163,2,3,126652,126654,126657,2,5,0
36164,1,3,126653,126657,126660,4,7,0
36165,6,2,126659,126660,126662,1,3,0
36166,1,3,126660,126662,126665,2,5,0
36167,1,2,126661,126665,126667,4,6,0
36168,2,1,126663,126667,126668,4,5,0
36169,3,1,126666,126668,126669,2,3,0
36170,1,3,126667,126669,126672,2,5,0
36171,3,3,126670,126672,126675,2,5,0
36172,1,2,126671,126675,126677,4,6,0
36173,6,1,126677,126677,126678,0,1,0
36174,6,3,126683,126683,126686,0,3,5
36175,3,2,126686,126686,126688,0,2,0
36176,5,1,126691,126691,126692,0,1,3
36177,2,3,126693,126693,126696,0,3,1
36178,2,1,126695,126696,126697,1,2,0
36179,2,1,126697,126697,126698,0,1,0
36180,5,3,126702,126702,126705,0,3,4
36181,6,3,126708,126708,126711,0,3,3
36182,6,3,126714,126714,126717,0,3,3
36183,6,1,126720,126720,126721,0,1,3
36184,6,1,126726,126726,126727,0,1,5
36185,5,3,126731,126731,126734,0,3,4
36186,2,3,126733,126734,126737,1,4,0
36187,3,3,126736,126737,126740,1,4,0
36188,6,3,126742,126742,126745,0,3,2
36189,2,1,126744,126745,126746,1,2,0
36190,3,1,126747,126747,126748,0,1,1
36191,3,2,126750,126750,126752,0,2,2
36192,6,1,126756,126756,126757,0,1,4
36193,1,1,126757,126757,126758,0,1,0
36194,6,2,126763,126763,126765,0,2,5
36195,2,2,126765,126765,126767,0,2,0
36196,1,2,126766,126767,126769,1,3,0
36197,6,2,126772,126772,126774,0,2,3
36198,5,2,126777,126777,126779,0,2,3
36199,3,1,126780,126780,126781,0,1,1
36200,3,3,126783,126783,126786,0,3,2
36201,5,2,126788,126788,126790,0,2,2
36202,3,1,126791,126791,126792,0,1,1
36203,6,3,126797,126797,126800,0,3,5
36204,2,1,126799,126800,126801,1,2,0
36205,3,3,126802,126802,126805,0,3,1
36206,4,1,126806,126806,126807,0,1,1
36207,6,1,126812,126812,126813,0,1,5
36208,4,3,126816,126816,126819,0,3,3
36209,1,2,126817,126819,126821,2,4,0
36210,2,2,126819,126821,126823,2,4,0
36211,6,1,126825,126825,126826,0,1,2
36212,6,2,126831,126831,126833,0,2,5
36213,5,2,126836,126836,126838,0,2,3
36214,6,3,126842,126842,126845,0,3,4
36215,6,2,126848,126848,126850,0,2,3
36216,6,1,126854,126854,126855,0,1,4
36217,1,1,126855,126855,126856,0,1,0
36218,4,2,126859,126859,126861,0,2,3
36219,1,2,126860,126861,126863,1,3,0
36220,1,3,126861,126863,126866,2,5,0
36221,6,2,126867,126867,126869,0,2,1
36222,2,3,126869,126869,126872,0,3,0
36223,1,3,126870,126872,126875,2,5,0
36224,1,3,126871,126875,126878,4,7,0
36225,3,3,126874,126878,126881,4,7,0
36226,1,3,126875,126881,126884,6,9,0
36227,3,2,126878,126884,126886,6,8,0
36228,2,2,126880,126886,126888,6,8,0
36229,2,1,126882,126888,126889,6,7,0
36230,6,1,126888,126889,126890,1,2,0
36231,3,3,126891,126891,126894,0,3,1
36232,4,1,126895,126895,126896,0,1,1
36233,3,2,126898,126898,126900,0,2,2
36234,1,3,126899,126900,126903,1,4,0
36235,4,3,126903,126903,126906,0,3,0
36236,3,2,126906,126906,126908,0,2,0
36237,2,3,126908,126908,126911,0,3,0
36238,4,2,126912,126912,126914,0,2,1
36239,4,1,126916,126916,126917,0,1,2
36240,5,1,126921,126921,126922,0,1,4
36241,1,2,126922,126922,126924,0,2,0
36242,1,3,126923,126924,126927,1,4,0
36243,3,2,126926,126927,126929,1,3,0
36244,4,1,126930,126930,126931,0,1,1
36245,2,1,126932,126932,126933,0,1,1
36246,4,2,126936,126936,126938,0,2,3
36247,4,3,126940,126940,126943,0,3,2
36248,1,1,126941,126943,126944,2,3,0
36249,5,2,126946,126946,126948,0,2,2
36250,6,2,126952,126952,126954,0,2,4
36251,3,2,126955,126955,126957,0,2,1
36252,2,2,126957,126957,126959,0,2,0
36253,6,3,126963,126963,126966,0,3,4
36254,4,3,126967,126967,126970,0,3,1
36255,3,3,126970,126970,126973,0,3,0
36256,6,1,126976,126976,126977,0,1,3
36257,1,1,126977,126977,126978,0,1,0
36258,4,2,126981,126981,126983,0,2,3
36259,3,1,126984,126984,126985,0,1,1
36260,1,2,126985,126985,126987,0,2,0
36261,3,1,126988,126988,126989,0,1,1
36262,2,3,126990,126990,126993,0,3,1
36263,3,2,126993,126993,126995,0,2,0
36264,3,1,126996,126996,126997,0,1,1
36265,1,1,126997,126997,126998,0,1,0
36266,3,2,127000,127000,127002,0,2,2
36267,6,1,127006,127006,127007,0,1,4
36268,6,1,127012,127012,127013,0,1,5
36269,6,3,127018,127018,127021,0,3,5
36270,2,2,127020,127021,127023,1,3,0
36271,5,3,127025,127025,127028,0,3,2
36272,1,1,127026,127028,127029,2,3,0
36273,5,1,127031,127031,127032,0,1,2
36274,5,1,127036,127036,127037,0,1,4
36275,3,3,127039,127039,127042,0,3,2
36276,4,3,127043,127043,127046,0,3,1
36277,5,2,127048,127048,127050,0,2,2
36278,4,2,127052,127052,127054,0,2,2
36279,2,1,127054,127054,127055,0,1,0
36280,2,3,127056,127056,127059,0,3,1
36281,2,3,127058,127059,127062,1,4,0
36282,1,3,127059,127062,127065,3,6,0
36283,4,2,127063,127065,127067,2,4,0
36284,5,1,127068,127068,127069,0,1,1
36285,5,2,127073,127073,127075,0,2,4
36286,2,2,127075,127075,127077,0,2,0
36287,6,2,127081,127081,127083,0,2,4
36288,6,3,127087,127087,127090,0,3,4
36289,3,3,127090,127090,127093,0,3,0
36290,6,1,127096,127096,127097,0,1,3
36291,2,3,127098,127098,127101,0,3,1
36292,5,2,127103,127103,127105,0,2,2
36293,6,2,127109,127109,127111,0,2,4
36294,1,3,127110,127111,127114,1,4,0
36295,5,3,127115,127115,127118,0,3,1
36296,4,3,127119,127119,127122,0,3,1
36297,5,3,127124,127124,127127,0,3,2
36298,2,3,127126,127127,127130,1,4,0
36299,3,3,127129,127130,127133,1,4,0
36300,2,3,127131,127133,127136,2,5,0
36301,6,2,127137,127137,127139,0,2,1
36302,3,1,127140,127140,127141,0,1,1
36303,1,3,127141,127141,127144,0,3,0
36304,3,3,127144,127144,127147,0,3,0
36305,6,1,127150,127150,127151,0,1,3
36306,2,1,127152,127152,127153,0,1,1
36307,6,3,127158,127158,127161,0,3,5
36308,2,3,127160,127161,127164,1,4,0
36309,4,2,127164,127164,127166,0,2,0
36310,6,1,127170,127170,127171,0,1,4
36311,3,3,127173,127173,127176,0,3,2
36312,3,2,127176,127176,127178,0,2,0
36313,1,3,127177,127178,127181,1,4,0
36314,6,2,127183,127183,127185,0,2,2
36315,3,3,127186,127186,127189,0,3,1
36316,1,1,127187,127189,127190,2,3,0
36317,3,1,127190,127190,127191,0,1,0
36318,4,1,127194,127194,127195,0,1,3
36319,4,1,127198,127198,127199,0,1,3
36320,6,2,127204,127204,127206,0,2,5
36321,4,1,127208,127208,127209,0,1,2
36322,4,3,127212,127212,127215,0,3,3
36323,6,2,127218,127218,127220,0,2,3
36324,6,1,127224,127224,127225,0,1,4
36325,2,3,127226,127226,127229,0,3,1
36326,2,1,127228,127229,127230,1,2,0
36327,1,1,127229,127230,127231,1,2,0
36328,6,1,127235,127235,127236,0,1,4
36329,3,3,127238,127238,127241,0,3,2
36330,4,1,127242,127242,127243,0,1,1
36331,1,1,127243,127243,127244,0,1,0
36332,4,1,127247,127247,127248,0,1,3
36333,1,3,127248,127248,127251,0,3,0
36334,6,3,127254,127254,127257,0,3,3
36335,6,3,127260,127260,127263,0,3,3
36336,1,2,127261,127263,127265,2,4,0
36337,1,3,127262,127265,127268,3,6,0
36338,6,2,127268,127268,127270,0,2,0
36339,4,1,127272,127272,127273,0,1,2
36340,5,2,127277,127277,127279,0,2,4
36341,2,1,127279,127279,127280,0,1,0
36342,1,3,127280,127280,127283,0,3,0
36343,6,1,127286,127286,127287,0,1,3
36344,1,2,127287,127287,127289,0,2,0
36345,2,2,127289,127289,127291,0,2,0
36346,4,3,127293,127293,127296,0,3,2
36347,1,2,127294,127296,127298,2,4,0
36348,1,3,127295,127298,127301,3,6,0
36349,1,3,127296,127301,127304,5,8,0
36350,1,2,127297,127304,127306,7,9,0
36351,6,2,127303,127306,127308,3,5,0
36352,3,2,127306,127308,127310,2,4,0
36353,2,2,127308,127310,127312,2,4,0
36354,2,2,127310,127312,127314,2,4,0
36355,3,1,127313,127314,127315,1,2,0
36356,2,1,127315,127315,127316,0,1,0
36357,4,1,127319,127319,127320,0,1,3
36358,3,2,127322,127322,127324,0,2,2
36359,6,2,127328,127328,127330,0,2,4
36360,4,3,127332,127332,127335,0,3,2
36361,6,2,127338,127338,127340,0,2,3
36362,5,3,127343,127343,127346,0,3,3
36363,4,1,127347,127347,127348,0,1,1
36364,5,1,127352,127352,127353,0,1,4
36365,1,2,127353,127353,127355,0,2,0
36366,5,2,127358,127358,127360,0,2,3
36367,6,3,127364,127364,127367,0,3,4
36368,4,2,127368,127368,127370,0,2,1
36369,5,1,127373,127373,127374,0,1,3
36370,6,1,127379,127379,127380,0,1,5
36371,4,2,127383,127383,127385,0,2,3
36372,5,1,127388,127388,127389,0,1,3
36373,5,1,127393,127393,127394,0,1,4
36374,3,1,127396,127396,127397,0,1,2
36375,1,2,127397,127397,127399,0,2,0
36376,5,2,127402,127402,127404,0,2,3
36377,5,1,127407,127407,127408,0,1,3
36378,4,3,127411,127411,127414,0,3,3
36379,5,3,127416,127416,127419,0,3,2
36380,4,1,127420,127420,127421,0,1,1
36381,5,1,127425,127425,127426,0,1,4
36382,5,1,127430,127430,127431,0,1,4
36383,3,2,127433,127433,127435,0,2,2
36384,5,1,127438,127438,127439,0,1,3
36385,3,3,127441,127441,127444,0,3,2
36386,6,2,127447,127447,127449,0,2,3
36387,1,1,127448,127449,127450,1,2,0
36388,2,1,127450,127450,127451,0,1,0
36389,6,3,127456,127456,127459,0,3,5
36390,6,2,127462,127462,127464,0,2,3
36391,2,3,127464,127464,127467,0,3,0
36392,2,3,127466,127467,127470,1,4,0
36393,2,1,127468,127470,127471,2,3,0
36394,6,1,127474,127474,127475,0,1,3
36395,1,2,127475,127475,127477,0,2,0
36396,2,3,127477,127477,127480,0,3,0
36397,5,2,127482,127482,127484,0,2,2
36398,4,2,127486,127486,127488,0,2,2
36399,6,2,127492,127492,127494,0,2,4
36400,3,3,127495,127495,127498,0,3,1
36401,1,1,127496,127498,127499,2,3,0
36402,4,1,127500,127500,127501,0,1,1
36403,5,2,127505,127505,127507,0,2,4
36404,2,1,127507,127507,127508,0,1,0
36405,2,2,127509,127509,127511,0,2,1
36406,5,3,127514,127514,127517,0,3,3
36407,1,1,127515,127517,127518,2,3,0
36408,1,1,127516,127518,127519,2,3,0
36409,3,1,127519,127519,127520,0,1,0
36410,1,3,127520,127520,127523,0,3,0
36411,1,2,127521,127523,127525,2,4,0
36412,6,3,127527,127527,127530,0,3,2
36413,3,3,127530,127530,127533,0,3,0
36414,1,3,127531,127533,127536,2,5,0
36415,6,2,127537,127537,127539,0,2,1
36416,3,1,127540,127540,127541,0,1,1
36417,6,1,127546,127546,127547,0,1,5
36418,6,1,127552,127552,127553,0,1,5
36419,1,3,127553,127553,127556,0,3,0
36420,3,2,127556,127556,127558,0,2,0
36421,1,1,127557,127558,127559,1,2,0
36422,1,2,127558,127559,127561,1,3,0
36423,3,1,127561,127561,127562,0,1,0
36424,2,2,127563,127563,127565,0,2,1
36425,1,1,127564,127565,127566,1,2,0
36426,6,1,127570,127570,127571,0,1,4
36427,3,1,127573,127573,127574,0,1,2
36428,2,3,127575,127575,127578,0,3,1
36429,1,3,127576,127578,127581,2,5,0
36430,6,1,127582,127582,127583,0,1,1
36431,3,2,127585,127585,127587,0,2,2
36432,2,2,127587,127587,127589,0,2,0
36433,6,2,127593,127593,127595,0,2,4
36434,1,1,127594,127595,127596,1,2,0
36435,3,3,127597,127597,127600,0,3,1
36436,6,1,127603,127603,127604,0,1,3
36437,2,3,127605,127605,127608,0,3,1
36438,1,3,127606,127608,127611,2,5,0
36439,4,2,127610,127611,127613,1,3,0
36440,3,1,127613,127613,127614,0,1,0
36441,4,2,127617,127617,127619,0,2,3
36442,3,3,127620,127620,127623,0,3,1
36443,2,3,127622,127623,127626,1,4,0
36444,5,3,127627,127627,127630,0,3,1
36445,3,3,127630,127630,127633,0,3,0
36446,5,3,127635,127635,127638,0,3,2
36447,1,3,127636,127638,127641,2,5,0
36448,1,3,127637,127641,127644,4,7,0
36449,2,3,127639,127644,127647,5,8,0
36450,3,2,127642,127647,127649,5,7,0
36451,1,1,127643,127649,127650,6,7,0
36452,3,3,127646,127650,127653,4,7,0
36453,2,3,127648,127653,127656,5,8,0
36454,6,2,127654,127656,127658,2,4,0
36455,5,2,127659,127659,127661,0,2,1
36456,5,2,127664,127664,127666,0,2,3
36457,6,3,127670,127670,127673,0,3,4
36458,1,3,127671,127673,127676,2,5,0
36459,2,3,127673,127676,127679,3,6,0
36460,4,3,127677,127679,127682,2,5,0
36461,1,2,127678,127682,127684,4,6,0
36462,3,2,127681,127684,127686,3,5,0
36463,5,2,127686,127686,127688,0,2,0
36464,5,3,127691,127691,127694,0,3,3
36465,2,1,127693,127694,127695,1,2,0
36466,2,2,127695,127695,127697,0,2,0
36467,5,3,127700,127700,127703,0,3,3
36468,1,3,127701,127703,127706,2,5,0
36469,6,2,127707,127707,127709,0,2,1
36470,3,2,127710,127710,127712,0,2,1
36471,5,3,127715,127715,127718,0,3,3
36472,5,1,127720,127720,127721,0,1,2
36473,3,1,127723,127723,127724,0,1,2
36474,6,1,127729,127729,127730,0,1,5
36475,6,2,127735,127735,127737,0,2,5
36476,4,2,127739,127739,127741,0,2,2
36477,5,2,127744,127744,127746,0,2,3
36478,1,2,127745,127746,127748,1,3,0
36479,2,2,127747,127748,127750,1,3,0
36480,5,1,127752,127752,127753,0,1,2
36481,6,1,127758,127758,127759,0,1,5
36482,4,3,127762,127762,127765,0,3,3
36483,4,3,127766,127766,127769,0,3,1
36484,6,2,127772,127772,127774,0,2,3
36485,4,1,127776,127776,127777,0,1,2
36486,6,1,127782,127782,127783,0,1,5
36487,4,3,127786,127786,127789,0,3,3
36488,1,3,127787,127789,127792,2,5,0
36489,2,1,127789,127792,127793,3,4,0
36490,2,2,127791,127793,127795,2,4,0
36491,1,2,127792,127795,127797,3,5,0
36492,2,3,127794,127797,127800,3,6,0
36493,6,2,127800,127800,127802,0,2,0
36494,6,1,127806,127806,127807,0,1,4
36495,6,2,127812,127812,127814,0,2,5
36496,1,3,127813,127814,127817,1,4,0
36497,2,1,127815,127817,127818,2,3,0
36498,1,2,127816,127818,127820,2,4,0
36499,3,2,127819,127820,127822,1,3,0
36500,6,2,127825,127825,127827,0,2,3
36501,4,3,127829,127829,127832,0,3,2
36502,1,3,127830,127832,127835,2,5,0
36503,5,1,127835,127835,127836,0,1,0
36504,4,1,127839,127839,127840,0,1,3
36505,4,3,127843,127843,127846,0,3,3
36506,5,2,127848,127848,127850,0,2,2
36507,4,1,127852,127852,127853,0,1,2
36508,2,2,127854,127854,127856,0,2,1
36509,4,1,127858,127858,127859,0,1,2
36510,3,3,127861,127861,127864,0,3,2
36511,1,3,127862,127864,127867,2,5,0
36512,6,3,127868,127868,127871,0,3,1
36513,6,2,127874,127874,127876,0,2,3
36514,4,3,127878,127878,127881,0,3,2
36515,2,1,127880,127881,127882,1,2,0
36516,4,3,127884,127884,127887,0,3,2
36517,6,3,127890,127890,127893,0,3,3
36518,5,1,127895,127895,127896,0,1,2
36519,1,1,127896,127896,127897,0,1,0
36520,6,1,127902,127902,127903,0,1,5
36521,1,1,127903,127903,127904,0,1,0
36522,2,2,127905,127905,127907,0,2,1
36523,1,3,127906,127907,127910,1,4,0
36524,3,2,127909,127910,127912,1,3,0
36525,2,1,127911,127912,127913,1,2,0
36526,3,2,127914,127914,127916,0,2,1
36527,6,2,127920,127920,127922,0,2,4
36528,1,3,127921,127922,127925,1,4,0
36529,6,1,127927,127927,127928,0,1,2
36530,2,1,127929,127929,127930,0,1,1
36531,3,1,127932,127932,127933,0,1,2
36532,6,1,127938,127938,127939,0,1,5
36533,4,1,127942,127942,127943,0,1,3
36534,1,2,127943,127943,127945,0,2,0
36535,1,2,127944,127945,127947,1,3,0
36536,3,2,127947,127947,127949,0,2,0
36537,1,2,127948,127949,127951,1,3,0
36538,6,3,127954,127954,127957,0,3,3
36539,2,2,127956,127957,127959,1,3,0
36540,4,3,127960,127960,127963,0,3,1
36541,6,2,127966,127966,127968,0,2,3
36542,2,3,127968,127968,127971,0,3,0
36543,1,2,127969,127971,127973,2,4,0
36544,3,2,127972,127973,127975,1,3,0
36545,4,3,127976,127976,127979,0,3,1
36546,4,1,127980,127980,127981,0,1,1
36547,1,2,127981,127981,127983,0,2,0
36548,2,2,127983,127983,127985,0,2,0
36549,1,1,127984,127985,127986,1,2,0
36550,6,2,127990,127990,127992,0,2,4
36551,3,1,127993,127993,127994,0,1,1
36552,4,1,127997,127997,127998,0,1,3
36553,2,3,127999,127999,128002,0,3,1
36554,4,1,128003,128003,128004,0,1,1
36555,4,3,128007,128007,128010,0,3,3
36556,4,2,128011,128011,128013,0,2,1
36557,2,2,128013,128013,128015,0,2,0
36558,1,1,128014,128015,128016,1,2,0
36559,1,3,128015,128016,128019,1,4,0
36560,5,3,128020,128020,128023,0,3,1
36561,6,3,128026,128026,128029,0,3,3
36562,1,2,128027,128029,128031,2,4,0
36563,4,3,128031,128031,128034,0,3,0
36564,3,1,128034,128034,128035,0,1,0
36565,3,2,128037,128037,128039,0,2,2
36566,2,2,128039,128039,128041,0,2,0
36567,1,1,128040,128041,128042,1,2,0
36568,5,1,128045,128045,128046,0,1,3
36569,3,2,128048,128048,128050,0,2,2
36570,1,1,128049,128050,128051,1,2,0
36571,1,2,128050,128051,128053,1,3,0
36572,1,1,128051,128053,128054,2,3,0
36573,2,2,128053,128054,128056,1,3,0
36574,3,3,128056,128056,128059,0,3,0
36575,5,3,128061,128061,128064,0,3,2
36576,2,2,128063,128064,128066,1,3,0
36577,4,1,128067,128067,128068,0,1,1
36578,4,2,128071,128071,128073,0,2,3
36579,6,3,128077,128077,128080,0,3,4
36580,5,2,128082,128082,128084,0,2,2
36581,2,3,128084,128084,128087,0,3,0
36582,5,3,128089,128089,128092,0,3,2
36583,5,1,128094,128094,128095,0,1,2
36584,6,1,128100,128100,128101,0,1,5
36585,3,2,128103,128103,128105,0,2,2
36586,3,1,128106,128106,128107,0,1,1
36587,3,3,128109,128109,128112,0,3,2
36588,1,3,128110,128112,128115,2,5,0
36589,5,3,128115,128115,128118,0,3,0
36590,5,3,128120,128120,128123,0,3,2
36591,1,2,128121,128123,128125,2,4,0
36592,1,1,128122,128125,128126,3,4,0
36593,3,1,128125,128126,128127,1,2,0
36594,1,2,128126,128127,128129,1,3,0
36595,1,1,128127,128129,128130,2,3,0
36596,2,2,128129,128130,128132,1,3,0
36597,1,3,128130,128132,128135,2,5,0
36598,2,1,128132,128135,128136,3,4,0
36599,5,2,128137,128137,128139,0,2,1
36600,3,2,128140,128140,128142,0,2,1
36601,4,3,128144,128144,128147,0,3,2
36602,5,3,128149,128149,128152,0,3,2
36603,4,2,128153,128153,128155,0,2,1
36604,6,3,128159,128159,128162,0,3,4
36605,2,1,128161,128162,128163,1,2,0
36606,1,1,128162,128163,128164,1,2,0
36607,3,2,128165,128165,128167,0,2,1
36608,2,3,128167,128167,128170,0,3,0
36609,4,1,128171,128171,128172,0,1,1
36610,6,3,128177,128177,128180,0,3,5
36611,4,2,128181,128181,128183,0,2,1
36612,2,1,128183,128183,128184,0,1,0
36613,3,1,128186,128186,128187,0,1,2
36614,3,3,128189,128189,128192,0,3,2
36615,2,3,128191,128192,128195,1,4,0
36616,4,2,128195,128195,128197,0,2,0
36617,5,2,128200,128200,128202,0,2,3
36618,3,3,128203,128203,128206,0,3,1
36619,2,1,128205,128206,128207,1,2,0
36620,4,3,128209,128209,128212,0,3,2
36621,6,2,128215,128215,128217,0,2,3
36622,4,1,128219,128219,128220,0,1,2
36623,4,3,128223,128223,128226,0,3,3
36624,1,3,128224,128226,128229,2,5,0
36625,1,3,128225,128229,128232,4,7,0
36626,6,2,128231,128232,128234,1,3,0
36627,1,1,128232,128234,128235,2,3,0
36628,3,1,128235,128235,128236,0,1,0
36629,4,3,128239,128239,128242,0,3,3
36630,1,3,128240,128242,128245,2,5,0
36631,3,3,128243,128245,128248,2,5,0
36632,1,2,128244,128248,128250,4,6,0
36633,6,3,128250,128250,128253,0,3,0
36634,6,3,128256,128256,128259,0,3,3
36635,4,3,128260,128260,128263,0,3,1
36636,3,2,128263,128263,128265,0,2,0
36637,6,3,128269,128269,128272,0,3,4
36638,6,2,128275,128275,128277,0,2,3
36639,4,2,128279,128279,128281,0,2,2
36640,1,3,128280,128281,128284,1,4,0
36641,3,2,128283,128284,128286,1,3,0
36642,3,2,128286,128286,128288,0,2,0
36643,3,2,128289,128289,128291,0,2,1
36644,3,2,128292,128292,128294,0,2,1
36645,1,2,128293,128294,128296,1,3,0
36646,1,2,128294,128296,128298,2,4,0
36647,1,2,128295,128298,128300,3,5,0
36648,6,3,128301,128301,128304,0,3,1
36649,1,1,128302,128304,128305,2,3,0
36650,6,2,128308,128308,128310,0,2,3
36651,6,3,128314,128314,128317,0,3,4
36652,5,2,128319,128319,128321,0,2,2
36653,4,3,128323,128323,128326,0,3,2
36654,5,3,128328,128328,128331,0,3,2
36655,2,1,128330,128331,128332,1,2,0
36656,5,1,128335,128335,128336,0,1,3
36657,5,3,128340,128340,128343,0,3,4
36658,1,3,128341,128343,128346,2,5,0
36659,5,2,128346,128346,128348,0,2,0
36660,2,1,128348,128348,128349,0,1,0
36661,6,1,128354,128354,128355,0,1,5
36662,3,1,128357,128357,128358,0,1,2
36663,3,3,128360,128360,128363,0,3,2
36664,3,3,128363,128363,128366,0,3,0
36665,3,1,128366,128366,128367,0,1,0
36666,6,3,128372,128372,128375,0,3,5
36667,6,2,128378,128378,128380,0,2,3
36668,1,3,128379,128380,128383,1,4,0
36669,4,1,128383,128383,128384,0,1,0
36670,2,2,128385,128385,128387,0,2,1
36671,1,3,128386,128387,128390,1,4,0
36672,4,3,128390,128390,128393,0,3,0
36673,5,2,128395,128395,128397,0,2,2
36674,3,2,128398,128398,128400,0,2,1
36675,6,2,128404,128404,128406,0,2,4
36676,6,3,128410,128410,128413,0,3,4
36677,3,2,128413,128413,128415,0,2,0
36678,6,3,128419,128419,128422,0,3,4
36679,4,1,128423,128423,128424,0,1,1
36680,4,3,128427,128427,128430,0,3,3
36681,6,2,128433,128433,128435,0,2,3
36682,5,3,128438,128438,128441,0,3,3
36683,3,3,128441,128441,128444,0,3,0
36684,4,3,128445,128445,128448,0,3,1
36685,5,2,128450,128450,128452,0,2,2
36686,5,2,128455,128455,128457,0,2,3
36687,6,3,128461,128461,128464,0,3,4
36688,2,2,128463,128464,128466,1,3,0
36689,6,1,128469,128469,128470,0,1,3
36690,2,1,128471,128471,128472,0,1,1
36691,4,2,128475,128475,128477,0,2,3
36692,1,2,128476,128477,128479,1,3,0
36693,2,1,128478,128479,128480,1,2,0
36694,4,1,128482,128482,128483,0,1,2
36695,4,3,128486,128486,128489,0,3,3
36696,6,3,128492,128492,128495,0,3,3
36697,3,1,128495,128495,128496,0,1,0
36698,4,1,128499,128499,128500,0,1,3
36699,1,1,128500,128500,128501,0,1,0
36700,5,1,128505,128505,128506,0,1,4
36701,6,1,128511,128511,128512,0,1,5
36702,6,1,128517,128517,128518,0,1,5
36703,4,3,128521,128521,128524,0,3,3
36704,2,2,128523,128524,128526,1,3,0
36705,4,2,128527,128527,128529,0,2,1
36706,6,2,128533,128533,128535,0,2,4
36707,4,3,128537,128537,128540,0,3,2
36708,5,2,128542,128542,128544,0,2,2
36709,3,3,128545,128545,128548,0,3,1
36710,1,2,128546,128548,128550,2,4,0
36711,2,3,128548,128550,128553,2,5,0
36712,3,3,128551,128553,128556,2,5,0
36713,3,2,128554,128556,128558,2,4,0
36714,6,3,128560,128560,128563,0,3,2
36715,2,3,128562,128563,128566,1,4,0
36716,1,2,128563,128566,128568,3,5,0
36717,4,1,128567,128568,128569,1,2,0
36718,2,1,128569,128569,128570,0,1,0
36719,5,2,128574,128574,128576,0,2,4
36720,2,2,128576,128576,128578,0,2,0
36721,1,1,128577,128578,128579,1,2,0
36722,4,3,128581,128581,128584,0,3,2
36723,4,3,128585,128585,128588,0,3,1
36724,1,1,128586,128588,128589,2,3,0
36725,2,2,128588,128589,128591,1,3,0
36726,6,3,128594,128594,128597,0,3,3
36727,5,3,128599,128599,128602,0,3,2
36728,1,1,128600,128602,128603,2,3,0
36729,3,2,128603,128603,128605,0,2,0
36730,2,2,128605,128605,128607,0,2,0
36731,5,2,128610,128610,128612,0,2,3
36732,5,2,128615,128615,128617,0,2,3
36733,6,1,128621,128621,128622,0,1,4
36734,5,3,128626,128626,128629,0,3,4
36735,3,3,128629,128629,128632,0,3,0
36736,2,1,128631,128632,128633,1,2,0
36737,2,2,128633,128633,128635,0,2,0
36738,6,2,128639,128639,128641,0,2,4
36739,5,2,128644,128644,128646,0,2,3
36740,4,2,128648,128648,128650,0,2,2
36741,5,3,128653,128653,128656,0,3,3
36742,5,2,128658,128658,128660,0,2,2
36743,3,3,128661,128661,128664,0,3,1
36744,3,2,128664,128664,128666,0,2,0
36745,4,2,128668,128668,128670,0,2,2
36746,6,3,128674,128674,128677,0,3,4
36747,4,1,128678,128678,128679,0,1,1
36748,6,2,128684,128684,128686,0,2,5
36749,2,3,128686,128686,128689,0,3,0
36750,2,3,128688,128689,128692,1,4,0
36751,2,2,128690,128692,128694,2,4,0
36752,1,1,128691,128694,128695,3,4,0
36753,3,3,128694,128695,128698,1,4,0
36754,3,1,128697,128698,128699,1,2,0
36755,4,1,128701,128701,128702,0,1,2
36756,5,2,128706,128706,128708,0,2,4
36757,5,2,128711,128711,128713,0,2,3
36758,3,2,128714,128714,128716,0,2,1
36759,6,3,128720,128720,128723,0,3,4
36760,6,3,128726,128726,128729,0,3,3
36761,6,1,128732,128732,128733,0,1,3
36762,6,3,128738,128738,128741,0,3,5
36763,6,3,128744,128744,128747,0,3,3
36764,4,1,128748,128748,128749,0,1,1
36765,4,1,128752,128752,128753,0,1,3
36766,1,2,128753,128753,128755,0,2,0
36767,4,2,128757,128757,128759,0,2,2
36768,1,2,128758,128759,128761,1,3,0
36769,2,1,128760,128761,128762,1,2,0
36770,2,1,128762,128762,128763,0,1,0
36771,5,2,128767,128767,128769,0,2,4
36772,1,1,128768,128769,128770,1,2,0
36773,4,3,128772,128772,128775,0,3,2
36774,2,3,128774,128775,128778,1,4,0
36775,2,3,128776,128778,128781,2,5,0
36776,4,2,128780,128781,128783,1,3,0
36777,4,2,128784,128784,128786,0,2,1
36778,4,3,128788,128788,128791,0,3,2
36779,6,2,128794,128794,128796,0,2,3
36780,3,3,128797,128797,128800,0,3,1
36781,3,3,128800,128800,128803,0,3,0
36782,1,2,128801,128803,128805,2,4,0
36783,2,3,128803,128805,128808,2,5,0
36784,6,2,128809,128809,128811,0,2,1
36785,6,1,128815,128815,128816,0,1,4
36786,1,2,128816,128816,128818,0,2,0
36787,2,1,128818,128818,128819,0,1,0
36788,6,1,128824,128824,128825,0,1,5
36789,2,2,128826,128826,128828,0,2,1
36790,1,3,128827,128828,128831,1,4,0
36791,3,1,128830,128831,128832,1,2,0
36792,6,1,128836,128836,128837,0,1,4
36793,6,1,128842,128842,128843,0,1,5
36794,4,2,128846,128846,128848,0,2,3
36795,3,2,128849,128849,128851,0,2,1
36796,4,3,128853,128853,128856,0,3,2
36797,2,1,128855,128856,128857,1,2,0
36798,1,2,128856,128857,128859,1,3,0
36799,3,2,128859,128859,128861,0,2,0
36800,1,2,128860,128861,128863,1,3,0
36801,5,2,128865,128865,128867,0,2,2
36802,3,3,128868,128868,128871,0,3,1
36803,1,3,128869,128871,128874,2,5,0
36804,4,2,128873,128874,128876,1,3,0
36805,4,1,128877,128877,128878,0,1,1
36806,4,1,128881,128881,128882,0,1,3
36807,5,1,128886,128886,128887,0,1,4
36808,1,2,128887,128887,128889,0,2,0
36809,5,1,128892,128892,128893,0,1,3
36810,3,2,128895,128895,128897,0,2,2
36811,6,1,128901,128901,128902,0,1,4
36812,5,1,128906,128906,128907,0,1,4
36813,1,3,128907,128907,128910,0,3,0
36814,5,3,128912,128912,128915,0,3,2
36815,1,1,128913,128915,128916,2,3,0
36816,6,1,128919,128919,128920,0,1,3
36817,1,3,128920,128920,128923,0,3,0
36818,1,2,128921,128923,128925,2,4,0
36819,4,1,128925,128925,128926,0,1,0
36820,6,2,128931,128931,128933,0,2,5
36821,4,1,128935,128935,128936,0,1,2
36822,6,1,128941,128941,128942,0,1,5
36823,6,2,128947,128947,128949,0,2,5
36824,4,1,128951,128951,128952,0,1,2
36825,5,1,128956,128956,128957,0,1,4
36826,4,1,128960,128960,128961,0,1,3
36827,3,1,128963,128963,128964,0,1,2
36828,6,2,128969,128969,128971,0,2,5
36829,4,1,128973,128973,128974,0,1,2
36830,6,3,128979,128979,128982,0,3,5
36831,1,3,128980,128982,128985,2,5,0
36832,5,2,128985,128985,128987,0,2,0
36833,1,3,128986,128987,128990,1,4,0
36834,3,1,128989,128990,128991,1,2,0
36835,1,2,128990,128991,128993,1,3,0
36836,2,3,128992,128993,128996,1,4,0
36837,5,3,128997,128997,129000,0,3,1
36838,4,3,129001,129001,129004,0,3,1
36839,2,1,129003,129004,129005,1,2,0
36840,5,2,129008,129008,129010,0,2,3
36841,4,2,129012,129012,129014,0,2,2
36842,1,3,129013,129014,129017,1,4,0
36843,5,3,129018,129018,129021,0,3,1
36844,2,2,129020,129021,129023,1,3,0
36845,3,1,129023,129023,129024,0,1,0
36846,4,1,129027,129027,129028,0,1,3
36847,5,2,129032,129032,129034,0,2,4
36848,3,3,129035,129035,129038,0,3,1
36849,3,3,129038,129038,129041,0,3,0
36850,6,1,129044,129044,129045,0,1,3
36851,1,3,129045,129045,129048,0,3,0
36852,2,2,129047,129048,129050,1,3,0
36853,5,2,129052,129052,129054,0,2,2
36854,3,3,129055,129055,129058,0,3,1
36855,3,2,129058,129058,129060,0,2,0
36856,4,1,129062,129062,129063,0,1,2
36857,2,3,129064,129064,129067,0,3,1
36858,1,1,129065,129067,129068,2,3,0
36859,2,3,129067,129068,129071,1,4,0
36860,1,1,129068,129071,129072,3,4,0
36861,4,2,129072,129072,129074,0,2,0
36862,2,1,129074,129074,129075,0,1,0
36863,1,3,129075,129075,129078,0,3,0
36864,2,3,129077,129078,129081,1,4,0
36865,5,2,129082,129082,129084,0,2,1
36866,5,2,129087,129087,129089,0,2,3
36867,1,2,129088,129089,129091,1,3,0
36868,5,3,129093,129093,129096,0,3,2
36869,1,2,129094,129096,129098,2,4,0
36870,5,2,129099,129099,129101,0,2,1
36871,5,1,129104,129104,129105,0,1,3
36872,1,2,129105,129105,129107,0,2,0
36873,3,3,129108,129108,129111,0,3,1
36874,2,1,129110,129111,129112,1,2,0
36875,4,2,129114,129114,129116,0,2,2
36876,4,3,129118,129118,129121,0,3,2
36877,3,3,129121,129121,129124,0,3,0
36878,2,1,129123,129124,129125,1,2,0
36879,3,2,129126,129126,129128,0,2,1
36880,5,2,129131,129131,129133,0,2,3
36881,4,2,129135,129135,129137,0,2,2
36882,1,1,129136,129137,129138,1,2,0
36883,2,1,129138,129138,129139,0,1,0
36884,5,1,129143,129143,129144,0,1,4
36885,5,3,129148,129148,129151,0,3,4
36886,6,2,129154,129154,129156,0,2,3
36887,4,1,129158,129158,129159,0,1,2
36888,2,1,129160,129160,129161,0,1,1
36889,2,3,129162,129162,129165,0,3,1
36890,3,2,129165,129165,129167,0,2,0
36891,5,3,129170,129170,129173,0,3,3
36892,3,3,129173,129173,129176,0,3,0
36893,3,3,129176,129176,129179,0,3,0
36894,2,1,129178,129179,129180,1,2,0
36895,6,1,129184,129184,129185,0,1,4
36896,6,1,129190,129190,129191,0,1,5
36897,1,1,129191,129191,129192,0,1,0
36898,5,1,129196,129196,129197,0,1,4
36899,5,3,129201,129201,129204,0,3,4
36900,3,2,129204,129204,129206,0,2,0
36901,6,2,129210,129210,129212,0,2,4
36902,5,1,129215,129215,129216,0,1,3
36903,2,3,129217,129217,129220,0,3,1
36904,5,2,129222,129222,129224,0,2,2
36905,4,1,129226,129226,129227,0,1,2
36906,5,3,129231,129231,129234,0,3,4
36907,4,3,129235,129235,129238,0,3,1
36908,2,2,129237,129238,129240,1,3,0
36909,4,1,129241,129241,129242,0,1,1
36910,1,2,129242,129242,129244,0,2,0
36911,6,2,129248,129248,129250,0,2,4
36912,3,2,129251,129251,129253,0,2,1
36913,5,3,129256,129256,129259,0,3,3
36914,4,2,129260,129260,129262,0,2,1
36915,2,2,129262,129262,129264,0,2,0
36916,1,3,129263,129264,129267,1,4,0
36917,3,3,129266,129267,129270,1,4,0
36918,2,3,129268,129270,129273,2,5,0
36919,5,3,129273,129273,129276,0,3,0
36920,6,3,129279,129279,129282,0,3,3
36921,6,2,129285,129285,129287,0,2,3
36922,6,1,129291,129291,129292,0,1,4
36923,1,2,129292,129292,129294,0,2,0
36924,2,3,129294,129294,129297,0,3,0
36925,1,2,129295,129297,129299,2,4,0
36926,1,1,129296,129299,129300,3,4,0
36927,4,3,129300,129300,129303,0,3,0
36928,5,2,129305,129305,129307,0,2,2
36929,6,1,129311,129311,129312,0,1,4
36930,3,1,129314,129314,129315,0,1,2
36931,2,3,129316,129316,129319,0,3,1
36932,2,2,129318,129319,129321,1,3,0
36933,3,1,129321,129321,129322,0,1,0
36934,4,2,129325,129325,129327,0,2,3
36935,4,1,129329,129329,129330,0,1,2
36936,4,2,129333,129333,129335,0,2,3
36937,6,3,129339,129339,129342,0,3,4
36938,3,2,129342,129342,129344,0,2,0
36939,1,3,129343,129344,129347,1,4,0
36940,6,1,129349,129349,129350,0,1,2
36941,6,1,129355,129355,129356,0,1,5
36942,6,3,129361,129361,129364,0,3,5
36943,1,3,129362,129364,129367,2,5,0
36944,4,3,129366,129367,129370,1,4,0
36945,4,1,129370,129370,129371,0,1,0
36946,4,2,129374,129374,129376,0,2,3
36947,2,2,129376,129376,129378,0,2,0
36948,4,2,129380,129380,129382,0,2,2
36949,3,3,129383,129383,129386,0,3,1
36950,5,3,129388,129388,129391,0,3,2
36951,5,1,129393,129393,129394,0,1,2
36952,6,3,129399,129399,129402,0,3,5
36953,3,2,129402,129402,129404,0,2,0
36954,1,3,129403,129404,129407,1,4,0
36955,1,2,129404,129407,129409,3,5,0
36956,1,2,129405,129409,129411,4,6,0
36957,6,3,129411,129411,129414,0,3,0
36958,1,1,129412,129414,129415,2,3,0
36959,4,1,129416,129416,129417,0,1,1
36960,6,2,129422,129422,129424,0,2,5
36961,1,3,129423,129424,129427,1,4,0
36962,2,1,129425,129427,129428,2,3,0
36963,1,3,129426,129428,129431,2,5,0
36964,6,2,129432,129432,129434,0,2,1
36965,6,3,129438,129438,129441,0,3,4
36966,6,2,129444,129444,129446,0,2,3
36967,5,2,129449,129449,129451,0,2,3
36968,6,2,129455,129455,129457,0,2,4
36969,2,1,129457,129457,129458,0,1,0
36970,6,3,129463,129463,129466,0,3,5
36971,5,3,129468,129468,129471,0,3,2
36972,6,3,129474,129474,129477,0,3,3
36973,2,2,129476,129477,129479,1,3,0
36974,3,3,129479,129479,129482,0,3,0
36975,5,3,129484,129484,129487,0,3,2
36976,5,2,129489,129489,129491,0,2,2
36977,2,2,129491,129491,129493,0,2,0
36978,1,2,129492,129493,129495,1,3,0
36979,3,1,129495,129495,129496,0,1,0
36980,1,3,129496,129496,129499,0,3,0
36981,2,1,129498,129499,129500,1,2,0
36982,1,2,129499,129500,129502,1,3,0
36983,1,1,129500,129502,129503,2,3,0
36984,3,1,129503,129503,129504,0,1,0
36985,5,2,129508,129508,129510,0,2,4
36986,1,3,129509,129510,129513,1,4,0
36987,2,2,129511,129513,129515,2,4,0
36988,5,1,129516,129516,129517,0,1,1
36989,5,1,129521,129521,129522,0,1,4
36990,6,1,129527,129527,129528,0,1,5
36991,1,1,129528,129528,129529,0,1,0
36992,6,1,129534,129534,129535,0,1,5
36993,5,2,129539,129539,129541,0,2,4
36994,6,2,129545,129545,129547,0,2,4
36995,4,1,129549,129549,129550,0,1,2
36996,6,1,129555,129555,129556,0,1,5
36997,5,3,129560,129560,129563,0,3,4
36998,1,1,129561,129563,129564,2,3,0
36999,1,1,129562,129564,129565,2,3,0
37000,4,2,129566,129566,129568,0,2,1
37001,4,1,129570,129570,129571,0,1,2
37002,5,1,129575,129575,129576,0,1,4
37003,6,3,129581,129581,129584,0,3,5
37004,1,3,129582,129584,129587,2,5,0
37005,1,2,129583,129587,129589,4,6,0
37006,2,1,129585,129589,129590,4,5,0
37007,5,3,129590,129590,129593,0,3,0
37008,4,1,129594,129594,129595,0,1,1
37009,6,2,129600,129600,129602,0,2,5
37010,2,3,129602,129602,129605,0,3,0
37011,2,3,129604,129605,129608,1,4,0
37012,6,2,129610,129610,129612,0,2,2
37013,1,3,129611,129612,129615,1,4,0
37014,5,3,129616,129616,129619,0,3,1
37015,1,2,129617,129619,129621,2,4,0
37016,4,1,129621,129621,129622,0,1,0
37017,5,1,129626,129626,129627,0,1,4
37018,6,2,129632,129632,129634,0,2,5
37019,1,2,129633,129634,129636,1,3,0
37020,2,3,129635,129636,129639,1,4,0
37021,5,1,129640,129640,129641,0,1,1
37022,6,1,129646,129646,129647,0,1,5
37023,2,2,129648,129648,129650,0,2,1
37024,6,1,129654,129654,129655,0,1,4
37025,6,2,129660,129660,129662,0,2,5
37026,1,2,129661,129662,129664,1,3,0
37027,1,2,129662,129664,129666,2,4,0
37028,1,1,129663,129666,129667,3,4,0
37029,6,2,129669,129669,129671,0,2,2
37030,2,3,129671,129671,129674,0,3,0
37031,5,1,129676,129676,129677,0,1,2
37032,3,1,129679,129679,129680,0,1,2
37033,4,1,129683,129683,129684,0,1,3
37034,3,2,129686,129686,129688,0,2,2
37035,6,2,129692,129692,129694,0,2,4
37036,3,2,129695,129695,129697,0,2,1
37037,6,2,129701,129701,129703,0,2,4
37038,6,2,129707,129707,129709,0,2,4
37039,5,3,129712,129712,129715,0,3,3
37040,1,2,129713,129715,129717,2,4,0
37041,6,3,129719,129719,129722,0,3,2
37042,5,2,129724,129724,129726,0,2,2
37043,4,1,129728,129728,129729,0,1,2
37044,6,3,129734,129734,129737,0,3,5
37045,1,2,129735,129737,129739,2,4,0
37046,2,3,129737,129739,129742,2,5,0
37047,6,3,129743,129743,129746,0,3,1
37048,2,2,129745,129746,129748,1,3,0
37049,1,3,129746,129748,129751,2,5,0
37050,2,1,129748,129751,129752,3,4,0
37051,5,2,129753,129753,129755,0,2,1
37052,5,3,129758,129758,129761,0,3,3
37053,2,2,129760,129761,129763,1,3,0
37054,2,1,129762,129763,129764,1,2,0
37055,4,3,129766,129766,129769,0,3,2
37056,1,3,129767,129769,129772,2,5,0
37057,3,2,129770,129772,129774,2,4,0
37058,3,2,129773,129774,129776,1,3,0
37059,1,3,129774,129776,129779,2,5,0
37060,5,1,129779,129779,129780,0,1,0
37061,3,1,129782,129782,129783,0,1,2
37062,3,2,129785,129785,129787,0,2,2
37063,6,3,129791,129791,129794,0,3,4
37064,4,3,129795,129795,129798,0,3,1
37065,4,1,129799,129799,129800,0,1,1
37066,2,1,129801,129801,129802,0,1,1
37067,2,3,129803,129803,129806,0,3,1
37068,1,2,129804,129806,129808,2,4,0
37069,1,1,129805,129808,129809,3,4,0
37070,6,1,129811,129811,129812,0,1,2
37071,2,2,129813,129813,129815,0,2,1
37072,4,3,129817,129817,129820,0,3,2
37073,3,2,129820,129820,129822,0,2,0
37074,6,1,129826,129826,129827,0,1,4
37075,4,1,129830,129830,129831,0,1,3
37076,4,1,129834,129834,129835,0,1,3
37077,4,3,129838,129838,129841,0,3,3
37078,3,3,129841,129841,129844,0,3,0
37079,4,2,129845,129845,129847,0,2,1
37080,6,3,129851,129851,129854,0,3,4
37081,1,1,129852,129854,129855,2,3,0
37082,3,2,129855,129855,129857,0,2,0
37083,4,2,129859,129859,129861,0,2,2
37084,6,1,129865,129865,129866,0,1,4
37085,3,1,129868,129868,129869,0,1,2
37086,5,3,129873,129873,129876,0,3,4
37087,2,1,129875,129876,129877,1,2,0
37088,6,3,129881,129881,129884,0,3,4
37089,5,1,129886,129886,129887,0,1,2
37090,3,3,129889,129889,129892,0,3,2
37091,2,2,129891,129892,129894,1,3,0
37092,4,2,129895,129895,129897,0,2,1
37093,5,3,129900,129900,129903,0,3,3
37094,2,1,129902,129903,129904,1,2,0
37095,1,1,129903,129904,129905,1,2,0
37096,2,1,129905,129905,129906,0,1,0
37097,5,1,129910,129910,129911,0,1,4
37098,2,2,129912,129912,129914,0,2,1
37099,5,3,129917,129917,129920,0,3,3
37100,2,2,129919,129920,129922,1,3,0
37101,6,1,129925,129925,129926,0,1,3
37102,3,3,129928,129928,129931,0,3,2
37103,1,2,129929,129931,129933,2,4,0
37104,1,2,129930,129933,129935,3,5,0
37105,4,1,129934,129935,129936,1,2,0
37106,6,3,129940,129940,129943,0,3,4
37107,2,2,129942,129943,129945,1,3,0
37108,1,1,129943,129945,129946,2,3,0
37109,2,1,129945,129946,129947,1,2,0
37110,2,3,129947,129947,129950,0,3,0
37111,1,2,129948,129950,129952,2,4,0
37112,5,1,129953,129953,129954,0,1,1
37113,2,1,129955,129955,129956,0,1,1
37114,5,1,129960,129960,129961,0,1,4
37115,6,2,129966,129966,129968,0,2,5
37116,3,3,129969,129969,129972,0,3,1
37117,6,3,129975,129975,129978,0,3,3
37118,1,1,129976,129978,129979,2,3,0
37119,4,2,129980,129980,129982,0,2,1
37120,2,2,129982,129982,129984,0,2,0
37121,2,3,129984,129984,129987,0,3,0
37122,3,1,129987,129987,129988,0,1,0
37123,1,1,129988,129988,129989,0,1,0
37124,6,1,129994,129994,129995,0,1,5
37125,4,2,129998,129998,130000,0,2,3
37126,2,1,130000,130000,130001,0,1,0
37127,4,2,130004,130004,130006,0,2,3
37128,1,2,130005,130006,130008,1,3,0
37129,1,3,130006,130008,130011,2,5,0
37130,4,1,130010,130011,130012,1,2,0
37131,4,2,130014,130014,130016,0,2,2
37132,5,3,130019,130019,130022,0,3,3
37133,5,1,130024,130024,130025,0,1,2
37134,3,3,130027,130027,130030,0,3,2
37135,3,2,130030,130030,130032,0,2,0
37136,5,3,130035,130035,130038,0,3,3
37137,6,3,130041,130041,130044,0,3,3
37138,2,3,130043,130044,130047,1,4,0
37139,3,1,130046,130047,130048,1,2,0
37140,3,2,130049,130049,130051,0,2,1
37141,3,3,130052,130052,130055,0,3,1
37142,4,1,130056,130056,130057,0,1,1
37143,3,2,130059,130059,130061,0,2,2
37144,5,1,130064,130064,130065,0,1,3
37145,4,1,130068,130068,130069,0,1,3
37146,3,2,130071,130071,130073,0,2,2
37147,4,3,130075,130075,130078,0,3,2
37148,1,3,130076,130078,130081,2,5,0
37149,4,3,130080,130081,130084,1,4,0
37150,3,2,130083,130084,130086,1,3,0
37151,4,1,130087,130087,130088,0,1,1
37152,5,3,130092,130092,130095,0,3,4
37153,1,3,130093,130095,130098,2,5,0
37154,4,1,130097,130098,130099,1,2,0
37155,1,2,130098,130099,130101,1,3,0
37156,6,3,130104,130104,130107,0,3,3
37157,3,2,130107,130107,130109,0,2,0
37158,5,2,130112,130112,130114,0,2,3
37159,5,3,130117,130117,130120,0,3,3
37160,4,3,130121,130121,130124,0,3,1
37161,3,1,130124,130124,130125,0,1,0
37162,3,2,130127,130127,130129,0,2,2
37163,2,2,130129,130129,130131,0,2,0
37164,4,1,130133,130133,130134,0,1,2
37165,1,1,130134,130134,130135,0,1,0
37166,6,2,130140,130140,130142,0,2,5
37167,4,1,130144,130144,130145,0,1,2
37168,1,1,130145,130145,130146,0,1,0
37169,3,2,130148,130148,130150,0,2,2
37170,4,2,130152,130152,130154,0,2,2
37171,4,3,130156,130156,130159,0,3,2
37172,4,3,130160,130160,130163,0,3,1
37173,6,3,130166,130166,130169,0,3,3
37174,1,3,130167,130169,130172,2,5,0
37175,3,2,130170,130172,130174,2,4,0
37176,4,2,130174,130174,130176,0,2,0
37177,6,2,130180,130180,130182,0,2,4
37178,3,2,130183,130183,130185,0,2,1
37179,4,2,130187,130187,130189,0,2,2
37180,4,2,130191,130191,130193,0,2,2
37181,2,3,130193,130193,130196,0,3,0
37182,5,1,130198,130198,130199,0,1,2
37183,5,3,130203,130203,130206,0,3,4
37184,4,1,130207,130207,130208,0,1,1
37185,5,2,130212,130212,130214,0,2,4
37186,1,1,130213,130214,130215,1,2,0
37187,5,3,130218,130218,130221,0,3,3
37188,2,2,130220,130221,130223,1,3,0
37189,2,1,130222,130223,130224,1,2,0
37190,3,1,130225,130225,130226,0,1,1
37191,6,1,130231,130231,130232,0,1,5
37192,2,3,130233,130233,130236,0,3,1
37193,5,2,130238,130238,130240,0,2,2
37194,2,2,130240,130240,130242,0,2,0
37195,1,3,130241,130242,130245,1,4,0
37196,6,1,130247,130247,130248,0,1,2
37197,5,1,130252,130252,130253,0,1,4
37198,2,2,130254,130254,130256,0,2,1
37199,2,1,130256,130256,130257,0,1,0
37200,5,3,130261,130261,130264,0,3,4
37201,6,1,130267,130267,130268,0,1,3
37202,2,1,130269,130269,130270,0,1,1
37203,5,1,130274,130274,130275,0,1,4
37204,6,2,130280,130280,130282,0,2,5
37205,5,1,130285,130285,130286,0,1,3
37206,1,2,130286,130286,130288,0,2,0
37207,6,3,130292,130292,130295,0,3,4
37208,5,2,130297,130297,130299,0,2,2
37209,1,1,130298,130299,130300,1,2,0
37210,2,2,130300,130300,130302,0,2,0
37211,3,3,130303,130303,130306,0,3,1
37212,1,2,130304,130306,130308,2,4,0
37213,4,1,130308,130308,130309,0,1,0
37214,3,2,130311,130311,130313,0,2,2
37215,3,3,130314,130314,130317,0,3,1
37216,2,3,130316,130317,130320,1,4,0
37217,4,3,130320,130320,130323,0,3,0
37218,6,2,130326,130326,130328,0,2,3
37219,4,1,130330,130330,130331,0,1,2
37220,3,3,130333,130333,130336,0,3,2
37221,6,3,130339,130339,130342,0,3,3
37222,1,2,130340,130342,130344,2,4,0
37223,4,1,130344,130344,130345,0,1,0
37224,2,1,130346,130346,130347,0,1,1
37225,6,2,130352,130352,130354,0,2,5
37226,6,2,130358,130358,130360,0,2,4
37227,5,1,130363,130363,130364,0,1,3
37228,6,3,130369,130369,130372,0,3,5
37229,2,2,130371,130372,130374,1,3,0
37230,2,3,130373,130374,130377,1,4,0
37231,2,2,130375,130377,130379,2,4,0
37232,1,2,130376,130379,130381,3,5,0
37233,4,3,130380,130381,130384,1,4,0
37234,4,3,130384,130384,130387,0,3,0
37235,6,2,130390,130390,130392,0,2,3
37236,1,2,130391,130392,130394,1,3,0
37237,4,1,130395,130395,130396,0,1,1
37238,6,1,130401,130401,130402,0,1,5
37239,6,1,130407,130407,130408,0,1,5
37240,3,1,130410,130410,130411,0,1,2
37241,6,2,130416,130416,130418,0,2,5
37242,2,3,130418,130418,130421,0,3,0
37243,1,3,130419,130421,130424,2,5,0
37244,6,2,130425,130425,130427,0,2,1
37245,5,2,130430,130430,130432,0,2,3
37246,2,2,130432,130432,130434,0,2,0
37247,6,1,130438,130438,130439,0,1,4
37248,1,1,130439,130439,130440,0,1,0
37249,3,2,130442,130442,130444,0,2,2
37250,3,1,130445,130445,130446,0,1,1
37251,5,2,130450,130450,130452,0,2,4
37252,5,2,130455,130455,130457,0,2,3
37253,6,1,130461,130461,130462,0,1,4
37254,6,3,130467,130467,130470,0,3,5
37255,1,3,130468,130470,130473,2,5,0
37256,6,2,130474,130474,130476,0,2,1
37257,2,3,130476,130476,130479,0,3,0
37258,5,1,130481,130481,130482,0,1,2
37259,5,3,130486,130486,130489,0,3,4
37260,5,3,130491,130491,130494,0,3,2
37261,5,3,130496,130496,130499,0,3,2
37262,4,1,130500,130500,130501,0,1,1
37263,5,2,130505,130505,130507,0,2,4
37264,5,2,130510,130510,130512,0,2,3
37265,1,2,130511,130512,130514,1,3,0
37266,2,3,130513,130514,130517,1,4,0
37267,4,2,130517,130517,130519,0,2,0
37268,3,2,130520,130520,130522,0,2,1
37269,6,2,130526,130526,130528,0,2,4
37270,6,2,130532,130532,130534,0,2,4
37271,4,3,130536,130536,130539,0,3,2
37272,6,1,130542,130542,130543,0,1,3
37273,2,3,130544,130544,130547,0,3,1
37274,3,1,130547,130547,130548,0,1,0
37275,2,1,130549,130549,130550,0,1,1
37276,4,3,130553,130553,130556,0,3,3
37277,4,1,130557,130557,130558,0,1,1
37278,6,2,130563,130563,130565,0,2,5
37279,5,1,130568,130568,130569,0,1,3
37280,1,2,130569,130569,130571,0,2,0
37281,5,2,130574,130574,130576,0,2,3
37282,5,2,130579,130579,130581,0,2,3
37283,1,2,130580,130581,130583,1,3,0
37284,4,3,130584,130584,130587,0,3,1
37285,2,1,130586,130587,130588,1,2,0
37286,6,2,130592,130592,130594,0,2,4
37287,6,3,130598,130598,130601,0,3,4
37288,5,1,130603,130603,130604,0,1,2
37289,4,3,130607,130607,130610,0,3,3
37290,2,1,130609,130610,130611,1,2,0
37291,4,2,130613,130613,130615,0,2,2
37292,3,2,130616,130616,130618,0,2,1
37293,3,2,130619,130619,130621,0,2,1
37294,5,3,130624,130624,130627,0,3,3
37295,2,1,130626,130627,130628,1,2,0
37296,6,3,130632,130632,130635,0,3,4
37297,6,2,130638,130638,130640,0,2,3
37298,4,2,130642,130642,130644,0,2,2
37299,2,3,130644,130644,130647,0,3,0
37300,6,1,130650,130650,130651,0,1,3
37301,1,3,130651,130651,130654,0,3,0
37302,3,2,130654,130654,130656,0,2,0
37303,4,2,130658,130658,130660,0,2,2
37304,2,3,130660,130660,130663,0,3,0
37305,5,2,130665,130665,130667,0,2,2
37306,5,2,130670,130670,130672,0,2,3
37307,6,3,130676,130676,130679,0,3,4
37308,5,2,130681,130681,130683,0,2,2
37309,2,3,130683,130683,130686,0,3,0
37310,5,2,130688,130688,130690,0,2,2
37311,1,1,130689,130690,130691,1,2,0
37312,1,2,130690,130691,130693,1,3,0
37313,1,3,130691,130693,130696,2,5,0
37314,4,2,130695,130696,130698,1,3,0
37315,5,1,130700,130700,130701,0,1,2
37316,5,3,130705,130705,130708,0,3,4
37317,5,3,130710,130710,130713,0,3,2
37318,1,1,130711,130713,130714,2,3,0
37319,1,3,130712,130714,130717,2,5,0
37320,3,2,130715,130717,130719,2,4,0
37321,4,1,130719,130719,130720,0,1,0
37322,1,3,130720,130720,130723,0,3,0
37323,1,1,130721,130723,130724,2,3,0
37324,2,2,130723,130724,130726,1,3,0
37325,5,1,130728,130728,130729,0,1,2
37326,1,3,130729,130729,130732,0,3,0
37327,2,2,130731,130732,130734,1,3,0
37328,5,1,130736,130736,130737,0,1,2
37329,4,3,130740,130740,130743,0,3,3
37330,4,3,130744,130744,130747,0,3,1
37331,4,2,130748,130748,130750,0,2,1
37332,2,3,130750,130750,130753,0,3,0
37333,3,2,130753,130753,130755,0,2,0
37334,1,2,130754,130755,130757,1,3,0
37335,5,3,130759,130759,130762,0,3,2
37336,6,2,130765,130765,130767,0,2,3
37337,1,3,130766,130767,130770,1,4,0
37338,6,1,130772,130772,130773,0,1,2
37339,1,3,130773,130773,130776,0,3,0
37340,3,1,130776,130776,130777,0,1,0
37341,5,2,130781,130781,130783,0,2,4
37342,5,3,130786,130786,130789,0,3,3
37343,3,1,130789,130789,130790,0,1,0
37344,2,2,130791,130791,130793,0,2,1
37345,5,1,130796,130796,130797,0,1,3
37346,6,2,130802,130802,130804,0,2,5
37347,1,3,130803,130804,130807,1,4,0
37348,3,2,130806,130807,130809,1,3,0
37349,1,2,130807,130809,130811,2,4,0
37350,4,1,130811,130811,130812,0,1,0
37351,2,1,130813,130813,130814,0,1,1
37352,6,2,130819,130819,130821,0,2,5
37353,2,2,130821,130821,130823,0,2,0
37354,2,2,130823,130823,130825,0,2,0
37355,2,1,130825,130825,130826,0,1,0
37356,2,1,130827,130827,130828,0,1,1
37357,2,3,130829,130829,130832,0,3,1
37358,3,3,130832,130832,130835,0,3,0
37359,2,2,130834,130835,130837,1,3,0
37360,6,2,130840,130840,130842,0,2,3
37361,3,1,130843,130843,130844,0,1,1
37362,1,3,130844,130844,130847,0,3,0
37363,6,3,130850,130850,130853,0,3,3
37364,4,1,130854,130854,130855,0,1,1
37365,3,2,130857,130857,130859,0,2,2
37366,5,1,130862,130862,130863,0,1,3
37367,4,3,130866,130866,130869,0,3,3
37368,5,2,130871,130871,130873,0,2,2
37369,2,3,130873,130873,130876,0,3,0
37370,4,2,130877,130877,130879,0,2,1
37371,3,3,130880,130880,130883,0,3,1
37372,1,2,130881,130883,130885,2,4,0
37373,4,3,130885,130885,130888,0,3,0
37374,5,1,130890,130890,130891,0,1,2
37375,6,2,130896,130896,130898,0,2,5
37376,6,3,130902,130902,130905,0,3,4
37377,1,3,130903,130905,130908,2,5,0
37378,5,2,130908,130908,130910,0,2,0
37379,5,2,130913,130913,130915,0,2,3
37380,2,3,130915,130915,130918,0,3,0
37381,2,2,130917,130918,130920,1,3,0
37382,2,3,130919,130920,130923,1,4,0
37383,4,2,130923,130923,130925,0,2,0
37384,2,3,130925,130925,130928,0,3,0
37385,1,2,130926,130928,130930,2,4,0
37386,2,1,130928,130930,130931,2,3,0
37387,4,3,130932,130932,130935,0,3,1
37388,5,1,130937,130937,130938,0,1,2
37389,5,2,130942,130942,130944,0,2,4
37390,2,1,130944,130944,130945,0,1,0
37391,2,1,130946,130946,130947,0,1,1
37392,2,2,130948,130948,130950,0,2,1
37393,4,2,130952,130952,130954,0,2,2
37394,4,1,130956,130956,130957,0,1,2
37395,6,2,130962,130962,130964,0,2,5
37396,2,3,130964,130964,130967,0,3,0
37397,6,3,130970,130970,130973,0,3,3
37398,2,2,130972,130973,130975,1,3,0
37399,6,1,130978,130978,130979,0,1,3
37400,2,3,130980,130980,130983,0,3,1
37401,1,1,130981,130983,130984,2,3,0
37402,3,1,130984,130984,130985,0,1,0
37403,1,3,130985,130985,130988,0,3,0
37404,3,2,130988,130988,130990,0,2,0
37405,6,3,130994,130994,130997,0,3,4
37406,6,3,131000,131000,131003,0,3,3
37407,2,2,131002,131003,131005,1,3,0
37408,1,3,131003,131005,131008,2,5,0
37409,3,1,131006,131008,131009,2,3,0
37410,3,2,131009,131009,131011,0,2,0
37411,4,2,131013,131013,131015,0,2,2
37412,4,3,131017,131017,131020,0,3,2
37413,6,3,131023,131023,131026,0,3,3
37414,2,1,131025,131026,131027,1,2,0
37415,3,2,131028,131028,131030,0,2,1
37416,6,2,131034,131034,131036,0,2,4
37417,2,3,131036,131036,131039,0,3,0
37418,1,1,131037,131039,131040,2,3,0
37419,3,3,131040,131040,131043,0,3,0
37420,3,3,131043,131043,131046,0,3,0
37421,1,2,131044,131046,131048,2,4,0
37422,4,2,131048,131048,131050,0,2,0
37423,6,2,131054,131054,131056,0,2,4
37424,5,2,131059,131059,131061,0,2,3
37425,5,2,131064,131064,131066,0,2,3
37426,5,2,131069,131069,131071,0,2,3
37427,3,1,131072,131072,131073,0,1,1
37428,2,3,131074,131074,131077,0,3,1
37429,3,3,131077,131077,131080,0,3,0
37430,4,2,131081,131081,131083,0,2,1
37431,4,2,131085,131085,131087,0,2,2
37432,1,2,131086,131087,131089,1,3,0
37433,2,2,131088,131089,131091,1,3,0
37434,3,2,131091,131091,131093,0,2,0
37435,5,2,131096,131096,131098,0,2,3
37436,5,3,131101,131101,131104,0,3,3
37437,2,1,131103,131104,131105,1,2,0
37438,5,2,131108,131108,131110,0,2,3
37439,6,1,131114,131114,131115,0,1,4
37440,1,1,131115,131115,131116,0,1,0
37441,6,2,131121,131121,131123,0,2,5
37442,1,1,131122,131123,131124,1,2,0
37443,2,2,131124,131124,131126,0,2,0
37444,5,2,131129,131129,131131,0,2,3
37445,4,3,131133,131133,131136,0,3,2
37446,6,1,131139,131139,131140,0,1,3
37447,6,3,131145,131145,131148,0,3,5
37448,5,3,131150,131150,131153,0,3,2
37449,3,2,131153,131153,131155,0,2,0
37450,5,1,131158,131158,131159,0,1,3
37451,6,3,131164,131164,131167,0,3,5
37452,5,2,131169,131169,131171,0,2,2
37453,4,2,131173,131173,131175,0,2,2
37454,5,2,131178,131178,131180,0,2,3
37455,5,2,131183,131183,131185,0,2,3
37456,3,3,131186,131186,131189,0,3,1
37457,2,1,131188,131189,131190,1,2,0
37458,4,2,131192,131192,131194,0,2,2
37459,4,1,131196,131196,131197,0,1,2
37460,6,2,131202,131202,131204,0,2,5
37461,4,2,131206,131206,131208,0,2,2
37462,1,2,131207,131208,131210,1,3,0
37463,4,2,131211,131211,131213,0,2,1
37464,2,2,131213,131213,131215,0,2,0
37465,2,2,131215,131215,131217,0,2,0
37466,6,2,131221,131221,131223,0,2,4
37467,3,1,131224,131224,131225,0,1,1
37468,6,3,131230,131230,131233,0,3,5
37469,6,3,131236,131236,131239,0,3,3
37470,4,2,131240,131240,131242,0,2,1
37471,5,1,131245,131245,131246,0,1,3
37472,4,2,131249,131249,131251,0,2,3
37473,1,1,131250,131251,131252,1,2,0
37474,3,2,131253,131253,131255,0,2,1
37475,1,2,131254,131255,131257,1,3,0
37476,1,1,131255,131257,131258,2,3,0
37477,3,1,131258,131258,131259,0,1,0
37478,5,1,131263,131263,131264,0,1,4
37479,4,3,131267,131267,131270,0,3,3
37480,2,3,131269,131270,131273,1,4,0
37481,3,2,131272,131273,131275,1,3,0
37482,5,1,131277,131277,131278,0,1,2
37483,4,3,131281,131281,131284,0,3,3
37484,5,2,131286,131286,131288,0,2,2
37485,1,1,131287,131288,131289,1,2,0
37486,6,2,131293,131293,131295,0,2,4
37487,5,2,131298,131298,131300,0,2,3
37488,1,3,131299,131300,131303,1,4,0
37489,6,3,131305,131305,131308,0,3,2
37490,5,3,131310,131310,131313,0,3,2
37491,6,1,131316,131316,131317,0,1,3
37492,2,2,131318,131318,131320,0,2,1
37493,5,2,131323,131323,131325,0,2,3
37494,2,3,131325,131325,131328,0,3,0
37495,3,1,131328,131328,131329,0,1,0
37496,4,3,131332,131332,131335,0,3,3
37497,6,3,131338,131338,131341,0,3,3
37498,6,2,131344,131344,131346,0,2,3
37499,4,3,131348,131348,131351,0,3,2
37500,1,3,131349,131351,131354,2,5,0
37501,3,3,131352,131354,131357,2,5,0
37502,4,2,131356,131357,131359,1,3,0
37503,4,3,131360,131360,131363,0,3,1
37504,4,3,131364,131364,131367,0,3,1
37505,6,2,131370,131370,131372,0,2,3
37506,6,2,131376,131376,131378,0,2,4
37507,3,2,131379,131379,131381,0,2,1
37508,2,2,131381,131381,131383,0,2,0
37509,3,1,131384,131384,131385,0,1,1
37510,3,3,131387,131387,131390,0,3,2
37511,5,2,131392,131392,131394,0,2,2
37512,4,3,131396,131396,131399,0,3,2
37513,2,1,131398,131399,131400,1,2,0
37514,4,1,131402,131402,131403,0,1,2
37515,1,1,131403,131403,131404,0,1,0
37516,3,2,131406,131406,131408,0,2,2
37517,6,3,131412,131412,131415,0,3,4
37518,4,1,131416,131416,131417,0,1,1
37519,1,1,131417,131417,131418,0,1,0
37520,3,1,131420,131420,131421,0,1,2
37521,4,2,131424,131424,131426,0,2,3
37522,6,3,131430,131430,131433,0,3,4
37523,6,3,131436,131436,131439,0,3,3
37524,1,2,131437,131439,131441,2,4,0
37525,1,2,131438,131441,131443,3,5,0
37526,3,1,131441,131443,131444,2,3,0
37527,3,3,131444,131444,131447,0,3,0
37528,6,3,131450,131450,131453,0,3,3
37529,4,3,131454,131454,131457,0,3,1
37530,3,1,131457,131457,131458,0,1,0
37531,6,2,131463,131463,131465,0,2,5
37532,6,2,131469,131469,131471,0,2,4
37533,2,3,131471,131471,131474,0,3,0
37534,4,3,131475,131475,131478,0,3,1
37535,5,2,131480,131480,131482,0,2,2
37536,4,3,131484,131484,131487,0,3,2
37537,2,3,131486,131487,131490,1,4,0
37538,5,2,131491,131491,131493,0,2,1
37539,4,2,131495,131495,131497,0,2,2
37540,3,3,131498,131498,131501,0,3,1
37541,5,2,131503,131503,131505,0,2,2
37542,1,2,131504,131505,131507,1,3,0
37543,5,3,131509,131509,131512,0,3,2
37544,3,1,131512,131512,131513,0,1,0
37545,6,1,131518,131518,131519,0,1,5
37546,3,1,131521,131521,131522,0,1,2
37547,1,1,131522,131522,131523,0,1,0
37548,4,3,131526,131526,131529,0,3,3
37549,6,1,131532,131532,131533,0,1,3
37550,3,1,131535,131535,131536,0,1,2
37551,1,2,131536,131536,131538,0,2,0
37552,5,2,131541,131541,131543,0,2,3
37553,4,3,131545,131545,131548,0,3,2
37554,2,3,131547,131548,131551,1,4,0
37555,2,1,131549,131551,131552,2,3,0
37556,3,1,131552,131552,131553,0,1,0
37557,1,3,131553,131553,131556,0,3,0
37558,3,1,131556,131556,131557,0,1,0
37559,3,3,131559,131559,131562,0,3,2
37560,6,1,131565,131565,131566,0,1,3
37561,2,2,131567,131567,131569,0,2,1
37562,6,2,131573,131573,131575,0,2,4
37563,5,3,131578,131578,131581,0,3,3
37564,5,2,131583,131583,131585,0,2,2
37565,5,1,131588,131588,131589,0,1,3
37566,5,3,131593,131593,131596,0,3,4
37567,2,1,131595,131596,131597,1,2,0
37568,6,3,131601,131601,131604,0,3,4
37569,3,2,131604,131604,131606,0,2,0
37570,6,2,131610,131610,131612,0,2,4
37571,3,1,131613,131613,131614,0,1,1
37572,1,3,131614,131614,131617,0,3,0
37573,4,2,131618,131618,131620,0,2,1
37574,4,1,131622,131622,131623,0,1,2
37575,3,2,131625,131625,131627,0,2,2
37576,5,1,131630,131630,131631,0,1,3
37577,1,2,131631,131631,131633,0,2,0
37578,6,3,131637,131637,131640,0,3,4
37579,1,3,131638,131640,131643,2,5,0
37580,4,1,131642,131643,131644,1,2,0
37581,2,1,131644,131644,131645,0,1,0
37582,5,3,131649,131649,131652,0,3,4
37583,5,3,131654,131654,131657,0,3,2
37584,4,1,131658,131658,131659,0,1,1
37585,6,1,131664,131664,131665,0,1,5
37586,6,3,131670,131670,131673,0,3,5
37587,5,1,131675,131675,131676,0,1,2
37588,5,3,131680,131680,131683,0,3,4
37589,3,3,131683,131683,131686,0,3,0
37590,1,2,131684,131686,131688,2,4,0
37591,1,3,131685,131688,131691,3,6,0
37592,2,3,131687,131691,131694,4,7,0
37593,3,2,131690,131694,131696,4,6,0
37594,4,1,131694,131696,131697,2,3,0
37595,2,1,131696,131697,131698,1,2,0
37596,5,1,131701,131701,131702,0,1,3
37597,3,3,131704,131704,131707,0,3,2
37598,2,3,131706,131707,131710,1,4,0
37599,1,2,131707,131710,131712,3,5,0
37600,6,3,131713,131713,131716,0,3,1
37601,5,1,131718,131718,131719,0,1,2
37602,4,1,131722,131722,131723,0,1,3
37603,6,3,131728,131728,131731,0,3,5
37604,2,2,131730,131731,131733,1,3,0
37605,1,2,131731,131733,131735,2,4,0
37606,1,3,131732,131735,131738,3,6,0
37607,6,2,131738,131738,131740,0,2,0
37608,3,3,131741,131741,131744,0,3,1
37609,2,1,131743,131744,131745,1,2,0
37610,5,1,131748,131748,131749,0,1,3
37611,4,3,131752,131752,131755,0,3,3
37612,6,1,131758,131758,131759,0,1,3
37613,3,2,131761,131761,131763,0,2,2
37614,6,1,131767,131767,131768,0,1,4
37615,1,1,131768,131768,131769,0,1,0
37616,4,3,131772,131772,131775,0,3,3
37617,6,1,131778,131778,131779,0,1,3
37618,5,2,131783,131783,131785,0,2,4
37619,3,2,131786,131786,131788,0,2,1
37620,5,3,131791,131791,131794,0,3,3
37621,2,1,131793,131794,131795,1,2,0
37622,6,3,131799,131799,131802,0,3,4
37623,5,3,131804,131804,131807,0,3,2
37624,4,1,131808,131808,131809,0,1,1
37625,6,2,131814,131814,131816,0,2,5
37626,4,3,131818,131818,131821,0,3,2
37627,5,2,131823,131823,131825,0,2,2
37628,4,3,131827,131827,131830,0,3,2
37629,5,2,131832,131832,131834,0,2,2
37630,6,1,131838,131838,131839,0,1,4
37631,6,1,131844,131844,131845,0,1,5
37632,5,3,131849,131849,131852,0,3,4
37633,4,1,131853,131853,131854,0,1,1
37634,6,2,131859,131859,131861,0,2,5
37635,1,1,131860,131861,131862,1,2,0
37636,3,3,131863,131863,131866,0,3,1
37637,2,1,131865,131866,131867,1,2,0
37638,5,3,131870,131870,131873,0,3,3
37639,1,3,131871,131873,131876,2,5,0
37640,3,1,131874,131876,131877,2,3,0
37641,1,2,131875,131877,131879,2,4,0
37642,4,2,131879,131879,131881,0,2,0
37643,2,2,131881,131881,131883,0,2,0
37644,2,2,131883,131883,131885,0,2,0
37645,2,3,131885,131885,131888,0,3,0
37646,2,1,131887,131888,131889,1,2,0
37647,1,2,131888,131889,131891,1,3,0
37648,4,1,131892,131892,131893,0,1,1
37649,4,2,131896,131896,131898,0,2,3
37650,6,1,131902,131902,131903,0,1,4
37651,5,1,131907,131907,131908,0,1,4
37652,2,2,131909,131909,131911,0,2,1
37653,4,3,131913,131913,131916,0,3,2
37654,1,1,131914,131916,131917,2,3,0
37655,2,1,131916,131917,131918,1,2,0
37656,3,2,131919,131919,131921,0,2,1
37657,2,1,131921,131921,131922,0,1,0
37658,2,1,131923,131923,131924,0,1,1
37659,5,2,131928,131928,131930,0,2,4
37660,3,1,131931,131931,131932,0,1,1
37661,5,1,131936,131936,131937,0,1,4
37662,6,2,131942,131942,131944,0,2,5
37663,5,3,131947,131947,131950,0,3,3
37664,2,2,131949,131950,131952,1,3,0
37665,5,2,131954,131954,131956,0,2,2
37666,5,3,131959,131959,131962,0,3,3
37667,1,1,131960,131962,131963,2,3,0
37668,2,3,131962,131963,131966,1,4,0
37669,3,1,131965,131966,131967,1,2,0
37670,6,2,131971,131971,131973,0,2,4
37671,3,1,131974,131974,131975,0,1,1
37672,1,3,131975,131975,131978,0,3,0
37673,1,3,131976,131978,131981,2,5,0
37674,3,2,131979,131981,131983,2,4,0
37675,2,3,131981,131983,131986,2,5,0
37676,1,2,131982,131986,131988,4,6,0
37677,3,2,131985,131988,131990,3,5,0
37678,5,2,131990,131990,131992,0,2,0
37679,1,3,131991,131992,131995,1,4,0
37680,6,3,131997,131997,132000,0,3,2
37681,2,1,131999,132000,132001,1,2,0
37682,1,2,132000,132001,132003,1,3,0
37683,3,2,132003,132003,132005,0,2,0
37684,4,2,132007,132007,132009,0,2,2
37685,5,2,132012,132012,132014,0,2,3
37686,2,2,132014,132014,132016,0,2,0
37687,2,3,132016,132016,132019,0,3,0
37688,2,2,132018,132019,132021,1,3,0
37689,3,2,132021,132021,132023,0,2,0
37690,4,1,132025,132025,132026,0,1,2
37691,1,1,132026,132026,132027,0,1,0
37692,4,1,132030,132030,132031,0,1,3
37693,1,1,132031,132031,132032,0,1,0
37694,5,3,132036,132036,132039,0,3,4
37695,2,3,132038,132039,132042,1,4,0
37696,2,2,132040,132042,132044,2,4,0
37697,3,3,132043,132044,132047,1,4,0
37698,4,1,132047,132047,132048,0,1,0
37699,6,1,132053,132053,132054,0,1,5
37700,1,1,132054,132054,132055,0,1,0
37701,2,3,132056,132056,132059,0,3,1
37702,5,2,132061,132061,132063,0,2,2
37703,3,3,132064,132064,132067,0,3,1
37704,1,3,132065,132067,132070,2,5,0
37705,1,3,132066,132070,132073,4,7,0
37706,3,2,132069,132073,132075,4,6,0
37707,5,1,132074,132075,132076,1,2,0
37708,3,1,132077,132077,132078,0,1,1
37709,3,1,132080,132080,132081,0,1,2
37710,4,1,132084,132084,132085,0,1,3
37711,6,2,132090,132090,132092,0,2,5
37712,4,2,132094,132094,132096,0,2,2
37713,5,2,132099,132099,132101,0,2,3
37714,6,2,132105,132105,132107,0,2,4
37715,1,3,132106,132107,132110,1,4,0
37716,2,2,132108,132110,132112,2,4,0
37717,1,2,132109,132112,132114,3,5,0
37718,2,2,132111,132114,132116,3,5,0
37719,4,1,132115,132116,132117,1,2,0
37720,4,1,132119,132119,132120,0,1,2
37721,6,2,132125,132125,132127,0,2,5
37722,2,1,132127,132127,132128,0,1,0
37723,5,2,132132,132132,132134,0,2,4
37724,4,3,132136,132136,132139,0,3,2
37725,4,2,132140,132140,132142,0,2,1
37726,4,2,132144,132144,132146,0,2,2
37727,6,2,132150,132150,132152,0,2,4
37728,3,2,132153,132153,132155,0,2,1
37729,1,3,132154,132155,132158,1,4,0
37730,3,2,132157,132158,132160,1,3,0
37731,5,2,132162,132162,132164,0,2,2
37732,5,1,132167,132167,132168,0,1,3
37733,2,3,132169,132169,132172,0,3,1
37734,4,1,132173,132173,132174,0,1,1
37735,1,1,132174,132174,132175,0,1,0
37736,1,1,132175,132175,132176,0,1,0
37737,4,3,132179,132179,132182,0,3,3
37738,1,1,132180,132182,132183,2,3,0
37739,5,2,132185,132185,132187,0,2,2
37740,4,1,132189,132189,132190,0,1,2
37741,2,3,132191,132191,132194,0,3,1
37742,4,3,132195,132195,132198,0,3,1
37743,5,1,132200,132200,132201,0,1,2
37744,3,1,132203,132203,132204,0,1,2
37745,2,3,132205,132205,132208,0,3,1
37746,6,2,132211,132211,132213,0,2,3
37747,2,1,132213,132213,132214,0,1,0
37748,3,2,132216,132216,132218,0,2,2
37749,6,1,132222,132222,132223,0,1,4
37750,6,3,132228,132228,132231,0,3,5
37751,6,2,132234,132234,132236,0,2,3
37752,1,3,132235,132236,132239,1,4,0
37753,3,1,132238,132239,132240,1,2,0
37754,2,1,132240,132240,132241,0,1,0
37755,1,1,132241,132241,132242,0,1,0
37756,3,2,132244,132244,132246,0,2,2
37757,1,1,132245,132246,132247,1,2,0
37758,5,2,132250,132250,132252,0,2,3
37759,1,3,132251,132252,132255,1,4,0
37760,5,3,132256,132256,132259,0,3,1
37761,3,2,132259,132259,132261,0,2,0
37762,3,2,132262,132262,132264,0,2,1
37763,4,1,132266,132266,132267,0,1,2
37764,1,3,132267,132267,132270,0,3,0
37765,5,1,132272,132272,132273,0,1,2
37766,1,3,132273,132273,132276,0,3,0
37767,4,3,132277,132277,132280,0,3,1
37768,5,1,132282,132282,132283,0,1,2
37769,6,3,132288,132288,132291,0,3,5
37770,3,1,132291,132291,132292,0,1,0
37771,1,3,132292,132292,132295,0,3,0
37772,5,1,132297,132297,132298,0,1,2
37773,6,1,132303,132303,132304,0,1,5
37774,4,3,132307,132307,132310,0,3,3
37775,5,3,132312,132312,132315,0,3,2
37776,5,1,132317,132317,132318,0,1,2
37777,3,2,132320,132320,132322,0,2,2
37778,6,3,132326,132326,132329,0,3,4
37779,2,3,132328,132329,132332,1,4,0
37780,1,2,132329,132332,132334,3,5,0
37781,3,2,132332,132334,132336,2,4,0
37782,5,3,132337,132337,132340,0,3,1
37783,4,3,132341,132341,132344,0,3,1
37784,3,2,132344,132344,132346,0,2,0
37785,3,1,132347,132347,132348,0,1,1
37786,5,1,132352,132352,132353,0,1,4
37787,1,1,132353,132353,132354,0,1,0
37788,1,3,132354,132354,132357,0,3,0
37789,5,3,132359,132359,132362,0,3,2
37790,3,1,132362,132362,132363,0,1,0
37791,3,1,132365,132365,132366,0,1,2
37792,5,1,132370,132370,132371,0,1,4
37793,6,3,132376,132376,132379,0,3,5
37794,1,1,132377,132379,132380,2,3,0
37795,1,2,132378,132380,132382,2,4,0
37796,1,2,132379,132382,132384,3,5,0
37797,5,3,132384,132384,132387,0,3,0
37798,6,2,132390,132390,132392,0,2,3
37799,3,2,132393,132393,132395,0,2,1
37800,2,1,132395,132395,132396,0,1,0
37801,6,3,132401,132401,132404,0,3,5
37802,2,2,132403,132404,132406,1,3,0
37803,1,1,132404,132406,132407,2,3,0
37804,6,2,132410,132410,132412,0,2,3
37805,5,1,132415,132415,132416,0,1,3
37806,4,3,132419,132419,132422,0,3,3
37807,2,2,132421,132422,132424,1,3,0
37808,6,3,132427,132427,132430,0,3,3
37809,3,1,132430,132430,132431,0,1,0
37810,3,1,132433,132433,132434,0,1,2
37811,6,3,132439,132439,132442,0,3,5
37812,5,2,132444,132444,132446,0,2,2
37813,5,3,132449,132449,132452,0,3,3
37814,2,3,132451,132452,132455,1,4,0
37815,4,1,132455,132455,132456,0,1,0
37816,4,3,132459,132459,132462,0,3,3
37817,6,1,132465,132465,132466,0,1,3
37818,5,3,132470,132470,132473,0,3,4
37819,5,3,132475,132475,132478,0,3,2
37820,6,1,132481,132481,132482,0,1,3
37821,2,3,132483,132483,132486,0,3,1
37822,1,1,132484,132486,132487,2,3,0
37823,1,3,132485,132487,132490,2,5,0
37824,1,1,132486,132490,132491,4,5,0
37825,1,2,132487,132491,132493,4,6,0
37826,5,2,132492,132493,132495,1,3,0
37827,2,2,132494,132495,132497,1,3,0
37828,6,1,132500,132500,132501,0,1,3
37829,5,1,132505,132505,132506,0,1,4
37830,3,3,132508,132508,132511,0,3,2
37831,4,1,132512,132512,132513,0,1,1
37832,5,3,132517,132517,132520,0,3,4
37833,4,1,132521,132521,132522,0,1,1
37834,3,1,132524,132524,132525,0,1,2
37835,3,2,132527,132527,132529,0,2,2
37836,6,1,132533,132533,132534,0,1,4
37837,4,1,132537,132537,132538,0,1,3
37838,2,1,132539,132539,132540,0,1,1
37839,5,1,132544,132544,132545,0,1,4
37840,4,3,132548,132548,132551,0,3,3
37841,4,2,132552,132552,132554,0,2,1
37842,3,1,132555,132555,132556,0,1,1
37843,2,3,132557,132557,132560,0,3,1
37844,1,3,132558,132560,132563,2,5,0
37845,6,3,132564,132564,132567,0,3,1
37846,5,3,132569,132569,132572,0,3,2
37847,5,1,132574,132574,132575,0,1,2
37848,3,1,132577,132577,132578,0,1,2
37849,5,3,132582,132582,132585,0,3,4
37850,2,1,132584,132585,132586,1,2,0
37851,4,2,132588,132588,132590,0,2,2
37852,4,2,132592,132592,132594,0,2,2
37853,4,2,132596,132596,132598,0,2,2
37854,5,2,132601,132601,132603,0,2,3
37855,1,3,132602,132603,132606,1,4,0
37856,5,2,132607,132607,132609,0,2,1
37857,6,2,132613,132613,132615,0,2,4
37858,2,1,132615,132615,132616,0,1,0
37859,5,3,132620,132620,132623,0,3,4
37860,2,1,132622,132623,132624,1,2,0
37861,4,1,132626,132626,132627,0,1,2
37862,4,1,132630,132630,132631,0,1,3
37863,6,3,132636,132636,132639,0,3,5
37864,2,1,132638,132639,132640,1,2,0
37865,4,3,132642,132642,132645,0,3,2
37866,5,2,132647,132647,132649,0,2,2
37867,6,2,132653,132653,132655,0,2,4
37868,1,3,132654,132655,132658,1,4,0
37869,4,3,132658,132658,132661,0,3,0
37870,4,1,132662,132662,132663,0,1,1
37871,4,1,132666,132666,132667,0,1,3
37872,4,2,132670,132670,132672,0,2,3
37873,4,2,132674,132674,132676,0,2,2
37874,6,3,132680,132680,132683,0,3,4
37875,4,3,132684,132684,132687,0,3,1
37876,4,3,132688,132688,132691,0,3,1
37877,5,3,132693,132693,132696,0,3,2
37878,6,2,132699,132699,132701,0,2,3
37879,2,1,132701,132701,132702,0,1,0
37880,2,2,132703,132703,132705,0,2,1
37881,5,2,132708,132708,132710,0,2,3
37882,1,1,132709,132710,132711,1,2,0
37883,6,1,132715,132715,132716,0,1,4
37884,6,1,132721,132721,132722,0,1,5
37885,6,2,132727,132727,132729,0,2,5
37886,6,3,132733,132733,132736,0,3,4
37887,6,3,132739,132739,132742,0,3,3
37888,5,1,132744,132744,132745,0,1,2
37889,1,3,132745,132745,132748,0,3,0
37890,4,1,132749,132749,132750,0,1,1
37891,5,1,132754,132754,132755,0,1,4
37892,6,3,132760,132760,132763,0,3,5
37893,3,2,132763,132763,132765,0,2,0
37894,3,1,132766,132766,132767,0,1,1
37895,5,2,132771,132771,132773,0,2,4
37896,4,3,132775,132775,132778,0,3,2
37897,1,1,132776,132778,132779,2,3,0
37898,5,2,132781,132781,132783,0,2,2
37899,3,2,132784,132784,132786,0,2,1
37900,3,3,132787,132787,132790,0,3,1
37901,2,3,132789,132790,132793,1,4,0
37902,4,2,132793,132793,132795,0,2,0
37903,4,1,132797,132797,132798,0,1,2
37904,1,3,132798,132798,132801,0,3,0
37905,1,1,132799,132801,132802,2,3,0
37906,5,3,132804,132804,132807,0,3,2
37907,2,3,132806,132807,132810,1,4,0
37908,2,2,132808,132810,132812,2,4,0
37909,4,1,132812,132812,132813,0,1,0
37910,1,3,132813,132813,132816,0,3,0
37911,2,1,132815,132816,132817,1,2,0
37912,3,2,132818,132818,132820,0,2,1
37913,2,3,132820,132820,132823,0,3,0
37914,1,3,132821,132823,132826,2,5,0
37915,1,2,132822,132826,132828,4,6,0
37916,1,1,132823,132828,132829,5,6,0
37917,3,2,132826,132829,132831,3,5,0
37918,6,2,132832,132832,132834,0,2,1
37919,4,2,132836,132836,132838,0,2,2
37920,6,1,132842,132842,132843,0,1,4
37921,6,1,132848,132848,132849,0,1,5
37922,6,1,132854,132854,132855,0,1,5
37923,5,2,132859,132859,132861,0,2,4
37924,1,1,132860,132861,132862,1,2,0
37925,5,2,132865,132865,132867,0,2,3
37926,4,2,132869,132869,132871,0,2,2
37927,6,2,132875,132875,132877,0,2,4
37928,2,1,132877,132877,132878,0,1,0
37929,6,3,132883,132883,132886,0,3,5
37930,6,1,132889,132889,132890,0,1,3
37931,6,3,132895,132895,132898,0,3,5
37932,5,2,132900,132900,132902,0,2,2
37933,3,1,132903,132903,132904,0,1,1
37934,4,1,132907,132907,132908,0,1,3
37935,4,2,132911,132911,132913,0,2,3
37936,4,3,132915,132915,132918,0,3,2
37937,5,1,132920,132920,132921,0,1,2
37938,3,1,132923,132923,132924,0,1,2
37939,1,1,132924,132924,132925,0,1,0
37940,2,2,132926,132926,132928,0,2,1
37941,5,2,132931,132931,132933,0,2,3
37942,5,2,132936,132936,132938,0,2,3
37943,1,1,132937,132938,132939,1,2,0
37944,3,1,132940,132940,132941,0,1,1
37945,2,1,132942,132942,132943,0,1,1
37946,4,2,132946,132946,132948,0,2,3
37947,5,1,132951,132951,132952,0,1,3
37948,6,1,132957,132957,132958,0,1,5
37949,5,2,132962,132962,132964,0,2,4
37950,4,1,132966,132966,132967,0,1,2
37951,2,2,132968,132968,132970,0,2,1
37952,4,3,132972,132972,132975,0,3,2
37953,1,2,132973,132975,132977,2,4,0
37954,1,2,132974,132977,132979,3,5,0
37955,1,2,132975,132979,132981,4,6,0
37956,4,1,132979,132981,132982,2,3,0
37957,3,2,132982,132982,132984,0,2,0
37958,2,3,132984,132984,132987,0,3,0
37959,3,1,132987,132987,132988,0,1,0
37960,1,1,132988,132988,132989,0,1,0
37961,2,1,132990,132990,132991,0,1,1
37962,6,1,132996,132996,132997,0,1,5
37963,4,1,133000,133000,133001,0,1,3
37964,2,2,133002,133002,133004,0,2,1
37965,6,1,133008,133008,133009,0,1,4
37966,6,2,133014,133014,133016,0,2,5
37967,5,1,133019,133019,133020,0,1,3
37968,5,3,133024,133024,133027,0,3,4
37969,2,1,133026,133027,133028,1,2,0
37970,5,3,133031,133031,133034,0,3,3
37971,2,3,133033,133034,133037,1,4,0
37972,6,2,133039,133039,133041,0,2,2
37973,1,3,133040,133041,133044,1,4,0
37974,1,2,133041,133044,133046,3,5,0
37975,4,2,133045,133046,133048,1,3,0
37976,6,1,133051,133051,133052,0,1,3
37977,2,2,133053,133053,133055,0,2,1
37978,2,1,133055,133055,133056,0,1,0
37979,6,2,133061,133061,133063,0,2,5
37980,5,3,133066,133066,133069,0,3,3
37981,6,2,133072,133072,133074,0,2,3
37982,2,1,133074,133074,133075,0,1,0
37983,4,1,133078,133078,133079,0,1,3
37984,2,3,133080,133080,133083,0,3,1
37985,2,2,133082,133083,133085,1,3,0
37986,5,3,133087,133087,133090,0,3,2
37987,4,2,133091,133091,133093,0,2,1
37988,3,3,133094,133094,133097,0,3,1
37989,6,1,133100,133100,133101,0,1,3
37990,1,2,133101,133101,133103,0,2,0
37991,5,2,133106,133106,133108,0,2,3
37992,3,3,133109,133109,133112,0,3,1
37993,4,2,133113,133113,133115,0,2,1
37994,6,3,133119,133119,133122,0,3,4
37995,6,2,133125,133125,133127,0,2,3
37996,2,2,133127,133127,133129,0,2,0
37997,3,3,133130,133130,133133,0,3,1
37998,1,2,133131,133133,133135,2,4,0
37999,2,1,133133,133135,133136,2,3,0
38000,4,2,133137,133137,133139,0,2,1
38001,4,1,133141,133141,133142,0,1,2
38002,3,1,133144,133144,133145,0,1,2
38003,5,2,133149,133149,133151,0,2,4
38004,4,1,133153,133153,133154,0,1,2
38005,4,2,133157,133157,133159,0,2,3
38006,4,3,133161,133161,133164,0,3,2
38007,5,3,133166,133166,133169,0,3,2
38008,3,1,133169,133169,133170,0,1,0
38009,4,1,133173,133173,133174,0,1,3
38010,4,2,133177,133177,133179,0,2,3
38011,3,1,133180,133180,133181,0,1,1
38012,5,1,133185,133185,133186,0,1,4
38013,3,3,133188,133188,133191,0,3,2
38014,1,3,133189,133191,133194,2,5,0
38015,4,2,133193,133194,133196,1,3,0
38016,6,3,133199,133199,133202,0,3,3
38017,3,2,133202,133202,133204,0,2,0
38018,5,1,133207,133207,133208,0,1,3
38019,6,1,133213,133213,133214,0,1,5
38020,2,2,133215,133215,133217,0,2,1
38021,3,2,133218,133218,133220,0,2,1
38022,6,2,133224,133224,133226,0,2,4
38023,5,2,133229,133229,133231,0,2,3
38024,1,1,133230,133231,133232,1,2,0
38025,1,2,133231,133232,133234,1,3,0
38026,3,2,133234,133234,133236,0,2,0
38027,3,1,133237,133237,133238,0,1,1
38028,6,1,133243,133243,133244,0,1,5
38029,6,3,133249,133249,133252,0,3,5
38030,4,3,133253,133253,133256,0,3,1
38031,1,3,133254,133256,133259,2,5,0
38032,2,2,133256,133259,133261,3,5,0
38033,6,1,133262,133262,133263,0,1,1
38034,5,1,133267,133267,133268,0,1,4
38035,5,3,133272,133272,133275,0,3,4
38036,5,3,133277,133277,133280,0,3,2
38037,1,3,133278,133280,133283,2,5,0
38038,2,1,133280,133283,133284,3,4,0
38039,4,1,133284,133284,133285,0,1,0
38040,1,2,133285,133285,133287,0,2,0
38041,1,2,133286,133287,133289,1,3,0
38042,1,1,133287,133289,133290,2,3,0
38043,5,3,133292,133292,133295,0,3,2
38044,6,1,133298,133298,133299,0,1,3
38045,5,2,133303,133303,133305,0,2,4
38046,3,2,133306,133306,133308,0,2,1
38047,1,1,133307,133308,133309,1,2,0
38048,3,3,133310,133310,133313,0,3,1
38049,4,3,133314,133314,133317,0,3,1
38050,5,1,133319,133319,133320,0,1,2
38051,2,2,133321,133321,133323,0,2,1
38052,5,3,133326,133326,133329,0,3,3
38053,5,2,133331,133331,133333,0,2,2
38054,1,2,133332,133333,133335,1,3,0
38055,6,1,133338,133338,133339,0,1,3
38056,6,1,133344,133344,133345,0,1,5
38057,3,2,133347,133347,133349,0,2,2
38058,6,3,133353,133353,133356,0,3,4
38059,6,3,133359,133359,133362,0,3,3
38060,5,2,133364,133364,133366,0,2,2
38061,5,1,133369,133369,133370,0,1,3
38062,4,2,133373,133373,133375,0,2,3
38063,3,1,133376,133376,133377,0,1,1
38064,5,2,133381,133381,133383,0,2,4
38065,5,2,133386,133386,133388,0,2,3
38066,5,1,133391,133391,133392,0,1,3
38067,2,1,133393,133393,133394,0,1,1
38068,1,1,133394,133394,133395,0,1,0
38069,6,2,133400,133400,133402,0,2,5
38070,1,1,133401,133402,133403,1,2,0
38071,5,1,133406,133406,133407,0,1,3
38072,1,3,133407,133407,133410,0,3,0
38073,6,2,133413,133413,133415,0,2,3
38074,1,1,133414,133415,133416,1,2,0
38075,6,1,133420,133420,133421,0,1,4
38076,1,2,133421,133421,133423,0,2,0
38077,1,3,133422,133423,133426,1,4,0
38078,2,2,133424,133426,133428,2,4,0
38079,6,2,133430,133430,133432,0,2,2
38080,2,3,133432,133432,133435,0,3,0
38081,1,1,133433,133435,133436,2,3,0
38082,6,1,133439,133439,133440,0,1,3
38083,6,2,133445,133445,133447,0,2,5
38084,2,1,133447,133447,133448,0,1,0
38085,4,2,133451,133451,133453,0,2,3
38086,5,2,133456,133456,133458,0,2,3
38087,5,1,133461,133461,133462,0,1,3
38088,6,1,133467,133467,133468,0,1,5
38089,6,1,133473,133473,133474,0,1,5
38090,1,3,133474,133474,133477,0,3,0
38091,6,3,133480,133480,133483,0,3,3
38092,4,2,133484,133484,133486,0,2,1
38093,2,3,133486,133486,133489,0,3,0
38094,6,1,133492,133492,133493,0,1,3
38095,5,2,133497,133497,133499,0,2,4
38096,5,1,133502,133502,133503,0,1,3
38097,4,3,133506,133506,133509,0,3,3
38098,6,3,133512,133512,133515,0,3,3
38099,6,1,133518,133518,133519,0,1,3
38100,3,2,133521,133521,133523,0,2,2
38101,1,3,133522,133523,133526,1,4,0
38102,6,2,133528,133528,133530,0,2,2
38103,5,2,133533,133533,133535,0,2,3
38104,5,1,133538,133538,133539,0,1,3
38105,3,2,133541,133541,133543,0,2,2
38106,3,3,133544,133544,133547,0,3,1
38107,4,1,133548,133548,133549,0,1,1
38108,4,1,133552,133552,133553,0,1,3
38109,1,1,133553,133553,133554,0,1,0
38110,6,1,133559,133559,133560,0,1,5
38111,2,1,133561,133561,133562,0,1,1
38112,5,2,133566,133566,133568,0,2,4
38113,1,2,133567,133568,133570,1,3,0
38114,1,1,133568,133570,133571,2,3,0
38115,3,1,133571,133571,133572,0,1,0
38116,6,2,133577,133577,133579,0,2,5
38117,1,2,133578,133579,133581,1,3,0
38118,6,3,133584,133584,133587,0,3,3
38119,6,1,133590,133590,133591,0,1,3
38120,4,2,133594,133594,133596,0,2,3
38121,5,2,133599,133599,133601,0,2,3
38122,6,2,133605,133605,133607,0,2,4
38123,2,2,133607,133607,133609,0,2,0
38124,5,3,133612,133612,133615,0,3,3
38125,1,3,133613,133615,133618,2,5,0
38126,1,2,133614,133618,133620,4,6,0
38127,5,3,133619,133620,133623,1,4,0
38128,6,2,133625,133625,133627,0,2,2
38129,5,2,133630,133630,133632,0,2,3
38130,5,1,133635,133635,133636,0,1,3
38131,6,2,133641,133641,133643,0,2,5
38132,1,1,133642,133643,133644,1,2,0
38133,6,2,133648,133648,133650,0,2,4
38134,2,3,133650,133650,133653,0,3,0
38135,3,3,133653,133653,133656,0,3,0
38136,4,1,133657,133657,133658,0,1,1
38137,5,1,133662,133662,133663,0,1,4
38138,5,1,133667,133667,133668,0,1,4
38139,2,3,133669,133669,133672,0,3,1
38140,2,2,133671,133672,133674,1,3,0
38141,5,1,133676,133676,133677,0,1,2
38142,2,3,133678,133678,133681,0,3,1
38143,2,3,133680,133681,133684,1,4,0
38144,2,3,133682,133684,133687,2,5,0
38145,4,1,133686,133687,133688,1,2,0
38146,4,1,133690,133690,133691,0,1,2
38147,5,2,133695,133695,133697,0,2,4
38148,2,2,133697,133697,133699,0,2,0
38149,6,2,133703,133703,133705,0,2,4
38150,2,1,133705,133705,133706,0,1,0
38151,6,2,133711,133711,133713,0,2,5
38152,1,2,133712,133713,133715,1,3,0
38153,2,3,133714,133715,133718,1,4,0
38154,3,3,133717,133718,133721,1,4,0
38155,5,3,133722,133722,133725,0,3,1
38156,1,2,133723,133725,133727,2,4,0
38157,4,3,133727,133727,133730,0,3,0
38158,5,1,133732,133732,133733,0,1,2
38159,1,2,133733,133733,133735,0,2,0
38160,6,3,133739,133739,133742,0,3,4
38161,1,2,133740,133742,133744,2,4,0
38162,3,2,133743,133744,133746,1,3,0
38163,2,2,133745,133746,133748,1,3,0
38164,4,3,133749,133749,133752,0,3,1
38165,2,3,133751,133752,133755,1,4,0
38166,4,1,133755,133755,133756,0,1,0
38167,1,1,133756,133756,133757,0,1,0
38168,3,3,133759,133759,133762,0,3,2
38169,6,1,133765,133765,133766,0,1,3
38170,3,2,133768,133768,133770,0,2,2
38171,1,2,133769,133770,133772,1,3,0
38172,5,1,133774,133774,133775,0,1,2
38173,1,1,133775,133775,133776,0,1,0
38174,6,2,133781,133781,133783,0,2,5
38175,2,2,133783,133783,133785,0,2,0
38176,4,1,133787,133787,133788,0,1,2
38177,1,2,133788,133788,133790,0,2,0
38178,4,3,133792,133792,133795,0,3,2
38179,2,3,133794,133795,133798,1,4,0
38180,4,2,133798,133798,133800,0,2,0
38181,1,1,133799,133800,133801,1,2,0
38182,2,3,133801,133801,133804,0,3,0
38183,5,1,133806,133806,133807,0,1,2
38184,4,1,133810,133810,133811,0,1,3
38185,5,2,133815,133815,133817,0,2,4
38186,1,1,133816,133817,133818,1,2,0
38187,4,1,133820,133820,133821,0,1,2
38188,5,1,133825,133825,133826,0,1,4
38189,2,3,133827,133827,133830,0,3,1
38190,3,1,133830,133830,133831,0,1,0
38191,4,3,133834,133834,133837,0,3,3
38192,5,2,133839,133839,133841,0,2,2
38193,2,1,133841,133841,133842,0,1,0
38194,2,1,133843,133843,133844,0,1,1
38195,5,3,133848,133848,133851,0,3,4
38196,1,1,133849,133851,133852,2,3,0
38197,1,2,133850,133852,133854,2,4,0
38198,4,1,133854,133854,133855,0,1,0
38199,6,3,133860,133860,133863,0,3,5
38200,2,1,133862,133863,133864,1,2,0
38201,3,2,133865,133865,133867,0,2,1
38202,1,1,133866,133867,133868,1,2,0
38203,1,3,133867,133868,133871,1,4,0
38204,6,1,133873,133873,133874,0,1,2
38205,4,1,133877,133877,133878,0,1,3
38206,6,1,133883,133883,133884,0,1,5
38207,3,2,133886,133886,133888,0,2,2
38208,4,3,133890,133890,133893,0,3,2
38209,2,1,133892,133893,133894,1,2,0
38210,5,2,133897,133897,133899,0,2,3
38211,5,2,133902,133902,133904,0,2,3
38212,2,1,133904,133904,133905,0,1,0
38213,1,3,133905,133905,133908,0,3,0
38214,1,1,133906,133908,133909,2,3,0
38215,6,3,133912,133912,133915,0,3,3
38216,6,3,133918,133918,133921,0,3,3
38217,2,2,133920,133921,133923,1,3,0
38218,4,2,133924,133924,133926,0,2,1
38219,4,3,133928,133928,133931,0,3,2
38220,6,1,133934,133934,133935,0,1,3
38221,3,1,133937,133937,133938,0,1,2
38222,5,2,133942,133942,133944,0,2,4
38223,5,1,133947,133947,133948,0,1,3
38224,4,2,133951,133951,133953,0,2,3
38225,3,2,133954,133954,133956,0,2,1
38226,6,2,133960,133960,133962,0,2,4
38227,4,2,133964,133964,133966,0,2,2
38228,5,3,133969,133969,133972,0,3,3
38229,5,1,133974,133974,133975,0,1,2
38230,1,1,133975,133975,133976,0,1,0
38231,6,1,133981,133981,133982,0,1,5
38232,1,2,133982,133982,133984,0,2,0
38233,4,2,133986,133986,133988,0,2,2
38234,5,1,133991,133991,133992,0,1,3
38235,2,3,133993,133993,133996,0,3,1
38236,2,2,133995,133996,133998,1,3,0
38237,3,1,133998,133998,133999,0,1,0
38238,4,1,134002,134002,134003,0,1,3
38239,3,3,134005,134005,134008,0,3,2
38240,4,3,134009,134009,134012,0,3,1
38241,2,3,134011,134012,134015,1,4,0
38242,2,1,134013,134015,134016,2,3,0
38243,6,2,134019,134019,134021,0,2,3
38244,1,1,134020,134021,134022,1,2,0
38245,3,1,134023,134023,134024,0,1,1
38246,4,1,134027,134027,134028,0,1,3
38247,3,1,134030,134030,134031,0,1,2
38248,3,2,134033,134033,134035,0,2,2
38249,2,2,134035,134035,134037,0,2,0
38250,4,2,134039,134039,134041,0,2,2
38251,2,1,134041,134041,134042,0,1,0
38252,6,3,134047,134047,134050,0,3,5
38253,6,1,134053,134053,134054,0,1,3
38254,1,2,134054,134054,134056,0,2,0
38255,3,2,134057,134057,134059,0,2,1
38256,4,1,134061,134061,134062,0,1,2
38257,1,1,134062,134062,134063,0,1,0
38258,4,2,134066,134066,134068,0,2,3
38259,3,1,134069,134069,134070,0,1,1
38260,4,3,134073,134073,134076,0,3,3
38261,4,2,134077,134077,134079,0,2,1
38262,2,2,134079,134079,134081,0,2,0
38263,4,3,134083,134083,134086,0,3,2
38264,3,2,134086,134086,134088,0,2,0
38265,1,3,134087,134088,134091,1,4,0
38266,1,3,134088,134091,134094,3,6,0
38267,2,3,134090,134094,134097,4,7,0
38268,3,2,134093,134097,134099,4,6,0
38269,5,1,134098,134099,134100,1,2,0
38270,5,1,134103,134103,134104,0,1,3
38271,2,3,134105,134105,134108,0,3,1
38272,5,3,134110,134110,134113,0,3,2
38273,1,2,134111,134113,134115,2,4,0
38274,2,3,134113,134115,134118,2,5,0
38275,4,1,134117,134118,134119,1,2,0
38276,3,2,134120,134120,134122,0,2,1
38277,6,2,134126,134126,134128,0,2,4
38278,6,1,134132,134132,134133,0,1,4
38279,4,1,134136,134136,134137,0,1,3
38280,1,1,134137,134137,134138,0,1,0
38281,4,3,134141,134141,134144,0,3,3
38282,3,1,134144,134144,134145,0,1,0
38283,2,1,134146,134146,134147,0,1,1
38284,3,1,134149,134149,134150,0,1,2
38285,3,3,134152,134152,134155,0,3,2
38286,3,2,134155,134155,134157,0,2,0
38287,3,1,134158,134158,134159,0,1,1
38288,1,1,134159,134159,134160,0,1,0
38289,5,3,134164,134164,134167,0,3,4
38290,1,1,134165,134167,134168,2,3,0
38291,4,2,134169,134169,134171,0,2,1
38292,6,2,134175,134175,134177,0,2,4
38293,5,1,134180,134180,134181,0,1,3
38294,4,3,134184,134184,134187,0,3,3
38295,5,1,134189,134189,134190,0,1,2
38296,3,1,134192,134192,134193,0,1,2
38297,4,3,134196,134196,134199,0,3,3
38298,4,2,134200,134200,134202,0,2,1
38299,4,1,134204,134204,134205,0,1,2
38300,1,3,134205,134205,134208,0,3,0
38301,1,2,134206,134208,134210,2,4,0
38302,1,2,134207,134210,134212,3,5,0
38303,3,2,134210,134212,134214,2,4,0
38304,4,1,134214,134214,134215,0,1,0
38305,2,1,134216,134216,134217,0,1,1
38306,1,3,134217,134217,134220,0,3,0
38307,3,3,134220,134220,134223,0,3,0
38308,4,3,134224,134224,134227,0,3,1
38309,3,1,134227,134227,134228,0,1,0
38310,2,3,134229,134229,134232,0,3,1
38311,3,1,134232,134232,134233,0,1,0
38312,4,1,134236,134236,134237,0,1,3
38313,1,3,134237,134237,134240,0,3,0
38314,1,1,134238,134240,134241,2,3,0
38315,5,1,134243,134243,134244,0,1,2
38316,5,3,134248,134248,134251,0,3,4
38317,3,3,134251,134251,134254,0,3,0
38318,5,3,134256,134256,134259,0,3,2
38319,2,2,134258,134259,134261,1,3,0
38320,6,2,134264,134264,134266,0,2,3
38321,6,1,134270,134270,134271,0,1,4
38322,5,2,134275,134275,134277,0,2,4
38323,4,3,134279,134279,134282,0,3,2
38324,4,2,134283,134283,134285,0,2,1
38325,1,3,134284,134285,134288,1,4,0
38326,6,1,134290,134290,134291,0,1,2
38327,2,2,134292,134292,134294,0,2,1
38328,4,1,134296,134296,134297,0,1,2
38329,3,3,134299,134299,134302,0,3,2
38330,2,3,134301,134302,134305,1,4,0
38331,5,3,134306,134306,134309,0,3,1
38332,5,2,134311,134311,134313,0,2,2
38333,3,2,134314,134314,134316,0,2,1
38334,2,2,134316,134316,134318,0,2,0
38335,4,1,134320,134320,134321,0,1,2
38336,2,3,134322,134322,134325,0,3,1
38337,2,3,134324,134325,134328,1,4,0
38338,2,2,134326,134328,134330,2,4,0
38339,1,3,134327,134330,134333,3,6,0
38340,6,2,134333,134333,134335,0,2,0
38341,2,1,134335,134335,134336,0,1,0
38342,1,3,134336,134336,134339,0,3,0
38343,2,1,134338,134339,134340,1,2,0
38344,3,2,134341,134341,134343,0,2,1
38345,3,3,134344,134344,134347,0,3,1
38346,4,1,134348,134348,134349,0,1,1
38347,4,3,134352,134352,134355,0,3,3
38348,6,1,134358,134358,134359,0,1,3
38349,1,2,134359,134359,134361,0,2,0
38350,1,1,134360,134361,134362,1,2,0
38351,4,1,134364,134364,134365,0,1,2
38352,4,1,134368,134368,134369,0,1,3
38353,2,1,134370,134370,134371,0,1,1
38354,1,3,134371,134371,134374,0,3,0
38355,4,2,134375,134375,134377,0,2,1
38356,6,2,134381,134381,134383,0,2,4
38357,3,2,134384,134384,134386,0,2,1
38358,6,2,134390,134390,134392,0,2,4
38359,4,1,134394,134394,134395,0,1,2
38360,1,3,134395,134395,134398,0,3,0
38361,1,3,134396,134398,134401,2,5,0
38362,6,3,134402,134402,134405,0,3,1
38363,5,1,134407,134407,134408,0,1,2
38364,6,1,134413,134413,134414,0,1,5
38365,2,1,134415,134415,134416,0,1,1
38366,4,3,134419,134419,134422,0,3,3
38367,2,3,134421,134422,134425,1,4,0
38368,5,3,134426,134426,134429,0,3,1
38369,6,3,134432,134432,134435,0,3,3
38370,4,1,134436,134436,134437,0,1,1
38371,5,2,134441,134441,134443,0,2,4
38372,6,1,134447,134447,134448,0,1,4
38373,4,2,134451,134451,134453,0,2,3
38374,2,1,134453,134453,134454,0,1,0
38375,1,1,134454,134454,134455,0,1,0
38376,5,3,134459,134459,134462,0,3,4
38377,6,3,134465,134465,134468,0,3,3
38378,1,3,134466,134468,134471,2,5,0
38379,1,1,134467,134471,134472,4,5,0
38380,3,3,134470,134472,134475,2,5,0
38381,2,3,134472,134475,134478,3,6,0
38382,3,3,134475,134478,134481,3,6,0
38383,5,1,134480,134481,134482,1,2,0
38384,3,3,134483,134483,134486,0,3,1
38385,5,3,134488,134488,134491,0,3,2
38386,6,2,134494,134494,134496,0,2,3
38387,2,2,134496,134496,134498,0,2,0
38388,4,3,134500,134500,134503,0,3,2
38389,4,3,134504,134504,134507,0,3,1
38390,1,1,134505,134507,134508,2,3,0
38391,1,1,134506,134508,134509,2,3,0
38392,5,1,134511,134511,134512,0,1,2
38393,2,1,134513,134513,134514,0,1,1
38394,2,1,134515,134515,134516,0,1,1
38395,3,1,134518,134518,134519,0,1,2
38396,1,2,134519,134519,134521,0,2,0
38397,3,3,134522,134522,134525,0,3,1
38398,4,2,134526,134526,134528,0,2,1
38399,5,2,134531,134531,134533,0,2,3
38400,2,2,134533,134533,134535,0,2,0
38401,5,2,134538,134538,134540,0,2,3
38402,4,1,134542,134542,134543,0,1,2
38403,5,2,134547,134547,134549,0,2,4
38404,3,3,134550,134550,134553,0,3,1
38405,3,1,134553,134553,134554,0,1,0
38406,5,2,134558,134558,134560,0,2,4
38407,2,1,134560,134560,134561,0,1,0
38408,2,3,134562,134562,134565,0,3,1
38409,1,3,134563,134565,134568,2,5,0
38410,1,2,134564,134568,134570,4,6,0
38411,5,2,134569,134570,134572,1,3,0
38412,1,3,134570,134572,134575,2,5,0
38413,6,2,134576,134576,134578,0,2,1
38414,2,2,134578,134578,134580,0,2,0
38415,2,3,134580,134580,134583,0,3,0
38416,6,3,134586,134586,134589,0,3,3
38417,1,2,134587,134589,134591,2,4,0
38418,1,3,134588,134591,134594,3,6,0
38419,5,1,134593,134594,134595,1,2,0
38420,3,3,134596,134596,134599,0,3,1
38421,6,3,134602,134602,134605,0,3,3
38422,5,1,134607,134607,134608,0,1,2
38423,3,2,134610,134610,134612,0,2,2
38424,4,2,134614,134614,134616,0,2,2
38425,6,3,134620,134620,134623,0,3,4
38426,6,1,134626,134626,134627,0,1,3
38427,2,3,134628,134628,134631,0,3,1
38428,4,3,134632,134632,134635,0,3,1
38429,6,2,134638,134638,134640,0,2,3
38430,4,2,134642,134642,134644,0,2,2
38431,4,2,134646,134646,134648,0,2,2
38432,6,3,134652,134652,134655,0,3,4
38433,6,2,134658,134658,134660,0,2,3
38434,1,3,134659,134660,134663,1,4,0
38435,6,2,134665,134665,134667,0,2,2
38436,5,2,134670,134670,134672,0,2,3
38437,4,3,134674,134674,134677,0,3,2
38438,6,3,134680,134680,134683,0,3,3
38439,2,1,134682,134683,134684,1,2,0
38440,4,2,134686,134686,134688,0,2,2
38441,6,3,134692,134692,134695,0,3,4
38442,6,1,134698,134698,134699,0,1,3
38443,6,2,134704,134704,134706,0,2,5
38444,6,3,134710,134710,134713,0,3,4
38445,3,1,134713,134713,134714,0,1,0
38446,4,1,134717,134717,134718,0,1,3
38447,4,3,134721,134721,134724,0,3,3
38448,4,1,134725,134725,134726,0,1,1
38449,2,1,134727,134727,134728,0,1,1
38450,4,2,134731,134731,134733,0,2,3
38451,1,2,134732,134733,134735,1,3,0
38452,4,2,134736,134736,134738,0,2,1
38453,3,2,134739,134739,134741,0,2,1
38454,2,1,134741,134741,134742,0,1,0
38455,6,1,134747,134747,134748,0,1,5
38456,6,3,134753,134753,134756,0,3,5
38457,6,1,134759,134759,134760,0,1,3
38458,4,3,134763,134763,134766,0,3,3
38459,1,1,134764,134766,134767,2,3,0
38460,6,2,134770,134770,134772,0,2,3
38461,2,3,134772,134772,134775,0,3,0
38462,1,2,134773,134775,134777,2,4,0
38463,3,1,134776,134777,134778,1,2,0
38464,4,3,134780,134780,134783,0,3,2
38465,2,2,134782,134783,134785,1,3,0
38466,1,2,134783,134785,134787,2,4,0
38467,3,2,134786,134787,134789,1,3,0
38468,4,3,134790,134790,134793,0,3,1
38469,2,2,134792,134793,134795,1,3,0
38470,6,3,134798,134798,134801,0,3,3
38471,3,2,134801,134801,134803,0,2,0
38472,5,2,134806,134806,134808,0,2,3
38473,4,2,134810,134810,134812,0,2,2
38474,4,3,134814,134814,134817,0,3,2
38475,2,3,134816,134817,134820,1,4,0
38476,3,1,134819,134820,134821,1,2,0
38477,6,2,134825,134825,134827,0,2,4
38478,1,1,134826,134827,134828,1,2,0
38479,3,1,134829,134829,134830,0,1,1
38480,4,3,134833,134833,134836,0,3,3
38481,3,2,134836,134836,134838,0,2,0
38482,2,3,134838,134838,134841,0,3,0
38483,3,1,134841,134841,134842,0,1,0
38484,1,3,134842,134842,134845,0,3,0
38485,3,3,134845,134845,134848,0,3,0
38486,1,3,134846,134848,134851,2,5,0
38487,1,1,134847,134851,134852,4,5,0
38488,2,1,134849,134852,134853,3,4,0
38489,2,2,134851,134853,134855,2,4,0
38490,5,1,134856,134856,134857,0,1,1
38491,6,3,134862,134862,134865,0,3,5
38492,3,2,134865,134865,134867,0,2,0
38493,3,2,134868,134868,134870,0,2,1
38494,1,3,134869,134870,134873,1,4,0
38495,4,1,134873,134873,134874,0,1,0
38496,6,2,134879,134879,134881,0,2,5
38497,3,3,134882,134882,134885,0,3,1
38498,4,1,134886,134886,134887,0,1,1
38499,5,3,134891,134891,134894,0,3,4
38500,1,3,134892,134894,134897,2,5,0
38501,3,1,134895,134897,134898,2,3,0
38502,2,2,134897,134898,134900,1,3,0
38503,5,2,134902,134902,134904,0,2,2
38504,3,3,134905,134905,134908,0,3,1
38505,1,3,134906,134908,134911,2,5,0
38506,2,3,134908,134911,134914,3,6,0
38507,1,1,134909,134914,134915,5,6,0
38508,2,2,134911,134915,134917,4,6,0
38509,6,2,134917,134917,134919,0,2,0
38510,4,2,134921,134921,134923,0,2,2
38511,4,3,134925,134925,134928,0,3,2
38512,2,2,134927,134928,134930,1,3,0
38513,1,1,134928,134930,134931,2,3,0
38514,3,3,134931,134931,134934,0,3,0
38515,2,1,134933,134934,134935,1,2,0
38516,6,2,134939,134939,134941,0,2,4
38517,5,2,134944,134944,134946,0,2,3
38518,2,2,134946,134946,134948,0,2,0
38519,6,2,134952,134952,134954,0,2,4
38520,2,1,134954,134954,134955,0,1,0
38521,2,3,134956,134956,134959,0,3,1
38522,3,2,134959,134959,134961,0,2,0
38523,3,1,134962,134962,134963,0,1,1
38524,2,3,134964,134964,134967,0,3,1
38525,5,3,134969,134969,134972,0,3,2
38526,4,3,134973,134973,134976,0,3,1
38527,4,1,134977,134977,134978,0,1,1
38528,5,3,134982,134982,134985,0,3,4
38529,1,3,134983,134985,134988,2,5,0
38530,4,2,134987,134988,134990,1,3,0
38531,5,2,134992,134992,134994,0,2,2
38532,4,3,134996,134996,134999,0,3,2
38533,3,3,134999,134999,135002,0,3,0
38534,2,1,135001,135002,135003,1,2,0
38535,2,2,135003,135003,135005,0,2,0
38536,2,3,135005,135005,135008,0,3,0
38537,5,2,135010,135010,135012,0,2,2
38538,5,2,135015,135015,135017,0,2,3
38539,1,2,135016,135017,135019,1,3,0
38540,4,3,135020,135020,135023,0,3,1
38541,2,2,135022,135023,135025,1,3,0
38542,2,3,135024,135025,135028,1,4,0
38543,3,1,135027,135028,135029,1,2,0
38544,5,3,135032,135032,135035,0,3,3
38545,2,2,135034,135035,135037,1,3,0
38546,2,2,135036,135037,135039,1,3,0
38547,2,1,135038,135039,135040,1,2,0
38548,3,3,135041,135041,135044,0,3,1
38549,2,1,135043,135044,135045,1,2,0
38550,5,1,135048,135048,135049,0,1,3
38551,5,1,135053,135053,135054,0,1,4
38552,2,1,135055,135055,135056,0,1,1
38553,1,3,135056,135056,135059,0,3,0
38554,3,3,135059,135059,135062,0,3,0
38555,3,3,135062,135062,135065,0,3,0
38556,3,1,135065,135065,135066,0,1,0
38557,3,1,135068,135068,135069,0,1,2
38558,6,3,135074,135074,135077,0,3,5
38559,4,1,135078,135078,135079,0,1,1
38560,3,3,135081,135081,135084,0,3,2
38561,6,3,135087,135087,135090,0,3,3
38562,4,3,135091,135091,135094,0,3,1
38563,4,2,135095,135095,135097,0,2,1
38564,4,2,135099,135099,135101,0,2,2
38565,5,3,135104,135104,135107,0,3,3
38566,1,3,135105,135107,135110,2,5,0
38567,2,1,135107,135110,135111,3,4,0
38568,4,1,135111,135111,135112,0,1,0
38569,2,3,135113,135113,135116,0,3,1
38570,1,2,135114,135116,135118,2,4,0
38571,2,1,135116,135118,135119,2,3,0
38572,2,1,135118,135119,135120,1,2,0
38573,5,3,135123,135123,135126,0,3,3
38574,4,1,135127,135127,135128,0,1,1
38575,2,2,135129,135129,135131,0,2,1
38576,3,2,135132,135132,135134,0,2,1
38577,4,3,135136,135136,135139,0,3,2
38578,1,3,135137,135139,135142,2,5,0
38579,5,3,135142,135142,135145,0,3,0
38580,2,2,135144,135145,135147,1,3,0
38581,1,2,135145,135147,135149,2,4,0
38582,5,2,135150,135150,135152,0,2,1
38583,5,2,135155,135155,135157,0,2,3
38584,5,1,135160,135160,135161,0,1,3
38585,2,1,135162,135162,135163,0,1,1
38586,3,1,135165,135165,135166,0,1,2
38587,1,3,135166,135166,135169,0,3,0
38588,6,2,135172,135172,135174,0,2,3
38589,6,3,135178,135178,135181,0,3,4
38590,1,3,135179,135181,135184,2,5,0
38591,3,3,135182,135184,135187,2,5,0
38592,4,1,135186,135187,135188,1,2,0
38593,3,3,135189,135189,135192,0,3,1
38594,4,3,135193,135193,135196,0,3,1
38595,5,1,135198,135198,135199,0,1,2
38596,4,1,135202,135202,135203,0,1,3
38597,1,1,135203,135203,135204,0,1,0
38598,2,3,135205,135205,135208,0,3,1
38599,2,3,135207,135208,135211,1,4,0
38600,5,1,135212,135212,135213,0,1,1
38601,2,3,135214,135214,135217,0,3,1
38602,5,3,135219,135219,135222,0,3,2
38603,4,1,135223,135223,135224,0,1,1
38604,4,1,135227,135227,135228,0,1,3
38605,5,1,135232,135232,135233,0,1,4
38606,6,1,135238,135238,135239,0,1,5
38607,4,1,135242,135242,135243,0,1,3
38608,3,2,135245,135245,135247,0,2,2
38609,4,3,135249,135249,135252,0,3,2
38610,5,3,135254,135254,135257,0,3,2
38611,4,3,135258,135258,135261,0,3,1
38612,3,2,135261,135261,135263,0,2,0
38613,1,1,135262,135263,135264,1,2,0
38614,4,1,135266,135266,135267,0,1,2
38615,3,1,135269,135269,135270,0,1,2
38616,5,2,135274,135274,135276,0,2,4
38617,1,2,135275,135276,135278,1,3,0
38618,6,3,135281,135281,135284,0,3,3
38619,3,2,135284,135284,135286,0,2,0
38620,6,3,135290,135290,135293,0,3,4
38621,6,3,135296,135296,135299,0,3,3
38622,2,2,135298,135299,135301,1,3,0
38623,5,2,135303,135303,135305,0,2,2
38624,3,1,135306,135306,135307,0,1,1
38625,4,3,135310,135310,135313,0,3,3
38626,3,1,135313,135313,135314,0,1,0
38627,3,2,135316,135316,135318,0,2,2
38628,3,3,135319,135319,135322,0,3,1
38629,1,3,135320,135322,135325,2,5,0
38630,4,1,135324,135325,135326,1,2,0
38631,2,1,135326,135326,135327,0,1,0
38632,6,3,135332,135332,135335,0,3,5
38633,5,3,135337,135337,135340,0,3,2
38634,1,3,135338,135340,135343,2,5,0
38635,4,2,135342,135343,135345,1,3,0
38636,5,3,135347,135347,135350,0,3,2
38637,3,2,135350,135350,135352,0,2,0
38638,3,3,135353,135353,135356,0,3,1
38639,3,2,135356,135356,135358,0,2,0
38640,6,1,135362,135362,135363,0,1,4
38641,3,3,135365,135365,135368,0,3,2
38642,5,3,135370,135370,135373,0,3,2
38643,6,1,135376,135376,135377,0,1,3
38644,2,3,135378,135378,135381,0,3,1
38645,4,2,135382,135382,135384,0,2,1
38646,4,1,135386,135386,135387,0,1,2
38647,5,3,135391,135391,135394,0,3,4
38648,5,1,135396,135396,135397,0,1,2
38649,2,3,135398,135398,135401,0,3,1
38650,4,1,135402,135402,135403,0,1,1
38651,2,2,135404,135404,135406,0,2,1
38652,3,3,135407,135407,135410,0,3,1
38653,5,1,135412,135412,135413,0,1,2
38654,6,3,135418,135418,135421,0,3,5
38655,1,1,135419,135421,135422,2,3,0
38656,5,3,135424,135424,135427,0,3,2
38657,3,3,135427,135427,135430,0,3,0
38658,3,2,135430,135430,135432,0,2,0
38659,2,3,135432,135432,135435,0,3,0
38660,4,2,135436,135436,135438,0,2,1
38661,1,3,135437,135438,135441,1,4,0
38662,6,2,135443,135443,135445,0,2,2
38663,4,3,135447,135447,135450,0,3,2
38664,3,3,135450,135450,135453,0,3,0
38665,3,3,135453,135453,135456,0,3,0
38666,1,2,135454,135456,135458,2,4,0
38667,5,3,135459,135459,135462,0,3,1
38668,4,1,135463,135463,135464,0,1,1
38669,1,3,135464,135464,135467,0,3,0
38670,3,1,135467,135467,135468,0,1,0
38671,3,2,135470,135470,135472,0,2,2
38672,2,2,135472,135472,135474,0,2,0
38673,5,1,135477,135477,135478,0,1,3
38674,2,2,135479,135479,135481,0,2,1
38675,6,1,135485,135485,135486,0,1,4
38676,3,2,135488,135488,135490,0,2,2
38677,4,3,135492,135492,135495,0,3,2
38678,3,3,135495,135495,135498,0,3,0
38679,3,1,135498,135498,135499,0,1,0
38680,5,2,135503,135503,135505,0,2,4
38681,1,1,135504,135505,135506,1,2,0
38682,3,3,135507,135507,135510,0,3,1
38683,1,2,135508,135510,135512,2,4,0
38684,2,2,135510,135512,135514,2,4,0
38685,3,2,135513,135514,135516,1,3,0
38686,5,3,135518,135518,135521,0,3,2
38687,4,3,135522,135522,135525,0,3,1
38688,4,2,135526,135526,135528,0,2,1
38689,6,2,135532,135532,135534,0,2,4
38690,3,3,135535,135535,135538,0,3,1
38691,2,2,135537,135538,135540,1,3,0
38692,6,2,135543,135543,135545,0,2,3
38693,6,1,135549,135549,135550,0,1,4
38694,1,3,135550,135550,135553,0,3,0
38695,6,3,135556,135556,135559,0,3,3
38696,2,1,135558,135559,135560,1,2,0
38697,6,3,135564,135564,135567,0,3,4
38698,5,1,135569,135569,135570,0,1,2
38699,3,1,135572,135572,135573,0,1,2
38700,4,3,135576,135576,135579,0,3,3
38701,5,2,135581,135581,135583,0,2,2
38702,2,2,135583,135583,135585,0,2,0
38703,5,1,135588,135588,135589,0,1,3
38704,5,3,135593,135593,135596,0,3,4
38705,1,1,135594,135596,135597,2,3,0
38706,6,3,135600,135600,135603,0,3,3
38707,6,3,135606,135606,135609,0,3,3
38708,1,1,135607,135609,135610,2,3,0
38709,5,3,135612,135612,135615,0,3,2
38710,3,2,135615,135615,135617,0,2,0
38711,3,3,135618,135618,135621,0,3,1
38712,3,3,135621,135621,135624,0,3,0
38713,4,3,135625,135625,135628,0,3,1
38714,6,2,135631,135631,135633,0,2,3
38715,5,2,135636,135636,135638,0,2,3
38716,6,3,135642,135642,135645,0,3,4
38717,6,3,135648,135648,135651,0,3,3
38718,1,2,135649,135651,135653,2,4,0
38719,2,2,135651,135653,135655,2,4,0
38720,3,2,135654,135655,135657,1,3,0
38721,4,3,135658,135658,135661,0,3,1
38722,5,2,135663,135663,135665,0,2,2
38723,6,3,135669,135669,135672,0,3,4
38724,5,1,135674,135674,135675,0,1,2
38725,6,2,135680,135680,135682,0,2,5
38726,6,1,135686,135686,135687,0,1,4
38727,1,2,135687,135687,135689,0,2,0
38728,2,1,135689,135689,135690,0,1,0
38729,4,1,135693,135693,135694,0,1,3
38730,3,1,135696,135696,135697,0,1,2
38731,2,1,135698,135698,135699,0,1,1
38732,6,2,135704,135704,135706,0,2,5
38733,6,1,135710,135710,135711,0,1,4
38734,2,1,135712,135712,135713,0,1,1
38735,6,3,135718,135718,135721,0,3,5
38736,4,3,135722,135722,135725,0,3,1
38737,4,2,135726,135726,135728,0,2,1
38738,6,2,135732,135732,135734,0,2,4
38739,6,3,135738,135738,135741,0,3,4
38740,2,3,135740,135741,135744,1,4,0
38741,3,1,135743,135744,135745,1,2,0
38742,2,3,135745,135745,135748,0,3,0
38743,6,1,135751,135751,135752,0,1,3
38744,4,1,135755,135755,135756,0,1,3
38745,1,2,135756,135756,135758,0,2,0
38746,2,2,135758,135758,135760,0,2,0
38747,2,2,135760,135760,135762,0,2,0
38748,6,1,135766,135766,135767,0,1,4
38749,6,2,135772,135772,135774,0,2,5
38750,6,1,135778,135778,135779,0,1,4
38751,3,2,135781,135781,135783,0,2,2
38752,1,3,135782,135783,135786,1,4,0
38753,1,1,135783,135786,135787,3,4,0
38754,4,1,135787,135787,135788,0,1,0
38755,3,3,135790,135790,135793,0,3,2
38756,5,3,135795,135795,135798,0,3,2
38757,4,2,135799,135799,135801,0,2,1
38758,1,1,135800,135801,135802,1,2,0
38759,5,2,135805,135805,135807,0,2,3
38760,2,1,135807,135807,135808,0,1,0
38761,5,2,135812,135812,135814,0,2,4
38762,6,3,135818,135818,135821,0,3,4
38763,3,2,135821,135821,135823,0,2,0
38764,2,3,135823,135823,135826,0,3,0
38765,2,1,135825,135826,135827,1,2,0
38766,4,1,135829,135829,135830,0,1,2
38767,1,1,135830,135830,135831,0,1,0
38768,3,1,135833,135833,135834,0,1,2
38769,5,1,135838,135838,135839,0,1,4
38770,5,2,135843,135843,135845,0,2,4
38771,2,1,135845,135845,135846,0,1,0
38772,3,1,135848,135848,135849,0,1,2
38773,1,1,135849,135849,135850,0,1,0
38774,5,3,135854,135854,135857,0,3,4
38775,6,3,135860,135860,135863,0,3,3
38776,3,3,135863,135863,135866,0,3,0
38777,1,1,135864,135866,135867,2,3,0
38778,1,2,135865,135867,135869,2,4,0
38779,1,3,135866,135869,135872,3,6,0
38780,5,2,135871,135872,135874,1,3,0
38781,5,1,135876,135876,135877,0,1,2
38782,5,2,135881,135881,135883,0,2,4
38783,1,3,135882,135883,135886,1,4,0
38784,3,3,135885,135886,135889,1,4,0
38785,5,3,135890,135890,135893,0,3,1
38786,1,3,135891,135893,135896,2,5,0
38787,6,3,135897,135897,135900,0,3,1
38788,6,1,135903,135903,135904,0,1,3
38789,1,2,135904,135904,135906,0,2,0
38790,2,2,135906,135906,135908,0,2,0
38791,3,1,135909,135909,135910,0,1,1
38792,1,1,135910,135910,135911,0,1,0
38793,1,2,135911,135911,135913,0,2,0
38794,4,3,135915,135915,135918,0,3,2
38795,4,2,135919,135919,135921,0,2,1
38796,5,2,135924,135924,135926,0,2,3
38797,4,2,135928,135928,135930,0,2,2
38798,5,3,135933,135933,135936,0,3,3
38799,6,1,135939,135939,135940,0,1,3
38800,2,2,135941,135941,135943,0,2,1
38801,4,1,135945,135945,135946,0,1,2
38802,1,1,135946,135946,135947,0,1,0
38803,2,3,135948,135948,135951,0,3,1
38804,2,2,135950,135951,135953,1,3,0
38805,1,2,135951,135953,135955,2,4,0
38806,2,3,135953,135955,135958,2,5,0
38807,1,3,135954,135958,135961,4,7,0
38808,6,3,135960,135961,135964,1,4,0
38809,6,2,135966,135966,135968,0,2,2
38810,5,1,135971,135971,135972,0,1,3
38811,3,3,135974,135974,135977,0,3,2
38812,6,2,135980,135980,135982,0,2,3
38813,4,2,135984,135984,135986,0,2,2
38814,1,3,135985,135986,135989,1,4,0
38815,5,3,135990,135990,135993,0,3,1
38816,3,3,135993,135993,135996,0,3,0
38817,4,2,135997,135997,135999,0,2,1
38818,3,2,136000,136000,136002,0,2,1
38819,1,2,136001,136002,136004,1,3,0
38820,1,2,136002,136004,136006,2,4,0
38821,6,2,136008,136008,136010,0,2,2
38822,2,1,136010,136010,136011,0,1,0
38823,1,1,136011,136011,136012,0,1,0
38824,1,1,136012,136012,136013,0,1,0
38825,6,1,136018,136018,136019,0,1,5
38826,6,2,136024,136024,136026,0,2,5
38827,2,3,136026,136026,136029,0,3,0
38828,6,3,136032,136032,136035,0,3,3
38829,2,3,136034,136035,136038,1,4,0
38830,6,3,136040,136040,136043,0,3,2
38831,3,1,136043,136043,136044,0,1,0
38832,2,1,136045,136045,136046,0,1,1
38833,6,1,136051,136051,136052,0,1,5
38834,5,3,136056,136056,136059,0,3,4
38835,4,1,136060,136060,136061,0,1,1
38836,5,2,136065,136065,136067,0,2,4
38837,5,1,136070,136070,136071,0,1,3
38838,1,1,136071,136071,136072,0,1,0
38839,6,2,136077,136077,136079,0,2,5
38840,6,1,136083,136083,136084,0,1,4
38841,5,3,136088,136088,136091,0,3,4
38842,1,2,136089,136091,136093,2,4,0
38843,5,3,136094,136094,136097,0,3,1
38844,6,2,136100,136100,136102,0,2,3
38845,2,1,136102,136102,136103,0,1,0
38846,3,2,136105,136105,136107,0,2,2
38847,3,1,136108,136108,136109,0,1,1
38848,3,2,136111,136111,136113,0,2,2
38849,6,1,136117,136117,136118,0,1,4
38850,2,3,136119,136119,136122,0,3,1
38851,4,3,136123,136123,136126,0,3,1
38852,4,1,136127,136127,136128,0,1,1
38853,2,2,136129,136129,136131,0,2,1
38854,4,3,136133,136133,136136,0,3,2
38855,3,2,136136,136136,136138,0,2,0
38856,4,2,136140,136140,136142,0,2,2
38857,3,2,136143,136143,136145,0,2,1
38858,2,3,136145,136145,136148,0,3,0
38859,6,1,136151,136151,136152,0,1,3
38860,5,2,136156,136156,136158,0,2,4
38861,6,3,136162,136162,136165,0,3,4
38862,6,3,136168,136168,136171,0,3,3
38863,3,1,136171,136171,136172,0,1,0
38864,3,2,136174,136174,136176,0,2,2
38865,1,2,136175,136176,136178,1,3,0
38866,2,3,136177,136178,136181,1,4,0
38867,3,2,136180,136181,136183,1,3,0
38868,6,3,136186,136186,136189,0,3,3
38869,2,3,136188,136189,136192,1,4,0
38870,3,2,136191,136192,136194,1,3,0
38871,5,1,136196,136196,136197,0,1,2
38872,1,1,136197,136197,136198,0,1,0
38873,6,1,136203,136203,136204,0,1,5
38874,6,2,136209,136209,136211,0,2,5
38875,2,1,136211,136211,136212,0,1,0
38876,2,3,136213,136213,136216,0,3,1
38877,1,1,136214,136216,136217,2,3,0
38878,6,2,136220,136220,136222,0,2,3
38879,5,2,136225,136225,136227,0,2,3
38880,6,2,136231,136231,136233,0,2,4
38881,3,3,136234,136234,136237,0,3,1
38882,4,1,136238,136238,136239,0,1,1
38883,3,2,136241,136241,136243,0,2,2
38884,5,1,136246,136246,136247,0,1,3
38885,3,3,136249,136249,136252,0,3,2
38886,2,3,136251,136252,136255,1,4,0
38887,3,3,136254,136255,136258,1,4,0
38888,3,1,136257,136258,136259,1,2,0
38889,3,1,136260,136260,136261,0,1,1
38890,6,1,136266,136266,136267,0,1,5
38891,5,3,136271,136271,136274,0,3,4
38892,3,1,136274,136274,136275,0,1,0
38893,5,1,136279,136279,136280,0,1,4
38894,6,1,136285,136285,136286,0,1,5
38895,3,3,136288,136288,136291,0,3,2
38896,1,3,136289,136291,136294,2,5,0
38897,2,1,136291,136294,136295,3,4,0
38898,6,3,136297,136297,136300,0,3,2
38899,1,2,136298,136300,136302,2,4,0
38900,1,3,136299,136302,136305,3,6,0
38901,5,3,136304,136305,136308,1,4,0
38902,5,1,136309,136309,136310,0,1,1
38903,4,3,136313,136313,136316,0,3,3
38904,2,3,136315,136316,136319,1,4,0
38905,2,2,136317,136319,136321,2,4,0
38906,6,1,136323,136323,136324,0,1,2
38907,6,3,136329,136329,136332,0,3,5
38908,6,2,136335,136335,136337,0,2,3
38909,5,3,136340,136340,136343,0,3,3
38910,3,2,136343,136343,136345,0,2,0
38911,3,1,136346,136346,136347,0,1,1
38912,5,1,136351,136351,136352,0,1,4
38913,6,1,136357,136357,136358,0,1,5
38914,5,2,136362,136362,136364,0,2,4
38915,5,2,136367,136367,136369,0,2,3
38916,1,1,136368,136369,136370,1,2,0
38917,2,1,136370,136370,136371,0,1,0
38918,3,2,136373,136373,136375,0,2,2
38919,6,2,136379,136379,136381,0,2,4
38920,5,3,136384,136384,136387,0,3,3
38921,1,1,136385,136387,136388,2,3,0
38922,6,1,136391,136391,136392,0,1,3
38923,4,1,136395,136395,136396,0,1,3
38924,3,1,136398,136398,136399,0,1,2
38925,6,3,136404,136404,136407,0,3,5
38926,3,2,136407,136407,136409,0,2,0
38927,2,3,136409,136409,136412,0,3,0
38928,4,2,136413,136413,136415,0,2,1
38929,6,3,136419,136419,136422,0,3,4
38930,4,3,136423,136423,136426,0,3,1
38931,4,3,136427,136427,136430,0,3,1
38932,3,2,136430,136430,136432,0,2,0
38933,2,2,136432,136432,136434,0,2,0
38934,4,2,136436,136436,136438,0,2,2
38935,5,3,136441,136441,136444,0,3,3
38936,3,3,136444,136444,136447,0,3,0
38937,1,2,136445,136447,136449,2,4,0
38938,5,2,136450,136450,136452,0,2,1
38939,2,3,136452,136452,136455,0,3,0
38940,4,3,136456,136456,136459,0,3,1
38941,6,2,136462,136462,136464,0,2,3
38942,2,2,136464,136464,136466,0,2,0
38943,3,2,136467,136467,136469,0,2,1
38944,2,3,136469,136469,136472,0,3,0
38945,4,1,136473,136473,136474,0,1,1
38946,1,3,136474,136474,136477,0,3,0
38947,6,3,136480,136480,136483,0,3,3
38948,5,1,136485,136485,136486,0,1,2
38949,4,3,136489,136489,136492,0,3,3
38950,3,2,136492,136492,136494,0,2,0
38951,6,1,136498,136498,136499,0,1,4
38952,2,2,136500,136500,136502,0,2,1
38953,6,3,136506,136506,136509,0,3,4
38954,6,1,136512,136512,136513,0,1,3
38955,4,2,136516,136516,136518,0,2,3
38956,6,3,136522,136522,136525,0,3,4
38957,6,1,136528,136528,136529,0,1,3
38958,1,2,136529,136529,136531,0,2,0
38959,4,1,136533,136533,136534,0,1,2
38960,4,2,136537,136537,136539,0,2,3
38961,5,2,136542,136542,136544,0,2,3
38962,3,2,136545,136545,136547,0,2,1
38963,5,2,136550,136550,136552,0,2,3
38964,1,1,136551,136552,136553,1,2,0
38965,3,1,136554,136554,136555,0,1,1
38966,2,2,136556,136556,136558,0,2,1
38967,3,2,136559,136559,136561,0,2,1
38968,2,2,136561,136561,136563,0,2,0
38969,3,3,136564,136564,136567,0,3,1
38970,1,1,136565,136567,136568,2,3,0
38971,4,3,136569,136569,136572,0,3,1
38972,4,2,136573,136573,136575,0,2,1
38973,3,3,136576,136576,136579,0,3,1
38974,6,3,136582,136582,136585,0,3,3
38975,2,2,136584,136585,136587,1,3,0
38976,4,2,136588,136588,136590,0,2,1
38977,6,3,136594,136594,136597,0,3,4
38978,6,2,136600,136600,136602,0,2,3
38979,5,3,136605,136605,136608,0,3,3
38980,4,2,136609,136609,136611,0,2,1
38981,2,2,136611,136611,136613,0,2,0
38982,4,2,136615,136615,136617,0,2,2
38983,6,3,136621,136621,136624,0,3,4
38984,3,2,136624,136624,136626,0,2,0
38985,2,1,136626,136626,136627,0,1,0
38986,1,1,136627,136627,136628,0,1,0
38987,4,3,136631,136631,136634,0,3,3
38988,1,2,136632,136634,136636,2,4,0
38989,2,2,136634,136636,136638,2,4,0
38990,3,1,136637,136638,136639,1,2,0
38991,6,1,136643,136643,136644,0,1,4
38992,3,1,136646,136646,136647,0,1,2
38993,6,1,136652,136652,136653,0,1,5
38994,3,3,136655,136655,136658,0,3,2
38995,4,1,136659,136659,136660,0,1,1
38996,6,3,136665,136665,136668,0,3,5
38997,3,2,136668,136668,136670,0,2,0
38998,2,3,136670,136670,136673,0,3,0
38999,6,3,136676,136676,136679,0,3,3
39000,5,1,136681,136681,136682,0,1,2
39001,2,2,136683,136683,136685,0,2,1
39002,2,2,136685,136685,136687,0,2,0
39003,1,3,136686,136687,136690,1,4,0
39004,4,2,136690,136690,136692,0,2,0
39005,6,3,136696,136696,136699,0,3,4
39006,3,3,136699,136699,136702,0,3,0
39007,2,3,136701,136702,136705,1,4,0
39008,3,2,136704,136705,136707,1,3,0
39009,1,2,136705,136707,136709,2,4,0
39010,4,2,136709,136709,136711,0,2,0
39011,4,2,136713,136713,136715,0,2,2
39012,5,1,136718,136718,136719,0,1,3
39013,3,1,136721,136721,136722,0,1,2
39014,2,1,136723,136723,136724,0,1,1
39015,5,3,136728,136728,136731,0,3,4
39016,4,2,136732,136732,136734,0,2,1
39017,4,1,136736,136736,136737,0,1,2
39018,3,3,136739,136739,136742,0,3,2
39019,1,2,136740,136742,136744,2,4,0
39020,2,3,136742,136744,136747,2,5,0
39021,2,3,136744,136747,136750,3,6,0
39022,3,3,136747,136750,136753,3,6,0
39023,6,2,136753,136753,136755,0,2,0
39024,1,2,136754,136755,136757,1,3,0
39025,1,1,136755,136757,136758,2,3,0
39026,3,2,136758,136758,136760,0,2,0
39027,4,1,136762,136762,136763,0,1,2
39028,6,3,136768,136768,136771,0,3,5
39029,3,1,136771,136771,136772,0,1,0
39030,1,2,136772,136772,136774,0,2,0
39031,4,3,136776,136776,136779,0,3,2
39032,1,1,136777,136779,136780,2,3,0
39033,4,1,136781,136781,136782,0,1,1
39034,3,1,136784,136784,136785,0,1,2
39035,4,2,136788,136788,136790,0,2,3
39036,3,3,136791,136791,136794,0,3,1
39037,1,2,136792,136794,136796,2,4,0
39038,4,1,136796,136796,136797,0,1,0
39039,2,2,136798,136798,136800,0,2,1
39040,3,2,136801,136801,136803,0,2,1
39041,6,1,136807,136807,136808,0,1,4
39042,2,3,136809,136809,136812,0,3,1
39043,1,3,136810,136812,136815,2,5,0
39044,2,2,136812,136815,136817,3,5,0
39045,4,2,136816,136817,136819,1,3,0
39046,5,2,136821,136821,136823,0,2,2
39047,5,3,136826,136826,136829,0,3,3
39048,1,2,136827,136829,136831,2,4,0
39049,6,3,136833,136833,136836,0,3,2
39050,6,2,136839,136839,136841,0,2,3
39051,3,2,136842,136842,136844,0,2,1
39052,5,3,136847,136847,136850,0,3,3
39053,5,3,136852,136852,136855,0,3,2
39054,3,2,136855,136855,136857,0,2,0
39055,6,2,136861,136861,136863,0,2,4
39056,4,1,136865,136865,136866,0,1,2
39057,5,1,136870,136870,136871,0,1,4
39058,3,2,136873,136873,136875,0,2,2
39059,2,3,136875,136875,136878,0,3,0
39060,1,3,136876,136878,136881,2,5,0
39061,1,3,136877,136881,136884,4,7,0
39062,5,3,136882,136884,136887,2,5,0
39063,1,3,136883,136887,136890,4,7,0
39064,3,1,136886,136890,136891,4,5,0
39065,2,1,136888,136891,136892,3,4,0
39066,3,1,136891,136892,136893,1,2,0
39067,3,1,136894,136894,136895,0,1,1
39068,6,1,136900,136900,136901,0,1,5
39069,2,2,136902,136902,136904,0,2,1
39070,1,1,136903,136904,136905,1,2,0
39071,1,3,136904,136905,136908,1,4,0
39072,5,1,136909,136909,136910,0,1,1
39073,6,1,136915,136915,136916,0,1,5
39074,3,3,136918,136918,136921,0,3,2
39075,2,1,136920,136921,136922,1,2,0
39076,1,3,136921,136922,136925,1,4,0
39077,3,1,136924,136925,136926,1,2,0
39078,6,3,136930,136930,136933,0,3,4
39079,5,2,136935,136935,136937,0,2,2
39080,5,2,136940,136940,136942,0,2,3
39081,1,2,136941,136942,136944,1,3,0
39082,3,3,136944,136944,136947,0,3,0
39083,2,3,136946,136947,136950,1,4,0
39084,5,1,136951,136951,136952,0,1,1
39085,4,1,136955,136955,136956,0,1,3
39086,6,2,136961,136961,136963,0,2,5
39087,3,3,136964,136964,136967,0,3,1
39088,2,2,136966,136967,136969,1,3,0
39089,4,2,136970,136970,136972,0,2,1
39090,5,2,136975,136975,136977,0,2,3
39091,6,1,136981,136981,136982,0,1,4
39092,1,2,136982,136982,136984,0,2,0
39093,6,1,136988,136988,136989,0,1,4
39094,4,3,136992,136992,136995,0,3,3
39095,5,2,136997,136997,136999,0,2,2
39096,2,3,136999,136999,137002,0,3,0
39097,5,3,137004,137004,137007,0,3,2
39098,6,3,137010,137010,137013,0,3,3
39099,5,2,137015,137015,137017,0,2,2
39100,6,1,137021,137021,137022,0,1,4
39101,2,1,137023,137023,137024,0,1,1
39102,5,3,137028,137028,137031,0,3,4
39103,2,2,137030,137031,137033,1,3,0
39104,3,2,137033,137033,137035,0,2,0
39105,6,1,137039,137039,137040,0,1,4
39106,4,1,137043,137043,137044,0,1,3
39107,1,2,137044,137044,137046,0,2,0
39108,4,3,137048,137048,137051,0,3,2
39109,1,1,137049,137051,137052,2,3,0
39110,1,3,137050,137052,137055,2,5,0
39111,1,2,137051,137055,137057,4,6,0
39112,5,3,137056,137057,137060,1,4,0
39113,3,1,137059,137060,137061,1,2,0
39114,6,3,137065,137065,137068,0,3,4
39115,2,3,137067,137068,137071,1,4,0
39116,5,1,137072,137072,137073,0,1,1
39117,5,3,137077,137077,137080,0,3,4
39118,1,1,137078,137080,137081,2,3,0
39119,4,3,137082,137082,137085,0,3,1
39120,2,3,137084,137085,137088,1,4,0
39121,6,3,137090,137090,137093,0,3,2
39122,3,1,137093,137093,137094,0,1,0
39123,6,2,137099,137099,137101,0,2,5
39124,1,1,137100,137101,137102,1,2,0
39125,1,2,137101,137102,137104,1,3,0
39126,3,1,137104,137104,137105,0,1,0
39127,3,1,137107,137107,137108,0,1,2
39128,3,2,137110,137110,137112,0,2,2
39129,6,1,137116,137116,137117,0,1,4
39130,5,1,137121,137121,137122,0,1,4
39131,6,2,137127,137127,137129,0,2,5
39132,6,3,137133,137133,137136,0,3,4
39133,3,1,137136,137136,137137,0,1,0
39134,1,1,137137,137137,137138,0,1,0
39135,1,2,137138,137138,137140,0,2,0
39136,3,3,137141,137141,137144,0,3,1
39137,3,3,137144,137144,137147,0,3,0
39138,2,2,137146,137147,137149,1,3,0
39139,1,2,137147,137149,137151,2,4,0
39140,3,1,137150,137151,137152,1,2,0
39141,6,2,137156,137156,137158,0,2,4
39142,6,3,137162,137162,137165,0,3,4
39143,2,2,137164,137165,137167,1,3,0
39144,2,2,137166,137167,137169,1,3,0
39145,5,2,137171,137171,137173,0,2,2
39146,1,1,137172,137173,137174,1,2,0
39147,3,1,137175,137175,137176,0,1,1
39148,6,1,137181,137181,137182,0,1,5
39149,2,3,137183,137183,137186,0,3,1
39150,1,2,137184,137186,137188,2,4,0
39151,4,1,137188,137188,137189,0,1,0
39152,4,3,137192,137192,137195,0,3,3
39153,5,1,137197,137197,137198,0,1,2
39154,3,2,137200,137200,137202,0,2,2
39155,1,1,137201,137202,137203,1,2,0
39156,6,2,137207,137207,137209,0,2,4
39157,5,2,137212,137212,137214,0,2,3
39158,3,3,137215,137215,137218,0,3,1
39159,2,1,137217,137218,137219,1,2,0
39160,6,2,137223,137223,137225,0,2,4
39161,6,1,137229,137229,137230,0,1,4
39162,2,1,137231,137231,137232,0,1,1
39163,2,2,137233,137233,137235,0,2,1
39164,1,3,137234,137235,137238,1,4,0
39165,3,1,137237,137238,137239,1,2,0
39166,5,3,137242,137242,137245,0,3,3
39167,2,1,137244,137245,137246,1,2,0
39168,2,1,137246,137246,137247,0,1,0
39169,6,3,137252,137252,137255,0,3,5
39170,5,1,137257,137257,137258,0,1,2
39171,6,2,137263,137263,137265,0,2,5
39172,1,3,137264,137265,137268,1,4,0
39173,3,2,137267,137268,137270,1,3,0
39174,4,1,137271,137271,137272,0,1,1
39175,6,2,137277,137277,137279,0,2,5
39176,4,1,137281,137281,137282,0,1,2
39177,4,1,137285,137285,137286,0,1,3
39178,6,3,137291,137291,137294,0,3,5
39179,6,2,137297,137297,137299,0,2,3
39180,5,2,137302,137302,137304,0,2,3
39181,5,1,137307,137307,137308,0,1,3
39182,2,2,137309,137309,137311,0,2,1
39183,2,1,137311,137311,137312,0,1,0
39184,6,2,137317,137317,137319,0,2,5
39185,3,1,137320,137320,137321,0,1,1
39186,1,2,137321,137321,137323,0,2,0
39187,2,2,137323,137323,137325,0,2,0
39188,2,3,137325,137325,137328,0,3,0
39189,1,2,137326,137328,137330,2,4,0
39190,5,1,137331,137331,137332,0,1,1
39191,1,2,137332,137332,137334,0,2,0
39192,6,2,137338,137338,137340,0,2,4
39193,6,3,137344,137344,137347,0,3,4
39194,2,2,137346,137347,137349,1,3,0
39195,4,2,137350,137350,137352,0,2,1
39196,5,1,137355,137355,137356,0,1,3
39197,4,1,137359,137359,137360,0,1,3
39198,3,2,137362,137362,137364,0,2,2
39199,1,1,137363,137364,137365,1,2,0
39200,3,1,137366,137366,137367,0,1,1
39201,2,3,137368,137368,137371,0,3,1
39202,3,3,137371,137371,137374,0,3,0
39203,3,2,137374,137374,137376,0,2,0
39204,5,1,137379,137379,137380,0,1,3
39205,5,1,137384,137384,137385,0,1,4
39206,6,1,137390,137390,137391,0,1,5
39207,6,2,137396,137396,137398,0,2,5
39208,6,3,137402,137402,137405,0,3,4
39209,2,3,137404,137405,137408,1,4,0
39210,1,1,137405,137408,137409,3,4,0
39211,4,2,137409,137409,137411,0,2,0
39212,5,3,137414,137414,137417,0,3,3
39213,5,2,137419,137419,137421,0,2,2
39214,6,2,137425,137425,137427,0,2,4
39215,6,1,137431,137431,137432,0,1,4
39216,1,3,137432,137432,137435,0,3,0
39217,2,2,137434,137435,137437,1,3,0
39218,1,3,137435,137437,137440,2,5,0
39219,6,2,137441,137441,137443,0,2,1
39220,5,3,137446,137446,137449,0,3,3
39221,1,1,137447,137449,137450,2,3,0
39222,5,2,137452,137452,137454,0,2,2
39223,6,1,137458,137458,137459,0,1,4
39224,1,2,137459,137459,137461,0,2,0
39225,1,1,137460,137461,137462,1,2,0
39226,4,3,137464,137464,137467,0,3,2
39227,6,1,137470,137470,137471,0,1,3
39228,4,2,137474,137474,137476,0,2,3
39229,4,1,137478,137478,137479,0,1,2
39230,5,1,137483,137483,137484,0,1,4
39231,3,1,137486,137486,137487,0,1,2
39232,3,3,137489,137489,137492,0,3,2
39233,5,2,137494,137494,137496,0,2,2
39234,6,3,137500,137500,137503,0,3,4
39235,3,3,137503,137503,137506,0,3,0
39236,2,1,137505,137506,137507,1,2,0
39237,2,1,137507,137507,137508,0,1,0
39238,2,1,137509,137509,137510,0,1,1
39239,1,3,137510,137510,137513,0,3,0
39240,2,2,137512,137513,137515,1,3,0
39241,2,1,137514,137515,137516,1,2,0
39242,5,3,137519,137519,137522,0,3,3
39243,6,3,137525,137525,137528,0,3,3
39244,3,3,137528,137528,137531,0,3,0
39245,6,2,137534,137534,137536,0,2,3
39246,5,3,137539,137539,137542,0,3,3
39247,5,1,137544,137544,137545,0,1,2
39248,5,2,137549,137549,137551,0,2,4
39249,2,1,137551,137551,137552,0,1,0
39250,1,3,137552,137552,137555,0,3,0
39251,1,1,137553,137555,137556,2,3,0
39252,3,2,137556,137556,137558,0,2,0
39253,6,2,137562,137562,137564,0,2,4
39254,3,1,137565,137565,137566,0,1,1
39255,5,3,137570,137570,137573,0,3,4
39256,2,3,137572,137573,137576,1,4,0
39257,4,3,137576,137576,137579,0,3,0
39258,2,3,137578,137579,137582,1,4,0
39259,4,2,137582,137582,137584,0,2,0
39260,3,1,137585,137585,137586,0,1,1
39261,5,2,137590,137590,137592,0,2,4
39262,3,1,137593,137593,137594,0,1,1
39263,6,2,137599,137599,137601,0,2,5
39264,2,3,137601,137601,137604,0,3,0
39265,6,1,137607,137607,137608,0,1,3
39266,1,2,137608,137608,137610,0,2,0
39267,4,2,137612,137612,137614,0,2,2
39268,1,2,137613,137614,137616,1,3,0
39269,1,1,137614,137616,137617,2,3,0
39270,5,3,137619,137619,137622,0,3,2
39271,6,1,137625,137625,137626,0,1,3
39272,6,3,137631,137631,137634,0,3,5
39273,4,2,137635,137635,137637,0,2,1
39274,4,2,137639,137639,137641,0,2,2
39275,4,1,137643,137643,137644,0,1,2
39276,5,2,137648,137648,137650,0,2,4
39277,6,3,137654,137654,137657,0,3,4
39278,2,3,137656,137657,137660,1,4,0
39279,4,2,137660,137660,137662,0,2,0
39280,6,1,137666,137666,137667,0,1,4
39281,6,1,137672,137672,137673,0,1,5
39282,3,2,137675,137675,137677,0,2,2
39283,4,3,137679,137679,137682,0,3,2
39284,1,2,137680,137682,137684,2,4,0
39285,3,3,137683,137684,137687,1,4,0
39286,6,2,137689,137689,137691,0,2,2
39287,1,3,137690,137691,137694,1,4,0
39288,4,2,137694,137694,137696,0,2,0
39289,3,2,137697,137697,137699,0,2,1
39290,4,3,137701,137701,137704,0,3,2
39291,5,1,137706,137706,137707,0,1,2
39292,1,3,137707,137707,137710,0,3,0
39293,2,3,137709,137710,137713,1,4,0
39294,2,3,137711,137713,137716,2,5,0
39295,2,1,137713,137716,137717,3,4,0
39296,4,2,137717,137717,137719,0,2,0
39297,2,2,137719,137719,137721,0,2,0
39298,5,2,137724,137724,137726,0,2,3
39299,6,3,137730,137730,137733,0,3,4
39300,3,1,137733,137733,137734,0,1,0
39301,4,1,137737,137737,137738,0,1,3
39302,2,1,137739,137739,137740,0,1,1
39303,3,2,137742,137742,137744,0,2,2
39304,6,2,137748,137748,137750,0,2,4
39305,3,1,137751,137751,137752,0,1,1
39306,6,3,137757,137757,137760,0,3,5
39307,4,2,137761,137761,137763,0,2,1
39308,5,3,137766,137766,137769,0,3,3
39309,5,1,137771,137771,137772,0,1,2
39310,4,2,137775,137775,137777,0,2,3
39311,4,2,137779,137779,137781,0,2,2
39312,4,3,137783,137783,137786,0,3,2
39313,4,3,137787,137787,137790,0,3,1
39314,3,2,137790,137790,137792,0,2,0
39315,6,1,137796,137796,137797,0,1,4
39316,4,1,137800,137800,137801,0,1,3
39317,2,2,137802,137802,137804,0,2,1
39318,2,1,137804,137804,137805,0,1,0
39319,3,3,137807,137807,137810,0,3,2
39320,4,2,137811,137811,137813,0,2,1
39321,2,1,137813,137813,137814,0,1,0
39322,2,3,137815,137815,137818,0,3,1
39323,2,2,137817,137818,137820,1,3,0
39324,4,3,137821,137821,137824,0,3,1
39325,3,1,137824,137824,137825,0,1,0
39326,2,3,137826,137826,137829,0,3,1
39327,6,2,137832,137832,137834,0,2,3
39328,5,3,137837,137837,137840,0,3,3
39329,2,3,137839,137840,137843,1,4,0
39330,6,2,137845,137845,137847,0,2,2
39331,3,2,137848,137848,137850,0,2,1
39332,2,1,137850,137850,137851,0,1,0
39333,6,2,137856,137856,137858,0,2,5
39334,1,3,137857,137858,137861,1,4,0
39335,4,3,137861,137861,137864,0,3,0
39336,3,3,137864,137864,137867,0,3,0
39337,4,1,137868,137868,137869,0,1,1
39338,1,1,137869,137869,137870,0,1,0
39339,3,2,137872,137872,137874,0,2,2
39340,2,3,137874,137874,137877,0,3,0
39341,4,2,137878,137878,137880,0,2,1
39342,5,2,137883,137883,137885,0,2,3
39343,3,3,137886,137886,137889,0,3,1
39344,6,3,137892,137892,137895,0,3,3
39345,3,2,137895,137895,137897,0,2,0
39346,5,2,137900,137900,137902,0,2,3
39347,5,3,137905,137905,137908,0,3,3
39348,5,2,137910,137910,137912,0,2,2
39349,1,1,137911,137912,137913,1,2,0
39350,4,1,137915,137915,137916,0,1,2
39351,1,3,137916,137916,137919,0,3,0
39352,2,2,137918,137919,137921,1,3,0
39353,2,2,137920,137921,137923,1,3,0
39354,4,3,137924,137924,137927,0,3,1
39355,4,2,137928,137928,137930,0,2,1
39356,1,2,137929,137930,137932,1,3,0
39357,6,3,137935,137935,137938,0,3,3
39358,4,3,137939,137939,137942,0,3,1
39359,3,3,137942,137942,137945,0,3,0
39360,5,2,137947,137947,137949,0,2,2
39361,6,2,137953,137953,137955,0,2,4
39362,1,2,137954,137955,137957,1,3,0
39363,1,1,137955,137957,137958,2,3,0
39364,3,1,137958,137958,137959,0,1,0
39365,3,2,137961,137961,137963,0,2,2
39366,4,1,137965,137965,137966,0,1,2
39367,6,1,137971,137971,137972,0,1,5
39368,4,2,137975,137975,137977,0,2,3
39369,2,2,137977,137977,137979,0,2,0
39370,3,3,137980,137980,137983,0,3,1
39371,6,1,137986,137986,137987,0,1,3
39372,5,2,137991,137991,137993,0,2,4
39373,2,1,137993,137993,137994,0,1,0
39374,6,3,137999,137999,138002,0,3,5
39375,6,1,138005,138005,138006,0,1,3
39376,2,1,138007,138007,138008,0,1,1
39377,4,2,138011,138011,138013,0,2,3
39378,5,3,138016,138016,138019,0,3,3
39379,6,2,138022,138022,138024,0,2,3
39380,2,3,138024,138024,138027,0,3,0
39381,6,3,138030,138030,138033,0,3,3
39382,6,3,138036,138036,138039,0,3,3
39383,5,1,138041,138041,138042,0,1,2
39384,5,3,138046,138046,138049,0,3,4
39385,2,1,138048,138049,138050,1,2,0
39386,3,1,138051,138051,138052,0,1,1
39387,3,3,138054,138054,138057,0,3,2
39388,1,3,138055,138057,138060,2,5,0
39389,4,3,138059,138060,138063,1,4,0
39390,1,3,138060,138063,138066,3,6,0
39391,5,3,138065,138066,138069,1,4,0
39392,6,2,138071,138071,138073,0,2,2
39393,4,3,138075,138075,138078,0,3,2
39394,4,1,138079,138079,138080,0,1,1
39395,5,1,138084,138084,138085,0,1,4
39396,1,1,138085,138085,138086,0,1,0
39397,2,1,138087,138087,138088,0,1,1
39398,2,2,138089,138089,138091,0,2,1
39399,1,3,138090,138091,138094,1,4,0
39400,1,1,138091,138094,138095,3,4,0
39401,4,1,138095,138095,138096,0,1,0
39402,3,1,138098,138098,138099,0,1,2
39403,3,1,138101,138101,138102,0,1,2
39404,5,1,138106,138106,138107,0,1,4
39405,6,3,138112,138112,138115,0,3,5
39406,6,1,138118,138118,138119,0,1,3
39407,3,3,138121,138121,138124,0,3,2
39408,3,2,138124,138124,138126,0,2,0
39409,1,1,138125,138126,138127,1,2,0
39410,2,2,138127,138127,138129,0,2,0
39411,6,1,138133,138133,138134,0,1,4
39412,6,1,138139,138139,138140,0,1,5
39413,6,3,138145,138145,138148,0,3,5
39414,4,3,138149,138149,138152,0,3,1
39415,2,2,138151,138152,138154,1,3,0
39416,3,1,138154,138154,138155,0,1,0
39417,1,2,138155,138155,138157,0,2,0
39418,3,3,138158,138158,138161,0,3,1
39419,4,1,138162,138162,138163,0,1,1
39420,5,1,138167,138167,138168,0,1,4
39421,3,3,138170,138170,138173,0,3,2
39422,6,1,138176,138176,138177,0,1,3
39423,3,1,138179,138179,138180,0,1,2
39424,6,3,138185,138185,138188,0,3,5
39425,6,2,138191,138191,138193,0,2,3
39426,2,1,138193,138193,138194,0,1,0
39427,4,2,138197,138197,138199,0,2,3
39428,5,3,138202,138202,138205,0,3,3
39429,5,2,138207,138207,138209,0,2,2
39430,6,3,138213,138213,138216,0,3,4
39431,1,2,138214,138216,138218,2,4,0
39432,3,2,138217,138218,138220,1,3,0
39433,3,1,138220,138220,138221,0,1,0
39434,5,1,138225,138225,138226,0,1,4
39435,2,1,138227,138227,138228,0,1,1
39436,1,3,138228,138228,138231,0,3,0
39437,5,2,138233,138233,138235,0,2,2
39438,5,3,138238,138238,138241,0,3,3
39439,6,3,138244,138244,138247,0,3,3
39440,4,3,138248,138248,138251,0,3,1
39441,5,3,138253,138253,138256,0,3,2
39442,3,1,138256,138256,138257,0,1,0
39443,3,3,138259,138259,138262,0,3,2
39444,1,3,138260,138262,138265,2,5,0
39445,5,2,138265,138265,138267,0,2,0
39446,6,2,138271,138271,138273,0,2,4
39447,4,2,138275,138275,138277,0,2,2
39448,6,1,138281,138281,138282,0,1,4
39449,4,2,138285,138285,138287,0,2,3
39450,6,3,138291,138291,138294,0,3,4
39451,1,3,138292,138294,138297,2,5,0
39452,5,3,138297,138297,138300,0,3,0
39453,5,3,138302,138302,138305,0,3,2
39454,6,2,138308,138308,138310,0,2,3
39455,1,2,138309,138310,138312,1,3,0
39456,2,1,138311,138312,138313,1,2,0
39457,3,1,138314,138314,138315,0,1,1
39458,6,2,138320,138320,138322,0,2,5
39459,5,3,138325,138325,138328,0,3,3
39460,3,2,138328,138328,138330,0,2,0
39461,3,1,138331,138331,138332,0,1,1
39462,3,1,138334,138334,138335,0,1,2
39463,6,2,138340,138340,138342,0,2,5
39464,1,1,138341,138342,138343,1,2,0
39465,5,1,138346,138346,138347,0,1,3
39466,3,1,138349,138349,138350,0,1,2
39467,6,3,138355,138355,138358,0,3,5
39468,2,2,138357,138358,138360,1,3,0
39469,2,1,138359,138360,138361,1,2,0
39470,5,2,138364,138364,138366,0,2,3
39471,5,1,138369,138369,138370,0,1,3
39472,1,3,138370,138370,138373,0,3,0
39473,5,2,138375,138375,138377,0,2,2
39474,6,2,138381,138381,138383,0,2,4
39475,1,1,138382,138383,138384,1,2,0
39476,2,2,138384,138384,138386,0,2,0
39477,5,1,138389,138389,138390,0,1,3
39478,5,3,138394,138394,138397,0,3,4
39479,6,3,138400,138400,138403,0,3,3
39480,2,1,138402,138403,138404,1,2,0
39481,5,3,138407,138407,138410,0,3,3
39482,3,3,138410,138410,138413,0,3,0
39483,2,1,138412,138413,138414,1,2,0
39484,5,3,138417,138417,138420,0,3,3
39485,4,2,138421,138421,138423,0,2,1
39486,6,1,138427,138427,138428,0,1,4
39487,5,2,138432,138432,138434,0,2,4
39488,1,1,138433,138434,138435,1,2,0
39489,1,1,138434,138435,138436,1,2,0
39490,1,3,138435,138436,138439,1,4,0
39491,1,3,138436,138439,138442,3,6,0
39492,4,2,138440,138442,138444,2,4,0
39493,1,1,138441,138444,138445,3,4,0
39494,6,2,138447,138447,138449,0,2,2
39495,2,3,138449,138449,138452,0,3,0
39496,3,2,138452,138452,138454,0,2,0
39497,5,1,138457,138457,138458,0,1,3
39498,1,2,138458,138458,138460,0,2,0
39499,4,2,138462,138462,138464,0,2,2
39500,1,1,138463,138464,138465,1,2,0
39501,4,1,138467,138467,138468,0,1,2
39502,2,1,138469,138469,138470,0,1,1
39503,2,1,138471,138471,138472,0,1,1
39504,2,3,138473,138473,138476,0,3,1
39505,1,1,138474,138476,138477,2,3,0
39506,1,3,138475,138477,138480,2,5,0
39507,2,2,138477,138480,138482,3,5,0
39508,4,1,138481,138482,138483,1,2,0
39509,6,2,138487,138487,138489,0,2,4
39510,5,1,138492,138492,138493,0,1,3
39511,4,3,138496,138496,138499,0,3,3
39512,2,2,138498,138499,138501,1,3,0
39513,4,2,138502,138502,138504,0,2,1
39514,5,1,138507,138507,138508,0,1,3
39515,1,2,138508,138508,138510,0,2,0
39516,3,2,138511,138511,138513,0,2,1
39517,3,2,138514,138514,138516,0,2,1
39518,4,3,138518,138518,138521,0,3,2
39519,2,1,138520,138521,138522,1,2,0
39520,3,1,138523,138523,138524,0,1,1
39521,5,1,138528,138528,138529,0,1,4
39522,3,1,138531,138531,138532,0,1,2
39523,3,2,138534,138534,138536,0,2,2
39524,5,1,138539,138539,138540,0,1,3
39525,5,2,138544,138544,138546,0,2,4
39526,4,3,138548,138548,138551,0,3,2
39527,5,3,138553,138553,138556,0,3,2
39528,4,1,138557,138557,138558,0,1,1
39529,5,3,138562,138562,138565,0,3,4
39530,6,2,138568,138568,138570,0,2,3
39531,3,3,138571,138571,138574,0,3,1
39532,3,3,138574,138574,138577,0,3,0
39533,2,2,138576,138577,138579,1,3,0
39534,3,1,138579,138579,138580,0,1,0
39535,2,2,138581,138581,138583,0,2,1
39536,6,3,138587,138587,138590,0,3,4
39537,6,3,138593,138593,138596,0,3,3
39538,4,1,138597,138597,138598,0,1,1
39539,5,2,138602,138602,138604,0,2,4
39540,2,1,138604,138604,138605,0,1,0
39541,3,3,138607,138607,138610,0,3,2
39542,3,1,138610,138610,138611,0,1,0
39543,6,1,138616,138616,138617,0,1,5
39544,2,3,138618,138618,138621,0,3,1
39545,6,1,138624,138624,138625,0,1,3
39546,1,1,138625,138625,138626,0,1,0
39547,1,1,138626,138626,138627,0,1,0
39548,6,3,138632,138632,138635,0,3,5
39549,4,1,138636,138636,138637,0,1,1
39550,5,2,138641,138641,138643,0,2,4
39551,1,2,138642,138643,138645,1,3,0
39552,1,3,138643,138645,138648,2,5,0
39553,6,1,138649,138649,138650,0,1,1
39554,4,1,138653,138653,138654,0,1,3
39555,3,1,138656,138656,138657,0,1,2
39556,1,3,138657,138657,138660,0,3,0
39557,6,1,138663,138663,138664,0,1,3
39558,2,2,138665,138665,138667,0,2,1
39559,3,1,138668,138668,138669,0,1,1
39560,1,3,138669,138669,138672,0,3,0
39561,6,1,138675,138675,138676,0,1,3
39562,2,3,138677,138677,138680,0,3,1
39563,6,3,138683,138683,138686,0,3,3
39564,6,2,138689,138689,138691,0,2,3
39565,2,1,138691,138691,138692,0,1,0
39566,4,2,138695,138695,138697,0,2,3
39567,6,2,138701,138701,138703,0,2,4
39568,1,3,138702,138703,138706,1,4,0
39569,3,2,138705,138706,138708,1,3,0
39570,5,3,138710,138710,138713,0,3,2
39571,3,2,138713,138713,138715,0,2,0
39572,3,3,138716,138716,138719,0,3,1
39573,5,2,138721,138721,138723,0,2,2
39574,6,1,138727,138727,138728,0,1,4
39575,4,2,138731,138731,138733,0,2,3
39576,2,3,138733,138733,138736,0,3,0
39577,6,1,138739,138739,138740,0,1,3
39578,1,3,138740,138740,138743,0,3,0
39579,2,3,138742,138743,138746,1,4,0
39580,5,2,138747,138747,138749,0,2,1
39581,4,2,138751,138751,138753,0,2,2
39582,6,1,138757,138757,138758,0,1,4
39583,4,1,138761,138761,138762,0,1,3
39584,3,2,138764,138764,138766,0,2,2
39585,2,2,138766,138766,138768,0,2,0
39586,4,1,138770,138770,138771,0,1,2
39587,2,2,138772,138772,138774,0,2,1
39588,6,2,138778,138778,138780,0,2,4
39589,5,1,138783,138783,138784,0,1,3
39590,6,3,138789,138789,138792,0,3,5
39591,5,2,138794,138794,138796,0,2,2
39592,5,2,138799,138799,138801,0,2,3
39593,2,3,138801,138801,138804,0,3,0
39594,2,3,138803,138804,138807,1,4,0
39595,5,1,138808,138808,138809,0,1,1
39596,1,2,138809,138809,138811,0,2,0
39597,3,1,138812,138812,138813,0,1,1
39598,6,1,138818,138818,138819,0,1,5
39599,5,3,138823,138823,138826,0,3,4
39600,5,1,138828,138828,138829,0,1,2
39601,2,2,138830,138830,138832,0,2,1
39602,6,2,138836,138836,138838,0,2,4
39603,1,1,138837,138838,138839,1,2,0
39604,3,2,138840,138840,138842,0,2,1
39605,3,3,138843,138843,138846,0,3,1
39606,1,3,138844,138846,138849,2,5,0
39607,6,3,138850,138850,138853,0,3,1
39608,1,3,138851,138853,138856,2,5,0
39609,6,2,138857,138857,138859,0,2,1
39610,5,2,138862,138862,138864,0,2,3
39611,2,3,138864,138864,138867,0,3,0
39612,2,1,138866,138867,138868,1,2,0
39613,5,1,138871,138871,138872,0,1,3
39614,6,2,138877,138877,138879,0,2,5
39615,4,3,138881,138881,138884,0,3,2
39616,2,2,138883,138884,138886,1,3,0
39617,6,3,138889,138889,138892,0,3,3
39618,4,1,138893,138893,138894,0,1,1
39619,3,2,138896,138896,138898,0,2,2
39620,5,2,138901,138901,138903,0,2,3
39621,3,1,138904,138904,138905,0,1,1
39622,3,1,138907,138907,138908,0,1,2
39623,2,3,138909,138909,138912,0,3,1
39624,4,2,138913,138913,138915,0,2,1
39625,6,3,138919,138919,138922,0,3,4
39626,5,3,138924,138924,138927,0,3,2
39627,4,3,138928,138928,138931,0,3,1
39628,2,2,138930,138931,138933,1,3,0
39629,5,2,138935,138935,138937,0,2,2
39630,1,3,138936,138937,138940,1,4,0
39631,4,2,138940,138940,138942,0,2,0
39632,5,3,138945,138945,138948,0,3,3
39633,6,3,138951,138951,138954,0,3,3
39634,2,3,138953,138954,138957,1,4,0
39635,1,3,138954,138957,138960,3,6,0
39636,4,1,138958,138960,138961,2,3,0
39637,4,3,138962,138962,138965,0,3,1
39638,3,3,138965,138965,138968,0,3,0
39639,1,1,138966,138968,138969,2,3,0
39640,4,2,138970,138970,138972,0,2,1
39641,2,2,138972,138972,138974,0,2,0
39642,6,1,138978,138978,138979,0,1,4
39643,2,2,138980,138980,138982,0,2,1
39644,2,1,138982,138982,138983,0,1,0
39645,3,1,138985,138985,138986,0,1,2
39646,2,1,138987,138987,138988,0,1,1
39647,6,3,138993,138993,138996,0,3,5
39648,1,1,138994,138996,138997,2,3,0
39649,2,1,138996,138997,138998,1,2,0
39650,4,1,139000,139000,139001,0,1,2
39651,5,2,139005,139005,139007,0,2,4
39652,6,1,139011,139011,139012,0,1,4
39653,1,2,139012,139012,139014,0,2,0
39654,2,2,139014,139014,139016,0,2,0
39655,2,1,139016,139016,139017,0,1,0
39656,5,1,139021,139021,139022,0,1,4
39657,1,3,139022,139022,139025,0,3,0
39658,4,3,139026,139026,139029,0,3,1
39659,5,2,139031,139031,139033,0,2,2
39660,6,1,139037,139037,139038,0,1,4
39661,1,3,139038,139038,139041,0,3,0
39662,6,2,139044,139044,139046,0,2,3
39663,6,3,139050,139050,139053,0,3,4
39664,1,1,139051,139053,139054,2,3,0
39665,2,1,139053,139054,139055,1,2,0
39666,3,3,139056,139056,139059,0,3,1
39667,4,1,139060,139060,139061,0,1,1
39668,2,1,139062,139062,139063,0,1,1
39669,1,2,139063,139063,139065,0,2,0
39670,1,1,139064,139065,139066,1,2,0
39671,4,1,139068,139068,139069,0,1,2
39672,6,1,139074,139074,139075,0,1,5
39673,4,2,139078,139078,139080,0,2,3
39674,2,1,139080,139080,139081,0,1,0
39675,3,3,139083,139083,139086,0,3,2
39676,6,3,139089,139089,139092,0,3,3
39677,6,3,139095,139095,139098,0,3,3
39678,1,2,139096,139098,139100,2,4,0
39679,1,1,139097,139100,139101,3,4,0
39680,5,3,139102,139102,139105,0,3,1
39681,5,1,139107,139107,139108,0,1,2
39682,3,1,139110,139110,139111,0,1,2
39683,1,1,139111,139111,139112,0,1,0
39684,2,2,139113,139113,139115,0,2,1
39685,2,2,139115,139115,139117,0,2,0
39686,2,1,139117,139117,139118,0,1,0
39687,3,1,139120,139120,139121,0,1,2
39688,5,1,139125,139125,139126,0,1,4
39689,6,3,139131,139131,139134,0,3,5
39690,3,3,139134,139134,139137,0,3,0
39691,5,1,139139,139139,139140,0,1,2
39692,6,1,139145,139145,139146,0,1,5
39693,2,3,139147,139147,139150,0,3,1
39694,1,3,139148,139150,139153,2,5,0
39695,4,2,139152,139153,139155,1,3,0
39696,5,3,139157,139157,139160,0,3,2
39697,6,3,139163,139163,139166,0,3,3
39698,1,2,139164,139166,139168,2,4,0
39699,4,3,139168,139168,139171,0,3,0
39700,5,2,139173,139173,139175,0,2,2
39701,2,1,139175,139175,139176,0,1,0
39702,5,2,139180,139180,139182,0,2,4
39703,4,1,139184,139184,139185,0,1,2
39704,6,2,139190,139190,139192,0,2,5
39705,2,2,139192,139192,139194,0,2,0
39706,5,2,139197,139197,139199,0,2,3
39707,2,3,139199,139199,139202,0,3,0
39708,3,1,139202,139202,139203,0,1,0
39709,5,2,139207,139207,139209,0,2,4
39710,2,1,139209,139209,139210,0,1,0
39711,4,2,139213,139213,139215,0,2,3
39712,6,2,139219,139219,139221,0,2,4
39713,1,2,139220,139221,139223,1,3,0
39714,5,3,139225,139225,139228,0,3,2
39715,3,1,139228,139228,139229,0,1,0
39716,2,1,139230,139230,139231,0,1,1
39717,2,1,139232,139232,139233,0,1,1
39718,5,3,139237,139237,139240,0,3,4
39719,3,1,139240,139240,139241,0,1,0
39720,3,2,139243,139243,139245,0,2,2
39721,4,2,139247,139247,139249,0,2,2
39722,4,3,139251,139251,139254,0,3,2
39723,5,2,139256,139256,139258,0,2,2
39724,3,2,139259,139259,139261,0,2,1
39725,5,2,139264,139264,139266,0,2,3
39726,3,2,139267,139267,139269,0,2,1
39727,1,3,139268,139269,139272,1,4,0
39728,1,3,139269,139272,139275,3,6,0
39729,6,2,139275,139275,139277,0,2,0
39730,3,1,139278,139278,139279,0,1,1
39731,5,3,139283,139283,139286,0,3,4
39732,3,2,139286,139286,139288,0,2,0
39733,5,2,139291,139291,139293,0,2,3
39734,1,2,139292,139293,139295,1,3,0
39735,2,1,139294,139295,139296,1,2,0
39736,4,2,139298,139298,139300,0,2,2
39737,3,1,139301,139301,139302,0,1,1
39738,1,1,139302,139302,139303,0,1,0
39739,6,3,139308,139308,139311,0,3,5
39740,5,2,139313,139313,139315,0,2,2
39741,1,3,139314,139315,139318,1,4,0
39742,2,2,139316,139318,139320,2,4,0
39743,5,1,139321,139321,139322,0,1,1
39744,5,3,139326,139326,139329,0,3,4
39745,3,1,139329,139329,139330,0,1,0
39746,5,3,139334,139334,139337,0,3,4
39747,1,2,139335,139337,139339,2,4,0
39748,2,2,139337,139339,139341,2,4,0
39749,3,3,139340,139341,139344,1,4,0
39750,1,2,139341,139344,139346,3,5,0
39751,4,1,139345,139346,139347,1,2,0
39752,5,2,139350,139350,139352,0,2,3
39753,6,3,139356,139356,139359,0,3,4
39754,4,1,139360,139360,139361,0,1,1
39755,2,1,139362,139362,139363,0,1,1
39756,6,1,139368,139368,139369,0,1,5
39757,1,1,139369,139369,139370,0,1,0
39758,3,2,139372,139372,139374,0,2,2
39759,6,3,139378,139378,139381,0,3,4
39760,2,3,139380,139381,139384,1,4,0
39761,2,2,139382,139384,139386,2,4,0
39762,1,3,139383,139386,139389,3,6,0
39763,2,2,139385,139389,139391,4,6,0
39764,2,3,139387,139391,139394,4,7,0
39765,6,3,139393,139394,139397,1,4,0
39766,1,3,139394,139397,139400,3,6,0
39767,3,1,139397,139400,139401,3,4,0
39768,5,3,139402,139402,139405,0,3,1
39769,3,1,139405,139405,139406,0,1,0
39770,1,3,139406,139406,139409,0,3,0
39771,4,1,139410,139410,139411,0,1,1
39772,3,2,139413,139413,139415,0,2,2
39773,1,1,139414,139415,139416,1,2,0
39774,2,1,139416,139416,139417,0,1,0
39775,4,1,139420,139420,139421,0,1,3
39776,5,2,139425,139425,139427,0,2,4
39777,2,3,139427,139427,139430,0,3,0
39778,5,2,139432,139432,139434,0,2,2
39779,1,2,139433,139434,139436,1,3,0
39780,4,3,139437,139437,139440,0,3,1
39781,1,2,139438,139440,139442,2,4,0
39782,2,3,139440,139442,139445,2,5,0
39783,2,1,139442,139445,139446,3,4,0
39784,5,3,139447,139447,139450,0,3,1
39785,4,2,139451,139451,139453,0,2,1
39786,6,1,139457,139457,139458,0,1,4
39787,4,3,139461,139461,139464,0,3,3
39788,5,3,139466,139466,139469,0,3,2
39789,3,2,139469,139469,139471,0,2,0
39790,4,2,139473,139473,139475,0,2,2
39791,6,2,139479,139479,139481,0,2,4
39792,2,2,139481,139481,139483,0,2,0
39793,2,2,139483,139483,139485,0,2,0
39794,2,1,139485,139485,139486,0,1,0
39795,1,1,139486,139486,139487,0,1,0
39796,5,3,139491,139491,139494,0,3,4
39797,2,2,139493,139494,139496,1,3,0
39798,1,3,139494,139496,139499,2,5,0
39799,1,3,139495,139499,139502,4,7,0
39800,4,1,139499,139502,139503,3,4,0
39801,3,3,139502,139503,139506,1,4,0
39802,5,2,139507,139507,139509,0,2,1
39803,1,3,139508,139509,139512,1,4,0
39804,6,2,139514,139514,139516,0,2,2
39805,6,3,139520,139520,139523,0,3,4
39806,1,2,139521,139523,139525,2,4,0
39807,2,2,139523,139525,139527,2,4,0
39808,4,2,139527,139527,139529,0,2,0
39809,6,1,139533,139533,139534,0,1,4
39810,1,3,139534,139534,139537,0,3,0
39811,1,1,139535,139537,139538,2,3,0
39812,1,3,139536,139538,139541,2,5,0
39813,2,1,139538,139541,139542,3,4,0
39814,2,1,139540,139542,139543,2,3,0
39815,3,3,139543,139543,139546,0,3,0
39816,3,1,139546,139546,139547,0,1,0
39817,5,1,139551,139551,139552,0,1,4
39818,6,1,139557,139557,139558,0,1,5
39819,6,2,139563,139563,139565,0,2,5
39820,3,3,139566,139566,139569,0,3,1
39821,3,1,139569,139569,139570,0,1,0
39822,3,1,139572,139572,139573,0,1,2
39823,6,2,139578,139578,139580,0,2,5
39824,1,1,139579,139580,139581,1,2,0
39825,6,3,139585,139585,139588,0,3,4
39826,3,2,139588,139588,139590,0,2,0
39827,5,1,139593,139593,139594,0,1,3
39828,4,1,139597,139597,139598,0,1,3
39829,2,3,139599,139599,139602,0,3,1
39830,4,3,139603,139603,139606,0,3,1
39831,4,3,139607,139607,139610,0,3,1
39832,5,1,139612,139612,139613,0,1,2
39833,5,1,139617,139617,139618,0,1,4
39834,6,3,139623,139623,139626,0,3,5
39835,2,1,139625,139626,139627,1,2,0
39836,1,3,139626,139627,139630,1,4,0
39837,1,2,139627,139630,139632,3,5,0
39838,2,2,139629,139632,139634,3,5,0
39839,2,1,139631,139634,139635,3,4,0
39840,3,2,139634,139635,139637,1,3,0
39841,4,1,139638,139638,139639,0,1,1
39842,1,3,139639,139639,139642,0,3,0
39843,4,3,139643,139643,139646,0,3,1
39844,5,2,139648,139648,139650,0,2,2
39845,4,3,139652,139652,139655,0,3,2
39846,1,1,139653,139655,139656,2,3,0
39847,3,1,139656,139656,139657,0,1,0
39848,6,1,139662,139662,139663,0,1,5
39849,5,1,139667,139667,139668,0,1,4
39850,1,1,139668,139668,139669,0,1,0
39851,3,1,139671,139671,139672,0,1,2
39852,3,3,139674,139674,139677,0,3,2
39853,4,3,139678,139678,139681,0,3,1
39854,1,1,139679,139681,139682,2,3,0
39855,4,1,139683,139683,139684,0,1,1
39856,6,3,139689,139689,139692,0,3,5
39857,6,1,139695,139695,139696,0,1,3
39858,4,3,139699,139699,139702,0,3,3
39859,4,2,139703,139703,139705,0,2,1
39860,5,3,139708,139708,139711,0,3,3
39861,1,1,139709,139711,139712,2,3,0
39862,6,3,139715,139715,139718,0,3,3
39863,1,1,139716,139718,139719,2,3,0
39864,2,3,139718,139719,139722,1,4,0
39865,3,1,139721,139722,139723,1,2,0
39866,5,2,139726,139726,139728,0,2,3
39867,6,3,139732,139732,139735,0,3,4
39868,2,2,139734,139735,139737,1,3,0
39869,4,2,139738,139738,139740,0,2,1
39870,4,1,139742,139742,139743,0,1,2
39871,3,3,139745,139745,139748,0,3,2
39872,1,2,139746,139748,139750,2,4,0
39873,6,3,139752,139752,139755,0,3,2
39874,6,3,139758,139758,139761,0,3,3
39875,6,1,139764,139764,139765,0,1,3
39876,2,3,139766,139766,139769,0,3,1
39877,3,3,139769,139769,139772,0,3,0
39878,3,2,139772,139772,139774,0,2,0
39879,1,3,139773,139774,139777,1,4,0
39880,4,2,139777,139777,139779,0,2,0
39881,2,1,139779,139779,139780,0,1,0
39882,2,1,139781,139781,139782,0,1,1
39883,1,3,139782,139782,139785,0,3,0
39884,5,2,139787,139787,139789,0,2,2
39885,6,1,139793,139793,139794,0,1,4
39886,2,3,139795,139795,139798,0,3,1
39887,4,1,139799,139799,139800,0,1,1
39888,5,2,139804,139804,139806,0,2,4
39889,4,3,139808,139808,139811,0,3,2
39890,1,1,139809,139811,139812,2,3,0
39891,5,3,139814,139814,139817,0,3,2
39892,6,3,139820,139820,139823,0,3,3
39893,5,3,139825,139825,139828,0,3,2
39894,6,3,139831,139831,139834,0,3,3
39895,6,1,139837,139837,139838,0,1,3
39896,5,3,139842,139842,139845,0,3,4
39897,5,2,139847,139847,139849,0,2,2
39898,5,3,139852,139852,139855,0,3,3
39899,6,2,139858,139858,139860,0,2,3
39900,6,2,139864,139864,139866,0,2,4
39901,2,2,139866,139866,139868,0,2,0
39902,4,2,139870,139870,139872,0,2,2
39903,1,3,139871,139872,139875,1,4,0
39904,3,2,139874,139875,139877,1,3,0
39905,3,2,139877,139877,139879,0,2,0
39906,5,1,139882,139882,139883,0,1,3
39907,6,3,139888,139888,139891,0,3,5
39908,4,2,139892,139892,139894,0,2,1
39909,2,1,139894,139894,139895,0,1,0
39910,5,1,139899,139899,139900,0,1,4
39911,4,3,139903,139903,139906,0,3,3
39912,3,2,139906,139906,139908,0,2,0
39913,5,2,139911,139911,139913,0,2,3
39914,1,1,139912,139913,139914,1,2,0
39915,5,1,139917,139917,139918,0,1,3
39916,1,1,139918,139918,139919,0,1,0
39917,3,1,139921,139921,139922,0,1,2
39918,6,1,139927,139927,139928,0,1,5
39919,4,1,139931,139931,139932,0,1,3
39920,3,1,139934,139934,139935,0,1,2
39921,3,3,139937,139937,139940,0,3,2
39922,2,3,139939,139940,139943,1,4,0
39923,1,2,139940,139943,139945,3,5,0
39924,5,2,139945,139945,139947,0,2,0
39925,5,1,139950,139950,139951,0,1,3
39926,4,1,139954,139954,139955,0,1,3
39927,1,2,139955,139955,139957,0,2,0
39928,3,1,139958,139958,139959,0,1,1
39929,5,1,139963,139963,139964,0,1,4
39930,6,1,139969,139969,139970,0,1,5
39931,3,1,139972,139972,139973,0,1,2
39932,3,3,139975,139975,139978,0,3,2
39933,3,1,139978,139978,139979,0,1,0
39934,1,3,139979,139979,139982,0,3,0
39935,4,2,139983,139983,139985,0,2,1
39936,4,3,139987,139987,139990,0,3,2
39937,2,2,139989,139990,139992,1,3,0
39938,2,2,139991,139992,139994,1,3,0
39939,3,1,139994,139994,139995,0,1,0
39940,1,3,139995,139995,139998,0,3,0
39941,1,1,139996,139998,139999,2,3,0
39942,4,2,140000,140000,140002,0,2,1
39943,1,1,140001,140002,140003,1,2,0
39944,2,1,140003,140003,140004,0,1,0
39945,4,1,140007,140007,140008,0,1,3
39946,3,2,140010,140010,140012,0,2,2
39947,2,2,140012,140012,140014,0,2,0
39948,1,1,140013,140014,140015,1,2,0
39949,4,1,140017,140017,140018,0,1,2
39950,4,3,140021,140021,140024,0,3,3
39951,6,2,140027,140027,140029,0,2,3
39952,6,3,140033,140033,140036,0,3,4
39953,3,2,140036,140036,140038,0,2,0
39954,2,3,140038,140038,140041,0,3,0
39955,3,1,140041,140041,140042,0,1,0
39956,3,3,140044,140044,140047,0,3,2
39957,4,1,140048,140048,140049,0,1,1
39958,1,3,140049,140049,140052,0,3,0
39959,4,2,140053,140053,140055,0,2,1
39960,2,3,140055,140055,140058,0,3,0
39961,3,3,140058,140058,140061,0,3,0
39962,5,2,140063,140063,140065,0,2,2
39963,1,3,140064,140065,140068,1,4,0
39964,5,3,140069,140069,140072,0,3,1
39965,5,3,140074,140074,140077,0,3,2
39966,2,2,140076,140077,140079,1,3,0
39967,6,2,140082,140082,140084,0,2,3
39968,3,1,140085,140085,140086,0,1,1
39969,5,1,140090,140090,140091,0,1,4
39970,3,1,140093,140093,140094,0,1,2
39971,2,3,140095,140095,140098,0,3,1
39972,3,2,140098,140098,140100,0,2,0
39973,6,2,140104,140104,140106,0,2,4
39974,4,2,140108,140108,140110,0,2,2
39975,2,1,140110,140110,140111,0,1,0
39976,1,1,140111,140111,140112,0,1,0
39977,3,3,140114,140114,140117,0,3,2
39978,3,3,140117,140117,140120,0,3,0
39979,4,1,140121,140121,140122,0,1,1
39980,1,2,140122,140122,140124,0,2,0
39981,6,2,140128,140128,140130,0,2,4
39982,5,1,140133,140133,140134,0,1,3
39983,2,2,140135,140135,140137,0,2,1
39984,2,2,140137,140137,140139,0,2,0
39985,2,3,140139,140139,140142,0,3,0
39986,1,1,140140,140142,140143,2,3,0
39987,5,1,140145,140145,140146,0,1,2
39988,3,1,140148,140148,140149,0,1,2
39989,4,1,140152,140152,140153,0,1,3
39990,1,1,140153,140153,140154,0,1,0
39991,1,3,140154,140154,140157,0,3,0
39992,1,2,140155,140157,140159,2,4,0
39993,1,3,140156,140159,140162,3,6,0
39994,6,1,140162,140162,140163,0,1,0
39995,4,3,140166,140166,140169,0,3,3
39996,2,3,140168,140169,140172,1,4,0
39997,1,1,140169,140172,140173,3,4,0
39998,3,1,140172,140173,140174,1,2,0
39999,1,3,140173,140174,140177,1,4,0
40000,6,3,140179,140179,140182,0,3,2
40001,5,3,140184,140184,140187,0,3,2
40002,6,3,140190,140190,140193,0,3,3
40003,4,3,140194,140194,140197,0,3,1
40004,5,1,140199,140199,140200,0,1,2
40005,1,1,140200,140200,140201,0,1,0
40006,3,1,140203,140203,140204,0,1,2
40007,3,2,140206,140206,140208,0,2,2
40008,6,2,140212,140212,140214,0,2,4
40009,3,2,140215,140215,140217,0,2,1
40010,1,1,140216,140217,140218,1,2,0
40011,1,3,140217,140218,140221,1,4,0
40012,2,2,140219,140221,140223,2,4,0
40013,4,2,140223,140223,140225,0,2,0
40014,6,1,140229,140229,140230,0,1,4
40015,1,2,140230,140230,140232,0,2,0
40016,3,1,140233,140233,140234,0,1,1
40017,4,1,140237,140237,140238,0,1,3
40018,4,3,140241,140241,140244,0,3,3
40019,2,1,140243,140244,140245,1,2,0
40020,2,3,140245,140245,140248,0,3,0
40021,1,2,140246,140248,140250,2,4,0
40022,6,3,140252,140252,140255,0,3,2
40023,2,3,140254,140255,140258,1,4,0
40024,3,2,140257,140258,140260,1,3,0
40025,2,3,140259,140260,140263,1,4,0
40026,4,1,140263,140263,140264,0,1,0
40027,2,2,140265,140265,140267,0,2,1
40028,2,1,140267,140267,140268,0,1,0
40029,5,1,140272,140272,140273,0,1,4
40030,6,2,140278,140278,140280,0,2,5
40031,4,2,140282,140282,140284,0,2,2
40032,5,3,140287,140287,140290,0,3,3
40033,1,3,140288,140290,140293,2,5,0
40034,3,2,140291,140293,140295,2,4,0
40035,2,1,140293,140295,140296,2,3,0
40036,4,3,140297,140297,140300,0,3,1
40037,3,2,140300,140300,140302,0,2,0
40038,6,1,140306,140306,140307,0,1,4
40039,3,3,140309,140309,140312,0,3,2
40040,4,1,140313,140313,140314,0,1,1
40041,3,2,140316,140316,140318,0,2,2
40042,4,2,140320,140320,140322,0,2,2
40043,6,3,140326,140326,140329,0,3,4
40044,3,1,140329,140329,140330,0,1,0
40045,4,3,140333,140333,140336,0,3,3
40046,3,3,140336,140336,140339,0,3,0
40047,2,1,140338,140339,140340,1,2,0
40048,3,2,140341,140341,140343,0,2,1
40049,4,1,140345,140345,140346,0,1,2
40050,6,2,140351,140351,140353,0,2,5
40051,4,3,140355,140355,140358,0,3,2
40052,2,1,140357,140358,140359,1,2,0
40053,3,2,140360,140360,140362,0,2,1
40054,3,2,140363,140363,140365,0,2,1
40055,4,1,140367,140367,140368,0,1,2
40056,4,2,140371,140371,140373,0,2,3
40057,4,2,140375,140375,140377,0,2,2
40058,4,2,140379,140379,140381,0,2,2
40059,4,2,140383,140383,140385,0,2,2
40060,2,2,140385,140385,140387,0,2,0
40061,2,2,140387,140387,140389,0,2,0
40062,5,3,140392,140392,140395,0,3,3
40063,4,3,140396,140396,140399,0,3,1
40064,4,2,140400,140400,140402,0,2,1
40065,1,3,140401,140402,140405,1,4,0
40066,3,3,140404,140405,140408,1,4,0
40067,6,2,140410,140410,140412,0,2,2
40068,2,1,140412,140412,140413,0,1,0
40069,3,3,140415,140415,140418,0,3,2
40070,6,3,140421,140421,140424,0,3,3
40071,3,3,140424,140424,140427,0,3,0
40072,5,2,140429,140429,140431,0,2,2
40073,5,2,140434,140434,140436,0,2,3
40074,5,1,140439,140439,140440,0,1,3
40075,5,1,140444,140444,140445,0,1,4
40076,5,3,140449,140449,140452,0,3,4
40077,3,1,140452,140452,140453,0,1,0
40078,2,2,140454,140454,140456,0,2,1
40079,5,2,140459,140459,140461,0,2,3
40080,5,2,140464,140464,140466,0,2,3
40081,5,1,140469,140469,140470,0,1,3
40082,3,3,140472,140472,140475,0,3,2
40083,5,3,140477,140477,140480,0,3,2
40084,6,1,140483,140483,140484,0,1,3
40085,4,1,140487,140487,140488,0,1,3
40086,5,3,140492,140492,140495,0,3,4
40087,1,3,140493,140495,140498,2,5,0
40088,3,3,140496,140498,140501,2,5,0
40089,6,1,140502,140502,140503,0,1,1
40090,6,2,140508,140508,140510,0,2,5
40091,6,2,140514,140514,140516,0,2,4
40092,6,2,140520,140520,140522,0,2,4
40093,6,1,140526,140526,140527,0,1,4
40094,5,2,140531,140531,140533,0,2,4
40095,4,2,140535,140535,140537,0,2,2
40096,5,2,140540,140540,140542,0,2,3
40097,5,1,140545,140545,140546,0,1,3
40098,2,3,140547,140547,140550,0,3,1
40099,5,2,140552,140552,140554,0,2,2
40100,3,1,140555,140555,140556,0,1,1
40101,5,2,140560,140560,140562,0,2,4
40102,5,1,140565,140565,140566,0,1,3
40103,6,1,140571,140571,140572,0,1,5
40104,5,3,140576,140576,140579,0,3,4
40105,4,2,140580,140580,140582,0,2,1
40106,2,1,140582,140582,140583,0,1,0
40107,3,1,140585,140585,140586,0,1,2
40108,4,1,140589,140589,140590,0,1,3
40109,6,3,140595,140595,140598,0,3,5
40110,3,2,140598,140598,140600,0,2,0
40111,2,2,140600,140600,140602,0,2,0
40112,3,1,140603,140603,140604,0,1,1
40113,6,3,140609,140609,140612,0,3,5
40114,6,1,140615,140615,140616,0,1,3
40115,3,2,140618,140618,140620,0,2,2
40116,6,2,140624,140624,140626,0,2,4
40117,1,3,140625,140626,140629,1,4,0
40118,6,2,140631,140631,140633,0,2,2
40119,5,1,140636,140636,140637,0,1,3
40120,3,2,140639,140639,140641,0,2,2
40121,1,3,140640,140641,140644,1,4,0
40122,5,3,140645,140645,140648,0,3,1
40123,5,3,140650,140650,140653,0,3,2
40124,6,2,140656,140656,140658,0,2,3
40125,5,2,140661,140661,140663,0,2,3
40126,3,2,140664,140664,140666,0,2,1
40127,5,2,140669,140669,140671,0,2,3
40128,1,2,140670,140671,140673,1,3,0
40129,2,3,140672,140673,140676,1,4,0
40130,5,1,140677,140677,140678,0,1,1
40131,6,2,140683,140683,140685,0,2,5
40132,6,1,140689,140689,140690,0,1,4
40133,4,2,140693,140693,140695,0,2,3
40134,3,3,140696,140696,140699,0,3,1
40135,6,3,140702,140702,140705,0,3,3
40136,3,2,140705,140705,140707,0,2,0
40137,2,3,140707,140707,140710,0,3,0
40138,2,1,140709,140710,140711,1,2,0
40139,6,3,140715,140715,140718,0,3,4
40140,3,1,140718,140718,140719,0,1,0
40141,6,1,140724,140724,140725,0,1,5
40142,3,3,140727,140727,140730,0,3,2
40143,2,1,140729,140730,140731,1,2,0
40144,1,1,140730,140731,140732,1,2,0
40145,5,1,140735,140735,140736,0,1,3
40146,4,2,140739,140739,140741,0,2,3
40147,3,2,140742,140742,140744,0,2,1
40148,3,2,140745,140745,140747,0,2,1
40149,6,1,140751,140751,140752,0,1,4
40150,3,3,140754,140754,140757,0,3,2
40151,6,1,140760,140760,140761,0,1,3
40152,5,3,140765,140765,140768,0,3,4
40153,6,2,140771,140771,140773,0,2,3
40154,1,2,140772,140773,140775,1,3,0
40155,4,1,140776,140776,140777,0,1,1
40156,3,1,140779,140779,140780,0,1,2
40157,6,2,140785,140785,140787,0,2,5
40158,1,3,140786,140787,140790,1,4,0
40159,3,2,140789,140790,140792,1,3,0
40160,6,1,140795,140795,140796,0,1,3
40161,4,2,140799,140799,140801,0,2,3
40162,1,1,140800,140801,140802,1,2,0
40163,3,1,140803,140803,140804,0,1,1
40164,4,3,140807,140807,140810,0,3,3
40165,6,1,140813,140813,140814,0,1,3
40166,2,2,140815,140815,140817,0,2,1
40167,5,2,140820,140820,140822,0,2,3
40168,5,2,140825,140825,140827,0,2,3
40169,1,3,140826,140827,140830,1,4,0
40170,3,2,140829,140830,140832,1,3,0
40171,2,3,140831,140832,140835,1,4,0
40172,3,3,140834,140835,140838,1,4,0
40173,1,2,140835,140838,140840,3,5,0
40174,3,1,140838,140840,140841,2,3,0
40175,6,1,140844,140844,140845,0,1,3
40176,6,1,140850,140850,140851,0,1,5
40177,1,1,140851,140851,140852,0,1,0
40178,4,3,140855,140855,140858,0,3,3
40179,1,3,140856,140858,140861,2,5,0
40180,6,3,140862,140862,140865,0,3,1
40181,6,3,140868,140868,140871,0,3,3
40182,1,3,140869,140871,140874,2,5,0
40183,1,2,140870,140874,140876,4,6,0
40184,3,1,140873,140876,140877,3,4,0
40185,6,1,140879,140879,140880,0,1,2
40186,3,1,140882,140882,140883,0,1,2
40187,5,1,140887,140887,140888,0,1,4
40188,1,3,140888,140888,140891,0,3,0
40189,5,1,140893,140893,140894,0,1,2
40190,5,3,140898,140898,140901,0,3,4
40191,4,1,140902,140902,140903,0,1,1
40192,4,3,140906,140906,140909,0,3,3
40193,1,3,140907,140909,140912,2,5,0
40194,1,1,140908,140912,140913,4,5,0
40195,2,3,140910,140913,140916,3,6,0
40196,6,3,140916,140916,140919,0,3,0
40197,5,1,140921,140921,140922,0,1,2
40198,1,2,140922,140922,140924,0,2,0
40199,3,3,140925,140925,140928,0,3,1
40200,6,1,140931,140931,140932,0,1,3
40201,1,1,140932,140932,140933,0,1,0
40202,3,1,140935,140935,140936,0,1,2
40203,3,3,140938,140938,140941,0,3,2
40204,6,2,140944,140944,140946,0,2,3
40205,6,3,140950,140950,140953,0,3,4
40206,4,1,140954,140954,140955,0,1,1
40207,5,3,140959,140959,140962,0,3,4
40208,6,3,140965,140965,140968,0,3,3
40209,6,1,140971,140971,140972,0,1,3
40210,1,1,140972,140972,140973,0,1,0
40211,4,1,140976,140976,140977,0,1,3
40212,1,2,140977,140977,140979,0,2,0
40213,3,3,140980,140980,140983,0,3,1
40214,6,3,140986,140986,140989,0,3,3
40215,1,2,140987,140989,140991,2,4,0
40216,6,1,140993,140993,140994,0,1,2
40217,5,3,140998,140998,141001,0,3,4
40218,3,3,141001,141001,141004,0,3,0
40219,4,3,141005,141005,141008,0,3,1
40220,3,2,141008,141008,141010,0,2,0
40221,3,3,141011,141011,141014,0,3,1
40222,4,3,141015,141015,141018,0,3,1
40223,5,3,141020,141020,141023,0,3,2
40224,6,3,141026,141026,141029,0,3,3
40225,6,3,141032,141032,141035,0,3,3
40226,6,2,141038,141038,141040,0,2,3
40227,1,2,141039,141040,141042,1,3,0
40228,6,3,141045,141045,141048,0,3,3
40229,3,1,141048,141048,141049,0,1,0
40230,1,1,141049,141049,141050,0,1,0
40231,2,2,141051,141051,141053,0,2,1
40232,2,3,141053,141053,141056,0,3,0
40233,4,3,141057,141057,141060,0,3,1
40234,1,3,141058,141060,141063,2,5,0
40235,6,2,141064,141064,141066,0,2,1
40236,6,1,141070,141070,141071,0,1,4
40237,6,1,141076,141076,141077,0,1,5
40238,4,1,141080,141080,141081,0,1,3
40239,1,2,141081,141081,141083,0,2,0
40240,2,1,141083,141083,141084,0,1,0
40241,5,1,141088,141088,141089,0,1,4
40242,6,3,141094,141094,141097,0,3,5
40243,3,2,141097,141097,141099,0,2,0
40244,5,2,141102,141102,141104,0,2,3
40245,1,2,141103,141104,141106,1,3,0
40246,4,2,141107,141107,141109,0,2,1
40247,2,2,141109,141109,141111,0,2,0
40248,2,3,141111,141111,141114,0,3,0
40249,6,1,141117,141117,141118,0,1,3
40250,6,2,141123,141123,141125,0,2,5
40251,5,1,141128,141128,141129,0,1,3
40252,4,2,141132,141132,141134,0,2,3
40253,1,1,141133,141134,141135,1,2,0
40254,5,3,141138,141138,141141,0,3,3
40255,2,1,141140,141141,141142,1,2,0
40256,6,3,141146,141146,141149,0,3,4
40257,5,3,141151,141151,141154,0,3,2
40258,3,3,141154,141154,141157,0,3,0
40259,5,1,141159,141159,141160,0,1,2
40260,6,3,141165,141165,141168,0,3,5
40261,3,3,141168,141168,141171,0,3,0
40262,3,3,141171,141171,141174,0,3,0
40263,6,1,141177,141177,141178,0,1,3
40264,2,1,141179,141179,141180,0,1,1
40265,4,2,141183,141183,141185,0,2,3
40266,5,3,141188,141188,141191,0,3,3
40267,5,1,141193,141193,141194,0,1,2
40268,5,2,141198,141198,141200,0,2,4
40269,1,1,141199,141200,141201,1,2,0
40270,3,2,141202,141202,141204,0,2,1
40271,3,1,141205,141205,141206,0,1,1
40272,1,2,141206,141206,141208,0,2,0
40273,1,3,141207,141208,141211,1,4,0
40274,1,2,141208,141211,141213,3,5,0
40275,1,1,141209,141213,141214,4,5,0
40276,1,2,141210,141214,141216,4,6,0
40277,5,3,141215,141216,141219,1,4,0
40278,2,1,141217,141219,141220,2,3,0
40279,3,2,141220,141220,141222,0,2,0
40280,3,3,141223,141223,141226,0,3,1
40281,1,2,141224,141226,141228,2,4,0
40282,3,2,141227,141228,141230,1,3,0
40283,2,1,141229,141230,141231,1,2,0
40284,1,3,141230,141231,141234,1,4,0
40285,5,2,141235,141235,141237,0,2,1
40286,3,2,141238,141238,141240,0,2,1
40287,5,3,141243,141243,141246,0,3,3
40288,1,1,141244,141246,141247,2,3,0
40289,3,2,141247,141247,141249,0,2,0
40290,2,2,141249,141249,141251,0,2,0
40291,3,2,141252,141252,141254,0,2,1
40292,4,2,141256,141256,141258,0,2,2
40293,6,1,141262,141262,141263,0,1,4
40294,3,3,141265,141265,141268,0,3,2
40295,6,3,141271,141271,141274,0,3,3
40296,2,2,141273,141274,141276,1,3,0
40297,6,1,141279,141279,141280,0,1,3
40298,2,1,141281,141281,141282,0,1,1
40299,3,1,141284,141284,141285,0,1,2
40300,3,2,141287,141287,141289,0,2,2
40301,3,2,141290,141290,141292,0,2,1
40302,3,3,141293,141293,141296,0,3,1
40303,6,3,141299,141299,141302,0,3,3
40304,2,1,141301,141302,141303,1,2,0
40305,1,2,141302,141303,141305,1,3,0
40306,3,2,141305,141305,141307,0,2,0
40307,3,3,141308,141308,141311,0,3,1
40308,4,1,141312,141312,141313,0,1,1
40309,4,2,141316,141316,141318,0,2,3
40310,4,1,141320,141320,141321,0,1,2
40311,3,3,141323,141323,141326,0,3,2
40312,4,2,141327,141327,141329,0,2,1
40313,6,1,141333,141333,141334,0,1,4
40314,5,3,141338,141338,141341,0,3,4
40315,4,2,141342,141342,141344,0,2,1
40316,5,2,141347,141347,141349,0,2,3
40317,3,2,141350,141350,141352,0,2,1
40318,6,3,141356,141356,141359,0,3,4
40319,6,2,141362,141362,141364,0,2,3
40320,6,1,141368,141368,141369,0,1,4
40321,6,1,141374,141374,141375,0,1,5
40322,4,1,141378,141378,141379,0,1,3
40323,3,2,141381,141381,141383,0,2,2
40324,3,3,141384,141384,141387,0,3,1
40325,3,2,141387,141387,141389,0,2,0
40326,3,3,141390,141390,141393,0,3,1
40327,1,1,141391,141393,141394,2,3,0
40328,5,1,141396,141396,141397,0,1,2
40329,6,2,141402,141402,141404,0,2,5
40330,3,3,141405,141405,141408,0,3,1
40331,3,1,141408,141408,141409,0,1,0
40332,2,1,141410,141410,141411,0,1,1
40333,6,2,141416,141416,141418,0,2,5
40334,5,3,141421,141421,141424,0,3,3
40335,2,1,141423,141424,141425,1,2,0
40336,1,1,141424,141425,141426,1,2,0
40337,4,3,141428,141428,141431,0,3,2
40338,6,2,141434,141434,141436,0,2,3
40339,6,3,141440,141440,141443,0,3,4
40340,5,3,141445,141445,141448,0,3,2
40341,4,1,141449,141449,141450,0,1,1
40342,4,3,141453,141453,141456,0,3,3
40343,5,2,141458,141458,141460,0,2,2
40344,4,2,141462,141462,141464,0,2,2
40345,6,3,141468,141468,141471,0,3,4
40346,1,3,141469,141471,141474,2,5,0
40347,6,3,141475,141475,141478,0,3,1
40348,6,1,141481,141481,141482,0,1,3
40349,3,1,141484,141484,141485,0,1,2
40350,4,2,141488,141488,141490,0,2,3
40351,2,1,141490,141490,141491,0,1,0
40352,5,3,141495,141495,141498,0,3,4
40353,1,1,141496,141498,141499,2,3,0
40354,6,1,141502,141502,141503,0,1,3
40355,6,3,141508,141508,141511,0,3,5
40356,4,3,141512,141512,141515,0,3,1
40357,6,2,141518,141518,141520,0,2,3
40358,1,1,141519,141520,141521,1,2,0
40359,6,2,141525,141525,141527,0,2,4
40360,2,3,141527,141527,141530,0,3,0
40361,2,1,141529,141530,141531,1,2,0
40362,2,3,141531,141531,141534,0,3,0
40363,3,1,141534,141534,141535,0,1,0
40364,1,1,141535,141535,141536,0,1,0
40365,5,3,141540,141540,141543,0,3,4
40366,4,2,141544,141544,141546,0,2,1
40367,5,1,141549,141549,141550,0,1,3
40368,6,2,141555,141555,141557,0,2,5
40369,6,2,141561,141561,141563,0,2,4
40370,2,3,141563,141563,141566,0,3,0
40371,6,3,141569,141569,141572,0,3,3
40372,3,1,141572,141572,141573,0,1,0
40373,3,3,141575,141575,141578,0,3,2
40374,1,3,141576,141578,141581,2,5,0
40375,2,2,141578,141581,141583,3,5,0
40376,3,1,141581,141583,141584,2,3,0
40377,4,3,141585,141585,141588,0,3,1
40378,4,3,141589,141589,141592,0,3,1
40379,4,3,141593,141593,141596,0,3,1
40380,2,1,141595,141596,141597,1,2,0
40381,1,1,141596,141597,141598,1,2,0
40382,3,1,141599,141599,141600,0,1,1
40383,5,2,141604,141604,141606,0,2,4
40384,2,2,141606,141606,141608,0,2,0
40385,2,1,141608,141608,141609,0,1,0
40386,1,1,141609,141609,141610,0,1,0
40387,6,3,141615,141615,141618,0,3,5
40388,6,3,141621,141621,141624,0,3,3
40389,1,1,141622,141624,141625,2,3,0
40390,4,3,141626,141626,141629,0,3,1
40391,4,2,141630,141630,141632,0,2,1
40392,1,1,141631,141632,141633,1,2,0
40393,5,1,141636,141636,141637,0,1,3
40394,5,1,141641,141641,141642,0,1,4
40395,1,3,141642,141642,141645,0,3,0
40396,3,3,141645,141645,141648,0,3,0
40397,1,1,141646,141648,141649,2,3,0
40398,3,3,141649,141649,141652,0,3,0
40399,1,1,141650,141652,141653,2,3,0
40400,2,3,141652,141653,141656,1,4,0
40401,6,2,141658,141658,141660,0,2,2
40402,1,3,141659,141660,141663,1,4,0
40403,6,3,141665,141665,141668,0,3,2
40404,6,3,141671,141671,141674,0,3,3
40405,4,1,141675,141675,141676,0,1,1
40406,6,2,141681,141681,141683,0,2,5
40407,1,1,141682,141683,141684,1,2,0
40408,4,3,141686,141686,141689,0,3,2
40409,6,2,141692,141692,141694,0,2,3
40410,1,1,141693,141694,141695,1,2,0
40411,1,2,141694,141695,141697,1,3,0
40412,5,1,141699,141699,141700,0,1,2
40413,5,3,141704,141704,141707,0,3,4
40414,5,1,141709,141709,141710,0,1,2
40415,2,3,141711,141711,141714,0,3,1
40416,5,2,141716,141716,141718,0,2,2
40417,4,3,141720,141720,141723,0,3,2
40418,5,3,141725,141725,141728,0,3,2
40419,2,1,141727,141728,141729,1,2,0
40420,1,3,141728,141729,141732,1,4,0
40421,4,1,141732,141732,141733,0,1,0
40422,5,1,141737,141737,141738,0,1,4
40423,5,3,141742,141742,141745,0,3,4
40424,3,1,141745,141745,141746,0,1,0
40425,1,3,141746,141746,141749,0,3,0
40426,1,1,141747,141749,141750,2,3,0
40427,6,1,141753,141753,141754,0,1,3
40428,5,1,141758,141758,141759,0,1,4
40429,6,2,141764,141764,141766,0,2,5
40430,4,1,141768,141768,141769,0,1,2
40431,2,1,141770,141770,141771,0,1,1
40432,4,3,141774,141774,141777,0,3,3
40433,5,1,141779,141779,141780,0,1,2
40434,5,2,141784,141784,141786,0,2,4
40435,5,2,141789,141789,141791,0,2,3
40436,1,1,141790,141791,141792,1,2,0
40437,3,2,141793,141793,141795,0,2,1
40438,6,3,141799,141799,141802,0,3,4
40439,5,2,141804,141804,141806,0,2,2
40440,5,1,141809,141809,141810,0,1,3
40441,5,1,141814,141814,141815,0,1,4
40442,1,3,141815,141815,141818,0,3,0
40443,3,1,141818,141818,141819,0,1,0
40444,2,1,141820,141820,141821,0,1,1
40445,2,2,141822,141822,141824,0,2,1
40446,5,2,141827,141827,141829,0,2,3
40447,5,3,141832,141832,141835,0,3,3
40448,4,3,141836,141836,141839,0,3,1
40449,2,3,141838,141839,141842,1,4,0
40450,6,2,141844,141844,141846,0,2,2
40451,3,3,141847,141847,141850,0,3,1
40452,2,1,141849,141850,141851,1,2,0
40453,2,2,141851,141851,141853,0,2,0
40454,6,2,141857,141857,141859,0,2,4
40455,1,1,141858,141859,141860,1,2,0
40456,4,1,141862,141862,141863,0,1,2
40457,1,2,141863,141863,141865,0,2,0
40458,2,1,141865,141865,141866,0,1,0
40459,6,3,141871,141871,141874,0,3,5
40460,6,3,141877,141877,141880,0,3,3
40461,3,2,141880,141880,141882,0,2,0
40462,1,2,141881,141882,141884,1,3,0
40463,4,1,141885,141885,141886,0,1,1
40464,4,3,141889,141889,141892,0,3,3
40465,2,1,141891,141892,141893,1,2,0
40466,5,3,141896,141896,141899,0,3,3
40467,4,3,141900,141900,141903,0,3,1
40468,4,1,141904,141904,141905,0,1,1
40469,4,1,141908,141908,141909,0,1,3
40470,2,2,141910,141910,141912,0,2,1
40471,1,2,141911,141912,141914,1,3,0
40472,6,3,141917,141917,141920,0,3,3
40473,1,2,141918,141920,141922,2,4,0
40474,1,2,141919,141922,141924,3,5,0
40475,4,2,141923,141924,141926,1,3,0
40476,2,2,141925,141926,141928,1,3,0
40477,6,3,141931,141931,141934,0,3,3
40478,5,1,141936,141936,141937,0,1,2
40479,2,1,141938,141938,141939,0,1,1
40480,2,2,141940,141940,141942,0,2,1
40481,6,1,141946,141946,141947,0,1,4
40482,6,2,141952,141952,141954,0,2,5
40483,5,1,141957,141957,141958,0,1,3
40484,6,1,141963,141963,141964,0,1,5
40485,5,1,141968,141968,141969,0,1,4
40486,6,2,141974,141974,141976,0,2,5
40487,1,2,141975,141976,141978,1,3,0
40488,2,3,141977,141978,141981,1,4,0
40489,5,3,141982,141982,141985,0,3,1
40490,4,2,141986,141986,141988,0,2,1
40491,1,2,141987,141988,141990,1,3,0
40492,5,1,141992,141992,141993,0,1,2
40493,6,1,141998,141998,141999,0,1,5
40494,5,1,142003,142003,142004,0,1,4
40495,2,2,142005,142005,142007,0,2,1
40496,1,3,142006,142007,142010,1,4,0
40497,5,1,142011,142011,142012,0,1,1
40498,2,3,142013,142013,142016,0,3,1
40499,3,1,142016,142016,142017,0,1,0
40500,2,2,142018,142018,142020,0,2,1
40501,1,3,142019,142020,142023,1,4,0
40502,3,2,142022,142023,142025,1,3,0
40503,5,2,142027,142027,142029,0,2,2
40504,1,3,142028,142029,142032,1,4,0
40505,3,1,142031,142032,142033,1,2,0
40506,4,3,142035,142035,142038,0,3,2
40507,2,1,142037,142038,142039,1,2,0
40508,3,1,142040,142040,142041,0,1,1
40509,2,2,142042,142042,142044,0,2,1
40510,5,3,142047,142047,142050,0,3,3
40511,6,2,142053,142053,142055,0,2,3
40512,1,2,142054,142055,142057,1,3,0
40513,1,2,142055,142057,142059,2,4,0
40514,6,1,142061,142061,142062,0,1,2
40515,2,3,142063,142063,142066,0,3,1
40516,2,2,142065,142066,142068,1,3,0
40517,4,2,142069,142069,142071,0,2,1
40518,1,1,142070,142071,142072,1,2,0
40519,4,3,142074,142074,142077,0,3,2
40520,5,1,142079,142079,142080,0,1,2
40521,2,2,142081,142081,142083,0,2,1
40522,6,1,142087,142087,142088,0,1,4
40523,1,2,142088,142088,142090,0,2,0
40524,5,2,142093,142093,142095,0,2,3
40525,4,3,142097,142097,142100,0,3,2
40526,3,3,142100,142100,142103,0,3,0
40527,5,1,142105,142105,142106,0,1,2
40528,1,2,142106,142106,142108,0,2,0
40529,3,3,142109,142109,142112,0,3,1
40530,2,2,142111,142112,142114,1,3,0
40531,6,1,142117,142117,142118,0,1,3
40532,1,3,142118,142118,142121,0,3,0
40533,5,1,142123,142123,142124,0,1,2
40534,5,3,142128,142128,142131,0,3,4
40535,2,1,142130,142131,142132,1,2,0
40536,2,2,142132,142132,142134,0,2,0
40537,3,2,142135,142135,142137,0,2,1
40538,5,1,142140,142140,142141,0,1,3
40539,6,3,142146,142146,142149,0,3,5
40540,3,2,142149,142149,142151,0,2,0
40541,2,2,142151,142151,142153,0,2,0
40542,5,2,142156,142156,142158,0,2,3
40543,5,2,142161,142161,142163,0,2,3
40544,3,2,142164,142164,142166,0,2,1
40545,6,2,142170,142170,142172,0,2,4
40546,2,1,142172,142172,142173,0,1,0
40547,5,1,142177,142177,142178,0,1,4
40548,2,1,142179,142179,142180,0,1,1
40549,2,1,142181,142181,142182,0,1,1
40550,6,3,142187,142187,142190,0,3,5
40551,5,2,142192,142192,142194,0,2,2
40552,4,2,142196,142196,142198,0,2,2
40553,1,2,142197,142198,142200,1,3,0
40554,3,3,142200,142200,142203,0,3,0
40555,5,3,142205,142205,142208,0,3,2
40556,3,3,142208,142208,142211,0,3,0
40557,3,1,142211,142211,142212,0,1,0
40558,3,1,142214,142214,142215,0,1,2
40559,2,2,142216,142216,142218,0,2,1
40560,2,3,142218,142218,142221,0,3,0
40561,5,3,142223,142223,142226,0,3,2
40562,3,1,142226,142226,142227,0,1,0
40563,4,2,142230,142230,142232,0,2,3
40564,1,2,142231,142232,142234,1,3,0
40565,4,3,142235,142235,142238,0,3,1
40566,5,3,142240,142240,142243,0,3,2
40567,3,1,142243,142243,142244,0,1,0
40568,1,2,142244,142244,142246,0,2,0
40569,2,1,142246,142246,142247,0,1,0
40570,1,1,142247,142247,142248,0,1,0
40571,2,2,142249,142249,142251,0,2,1
40572,4,3,142253,142253,142256,0,3,2
40573,2,1,142255,142256,142257,1,2,0
40574,5,2,142260,142260,142262,0,2,3
40575,6,2,142266,142266,142268,0,2,4
40576,2,1,142268,142268,142269,0,1,0
40577,4,1,142272,142272,142273,0,1,3
40578,1,3,142273,142273,142276,0,3,0
40579,2,3,142275,142276,142279,1,4,0
40580,3,2,142278,142279,142281,1,3,0
40581,1,1,142279,142281,142282,2,3,0
40582,6,3,142285,142285,142288,0,3,3
40583,1,1,142286,142288,142289,2,3,0
40584,5,1,142291,142291,142292,0,1,2
40585,6,3,142297,142297,142300,0,3,5
40586,1,2,142298,142300,142302,2,4,0
40587,4,3,142302,142302,142305,0,3,0
40588,1,3,142303,142305,142308,2,5,0
40589,2,3,142305,142308,142311,3,6,0
40590,4,1,142309,142311,142312,2,3,0
40591,2,1,142311,142312,142313,1,2,0
40592,2,3,142313,142313,142316,0,3,0
40593,1,2,142314,142316,142318,2,4,0
40594,6,2,142320,142320,142322,0,2,2
40595,6,1,142326,142326,142327,0,1,4
40596,4,1,142330,142330,142331,0,1,3
40597,5,3,142335,142335,142338,0,3,4
40598,3,2,142338,142338,142340,0,2,0
40599,6,1,142344,142344,142345,0,1,4
40600,4,3,142348,142348,142351,0,3,3
40601,2,3,142350,142351,142354,1,4,0
40602,3,3,142353,142354,142357,1,4,0
40603,3,3,142356,142357,142360,1,4,0
40604,3,1,142359,142360,142361,1,2,0
40605,6,1,142365,142365,142366,0,1,4
40606,4,1,142369,142369,142370,0,1,3
40607,6,1,142375,142375,142376,0,1,5
40608,3,3,142378,142378,142381,0,3,2
40609,6,2,142384,142384,142386,0,2,3
40610,5,3,142389,142389,142392,0,3,3
40611,3,1,142392,142392,142393,0,1,0
40612,2,1,142394,142394,142395,0,1,1
40613,2,1,142396,142396,142397,0,1,1
40614,4,3,142400,142400,142403,0,3,3
40615,2,2,142402,142403,142405,1,3,0
40616,3,2,142405,142405,142407,0,2,0
40617,5,1,142410,142410,142411,0,1,3
40618,4,1,142414,142414,142415,0,1,3
40619,3,2,142417,142417,142419,0,2,2
40620,2,2,142419,142419,142421,0,2,0
40621,6,3,142425,142425,142428,0,3,4
40622,3,2,142428,142428,142430,0,2,0
40623,1,3,142429,142430,142433,1,4,0
40624,1,3,142430,142433,142436,3,6,0
40625,6,1,142436,142436,142437,0,1,0
40626,2,3,142438,142438,142441,0,3,1
40627,6,2,142444,142444,142446,0,2,3
40628,5,2,142449,142449,142451,0,2,3
40629,2,3,142451,142451,142454,0,3,0
40630,5,3,142456,142456,142459,0,3,2
40631,4,3,142460,142460,142463,0,3,1
40632,5,2,142465,142465,142467,0,2,2
40633,3,2,142468,142468,142470,0,2,1
40634,2,1,142470,142470,142471,0,1,0
40635,4,2,142474,142474,142476,0,2,3
40636,4,3,142478,142478,142481,0,3,2
40637,5,1,142483,142483,142484,0,1,2
40638,3,1,142486,142486,142487,0,1,2
40639,5,3,142491,142491,142494,0,3,4
40640,1,2,142492,142494,142496,2,4,0
40641,3,2,142495,142496,142498,1,3,0
40642,4,3,142499,142499,142502,0,3,1
40643,6,3,142505,142505,142508,0,3,3
40644,1,2,142506,142508,142510,2,4,0
40645,1,3,142507,142510,142513,3,6,0
40646,6,3,142513,142513,142516,0,3,0
40647,2,1,142515,142516,142517,1,2,0
40648,2,1,142517,142517,142518,0,1,0
40649,4,3,142521,142521,142524,0,3,3
40650,4,3,142525,142525,142528,0,3,1
40651,5,1,142530,142530,142531,0,1,2
40652,1,3,142531,142531,142534,0,3,0
40653,5,2,142536,142536,142538,0,2,2
40654,5,2,142541,142541,142543,0,2,3
40655,4,2,142545,142545,142547,0,2,2
40656,1,3,142546,142547,142550,1,4,0
40657,2,2,142548,142550,142552,2,4,0
40658,6,2,142554,142554,142556,0,2,2
40659,5,2,142559,142559,142561,0,2,3
40660,5,2,142564,142564,142566,0,2,3
40661,4,2,142568,142568,142570,0,2,2
40662,3,2,142571,142571,142573,0,2,1
40663,4,3,142575,142575,142578,0,3,2
40664,5,3,142580,142580,142583,0,3,2
40665,6,1,142586,142586,142587,0,1,3
40666,5,3,142591,142591,142594,0,3,4
40667,4,1,142595,142595,142596,0,1,1
40668,6,3,142601,142601,142604,0,3,5
40669,4,1,142605,142605,142606,0,1,1
40670,1,3,142606,142606,142609,0,3,0
40671,6,2,142612,142612,142614,0,2,3
40672,3,1,142615,142615,142616,0,1,1
40673,3,1,142618,142618,142619,0,1,2
40674,6,3,142624,142624,142627,0,3,5
40675,2,2,142626,142627,142629,1,3,0
40676,2,3,142628,142629,142632,1,4,0
40677,3,1,142631,142632,142633,1,2,0
40678,3,1,142634,142634,142635,0,1,1
40679,5,3,142639,142639,142642,0,3,4
40680,6,2,142645,142645,142647,0,2,3
40681,5,2,142650,142650,142652,0,2,3
40682,1,1,142651,142652,142653,1,2,0
40683,4,2,142655,142655,142657,0,2,2
40684,6,2,142661,142661,142663,0,2,4
40685,1,2,142662,142663,142665,1,3,0
40686,1,3,142663,142665,142668,2,5,0
40687,2,1,142665,142668,142669,3,4,0
40688,3,2,142668,142669,142671,1,3,0
40689,1,2,142669,142671,142673,2,4,0
40690,2,3,142671,142673,142676,2,5,0
40691,6,2,142677,142677,142679,0,2,1
40692,2,3,142679,142679,142682,0,3,0
40693,3,1,142682,142682,142683,0,1,0
40694,3,1,142685,142685,142686,0,1,2
40695,1,1,142686,142686,142687,0,1,0
40696,1,3,142687,142687,142690,0,3,0
40697,1,3,142688,142690,142693,2,5,0
40698,6,2,142694,142694,142696,0,2,1
40699,3,3,142697,142697,142700,0,3,1
40700,4,1,142701,142701,142702,0,1,1
40701,6,3,142707,142707,142710,0,3,5
40702,2,3,142709,142710,142713,1,4,0
40703,2,1,142711,142713,142714,2,3,0
40704,2,1,142713,142714,142715,1,2,0
40705,5,1,142718,142718,142719,0,1,3
40706,1,3,142719,142719,142722,0,3,0
40707,2,1,142721,142722,142723,1,2,0
40708,2,3,142723,142723,142726,0,3,0
40709,6,3,142729,142729,142732,0,3,3
40710,4,3,142733,142733,142736,0,3,1
40711,3,2,142736,142736,142738,0,2,0
40712,5,1,142741,142741,142742,0,1,3
40713,4,2,142745,142745,142747,0,2,3
40714,2,3,142747,142747,142750,0,3,0
40715,1,2,142748,142750,142752,2,4,0
40716,3,3,142751,142752,142755,1,4,0
40717,3,3,142754,142755,142758,1,4,0
40718,5,1,142759,142759,142760,0,1,1
40719,2,3,142761,142761,142764,0,3,1
40720,6,3,142767,142767,142770,0,3,3
40721,6,2,142773,142773,142775,0,2,3
40722,5,3,142778,142778,142781,0,3,3
40723,2,3,142780,142781,142784,1,4,0
40724,2,1,142782,142784,142785,2,3,0
40725,5,2,142787,142787,142789,0,2,2
40726,5,1,142792,142792,142793,0,1,3
40727,1,2,142793,142793,142795,0,2,0
40728,4,1,142797,142797,142798,0,1,2
40729,3,1,142800,142800,142801,0,1,2
40730,5,3,142805,142805,142808,0,3,4
40731,1,3,142806,142808,142811,2,5,0
40732,1,3,142807,142811,142814,4,7,0
40733,6,3,142813,142814,142817,1,4,0
40734,6,1,142819,142819,142820,0,1,2
40735,4,3,142823,142823,142826,0,3,3
40736,5,2,142828,142828,142830,0,2,2
40737,3,1,142831,142831,142832,0,1,1
40738,6,3,142837,142837,142840,0,3,5
40739,6,1,142843,142843,142844,0,1,3
40740,2,3,142845,142845,142848,0,3,1
40741,3,3,142848,142848,142851,0,3,0
40742,5,1,142853,142853,142854,0,1,2
40743,4,2,142857,142857,142859,0,2,3
40744,4,1,142861,142861,142862,0,1,2
40745,6,3,142867,142867,142870,0,3,5
40746,4,1,142871,142871,142872,0,1,1
40747,4,1,142875,142875,142876,0,1,3
40748,1,1,142876,142876,142877,0,1,0
40749,5,2,142881,142881,142883,0,2,4
40750,5,2,142886,142886,142888,0,2,3
40751,6,3,142892,142892,142895,0,3,4
40752,4,1,142896,142896,142897,0,1,1
40753,3,2,142899,142899,142901,0,2,2
40754,4,2,142903,142903,142905,0,2,2
40755,4,3,142907,142907,142910,0,3,2
40756,6,3,142913,142913,142916,0,3,3
40757,3,2,142916,142916,142918,0,2,0
40758,1,3,142917,142918,142921,1,4,0
40759,3,1,142920,142921,142922,1,2,0
40760,3,1,142923,142923,142924,0,1,1
40761,3,2,142926,142926,142928,0,2,2
40762,6,2,142932,142932,142934,0,2,4
40763,4,3,142936,142936,142939,0,3,2
40764,6,1,142942,142942,142943,0,1,3
40765,1,1,142943,142943,142944,0,1,0
40766,4,2,142947,142947,142949,0,2,3
40767,6,3,142953,142953,142956,0,3,4
40768,5,2,142958,142958,142960,0,2,2
40769,5,3,142963,142963,142966,0,3,3
40770,4,2,142967,142967,142969,0,2,1
40771,2,1,142969,142969,142970,0,1,0
40772,6,1,142975,142975,142976,0,1,5
40773,5,3,142980,142980,142983,0,3,4
40774,5,1,142985,142985,142986,0,1,2
40775,1,3,142986,142986,142989,0,3,0
40776,1,2,142987,142989,142991,2,4,0
40777,6,1,142993,142993,142994,0,1,2
40778,1,3,142994,142994,142997,0,3,0
40779,1,3,142995,142997,143000,2,5,0
40780,1,2,142996,143000,143002,4,6,0
40781,1,3,142997,143002,143005,5,8,0
40782,3,3,143000,143005,143008,5,8,0
40783,3,1,143003,143008,143009,5,6,0
40784,5,1,143008,143009,143010,1,2,0
40785,6,1,143014,143014,143015,0,1,4
40786,1,2,143015,143015,143017,0,2,0
40787,3,1,143018,143018,143019,0,1,1
40788,1,2,143019,143019,143021,0,2,0
40789,4,3,143023,143023,143026,0,3,2
40790,2,1,143025,143026,143027,1,2,0
40791,4,1,143029,143029,143030,0,1,2
40792,5,2,143034,143034,143036,0,2,4
40793,1,2,143035,143036,143038,1,3,0
40794,1,3,143036,143038,143041,2,5,0
40795,3,3,143039,143041,143044,2,5,0
40796,4,3,143043,143044,143047,1,4,0
40797,4,2,143047,143047,143049,0,2,0
40798,5,2,143052,143052,143054,0,2,3
40799,5,1,143057,143057,143058,0,1,3
40800,4,2,143061,143061,143063,0,2,3
40801,4,3,143065,143065,143068,0,3,2
40802,3,3,143068,143068,143071,0,3,0
40803,5,1,143073,143073,143074,0,1,2
40804,3,3,143076,143076,143079,0,3,2
40805,3,2,143079,143079,143081,0,2,0
40806,1,2,143080,143081,143083,1,3,0
40807,4,2,143084,143084,143086,0,2,1
40808,6,3,143090,143090,143093,0,3,4
40809,1,2,143091,143093,143095,2,4,0
40810,3,2,143094,143095,143097,1,3,0
40811,1,2,143095,143097,143099,2,4,0
40812,1,3,143096,143099,143102,3,6,0
40813,1,3,143097,143102,143105,5,8,0
40814,2,2,143099,143105,143107,6,8,0
40815,3,2,143102,143107,143109,5,7,0
40816,1,1,143103,143109,143110,6,7,0
40817,2,3,143105,143110,143113,5,8,0
40818,4,1,143109,143113,143114,4,5,0
40819,4,3,143113,143114,143117,1,4,0
40820,4,2,143117,143117,143119,0,2,0
40821,1,3,143118,143119,143122,1,4,0
40822,4,1,143122,143122,143123,0,1,0
40823,1,2,143123,143123,143125,0,2,0
40824,6,1,143129,143129,143130,0,1,4
40825,2,3,143131,143131,143134,0,3,1
40826,1,2,143132,143134,143136,2,4,0
40827,2,3,143134,143136,143139,2,5,0
40828,4,1,143138,143139,143140,1,2,0
40829,4,3,143142,143142,143145,0,3,2
40830,2,1,143144,143145,143146,1,2,0
40831,3,3,143147,143147,143150,0,3,1
40832,2,2,143149,143150,143152,1,3,0
40833,3,2,143152,143152,143154,0,2,0
40834,3,2,143155,143155,143157,0,2,1
40835,3,1,143158,143158,143159,0,1,1
40836,6,3,143164,143164,143167,0,3,5
40837,2,3,143166,143167,143170,1,4,0
40838,6,3,143172,143172,143175,0,3,2
40839,3,1,143175,143175,143176,0,1,0
40840,1,2,143176,143176,143178,0,2,0
40841,6,1,143182,143182,143183,0,1,4
40842,5,3,143187,143187,143190,0,3,4
40843,5,2,143192,143192,143194,0,2,2
40844,1,2,143193,143194,143196,1,3,0
40845,3,2,143196,143196,143198,0,2,0
40846,5,3,143201,143201,143204,0,3,3
40847,6,2,143207,143207,143209,0,2,3
40848,3,2,143210,143210,143212,0,2,1
40849,4,3,143214,143214,143217,0,3,2
40850,1,2,143215,143217,143219,2,4,0
40851,4,1,143219,143219,143220,0,1,0
40852,6,3,143225,143225,143228,0,3,5
40853,2,1,143227,143228,143229,1,2,0
40854,1,2,143228,143229,143231,1,3,0
40855,6,2,143234,143234,143236,0,2,3
40856,5,2,143239,143239,143241,0,2,3
40857,6,3,143245,143245,143248,0,3,4
40858,6,3,143251,143251,143254,0,3,3
40859,2,1,143253,143254,143255,1,2,0
40860,5,2,143258,143258,143260,0,2,3
40861,4,1,143262,143262,143263,0,1,2
40862,2,2,143264,143264,143266,0,2,1
40863,5,2,143269,143269,143271,0,2,3
40864,1,3,143270,143271,143274,1,4,0
40865,3,2,143273,143274,143276,1,3,0
40866,6,3,143279,143279,143282,0,3,3
40867,2,3,143281,143282,143285,1,4,0
40868,3,1,143284,143285,143286,1,2,0
40869,2,3,143286,143286,143289,0,3,0
40870,5,3,143291,143291,143294,0,3,2
40871,3,2,143294,143294,143296,0,2,0
40872,4,1,143298,143298,143299,0,1,2
40873,3,3,143301,143301,143304,0,3,2
40874,1,1,143302,143304,143305,2,3,0
40875,6,3,143308,143308,143311,0,3,3
40876,5,3,143313,143313,143316,0,3,2
40877,6,1,143319,143319,143320,0,1,3
40878,4,2,143323,143323,143325,0,2,3
40879,5,1,143328,143328,143329,0,1,3
40880,4,2,143332,143332,143334,0,2,3
40881,3,1,143335,143335,143336,0,1,1
40882,1,2,143336,143336,143338,0,2,0
40883,3,3,143339,143339,143342,0,3,1
40884,5,3,143344,143344,143347,0,3,2
40885,6,1,143350,143350,143351,0,1,3
40886,2,2,143352,143352,143354,0,2,1
40887,3,1,143355,143355,143356,0,1,1
40888,2,3,143357,143357,143360,0,3,1
40889,4,3,143361,143361,143364,0,3,1
40890,2,2,143363,143364,143366,1,3,0
40891,3,3,143366,143366,143369,0,3,0
40892,3,3,143369,143369,143372,0,3,0
40893,1,3,143370,143372,143375,2,5,0
40894,1,1,143371,143375,143376,4,5,0
40895,1,2,143372,143376,143378,4,6,0
40896,1,3,143373,143378,143381,5,8,0
40897,3,1,143376,143381,143382,5,6,0
40898,6,1,143382,143382,143383,0,1,0
40899,6,2,143388,143388,143390,0,2,5
40900,3,1,143391,143391,143392,0,1,1
40901,2,1,143393,143393,143394,0,1,1
40902,4,1,143397,143397,143398,0,1,3
40903,1,1,143398,143398,143399,0,1,0
40904,4,3,143402,143402,143405,0,3,3
40905,1,3,143403,143405,143408,2,5,0
40906,1,2,143404,143408,143410,4,6,0
40907,5,2,143409,143410,143412,1,3,0
40908,3,2,143412,143412,143414,0,2,0
40909,4,2,143416,143416,143418,0,2,2
40910,3,3,143419,143419,143422,0,3,1
40911,1,3,143420,143422,143425,2,5,0
40912,2,3,143422,143425,143428,3,6,0
40913,3,3,143425,143428,143431,3,6,0
40914,3,3,143428,143431,143434,3,6,0
40915,4,2,143432,143434,143436,2,4,0
40916,3,1,143435,143436,143437,1,2,0
40917,4,1,143439,143439,143440,0,1,2
40918,1,3,143440,143440,143443,0,3,0
40919,2,2,143442,143443,143445,1,3,0
40920,3,1,143445,143445,143446,0,1,0
40921,2,3,143447,143447,143450,0,3,1
40922,1,2,143448,143450,143452,2,4,0
40923,6,3,143454,143454,143457,0,3,2
40924,5,3,143459,143459,143462,0,3,2
40925,2,3,143461,143462,143465,1,4,0
40926,3,2,143464,143465,143467,1,3,0
40927,6,2,143470,143470,143472,0,2,3
40928,1,3,143471,143472,143475,1,4,0
40929,2,3,143473,143475,143478,2,5,0
40930,3,1,143476,143478,143479,2,3,0
40931,3,1,143479,143479,143480,0,1,0
40932,1,2,143480,143480,143482,0,2,0
40933,1,3,143481,143482,143485,1,4,0
40934,1,1,143482,143485,143486,3,4,0
40935,5,3,143487,143487,143490,0,3,1
40936,6,3,143493,143493,143496,0,3,3
40937,3,3,143496,143496,143499,0,3,0
40938,6,2,143502,143502,143504,0,2,3
40939,6,1,143508,143508,143509,0,1,4
40940,2,2,143510,143510,143512,0,2,1
40941,3,2,143513,143513,143515,0,2,1
40942,4,1,143517,143517,143518,0,1,2
40943,1,3,143518,143518,143521,0,3,0
40944,5,2,143523,143523,143525,0,2,2
40945,6,1,143529,143529,143530,0,1,4
40946,2,2,143531,143531,143533,0,2,1
40947,2,3,143533,143533,143536,0,3,0
40948,2,1,143535,143536,143537,1,2,0
40949,2,3,143537,143537,143540,0,3,0
40950,3,3,143540,143540,143543,0,3,0
40951,4,2,143544,143544,143546,0,2,1
40952,1,1,143545,143546,143547,1,2,0
40953,3,3,143548,143548,143551,0,3,1
40954,1,3,143549,143551,143554,2,5,0
40955,1,1,143550,143554,143555,4,5,0
40956,1,3,143551,143555,143558,4,7,0
40957,5,2,143556,143558,143560,2,4,0
40958,2,2,143558,143560,143562,2,4,0
40959,3,1,143561,143562,143563,1,2,0
40960,5,1,143566,143566,143567,0,1,3
40961,5,3,143571,143571,143574,0,3,4
40962,1,1,143572,143574,143575,2,3,0
40963,5,2,143577,143577,143579,0,2,2
40964,4,1,143581,143581,143582,0,1,2
40965,2,1,143583,143583,143584,0,1,1
40966,2,2,143585,143585,143587,0,2,1
40967,3,1,143588,143588,143589,0,1,1
40968,1,1,143589,143589,143590,0,1,0
40969,1,1,143590,143590,143591,0,1,0
40970,3,2,143593,143593,143595,0,2,2
40971,5,1,143598,143598,143599,0,1,3
40972,2,1,143600,143600,143601,0,1,1
40973,2,1,143602,143602,143603,0,1,1
40974,6,1,143608,143608,143609,0,1,5
40975,6,3,143614,143614,143617,0,3,5
40976,6,2,143620,143620,143622,0,2,3
40977,6,3,143626,143626,143629,0,3,4
40978,5,1,143631,143631,143632,0,1,2
40979,3,1,143634,143634,143635,0,1,2
40980,4,2,143638,143638,143640,0,2,3
40981,5,2,143643,143643,143645,0,2,3
40982,4,1,143647,143647,143648,0,1,2
40983,5,1,143652,143652,143653,0,1,4
40984,6,2,143658,143658,143660,0,2,5
40985,5,3,143663,143663,143666,0,3,3
40986,3,3,143666,143666,143669,0,3,0
40987,5,1,143671,143671,143672,0,1,2
40988,2,2,143673,143673,143675,0,2,1
40989,2,3,143675,143675,143678,0,3,0
40990,5,1,143680,143680,143681,0,1,2
40991,1,3,143681,143681,143684,0,3,0
40992,4,1,143685,143685,143686,0,1,1
40993,6,3,143691,143691,143694,0,3,5
40994,5,2,143696,143696,143698,0,2,2
40995,6,2,143702,143702,143704,0,2,4
40996,6,1,143708,143708,143709,0,1,4
40997,3,1,143711,143711,143712,0,1,2
40998,5,3,143716,143716,143719,0,3,4
40999,6,2,143722,143722,143724,0,2,3
41000,2,1,143724,143724,143725,0,1,0
41001,1,2,143725,143725,143727,0,2,0
41002,6,1,143731,143731,143732,0,1,4
41003,4,3,143735,143735,143738,0,3,3
41004,1,3,143736,143738,143741,2,5,0
41005,5,1,143741,143741,143742,0,1,0
41006,3,3,143744,143744,143747,0,3,2
41007,6,1,143750,143750,143751,0,1,3
41008,2,3,143752,143752,143755,0,3,1
41009,3,1,143755,143755,143756,0,1,0
41010,2,1,143757,143757,143758,0,1,1
41011,3,3,143760,143760,143763,0,3,2
41012,1,3,143761,143763,143766,2,5,0
41013,5,2,143766,143766,143768,0,2,0
41014,3,1,143769,143769,143770,0,1,1
41015,3,3,143772,143772,143775,0,3,2
41016,6,3,143778,143778,143781,0,3,3
41017,2,2,143780,143781,143783,1,3,0
41018,6,2,143786,143786,143788,0,2,3
41019,3,1,143789,143789,143790,0,1,1
41020,3,2,143792,143792,143794,0,2,2
41021,4,3,143796,143796,143799,0,3,2
41022,2,3,143798,143799,143802,1,4,0
41023,1,1,143799,143802,143803,3,4,0
41024,4,3,143803,143803,143806,0,3,0
41025,6,2,143809,143809,143811,0,2,3
41026,3,3,143812,143812,143815,0,3,1
41027,2,3,143814,143815,143818,1,4,0
41028,1,1,143815,143818,143819,3,4,0
41029,1,3,143816,143819,143822,3,6,0
41030,6,3,143822,143822,143825,0,3,0
41031,2,2,143824,143825,143827,1,3,0
41032,1,2,143825,143827,143829,2,4,0
41033,6,2,143831,143831,143833,0,2,2
41034,1,2,143832,143833,143835,1,3,0
41035,5,2,143837,143837,143839,0,2,2
41036,5,2,143842,143842,143844,0,2,3
41037,3,1,143845,143845,143846,0,1,1
41038,6,1,143851,143851,143852,0,1,5
41039,2,1,143853,143853,143854,0,1,1
41040,1,2,143854,143854,143856,0,2,0
41041,6,1,143860,143860,143861,0,1,4
41042,5,3,143865,143865,143868,0,3,4
41043,4,3,143869,143869,143872,0,3,1
41044,5,2,143874,143874,143876,0,2,2
41045,3,1,143877,143877,143878,0,1,1
41046,3,1,143880,143880,143881,0,1,2
41047,2,1,143882,143882,143883,0,1,1
41048,4,2,143886,143886,143888,0,2,3
41049,4,3,143890,143890,143893,0,3,2
41050,4,2,143894,143894,143896,0,2,1
41051,4,3,143898,143898,143901,0,3,2
41052,1,3,143899,143901,143904,2,5,0
41053,3,2,143902,143904,143906,2,4,0
41054,1,1,143903,143906,143907,3,4,0
41055,2,1,143905,143907,143908,2,3,0
41056,5,1,143910,143910,143911,0,1,2
41057,6,1,143916,143916,143917,0,1,5
41058,1,2,143917,143917,143919,0,2,0
41059,4,1,143921,143921,143922,0,1,2
41060,4,3,143925,143925,143928,0,3,3
41061,4,1,143929,143929,143930,0,1,1
41062,1,3,143930,143930,143933,0,3,0
41063,3,3,143933,143933,143936,0,3,0
41064,2,3,143935,143936,143939,1,4,0
41065,5,1,143940,143940,143941,0,1,1
41066,6,3,143946,143946,143949,0,3,5
41067,1,1,143947,143949,143950,2,3,0
41068,2,3,143949,143950,143953,1,4,0
41069,3,2,143952,143953,143955,1,3,0
41070,2,3,143954,143955,143958,1,4,0
41071,5,1,143959,143959,143960,0,1,1
41072,4,2,143963,143963,143965,0,2,3
41073,4,3,143967,143967,143970,0,3,2
41074,6,1,143973,143973,143974,0,1,3
41075,2,1,143975,143975,143976,0,1,1
41076,1,2,143976,143976,143978,0,2,0
41077,3,1,143979,143979,143980,0,1,1
41078,4,2,143983,143983,143985,0,2,3
41079,5,2,143988,143988,143990,0,2,3
41080,1,3,143989,143990,143993,1,4,0
41081,3,1,143992,143993,143994,1,2,0
41082,1,2,143993,143994,143996,1,3,0
41083,1,3,143994,143996,143999,2,5,0
41084,1,3,143995,143999,144002,4,7,0
41085,1,3,143996,144002,144005,6,9,0
41086,5,2,144001,144005,144007,4,6,0
41087,5,1,144006,144007,144008,1,2,0
41088,3,1,144009,144009,144010,0,1,1
41089,4,1,144013,144013,144014,0,1,3
41090,1,2,144014,144014,144016,0,2,0
41091,6,2,144020,144020,144022,0,2,4
41092,6,2,144026,144026,144028,0,2,4
41093,6,3,144032,144032,144035,0,3,4
41094,3,2,144035,144035,144037,0,2,0
41095,1,2,144036,144037,144039,1,3,0
41096,1,1,144037,144039,144040,2,3,0
41097,4,2,144041,144041,144043,0,2,1
41098,2,3,144043,144043,144046,0,3,0
41099,6,3,144049,144049,144052,0,3,3
41100,2,2,144051,144052,144054,1,3,0
41101,5,2,144056,144056,144058,0,2,2
41102,2,1,144058,144058,144059,0,1,0
41103,1,2,144059,144059,144061,0,2,0
41104,6,2,144065,144065,144067,0,2,4
41105,1,3,144066,144067,144070,1,4,0
41106,3,1,144069,144070,144071,1,2,0
41107,4,3,144073,144073,144076,0,3,2
41108,3,2,144076,144076,144078,0,2,0
41109,1,2,144077,144078,144080,1,3,0
41110,6,2,144083,144083,144085,0,2,3
41111,1,3,144084,144085,144088,1,4,0
41112,2,2,144086,144088,144090,2,4,0
41113,6,2,144092,144092,144094,0,2,2
41114,1,1,144093,144094,144095,1,2,0
41115,2,2,144095,144095,144097,0,2,0
41116,6,1,144101,144101,144102,0,1,4
41117,3,1,144104,144104,144105,0,1,2
41118,3,1,144107,144107,144108,0,1,2
41119,1,2,144108,144108,144110,0,2,0
41120,4,3,144112,144112,144115,0,3,2
41121,6,1,144118,144118,144119,0,1,3
41122,4,3,144122,144122,144125,0,3,3
41123,3,2,144125,144125,144127,0,2,0
41124,4,1,144129,144129,144130,0,1,2
41125,4,1,144133,144133,144134,0,1,3
41126,6,2,144139,144139,144141,0,2,5
41127,1,2,144140,144141,144143,1,3,0
41128,5,3,144145,144145,144148,0,3,2
41129,5,2,144150,144150,144152,0,2,2
41130,5,2,144155,144155,144157,0,2,3
41131,6,1,144161,144161,144162,0,1,4
41132,3,3,144164,144164,144167,0,3,2
41133,5,1,144169,144169,144170,0,1,2
41134,1,1,144170,144170,144171,0,1,0
41135,6,3,144176,144176,144179,0,3,5
41136,6,3,144182,144182,144185,0,3,3
41137,4,2,144186,144186,144188,0,2,1
41138,6,2,144192,144192,144194,0,2,4
41139,1,3,144193,144194,144197,1,4,0
41140,4,3,144197,144197,144200,0,3,0
41141,4,1,144201,144201,144202,0,1,1
41142,5,1,144206,144206,144207,0,1,4
41143,2,3,144208,144208,144211,0,3,1
41144,2,3,144210,144211,144214,1,4,0
41145,2,2,144212,144214,144216,2,4,0
41146,3,3,144215,144216,144219,1,4,0
41147,5,2,144220,144220,144222,0,2,1
41148,3,1,144223,144223,144224,0,1,1
41149,3,2,144226,144226,144228,0,2,2
41150,1,2,144227,144228,144230,1,3,0
41151,3,1,144230,144230,144231,0,1,0
41152,2,3,144232,144232,144235,0,3,1
41153,4,3,144236,144236,144239,0,3,1
41154,5,3,144241,144241,144244,0,3,2
41155,4,3,144245,144245,144248,0,3,1
41156,3,2,144248,144248,144250,0,2,0
41157,3,1,144251,144251,144252,0,1,1
41158,3,1,144254,144254,144255,0,1,2
41159,3,2,144257,144257,144259,0,2,2
41160,1,2,144258,144259,144261,1,3,0
41161,1,1,144259,144261,144262,2,3,0
41162,4,1,144263,144263,144264,0,1,1
41163,2,2,144265,144265,144267,0,2,1
41164,4,1,144269,144269,144270,0,1,2
41165,6,1,144275,144275,144276,0,1,5
41166,1,2,144276,144276,144278,0,2,0
41167,1,3,144277,144278,144281,1,4,0
41168,1,2,144278,144281,144283,3,5,0
41169,3,3,144281,144283,144286,2,5,0
41170,5,1,144286,144286,144287,0,1,0
41171,3,1,144289,144289,144290,0,1,2
41172,3,3,144292,144292,144295,0,3,2
41173,3,3,144295,144295,144298,0,3,0
41174,4,3,144299,144299,144302,0,3,1
41175,6,3,144305,144305,144308,0,3,3
41176,5,2,144310,144310,144312,0,2,2
41177,6,1,144316,144316,144317,0,1,4
41178,1,2,144317,144317,144319,0,2,0
41179,6,3,144323,144323,144326,0,3,4
41180,2,2,144325,144326,144328,1,3,0
41181,6,2,144331,144331,144333,0,2,3
41182,5,1,144336,144336,144337,0,1,3
41183,2,1,144338,144338,144339,0,1,1
41184,3,2,144341,144341,144343,0,2,2
41185,1,2,144342,144343,144345,1,3,0
41186,5,1,144347,144347,144348,0,1,2
41187,5,3,144352,144352,144355,0,3,4
41188,3,2,144355,144355,144357,0,2,0
41189,5,2,144360,144360,144362,0,2,3
41190,1,3,144361,144362,144365,1,4,0
41191,5,3,144366,144366,144369,0,3,1
41192,1,1,144367,144369,144370,2,3,0
41193,2,1,144369,144370,144371,1,2,0
41194,5,1,144374,144374,144375,0,1,3
41195,2,2,144376,144376,144378,0,2,1
41196,3,2,144379,144379,144381,0,2,1
41197,3,3,144382,144382,144385,0,3,1
41198,6,2,144388,144388,144390,0,2,3
41199,3,2,144391,144391,144393,0,2,1
41200,4,2,144395,144395,144397,0,2,2
41201,5,1,144400,144400,144401,0,1,3
41202,1,1,144401,144401,144402,0,1,0
41203,4,2,144405,144405,144407,0,2,3
41204,1,1,144406,144407,144408,1,2,0
41205,6,3,144412,144412,144415,0,3,4
41206,2,3,144414,144415,144418,1,4,0
41207,4,1,144418,144418,144419,0,1,0
41208,2,2,144420,144420,144422,0,2,1
41209,6,1,144426,144426,144427,0,1,4
41210,3,1,144429,144429,144430,0,1,2
41211,5,1,144434,144434,144435,0,1,4
41212,1,2,144435,144435,144437,0,2,0
41213,4,2,144439,144439,144441,0,2,2
41214,1,2,144440,144441,144443,1,3,0
41215,5,1,144445,144445,144446,0,1,2
41216,1,2,144446,144446,144448,0,2,0
41217,2,2,144448,144448,144450,0,2,0
41218,1,1,144449,144450,144451,1,2,0
41219,4,3,144453,144453,144456,0,3,2
41220,2,1,144455,144456,144457,1,2,0
41221,5,1,144460,144460,144461,0,1,3
41222,1,1,144461,144461,144462,0,1,0
41223,5,1,144466,144466,144467,0,1,4
41224,3,1,144469,144469,144470,0,1,2
41225,2,2,144471,144471,144473,0,2,1
41226,2,1,144473,144473,144474,0,1,0
41227,4,2,144477,144477,144479,0,2,3
41228,3,1,144480,144480,144481,0,1,1
41229,4,3,144484,144484,144487,0,3,3
41230,6,3,144490,144490,144493,0,3,3
41231,4,3,144494,144494,144497,0,3,1
41232,4,1,144498,144498,144499,0,1,1
41233,5,2,144503,144503,144505,0,2,4
41234,1,2,144504,144505,144507,1,3,0
41235,2,2,144506,144507,144509,1,3,0
41236,1,3,144507,144509,144512,2,5,0
41237,6,3,144513,144513,144516,0,3,1
41238,3,3,144516,144516,144519,0,3,0
41239,4,1,144520,144520,144521,0,1,1
41240,2,1,144522,144522,144523,0,1,1
41241,5,1,144527,144527,144528,0,1,4
41242,4,2,144531,144531,144533,0,2,3
41243,3,3,144534,144534,144537,0,3,1
41244,4,2,144538,144538,144540,0,2,1
41245,4,1,144542,144542,144543,0,1,2
41246,2,1,144544,144544,144545,0,1,1
41247,3,1,144547,144547,144548,0,1,2
41248,5,2,144552,144552,144554,0,2,4
41249,2,3,144554,144554,144557,0,3,0
41250,6,2,144560,144560,144562,0,2,3
41251,5,2,144565,144565,144567,0,2,3
41252,5,3,144570,144570,144573,0,3,3
41253,6,2,144576,144576,144578,0,2,3
41254,1,3,144577,144578,144581,1,4,0
41255,3,2,144580,144581,144583,1,3,0
41256,4,3,144584,144584,144587,0,3,1
41257,1,2,144585,144587,144589,2,4,0
41258,5,2,144590,144590,144592,0,2,1
41259,1,3,144591,144592,144595,1,4,0
41260,1,1,144592,144595,144596,3,4,0
41261,4,2,144596,144596,144598,0,2,0
41262,1,1,144597,144598,144599,1,2,0
41263,6,2,144603,144603,144605,0,2,4
41264,3,2,144606,144606,144608,0,2,1
41265,6,1,144612,144612,144613,0,1,4
41266,2,1,144614,144614,144615,0,1,1
41267,4,3,144618,144618,144621,0,3,3
41268,6,1,144624,144624,144625,0,1,3
41269,2,1,144626,144626,144627,0,1,1
41270,1,3,144627,144627,144630,0,3,0
41271,3,3,144630,144630,144633,0,3,0
41272,6,3,144636,144636,144639,0,3,3
41273,6,2,144642,144642,144644,0,2,3
41274,5,1,144647,144647,144648,0,1,3
41275,6,3,144653,144653,144656,0,3,5
41276,1,3,144654,144656,144659,2,5,0
41277,6,3,144660,144660,144663,0,3,1
41278,4,1,144664,144664,144665,0,1,1
41279,2,3,144666,144666,144669,0,3,1
41280,4,1,144670,144670,144671,0,1,1
41281,4,1,144674,144674,144675,0,1,3
41282,6,2,144680,144680,144682,0,2,5
41283,4,1,144684,144684,144685,0,1,2
41284,6,2,144690,144690,144692,0,2,5
41285,3,1,144693,144693,144694,0,1,1
41286,2,1,144695,144695,144696,0,1,1
41287,1,1,144696,144696,144697,0,1,0
41288,4,3,144700,144700,144703,0,3,3
41289,3,3,144703,144703,144706,0,3,0
41290,4,2,144707,144707,144709,0,2,1
41291,5,3,144712,144712,144715,0,3,3
41292,5,1,144717,144717,144718,0,1,2
41293,1,2,144718,144718,144720,0,2,0
41294,3,2,144721,144721,144723,0,2,1
41295,6,3,144727,144727,144730,0,3,4
41296,3,1,144730,144730,144731,0,1,0
41297,1,2,144731,144731,144733,0,2,0
41298,1,2,144732,144733,144735,1,3,0
41299,2,3,144734,144735,144738,1,4,0
41300,6,3,144740,144740,144743,0,3,2
41301,3,1,144743,144743,144744,0,1,0
41302,1,1,144744,144744,144745,0,1,0
41303,1,1,144745,144745,144746,0,1,0
41304,4,3,144749,144749,144752,0,3,3
41305,5,3,144754,144754,144757,0,3,2
41306,5,2,144759,144759,144761,0,2,2
41307,4,2,144763,144763,144765,0,2,2
41308,2,3,144765,144765,144768,0,3,0
41309,5,2,144770,144770,144772,0,2,2
41310,5,1,144775,144775,144776,0,1,3
41311,1,1,144776,144776,144777,0,1,0
41312,6,1,144782,144782,144783,0,1,5
41313,6,2,144788,144788,144790,0,2,5
41314,3,2,144791,144791,144793,0,2,1
41315,1,1,144792,144793,144794,1,2,0
41316,1,2,144793,144794,144796,1,3,0
41317,4,2,144797,144797,144799,0,2,1
41318,5,1,144802,144802,144803,0,1,3
41319,4,3,144806,144806,144809,0,3,3
41320,2,3,144808,144809,144812,1,4,0
41321,4,3,144812,144812,144815,0,3,0
41322,3,1,144815,144815,144816,0,1,0
41323,1,1,144816,144816,144817,0,1,0
41324,3,3,144819,144819,144822,0,3,2
41325,2,1,144821,144822,144823,1,2,0
41326,2,2,144823,144823,144825,0,2,0
41327,2,1,144825,144825,144826,0,1,0
41328,4,2,144829,144829,144831,0,2,3
41329,4,1,144833,144833,144834,0,1,2
41330,3,3,144836,144836,144839,0,3,2
41331,5,1,144841,144841,144842,0,1,2
41332,6,3,144847,144847,144850,0,3,5
41333,5,1,144852,144852,144853,0,1,2
41334,4,1,144856,144856,144857,0,1,3
41335,3,1,144859,144859,144860,0,1,2
41336,5,2,144864,144864,144866,0,2,4
41337,6,2,144870,144870,144872,0,2,4
41338,3,1,144873,144873,144874,0,1,1
41339,4,1,144877,144877,144878,0,1,3
41340,1,2,144878,144878,144880,0,2,0
41341,6,1,144884,144884,144885,0,1,4
41342,5,1,144889,144889,144890,0,1,4
41343,6,3,144895,144895,144898,0,3,5
41344,2,3,144897,144898,144901,1,4,0
41345,2,1,144899,144901,144902,2,3,0
41346,2,2,144901,144902,144904,1,3,0
41347,6,3,144907,144907,144910,0,3,3
41348,2,3,144909,144910,144913,1,4,0
41349,6,2,144915,144915,144917,0,2,2
41350,3,3,144918,144918,144921,0,3,1
41351,2,1,144920,144921,144922,1,2,0
41352,3,2,144923,144923,144925,0,2,1
41353,5,3,144928,144928,144931,0,3,3
41354,3,1,144931,144931,144932,0,1,0
41355,6,3,144937,144937,144940,0,3,5
41356,5,2,144942,144942,144944,0,2,2
41357,2,1,144944,144944,144945,0,1,0
41358,2,2,144946,144946,144948,0,2,1
41359,2,2,144948,144948,144950,0,2,0
41360,3,1,144951,144951,144952,0,1,1
41361,4,1,144955,144955,144956,0,1,3
41362,6,2,144961,144961,144963,0,2,5
41363,4,3,144965,144965,144968,0,3,2
41364,5,1,144970,144970,144971,0,1,2
41365,2,1,144972,144972,144973,0,1,1
41366,3,3,144975,144975,144978,0,3,2
41367,6,3,144981,144981,144984,0,3,3
41368,6,2,144987,144987,144989,0,2,3
41369,6,3,144993,144993,144996,0,3,4
41370,4,3,144997,144997,145000,0,3,1
41371,4,3,145001,145001,145004,0,3,1
41372,3,2,145004,145004,145006,0,2,0
41373,4,3,145008,145008,145011,0,3,2
41374,6,3,145014,145014,145017,0,3,3
41375,3,3,145017,145017,145020,0,3,0
41376,6,2,145023,145023,145025,0,2,3
41377,3,1,145026,145026,145027,0,1,1
41378,6,1,145032,145032,145033,0,1,5
41379,2,3,145034,145034,145037,0,3,1
41380,2,1,145036,145037,145038,1,2,0
41381,2,1,145038,145038,145039,0,1,0
41382,5,1,145043,145043,145044,0,1,4
41383,5,1,145048,145048,145049,0,1,4
41384,2,3,145050,145050,145053,0,3,1
41385,3,2,145053,145053,145055,0,2,0
41386,5,1,145058,145058,145059,0,1,3
41387,5,2,145063,145063,145065,0,2,4
41388,1,2,145064,145065,145067,1,3,0
41389,6,3,145070,145070,145073,0,3,3
41390,2,2,145072,145073,145075,1,3,0
41391,1,3,145073,145075,145078,2,5,0
41392,6,1,145079,145079,145080,0,1,1
41393,4,3,145083,145083,145086,0,3,3
41394,3,3,145086,145086,145089,0,3,0
41395,6,1,145092,145092,145093,0,1,3
41396,1,1,145093,145093,145094,0,1,0
41397,4,1,145097,145097,145098,0,1,3
41398,1,3,145098,145098,145101,0,3,0
41399,2,2,145100,145101,145103,1,3,0
41400,4,3,145104,145104,145107,0,3,1
41401,6,2,145110,145110,145112,0,2,3
41402,6,2,145116,145116,145118,0,2,4
41403,1,3,145117,145118,145121,1,4,0
41404,1,1,145118,145121,145122,3,4,0
41405,6,3,145124,145124,145127,0,3,2
41406,1,1,145125,145127,145128,2,3,0
41407,2,1,145127,145128,145129,1,2,0
41408,5,3,145132,145132,145135,0,3,3
41409,1,3,145133,145135,145138,2,5,0
41410,6,3,145139,145139,145142,0,3,1
41411,2,3,145141,145142,145145,1,4,0
41412,2,2,145143,145145,145147,2,4,0
41413,6,2,145149,145149,145151,0,2,2
41414,6,2,145155,145155,145157,0,2,4
41415,3,2,145158,145158,145160,0,2,1
41416,5,2,145163,145163,145165,0,2,3
41417,3,3,145166,145166,145169,0,3,1
41418,3,2,145169,145169,145171,0,2,0
41419,3,2,145172,145172,145174,0,2,1
41420,4,3,145176,145176,145179,0,3,2
41421,5,1,145181,145181,145182,0,1,2
41422,3,1,145184,145184,145185,0,1,2
41423,6,1,145190,145190,145191,0,1,5
41424,5,2,145195,145195,145197,0,2,4
41425,1,2,145196,145197,145199,1,3,0
41426,3,1,145199,145199,145200,0,1,0
41427,4,1,145203,145203,145204,0,1,3
41428,6,3,145209,145209,145212,0,3,5
41429,4,2,145213,145213,145215,0,2,1
41430,6,2,145219,145219,145221,0,2,4
41431,5,1,145224,145224,145225,0,1,3
41432,3,3,145227,145227,145230,0,3,2
41433,5,3,145232,145232,145235,0,3,2
41434,2,1,145234,145235,145236,1,2,0
41435,1,3,145235,145236,145239,1,4,0
41436,1,3,145236,145239,145242,3,6,0
41437,4,3,145240,145242,145245,2,5,0
41438,3,1,145243,145245,145246,2,3,0
41439,6,3,145249,145249,145252,0,3,3
41440,4,2,145253,145253,145255,0,2,1
41441,6,2,145259,145259,145261,0,2,4
41442,3,2,145262,145262,145264,0,2,1
41443,6,1,145268,145268,145269,0,1,4
41444,2,3,145270,145270,145273,0,3,1
41445,5,1,145275,145275,145276,0,1,2
41446,5,1,145280,145280,145281,0,1,4
41447,2,1,145282,145282,145283,0,1,1
41448,5,1,145287,145287,145288,0,1,4
41449,6,3,145293,145293,145296,0,3,5
41450,2,2,145295,145296,145298,1,3,0
41451,4,1,145299,145299,145300,0,1,1
41452,3,3,145302,145302,145305,0,3,2
41453,1,3,145303,145305,145308,2,5,0
41454,4,2,145307,145308,145310,1,3,0
41455,2,3,145309,145310,145313,1,4,0
41456,4,2,145313,145313,145315,0,2,0
41457,1,2,145314,145315,145317,1,3,0
41458,5,1,145319,145319,145320,0,1,2
41459,6,3,145325,145325,145328,0,3,5
41460,5,1,145330,145330,145331,0,1,2
41461,5,1,145335,145335,145336,0,1,4
41462,1,3,145336,145336,145339,0,3,0
41463,3,3,145339,145339,145342,0,3,0
41464,2,1,145341,145342,145343,1,2,0
41465,1,2,145342,145343,145345,1,3,0
41466,5,2,145347,145347,145349,0,2,2
41467,5,2,145352,145352,145354,0,2,3
41468,5,2,145357,145357,145359,0,2,3
41469,2,2,145359,145359,145361,0,2,0
41470,6,2,145365,145365,145367,0,2,4
41471,1,2,145366,145367,145369,1,3,0
41472,1,1,145367,145369,145370,2,3,0
41473,2,3,145369,145370,145373,1,4,0
41474,1,3,145370,145373,145376,3,6,0
41475,3,1,145373,145376,145377,3,4,0
41476,2,1,145375,145377,145378,2,3,0
41477,1,2,145376,145378,145380,2,4,0
41478,4,3,145380,145380,145383,0,3,0
41479,4,3,145384,145384,145387,0,3,1
41480,5,2,145389,145389,145391,0,2,2
41481,6,1,145395,145395,145396,0,1,4
41482,6,2,145401,145401,145403,0,2,5
41483,6,1,145407,145407,145408,0,1,4
41484,2,1,145409,145409,145410,0,1,1
41485,4,2,145413,145413,145415,0,2,3
41486,3,1,145416,145416,145417,0,1,1
41487,4,2,145420,145420,145422,0,2,3
41488,3,3,145423,145423,145426,0,3,1
41489,1,2,145424,145426,145428,2,4,0
41490,3,3,145427,145428,145431,1,4,0
41491,2,3,145429,145431,145434,2,5,0
41492,6,3,145435,145435,145438,0,3,1
41493,5,3,145440,145440,145443,0,3,2
41494,1,1,145441,145443,145444,2,3,0
41495,4,1,145445,145445,145446,0,1,1
41496,4,2,145449,145449,145451,0,2,3
41497,6,1,145455,145455,145456,0,1,4
41498,6,2,145461,145461,145463,0,2,5
41499,3,1,145464,145464,145465,0,1,1
41500,2,3,145466,145466,145469,0,3,1
41501,5,2,145471,145471,145473,0,2,2
41502,5,1,145476,145476,145477,0,1,3
41503,4,1,145480,145480,145481,0,1,3
41504,3,2,145483,145483,145485,0,2,2
41505,2,3,145485,145485,145488,0,3,0
41506,5,2,145490,145490,145492,0,2,2
41507,5,2,145495,145495,145497,0,2,3
41508,6,1,145501,145501,145502,0,1,4
41509,4,1,145505,145505,145506,0,1,3
41510,5,2,145510,145510,145512,0,2,4
41511,3,2,145513,145513,145515,0,2,1
41512,2,2,145515,145515,145517,0,2,0
41513,4,2,145519,145519,145521,0,2,2
41514,1,1,145520,145521,145522,1,2,0
41515,4,2,145524,145524,145526,0,2,2
41516,3,1,145527,145527,145528,0,1,1
41517,2,3,145529,145529,145532,0,3,1
41518,2,3,145531,145532,145535,1,4,0
41519,4,2,145535,145535,145537,0,2,0
41520,1,3,145536,145537,145540,1,4,0
41521,4,2,145540,145540,145542,0,2,0
41522,3,1,145543,145543,145544,0,1,1
41523,1,3,145544,145544,145547,0,3,0
41524,5,3,145549,145549,145552,0,3,2
41525,4,2,145553,145553,145555,0,2,1
41526,4,1,145557,145557,145558,0,1,2
41527,4,3,145561,145561,145564,0,3,3
41528,6,2,145567,145567,145569,0,2,3
41529,1,1,145568,145569,145570,1,2,0
41530,2,1,145570,145570,145571,0,1,0
41531,6,1,145576,145576,145577,0,1,5
41532,6,2,145582,145582,145584,0,2,5
41533,3,1,145585,145585,145586,0,1,1
41534,4,1,145589,145589,145590,0,1,3
41535,5,3,145594,145594,145597,0,3,4
41536,6,3,145600,145600,145603,0,3,3
41537,6,2,145606,145606,145608,0,2,3
41538,6,1,145612,145612,145613,0,1,4
41539,4,1,145616,145616,145617,0,1,3
41540,2,1,145618,145618,145619,0,1,1
41541,3,3,145621,145621,145624,0,3,2
41542,1,3,145622,145624,145627,2,5,0
41543,3,2,145625,145627,145629,2,4,0
41544,1,1,145626,145629,145630,3,4,0
41545,6,1,145632,145632,145633,0,1,2
41546,6,2,145638,145638,145640,0,2,5
41547,2,3,145640,145640,145643,0,3,0
41548,6,3,145646,145646,145649,0,3,3
41549,1,3,145647,145649,145652,2,5,0
41550,2,1,145649,145652,145653,3,4,0
41551,2,2,145651,145653,145655,2,4,0
41552,2,3,145653,145655,145658,2,5,0
41553,5,2,145658,145658,145660,0,2,0
41554,2,1,145660,145660,145661,0,1,0
41555,4,2,145664,145664,145666,0,2,3
41556,3,3,145667,145667,145670,0,3,1
41557,6,2,145673,145673,145675,0,2,3
41558,3,2,145676,145676,145678,0,2,1
41559,6,1,145682,145682,145683,0,1,4
41560,4,3,145686,145686,145689,0,3,3
41561,6,1,145692,145692,145693,0,1,3
41562,5,3,145697,145697,145700,0,3,4
41563,5,3,145702,145702,145705,0,3,2
41564,5,3,145707,145707,145710,0,3,2
41565,3,2,145710,145710,145712,0,2,0
41566,1,1,145711,145712,145713,1,2,0
41567,4,1,145715,145715,145716,0,1,2
41568,6,3,145721,145721,145724,0,3,5
41569,1,3,145722,145724,145727,2,5,0
41570,6,2,145728,145728,145730,0,2,1
41571,5,3,145733,145733,145736,0,3,3
41572,4,2,145737,145737,145739,0,2,1
41573,4,3,145741,145741,145744,0,3,2
41574,6,1,145747,145747,145748,0,1,3
41575,4,3,145751,145751,145754,0,3,3
41576,4,2,145755,145755,145757,0,2,1
41577,6,1,145761,145761,145762,0,1,4
41578,4,2,145765,145765,145767,0,2,3
41579,2,3,145767,145767,145770,0,3,0
41580,6,3,145773,145773,145776,0,3,3
41581,4,1,145777,145777,145778,0,1,1
41582,6,1,145783,145783,145784,0,1,5
41583,4,3,145787,145787,145790,0,3,3
41584,5,2,145792,145792,145794,0,2,2
41585,5,2,145797,145797,145799,0,2,3
41586,4,3,145801,145801,145804,0,3,2
41587,4,3,145805,145805,145808,0,3,1
41588,1,3,145806,145808,145811,2,5,0
41589,3,2,145809,145811,145813,2,4,0
41590,3,1,145812,145813,145814,1,2,0
41591,5,2,145817,145817,145819,0,2,3
41592,1,3,145818,145819,145822,1,4,0
41593,3,3,145821,145822,145825,1,4,0
41594,3,3,145824,145825,145828,1,4,0
41595,1,1,145825,145828,145829,3,4,0
41596,2,1,145827,145829,145830,2,3,0
41597,6,1,145833,145833,145834,0,1,3
41598,4,2,145837,145837,145839,0,2,3
41599,4,1,145841,145841,145842,0,1,2
41600,4,3,145845,145845,145848,0,3,3
41601,1,1,145846,145848,145849,2,3,0
41602,2,1,145848,145849,145850,1,2,0
41603,3,2,145851,145851,145853,0,2,1
41604,5,1,145856,145856,145857,0,1,3
41605,6,1,145862,145862,145863,0,1,5
41606,3,3,145865,145865,145868,0,3,2
41607,3,2,145868,145868,145870,0,2,0
41608,6,1,145874,145874,145875,0,1,4
41609,3,3,145877,145877,145880,0,3,2
41610,5,3,145882,145882,145885,0,3,2
41611,3,3,145885,145885,145888,0,3,0
41612,4,1,145889,145889,145890,0,1,1
41613,3,3,145892,145892,145895,0,3,2
41614,4,1,145896,145896,145897,0,1,1
41615,1,3,145897,145897,145900,0,3,0
41616,5,3,145902,145902,145905,0,3,2
41617,1,1,145903,145905,145906,2,3,0
41618,3,1,145906,145906,145907,0,1,0
41619,2,1,145908,145908,145909,0,1,1
41620,4,2,145912,145912,145914,0,2,3
41621,4,1,145916,145916,145917,0,1,2
41622,1,3,145917,145917,145920,0,3,0
41623,5,1,145922,145922,145923,0,1,2
41624,5,1,145927,145927,145928,0,1,4
41625,6,1,145933,145933,145934,0,1,5
41626,4,3,145937,145937,145940,0,3,3
41627,2,1,145939,145940,145941,1,2,0
41628,4,3,145943,145943,145946,0,3,2
41629,1,1,145944,145946,145947,2,3,0
41630,6,3,145950,145950,145953,0,3,3
41631,5,3,145955,145955,145958,0,3,2
41632,2,2,145957,145958,145960,1,3,0
41633,6,1,145963,145963,145964,0,1,3
41634,6,3,145969,145969,145972,0,3,5
41635,2,3,145971,145972,145975,1,4,0
41636,6,3,145977,145977,145980,0,3,2
41637,6,1,145983,145983,145984,0,1,3
41638,2,1,145985,145985,145986,0,1,1
41639,3,1,145988,145988,145989,0,1,2
41640,6,2,145994,145994,145996,0,2,5
41641,2,3,145996,145996,145999,0,3,0
41642,3,3,145999,145999,146002,0,3,0
41643,5,3,146004,146004,146007,0,3,2
41644,2,3,146006,146007,146010,1,4,0
41645,5,2,146011,146011,146013,0,2,1
41646,4,2,146015,146015,146017,0,2,2
41647,6,1,146021,146021,146022,0,1,4
41648,2,2,146023,146023,146025,0,2,1
41649,6,3,146029,146029,146032,0,3,4
41650,3,2,146032,146032,146034,0,2,0
41651,6,1,146038,146038,146039,0,1,4
41652,5,3,146043,146043,146046,0,3,4
41653,3,1,146046,146046,146047,0,1,0
41654,1,3,146047,146047,146050,0,3,0
41655,3,1,146050,146050,146051,0,1,0
41656,6,1,146056,146056,146057,0,1,5
41657,2,2,146058,146058,146060,0,2,1
41658,4,3,146062,146062,146065,0,3,2
41659,1,1,146063,146065,146066,2,3,0
41660,5,2,146068,146068,146070,0,2,2
41661,2,2,146070,146070,146072,0,2,0
41662,4,2,146074,146074,146076,0,2,2
41663,1,1,146075,146076,146077,1,2,0
41664,4,3,146079,146079,146082,0,3,2
41665,3,1,146082,146082,146083,0,1,0
41666,5,3,146087,146087,146090,0,3,4
41667,2,3,146089,146090,146093,1,4,0
41668,6,3,146095,146095,146098,0,3,2
41669,1,2,146096,146098,146100,2,4,0
41670,3,2,146099,146100,146102,1,3,0
41671,2,2,146101,146102,146104,1,3,0
41672,2,1,146103,146104,146105,1,2,0
41673,2,2,146105,146105,146107,0,2,0
41674,2,1,146107,146107,146108,0,1,0
41675,3,2,146110,146110,146112,0,2,2
41676,4,1,146114,146114,146115,0,1,2
41677,2,3,146116,146116,146119,0,3,1
41678,3,1,146119,146119,146120,0,1,0
41679,3,1,146122,146122,146123,0,1,2
41680,1,1,146123,146123,146124,0,1,0
41681,5,1,146128,146128,146129,0,1,4
41682,1,2,146129,146129,146131,0,2,0
41683,3,2,146132,146132,146134,0,2,1
41684,1,2,146133,146134,146136,1,3,0
41685,5,2,146138,146138,146140,0,2,2
41686,2,1,146140,146140,146141,0,1,0
41687,3,3,146143,146143,146146,0,3,2
41688,5,2,146148,146148,146150,0,2,2
41689,3,3,146151,146151,146154,0,3,1
41690,1,3,146152,146154,146157,2,5,0
41691,3,1,146155,146157,146158,2,3,0
41692,5,2,146160,146160,146162,0,2,2
41693,5,2,146165,146165,146167,0,2,3
41694,3,2,146168,146168,146170,0,2,1
41695,6,2,146174,146174,146176,0,2,4
41696,3,3,146177,146177,146180,0,3,1
41697,3,2,146180,146180,146182,0,2,0
41698,3,1,146183,146183,146184,0,1,1
41699,4,2,146187,146187,146189,0,2,3
41700,6,2,146193,146193,146195,0,2,4
41701,1,3,146194,146195,146198,1,4,0
41702,5,1,146199,146199,146200,0,1,1
41703,5,1,146204,146204,146205,0,1,4
41704,2,3,146206,146206,146209,0,3,1
41705,6,2,146212,146212,146214,0,2,3
41706,1,1,146213,146214,146215,1,2,0
41707,1,1,146214,146215,146216,1,2,0
41708,4,2,146218,146218,146220,0,2,2
41709,6,2,146224,146224,146226,0,2,4
41710,3,2,146227,146227,146229,0,2,1
41711,5,1,146232,146232,146233,0,1,3
41712,5,1,146237,146237,146238,0,1,4
41713,6,1,146243,146243,146244,0,1,5
41714,6,1,146249,146249,146250,0,1,5
41715,5,1,146254,146254,146255,0,1,4
41716,6,1,146260,146260,146261,0,1,5
41717,5,1,146265,146265,146266,0,1,4
41718,1,3,146266,146266,146269,0,3,0
41719,2,3,146268,146269,146272,1,4,0
41720,6,1,146274,146274,146275,0,1,2
41721,6,1,146280,146280,146281,0,1,5
41722,1,1,146281,146281,146282,0,1,0
41723,6,1,146287,146287,146288,0,1,5
41724,6,2,146293,146293,146295,0,2,5
41725,1,1,146294,146295,146296,1,2,0
41726,4,1,146298,146298,146299,0,1,2
41727,4,2,146302,146302,146304,0,2,3
41728,4,2,146306,146306,146308,0,2,2
41729,6,1,146312,146312,146313,0,1,4
41730,5,1,146317,146317,146318,0,1,4
41731,5,1,146322,146322,146323,0,1,4
41732,6,1,146328,146328,146329,0,1,5
41733,5,1,146333,146333,146334,0,1,4
41734,3,1,146336,146336,146337,0,1,2
41735,1,1,146337,146337,146338,0,1,0
41736,3,2,146340,146340,146342,0,2,2
41737,5,2,146345,146345,146347,0,2,3
41738,5,2,146350,146350,146352,0,2,3
41739,4,2,146354,146354,146356,0,2,2
41740,1,3,146355,146356,146359,1,4,0
41741,2,2,146357,146359,146361,2,4,0
41742,5,2,146362,146362,146364,0,2,1
41743,1,3,146363,146364,146367,1,4,0
41744,2,1,146365,146367,146368,2,3,0
41745,1,2,146366,146368,146370,2,4,0
41746,1,1,146367,146370,146371,3,4,0
41747,3,3,146370,146371,146374,1,4,0
41748,2,3,146372,146374,146377,2,5,0
41749,4,1,146376,146377,146378,1,2,0
41750,5,3,146381,146381,146384,0,3,3
41751,1,2,146382,146384,146386,2,4,0
41752,5,1,146387,146387,146388,0,1,1
41753,5,3,146392,146392,146395,0,3,4
41754,6,3,146398,146398,146401,0,3,3
41755,2,2,146400,146401,146403,1,3,0
41756,1,2,146401,146403,146405,2,4,0
41757,6,2,146407,146407,146409,0,2,2
41758,1,3,146408,146409,146412,1,4,0
41759,5,2,146413,146413,146415,0,2,1
41760,3,3,146416,146416,146419,0,3,1
41761,6,2,146422,146422,146424,0,2,3
41762,6,1,146428,146428,146429,0,1,4
41763,5,3,146433,146433,146436,0,3,4
41764,3,3,146436,146436,146439,0,3,0
41765,1,1,146437,146439,146440,2,3,0
41766,1,1,146438,146440,146441,2,3,0
41767,5,3,146443,146443,146446,0,3,2
41768,1,1,146444,146446,146447,2,3,0
41769,6,1,146450,146450,146451,0,1,3
41770,1,3,146451,146451,146454,0,3,0
41771,5,3,146456,146456,146459,0,3,2
41772,6,1,146462,146462,146463,0,1,3
41773,2,1,146464,146464,146465,0,1,1
41774,5,2,146469,146469,146471,0,2,4
41775,5,2,146474,146474,146476,0,2,3
41776,4,2,146478,146478,146480,0,2,2
41777,6,1,146484,146484,146485,0,1,4
41778,1,1,146485,146485,146486,0,1,0
41779,6,2,146491,146491,146493,0,2,5
41780,6,2,146497,146497,146499,0,2,4
41781,5,3,146502,146502,146505,0,3,3
41782,6,1,146508,146508,146509,0,1,3
41783,2,3,146510,146510,146513,0,3,1
41784,4,2,146514,146514,146516,0,2,1
41785,1,3,146515,146516,146519,1,4,0
41786,1,2,146516,146519,146521,3,5,0
41787,4,3,146520,146521,146524,1,4,0
41788,5,2,146525,146525,146527,0,2,1
41789,1,3,146526,146527,146530,1,4,0
41790,4,2,146530,146530,146532,0,2,0
41791,1,2,146531,146532,146534,1,3,0
41792,2,3,146533,146534,146537,1,4,0
41793,2,2,146535,146537,146539,2,4,0
41794,1,2,146536,146539,146541,3,5,0
41795,2,3,146538,146541,146544,3,6,0
41796,2,3,146540,146544,146547,4,7,0
41797,1,3,146541,146547,146550,6,9,0
41798,4,3,146545,146550,146553,5,8,0
41799,1,1,146546,146553,146554,7,8,0
41800,6,1,146552,146554,146555,2,3,0
41801,1,1,146553,146555,146556,2,3,0
41802,1,3,146554,146556,146559,2,5,0
41803,2,3,146556,146559,146562,3,6,0
41804,4,3,146560,146562,146565,2,5,0
41805,6,2,146566,146566,146568,0,2,1
41806,1,2,146567,146568,146570,1,3,0
41807,4,3,146571,146571,146574,0,3,1
41808,2,1,146573,146574,146575,1,2,0
41809,3,3,146576,146576,146579,0,3,1
41810,2,3,146578,146579,146582,1,4,0
41811,5,2,146583,146583,146585,0,2,1
41812,1,2,146584,146585,146587,1,3,0
41813,1,3,146585,146587,146590,2,5,0
41814,4,1,146589,146590,146591,1,2,0
41815,5,2,146594,146594,146596,0,2,3
41816,5,1,146599,146599,146600,0,1,3
41817,4,3,146603,146603,146606,0,3,3
41818,5,1,146608,146608,146609,0,1,2
41819,2,2,146610,146610,146612,0,2,1
41820,1,3,146611,146612,146615,1,4,0
41821,4,3,146615,146615,146618,0,3,0
41822,6,3,146621,146621,146624,0,3,3
41823,4,3,146625,146625,146628,0,3,1
41824,6,2,146631,146631,146633,0,2,3
41825,6,2,146637,146637,146639,0,2,4
41826,5,3,146642,146642,146645,0,3,3
41827,1,3,146643,146645,146648,2,5,0
41828,3,2,146646,146648,146650,2,4,0
41829,1,1,146647,146650,146651,3,4,0
41830,3,2,146650,146651,146653,1,3,0
41831,1,1,146651,146653,146654,2,3,0
41832,1,3,146652,146654,146657,2,5,0
41833,2,2,146654,146657,146659,3,5,0
41834,6,2,146660,146660,146662,0,2,1
41835,3,1,146663,146663,146664,0,1,1
41836,6,1,146669,146669,146670,0,1,5
41837,3,1,146672,146672,146673,0,1,2
41838,2,3,146674,146674,146677,0,3,1
41839,1,1,146675,146677,146678,2,3,0
41840,4,2,146679,146679,146681,0,2,1
41841,5,1,146684,146684,146685,0,1,3
41842,2,2,146686,146686,146688,0,2,1
41843,4,1,146690,146690,146691,0,1,2
41844,5,3,146695,146695,146698,0,3,4
41845,2,3,146697,146698,146701,1,4,0
41846,3,3,146700,146701,146704,1,4,0
41847,1,1,146701,146704,146705,3,4,0
41848,2,2,146703,146705,146707,2,4,0
41849,4,3,146707,146707,146710,0,3,0
41850,1,3,146708,146710,146713,2,5,0
41851,4,3,146712,146713,146716,1,4,0
41852,4,2,146716,146716,146718,0,2,0
41853,5,3,146721,146721,146724,0,3,3
41854,2,1,146723,146724,146725,1,2,0
41855,2,2,146725,146725,146727,0,2,0
41856,4,1,146729,146729,146730,0,1,2
41857,6,2,146735,146735,146737,0,2,5
41858,5,2,146740,146740,146742,0,2,3
41859,4,1,146744,146744,146745,0,1,2
41860,3,1,146747,146747,146748,0,1,2
41861,2,1,146749,146749,146750,0,1,1
41862,3,3,146752,146752,146755,0,3,2
41863,2,3,146754,146755,146758,1,4,0
41864,1,3,146755,146758,146761,3,6,0
41865,2,1,146757,146761,146762,4,5,0
41866,1,2,146758,146762,146764,4,6,0
41867,3,3,146761,146764,146767,3,6,0
41868,4,1,146765,146767,146768,2,3,0
41869,3,1,146768,146768,146769,0,1,0
41870,5,1,146773,146773,146774,0,1,4
41871,6,3,146779,146779,146782,0,3,5
41872,1,3,146780,146782,146785,2,5,0
41873,2,3,146782,146785,146788,3,6,0
41874,3,2,146785,146788,146790,3,5,0
41875,6,2,146791,146791,146793,0,2,1
41876,6,2,146797,146797,146799,0,2,4
41877,4,3,146801,146801,146804,0,3,2
41878,2,3,146803,146804,146807,1,4,0
41879,4,2,146807,146807,146809,0,2,0
41880,5,3,146812,146812,146815,0,3,3
41881,5,3,146817,146817,146820,0,3,2
41882,5,1,146822,146822,146823,0,1,2
41883,3,3,146825,146825,146828,0,3,2
41884,6,1,146831,146831,146832,0,1,3
41885,5,3,146836,146836,146839,0,3,4
41886,6,3,146842,146842,146845,0,3,3
41887,6,3,146848,146848,146851,0,3,3
41888,4,2,146852,146852,146854,0,2,1
41889,4,2,146856,146856,146858,0,2,2
41890,5,2,146861,146861,146863,0,2,3
41891,3,3,146864,146864,146867,0,3,1
41892,2,1,146866,146867,146868,1,2,0
41893,5,2,146871,146871,146873,0,2,3
41894,4,2,146875,146875,146877,0,2,2
41895,4,2,146879,146879,146881,0,2,2
41896,2,3,146881,146881,146884,0,3,0
41897,4,3,146885,146885,146888,0,3,1
41898,1,3,146886,146888,146891,2,5,0
41899,6,1,146892,146892,146893,0,1,1
41900,4,3,146896,146896,146899,0,3,3
41901,3,3,146899,146899,146902,0,3,0
41902,1,3,146900,146902,146905,2,5,0
41903,1,3,146901,146905,146908,4,7,0
41904,4,1,146905,146908,146909,3,4,0
41905,6,1,146911,146911,146912,0,1,2
41906,4,2,146915,146915,146917,0,2,3
41907,2,1,146917,146917,146918,0,1,0
41908,5,2,146922,146922,146924,0,2,4
41909,5,2,146927,146927,146929,0,2,3
41910,1,3,146928,146929,146932,1,4,0
41911,6,2,146934,146934,146936,0,2,2
41912,4,2,146938,146938,146940,0,2,2
41913,6,3,146944,146944,146947,0,3,4
41914,3,3,146947,146947,146950,0,3,0
41915,6,2,146953,146953,146955,0,2,3
41916,5,1,146958,146958,146959,0,1,3
41917,2,2,146960,146960,146962,0,2,1
41918,5,2,146965,146965,146967,0,2,3
41919,3,1,146968,146968,146969,0,1,1
41920,6,1,146974,146974,146975,0,1,5
41921,4,2,146978,146978,146980,0,2,3
41922,4,1,146982,146982,146983,0,1,2
41923,1,3,146983,146983,146986,0,3,0
41924,1,3,146984,146986,146989,2,5,0
41925,2,1,146986,146989,146990,3,4,0
41926,1,1,146987,146990,146991,3,4,0
41927,1,2,146988,146991,146993,3,5,0
41928,6,2,146994,146994,146996,0,2,1
41929,3,3,146997,146997,147000,0,3,1
41930,1,2,146998,147000,147002,2,4,0
41931,3,3,147001,147002,147005,1,4,0
41932,5,3,147006,147006,147009,0,3,1
41933,6,1,147012,147012,147013,0,1,3
41934,5,1,147017,147017,147018,0,1,4
41935,1,1,147018,147018,147019,0,1,0
41936,3,1,147021,147021,147022,0,1,2
41937,4,1,147025,147025,147026,0,1,3
41938,3,3,147028,147028,147031,0,3,2
41939,5,2,147033,147033,147035,0,2,2
41940,5,2,147038,147038,147040,0,2,3
41941,3,2,147041,147041,147043,0,2,1
41942,4,1,147045,147045,147046,0,1,2
41943,2,1,147047,147047,147048,0,1,1
41944,3,2,147050,147050,147052,0,2,2
41945,5,1,147055,147055,147056,0,1,3
41946,1,2,147056,147056,147058,0,2,0
41947,3,3,147059,147059,147062,0,3,1
41948,5,1,147064,147064,147065,0,1,2
41949,2,1,147066,147066,147067,0,1,1
41950,4,3,147070,147070,147073,0,3,3
41951,3,3,147073,147073,147076,0,3,0
41952,5,1,147078,147078,147079,0,1,2
41953,6,2,147084,147084,147086,0,2,5
41954,4,3,147088,147088,147091,0,3,2
41955,6,2,147094,147094,147096,0,2,3
41956,6,1,147100,147100,147101,0,1,4
41957,5,3,147105,147105,147108,0,3,4
41958,4,2,147109,147109,147111,0,2,1
41959,1,2,147110,147111,147113,1,3,0
41960,2,2,147112,147113,147115,1,3,0
41961,6,3,147118,147118,147121,0,3,3
41962,4,1,147122,147122,147123,0,1,1
41963,2,2,147124,147124,147126,0,2,1
41964,1,2,147125,147126,147128,1,3,0
41965,2,2,147127,147128,147130,1,3,0
41966,2,1,147129,147130,147131,1,2,0
41967,2,3,147131,147131,147134,0,3,0
41968,4,3,147135,147135,147138,0,3,1
41969,1,1,147136,147138,147139,2,3,0
41970,3,1,147139,147139,147140,0,1,0
41971,4,2,147143,147143,147145,0,2,3
41972,4,1,147147,147147,147148,0,1,2
41973,6,1,147153,147153,147154,0,1,5
41974,2,1,147155,147155,147156,0,1,1
41975,4,2,147159,147159,147161,0,2,3
41976,6,2,147165,147165,147167,0,2,4
41977,4,1,147169,147169,147170,0,1,2
41978,5,2,147174,147174,147176,0,2,4
41979,5,3,147179,147179,147182,0,3,3
41980,4,2,147183,147183,147185,0,2,1
41981,2,1,147185,147185,147186,0,1,0
41982,5,2,147190,147190,147192,0,2,4
41983,1,2,147191,147192,147194,1,3,0
41984,5,3,147196,147196,147199,0,3,2
41985,1,3,147197,147199,147202,2,5,0
41986,6,2,147203,147203,147205,0,2,1
41987,4,3,147207,147207,147210,0,3,2
41988,4,2,147211,147211,147213,0,2,1
41989,5,3,147216,147216,147219,0,3,3
41990,1,3,147217,147219,147222,2,5,0
41991,1,2,147218,147222,147224,4,6,0
41992,4,2,147222,147224,147226,2,4,0
41993,1,1,147223,147226,147227,3,4,0
41994,6,3,147229,147229,147232,0,3,2
41995,3,3,147232,147232,147235,0,3,0
41996,6,3,147238,147238,147241,0,3,3
41997,6,1,147244,147244,147245,0,1,3
41998,6,3,147250,147250,147253,0,3,5
41999,1,1,147251,147253,147254,2,3,0
42000,4,3,147255,147255,147258,0,3,1
42001,2,3,147257,147258,147261,1,4,0
42002,5,3,147262,147262,147265,0,3,1
42003,3,1,147265,147265,147266,0,1,0
42004,6,2,147271,147271,147273,0,2,5
42005,6,1,147277,147277,147278,0,1,4
42006,2,3,147279,147279,147282,0,3,1
42007,3,1,147282,147282,147283,0,1,0
42008,2,1,147284,147284,147285,0,1,1
42009,2,1,147286,147286,147287,0,1,1
42010,3,3,147289,147289,147292,0,3,2
42011,5,3,147294,147294,147297,0,3,2
42012,5,2,147299,147299,147301,0,2,2
42013,3,2,147302,147302,147304,0,2,1
42014,4,2,147306,147306,147308,0,2,2
42015,2,3,147308,147308,147311,0,3,0
42016,2,2,147310,147311,147313,1,3,0
42017,4,3,147314,147314,147317,0,3,1
42018,2,2,147316,147317,147319,1,3,0
42019,2,2,147318,147319,147321,1,3,0
42020,4,1,147322,147322,147323,0,1,1
42021,3,3,147325,147325,147328,0,3,2
42022,1,3,147326,147328,147331,2,5,0
42023,6,1,147332,147332,147333,0,1,1
42024,5,1,147337,147337,147338,0,1,4
42025,1,1,147338,147338,147339,0,1,0
42026,2,3,147340,147340,147343,0,3,1
42027,2,1,147342,147343,147344,1,2,0
42028,6,2,147348,147348,147350,0,2,4
42029,5,1,147353,147353,147354,0,1,3
42030,2,3,147355,147355,147358,0,3,1
42031,1,2,147356,147358,147360,2,4,0
42032,5,2,147361,147361,147363,0,2,1
42033,6,3,147367,147367,147370,0,3,4
42034,2,2,147369,147370,147372,1,3,0
42035,5,2,147374,147374,147376,0,2,2
42036,6,3,147380,147380,147383,0,3,4
42037,3,2,147383,147383,147385,0,2,0
42038,2,2,147385,147385,147387,0,2,0
42039,6,1,147391,147391,147392,0,1,4
42040,3,1,147394,147394,147395,0,1,2
42041,3,1,147397,147397,147398,0,1,2
42042,1,1,147398,147398,147399,0,1,0
42043,4,3,147402,147402,147405,0,3,3
42044,1,3,147403,147405,147408,2,5,0
42045,3,1,147406,147408,147409,2,3,0
42046,2,1,147408,147409,147410,1,2,0
42047,2,3,147410,147410,147413,0,3,0
42048,2,2,147412,147413,147415,1,3,0
42049,6,3,147418,147418,147421,0,3,3
42050,4,2,147422,147422,147424,0,2,1
42051,5,3,147427,147427,147430,0,3,3
42052,5,3,147432,147432,147435,0,3,2
42053,5,3,147437,147437,147440,0,3,2
42054,1,1,147438,147440,147441,2,3,0
42055,1,2,147439,147441,147443,2,4,0
42056,5,3,147444,147444,147447,0,3,1
42057,4,1,147448,147448,147449,0,1,1
42058,1,1,147449,147449,147450,0,1,0
42059,3,3,147452,147452,147455,0,3,2
42060,2,2,147454,147455,147457,1,3,0
42061,5,3,147459,147459,147462,0,3,2
42062,2,1,147461,147462,147463,1,2,0
42063,2,3,147463,147463,147466,0,3,0
42064,1,2,147464,147466,147468,2,4,0
42065,5,2,147469,147469,147471,0,2,1
42066,4,2,147473,147473,147475,0,2,2
42067,5,1,147478,147478,147479,0,1,3
42068,2,2,147480,147480,147482,0,2,1
42069,6,3,147486,147486,147489,0,3,4
42070,5,2,147491,147491,147493,0,2,2
42071,6,3,147497,147497,147500,0,3,4
42072,4,2,147501,147501,147503,0,2,1
42073,3,3,147504,147504,147507,0,3,1
42074,5,1,147509,147509,147510,0,1,2
42075,6,1,147515,147515,147516,0,1,5
42076,1,3,147516,147516,147519,0,3,0
42077,3,3,147519,147519,147522,0,3,0
42078,1,3,147520,147522,147525,2,5,0
42079,6,3,147526,147526,147529,0,3,1
42080,2,2,147528,147529,147531,1,3,0
42081,1,3,147529,147531,147534,2,5,0
42082,3,1,147532,147534,147535,2,3,0
42083,6,1,147538,147538,147539,0,1,3
42084,6,2,147544,147544,147546,0,2,5
42085,2,2,147546,147546,147548,0,2,0
42086,1,1,147547,147548,147549,1,2,0
42087,1,1,147548,147549,147550,1,2,0
42088,2,3,147550,147550,147553,0,3,0
42089,4,3,147554,147554,147557,0,3,1
42090,1,3,147555,147557,147560,2,5,0
42091,1,2,147556,147560,147562,4,6,0
42092,5,1,147561,147562,147563,1,2,0
42093,6,1,147567,147567,147568,0,1,4
42094,3,2,147570,147570,147572,0,2,2
42095,3,2,147573,147573,147575,0,2,1
42096,4,1,147577,147577,147578,0,1,2
42097,4,1,147581,147581,147582,0,1,3
42098,3,1,147584,147584,147585,0,1,2
42099,2,1,147586,147586,147587,0,1,1
42100,3,2,147589,147589,147591,0,2,2
42101,1,2,147590,147591,147593,1,3,0
42102,3,2,147593,147593,147595,0,2,0
42103,6,2,147599,147599,147601,0,2,4
42104,3,3,147602,147602,147605,0,3,1
42105,5,1,147607,147607,147608,0,1,2
42106,4,3,147611,147611,147614,0,3,3
42107,2,3,147613,147614,147617,1,4,0
42108,2,2,147615,147617,147619,2,4,0
42109,3,3,147618,147619,147622,1,4,0
42110,1,1,147619,147622,147623,3,4,0
42111,1,2,147620,147623,147625,3,5,0
42112,3,2,147623,147625,147627,2,4,0
42113,2,1,147625,147627,147628,2,3,0
42114,4,3,147629,147629,147632,0,3,1
42115,6,2,147635,147635,147637,0,2,3
42116,3,1,147638,147638,147639,0,1,1
42117,1,3,147639,147639,147642,0,3,0
42118,3,2,147642,147642,147644,0,2,0
42119,1,1,147643,147644,147645,1,2,0
42120,4,2,147647,147647,147649,0,2,2
42121,3,1,147650,147650,147651,0,1,1
42122,2,1,147652,147652,147653,0,1,1
42123,6,3,147658,147658,147661,0,3,5
42124,5,3,147663,147663,147666,0,3,2
42125,6,1,147669,147669,147670,0,1,3
42126,4,3,147673,147673,147676,0,3,3
42127,2,3,147675,147676,147679,1,4,0
42128,1,1,147676,147679,147680,3,4,0
42129,3,1,147679,147680,147681,1,2,0
42130,4,3,147683,147683,147686,0,3,2
42131,2,2,147685,147686,147688,1,3,0
42132,6,3,147691,147691,147694,0,3,3
42133,3,3,147694,147694,147697,0,3,0
42134,1,2,147695,147697,147699,2,4,0
42135,3,3,147698,147699,147702,1,4,0
42136,4,1,147702,147702,147703,0,1,0
42137,5,3,147707,147707,147710,0,3,4
42138,4,3,147711,147711,147714,0,3,1
42139,4,2,147715,147715,147717,0,2,1
42140,5,3,147720,147720,147723,0,3,3
42141,4,1,147724,147724,147725,0,1,1
42142,1,3,147725,147725,147728,0,3,0
42143,6,1,147731,147731,147732,0,1,3
42144,6,3,147737,147737,147740,0,3,5
42145,4,1,147741,147741,147742,0,1,1
42146,3,2,147744,147744,147746,0,2,2
42147,5,2,147749,147749,147751,0,2,3
42148,6,3,147755,147755,147758,0,3,4
42149,3,1,147758,147758,147759,0,1,0
42150,4,3,147762,147762,147765,0,3,3
42151,4,1,147766,147766,147767,0,1,1
42152,1,1,147767,147767,147768,0,1,0
42153,2,1,147769,147769,147770,0,1,1
42154,6,2,147775,147775,147777,0,2,5
42155,6,1,147781,147781,147782,0,1,4
42156,2,1,147783,147783,147784,0,1,1
42157,6,2,147789,147789,147791,0,2,5
42158,4,2,147793,147793,147795,0,2,2
42159,6,3,147799,147799,147802,0,3,4
42160,6,1,147805,147805,147806,0,1,3
42161,3,1,147808,147808,147809,0,1,2
42162,4,3,147812,147812,147815,0,3,3
42163,4,2,147816,147816,147818,0,2,1
42164,3,1,147819,147819,147820,0,1,1
42165,6,3,147825,147825,147828,0,3,5
42166,4,3,147829,147829,147832,0,3,1
42167,4,1,147833,147833,147834,0,1,1
42168,4,3,147837,147837,147840,0,3,3
42169,5,1,147842,147842,147843,0,1,2
42170,5,2,147847,147847,147849,0,2,4
42171,2,3,147849,147849,147852,0,3,0
42172,6,2,147855,147855,147857,0,2,3
42173,1,3,147856,147857,147860,1,4,0
42174,2,3,147858,147860,147863,2,5,0
42175,2,2,147860,147863,147865,3,5,0
42176,6,2,147866,147866,147868,0,2,1
42177,2,3,147868,147868,147871,0,3,0
42178,5,3,147873,147873,147876,0,3,2
42179,3,3,147876,147876,147879,0,3,0
42180,5,1,147881,147881,147882,0,1,2
42181,2,1,147883,147883,147884,0,1,1
42182,2,1,147885,147885,147886,0,1,1
42183,3,3,147888,147888,147891,0,3,2
42184,6,3,147894,147894,147897,0,3,3
42185,3,1,147897,147897,147898,0,1,0
42186,4,1,147901,147901,147902,0,1,3
42187,2,3,147903,147903,147906,0,3,1
42188,5,3,147908,147908,147911,0,3,2
42189,4,3,147912,147912,147915,0,3,1
42190,1,3,147913,147915,147918,2,5,0
42191,1,3,147914,147918,147921,4,7,0
42192,2,2,147916,147921,147923,5,7,0
42193,2,2,147918,147923,147925,5,7,0
42194,4,2,147922,147925,147927,3,5,0
42195,4,3,147926,147927,147930,1,4,0
42196,4,3,147930,147930,147933,0,3,0
42197,1,2,147931,147933,147935,2,4,0
42198,3,2,147934,147935,147937,1,3,0
42199,2,3,147936,147937,147940,1,4,0
42200,4,3,147940,147940,147943,0,3,0
42201,3,2,147943,147943,147945,0,2,0
42202,3,3,147946,147946,147949,0,3,1
42203,1,2,147947,147949,147951,2,4,0
42204,1,3,147948,147951,147954,3,6,0
42205,3,2,147951,147954,147956,3,5,0
42206,2,1,147953,147956,147957,3,4,0
42207,6,3,147959,147959,147962,0,3,2
42208,4,1,147963,147963,147964,0,1,1
42209,2,2,147965,147965,147967,0,2,1
42210,3,3,147968,147968,147971,0,3,1
42211,3,3,147971,147971,147974,0,3,0
42212,3,2,147974,147974,147976,0,2,0
42213,2,3,147976,147976,147979,0,3,0
42214,1,2,147977,147979,147981,2,4,0
42215,1,1,147978,147981,147982,3,4,0
42216,4,3,147982,147982,147985,0,3,0
42217,4,3,147986,147986,147989,0,3,1
42218,1,2,147987,147989,147991,2,4,0
42219,4,2,147991,147991,147993,0,2,0
42220,6,1,147997,147997,147998,0,1,4
42221,4,1,148001,148001,148002,0,1,3
42222,5,1,148006,148006,148007,0,1,4
42223,6,2,148012,148012,148014,0,2,5
42224,1,1,148013,148014,148015,1,2,0
42225,1,3,148014,148015,148018,1,4,0
42226,6,3,148020,148020,148023,0,3,2
42227,5,1,148025,148025,148026,0,1,2
42228,3,3,148028,148028,148031,0,3,2
42229,4,1,148032,148032,148033,0,1,1
42230,4,2,148036,148036,148038,0,2,3
42231,2,3,148038,148038,148041,0,3,0
42232,1,1,148039,148041,148042,2,3,0
42233,2,3,148041,148042,148045,1,4,0
42234,6,1,148047,148047,148048,0,1,2
42235,2,1,148049,148049,148050,0,1,1
42236,3,3,148052,148052,148055,0,3,2
42237,2,1,148054,148055,148056,1,2,0
42238,5,2,148059,148059,148061,0,2,3
42239,2,3,148061,148061,148064,0,3,0
42240,6,2,148067,148067,148069,0,2,3
42241,1,2,148068,148069,148071,1,3,0
42242,3,2,148071,148071,148073,0,2,0
42243,4,2,148075,148075,148077,0,2,2
42244,3,2,148078,148078,148080,0,2,1
42245,4,3,148082,148082,148085,0,3,2
42246,5,2,148087,148087,148089,0,2,2
42247,1,2,148088,148089,148091,1,3,0
42248,1,1,148089,148091,148092,2,3,0
42249,6,1,148095,148095,148096,0,1,3
42250,3,3,148098,148098,148101,0,3,2
42251,5,1,148103,148103,148104,0,1,2
42252,5,1,148108,148108,148109,0,1,4
42253,4,2,148112,148112,148114,0,2,3
42254,2,1,148114,148114,148115,0,1,0
42255,1,1,148115,148115,148116,0,1,0
42256,6,1,148121,148121,148122,0,1,5
42257,1,1,148122,148122,148123,0,1,0
42258,3,3,148125,148125,148128,0,3,2
42259,1,3,148126,148128,148131,2,5,0
42260,5,1,148131,148131,148132,0,1,0
42261,3,1,148134,148134,148135,0,1,2
42262,4,3,148138,148138,148141,0,3,3
42263,6,1,148144,148144,148145,0,1,3
42264,1,3,148145,148145,148148,0,3,0
42265,2,3,148147,148148,148151,1,4,0
42266,1,1,148148,148151,148152,3,4,0
42267,3,3,148151,148152,148155,1,4,0
42268,2,2,148153,148155,148157,2,4,0
42269,6,1,148159,148159,148160,0,1,2
42270,3,1,148162,148162,148163,0,1,2
42271,4,2,148166,148166,148168,0,2,3
42272,1,2,148167,148168,148170,1,3,0
42273,6,3,148173,148173,148176,0,3,3
42274,6,1,148179,148179,148180,0,1,3
42275,2,2,148181,148181,148183,0,2,1
42276,2,3,148183,148183,148186,0,3,0
42277,3,2,148186,148186,148188,0,2,0
42278,5,3,148191,148191,148194,0,3,3
42279,1,3,148192,148194,148197,2,5,0
42280,1,2,148193,148197,148199,4,6,0
42281,5,3,148198,148199,148202,1,4,0
42282,3,1,148201,148202,148203,1,2,0
42283,6,3,148207,148207,148210,0,3,4
42284,4,1,148211,148211,148212,0,1,1
42285,5,3,148216,148216,148219,0,3,4
42286,4,2,148220,148220,148222,0,2,1
42287,4,3,148224,148224,148227,0,3,2
42288,3,2,148227,148227,148229,0,2,0
42289,5,3,148232,148232,148235,0,3,3
42290,6,2,148238,148238,148240,0,2,3
42291,4,3,148242,148242,148245,0,3,2
42292,6,3,148248,148248,148251,0,3,3
42293,5,3,148253,148253,148256,0,3,2
42294,6,3,148259,148259,148262,0,3,3
42295,2,1,148261,148262,148263,1,2,0
42296,2,1,148263,148263,148264,0,1,0
42297,6,2,148269,148269,148271,0,2,5
42298,4,3,148273,148273,148276,0,3,2
42299,1,3,148274,148276,148279,2,5,0
42300,3,3,148277,148279,148282,2,5,0
42301,5,2,148282,148282,148284,0,2,0
42302,5,2,148287,148287,148289,0,2,3
42303,2,2,148289,148289,148291,0,2,0
42304,5,1,148294,148294,148295,0,1,3
42305,2,2,148296,148296,148298,0,2,1
42306,4,1,148300,148300,148301,0,1,2
42307,5,3,148305,148305,148308,0,3,4
42308,5,2,148310,148310,148312,0,2,2
42309,1,2,148311,148312,148314,1,3,0
42310,4,1,148315,148315,148316,0,1,1
42311,2,1,148317,148317,148318,0,1,1
42312,2,1,148319,148319,148320,0,1,1
42313,1,3,148320,148320,148323,0,3,0
42314,1,2,148321,148323,148325,2,4,0
42315,6,2,148327,148327,148329,0,2,2
42316,1,3,148328,148329,148332,1,4,0
42317,3,1,148331,148332,148333,1,2,0
42318,1,2,148332,148333,148335,1,3,0
42319,6,1,148338,148338,148339,0,1,3
42320,2,2,148340,148340,148342,0,2,1
42321,5,1,148345,148345,148346,0,1,3
42322,4,1,148349,148349,148350,0,1,3
42323,1,1,148350,148350,148351,0,1,0
42324,2,1,148352,148352,148353,0,1,1
42325,5,2,148357,148357,148359,0,2,4
42326,1,2,148358,148359,148361,1,3,0
42327,1,3,148359,148361,148364,2,5,0
42328,5,2,148364,148364,148366,0,2,0
42329,5,2,148369,148369,148371,0,2,3
42330,5,2,148374,148374,148376,0,2,3
42331,2,2,148376,148376,148378,0,2,0
42332,1,1,148377,148378,148379,1,2,0
42333,6,3,148383,148383,148386,0,3,4
42334,3,2,148386,148386,148388,0,2,0
42335,4,2,148390,148390,148392,0,2,2
42336,5,1,148395,148395,148396,0,1,3
42337,5,1,148400,148400,148401,0,1,4
42338,4,3,148404,148404,148407,0,3,3
42339,5,3,148409,148409,148412,0,3,2
42340,2,2,148411,148412,148414,1,3,0
42341,1,3,148412,148414,148417,2,5,0
42342,6,2,148418,148418,148420,0,2,1
42343,2,2,148420,148420,148422,0,2,0
42344,6,1,148426,148426,148427,0,1,4
42345,4,3,148430,148430,148433,0,3,3
42346,6,2,148436,148436,148438,0,2,3
42347,6,2,148442,148442,148444,0,2,4
42348,1,1,148443,148444,148445,1,2,0
42349,6,1,148449,148449,148450,0,1,4
42350,4,3,148453,148453,148456,0,3,3
42351,2,3,148455,148456,148459,1,4,0
42352,2,3,148457,148459,148462,2,5,0
42353,1,2,148458,148462,148464,4,6,0
42354,1,1,148459,148464,148465,5,6,0
42355,6,3,148465,148465,148468,0,3,0
42356,3,3,148468,148468,148471,0,3,0
42357,6,3,148474,148474,148477,0,3,3
42358,5,1,148479,148479,148480,0,1,2
42359,3,2,148482,148482,148484,0,2,2
42360,5,1,148487,148487,148488,0,1,3
42361,4,1,148491,148491,148492,0,1,3
42362,2,3,148493,148493,148496,0,3,1
42363,6,1,148499,148499,148500,0,1,3
42364,1,2,148500,148500,148502,0,2,0
42365,4,2,148504,148504,148506,0,2,2
42366,4,1,148508,148508,148509,0,1,2
42367,5,3,148513,148513,148516,0,3,4
42368,4,3,148517,148517,148520,0,3,1
42369,3,2,148520,148520,148522,0,2,0
42370,1,1,148521,148522,148523,1,2,0
42371,5,1,148526,148526,148527,0,1,3
42372,5,2,148531,148531,148533,0,2,4
42373,3,2,148534,148534,148536,0,2,1
42374,2,2,148536,148536,148538,0,2,0
42375,3,1,148539,148539,148540,0,1,1
42376,1,2,148540,148540,148542,0,2,0
42377,3,2,148543,148543,148545,0,2,1
42378,3,3,148546,148546,148549,0,3,1
42379,1,1,148547,148549,148550,2,3,0
42380,2,2,148549,148550,148552,1,3,0
42381,1,2,148550,148552,148554,2,4,0
42382,3,3,148553,148554,148557,1,4,0
42383,6,3,148559,148559,148562,0,3,2
42384,6,2,148565,148565,148567,0,2,3
42385,6,3,148571,148571,148574,0,3,4
42386,2,1,148573,148574,148575,1,2,0
42387,3,2,148576,148576,148578,0,2,1
42388,4,1,148580,148580,148581,0,1,2
42389,3,3,148583,148583,148586,0,3,2
42390,2,1,148585,148586,148587,1,2,0
42391,5,1,148590,148590,148591,0,1,3
42392,3,2,148593,148593,148595,0,2,2
42393,5,3,148598,148598,148601,0,3,3
42394,6,2,148604,148604,148606,0,2,3
42395,6,2,148610,148610,148612,0,2,4
42396,5,3,148615,148615,148618,0,3,3
42397,1,3,148616,148618,148621,2,5,0
42398,3,1,148619,148621,148622,2,3,0
42399,1,2,148620,148622,148624,2,4,0
42400,6,3,148626,148626,148629,0,3,2
42401,4,1,148630,148630,148631,0,1,1
42402,6,1,148636,148636,148637,0,1,5
42403,6,3,148642,148642,148645,0,3,5
42404,3,1,148645,148645,148646,0,1,0
42405,2,3,148647,148647,148650,0,3,1
42406,2,2,148649,148650,148652,1,3,0
42407,1,1,148650,148652,148653,2,3,0
42408,4,3,148654,148654,148657,0,3,1
42409,2,1,148656,148657,148658,1,2,0
42410,6,1,148662,148662,148663,0,1,4
42411,5,2,148667,148667,148669,0,2,4
42412,3,1,148670,148670,148671,0,1,1
42413,2,3,148672,148672,148675,0,3,1
42414,2,2,148674,148675,148677,1,3,0
42415,6,3,148680,148680,148683,0,3,3
42416,2,1,148682,148683,148684,1,2,0
42417,2,1,148684,148684,148685,0,1,0
42418,1,3,148685,148685,148688,0,3,0
42419,1,2,148686,148688,148690,2,4,0
42420,4,2,148690,148690,148692,0,2,0
42421,3,2,148693,148693,148695,0,2,1
42422,3,1,148696,148696,148697,0,1,1
42423,6,2,148702,148702,148704,0,2,5
42424,5,2,148707,148707,148709,0,2,3
42425,1,3,148708,148709,148712,1,4,0
42426,6,1,148714,148714,148715,0,1,2
42427,4,2,148718,148718,148720,0,2,3
42428,4,2,148722,148722,148724,0,2,2
42429,2,1,148724,148724,148725,0,1,0
42430,5,2,148729,148729,148731,0,2,4
42431,4,1,148733,148733,148734,0,1,2
42432,3,2,148736,148736,148738,0,2,2
42433,1,1,148737,148738,148739,1,2,0
42434,5,1,148742,148742,148743,0,1,3
42435,5,1,148747,148747,148748,0,1,4
42436,1,1,148748,148748,148749,0,1,0
42437,5,2,148753,148753,148755,0,2,4
42438,4,2,148757,148757,148759,0,2,2
42439,4,3,148761,148761,148764,0,3,2
42440,5,1,148766,148766,148767,0,1,2
42441,2,2,148768,148768,148770,0,2,1
42442,3,2,148771,148771,148773,0,2,1
42443,6,3,148777,148777,148780,0,3,4
42444,3,1,148780,148780,148781,0,1,0
42445,1,3,148781,148781,148784,0,3,0
42446,3,2,148784,148784,148786,0,2,0
42447,6,3,148790,148790,148793,0,3,4
42448,1,3,148791,148793,148796,2,5,0
42449,5,1,148796,148796,148797,0,1,0
42450,5,2,148801,148801,148803,0,2,4
42451,6,2,148807,148807,148809,0,2,4
42452,3,3,148810,148810,148813,0,3,1
42453,4,3,148814,148814,148817,0,3,1
42454,2,1,148816,148817,148818,1,2,0
42455,6,2,148822,148822,148824,0,2,4
42456,2,1,148824,148824,148825,0,1,0
42457,6,1,148830,148830,148831,0,1,5
42458,3,3,148833,148833,148836,0,3,2
42459,1,1,148834,148836,148837,2,3,0
42460,2,2,148836,148837,148839,1,3,0
42461,5,3,148841,148841,148844,0,3,2
42462,1,2,148842,148844,148846,2,4,0
42463,2,2,148844,148846,148848,2,4,0
42464,5,1,148849,148849,148850,0,1,1
42465,1,1,148850,148850,148851,0,1,0
42466,6,2,148856,148856,148858,0,2,5
42467,5,3,148861,148861,148864,0,3,3
42468,5,1,148866,148866,148867,0,1,2
42469,3,1,148869,148869,148870,0,1,2
42470,3,2,148872,148872,148874,0,2,2
42471,5,1,148877,148877,148878,0,1,3
42472,3,1,148880,148880,148881,0,1,2
42473,3,2,148883,148883,148885,0,2,2
42474,3,2,148886,148886,148888,0,2,1
42475,5,2,148891,148891,148893,0,2,3
42476,5,2,148896,148896,148898,0,2,3
42477,2,2,148898,148898,148900,0,2,0
42478,2,1,148900,148900,148901,0,1,0
42479,3,3,148903,148903,148906,0,3,2
42480,6,3,148909,148909,148912,0,3,3
42481,5,1,148914,148914,148915,0,1,2
42482,5,1,148919,148919,148920,0,1,4
42483,1,1,148920,148920,148921,0,1,0
42484,5,2,148925,148925,148927,0,2,4
42485,5,2,148930,148930,148932,0,2,3
42486,4,2,148934,148934,148936,0,2,2
42487,4,2,148938,148938,148940,0,2,2
42488,5,3,148943,148943,148946,0,3,3
42489,4,3,148947,148947,148950,0,3,1
42490,5,3,148952,148952,148955,0,3,2
42491,6,3,148958,148958,148961,0,3,3
42492,4,2,148962,148962,148964,0,2,1
42493,2,1,148964,148964,148965,0,1,0
42494,5,2,148969,148969,148971,0,2,4
42495,5,2,148974,148974,148976,0,2,3
42496,3,3,148977,148977,148980,0,3,1
42497,3,3,148980,148980,148983,0,3,0
42498,6,1,148986,148986,148987,0,1,3
42499,2,3,148988,148988,148991,0,3,1
42500,2,2,148990,148991,148993,1,3,0
42501,5,3,148995,148995,148998,0,3,2
42502,1,3,148996,148998,149001,2,5,0
42503,3,3,148999,149001,149004,2,5,0
42504,5,1,149004,149004,149005,0,1,0
42505,1,1,149005,149005,149006,0,1,0
42506,5,1,149010,149010,149011,0,1,4
42507,1,3,149011,149011,149014,0,3,0
42508,4,3,149015,149015,149018,0,3,1
42509,2,3,149017,149018,149021,1,4,0
42510,1,2,149018,149021,149023,3,5,0
42511,3,3,149021,149023,149026,2,5,0
42512,5,1,149026,149026,149027,0,1,0
42513,4,1,149030,149030,149031,0,1,3
42514,3,2,149033,149033,149035,0,2,2
42515,5,1,149038,149038,149039,0,1,3
42516,2,2,149040,149040,149042,0,2,1
42517,6,3,149046,149046,149049,0,3,4
42518,6,3,149052,149052,149055,0,3,3
42519,5,2,149057,149057,149059,0,2,2
42520,3,3,149060,149060,149063,0,3,1
42521,2,3,149062,149063,149066,1,4,0
42522,2,1,149064,149066,149067,2,3,0
42523,2,1,149066,149067,149068,1,2,0
42524,1,3,149067,149068,149071,1,4,0
42525,5,1,149072,149072,149073,0,1,1
42526,4,1,149076,149076,149077,0,1,3
42527,4,1,149080,149080,149081,0,1,3
42528,5,3,149085,149085,149088,0,3,4
42529,4,3,149089,149089,149092,0,3,1
42530,3,1,149092,149092,149093,0,1,0
42531,6,3,149098,149098,149101,0,3,5
42532,6,3,149104,149104,149107,0,3,3
42533,5,2,149109,149109,149111,0,2,2
42534,4,3,149113,149113,149116,0,3,2
42535,2,2,149115,149116,149118,1,3,0
42536,6,3,149121,149121,149124,0,3,3
42537,5,1,149126,149126,149127,0,1,2
42538,3,3,149129,149129,149132,0,3,2
42539,1,3,149130,149132,149135,2,5,0
42540,3,3,149133,149135,149138,2,5,0
42541,6,2,149139,149139,149141,0,2,1
42542,2,2,149141,149141,149143,0,2,0
42543,4,1,149145,149145,149146,0,1,2
42544,4,3,149149,149149,149152,0,3,3
42545,4,2,149153,149153,149155,0,2,1
42546,4,2,149157,149157,149159,0,2,2
42547,2,1,149159,149159,149160,0,1,0
42548,4,3,149163,149163,149166,0,3,3
42549,1,3,149164,149166,149169,2,5,0
42550,2,1,149166,149169,149170,3,4,0
42551,6,1,149172,149172,149173,0,1,2
42552,4,3,149176,149176,149179,0,3,3
42553,6,2,149182,149182,149184,0,2,3
42554,5,1,149187,149187,149188,0,1,3
42555,5,2,149192,149192,149194,0,2,4
42556,3,2,149195,149195,149197,0,2,1
42557,2,1,149197,149197,149198,0,1,0
42558,2,3,149199,149199,149202,0,3,1
42559,5,2,149204,149204,149206,0,2,2
42560,1,2,149205,149206,149208,1,3,0
42561,2,3,149207,149208,149211,1,4,0
42562,4,2,149211,149211,149213,0,2,0
42563,6,2,149217,149217,149219,0,2,4
42564,5,3,149222,149222,149225,0,3,3
42565,2,3,149224,149225,149228,1,4,0
42566,2,2,149226,149228,149230,2,4,0
42567,6,2,149232,149232,149234,0,2,2
42568,2,3,149234,149234,149237,0,3,0
42569,6,2,149240,149240,149242,0,2,3
42570,3,1,149243,149243,149244,0,1,1
42571,4,3,149247,149247,149250,0,3,3
42572,2,1,149249,149250,149251,1,2,0
42573,1,3,149250,149251,149254,1,4,0
42574,2,1,149252,149254,149255,2,3,0
42575,5,3,149257,149257,149260,0,3,2
42576,2,3,149259,149260,149263,1,4,0
42577,2,1,149261,149263,149264,2,3,0
42578,1,3,149262,149264,149267,2,5,0
42579,1,2,149263,149267,149269,4,6,0
42580,2,1,149265,149269,149270,4,5,0
42581,4,2,149269,149270,149272,1,3,0
42582,3,2,149272,149272,149274,0,2,0
42583,6,2,149278,149278,149280,0,2,4
42584,5,3,149283,149283,149286,0,3,3
42585,3,2,149286,149286,149288,0,2,0
42586,2,1,149288,149288,149289,0,1,0
42587,6,1,149294,149294,149295,0,1,5
42588,5,3,149299,149299,149302,0,3,4
42589,4,3,149303,149303,149306,0,3,1
42590,2,1,149305,149306,149307,1,2,0
42591,1,1,149306,149307,149308,1,2,0
42592,6,3,149312,149312,149315,0,3,4
42593,2,2,149314,149315,149317,1,3,0
42594,4,3,149318,149318,149321,0,3,1
42595,5,1,149323,149323,149324,0,1,2
42596,5,1,149328,149328,149329,0,1,4
42597,2,1,149330,149330,149331,0,1,1
42598,3,3,149333,149333,149336,0,3,2
42599,2,1,149335,149336,149337,1,2,0
42600,1,1,149336,149337,149338,1,2,0
42601,4,3,149340,149340,149343,0,3,2
42602,2,2,149342,149343,149345,1,3,0
42603,6,2,149348,149348,149350,0,2,3
42604,4,1,149352,149352,149353,0,1,2
42605,6,3,149358,149358,149361,0,3,5
42606,1,1,149359,149361,149362,2,3,0
42607,3,2,149362,149362,149364,0,2,0
42608,6,2,149368,149368,149370,0,2,4
42609,3,3,149371,149371,149374,0,3,1
42610,6,2,149377,149377,149379,0,2,3
42611,2,2,149379,149379,149381,0,2,0
42612,6,3,149385,149385,149388,0,3,4
42613,4,2,149389,149389,149391,0,2,1
42614,6,1,149395,149395,149396,0,1,4
42615,4,1,149399,149399,149400,0,1,3
42616,4,1,149403,149403,149404,0,1,3
42617,2,3,149405,149405,149408,0,3,1
42618,4,3,149409,149409,149412,0,3,1
42619,6,1,149415,149415,149416,0,1,3
42620,2,3,149417,149417,149420,0,3,1
42621,6,2,149423,149423,149425,0,2,3
42622,3,2,149426,149426,149428,0,2,1
42623,5,1,149431,149431,149432,0,1,3
42624,5,1,149436,149436,149437,0,1,4
42625,6,2,149442,149442,149444,0,2,5
42626,2,1,149444,149444,149445,0,1,0
42627,2,3,149446,149446,149449,0,3,1
42628,1,1,149447,149449,149450,2,3,0
42629,2,1,149449,149450,149451,1,2,0
42630,6,3,149455,149455,149458,0,3,4
42631,4,3,149459,149459,149462,0,3,1
42632,3,3,149462,149462,149465,0,3,0
42633,1,2,149463,149465,149467,2,4,0
42634,2,2,149465,149467,149469,2,4,0
42635,6,1,149471,149471,149472,0,1,2
42636,5,3,149476,149476,149479,0,3,4
42637,5,3,149481,149481,149484,0,3,2
42638,6,2,149487,149487,149489,0,2,3
42639,5,3,149492,149492,149495,0,3,3
42640,1,3,149493,149495,149498,2,5,0
42641,6,3,149499,149499,149502,0,3,1
42642,6,1,149505,149505,149506,0,1,3
42643,4,3,149509,149509,149512,0,3,3
42644,4,2,149513,149513,149515,0,2,1
42645,1,1,149514,149515,149516,1,2,0
42646,3,3,149517,149517,149520,0,3,1
42647,1,2,149518,149520,149522,2,4,0
42648,3,3,149521,149522,149525,1,4,0
42649,4,2,149525,149525,149527,0,2,0
42650,5,1,149530,149530,149531,0,1,3
42651,4,2,149534,149534,149536,0,2,3
42652,2,1,149536,149536,149537,0,1,0
42653,6,2,149542,149542,149544,0,2,5
42654,6,1,149548,149548,149549,0,1,4
42655,4,2,149552,149552,149554,0,2,3
42656,3,3,149555,149555,149558,0,3,1
42657,4,3,149559,149559,149562,0,3,1
42658,6,3,149565,149565,149568,0,3,3
42659,4,3,149569,149569,149572,0,3,1
42660,3,3,149572,149572,149575,0,3,0
42661,6,2,149578,149578,149580,0,2,3
42662,2,1,149580,149580,149581,0,1,0
42663,3,2,149583,149583,149585,0,2,2
42664,1,3,149584,149585,149588,1,4,0
42665,2,2,149586,149588,149590,2,4,0
42666,4,2,149590,149590,149592,0,2,0
42667,4,3,149594,149594,149597,0,3,2
42668,6,2,149600,149600,149602,0,2,3
42669,6,3,149606,149606,149609,0,3,4
42670,1,3,149607,149609,149612,2,5,0
42671,2,3,149609,149612,149615,3,6,0
42672,3,3,149612,149615,149618,3,6,0
42673,4,3,149616,149618,149621,2,5,0
42674,4,1,149620,149621,149622,1,2,0
42675,4,3,149624,149624,149627,0,3,2
42676,1,1,149625,149627,149628,2,3,0
42677,4,3,149629,149629,149632,0,3,1
42678,4,2,149633,149633,149635,0,2,1
42679,6,3,149639,149639,149642,0,3,4
42680,1,3,149640,149642,149645,2,5,0
42681,1,3,149641,149645,149648,4,7,0
42682,4,1,149645,149648,149649,3,4,0
42683,4,3,149649,149649,149652,0,3,0
42684,5,2,149654,149654,149656,0,2,2
42685,4,1,149658,149658,149659,0,1,2
42686,3,2,149661,149661,149663,0,2,2
42687,1,1,149662,149663,149664,1,2,0
42688,6,1,149668,149668,149669,0,1,4
42689,6,3,149674,149674,149677,0,3,5
42690,3,1,149677,149677,149678,0,1,0
42691,1,1,149678,149678,149679,0,1,0
42692,4,2,149682,149682,149684,0,2,3
42693,4,1,149686,149686,149687,0,1,2
42694,2,1,149688,149688,149689,0,1,1
42695,2,2,149690,149690,149692,0,2,1
42696,4,3,149694,149694,149697,0,3,2
42697,5,3,149699,149699,149702,0,3,2
42698,1,1,149700,149702,149703,2,3,0
42699,3,2,149703,149703,149705,0,2,0
42700,4,1,149707,149707,149708,0,1,2
42701,3,3,149710,149710,149713,0,3,2
42702,5,1,149715,149715,149716,0,1,2
42703,4,1,149719,149719,149720,0,1,3
42704,6,3,149725,149725,149728,0,3,5
42705,5,1,149730,149730,149731,0,1,2
42706,2,3,149732,149732,149735,0,3,1
42707,6,2,149738,149738,149740,0,2,3
42708,4,1,149742,149742,149743,0,1,2
42709,5,2,149747,149747,149749,0,2,4
42710,2,3,149749,149749,149752,0,3,0
42711,1,1,149750,149752,149753,2,3,0
42712,1,2,149751,149753,149755,2,4,0
42713,3,1,149754,149755,149756,1,2,0
42714,4,3,149758,149758,149761,0,3,2
42715,6,1,149764,149764,149765,0,1,3
42716,1,3,149765,149765,149768,0,3,0
42717,6,3,149771,149771,149774,0,3,3
42718,4,1,149775,149775,149776,0,1,1
42719,3,3,149778,149778,149781,0,3,2
42720,1,3,149779,149781,149784,2,5,0
42721,6,3,149785,149785,149788,0,3,1
42722,4,2,149789,149789,149791,0,2,1
42723,6,2,149795,149795,149797,0,2,4
42724,4,3,149799,149799,149802,0,3,2
42725,4,2,149803,149803,149805,0,2,1
42726,4,2,149807,149807,149809,0,2,2
42727,3,3,149810,149810,149813,0,3,1
42728,2,1,149812,149813,149814,1,2,0
42729,3,3,149815,149815,149818,0,3,1
42730,4,1,149819,149819,149820,0,1,1
42731,2,3,149821,149821,149824,0,3,1
42732,5,1,149826,149826,149827,0,1,2
42733,1,1,149827,149827,149828,0,1,0
42734,4,2,149831,149831,149833,0,2,3
42735,6,2,149837,149837,149839,0,2,4
42736,6,1,149843,149843,149844,0,1,4
42737,4,2,149847,149847,149849,0,2,3
42738,4,2,149851,149851,149853,0,2,2
42739,6,1,149857,149857,149858,0,1,4
42740,2,3,149859,149859,149862,0,3,1
42741,1,2,149860,149862,149864,2,4,0
42742,1,3,149861,149864,149867,3,6,0
42743,4,1,149865,149867,149868,2,3,0
42744,5,2,149870,149870,149872,0,2,2
42745,5,1,149875,149875,149876,0,1,3
42746,1,3,149876,149876,149879,0,3,0
42747,5,3,149881,149881,149884,0,3,2
42748,5,2,149886,149886,149888,0,2,2
42749,2,3,149888,149888,149891,0,3,0
42750,5,3,149893,149893,149896,0,3,2
42751,2,3,149895,149896,149899,1,4,0
42752,2,2,149897,149899,149901,2,4,0
42753,6,1,149903,149903,149904,0,1,2
42754,4,1,149907,149907,149908,0,1,3
42755,3,1,149910,149910,149911,0,1,2
42756,2,3,149912,149912,149915,0,3,1
42757,6,1,149918,149918,149919,0,1,3
42758,3,1,149921,149921,149922,0,1,2
42759,4,2,149925,149925,149927,0,2,3
42760,6,3,149931,149931,149934,0,3,4
42761,3,2,149934,149934,149936,0,2,0
42762,1,3,149935,149936,149939,1,4,0
42763,4,1,149939,149939,149940,0,1,0
42764,5,2,149944,149944,149946,0,2,4
42765,2,1,149946,149946,149947,0,1,0
42766,3,3,149949,149949,149952,0,3,2
42767,3,3,149952,149952,149955,0,3,0
42768,2,2,149954,149955,149957,1,3,0
42769,5,2,149959,149959,149961,0,2,2
42770,1,1,149960,149961,149962,1,2,0
42771,5,1,149965,149965,149966,0,1,3
42772,4,2,149969,149969,149971,0,2,3
42773,2,3,149971,149971,149974,0,3,0
42774,5,3,149976,149976,149979,0,3,2
42775,5,2,149981,149981,149983,0,2,2
42776,1,1,149982,149983,149984,1,2,0
42777,4,2,149986,149986,149988,0,2,2
42778,6,1,149992,149992,149993,0,1,4
42779,1,3,149993,149993,149996,0,3,0
42780,3,3,149996,149996,149999,0,3,0
42781,6,1,150002,150002,150003,0,1,3
42782,5,1,150007,150007,150008,0,1,4
42783,3,1,150010,150010,150011,0,1,2
42784,1,1,150011,150011,150012,0,1,0
42785,1,1,150012,150012,150013,0,1,0
42786,6,3,150018,150018,150021,0,3,5
42787,4,1,150022,150022,150023,0,1,1
42788,3,2,150025,150025,150027,0,2,2
42789,2,2,150027,150027,150029,0,2,0
42790,5,1,150032,150032,150033,0,1,3
42791,2,2,150034,150034,150036,0,2,1
42792,4,2,150038,150038,150040,0,2,2
42793,2,3,150040,150040,150043,0,3,0
42794,3,3,150043,150043,150046,0,3,0
42795,3,2,150046,150046,150048,0,2,0
42796,1,2,150047,150048,150050,1,3,0
42797,4,3,150051,150051,150054,0,3,1
42798,2,3,150053,150054,150057,1,4,0
42799,2,2,150055,150057,150059,2,4,0
42800,6,2,150061,150061,150063,0,2,2
42801,6,2,150067,150067,150069,0,2,4
42802,4,3,150071,150071,150074,0,3,2
42803,3,1,150074,150074,150075,0,1,0
42804,5,1,150079,150079,150080,0,1,4
42805,5,1,150084,150084,150085,0,1,4
42806,4,3,150088,150088,150091,0,3,3
42807,4,2,150092,150092,150094,0,2,1
42808,6,2,150098,150098,150100,0,2,4
42809,2,3,150100,150100,150103,0,3,0
42810,1,2,150101,150103,150105,2,4,0
42811,3,3,150104,150105,150108,1,4,0
42812,2,3,150106,150108,150111,2,5,0
42813,3,2,150109,150111,150113,2,4,0
42814,3,1,150112,150113,150114,1,2,0
42815,2,2,150114,150114,150116,0,2,0
42816,5,2,150119,150119,150121,0,2,3
42817,6,2,150125,150125,150127,0,2,4
42818,6,2,150131,150131,150133,0,2,4
42819,6,1,150137,150137,150138,0,1,4
42820,6,3,150143,150143,150146,0,3,5
42821,4,3,150147,150147,150150,0,3,1
42822,5,2,150152,150152,150154,0,2,2
42823,6,2,150158,150158,150160,0,2,4
42824,2,2,150160,150160,150162,0,2,0
42825,5,1,150165,150165,150166,0,1,3
42826,2,3,150167,150167,150170,0,3,1
42827,4,3,150171,150171,150174,0,3,1
42828,5,2,150176,150176,150178,0,2,2
42829,3,3,150179,150179,150182,0,3,1
42830,5,2,150184,150184,150186,0,2,2
42831,2,2,150186,150186,150188,0,2,0
42832,2,2,150188,150188,150190,0,2,0
42833,1,3,150189,150190,150193,1,4,0
42834,4,3,150193,150193,150196,0,3,0
42835,6,2,150199,150199,150201,0,2,3
42836,4,1,150203,150203,150204,0,1,2
42837,6,2,150209,150209,150211,0,2,5
42838,2,3,150211,150211,150214,0,3,0
42839,4,2,150215,150215,150217,0,2,1
42840,2,1,150217,150217,150218,0,1,0
42841,2,2,150219,150219,150221,0,2,1
42842,5,2,150224,150224,150226,0,2,3
42843,4,1,150228,150228,150229,0,1,2
42844,4,3,150232,150232,150235,0,3,3
42845,3,1,150235,150235,150236,0,1,0
42846,1,1,150236,150236,150237,0,1,0
42847,4,1,150240,150240,150241,0,1,3
42848,2,2,150242,150242,150244,0,2,1
42849,1,1,150243,150244,150245,1,2,0
42850,3,1,150246,150246,150247,0,1,1
42851,2,1,150248,150248,150249,0,1,1
42852,2,3,150250,150250,150253,0,3,1
42853,5,1,150255,150255,150256,0,1,2
42854,4,3,150259,150259,150262,0,3,3
42855,2,3,150261,150262,150265,1,4,0
42856,6,3,150267,150267,150270,0,3,2
42857,6,2,150273,150273,150275,0,2,3
42858,5,3,150278,150278,150281,0,3,3
42859,1,2,150279,150281,150283,2,4,0
42860,2,2,150281,150283,150285,2,4,0
42861,2,2,150283,150285,150287,2,4,0
42862,5,2,150288,150288,150290,0,2,1
42863,3,2,150291,150291,150293,0,2,1
42864,5,1,150296,150296,150297,0,1,3
42865,2,1,150298,150298,150299,0,1,1
42866,2,2,150300,150300,150302,0,2,1
42867,3,1,150303,150303,150304,0,1,1
42868,5,3,150308,150308,150311,0,3,4
42869,5,2,150313,150313,150315,0,2,2
42870,4,2,150317,150317,150319,0,2,2
42871,5,1,150322,150322,150323,0,1,3
42872,2,3,150324,150324,150327,0,3,1
42873,5,2,150329,150329,150331,0,2,2
42874,5,1,150334,150334,150335,0,1,3
42875,6,1,150340,150340,150341,0,1,5
42876,6,2,150346,150346,150348,0,2,5
42877,4,1,150350,150350,150351,0,1,2
42878,6,2,150356,150356,150358,0,2,5
42879,3,3,150359,150359,150362,0,3,1
42880,4,3,150363,150363,150366,0,3,1
42881,1,2,150364,150366,150368,2,4,0
42882,3,2,150367,150368,150370,1,3,0
42883,6,1,150373,150373,150374,0,1,3
42884,3,1,150376,150376,150377,0,1,2
42885,3,2,150379,150379,150381,0,2,2
42886,5,3,150384,150384,150387,0,3,3
42887,1,1,150385,150387,150388,2,3,0
42888,6,2,150391,150391,150393,0,2,3
42889,6,2,150397,150397,150399,0,2,4
42890,4,3,150401,150401,150404,0,3,2
42891,4,2,150405,150405,150407,0,2,1
42892,5,3,150410,150410,150413,0,3,3
42893,3,1,150413,150413,150414,0,1,0
42894,1,1,150414,150414,150415,0,1,0
42895,4,2,150418,150418,150420,0,2,3
42896,4,2,150422,150422,150424,0,2,2
42897,6,3,150428,150428,150431,0,3,4
42898,1,2,150429,150431,150433,2,4,0
42899,2,2,150431,150433,150435,2,4,0
42900,6,1,150437,150437,150438,0,1,2
42901,4,3,150441,150441,150444,0,3,3
42902,5,2,150446,150446,150448,0,2,2
42903,3,3,150449,150449,150452,0,3,1
42904,2,1,150451,150452,150453,1,2,0
42905,1,1,150452,150453,150454,1,2,0
42906,5,3,150457,150457,150460,0,3,3
42907,2,2,150459,150460,150462,1,3,0
42908,6,3,150465,150465,150468,0,3,3
42909,1,2,150466,150468,150470,2,4,0
42910,6,3,150472,150472,150475,0,3,2
42911,3,3,150475,150475,150478,0,3,0
42912,6,2,150481,150481,150483,0,2,3
42913,1,3,150482,150483,150486,1,4,0
42914,5,2,150487,150487,150489,0,2,1
42915,3,2,150490,150490,150492,0,2,1
42916,3,2,150493,150493,150495,0,2,1
42917,4,2,150497,150497,150499,0,2,2
42918,1,3,150498,150499,150502,1,4,0
42919,6,1,150504,150504,150505,0,1,2
42920,6,1,150510,150510,150511,0,1,5
42921,6,2,150516,150516,150518,0,2,5
42922,1,3,150517,150518,150521,1,4,0
42923,5,1,150522,150522,150523,0,1,1
42924,5,1,150527,150527,150528,0,1,4
42925,6,1,150533,150533,150534,0,1,5
42926,6,1,150539,150539,150540,0,1,5
42927,2,1,150541,150541,150542,0,1,1
42928,6,1,150547,150547,150548,0,1,5
42929,4,1,150551,150551,150552,0,1,3
42930,2,3,150553,150553,150556,0,3,1
42931,4,2,150557,150557,150559,0,2,1
42932,6,1,150563,150563,150564,0,1,4
42933,6,2,150569,150569,150571,0,2,5
42934,1,2,150570,150571,150573,1,3,0
42935,6,2,150576,150576,150578,0,2,3
42936,5,2,150581,150581,150583,0,2,3
42937,3,3,150584,150584,150587,0,3,1
42938,2,1,150586,150587,150588,1,2,0
42939,3,2,150589,150589,150591,0,2,1
42940,5,2,150594,150594,150596,0,2,3
42941,1,2,150595,150596,150598,1,3,0
42942,4,2,150599,150599,150601,0,2,1
42943,2,1,150601,150601,150602,0,1,0
42944,4,1,150605,150605,150606,0,1,3
42945,4,1,150609,150609,150610,0,1,3
42946,3,1,150612,150612,150613,0,1,2
42947,6,3,150618,150618,150621,0,3,5
42948,1,3,150619,150621,150624,2,5,0
42949,4,1,150623,150624,150625,1,2,0
42950,4,2,150627,150627,150629,0,2,2
42951,5,1,150632,150632,150633,0,1,3
42952,6,2,150638,150638,150640,0,2,5
42953,3,1,150641,150641,150642,0,1,1
42954,1,1,150642,150642,150643,0,1,0
42955,4,1,150646,150646,150647,0,1,3
42956,4,1,150650,150650,150651,0,1,3
42957,5,1,150655,150655,150656,0,1,4
42958,1,2,150656,150656,150658,0,2,0
42959,4,1,150660,150660,150661,0,1,2
42960,3,1,150663,150663,150664,0,1,2
42961,3,3,150666,150666,150669,0,3,2
42962,6,2,150672,150672,150674,0,2,3
42963,1,2,150673,150674,150676,1,3,0
42964,1,3,150674,150676,150679,2,5,0
42965,2,1,150676,150679,150680,3,4,0
42966,3,3,150679,150680,150683,1,4,0
42967,3,2,150682,150683,150685,1,3,0
42968,1,1,150683,150685,150686,2,3,0
42969,4,2,150687,150687,150689,0,2,1
42970,1,1,150688,150689,150690,1,2,0
42971,4,1,150692,150692,150693,0,1,2
42972,6,2,150698,150698,150700,0,2,5
42973,6,1,150704,150704,150705,0,1,4
42974,5,1,150709,150709,150710,0,1,4
42975,2,3,150711,150711,150714,0,3,1
42976,2,2,150713,150714,150716,1,3,0
42977,3,1,150716,150716,150717,0,1,0
42978,4,3,150720,150720,150723,0,3,3
42979,1,1,150721,150723,150724,2,3,0
42980,2,1,150723,150724,150725,1,2,0
42981,6,3,150729,150729,150732,0,3,4
42982,5,3,150734,150734,150737,0,3,2
42983,4,2,150738,150738,150740,0,2,1
42984,5,1,150743,150743,150744,0,1,3
42985,1,1,150744,150744,150745,0,1,0
42986,6,1,150750,150750,150751,0,1,5
42987,6,1,150756,150756,150757,0,1,5
42988,3,2,150759,150759,150761,0,2,2
42989,4,1,150763,150763,150764,0,1,2
42990,2,2,150765,150765,150767,0,2,1
42991,5,2,150770,150770,150772,0,2,3
42992,4,2,150774,150774,150776,0,2,2
42993,3,2,150777,150777,150779,0,2,1
42994,1,2,150778,150779,150781,1,3,0
42995,3,2,150781,150781,150783,0,2,0
42996,6,3,150787,150787,150790,0,3,4
42997,4,3,150791,150791,150794,0,3,1
42998,2,2,150793,150794,150796,1,3,0
42999,1,2,150794,150796,150798,2,4,0
43000,4,3,150798,150798,150801,0,3,0
43001,3,2,150801,150801,150803,0,2,0
43002,4,1,150805,150805,150806,0,1,2
43003,4,2,150809,150809,150811,0,2,3
43004,1,1,150810,150811,150812,1,2,0
43005,4,2,150814,150814,150816,0,2,2
43006,1,1,150815,150816,150817,1,2,0
43007,5,3,150820,150820,150823,0,3,3
43008,5,3,150825,150825,150828,0,3,2
43009,5,1,150830,150830,150831,0,1,2
43010,4,1,150834,150834,150835,0,1,3
43011,3,3,150837,150837,150840,0,3,2
43012,3,2,150840,150840,150842,0,2,0
43013,3,2,150843,150843,150845,0,2,1
43014,5,1,150848,150848,150849,0,1,3
43015,2,1,150850,150850,150851,0,1,1
43016,4,3,150854,150854,150857,0,3,3
43017,2,2,150856,150857,150859,1,3,0
43018,2,1,150858,150859,150860,1,2,0
43019,3,1,150861,150861,150862,0,1,1
43020,2,2,150863,150863,150865,0,2,1
43021,2,1,150865,150865,150866,0,1,0
43022,6,1,150871,150871,150872,0,1,5
43023,6,2,150877,150877,150879,0,2,5
43024,5,1,150882,150882,150883,0,1,3
43025,5,2,150887,150887,150889,0,2,4
43026,1,2,150888,150889,150891,1,3,0
43027,2,3,150890,150891,150894,1,4,0
43028,1,2,150891,150894,150896,3,5,0
43029,6,2,150897,150897,150899,0,2,1
43030,6,3,150903,150903,150906,0,3,4
43031,2,3,150905,150906,150909,1,4,0
43032,5,2,150910,150910,150912,0,2,1
43033,2,1,150912,150912,150913,0,1,0
43034,6,3,150918,150918,150921,0,3,5
43035,2,1,150920,150921,150922,1,2,0
43036,5,1,150925,150925,150926,0,1,3
43037,5,2,150930,150930,150932,0,2,4
43038,4,2,150934,150934,150936,0,2,2
43039,5,3,150939,150939,150942,0,3,3
43040,5,3,150944,150944,150947,0,3,2
43041,1,2,150945,150947,150949,2,4,0
43042,1,1,150946,150949,150950,3,4,0
43043,1,1,150947,150950,150951,3,4,0
43044,4,2,150951,150951,150953,0,2,0
43045,2,3,150953,150953,150956,0,3,0
43046,5,2,150958,150958,150960,0,2,2
43047,4,1,150962,150962,150963,0,1,2
43048,2,2,150964,150964,150966,0,2,1
43049,6,2,150970,150970,150972,0,2,4
43050,1,2,150971,150972,150974,1,3,0
43051,3,3,150974,150974,150977,0,3,0
43052,2,3,150976,150977,150980,1,4,0
43053,6,1,150982,150982,150983,0,1,2
43054,2,3,150984,150984,150987,0,3,1
43055,1,1,150985,150987,150988,2,3,0
43056,3,3,150988,150988,150991,0,3,0
43057,5,1,150993,150993,150994,0,1,2
43058,1,1,150994,150994,150995,0,1,0
43059,3,1,150997,150997,150998,0,1,2
43060,5,2,151002,151002,151004,0,2,4
43061,1,3,151003,151004,151007,1,4,0
43062,2,2,151005,151007,151009,2,4,0
43063,3,2,151008,151009,151011,1,3,0
43064,2,2,151010,151011,151013,1,3,0
43065,4,1,151014,151014,151015,0,1,1
43066,2,1,151016,151016,151017,0,1,1
43067,4,1,151020,151020,151021,0,1,3
43068,1,1,151021,151021,151022,0,1,0
43069,5,1,151026,151026,151027,0,1,4
43070,4,2,151030,151030,151032,0,2,3
43071,5,2,151035,151035,151037,0,2,3
43072,6,2,151041,151041,151043,0,2,4
43073,4,1,151045,151045,151046,0,1,2
43074,2,3,151047,151047,151050,0,3,1
43075,2,1,151049,151050,151051,1,2,0
43076,2,3,151051,151051,151054,0,3,0
43077,1,1,151052,151054,151055,2,3,0
43078,3,3,151055,151055,151058,0,3,0
43079,4,1,151059,151059,151060,0,1,1
43080,1,2,151060,151060,151062,0,2,0
43081,5,1,151065,151065,151066,0,1,3
43082,6,3,151071,151071,151074,0,3,5
43083,5,3,151076,151076,151079,0,3,2
43084,3,1,151079,151079,151080,0,1,0
43085,4,2,151083,151083,151085,0,2,3
43086,1,1,151084,151085,151086,1,2,0
43087,2,1,151086,151086,151087,0,1,0
43088,5,3,151091,151091,151094,0,3,4
43089,2,2,151093,151094,151096,1,3,0
43090,4,2,151097,151097,151099,0,2,1
43091,5,3,151102,151102,151105,0,3,3
43092,2,2,151104,151105,151107,1,3,0
43093,4,3,151108,151108,151111,0,3,1
43094,6,3,151114,151114,151117,0,3,3
43095,6,1,151120,151120,151121,0,1,3
43096,3,3,151123,151123,151126,0,3,2
43097,5,2,151128,151128,151130,0,2,2
43098,4,2,151132,151132,151134,0,2,2
43099,3,1,151135,151135,151136,0,1,1
43100,2,3,151137,151137,151140,0,3,1
43101,5,1,151142,151142,151143,0,1,2
43102,2,1,151144,151144,151145,0,1,1
43103,5,3,151149,151149,151152,0,3,4
43104,6,3,151155,151155,151158,0,3,3
43105,6,2,151161,151161,151163,0,2,3
43106,3,1,151164,151164,151165,0,1,1
43107,2,2,151166,151166,151168,0,2,1
43108,6,2,151172,151172,151174,0,2,4
43109,6,1,151178,151178,151179,0,1,4
43110,2,1,151180,151180,151181,0,1,1
43111,1,3,151181,151181,151184,0,3,0
43112,1,1,151182,151184,151185,2,3,0
43113,3,1,151185,151185,151186,0,1,0
43114,4,2,151189,151189,151191,0,2,3
43115,4,1,151193,151193,151194,0,1,2
43116,6,1,151199,151199,151200,0,1,5
43117,5,1,151204,151204,151205,0,1,4
43118,5,3,151209,151209,151212,0,3,4
43119,1,3,151210,151212,151215,2,5,0
43120,4,2,151214,151215,151217,1,3,0
43121,4,2,151218,151218,151220,0,2,1
43122,1,3,151219,151220,151223,1,4,0
43123,3,1,151222,151223,151224,1,2,0
43124,1,3,151223,151224,151227,1,4,0
43125,2,2,151225,151227,151229,2,4,0
43126,2,2,151227,151229,151231,2,4,0
43127,5,3,151232,151232,151235,0,3,1
43128,2,1,151234,151235,151236,1,2,0
43129,2,3,151236,151236,151239,0,3,0
43130,5,2,151241,151241,151243,0,2,2
43131,6,2,151247,151247,151249,0,2,4
43132,5,2,151252,151252,151254,0,2,3
43133,4,2,151256,151256,151258,0,2,2
43134,6,2,151262,151262,151264,0,2,4
43135,2,2,151264,151264,151266,0,2,0
43136,2,3,151266,151266,151269,0,3,0
43137,4,1,151270,151270,151271,0,1,1
43138,5,1,151275,151275,151276,0,1,4
43139,4,2,151279,151279,151281,0,2,3
43140,3,2,151282,151282,151284,0,2,1
43141,5,3,151287,151287,151290,0,3,3
43142,2,3,151289,151290,151293,1,4,0
43143,6,3,151295,151295,151298,0,3,2
43144,2,1,151297,151298,151299,1,2,0
43145,6,1,151303,151303,151304,0,1,4
43146,1,2,151304,151304,151306,0,2,0
43147,6,1,151310,151310,151311,0,1,4
43148,2,2,151312,151312,151314,0,2,1
43149,5,2,151317,151317,151319,0,2,3
43150,1,2,151318,151319,151321,1,3,0
43151,3,3,151321,151321,151324,0,3,0
43152,3,2,151324,151324,151326,0,2,0
43153,5,2,151329,151329,151331,0,2,3
43154,1,1,151330,151331,151332,1,2,0
43155,1,3,151331,151332,151335,1,4,0
43156,4,2,151335,151335,151337,0,2,0
43157,6,3,151341,151341,151344,0,3,4
43158,3,2,151344,151344,151346,0,2,0
43159,5,3,151349,151349,151352,0,3,3
43160,2,1,151351,151352,151353,1,2,0
43161,1,2,151352,151353,151355,1,3,0
43162,5,2,151357,151357,151359,0,2,2
43163,2,1,151359,151359,151360,0,1,0
43164,1,2,151360,151360,151362,0,2,0
43165,5,3,151365,151365,151368,0,3,3
43166,5,1,151370,151370,151371,0,1,2
43167,6,3,151376,151376,151379,0,3,5
43168,6,1,151382,151382,151383,0,1,3
43169,6,1,151388,151388,151389,0,1,5
43170,1,1,151389,151389,151390,0,1,0
43171,4,2,151393,151393,151395,0,2,3
43172,3,1,151396,151396,151397,0,1,1
43173,5,3,151401,151401,151404,0,3,4
43174,3,2,151404,151404,151406,0,2,0
43175,3,3,151407,151407,151410,0,3,1
43176,2,2,151409,151410,151412,1,3,0
43177,4,1,151413,151413,151414,0,1,1
43178,3,3,151416,151416,151419,0,3,2
43179,1,2,151417,151419,151421,2,4,0
43180,3,3,151420,151421,151424,1,4,0
43181,5,2,151425,151425,151427,0,2,1
43182,2,1,151427,151427,151428,0,1,0
43183,2,1,151429,151429,151430,0,1,1
43184,6,2,151435,151435,151437,0,2,5
43185,5,3,151440,151440,151443,0,3,3
43186,3,2,151443,151443,151445,0,2,0
43187,4,3,151447,151447,151450,0,3,2
43188,6,1,151453,151453,151454,0,1,3
43189,3,1,151456,151456,151457,0,1,2
43190,5,3,151461,151461,151464,0,3,4
43191,6,3,151467,151467,151470,0,3,3
43192,3,2,151470,151470,151472,0,2,0
43193,1,2,151471,151472,151474,1,3,0
43194,3,1,151474,151474,151475,0,1,0
43195,4,2,151478,151478,151480,0,2,3
43196,4,3,151482,151482,151485,0,3,2
43197,3,3,151485,151485,151488,0,3,0
43198,6,2,151491,151491,151493,0,2,3
43199,4,3,151495,151495,151498,0,3,2
43200,3,2,151498,151498,151500,0,2,0
43201,1,3,151499,151500,151503,1,4,0
43202,6,3,151505,151505,151508,0,3,2
43203,2,3,151507,151508,151511,1,4,0
43204,3,1,151510,151511,151512,1,2,0
43205,5,3,151515,151515,151518,0,3,3
43206,4,1,151519,151519,151520,0,1,1
43207,5,3,151524,151524,151527,0,3,4
43208,5,3,151529,151529,151532,0,3,2
43209,4,1,151533,151533,151534,0,1,1
43210,4,3,151537,151537,151540,0,3,3
43211,6,1,151543,151543,151544,0,1,3
43212,6,3,151549,151549,151552,0,3,5
43213,4,3,151553,151553,151556,0,3,1
43214,1,3,151554,151556,151559,2,5,0
43215,5,3,151559,151559,151562,0,3,0
43216,6,1,151565,151565,151566,0,1,3
43217,5,1,151570,151570,151571,0,1,4
43218,6,3,151576,151576,151579,0,3,5
43219,1,2,151577,151579,151581,2,4,0
43220,6,1,151583,151583,151584,0,1,2
43221,3,3,151586,151586,151589,0,3,2
43222,1,3,151587,151589,151592,2,5,0
43223,1,1,151588,151592,151593,4,5,0
43224,5,2,151593,151593,151595,0,2,0
43225,1,2,151594,151595,151597,1,3,0
43226,5,2,151599,151599,151601,0,2,2
43227,2,2,151601,151601,151603,0,2,0
43228,5,1,151606,151606,151607,0,1,3
43229,6,3,151612,151612,151615,0,3,5
43230,4,1,151616,151616,151617,0,1,1
43231,1,2,151617,151617,151619,0,2,0
43232,4,3,151621,151621,151624,0,3,2
43233,1,3,151622,151624,151627,2,5,0
43234,5,2,151627,151627,151629,0,2,0
43235,2,3,151629,151629,151632,0,3,0
43236,4,2,151633,151633,151635,0,2,1
43237,5,2,151638,151638,151640,0,2,3
43238,5,3,151643,151643,151646,0,3,3
43239,2,3,151645,151646,151649,1,4,0
43240,3,1,151648,151649,151650,1,2,0
43241,1,3,151649,151650,151653,1,4,0
43242,5,3,151654,151654,151657,0,3,1
43243,5,3,151659,151659,151662,0,3,2
43244,4,2,151663,151663,151665,0,2,1
43245,3,1,151666,151666,151667,0,1,1
43246,1,3,151667,151667,151670,0,3,0
43247,2,2,151669,151670,151672,1,3,0
43248,2,3,151671,151672,151675,1,4,0
43249,2,1,151673,151675,151676,2,3,0
43250,6,1,151679,151679,151680,0,1,3
43251,1,3,151680,151680,151683,0,3,0
43252,4,1,151684,151684,151685,0,1,1
43253,1,3,151685,151685,151688,0,3,0
43254,3,1,151688,151688,151689,0,1,0
43255,5,3,151693,151693,151696,0,3,4
43256,2,1,151695,151696,151697,1,2,0
43257,2,2,151697,151697,151699,0,2,0
43258,5,1,151702,151702,151703,0,1,3
43259,6,3,151708,151708,151711,0,3,5
43260,5,1,151713,151713,151714,0,1,2
43261,3,1,151716,151716,151717,0,1,2
43262,3,1,151719,151719,151720,0,1,2
43263,1,1,151720,151720,151721,0,1,0
43264,4,1,151724,151724,151725,0,1,3
43265,4,2,151728,151728,151730,0,2,3
43266,4,2,151732,151732,151734,0,2,2
43267,4,2,151736,151736,151738,0,2,2
43268,1,1,151737,151738,151739,1,2,0
43269,6,3,151743,151743,151746,0,3,4
43270,2,2,151745,151746,151748,1,3,0
43271,1,3,151746,151748,151751,2,5,0
43272,2,2,151748,151751,151753,3,5,0
43273,4,2,151752,151753,151755,1,3,0
43274,4,3,151756,151756,151759,0,3,1
43275,6,2,151762,151762,151764,0,2,3
43276,4,3,151766,151766,151769,0,3,2
43277,2,3,151768,151769,151772,1,4,0
43278,5,3,151773,151773,151776,0,3,1
43279,6,3,151779,151779,151782,0,3,3
43280,1,3,151780,151782,151785,2,5,0
43281,6,3,151786,151786,151789,0,3,1
43282,4,1,151790,151790,151791,0,1,1
43283,1,3,151791,151791,151794,0,3,0
43284,2,2,151793,151794,151796,1,3,0
43285,6,1,151799,151799,151800,0,1,3
43286,5,1,151804,151804,151805,0,1,4
43287,1,2,151805,151805,151807,0,2,0
43288,1,1,151806,151807,151808,1,2,0
43289,2,3,151808,151808,151811,0,3,0
43290,2,2,151810,151811,151813,1,3,0
43291,1,3,151811,151813,151816,2,5,0
43292,3,3,151814,151816,151819,2,5,0
43293,3,2,151817,151819,151821,2,4,0
43294,1,3,151818,151821,151824,3,6,0
43295,2,1,151820,151824,151825,4,5,0
43296,2,3,151822,151825,151828,3,6,0
43297,3,3,151825,151828,151831,3,6,0
43298,2,1,151827,151831,151832,4,5,0
43299,5,2,151832,151832,151834,0,2,0
43300,3,2,151835,151835,151837,0,2,1
43301,6,2,151841,151841,151843,0,2,4
43302,1,3,151842,151843,151846,1,4,0
43303,1,2,151843,151846,151848,3,5,0
43304,4,3,151847,151848,151851,1,4,0
43305,1,1,151848,151851,151852,3,4,0
43306,6,2,151854,151854,151856,0,2,2
43307,1,3,151855,151856,151859,1,4,0
43308,2,3,151857,151859,151862,2,5,0
43309,5,3,151862,151862,151865,0,3,0
43310,4,2,151866,151866,151868,0,2,1
43311,5,3,151871,151871,151874,0,3,3
43312,6,2,151877,151877,151879,0,2,3
43313,2,3,151879,151879,151882,0,3,0
43314,5,3,151884,151884,151887,0,3,2
43315,3,1,151887,151887,151888,0,1,0
43316,2,2,151889,151889,151891,0,2,1
43317,5,2,151894,151894,151896,0,2,3
43318,3,1,151897,151897,151898,0,1,1
43319,3,2,151900,151900,151902,0,2,2
43320,4,1,151904,151904,151905,0,1,2
43321,2,2,151906,151906,151908,0,2,1
43322,3,1,151909,151909,151910,0,1,1
43323,4,2,151913,151913,151915,0,2,3
43324,5,1,151918,151918,151919,0,1,3
43325,1,3,151919,151919,151922,0,3,0
43326,3,2,151922,151922,151924,0,2,0
43327,6,2,151928,151928,151930,0,2,4
43328,3,3,151931,151931,151934,0,3,1
43329,2,1,151933,151934,151935,1,2,0
43330,6,1,151939,151939,151940,0,1,4
43331,1,3,151940,151940,151943,0,3,0
43332,1,2,151941,151943,151945,2,4,0
43333,6,2,151947,151947,151949,0,2,2
43334,6,1,151953,151953,151954,0,1,4
43335,5,2,151958,151958,151960,0,2,4
43336,6,1,151964,151964,151965,0,1,4
43337,3,1,151967,151967,151968,0,1,2
43338,3,2,151970,151970,151972,0,2,2
43339,5,2,151975,151975,151977,0,2,3
43340,2,3,151977,151977,151980,0,3,0
43341,6,2,151983,151983,151985,0,2,3
43342,2,3,151985,151985,151988,0,3,0
43343,3,2,151988,151988,151990,0,2,0
43344,4,1,151992,151992,151993,0,1,2
43345,5,1,151997,151997,151998,0,1,4
43346,2,3,151999,151999,152002,0,3,1
43347,1,1,152000,152002,152003,2,3,0
43348,4,1,152004,152004,152005,0,1,1
43349,1,2,152005,152005,152007,0,2,0
43350,6,3,152011,152011,152014,0,3,4
43351,1,1,152012,152014,152015,2,3,0
43352,2,2,152014,152015,152017,1,3,0
43353,2,1,152016,152017,152018,1,2,0
43354,1,3,152017,152018,152021,1,4,0
43355,2,1,152019,152021,152022,2,3,0
43356,1,2,152020,152022,152024,2,4,0
43357,4,3,152024,152024,152027,0,3,0
43358,3,2,152027,152027,152029,0,2,0
43359,1,2,152028,152029,152031,1,3,0
43360,5,3,152033,152033,152036,0,3,2
43361,1,2,152034,152036,152038,2,4,0
43362,5,3,152039,152039,152042,0,3,1
43363,1,2,152040,152042,152044,2,4,0
43364,2,1,152042,152044,152045,2,3,0
43365,2,1,152044,152045,152046,1,2,0
43366,6,3,152050,152050,152053,0,3,4
43367,5,3,152055,152055,152058,0,3,2
43368,1,3,152056,152058,152061,2,5,0
43369,3,1,152059,152061,152062,2,3,0
43370,2,3,152061,152062,152065,1,4,0
43371,3,1,152064,152065,152066,1,2,0
43372,1,2,152065,152066,152068,1,3,0
43373,1,1,152066,152068,152069,2,3,0
43374,1,3,152067,152069,152072,2,5,0
43375,2,1,152069,152072,152073,3,4,0
43376,4,3,152073,152073,152076,0,3,0
43377,5,2,152078,152078,152080,0,2,2
43378,2,3,152080,152080,152083,0,3,0
43379,6,3,152086,152086,152089,0,3,3
43380,5,3,152091,152091,152094,0,3,2
43381,1,1,152092,152094,152095,2,3,0
43382,6,1,152098,152098,152099,0,1,3
43383,6,3,152104,152104,152107,0,3,5
43384,4,1,152108,152108,152109,0,1,1
43385,1,1,152109,152109,152110,0,1,0
43386,3,3,152112,152112,152115,0,3,2
43387,2,3,152114,152115,152118,1,4,0
43388,3,2,152117,152118,152120,1,3,0
43389,3,2,152120,152120,152122,0,2,0
43390,6,2,152126,152126,152128,0,2,4
43391,3,2,152129,152129,152131,0,2,1
43392,1,1,152130,152131,152132,1,2,0
43393,4,1,152134,152134,152135,0,1,2
43394,4,1,152138,152138,152139,0,1,3
43395,1,2,152139,152139,152141,0,2,0
43396,4,3,152143,152143,152146,0,3,2
43397,4,1,152147,152147,152148,0,1,1
43398,2,3,152149,152149,152152,0,3,1
43399,2,2,152151,152152,152154,1,3,0
43400,3,3,152154,152154,152157,0,3,0
43401,5,2,152159,152159,152161,0,2,2
43402,3,1,152162,152162,152163,0,1,1
43403,3,3,152165,152165,152168,0,3,2
43404,3,1,152168,152168,152169,0,1,0
43405,2,2,152170,152170,152172,0,2,1
43406,1,1,152171,152172,152173,1,2,0
43407,2,2,152173,152173,152175,0,2,0
43408,6,3,152179,152179,152182,0,3,4
43409,1,1,152180,152182,152183,2,3,0
43410,4,1,152184,152184,152185,0,1,1
43411,4,3,152188,152188,152191,0,3,3
43412,4,2,152192,152192,152194,0,2,1
43413,3,1,152195,152195,152196,0,1,1
43414,3,1,152198,152198,152199,0,1,2
43415,1,3,152199,152199,152202,0,3,0
43416,1,3,152200,152202,152205,2,5,0
43417,1,2,152201,152205,152207,4,6,0
43418,6,1,152207,152207,152208,0,1,0
43419,4,3,152211,152211,152214,0,3,3
43420,2,2,152213,152214,152216,1,3,0
43421,6,3,152219,152219,152222,0,3,3
43422,2,1,152221,152222,152223,1,2,0
43423,6,3,152227,152227,152230,0,3,4
43424,1,3,152228,152230,152233,2,5,0
43425,3,2,152231,152233,152235,2,4,0
43426,6,3,152237,152237,152240,0,3,2
43427,1,3,152238,152240,152243,2,5,0
43428,6,3,152244,152244,152247,0,3,1
43429,5,3,152249,152249,152252,0,3,2
43430,3,1,152252,152252,152253,0,1,0
43431,3,2,152255,152255,152257,0,2,2
43432,2,3,152257,152257,152260,0,3,0
43433,3,3,152260,152260,152263,0,3,0
43434,2,1,152262,152263,152264,1,2,0
43435,6,1,152268,152268,152269,0,1,4
43436,5,3,152273,152273,152276,0,3,4
43437,5,2,152278,152278,152280,0,2,2
43438,1,3,152279,152280,152283,1,4,0
43439,3,1,152282,152283,152284,1,2,0
43440,1,2,152283,152284,152286,1,3,0
43441,2,3,152285,152286,152289,1,4,0
43442,4,2,152289,152289,152291,0,2,0
43443,4,1,152293,152293,152294,0,1,2
43444,1,1,152294,152294,152295,0,1,0
43445,5,1,152299,152299,152300,0,1,4
43446,6,2,152305,152305,152307,0,2,5
43447,6,1,152311,152311,152312,0,1,4
43448,5,2,152316,152316,152318,0,2,4
43449,5,1,152321,152321,152322,0,1,3
43450,6,3,152327,152327,152330,0,3,5
43451,5,1,152332,152332,152333,0,1,2
43452,6,2,152338,152338,152340,0,2,5
43453,4,3,152342,152342,152345,0,3,2
43454,3,3,152345,152345,152348,0,3,0
43455,2,3,152347,152348,152351,1,4,0
43456,4,2,152351,152351,152353,0,2,0
43457,1,1,152352,152353,152354,1,2,0
43458,3,1,152355,152355,152356,0,1,1
43459,2,2,152357,152357,152359,0,2,1
43460,1,3,152358,152359,152362,1,4,0
43461,1,2,152359,152362,152364,3,5,0
43462,4,2,152363,152364,152366,1,3,0
43463,6,2,152369,152369,152371,0,2,3
43464,1,1,152370,152371,152372,1,2,0
43465,6,2,152376,152376,152378,0,2,4
43466,2,1,152378,152378,152379,0,1,0
43467,3,2,152381,152381,152383,0,2,2
43468,2,1,152383,152383,152384,0,1,0
43469,1,2,152384,152384,152386,0,2,0
43470,1,3,152385,152386,152389,1,4,0
43471,5,2,152390,152390,152392,0,2,1
43472,2,1,152392,152392,152393,0,1,0
43473,3,2,152395,152395,152397,0,2,2
43474,2,2,152397,152397,152399,0,2,0
43475,6,2,152403,152403,152405,0,2,4
43476,2,1,152405,152405,152406,0,1,0
43477,4,2,152409,152409,152411,0,2,3
43478,1,3,152410,152411,152414,1,4,0
43479,4,2,152414,152414,152416,0,2,0
43480,5,2,152419,152419,152421,0,2,3
43481,3,3,152422,152422,152425,0,3,1
43482,2,3,152424,152425,152428,1,4,0
43483,6,2,152430,152430,152432,0,2,2
43484,6,3,152436,152436,152439,0,3,4
43485,5,2,152441,152441,152443,0,2,2
43486,4,3,152445,152445,152448,0,3,2
43487,1,3,152446,152448,152451,2,5,0
43488,1,3,152447,152451,152454,4,7,0
43489,1,2,152448,152454,152456,6,8,0
43490,4,3,152452,152456,152459,4,7,0
43491,3,3,152455,152459,152462,4,7,0
43492,2,3,152457,152462,152465,5,8,0
43493,2,3,152459,152465,152468,6,9,0
43494,2,3,152461,152468,152471,7,10,0
43495,6,3,152467,152471,152474,4,7,0
43496,5,1,152472,152474,152475,2,3,0
43497,4,2,152476,152476,152478,0,2,1
43498,2,2,152478,152478,152480,0,2,0
43499,6,1,152484,152484,152485,0,1,4
43500,1,1,152485,152485,152486,0,1,0
43501,4,3,152489,152489,152492,0,3,3
43502,5,2,152494,152494,152496,0,2,2
43503,5,1,152499,152499,152500,0,1,3
43504,3,3,152502,152502,152505,0,3,2
43505,1,2,152503,152505,152507,2,4,0
43506,4,3,152507,152507,152510,0,3,0
43507,6,1,152513,152513,152514,0,1,3
43508,1,1,152514,152514,152515,0,1,0
43509,3,1,152517,152517,152518,0,1,2
43510,4,3,152521,152521,152524,0,3,3
43511,1,2,152522,152524,152526,2,4,0
43512,3,3,152525,152526,152529,1,4,0
43513,6,3,152531,152531,152534,0,3,2
43514,5,3,152536,152536,152539,0,3,2
43515,4,2,152540,152540,152542,0,2,1
43516,5,2,152545,152545,152547,0,2,3
43517,3,1,152548,152548,152549,0,1,1
43518,1,2,152549,152549,152551,0,2,0
43519,6,2,152555,152555,152557,0,2,4
43520,6,1,152561,152561,152562,0,1,4
43521,5,2,152566,152566,152568,0,2,4
43522,1,3,152567,152568,152571,1,4,0
43523,5,3,152572,152572,152575,0,3,1
43524,4,3,152576,152576,152579,0,3,1
43525,2,2,152578,152579,152581,1,3,0
43526,2,1,152580,152581,152582,1,2,0
43527,4,1,152584,152584,152585,0,1,2
43528,4,3,152588,152588,152591,0,3,3
43529,2,2,152590,152591,152593,1,3,0
43530,6,3,152596,152596,152599,0,3,3
43531,6,1,152602,152602,152603,0,1,3
43532,1,1,152603,152603,152604,0,1,0
43533,3,3,152606,152606,152609,0,3,2
43534,2,3,152608,152609,152612,1,4,0
43535,3,1,152611,152612,152613,1,2,0
43536,1,2,152612,152613,152615,1,3,0
43537,6,3,152618,152618,152621,0,3,3
43538,3,1,152621,152621,152622,0,1,0
43539,4,3,152625,152625,152628,0,3,3
43540,3,1,152628,152628,152629,0,1,0
43541,6,3,152634,152634,152637,0,3,5
43542,3,1,152637,152637,152638,0,1,0
43543,2,1,152639,152639,152640,0,1,1
43544,4,1,152643,152643,152644,0,1,3
43545,4,2,152647,152647,152649,0,2,3
43546,3,2,152650,152650,152652,0,2,1
43547,6,3,152656,152656,152659,0,3,4
43548,4,1,152660,152660,152661,0,1,1
43549,3,3,152663,152663,152666,0,3,2
43550,4,1,152667,152667,152668,0,1,1
43551,6,3,152673,152673,152676,0,3,5
43552,2,3,152675,152676,152679,1,4,0
43553,4,2,152679,152679,152681,0,2,0
43554,5,2,152684,152684,152686,0,2,3
43555,1,2,152685,152686,152688,1,3,0
43556,5,3,152690,152690,152693,0,3,2
43557,1,3,152691,152693,152696,2,5,0
43558,2,2,152693,152696,152698,3,5,0
43559,3,1,152696,152698,152699,2,3,0
43560,4,2,152700,152700,152702,0,2,1
43561,4,3,152704,152704,152707,0,3,2
43562,3,2,152707,152707,152709,0,2,0
43563,2,2,152709,152709,152711,0,2,0
43564,4,2,152713,152713,152715,0,2,2
43565,3,1,152716,152716,152717,0,1,1
43566,3,3,152719,152719,152722,0,3,2
43567,1,1,152720,152722,152723,2,3,0
43568,2,3,152722,152723,152726,1,4,0
43569,6,1,152728,152728,152729,0,1,2
43570,1,2,152729,152729,152731,0,2,0
43571,6,2,152735,152735,152737,0,2,4
43572,3,3,152738,152738,152741,0,3,1
43573,5,1,152743,152743,152744,0,1,2
43574,1,1,152744,152744,152745,0,1,0
43575,4,1,152748,152748,152749,0,1,3
43576,5,1,152753,152753,152754,0,1,4
43577,2,3,152755,152755,152758,0,3,1
43578,2,3,152757,152758,152761,1,4,0
43579,4,2,152761,152761,152763,0,2,0
43580,6,1,152767,152767,152768,0,1,4
43581,3,3,152770,152770,152773,0,3,2
43582,1,3,152771,152773,152776,2,5,0
43583,2,2,152773,152776,152778,3,5,0
43584,5,3,152778,152778,152781,0,3,0
43585,1,1,152779,152781,152782,2,3,0
43586,6,3,152785,152785,152788,0,3,3
43587,3,1,152788,152788,152789,0,1,0
43588,5,1,152793,152793,152794,0,1,4
43589,3,1,152796,152796,152797,0,1,2
43590,4,3,152800,152800,152803,0,3,3
43591,2,3,152802,152803,152806,1,4,0
43592,1,3,152803,152806,152809,3,6,0
43593,2,3,152805,152809,152812,4,7,0
43594,3,2,152808,152812,152814,4,6,0
43595,5,2,152813,152814,152816,1,3,0
43596,4,3,152817,152817,152820,0,3,1
43597,1,2,152818,152820,152822,2,4,0
43598,3,3,152821,152822,152825,1,4,0
43599,4,2,152825,152825,152827,0,2,0
43600,3,2,152828,152828,152830,0,2,1
43601,4,1,152832,152832,152833,0,1,2
43602,6,1,152838,152838,152839,0,1,5
43603,2,3,152840,152840,152843,0,3,1
43604,3,2,152843,152843,152845,0,2,0
43605,3,2,152846,152846,152848,0,2,1
43606,4,1,152850,152850,152851,0,1,2
43607,2,2,152852,152852,152854,0,2,1
43608,3,2,152855,152855,152857,0,2,1
43609,6,3,152861,152861,152864,0,3,4
43610,6,1,152867,152867,152868,0,1,3
43611,1,2,152868,152868,152870,0,2,0
43612,3,3,152871,152871,152874,0,3,1
43613,2,3,152873,152874,152877,1,4,0
43614,5,3,152878,152878,152881,0,3,1
43615,6,2,152884,152884,152886,0,2,3
43616,4,3,152888,152888,152891,0,3,2
43617,6,1,152894,152894,152895,0,1,3
43618,5,1,152899,152899,152900,0,1,4
43619,1,3,152900,152900,152903,0,3,0
43620,2,2,152902,152903,152905,1,3,0
43621,3,2,152905,152905,152907,0,2,0
43622,3,2,152908,152908,152910,0,2,1
43623,3,1,152911,152911,152912,0,1,1
43624,2,3,152913,152913,152916,0,3,1
43625,5,2,152918,152918,152920,0,2,2
43626,1,3,152919,152920,152923,1,4,0
43627,3,1,152922,152923,152924,1,2,0
43628,5,1,152927,152927,152928,0,1,3
43629,3,1,152930,152930,152931,0,1,2
43630,5,1,152935,152935,152936,0,1,4
43631,3,1,152938,152938,152939,0,1,2
43632,1,3,152939,152939,152942,0,3,0
43633,1,3,152940,152942,152945,2,5,0
43634,6,2,152946,152946,152948,0,2,1
43635,2,2,152948,152948,152950,0,2,0
43636,4,1,152952,152952,152953,0,1,2
43637,1,1,152953,152953,152954,0,1,0
43638,6,1,152959,152959,152960,0,1,5
43639,6,2,152965,152965,152967,0,2,5
43640,4,3,152969,152969,152972,0,3,2
43641,1,1,152970,152972,152973,2,3,0
43642,3,3,152973,152973,152976,0,3,0
43643,1,1,152974,152976,152977,2,3,0
43644,4,2,152978,152978,152980,0,2,1
43645,5,3,152983,152983,152986,0,3,3
43646,5,2,152988,152988,152990,0,2,2
43647,3,1,152991,152991,152992,0,1,1
43648,6,1,152997,152997,152998,0,1,5
43649,5,2,153002,153002,153004,0,2,4
43650,1,1,153003,153004,153005,1,2,0
43651,3,3,153006,153006,153009,0,3,1
43652,6,2,153012,153012,153014,0,2,3
43653,6,2,153018,153018,153020,0,2,4
43654,6,2,153024,153024,153026,0,2,4
43655,4,3,153028,153028,153031,0,3,2
43656,1,1,153029,153031,153032,2,3,0
43657,6,3,153035,153035,153038,0,3,3
43658,4,1,153039,153039,153040,0,1,1
43659,2,3,153041,153041,153044,0,3,1
43660,1,3,153042,153044,153047,2,5,0
43661,1,3,153043,153047,153050,4,7,0
43662,1,2,153044,153050,153052,6,8,0
43663,3,2,153047,153052,153054,5,7,0
43664,4,1,153051,153054,153055,3,4,0
43665,2,1,153053,153055,153056,2,3,0
43666,6,3,153059,153059,153062,0,3,3
43667,5,1,153064,153064,153065,0,1,2
43668,5,2,153069,153069,153071,0,2,4
43669,5,1,153074,153074,153075,0,1,3
43670,5,2,153079,153079,153081,0,2,4
43671,5,2,153084,153084,153086,0,2,3
43672,2,3,153086,153086,153089,0,3,0
43673,5,2,153091,153091,153093,0,2,2
43674,3,1,153094,153094,153095,0,1,1
43675,4,1,153098,153098,153099,0,1,3
43676,2,2,153100,153100,153102,0,2,1
43677,2,2,153102,153102,153104,0,2,0
43678,3,1,153105,153105,153106,0,1,1
43679,6,2,153111,153111,153113,0,2,5
43680,4,1,153115,153115,153116,0,1,2
43681,6,2,153121,153121,153123,0,2,5
43682,1,1,153122,153123,153124,1,2,0
43683,6,1,153128,153128,153129,0,1,4
43684,1,2,153129,153129,153131,0,2,0
43685,4,2,153133,153133,153135,0,2,2
43686,1,2,153134,153135,153137,1,3,0
43687,5,2,153139,153139,153141,0,2,2
43688,6,3,153145,153145,153148,0,3,4
43689,1,3,153146,153148,153151,2,5,0
43690,1,2,153147,153151,153153,4,6,0
43691,1,3,153148,153153,153156,5,8,0
43692,6,2,153154,153156,153158,2,4,0
43693,2,2,153156,153158,153160,2,4,0
43694,2,3,153158,153160,153163,2,5,0
43695,4,2,153162,153163,153165,1,3,0
43696,6,3,153168,153168,153171,0,3,3
43697,6,3,153174,153174,153177,0,3,3
43698,4,2,153178,153178,153180,0,2,1
43699,3,3,153181,153181,153184,0,3,1
43700,3,3,153184,153184,153187,0,3,0
43701,2,3,153186,153187,153190,1,4,0
43702,4,2,153190,153190,153192,0,2,0
43703,2,3,153192,153192,153195,0,3,0
43704,2,2,153194,153195,153197,1,3,0
43705,3,2,153197,153197,153199,0,2,0
43706,4,3,153201,153201,153204,0,3,2
43707,1,1,153202,153204,153205,2,3,0
43708,4,1,153206,153206,153207,0,1,1
43709,1,2,153207,153207,153209,0,2,0
43710,3,2,153210,153210,153212,0,2,1
43711,6,1,153216,153216,153217,0,1,4
43712,5,1,153221,153221,153222,0,1,4
43713,6,1,153227,153227,153228,0,1,5
43714,6,1,153233,153233,153234,0,1,5
43715,6,2,153239,153239,153241,0,2,5
43716,5,3,153244,153244,153247,0,3,3
43717,2,2,153246,153247,153249,1,3,0
43718,1,1,153247,153249,153250,2,3,0
43719,5,1,153252,153252,153253,0,1,2
43720,4,3,153256,153256,153259,0,3,3
43721,2,3,153258,153259,153262,1,4,0
43722,5,3,153263,153263,153266,0,3,1
43723,6,2,153269,153269,153271,0,2,3
43724,5,1,153274,153274,153275,0,1,3
43725,3,1,153277,153277,153278,0,1,2
43726,4,3,153281,153281,153284,0,3,3
43727,4,1,153285,153285,153286,0,1,1
43728,1,2,153286,153286,153288,0,2,0
43729,3,3,153289,153289,153292,0,3,1
43730,5,2,153294,153294,153296,0,2,2
43731,3,2,153297,153297,153299,0,2,1
43732,3,2,153300,153300,153302,0,2,1
43733,6,3,153306,153306,153309,0,3,4
43734,2,1,153308,153309,153310,1,2,0
43735,4,1,153312,153312,153313,0,1,2
43736,6,2,153318,153318,153320,0,2,5
43737,3,1,153321,153321,153322,0,1,1
43738,1,3,153322,153322,153325,0,3,0
43739,3,1,153325,153325,153326,0,1,0
43740,4,1,153329,153329,153330,0,1,3
43741,2,3,153331,153331,153334,0,3,1
43742,3,3,153334,153334,153337,0,3,0
43743,6,2,153340,153340,153342,0,2,3
43744,2,3,153342,153342,153345,0,3,0
43745,6,1,153348,153348,153349,0,1,3
43746,5,1,153353,153353,153354,0,1,4
43747,6,1,153359,153359,153360,0,1,5
43748,5,1,153364,153364,153365,0,1,4
43749,6,3,153370,153370,153373,0,3,5
43750,4,1,153374,153374,153375,0,1,1
43751,5,3,153379,153379,153382,0,3,4
43752,2,2,153381,153382,153384,1,3,0
43753,2,1,153383,153384,153385,1,2,0
43754,5,2,153388,153388,153390,0,2,3
43755,5,3,153393,153393,153396,0,3,3
43756,6,1,153399,153399,153400,0,1,3
43757,6,2,153405,153405,153407,0,2,5
43758,3,3,153408,153408,153411,0,3,1
43759,4,1,153412,153412,153413,0,1,1
43760,2,1,153414,153414,153415,0,1,1
43761,2,3,153416,153416,153419,0,3,1
43762,3,2,153419,153419,153421,0,2,0
43763,4,3,153423,153423,153426,0,3,2
43764,4,3,153427,153427,153430,0,3,1
43765,5,2,153432,153432,153434,0,2,2
43766,3,1,153435,153435,153436,0,1,1
43767,6,2,153441,153441,153443,0,2,5
43768,2,2,153443,153443,153445,0,2,0
43769,1,1,153444,153445,153446,1,2,0
43770,4,2,153448,153448,153450,0,2,2
43771,1,1,153449,153450,153451,1,2,0
43772,2,2,153451,153451,153453,0,2,0
43773,1,2,153452,153453,153455,1,3,0
43774,2,2,153454,153455,153457,1,3,0
43775,2,2,153456,153457,153459,1,3,0
43776,6,1,153462,153462,153463,0,1,3
43777,1,2,153463,153463,153465,0,2,0
43778,5,1,153468,153468,153469,0,1,3
43779,4,3,153472,153472,153475,0,3,3
43780,2,3,153474,153475,153478,1,4,0
43781,1,1,153475,153478,153479,3,4,0
43782,1,3,153476,153479,153482,3,6,0
43783,3,3,153479,153482,153485,3,6,0
43784,4,2,153483,153485,153487,2,4,0
43785,1,3,153484,153487,153490,3,6,0
43786,1,2,153485,153490,153492,5,7,0
43787,3,1,153488,153492,153493,4,5,0
43788,6,3,153494,153494,153497,0,3,1
43789,6,2,153500,153500,153502,0,2,3
43790,4,2,153504,153504,153506,0,2,2
43791,2,3,153506,153506,153509,0,3,0
43792,2,1,153508,153509,153510,1,2,0
43793,4,1,153512,153512,153513,0,1,2
43794,1,2,153513,153513,153515,0,2,0
43795,2,3,153515,153515,153518,0,3,0
43796,3,1,153518,153518,153519,0,1,0
43797,3,3,153521,153521,153524,0,3,2
43798,5,3,153526,153526,153529,0,3,2
43799,3,2,153529,153529,153531,0,2,0
43800,4,1,153533,153533,153534,0,1,2
43801,2,2,153535,153535,153537,0,2,1
43802,2,2,153537,153537,153539,0,2,0
43803,1,1,153538,153539,153540,1,2,0
43804,2,2,153540,153540,153542,0,2,0
43805,6,2,153546,153546,153548,0,2,4
43806,6,2,153552,153552,153554,0,2,4
43807,2,3,153554,153554,153557,0,3,0
43808,5,3,153559,153559,153562,0,3,2
43809,3,2,153562,153562,153564,0,2,0
43810,4,2,153566,153566,153568,0,2,2
43811,5,2,153571,153571,153573,0,2,3
43812,3,3,153574,153574,153577,0,3,1
43813,3,2,153577,153577,153579,0,2,0
43814,3,1,153580,153580,153581,0,1,1
43815,6,1,153586,153586,153587,0,1,5
43816,1,2,153587,153587,153589,0,2,0
43817,5,2,153592,153592,153594,0,2,3
43818,3,2,153595,153595,153597,0,2,1
43819,2,3,153597,153597,153600,0,3,0
43820,6,2,153603,153603,153605,0,2,3
43821,5,1,153608,153608,153609,0,1,3
43822,5,1,153613,153613,153614,0,1,4
43823,3,1,153616,153616,153617,0,1,2
43824,3,2,153619,153619,153621,0,2,2
43825,6,3,153625,153625,153628,0,3,4
43826,1,3,153626,153628,153631,2,5,0
43827,4,3,153630,153631,153634,1,4,0
43828,2,3,153632,153634,153637,2,5,0
43829,5,1,153637,153637,153638,0,1,0
43830,6,3,153643,153643,153646,0,3,5
43831,4,3,153647,153647,153650,0,3,1
43832,6,2,153653,153653,153655,0,2,3
43833,5,1,153658,153658,153659,0,1,3
43834,2,3,153660,153660,153663,0,3,1
43835,1,2,153661,153663,153665,2,4,0
43836,6,2,153667,153667,153669,0,2,2
43837,4,1,153671,153671,153672,0,1,2
43838,4,3,153675,153675,153678,0,3,3
43839,2,2,153677,153678,153680,1,3,0
43840,3,1,153680,153680,153681,0,1,0
43841,5,3,153685,153685,153688,0,3,4
43842,1,1,153686,153688,153689,2,3,0
43843,4,3,153690,153690,153693,0,3,1
43844,2,3,153692,153693,153696,1,4,0
43845,3,3,153695,153696,153699,1,4,0
43846,5,2,153700,153700,153702,0,2,1
43847,6,3,153706,153706,153709,0,3,4
43848,3,3,153709,153709,153712,0,3,0
43849,5,2,153714,153714,153716,0,2,2
43850,5,1,153719,153719,153720,0,1,3
43851,4,1,153723,153723,153724,0,1,3
43852,2,2,153725,153725,153727,0,2,1
43853,3,1,153728,153728,153729,0,1,1
43854,1,2,153729,153729,153731,0,2,0
43855,4,1,153733,153733,153734,0,1,2
43856,3,1,153736,153736,153737,0,1,2
43857,1,1,153737,153737,153738,0,1,0
43858,3,2,153740,153740,153742,0,2,2
43859,3,3,153743,153743,153746,0,3,1
43860,2,3,153745,153746,153749,1,4,0
43861,4,1,153749,153749,153750,0,1,0
43862,4,2,153753,153753,153755,0,2,3
43863,4,3,153757,153757,153760,0,3,2
43864,6,2,153763,153763,153765,0,2,3
43865,1,2,153764,153765,153767,1,3,0
43866,2,1,153766,153767,153768,1,2,0
43867,4,1,153770,153770,153771,0,1,2
43868,1,1,153771,153771,153772,0,1,0
43869,3,3,153774,153774,153777,0,3,2
43870,6,1,153780,153780,153781,0,1,3
43871,2,3,153782,153782,153785,0,3,1
43872,2,1,153784,153785,153786,1,2,0
43873,3,3,153787,153787,153790,0,3,1
43874,3,2,153790,153790,153792,0,2,0
43875,2,1,153792,153792,153793,0,1,0
43876,4,1,153796,153796,153797,0,1,3
43877,6,2,153802,153802,153804,0,2,5
43878,4,3,153806,153806,153809,0,3,2
43879,2,1,153808,153809,153810,1,2,0
43880,1,2,153809,153810,153812,1,3,0
43881,3,2,153812,153812,153814,0,2,0
43882,4,1,153816,153816,153817,0,1,2
43883,4,2,153820,153820,153822,0,2,3
43884,6,1,153826,153826,153827,0,1,4
43885,6,1,153832,153832,153833,0,1,5
43886,5,2,153837,153837,153839,0,2,4
43887,5,2,153842,153842,153844,0,2,3
43888,5,2,153847,153847,153849,0,2,3
43889,6,3,153853,153853,153856,0,3,4
43890,5,1,153858,153858,153859,0,1,2
43891,3,1,153861,153861,153862,0,1,2
43892,5,2,153866,153866,153868,0,2,4
43893,5,3,153871,153871,153874,0,3,3
43894,1,1,153872,153874,153875,2,3,0
43895,2,3,153874,153875,153878,1,4,0
43896,2,2,153876,153878,153880,2,4,0
43897,5,1,153881,153881,153882,0,1,1
43898,4,3,153885,153885,153888,0,3,3
43899,4,2,153889,153889,153891,0,2,1
43900,1,2,153890,153891,153893,1,3,0
43901,2,3,153892,153893,153896,1,4,0
43902,1,1,153893,153896,153897,3,4,0
43903,5,1,153898,153898,153899,0,1,1
43904,3,1,153901,153901,153902,0,1,2
43905,5,3,153906,153906,153909,0,3,4
43906,3,1,153909,153909,153910,0,1,0
43907,5,1,153914,153914,153915,0,1,4
43908,1,1,153915,153915,153916,0,1,0
43909,5,1,153920,153920,153921,0,1,4
43910,1,3,153921,153921,153924,0,3,0
43911,2,2,153923,153924,153926,1,3,0
43912,1,2,153924,153926,153928,2,4,0
43913,4,2,153928,153928,153930,0,2,0
43914,1,2,153929,153930,153932,1,3,0
43915,2,2,153931,153932,153934,1,3,0
43916,6,2,153937,153937,153939,0,2,3
43917,3,2,153940,153940,153942,0,2,1
43918,6,3,153946,153946,153949,0,3,4
43919,5,3,153951,153951,153954,0,3,2
43920,6,1,153957,153957,153958,0,1,3
43921,4,3,153961,153961,153964,0,3,3
43922,4,3,153965,153965,153968,0,3,1
43923,2,3,153967,153968,153971,1,4,0
43924,5,2,153972,153972,153974,0,2,1
43925,2,3,153974,153974,153977,0,3,0
43926,3,1,153977,153977,153978,0,1,0
43927,5,2,153982,153982,153984,0,2,4
43928,6,3,153988,153988,153991,0,3,4
43929,2,2,153990,153991,153993,1,3,0
43930,3,3,153993,153993,153996,0,3,0
43931,5,1,153998,153998,153999,0,1,2
43932,2,1,154000,154000,154001,0,1,1
43933,2,2,154002,154002,154004,0,2,1
43934,2,2,154004,154004,154006,0,2,0
43935,1,2,154005,154006,154008,1,3,0
43936,5,2,154010,154010,154012,0,2,2
43937,3,3,154013,154013,154016,0,3,1
43938,1,3,154014,154016,154019,2,5,0
43939,3,1,154017,154019,154020,2,3,0
43940,5,1,154022,154022,154023,0,1,2
43941,4,2,154026,154026,154028,0,2,3
43942,1,3,154027,154028,154031,1,4,0
43943,4,1,154031,154031,154032,0,1,0
43944,5,1,154036,154036,154037,0,1,4
43945,1,2,154037,154037,154039,0,2,0
43946,6,3,154043,154043,154046,0,3,4
43947,1,2,154044,154046,154048,2,4,0
43948,2,1,154046,154048,154049,2,3,0
43949,5,3,154051,154051,154054,0,3,2
43950,6,3,154057,154057,154060,0,3,3
43951,2,3,154059,154060,154063,1,4,0
43952,1,1,154060,154063,154064,3,4,0
43953,1,3,154061,154064,154067,3,6,0
43954,6,2,154067,154067,154069,0,2,0
43955,3,1,154070,154070,154071,0,1,1
43956,1,2,154071,154071,154073,0,2,0
43957,2,1,154073,154073,154074,0,1,0
43958,5,3,154078,154078,154081,0,3,4
43959,3,3,154081,154081,154084,0,3,0
43960,3,1,154084,154084,154085,0,1,0
43961,2,2,154086,154086,154088,0,2,1
43962,6,1,154092,154092,154093,0,1,4
43963,3,3,154095,154095,154098,0,3,2
43964,3,3,154098,154098,154101,0,3,0
43965,3,3,154101,154101,154104,0,3,0
43966,6,3,154107,154107,154110,0,3,3
43967,2,1,154109,154110,154111,1,2,0
43968,6,3,154115,154115,154118,0,3,4
43969,4,2,154119,154119,154121,0,2,1
43970,4,1,154123,154123,154124,0,1,2
43971,1,3,154124,154124,154127,0,3,0
43972,1,2,154125,154127,154129,2,4,0
43973,3,2,154128,154129,154131,1,3,0
43974,6,2,154134,154134,154136,0,2,3
43975,6,1,154140,154140,154141,0,1,4
43976,6,2,154146,154146,154148,0,2,5
43977,4,2,154150,154150,154152,0,2,2
43978,2,2,154152,154152,154154,0,2,0
43979,3,1,154155,154155,154156,0,1,1
43980,5,2,154160,154160,154162,0,2,4
43981,5,2,154165,154165,154167,0,2,3
43982,6,2,154171,154171,154173,0,2,4
43983,6,2,154177,154177,154179,0,2,4
43984,4,3,154181,154181,154184,0,3,2
43985,3,2,154184,154184,154186,0,2,0
43986,5,3,154189,154189,154192,0,3,3
43987,1,3,154190,154192,154195,2,5,0
43988,4,2,154194,154195,154197,1,3,0
43989,1,1,154195,154197,154198,2,3,0
43990,3,3,154198,154198,154201,0,3,0
43991,2,2,154200,154201,154203,1,3,0
43992,4,3,154204,154204,154207,0,3,1
43993,5,1,154209,154209,154210,0,1,2
43994,4,1,154213,154213,154214,0,1,3
43995,1,2,154214,154214,154216,0,2,0
43996,5,3,154219,154219,154222,0,3,3
43997,6,1,154225,154225,154226,0,1,3
43998,6,2,154231,154231,154233,0,2,5
43999,2,3,154233,154233,154236,0,3,0
44000,1,2,154234,154236,154238,2,4,0
44001,1,2,154235,154238,154240,3,5,0
44002,5,3,154240,154240,154243,0,3,0
44003,5,3,154245,154245,154248,0,3,2
44004,6,3,154251,154251,154254,0,3,3
44005,1,2,154252,154254,154256,2,4,0
44006,5,1,154257,154257,154258,0,1,1
44007,5,3,154262,154262,154265,0,3,4
44008,5,3,154267,154267,154270,0,3,2
44009,3,1,154270,154270,154271,0,1,0
44010,5,1,154275,154275,154276,0,1,4
44011,4,1,154279,154279,154280,0,1,3
44012,1,1,154280,154280,154281,0,1,0
44013,1,3,154281,154281,154284,0,3,0
44014,1,2,154282,154284,154286,2,4,0
44015,3,3,154285,154286,154289,1,4,0
44016,4,1,154289,154289,154290,0,1,0
44017,5,3,154294,154294,154297,0,3,4
44018,5,2,154299,154299,154301,0,2,2
44019,2,3,154301,154301,154304,0,3,0
44020,5,2,154306,154306,154308,0,2,2
44021,4,2,154310,154310,154312,0,2,2
44022,5,1,154315,154315,154316,0,1,3
44023,4,3,154319,154319,154322,0,3,3
44024,6,2,154325,154325,154327,0,2,3
44025,1,3,154326,154327,154330,1,4,0
44026,3,2,154329,154330,154332,1,3,0
44027,6,2,154335,154335,154337,0,2,3
44028,6,1,154341,154341,154342,0,1,4
44029,6,2,154347,154347,154349,0,2,5
44030,1,1,154348,154349,154350,1,2,0
44031,1,3,154349,154350,154353,1,4,0
44032,4,2,154353,154353,154355,0,2,0
44033,3,2,154356,154356,154358,0,2,1
44034,1,2,154357,154358,154360,1,3,0
44035,5,3,154362,154362,154365,0,3,2
44036,3,3,154365,154365,154368,0,3,0
44037,6,2,154371,154371,154373,0,2,3
44038,3,1,154374,154374,154375,0,1,1
44039,3,2,154377,154377,154379,0,2,2
44040,1,2,154378,154379,154381,1,3,0
44041,6,1,154384,154384,154385,0,1,3
44042,3,3,154387,154387,154390,0,3,2
44043,3,2,154390,154390,154392,0,2,0
44044,3,2,154393,154393,154395,0,2,1
44045,1,2,154394,154395,154397,1,3,0
44046,3,3,154397,154397,154400,0,3,0
44047,3,1,154400,154400,154401,0,1,0
44048,5,2,154405,154405,154407,0,2,4
44049,4,3,154409,154409,154412,0,3,2
44050,5,2,154414,154414,154416,0,2,2
44051,2,3,154416,154416,154419,0,3,0
44052,2,3,154418,154419,154422,1,4,0
44053,3,1,154421,154422,154423,1,2,0
44054,4,1,154425,154425,154426,0,1,2
44055,6,1,154431,154431,154432,0,1,5
44056,6,2,154437,154437,154439,0,2,5
44057,3,1,154440,154440,154441,0,1,1
44058,1,2,154441,154441,154443,0,2,0
44059,4,2,154445,154445,154447,0,2,2
44060,4,2,154449,154449,154451,0,2,2
44061,3,3,154452,154452,154455,0,3,1
44062,6,3,154458,154458,154461,0,3,3
44063,5,3,154463,154463,154466,0,3,2
44064,6,2,154469,154469,154471,0,2,3
44065,5,2,154474,154474,154476,0,2,3
44066,4,3,154478,154478,154481,0,3,2
44067,6,3,154484,154484,154487,0,3,3
44068,4,1,154488,154488,154489,0,1,1
44069,3,2,154491,154491,154493,0,2,2
44070,1,2,154492,154493,154495,1,3,0
44071,4,1,154496,154496,154497,0,1,1
44072,2,1,154498,154498,154499,0,1,1
44073,2,3,154500,154500,154503,0,3,1
44074,3,3,154503,154503,154506,0,3,0
44075,1,2,154504,154506,154508,2,4,0
44076,1,2,154505,154508,154510,3,5,0
44077,4,1,154509,154510,154511,1,2,0
44078,5,1,154514,154514,154515,0,1,3
44079,4,2,154518,154518,154520,0,2,3
44080,3,1,154521,154521,154522,0,1,1
44081,3,2,154524,154524,154526,0,2,2
44082,1,1,154525,154526,154527,1,2,0
44083,6,1,154531,154531,154532,0,1,4
44084,4,1,154535,154535,154536,0,1,3
44085,3,3,154538,154538,154541,0,3,2
44086,3,3,154541,154541,154544,0,3,0
44087,6,2,154547,154547,154549,0,2,3
44088,1,2,154548,154549,154551,1,3,0
44089,2,1,154550,154551,154552,1,2,0
44090,2,2,154552,154552,154554,0,2,0
44091,5,1,154557,154557,154558,0,1,3
44092,4,2,154561,154561,154563,0,2,3
44093,1,2,154562,154563,154565,1,3,0
44094,3,2,154565,154565,154567,0,2,0
44095,5,3,154570,154570,154573,0,3,3
44096,1,3,154571,154573,154576,2,5,0
44097,2,2,154573,154576,154578,3,5,0
44098,4,1,154577,154578,154579,1,2,0
44099,4,2,154581,154581,154583,0,2,2
44100,6,3,154587,154587,154590,0,3,4
44101,6,3,154593,154593,154596,0,3,3
44102,4,3,154597,154597,154600,0,3,1
44103,6,1,154603,154603,154604,0,1,3
44104,3,3,154606,154606,154609,0,3,2
44105,6,1,154612,154612,154613,0,1,3
44106,1,1,154613,154613,154614,0,1,0
44107,5,3,154618,154618,154621,0,3,4
44108,5,3,154623,154623,154626,0,3,2
44109,4,1,154627,154627,154628,0,1,1
44110,5,3,154632,154632,154635,0,3,4
44111,3,3,154635,154635,154638,0,3,0
44112,2,3,154637,154638,154641,1,4,0
44113,5,3,154642,154642,154645,0,3,1
44114,1,1,154643,154645,154646,2,3,0
44115,2,3,154645,154646,154649,1,4,0
44116,5,3,154650,154650,154653,0,3,1
44117,1,2,154651,154653,154655,2,4,0
44118,3,2,154654,154655,154657,1,3,0
44119,4,1,154658,154658,154659,0,1,1
44120,5,1,154663,154663,154664,0,1,4
44121,5,1,154668,154668,154669,0,1,4
44122,5,1,154673,154673,154674,0,1,4
44123,6,1,154679,154679,154680,0,1,5
44124,3,1,154682,154682,154683,0,1,2
44125,5,2,154687,154687,154689,0,2,4
44126,2,1,154689,154689,154690,0,1,0
44127,3,3,154692,154692,154695,0,3,2
44128,1,3,154693,154695,154698,2,5,0
44129,4,1,154697,154698,154699,1,2,0
44130,5,2,154702,154702,154704,0,2,3
44131,5,3,154707,154707,154710,0,3,3
44132,2,2,154709,154710,154712,1,3,0
44133,6,2,154715,154715,154717,0,2,3
44134,4,1,154719,154719,154720,0,1,2
44135,1,2,154720,154720,154722,0,2,0
44136,2,1,154722,154722,154723,0,1,0
44137,3,2,154725,154725,154727,0,2,2
44138,1,3,154726,154727,154730,1,4,0
44139,6,2,154732,154732,154734,0,2,2
44140,4,1,154736,154736,154737,0,1,2
44141,6,3,154742,154742,154745,0,3,5
44142,2,1,154744,154745,154746,1,2,0
44143,2,2,154746,154746,154748,0,2,0
44144,1,2,154747,154748,154750,1,3,0
44145,6,3,154753,154753,154756,0,3,3
44146,6,2,154759,154759,154761,0,2,3
44147,2,1,154761,154761,154762,0,1,0
44148,6,1,154767,154767,154768,0,1,5
44149,5,3,154772,154772,154775,0,3,4
44150,2,3,154774,154775,154778,1,4,0
44151,1,2,154775,154778,154780,3,5,0
44152,5,2,154780,154780,154782,0,2,0
44153,1,3,154781,154782,154785,1,4,0
44154,6,1,154787,154787,154788,0,1,2
44155,4,2,154791,154791,154793,0,2,3
44156,4,2,154795,154795,154797,0,2,2
44157,4,3,154799,154799,154802,0,3,2
44158,1,1,154800,154802,154803,2,3,0
44159,2,3,154802,154803,154806,1,4,0
44160,6,3,154808,154808,154811,0,3,2
44161,5,2,154813,154813,154815,0,2,2
44162,5,3,154818,154818,154821,0,3,3
44163,5,1,154823,154823,154824,0,1,2
44164,3,3,154826,154826,154829,0,3,2
44165,4,3,154830,154830,154833,0,3,1
44166,1,3,154831,154833,154836,2,5,0
44167,6,3,154837,154837,154840,0,3,1
44168,4,3,154841,154841,154844,0,3,1
44169,6,1,154847,154847,154848,0,1,3
44170,4,3,154851,154851,154854,0,3,3
44171,4,3,154855,154855,154858,0,3,1
44172,4,1,154859,154859,154860,0,1,1
44173,3,2,154862,154862,154864,0,2,2
44174,6,1,154868,154868,154869,0,1,4
44175,4,1,154872,154872,154873,0,1,3
44176,2,3,154874,154874,154877,0,3,1
44177,3,3,154877,154877,154880,0,3,0
44178,5,1,154882,154882,154883,0,1,2
44179,2,2,154884,154884,154886,0,2,1
44180,5,2,154889,154889,154891,0,2,3
44181,4,3,154893,154893,154896,0,3,2
44182,2,1,154895,154896,154897,1,2,0
44183,4,1,154899,154899,154900,0,1,2
44184,5,2,154904,154904,154906,0,2,4
44185,2,2,154906,154906,154908,0,2,0
44186,3,3,154909,154909,154912,0,3,1
44187,5,3,154914,154914,154917,0,3,2
44188,1,3,154915,154917,154920,2,5,0
44189,1,3,154916,154920,154923,4,7,0
44190,3,2,154919,154923,154925,4,6,0
44191,4,2,154923,154925,154927,2,4,0
44192,2,3,154925,154927,154930,2,5,0
44193,5,1,154930,154930,154931,0,1,0
44194,5,1,154935,154935,154936,0,1,4
44195,4,2,154939,154939,154941,0,2,3
44196,5,2,154944,154944,154946,0,2,3
44197,6,3,154950,154950,154953,0,3,4
44198,2,2,154952,154953,154955,1,3,0
44199,4,2,154956,154956,154958,0,2,1
44200,5,1,154961,154961,154962,0,1,3
44201,3,1,154964,154964,154965,0,1,2
44202,4,1,154968,154968,154969,0,1,3
44203,3,2,154971,154971,154973,0,2,2
44204,1,2,154972,154973,154975,1,3,0
44205,2,3,154974,154975,154978,1,4,0
44206,4,2,154978,154978,154980,0,2,0
44207,4,1,154982,154982,154983,0,1,2
44208,1,1,154983,154983,154984,0,1,0
44209,2,1,154985,154985,154986,0,1,1
44210,4,3,154989,154989,154992,0,3,3
44211,3,3,154992,154992,154995,0,3,0
44212,4,3,154996,154996,154999,0,3,1
44213,3,1,154999,154999,155000,0,1,0
44214,3,2,155002,155002,155004,0,2,2
44215,2,3,155004,155004,155007,0,3,0
44216,4,1,155008,155008,155009,0,1,1
44217,1,1,155009,155009,155010,0,1,0
44218,2,2,155011,155011,155013,0,2,1
44219,4,2,155015,155015,155017,0,2,2
44220,4,3,155019,155019,155022,0,3,2
44221,4,3,155023,155023,155026,0,3,1
44222,4,1,155027,155027,155028,0,1,1
44223,4,3,155031,155031,155034,0,3,3
44224,4,1,155035,155035,155036,0,1,1
44225,4,1,155039,155039,155040,0,1,3
44226,4,3,155043,155043,155046,0,3,3
44227,6,3,155049,155049,155052,0,3,3
44228,5,1,155054,155054,155055,0,1,2
44229,4,3,155058,155058,155061,0,3,3
44230,2,3,155060,155061,155064,1,4,0
44231,1,3,155061,155064,155067,3,6,0
44232,6,2,155067,155067,155069,0,2,0
44233,2,1,155069,155069,155070,0,1,0
44234,5,3,155074,155074,155077,0,3,4
44235,1,3,155075,155077,155080,2,5,0
44236,6,1,155081,155081,155082,0,1,1
44237,2,1,155083,155083,155084,0,1,1
44238,1,1,155084,155084,155085,0,1,0
44239,3,1,155087,155087,155088,0,1,2
44240,2,2,155089,155089,155091,0,2,1
44241,1,1,155090,155091,155092,1,2,0
44242,6,1,155096,155096,155097,0,1,4
44243,6,3,155102,155102,155105,0,3,5
44244,5,2,155107,155107,155109,0,2,2
44245,3,1,155110,155110,155111,0,1,1
44246,2,3,155112,155112,155115,0,3,1
44247,2,1,155114,155115,155116,1,2,0
44248,5,1,155119,155119,155120,0,1,3
44249,2,2,155121,155121,155123,0,2,1
44250,4,3,155125,155125,155128,0,3,2
44251,2,3,155127,155128,155131,1,4,0
44252,1,1,155128,155131,155132,3,4,0
44253,4,2,155132,155132,155134,0,2,0
44254,3,1,155135,155135,155136,0,1,1
44255,3,3,155138,155138,155141,0,3,2
44256,4,1,155142,155142,155143,0,1,1
44257,3,2,155145,155145,155147,0,2,2
44258,2,1,155147,155147,155148,0,1,0
44259,6,3,155153,155153,155156,0,3,5
44260,1,2,155154,155156,155158,2,4,0
44261,3,2,155157,155158,155160,1,3,0
44262,4,1,155161,155161,155162,0,1,1
44263,6,1,155167,155167,155168,0,1,5
44264,4,1,155171,155171,155172,0,1,3
44265,4,1,155175,155175,155176,0,1,3
44266,5,3,155180,155180,155183,0,3,4
44267,1,3,155181,155183,155186,2,5,0
44268,2,1,155183,155186,155187,3,4,0
44269,6,2,155189,155189,155191,0,2,2
44270,3,3,155192,155192,155195,0,3,1
44271,2,3,155194,155195,155198,1,4,0
44272,3,2,155197,155198,155200,1,3,0
44273,1,3,155198,155200,155203,2,5,0
44274,5,2,155203,155203,155205,0,2,0
44275,5,1,155208,155208,155209,0,1,3
44276,5,1,155213,155213,155214,0,1,4
44277,5,3,155218,155218,155221,0,3,4
44278,1,3,155219,155221,155224,2,5,0
44279,2,3,155221,155224,155227,3,6,0
44280,2,3,155223,155227,155230,4,7,0
44281,4,3,155227,155230,155233,3,6,0
44282,5,3,155232,155233,155236,1,4,0
44283,1,3,155233,155236,155239,3,6,0
44284,1,1,155234,155239,155240,5,6,0
44285,1,1,155235,155240,155241,5,6,0
44286,3,1,155238,155241,155242,3,4,0
44287,1,3,155239,155242,155245,3,6,0
44288,6,2,155245,155245,155247,0,2,0
44289,6,1,155251,155251,155252,0,1,4
44290,2,3,155253,155253,155256,0,3,1
44291,6,2,155259,155259,155261,0,2,3
44292,6,1,155265,155265,155266,0,1,4
44293,4,1,155269,155269,155270,0,1,3
44294,2,1,155271,155271,155272,0,1,1
44295,4,1,155275,155275,155276,0,1,3
44296,5,2,155280,155280,155282,0,2,4
44297,1,1,155281,155282,155283,1,2,0
44298,4,3,155285,155285,155288,0,3,2
44299,1,1,155286,155288,155289,2,3,0
44300,6,2,155292,155292,155294,0,2,3
44301,1,3,155293,155294,155297,1,4,0
44302,1,3,155294,155297,155300,3,6,0
44303,4,2,155298,155300,155302,2,4,0
44304,4,2,155302,155302,155304,0,2,0
44305,4,3,155306,155306,155309,0,3,2
44306,2,2,155308,155309,155311,1,3,0
44307,2,2,155310,155311,155313,1,3,0
44308,3,3,155313,155313,155316,0,3,0
44309,5,3,155318,155318,155321,0,3,2
44310,1,1,155319,155321,155322,2,3,0
44311,4,2,155323,155323,155325,0,2,1
44312,6,3,155329,155329,155332,0,3,4
44313,5,2,155334,155334,155336,0,2,2
44314,5,1,155339,155339,155340,0,1,3
44315,5,3,155344,155344,155347,0,3,4
44316,2,2,155346,155347,155349,1,3,0
44317,1,3,155347,155349,155352,2,5,0
44318,6,1,155353,155353,155354,0,1,1
44319,6,1,155359,155359,155360,0,1,5
44320,4,1,155363,155363,155364,0,1,3
44321,5,2,155368,155368,155370,0,2,4
44322,1,3,155369,155370,155373,1,4,0
44323,5,3,155374,155374,155377,0,3,1
44324,2,1,155376,155377,155378,1,2,0
44325,1,1,155377,155378,155379,1,2,0
44326,4,3,155381,155381,155384,0,3,2
44327,6,2,155387,155387,155389,0,2,3
44328,5,1,155392,155392,155393,0,1,3
44329,1,3,155393,155393,155396,0,3,0
44330,3,1,155396,155396,155397,0,1,0
44331,6,2,155402,155402,155404,0,2,5
44332,1,2,155403,155404,155406,1,3,0
44333,3,2,155406,155406,155408,0,2,0
44334,5,1,155411,155411,155412,0,1,3
44335,3,3,155414,155414,155417,0,3,2
44336,3,3,155417,155417,155420,0,3,0
44337,1,3,155418,155420,155423,2,5,0
44338,5,2,155423,155423,155425,0,2,0
44339,2,1,155425,155425,155426,0,1,0
44340,4,2,155429,155429,155431,0,2,3
44341,1,1,155430,155431,155432,1,2,0
44342,1,1,155431,155432,155433,1,2,0
44343,5,2,155436,155436,155438,0,2,3
44344,6,2,155442,155442,155444,0,2,4
44345,2,2,155444,155444,155446,0,2,0
44346,2,2,155446,155446,155448,0,2,0
44347,6,2,155452,155452,155454,0,2,4
44348,5,3,155457,155457,155460,0,3,3
44349,4,3,155461,155461,155464,0,3,1
44350,6,3,155467,155467,155470,0,3,3
44351,4,1,155471,155471,155472,0,1,1
44352,4,2,155475,155475,155477,0,2,3
44353,1,3,155476,155477,155480,1,4,0
44354,1,1,155477,155480,155481,3,4,0
44355,6,3,155483,155483,155486,0,3,2
44356,2,3,155485,155486,155489,1,4,0
44357,4,3,155489,155489,155492,0,3,0
44358,4,2,155493,155493,155495,0,2,1
44359,6,1,155499,155499,155500,0,1,4
44360,6,1,155505,155505,155506,0,1,5
44361,3,3,155508,155508,155511,0,3,2
44362,3,3,155511,155511,155514,0,3,0
44363,3,2,155514,155514,155516,0,2,0
44364,3,2,155517,155517,155519,0,2,1
44365,3,2,155520,155520,155522,0,2,1
44366,3,3,155523,155523,155526,0,3,1
44367,3,3,155526,155526,155529,0,3,0
44368,3,1,155529,155529,155530,0,1,0
44369,4,1,155533,155533,155534,0,1,3
44370,3,2,155536,155536,155538,0,2,2
44371,1,1,155537,155538,155539,1,2,0
44372,6,3,155543,155543,155546,0,3,4
44373,2,3,155545,155546,155549,1,4,0
44374,1,2,155546,155549,155551,3,5,0
44375,2,1,155548,155551,155552,3,4,0
44376,1,3,155549,155552,155555,3,6,0
44377,5,3,155554,155555,155558,1,4,0
44378,4,3,155558,155558,155561,0,3,0
44379,1,3,155559,155561,155564,2,5,0
44380,2,3,155561,155564,155567,3,6,0
44381,2,3,155563,155567,155570,4,7,0
44382,4,3,155567,155570,155573,3,6,0
44383,6,2,155573,155573,155575,0,2,0
44384,1,3,155574,155575,155578,1,4,0
44385,4,3,155578,155578,155581,0,3,0
44386,3,1,155581,155581,155582,0,1,0
44387,5,1,155586,155586,155587,0,1,4
44388,5,3,155591,155591,155594,0,3,4
44389,5,3,155596,155596,155599,0,3,2
44390,3,1,155599,155599,155600,0,1,0
44391,4,2,155603,155603,155605,0,2,3
44392,5,3,155608,155608,155611,0,3,3
44393,2,2,155610,155611,155613,1,3,0
44394,2,3,155612,155613,155616,1,4,0
44395,2,2,155614,155616,155618,2,4,0
44396,1,3,155615,155618,155621,3,6,0
44397,5,2,155620,155621,155623,1,3,0
44398,1,2,155621,155623,155625,2,4,0
44399,3,1,155624,155625,155626,1,2,0
44400,6,3,155630,155630,155633,0,3,4
44401,4,2,155634,155634,155636,0,2,1
44402,4,1,155638,155638,155639,0,1,2
44403,5,2,155643,155643,155645,0,2,4
44404,1,1,155644,155645,155646,1,2,0
44405,3,3,155647,155647,155650,0,3,1
44406,6,1,155653,155653,155654,0,1,3
44407,5,1,155658,155658,155659,0,1,4
44408,4,3,155662,155662,155665,0,3,3
44409,3,2,155665,155665,155667,0,2,0
44410,2,3,155667,155667,155670,0,3,0
44411,4,2,155671,155671,155673,0,2,1
44412,4,2,155675,155675,155677,0,2,2
44413,3,2,155678,155678,155680,0,2,1
44414,6,1,155684,155684,155685,0,1,4
44415,1,3,155685,155685,155688,0,3,0
44416,1,2,155686,155688,155690,2,4,0
44417,6,2,155692,155692,155694,0,2,2
44418,6,3,155698,155698,155701,0,3,4
44419,3,1,155701,155701,155702,0,1,0
44420,2,1,155703,155703,155704,0,1,1
44421,2,3,155705,155705,155708,0,3,1
44422,4,2,155709,155709,155711,0,2,1
44423,1,3,155710,155711,155714,1,4,0
44424,1,3,155711,155714,155717,3,6,0
44425,2,1,155713,155717,155718,4,5,0
44426,6,3,155719,155719,155722,0,3,1
44427,2,3,155721,155722,155725,1,4,0
44428,6,1,155727,155727,155728,0,1,2
44429,4,2,155731,155731,155733,0,2,3
44430,2,3,155733,155733,155736,0,3,0
44431,4,3,155737,155737,155740,0,3,1
44432,6,2,155743,155743,155745,0,2,3
44433,5,3,155748,155748,155751,0,3,3
44434,1,3,155749,155751,155754,2,5,0
44435,2,2,155751,155754,155756,3,5,0
44436,3,3,155754,155756,155759,2,5,0
44437,6,1,155760,155760,155761,0,1,1
44438,1,2,155761,155761,155763,0,2,0
44439,3,3,155764,155764,155767,0,3,1
44440,5,1,155769,155769,155770,0,1,2
44441,2,2,155771,155771,155773,0,2,1
44442,3,2,155774,155774,155776,0,2,1
44443,3,2,155777,155777,155779,0,2,1
44444,4,3,155781,155781,155784,0,3,2
44445,3,3,155784,155784,155787,0,3,0
44446,1,1,155785,155787,155788,2,3,0
44447,2,2,155787,155788,155790,1,3,0
44448,1,1,155788,155790,155791,2,3,0
44449,3,3,155791,155791,155794,0,3,0
44450,4,3,155795,155795,155798,0,3,1
44451,2,2,155797,155798,155800,1,3,0
44452,4,3,155801,155801,155804,0,3,1
44453,6,2,155807,155807,155809,0,2,3
44454,6,2,155813,155813,155815,0,2,4
44455,2,2,155815,155815,155817,0,2,0
44456,6,2,155821,155821,155823,0,2,4
44457,6,2,155827,155827,155829,0,2,4
44458,1,3,155828,155829,155832,1,4,0
44459,1,1,155829,155832,155833,3,4,0
44460,5,3,155834,155834,155837,0,3,1
44461,4,3,155838,155838,155841,0,3,1
44462,4,1,155842,155842,155843,0,1,1
44463,1,2,155843,155843,155845,0,2,0
44464,1,1,155844,155845,155846,1,2,0
44465,6,1,155850,155850,155851,0,1,4
44466,4,3,155854,155854,155857,0,3,3
44467,3,3,155857,155857,155860,0,3,0
44468,5,1,155862,155862,155863,0,1,2
44469,3,1,155865,155865,155866,0,1,2
44470,6,1,155871,155871,155872,0,1,5
44471,5,3,155876,155876,155879,0,3,4
44472,2,2,155878,155879,155881,1,3,0
44473,5,3,155883,155883,155886,0,3,2
44474,6,3,155889,155889,155892,0,3,3
44475,5,1,155894,155894,155895,0,1,2
44476,6,1,155900,155900,155901,0,1,5
44477,5,3,155905,155905,155908,0,3,4
44478,5,1,155910,155910,155911,0,1,2
44479,3,3,155913,155913,155916,0,3,2
44480,3,1,155916,155916,155917,0,1,0
44481,4,3,155920,155920,155923,0,3,3
44482,4,1,155924,155924,155925,0,1,1
44483,5,1,155929,155929,155930,0,1,4
44484,5,3,155934,155934,155937,0,3,4
44485,6,2,155940,155940,155942,0,2,3
44486,3,3,155943,155943,155946,0,3,1
44487,1,1,155944,155946,155947,2,3,0
44488,5,3,155949,155949,155952,0,3,2
44489,6,1,155955,155955,155956,0,1,3
44490,2,3,155957,155957,155960,0,3,1
44491,4,3,155961,155961,155964,0,3,1
44492,4,1,155965,155965,155966,0,1,1
44493,4,2,155969,155969,155971,0,2,3
44494,4,3,155973,155973,155976,0,3,2
44495,5,2,155978,155978,155980,0,2,2
44496,6,2,155984,155984,155986,0,2,4
44497,2,3,155986,155986,155989,0,3,0
44498,4,2,155990,155990,155992,0,2,1
44499,3,2,155993,155993,155995,0,2,1
44500,5,2,155998,155998,156000,0,2,3
44501,6,1,156004,156004,156005,0,1,4
44502,5,1,156009,156009,156010,0,1,4
44503,6,3,156015,156015,156018,0,3,5
44504,1,2,156016,156018,156020,2,4,0
44505,5,1,156021,156021,156022,0,1,1
44506,2,2,156023,156023,156025,0,2,1
44507,4,1,156027,156027,156028,0,1,2
44508,4,3,156031,156031,156034,0,3,3
44509,3,3,156034,156034,156037,0,3,0
44510,5,2,156039,156039,156041,0,2,2
44511,2,1,156041,156041,156042,0,1,0
44512,2,1,156043,156043,156044,0,1,1
44513,4,2,156047,156047,156049,0,2,3
44514,2,1,156049,156049,156050,0,1,0
44515,6,3,156055,156055,156058,0,3,5
44516,6,1,156061,156061,156062,0,1,3
44517,5,2,156066,156066,156068,0,2,4
44518,6,3,156072,156072,156075,0,3,4
44519,4,3,156076,156076,156079,0,3,1
44520,4,1,156080,156080,156081,0,1,1
44521,5,1,156085,156085,156086,0,1,4
44522,3,3,156088,156088,156091,0,3,2
44523,4,2,156092,156092,156094,0,2,1
44524,1,3,156093,156094,156097,1,4,0
44525,2,2,156095,156097,156099,2,4,0
44526,1,1,156096,156099,156100,3,4,0
44527,2,3,156098,156100,156103,2,5,0
44528,4,2,156102,156103,156105,1,3,0
44529,2,1,156104,156105,156106,1,2,0
44530,6,1,156110,156110,156111,0,1,4
44531,5,3,156115,156115,156118,0,3,4
44532,3,3,156118,156118,156121,0,3,0
44533,4,3,156122,156122,156125,0,3,1
44534,6,1,156128,156128,156129,0,1,3
44535,3,3,156131,156131,156134,0,3,2
44536,1,1,156132,156134,156135,2,3,0
44537,4,3,156136,156136,156139,0,3,1
44538,2,3,156138,156139,156142,1,4,0
44539,3,1,156141,156142,156143,1,2,0
44540,1,1,156142,156143,156144,1,2,0
44541,4,3,156146,156146,156149,0,3,2
44542,5,2,156151,156151,156153,0,2,2
44543,5,3,156156,156156,156159,0,3,3
44544,6,1,156162,156162,156163,0,1,3
44545,3,1,156165,156165,156166,0,1,2
44546,2,2,156167,156167,156169,0,2,1
44547,1,1,156168,156169,156170,1,2,0
44548,2,1,156170,156170,156171,0,1,0
44549,1,3,156171,156171,156174,0,3,0
44550,2,1,156173,156174,156175,1,2,0
44551,3,1,156176,156176,156177,0,1,1
44552,3,2,156179,156179,156181,0,2,2
44553,3,1,156182,156182,156183,0,1,1
44554,2,3,156184,156184,156187,0,3,1
44555,1,1,156185,156187,156188,2,3,0
44556,1,2,156186,156188,156190,2,4,0
44557,4,1,156190,156190,156191,0,1,0
44558,2,3,156192,156192,156195,0,3,1
44559,2,3,156194,156195,156198,1,4,0
44560,5,1,156199,156199,156200,0,1,1
44561,1,1,156200,156200,156201,0,1,0
44562,1,2,156201,156201,156203,0,2,0
44563,4,2,156205,156205,156207,0,2,2
44564,4,3,156209,156209,156212,0,3,2
44565,4,3,156213,156213,156216,0,3,1
44566,4,2,156217,156217,156219,0,2,1
44567,6,2,156223,156223,156225,0,2,4
44568,1,2,156224,156225,156227,1,3,0
44569,3,2,156227,156227,156229,0,2,0
44570,5,2,156232,156232,156234,0,2,3
44571,5,2,156237,156237,156239,0,2,3
44572,1,3,156238,156239,156242,1,4,0
44573,2,1,156240,156242,156243,2,3,0
44574,2,1,156242,156243,156244,1,2,0
44575,3,1,156245,156245,156246,0,1,1
44576,5,1,156250,156250,156251,0,1,4
44577,5,2,156255,156255,156257,0,2,4
44578,1,3,156256,156257,156260,1,4,0
44579,1,3,156257,156260,156263,3,6,0
44580,1,3,156258,156263,156266,5,8,0
44581,5,2,156263,156266,156268,3,5,0
44582,5,2,156268,156268,156270,0,2,0
44583,2,3,156270,156270,156273,0,3,0
44584,2,2,156272,156273,156275,1,3,0
44585,6,3,156278,156278,156281,0,3,3
44586,5,2,156283,156283,156285,0,2,2
44587,5,2,156288,156288,156290,0,2,3
44588,3,3,156291,156291,156294,0,3,1
44589,6,3,156297,156297,156300,0,3,3
44590,3,2,156300,156300,156302,0,2,0
44591,2,2,156302,156302,156304,0,2,0
44592,6,2,156308,156308,156310,0,2,4
44593,6,2,156314,156314,156316,0,2,4
44594,6,1,156320,156320,156321,0,1,4
44595,4,1,156324,156324,156325,0,1,3
44596,2,1,156326,156326,156327,0,1,1
44597,2,3,156328,156328,156331,0,3,1
44598,4,2,156332,156332,156334,0,2,1
44599,5,1,156337,156337,156338,0,1,3
44600,4,3,156341,156341,156344,0,3,3
44601,4,1,156345,156345,156346,0,1,1
44602,4,2,156349,156349,156351,0,2,3
44603,1,1,156350,156351,156352,1,2,0
44604,1,3,156351,156352,156355,1,4,0
44605,2,1,156353,156355,156356,2,3,0
44606,1,1,156354,156356,156357,2,3,0
44607,6,1,156360,156360,156361,0,1,3
44608,3,3,156363,156363,156366,0,3,2
44609,4,1,156367,156367,156368,0,1,1
44610,2,2,156369,156369,156371,0,2,1
44611,6,1,156375,156375,156376,0,1,4
44612,2,2,156377,156377,156379,0,2,1
44613,2,2,156379,156379,156381,0,2,0
44614,6,2,156385,156385,156387,0,2,4
44615,5,1,156390,156390,156391,0,1,3
44616,1,3,156391,156391,156394,0,3,0
44617,1,1,156392,156394,156395,2,3,0
44618,2,3,156394,156395,156398,1,4,0
44619,4,1,156398,156398,156399,0,1,0
44620,1,3,156399,156399,156402,0,3,0
44621,1,3,156400,156402,156405,2,5,0
44622,5,3,156405,156405,156408,0,3,0
44623,1,3,156406,156408,156411,2,5,0
44624,2,1,156408,156411,156412,3,4,0
44625,6,2,156414,156414,156416,0,2,2
44626,5,1,156419,156419,156420,0,1,3
44627,4,3,156423,156423,156426,0,3,3
44628,3,3,156426,156426,156429,0,3,0
44629,4,1,156430,156430,156431,0,1,1
44630,4,2,156434,156434,156436,0,2,3
44631,6,1,156440,156440,156441,0,1,4
44632,1,2,156441,156441,156443,0,2,0
44633,6,1,156447,156447,156448,0,1,4
44634,3,2,156450,156450,156452,0,2,2
44635,3,1,156453,156453,156454,0,1,1
44636,3,1,156456,156456,156457,0,1,2
44637,6,3,156462,156462,156465,0,3,5
44638,3,3,156465,156465,156468,0,3,0
44639,3,1,156468,156468,156469,0,1,0
44640,5,3,156473,156473,156476,0,3,4
44641,5,1,156478,156478,156479,0,1,2
44642,5,2,156483,156483,156485,0,2,4
44643,3,3,156486,156486,156489,0,3,1
44644,1,1,156487,156489,156490,2,3,0
44645,2,2,156489,156490,156492,1,3,0
44646,2,2,156491,156492,156494,1,3,0
44647,6,2,156497,156497,156499,0,2,3
44648,1,3,156498,156499,156502,1,4,0
44649,5,1,156503,156503,156504,0,1,1
44650,5,1,156508,156508,156509,0,1,4
44651,2,1,156510,156510,156511,0,1,1
44652,2,3,156512,156512,156515,0,3,1
44653,3,1,156515,156515,156516,0,1,0
44654,1,2,156516,156516,156518,0,2,0
44655,3,2,156519,156519,156521,0,2,1
44656,2,2,156521,156521,156523,0,2,0
44657,1,2,156522,156523,156525,1,3,0
44658,6,2,156528,156528,156530,0,2,3
44659,4,2,156532,156532,156534,0,2,2
44660,6,3,156538,156538,156541,0,3,4
44661,4,3,156542,156542,156545,0,3,1
44662,2,3,156544,156545,156548,1,4,0
44663,4,1,156548,156548,156549,0,1,0
44664,5,3,156553,156553,156556,0,3,4
44665,5,1,156558,156558,156559,0,1,2
44666,1,1,156559,156559,156560,0,1,0
44667,2,3,156561,156561,156564,0,3,1
44668,4,3,156565,156565,156568,0,3,1
44669,3,3,156568,156568,156571,0,3,0
44670,6,3,156574,156574,156577,0,3,3
44671,5,2,156579,156579,156581,0,2,2
44672,6,3,156585,156585,156588,0,3,4
44673,6,2,156591,156591,156593,0,2,3
44674,4,2,156595,156595,156597,0,2,2
44675,1,1,156596,156597,156598,1,2,0
44676,3,2,156599,156599,156601,0,2,1
44677,2,2,156601,156601,156603,0,2,0
44678,2,1,156603,156603,156604,0,1,0
44679,2,2,156605,156605,156607,0,2,1
44680,6,2,156611,156611,156613,0,2,4
44681,2,3,156613,156613,156616,0,3,0
44682,6,2,156619,156619,156621,0,2,3
44683,2,2,156621,156621,156623,0,2,0
44684,2,1,156623,156623,156624,0,1,0
44685,6,2,156629,156629,156631,0,2,5
44686,2,2,156631,156631,156633,0,2,0
44687,1,3,156632,156633,156636,1,4,0
44688,3,2,156635,156636,156638,1,3,0
44689,6,1,156641,156641,156642,0,1,3
44690,6,2,156647,156647,156649,0,2,5
44691,4,2,156651,156651,156653,0,2,2
44692,4,2,156655,156655,156657,0,2,2
44693,4,3,156659,156659,156662,0,3,2
44694,4,3,156663,156663,156666,0,3,1
44695,5,1,156668,156668,156669,0,1,2
44696,2,1,156670,156670,156671,0,1,1
44697,5,3,156675,156675,156678,0,3,4
44698,1,2,156676,156678,156680,2,4,0
44699,5,3,156681,156681,156684,0,3,1
44700,5,1,156686,156686,156687,0,1,2
44701,2,1,156688,156688,156689,0,1,1
44702,4,1,156692,156692,156693,0,1,3
44703,1,3,156693,156693,156696,0,3,0
44704,5,2,156698,156698,156700,0,2,2
44705,4,2,156702,156702,156704,0,2,2
44706,1,2,156703,156704,156706,1,3,0
44707,1,2,156704,156706,156708,2,4,0
44708,6,3,156710,156710,156713,0,3,2
44709,1,1,156711,156713,156714,2,3,0
44710,3,1,156714,156714,156715,0,1,0
44711,1,2,156715,156715,156717,0,2,0
44712,1,2,156716,156717,156719,1,3,0
44713,4,3,156720,156720,156723,0,3,1
44714,2,1,156722,156723,156724,1,2,0
44715,3,1,156725,156725,156726,0,1,1
44716,1,2,156726,156726,156728,0,2,0
44717,5,2,156731,156731,156733,0,2,3
44718,5,2,156736,156736,156738,0,2,3
44719,2,1,156738,156738,156739,0,1,0
44720,6,3,156744,156744,156747,0,3,5
44721,2,2,156746,156747,156749,1,3,0
44722,3,3,156749,156749,156752,0,3,0
44723,2,3,156751,156752,156755,1,4,0
44724,4,1,156755,156755,156756,0,1,0
44725,5,2,156760,156760,156762,0,2,4
44726,3,2,156763,156763,156765,0,2,1
44727,3,1,156766,156766,156767,0,1,1
44728,4,1,156770,156770,156771,0,1,3
44729,6,1,156776,156776,156777,0,1,5
44730,2,2,156778,156778,156780,0,2,1
44731,5,1,156783,156783,156784,0,1,3
44732,2,3,156785,156785,156788,0,3,1
44733,5,3,156790,156790,156793,0,3,2
44734,4,2,156794,156794,156796,0,2,1
44735,3,2,156797,156797,156799,0,2,1
44736,1,1,156798,156799,156800,1,2,0
44737,1,2,156799,156800,156802,1,3,0
44738,5,2,156804,156804,156806,0,2,2
44739,5,3,156809,156809,156812,0,3,3
44740,4,2,156813,156813,156815,0,2,1
44741,5,3,156818,156818,156821,0,3,3
44742,5,1,156823,156823,156824,0,1,2
44743,3,1,156826,156826,156827,0,1,2
44744,1,2,156827,156827,156829,0,2,0
44745,6,2,156833,156833,156835,0,2,4
44746,4,1,156837,156837,156838,0,1,2
44747,1,3,156838,156838,156841,0,3,0
44748,5,2,156843,156843,156845,0,2,2
44749,1,1,156844,156845,156846,1,2,0
44750,3,3,156847,156847,156850,0,3,1
44751,4,3,156851,156851,156854,0,3,1
44752,1,2,156852,156854,156856,2,4,0
44753,2,3,156854,156856,156859,2,5,0
44754,4,2,156858,156859,156861,1,3,0
44755,3,1,156861,156861,156862,0,1,0
44756,1,1,156862,156862,156863,0,1,0
44757,3,2,156865,156865,156867,0,2,2
44758,3,3,156868,156868,156871,0,3,1
44759,2,2,156870,156871,156873,1,3,0
44760,1,3,156871,156873,156876,2,5,0
44761,2,1,156873,156876,156877,3,4,0
44762,1,3,156874,156877,156880,3,6,0
44763,2,1,156876,156880,156881,4,5,0
44764,2,3,156878,156881,156884,3,6,0
44765,1,2,156879,156884,156886,5,7,0
44766,3,1,156882,156886,156887,4,5,0
44767,1,1,156883,156887,156888,4,5,0
44768,5,3,156888,156888,156891,0,3,0
44769,4,1,156892,156892,156893,0,1,1
44770,4,1,156896,156896,156897,0,1,3
44771,1,2,156897,156897,156899,0,2,0
44772,2,2,156899,156899,156901,0,2,0
44773,6,1,156905,156905,156906,0,1,4
44774,4,3,156909,156909,156912,0,3,3
44775,5,1,156914,156914,156915,0,1,2
44776,1,2,156915,156915,156917,0,2,0
44777,5,1,156920,156920,156921,0,1,3
44778,6,1,156926,156926,156927,0,1,5
44779,2,1,156928,156928,156929,0,1,1
44780,2,1,156930,156930,156931,0,1,1
44781,2,2,156932,156932,156934,0,2,1
44782,5,2,156937,156937,156939,0,2,3
44783,6,3,156943,156943,156946,0,3,4
44784,2,3,156945,156946,156949,1,4,0
44785,2,3,156947,156949,156952,2,5,0
44786,2,3,156949,156952,156955,3,6,0
44787,1,1,156950,156955,156956,5,6,0
44788,1,1,156951,156956,156957,5,6,0
44789,1,2,156952,156957,156959,5,7,0
44790,5,3,156957,156959,156962,2,5,0
44791,5,2,156962,156962,156964,0,2,0
44792,5,1,156967,156967,156968,0,1,3
44793,2,1,156969,156969,156970,0,1,1
44794,2,2,156971,156971,156973,0,2,1
44795,1,1,156972,156973,156974,1,2,0
44796,6,2,156978,156978,156980,0,2,4
44797,3,1,156981,156981,156982,0,1,1
44798,4,2,156985,156985,156987,0,2,3
44799,5,1,156990,156990,156991,0,1,3
44800,4,3,156994,156994,156997,0,3,3
44801,6,1,157000,157000,157001,0,1,3
44802,3,2,157003,157003,157005,0,2,2
44803,2,3,157005,157005,157008,0,3,0
44804,4,1,157009,157009,157010,0,1,1
44805,3,1,157012,157012,157013,0,1,2
44806,2,2,157014,157014,157016,0,2,1
44807,3,1,157017,157017,157018,0,1,1
44808,1,2,157018,157018,157020,0,2,0
44809,3,3,157021,157021,157024,0,3,1
44810,2,2,157023,157024,157026,1,3,0
44811,6,2,157029,157029,157031,0,2,3
44812,5,2,157034,157034,157036,0,2,3
44813,2,1,157036,157036,157037,0,1,0
44814,6,1,157042,157042,157043,0,1,5
44815,1,1,157043,157043,157044,0,1,0
44816,1,3,157044,157044,157047,0,3,0
44817,3,3,157047,157047,157050,0,3,0
44818,3,2,157050,157050,157052,0,2,0
44819,4,2,157054,157054,157056,0,2,2
44820,4,1,157058,157058,157059,0,1,2
44821,6,3,157064,157064,157067,0,3,5
44822,3,3,157067,157067,157070,0,3,0
44823,1,3,157068,157070,157073,2,5,0
44824,2,2,157070,157073,157075,3,5,0
44825,1,1,157071,157075,157076,4,5,0
44826,1,2,157072,157076,157078,4,6,0
44827,4,3,157076,157078,157081,2,5,0
44828,3,2,157079,157081,157083,2,4,0
44829,6,2,157085,157085,157087,0,2,2
44830,4,1,157089,157089,157090,0,1,2
44831,1,2,157090,157090,157092,0,2,0
44832,4,3,157094,157094,157097,0,3,2
44833,2,2,157096,157097,157099,1,3,0
44834,1,3,157097,157099,157102,2,5,0
44835,5,1,157102,157102,157103,0,1,0
44836,6,1,157108,157108,157109,0,1,5
44837,1,1,157109,157109,157110,0,1,0
44838,3,1,157112,157112,157113,0,1,2
44839,2,1,157114,157114,157115,0,1,1
44840,4,1,157118,157118,157119,0,1,3
44841,6,1,157124,157124,157125,0,1,5
44842,4,1,157128,157128,157129,0,1,3
44843,1,2,157129,157129,157131,0,2,0
44844,3,3,157132,157132,157135,0,3,1
44845,2,1,157134,157135,157136,1,2,0
44846,3,3,157137,157137,157140,0,3,1
44847,3,2,157140,157140,157142,0,2,0
44848,6,3,157146,157146,157149,0,3,4
44849,2,2,157148,157149,157151,1,3,0
44850,4,2,157152,157152,157154,0,2,1
44851,6,3,157158,157158,157161,0,3,4
44852,2,2,157160,157161,157163,1,3,0
44853,6,1,157166,157166,157167,0,1,3
44854,2,2,157168,157168,157170,0,2,1
44855,5,1,157173,157173,157174,0,1,3
44856,6,2,157179,157179,157181,0,2,5
44857,3,3,157182,157182,157185,0,3,1
44858,4,3,157186,157186,157189,0,3,1
44859,2,3,157188,157189,157192,1,4,0
44860,3,1,157191,157192,157193,1,2,0
44861,5,3,157196,157196,157199,0,3,3
44862,4,1,157200,157200,157201,0,1,1
44863,2,3,157202,157202,157205,0,3,1
44864,4,1,157206,157206,157207,0,1,1
44865,6,3,157212,157212,157215,0,3,5
44866,6,2,157218,157218,157220,0,2,3
44867,4,2,157222,157222,157224,0,2,2
44868,3,1,157225,157225,157226,0,1,1
44869,4,2,157229,157229,157231,0,2,3
44870,4,2,157233,157233,157235,0,2,2
44871,1,1,157234,157235,157236,1,2,0
44872,2,1,157236,157236,157237,0,1,0
44873,2,3,157238,157238,157241,0,3,1
44874,2,3,157240,157241,157244,1,4,0
44875,3,2,157243,157244,157246,1,3,0
44876,2,1,157245,157246,157247,1,2,0
44877,5,3,157250,157250,157253,0,3,3
44878,6,2,157256,157256,157258,0,2,3
44879,6,3,157262,157262,157265,0,3,4
44880,5,3,157267,157267,157270,0,3,2
44881,1,2,157268,157270,157272,2,4,0
44882,4,2,157272,157272,157274,0,2,0
44883,1,2,157273,157274,157276,1,3,0
44884,6,1,157279,157279,157280,0,1,3
44885,3,2,157282,157282,157284,0,2,2
44886,4,1,157286,157286,157287,0,1,2
44887,5,2,157291,157291,157293,0,2,4
44888,4,1,157295,157295,157296,0,1,2
44889,5,2,157300,157300,157302,0,2,4
44890,1,2,157301,157302,157304,1,3,0
44891,2,2,157303,157304,157306,1,3,0
44892,4,3,157307,157307,157310,0,3,1
44893,4,2,157311,157311,157313,0,2,1
44894,6,2,157317,157317,157319,0,2,4
44895,3,3,157320,157320,157323,0,3,1
44896,2,3,157322,157323,157326,1,4,0
44897,3,1,157325,157326,157327,1,2,0
44898,5,1,157330,157330,157331,0,1,3
44899,3,3,157333,157333,157336,0,3,2
44900,3,2,157336,157336,157338,0,2,0
44901,2,1,157338,157338,157339,0,1,0
44902,5,2,157343,157343,157345,0,2,4
44903,4,2,157347,157347,157349,0,2,2
44904,1,3,157348,157349,157352,1,4,0
44905,1,1,157349,157352,157353,3,4,0
44906,2,2,157351,157353,157355,2,4,0
44907,3,3,157354,157355,157358,1,4,0
44908,6,3,157360,157360,157363,0,3,2
44909,5,2,157365,157365,157367,0,2,2
44910,2,2,157367,157367,157369,0,2,0
44911,5,1,157372,157372,157373,0,1,3
44912,3,1,157375,157375,157376,0,1,2
44913,5,3,157380,157380,157383,0,3,4
44914,3,1,157383,157383,157384,0,1,0
44915,5,1,157388,157388,157389,0,1,4
44916,2,1,157390,157390,157391,0,1,1
44917,2,1,157392,157392,157393,0,1,1
44918,4,3,157396,157396,157399,0,3,3
44919,3,2,157399,157399,157401,0,2,0
44920,5,2,157404,157404,157406,0,2,3
44921,4,1,157408,157408,157409,0,1,2
44922,5,1,157413,157413,157414,0,1,4
44923,6,3,157419,157419,157422,0,3,5
44924,3,3,157422,157422,157425,0,3,0
44925,4,3,157426,157426,157429,0,3,1
44926,3,2,157429,157429,157431,0,2,0
44927,3,2,157432,157432,157434,0,2,1
44928,2,3,157434,157434,157437,0,3,0
44929,6,3,157440,157440,157443,0,3,3
44930,5,3,157445,157445,157448,0,3,2
44931,3,3,157448,157448,157451,0,3,0
44932,6,2,157454,157454,157456,0,2,3
44933,4,2,157458,157458,157460,0,2,2
44934,2,3,157460,157460,157463,0,3,0
44935,3,3,157463,157463,157466,0,3,0
44936,1,1,157464,157466,157467,2,3,0
44937,1,3,157465,157467,157470,2,5,0
44938,4,1,157469,157470,157471,1,2,0
44939,1,2,157470,157471,157473,1,3,0
44940,1,2,157471,157473,157475,2,4,0
44941,1,1,157472,157475,157476,3,4,0
44942,4,2,157476,157476,157478,0,2,0
44943,5,2,157481,157481,157483,0,2,3
44944,1,3,157482,157483,157486,1,4,0
44945,5,2,157487,157487,157489,0,2,1
44946,1,1,157488,157489,157490,1,2,0
44947,5,3,157493,157493,157496,0,3,3
44948,3,1,157496,157496,157497,0,1,0
44949,4,1,157500,157500,157501,0,1,3
44950,2,2,157502,157502,157504,0,2,1
44951,3,2,157505,157505,157507,0,2,1
44952,1,1,157506,157507,157508,1,2,0
44953,5,1,157511,157511,157512,0,1,3
44954,5,3,157516,157516,157519,0,3,4
44955,3,2,157519,157519,157521,0,2,0
44956,2,2,157521,157521,157523,0,2,0
44957,6,1,157527,157527,157528,0,1,4
44958,4,3,157531,157531,157534,0,3,3
44959,3,1,157534,157534,157535,0,1,0
44960,2,3,157536,157536,157539,0,3,1
44961,2,3,157538,157539,157542,1,4,0
44962,6,1,157544,157544,157545,0,1,2
44963,4,3,157548,157548,157551,0,3,3
44964,6,3,157554,157554,157557,0,3,3
44965,1,2,157555,157557,157559,2,4,0
44966,6,2,157561,157561,157563,0,2,2
44967,2,3,157563,157563,157566,0,3,0
44968,5,1,157568,157568,157569,0,1,2
44969,3,3,157571,157571,157574,0,3,2
44970,3,3,157574,157574,157577,0,3,0
44971,5,3,157579,157579,157582,0,3,2
44972,2,1,157581,157582,157583,1,2,0
44973,2,1,157583,157583,157584,0,1,0
44974,1,2,157584,157584,157586,0,2,0
44975,1,2,157585,157586,157588,1,3,0
44976,6,2,157591,157591,157593,0,2,3
44977,4,3,157595,157595,157598,0,3,2
44978,4,3,157599,157599,157602,0,3,1
44979,2,2,157601,157602,157604,1,3,0
44980,6,3,157607,157607,157610,0,3,3
44981,6,1,157613,157613,157614,0,1,3
44982,2,3,157615,157615,157618,0,3,1
44983,5,1,157620,157620,157621,0,1,2
44984,2,1,157622,157622,157623,0,1,1
44985,1,1,157623,157623,157624,0,1,0
44986,2,3,157625,157625,157628,0,3,1
44987,3,1,157628,157628,157629,0,1,0
44988,4,2,157632,157632,157634,0,2,3
44989,1,3,157633,157634,157637,1,4,0
44990,5,3,157638,157638,157641,0,3,1
44991,4,2,157642,157642,157644,0,2,1
44992,4,2,157646,157646,157648,0,2,2
44993,5,2,157651,157651,157653,0,2,3
44994,6,1,157657,157657,157658,0,1,4
44995,2,1,157659,157659,157660,0,1,1
44996,6,2,157665,157665,157667,0,2,5
44997,2,2,157667,157667,157669,0,2,0
44998,1,1,157668,157669,157670,1,2,0
44999,1,1,157669,157670,157671,1,2,0
45000,5,3,157674,157674,157677,0,3,3
45001,6,3,157680,157680,157683,0,3,3
45002,3,3,157683,157683,157686,0,3,0
45003,4,1,157687,157687,157688,0,1,1
45004,2,3,157689,157689,157692,0,3,1
45005,1,1,157690,157692,157693,2,3,0
45006,4,2,157694,157694,157696,0,2,1
45007,4,3,157698,157698,157701,0,3,2
45008,5,3,157703,157703,157706,0,3,2
45009,2,2,157705,157706,157708,1,3,0
45010,5,3,157710,157710,157713,0,3,2
45011,6,2,157716,157716,157718,0,2,3
45012,5,2,157721,157721,157723,0,2,3
45013,2,2,157723,157723,157725,0,2,0
45014,5,3,157728,157728,157731,0,3,3
45015,6,3,157734,157734,157737,0,3,3
45016,1,1,157735,157737,157738,2,3,0
45017,4,2,157739,157739,157741,0,2,1
45018,2,1,157741,157741,157742,0,1,0
45019,2,3,157743,157743,157746,0,3,1
45020,6,2,157749,157749,157751,0,2,3
45021,3,1,157752,157752,157753,0,1,1
45022,2,2,157754,157754,157756,0,2,1
45023,5,2,157759,157759,157761,0,2,3
45024,2,1,157761,157761,157762,0,1,0
45025,4,3,157765,157765,157768,0,3,3
45026,2,1,157767,157768,157769,1,2,0
45027,3,1,157770,157770,157771,0,1,1
45028,4,3,157774,157774,157777,0,3,3
45029,4,3,157778,157778,157781,0,3,1
45030,5,2,157783,157783,157785,0,2,2
45031,4,3,157787,157787,157790,0,3,2
45032,4,3,157791,157791,157794,0,3,1
45033,1,2,157792,157794,157796,2,4,0
45034,4,1,157796,157796,157797,0,1,0
45035,1,2,157797,157797,157799,0,2,0
45036,3,1,157800,157800,157801,0,1,1
45037,5,3,157805,157805,157808,0,3,4
45038,3,3,157808,157808,157811,0,3,0
45039,3,2,157811,157811,157813,0,2,0
45040,5,1,157816,157816,157817,0,1,3
45041,2,1,157818,157818,157819,0,1,1
45042,3,1,157821,157821,157822,0,1,2
45043,4,2,157825,157825,157827,0,2,3
45044,5,1,157830,157830,157831,0,1,3
45045,1,3,157831,157831,157834,0,3,0
45046,2,1,157833,157834,157835,1,2,0
45047,4,1,157837,157837,157838,0,1,2
45048,1,1,157838,157838,157839,0,1,0
45049,3,1,157841,157841,157842,0,1,2
45050,3,2,157844,157844,157846,0,2,2
45051,6,2,157850,157850,157852,0,2,4
45052,6,3,157856,157856,157859,0,3,4
45053,4,3,157860,157860,157863,0,3,1
45054,2,1,157862,157863,157864,1,2,0
45055,3,3,157865,157865,157868,0,3,1
45056,5,3,157870,157870,157873,0,3,2
45057,2,1,157872,157873,157874,1,2,0
45058,5,2,157877,157877,157879,0,2,3
45059,1,1,157878,157879,157880,1,2,0
45060,6,3,157884,157884,157887,0,3,4
45061,1,2,157885,157887,157889,2,4,0
45062,5,2,157890,157890,157892,0,2,1
45063,5,2,157895,157895,157897,0,2,3
45064,1,1,157896,157897,157898,1,2,0
45065,4,3,157900,157900,157903,0,3,2
45066,6,3,157906,157906,157909,0,3,3
45067,3,1,157909,157909,157910,0,1,0
45068,1,2,157910,157910,157912,0,2,0
45069,2,1,157912,157912,157913,0,1,0
45070,4,3,157916,157916,157919,0,3,3
45071,6,3,157922,157922,157925,0,3,3
45072,3,3,157925,157925,157928,0,3,0
45073,4,3,157929,157929,157932,0,3,1
45074,1,3,157930,157932,157935,2,5,0
45075,5,3,157935,157935,157938,0,3,0
45076,6,2,157941,157941,157943,0,2,3
45077,5,1,157946,157946,157947,0,1,3
45078,4,3,157950,157950,157953,0,3,3
45079,5,1,157955,157955,157956,0,1,2
45080,2,2,157957,157957,157959,0,2,1
45081,4,1,157961,157961,157962,0,1,2
45082,3,1,157964,157964,157965,0,1,2
45083,4,1,157968,157968,157969,0,1,3
45084,3,1,157971,157971,157972,0,1,2
45085,4,2,157975,157975,157977,0,2,3
45086,5,1,157980,157980,157981,0,1,3
45087,3,2,157983,157983,157985,0,2,2
45088,6,2,157989,157989,157991,0,2,4
45089,2,3,157991,157991,157994,0,3,0
45090,1,1,157992,157994,157995,2,3,0
45091,2,1,157994,157995,157996,1,2,0
45092,2,1,157996,157996,157997,0,1,0
45093,4,1,158000,158000,158001,0,1,3
45094,3,3,158003,158003,158006,0,3,2
45095,1,2,158004,158006,158008,2,4,0
45096,6,3,158010,158010,158013,0,3,2
45097,1,2,158011,158013,158015,2,4,0
45098,6,3,158017,158017,158020,0,3,2
45099,1,3,158018,158020,158023,2,5,0
45100,6,1,158024,158024,158025,0,1,1
45101,5,3,158029,158029,158032,0,3,4
45102,4,3,158033,158033,158036,0,3,1
45103,5,2,158038,158038,158040,0,2,2
45104,5,1,158043,158043,158044,0,1,3
45105,1,3,158044,158044,158047,0,3,0
45106,4,3,158048,158048,158051,0,3,1
45107,6,1,158054,158054,158055,0,1,3
45108,5,3,158059,158059,158062,0,3,4
45109,3,1,158062,158062,158063,0,1,0
45110,3,1,158065,158065,158066,0,1,2
45111,4,3,158069,158069,158072,0,3,3
45112,3,1,158072,158072,158073,0,1,0
45113,4,1,158076,158076,158077,0,1,3
45114,2,2,158078,158078,158080,0,2,1
45115,6,2,158084,158084,158086,0,2,4
45116,1,3,158085,158086,158089,1,4,0
45117,1,2,158086,158089,158091,3,5,0
45118,5,1,158091,158091,158092,0,1,0
45119,5,2,158096,158096,158098,0,2,4
45120,5,3,158101,158101,158104,0,3,3
45121,1,1,158102,158104,158105,2,3,0
45122,4,1,158106,158106,158107,0,1,1
45123,1,2,158107,158107,158109,0,2,0
45124,6,1,158113,158113,158114,0,1,4
45125,1,2,158114,158114,158116,0,2,0
45126,1,2,158115,158116,158118,1,3,0
45127,3,3,158118,158118,158121,0,3,0
45128,3,2,158121,158121,158123,0,2,0
45129,3,3,158124,158124,158127,0,3,1
45130,4,1,158128,158128,158129,0,1,1
45131,3,3,158131,158131,158134,0,3,2
45132,6,1,158137,158137,158138,0,1,3
45133,2,2,158139,158139,158141,0,2,1
45134,3,3,158142,158142,158145,0,3,1
45135,4,3,158146,158146,158149,0,3,1
45136,1,2,158147,158149,158151,2,4,0
45137,5,2,158152,158152,158154,0,2,1
45138,2,3,158154,158154,158157,0,3,0
45139,2,2,158156,158157,158159,1,3,0
45140,3,1,158159,158159,158160,0,1,0
45141,5,3,158164,158164,158167,0,3,4
45142,4,3,158168,158168,158171,0,3,1
45143,5,2,158173,158173,158175,0,2,2
45144,5,3,158178,158178,158181,0,3,3
45145,4,2,158182,158182,158184,0,2,1
45146,1,2,158183,158184,158186,1,3,0
45147,2,2,158185,158186,158188,1,3,0
45148,1,1,158186,158188,158189,2,3,0
45149,5,3,158191,158191,158194,0,3,2
45150,2,1,158193,158194,158195,1,2,0
45151,1,3,158194,158195,158198,1,4,0
45152,5,1,158199,158199,158200,0,1,1
45153,5,1,158204,158204,158205,0,1,4
45154,2,2,158206,158206,158208,0,2,1
45155,3,3,158209,158209,158212,0,3,1
45156,5,2,158214,158214,158216,0,2,2
45157,6,2,158220,158220,158222,0,2,4
45158,3,3,158223,158223,158226,0,3,1
45159,6,3,158229,158229,158232,0,3,3
45160,5,3,158234,158234,158237,0,3,2
45161,4,3,158238,158238,158241,0,3,1
45162,3,1,158241,158241,158242,0,1,0
45163,6,1,158247,158247,158248,0,1,5
45164,6,2,158253,158253,158255,0,2,5
45165,1,2,158254,158255,158257,1,3,0
45166,1,2,158255,158257,158259,2,4,0
45167,2,3,158257,158259,158262,2,5,0
45168,5,2,158262,158262,158264,0,2,0
45169,5,1,158267,158267,158268,0,1,3
45170,6,3,158273,158273,158276,0,3,5
45171,4,3,158277,158277,158280,0,3,1
45172,2,2,158279,158280,158282,1,3,0
45173,6,1,158285,158285,158286,0,1,3
45174,2,2,158287,158287,158289,0,2,1
45175,6,3,158293,158293,158296,0,3,4
45176,3,2,158296,158296,158298,0,2,0
45177,4,1,158300,158300,158301,0,1,2
45178,3,1,158303,158303,158304,0,1,2
45179,1,2,158304,158304,158306,0,2,0
45180,5,1,158309,158309,158310,0,1,3
45181,6,1,158315,158315,158316,0,1,5
45182,3,3,158318,158318,158321,0,3,2
45183,6,2,158324,158324,158326,0,2,3
45184,1,1,158325,158326,158327,1,2,0
45185,3,3,158328,158328,158331,0,3,1
45186,5,2,158333,158333,158335,0,2,2
45187,3,2,158336,158336,158338,0,2,1
45188,4,2,158340,158340,158342,0,2,2
45189,2,1,158342,158342,158343,0,1,0
45190,2,3,158344,158344,158347,0,3,1
45191,2,3,158346,158347,158350,1,4,0
45192,5,3,158351,158351,158354,0,3,1
45193,4,2,158355,158355,158357,0,2,1
45194,5,2,158360,158360,158362,0,2,3
45195,6,3,158366,158366,158369,0,3,4
45196,4,1,158370,158370,158371,0,1,1
45197,3,2,158373,158373,158375,0,2,2
45198,4,3,158377,158377,158380,0,3,2
45199,2,3,158379,158380,158383,1,4,0
45200,4,1,158383,158383,158384,0,1,0
45201,2,1,158385,158385,158386,0,1,1
45202,3,3,158388,158388,158391,0,3,2
45203,3,1,158391,158391,158392,0,1,0
45204,4,3,158395,158395,158398,0,3,3
45205,2,1,158397,158398,158399,1,2,0
45206,5,3,158402,158402,158405,0,3,3
45207,3,2,158405,158405,158407,0,2,0
45208,5,3,158410,158410,158413,0,3,3
45209,1,1,158411,158413,158414,2,3,0
45210,3,2,158414,158414,158416,0,2,0
45211,6,3,158420,158420,158423,0,3,4
45212,5,3,158425,158425,158428,0,3,2
45213,1,3,158426,158428,158431,2,5,0
45214,3,3,158429,158431,158434,2,5,0
45215,1,2,158430,158434,158436,4,6,0
45216,5,2,158435,158436,158438,1,3,0
45217,3,1,158438,158438,158439,0,1,0
45218,2,3,158440,158440,158443,0,3,1
45219,2,2,158442,158443,158445,1,3,0
45220,5,3,158447,158447,158450,0,3,2
45221,6,3,158453,158453,158456,0,3,3
45222,6,2,158459,158459,158461,0,2,3
45223,3,3,158462,158462,158465,0,3,1
45224,5,3,158467,158467,158470,0,3,2
45225,3,1,158470,158470,158471,0,1,0
45226,6,3,158476,158476,158479,0,3,5
45227,1,3,158477,158479,158482,2,5,0
45228,5,2,158482,158482,158484,0,2,0
45229,3,1,158485,158485,158486,0,1,1
45230,3,1,158488,158488,158489,0,1,2
45231,6,1,158494,158494,158495,0,1,5
45232,4,2,158498,158498,158500,0,2,3
45233,3,2,158501,158501,158503,0,2,1
45234,2,2,158503,158503,158505,0,2,0
45235,3,3,158506,158506,158509,0,3,1
45236,5,2,158511,158511,158513,0,2,2
45237,5,3,158516,158516,158519,0,3,3
45238,3,2,158519,158519,158521,0,2,0
45239,5,1,158524,158524,158525,0,1,3
45240,6,2,158530,158530,158532,0,2,5
45241,3,1,158533,158533,158534,0,1,1
45242,1,2,158534,158534,158536,0,2,0
45243,2,2,158536,158536,158538,0,2,0
45244,1,2,158537,158538,158540,1,3,0
45245,1,3,158538,158540,158543,2,5,0
45246,3,2,158541,158543,158545,2,4,0
45247,6,2,158547,158547,158549,0,2,2
45248,4,2,158551,158551,158553,0,2,2
45249,3,1,158554,158554,158555,0,1,1
45250,2,3,158556,158556,158559,0,3,1
45251,5,2,158561,158561,158563,0,2,2
45252,1,3,158562,158563,158566,1,4,0
45253,3,2,158565,158566,158568,1,3,0
45254,6,1,158571,158571,158572,0,1,3
45255,6,1,158577,158577,158578,0,1,5
45256,5,2,158582,158582,158584,0,2,4
45257,2,3,158584,158584,158587,0,3,0
45258,4,1,158588,158588,158589,0,1,1
45259,5,2,158593,158593,158595,0,2,4
45260,3,3,158596,158596,158599,0,3,1
45261,6,1,158602,158602,158603,0,1,3
45262,5,1,158607,158607,158608,0,1,4
45263,6,3,158613,158613,158616,0,3,5
45264,5,1,158618,158618,158619,0,1,2
45265,3,3,158621,158621,158624,0,3,2
45266,6,3,158627,158627,158630,0,3,3
45267,2,2,158629,158630,158632,1,3,0
45268,6,2,158635,158635,158637,0,2,3
45269,6,3,158641,158641,158644,0,3,4
45270,3,1,158644,158644,158645,0,1,0
45271,4,2,158648,158648,158650,0,2,3
45272,5,3,158653,158653,158656,0,3,3
45273,5,2,158658,158658,158660,0,2,2
45274,4,2,158662,158662,158664,0,2,2
45275,6,2,158668,158668,158670,0,2,4
45276,1,3,158669,158670,158673,1,4,0
45277,3,3,158672,158673,158676,1,4,0
45278,4,1,158676,158676,158677,0,1,0
45279,1,3,158677,158677,158680,0,3,0
45280,6,1,158683,158683,158684,0,1,3
45281,6,3,158689,158689,158692,0,3,5
45282,6,2,158695,158695,158697,0,2,3
45283,5,2,158700,158700,158702,0,2,3
45284,1,3,158701,158702,158705,1,4,0
45285,4,3,158705,158705,158708,0,3,0
45286,6,1,158711,158711,158712,0,1,3
45287,5,2,158716,158716,158718,0,2,4
45288,6,1,158722,158722,158723,0,1,4
45289,4,3,158726,158726,158729,0,3,3
45290,3,2,158729,158729,158731,0,2,0
45291,6,1,158735,158735,158736,0,1,4
45292,6,1,158741,158741,158742,0,1,5
45293,2,2,158743,158743,158745,0,2,1
45294,3,2,158746,158746,158748,0,2,1
45295,5,3,158751,158751,158754,0,3,3
45296,5,1,158756,158756,158757,0,1,2
45297,2,1,158758,158758,158759,0,1,1
45298,6,1,158764,158764,158765,0,1,5
45299,5,3,158769,158769,158772,0,3,4
45300,6,3,158775,158775,158778,0,3,3
45301,6,2,158781,158781,158783,0,2,3
45302,2,1,158783,158783,158784,0,1,0
45303,3,2,158786,158786,158788,0,2,2
45304,5,3,158791,158791,158794,0,3,3
45305,4,3,158795,158795,158798,0,3,1
45306,5,3,158800,158800,158803,0,3,2
45307,1,3,158801,158803,158806,2,5,0
45308,4,1,158805,158806,158807,1,2,0
45309,2,1,158807,158807,158808,0,1,0
45310,6,3,158813,158813,158816,0,3,5
45311,4,1,158817,158817,158818,0,1,1
45312,3,3,158820,158820,158823,0,3,2
45313,3,2,158823,158823,158825,0,2,0
45314,4,3,158827,158827,158830,0,3,2
45315,4,3,158831,158831,158834,0,3,1
45316,1,2,158832,158834,158836,2,4,0
45317,2,2,158834,158836,158838,2,4,0
45318,4,3,158838,158838,158841,0,3,0
45319,1,1,158839,158841,158842,2,3,0
45320,5,2,158844,158844,158846,0,2,2
45321,2,1,158846,158846,158847,0,1,0
45322,5,3,158851,158851,158854,0,3,4
45323,4,2,158855,158855,158857,0,2,1
45324,2,3,158857,158857,158860,0,3,0
45325,5,1,158862,158862,158863,0,1,2
45326,1,3,158863,158863,158866,0,3,0
45327,1,1,158864,158866,158867,2,3,0
45328,1,3,158865,158867,158870,2,5,0
45329,4,2,158869,158870,158872,1,3,0
45330,5,1,158874,158874,158875,0,1,2
45331,2,1,158876,158876,158877,0,1,1
45332,4,3,158880,158880,158883,0,3,3
45333,2,2,158882,158883,158885,1,3,0
45334,6,1,158888,158888,158889,0,1,3
45335,1,1,158889,158889,158890,0,1,0
45336,4,1,158893,158893,158894,0,1,3
45337,4,3,158897,158897,158900,0,3,3
45338,5,3,158902,158902,158905,0,3,2
45339,3,1,158905,158905,158906,0,1,0
45340,5,1,158910,158910,158911,0,1,4
45341,2,1,158912,158912,158913,0,1,1
45342,1,1,158913,158913,158914,0,1,0
45343,2,2,158915,158915,158917,0,2,1
45344,5,3,158920,158920,158923,0,3,3
45345,5,2,158925,158925,158927,0,2,2
45346,6,1,158931,158931,158932,0,1,4
45347,1,3,158932,158932,158935,0,3,0
45348,3,1,158935,158935,158936,0,1,0
45349,3,3,158938,158938,158941,0,3,2
45350,2,2,158940,158941,158943,1,3,0
45351,6,3,158946,158946,158949,0,3,3
45352,2,3,158948,158949,158952,1,4,0
45353,2,2,158950,158952,158954,2,4,0
45354,3,1,158953,158954,158955,1,2,0
45355,5,1,158958,158958,158959,0,1,3
45356,6,1,158964,158964,158965,0,1,5
45357,2,1,158966,158966,158967,0,1,1
45358,2,2,158968,158968,158970,0,2,1
45359,1,1,158969,158970,158971,1,2,0
45360,5,1,158974,158974,158975,0,1,3
45361,1,2,158975,158975,158977,0,2,0
45362,1,3,158976,158977,158980,1,4,0
45363,5,3,158981,158981,158984,0,3,1
45364,4,3,158985,158985,158988,0,3,1
45365,2,2,158987,158988,158990,1,3,0
45366,5,2,158992,158992,158994,0,2,2
45367,4,1,158996,158996,158997,0,1,2
45368,5,2,159001,159001,159003,0,2,4
45369,5,1,159006,159006,159007,0,1,3
45370,5,1,159011,159011,159012,0,1,4
45371,3,2,159014,159014,159016,0,2,2
45372,5,3,159019,159019,159022,0,3,3
45373,4,3,159023,159023,159026,0,3,1
45374,6,3,159029,159029,159032,0,3,3
45375,2,3,159031,159032,159035,1,4,0
45376,3,3,159034,159035,159038,1,4,0
45377,4,2,159038,159038,159040,0,2,0
45378,4,1,159042,159042,159043,0,1,2
45379,4,3,159046,159046,159049,0,3,3
45380,4,1,159050,159050,159051,0,1,1
45381,1,3,159051,159051,159054,0,3,0
45382,5,3,159056,159056,159059,0,3,2
45383,1,2,159057,159059,159061,2,4,0
45384,5,3,159062,159062,159065,0,3,1
45385,3,3,159065,159065,159068,0,3,0
45386,5,3,159070,159070,159073,0,3,2
45387,6,3,159076,159076,159079,0,3,3
45388,6,2,159082,159082,159084,0,2,3
45389,2,1,159084,159084,159085,0,1,0
45390,3,3,159087,159087,159090,0,3,2
45391,5,2,159092,159092,159094,0,2,2
45392,4,3,159096,159096,159099,0,3,2
45393,6,2,159102,159102,159104,0,2,3
45394,6,1,159108,159108,159109,0,1,4
45395,2,2,159110,159110,159112,0,2,1
45396,5,2,159115,159115,159117,0,2,3
45397,1,3,159116,159117,159120,1,4,0
45398,4,2,159120,159120,159122,0,2,0
45399,4,1,159124,159124,159125,0,1,2
45400,3,1,159127,159127,159128,0,1,2
45401,4,1,159131,159131,159132,0,1,3
45402,2,1,159133,159133,159134,0,1,1
45403,5,1,159138,159138,159139,0,1,4
45404,4,1,159142,159142,159143,0,1,3
45405,5,1,159147,159147,159148,0,1,4
45406,4,2,159151,159151,159153,0,2,3
45407,3,1,159154,159154,159155,0,1,1
45408,5,2,159159,159159,159161,0,2,4
45409,6,3,159165,159165,159168,0,3,4
45410,3,2,159168,159168,159170,0,2,0
45411,1,3,159169,159170,159173,1,4,0
45412,5,1,159174,159174,159175,0,1,1
45413,3,1,159177,159177,159178,0,1,2
45414,4,3,159181,159181,159184,0,3,3
45415,3,2,159184,159184,159186,0,2,0
45416,5,2,159189,159189,159191,0,2,3
45417,2,2,159191,159191,159193,0,2,0
45418,6,1,159197,159197,159198,0,1,4
45419,3,3,159200,159200,159203,0,3,2
45420,4,3,159204,159204,159207,0,3,1
45421,5,3,159209,159209,159212,0,3,2
45422,3,2,159212,159212,159214,0,2,0
45423,2,2,159214,159214,159216,0,2,0
45424,2,2,159216,159216,159218,0,2,0
45425,6,3,159222,159222,159225,0,3,4
45426,3,3,159225,159225,159228,0,3,0
45427,2,1,159227,159228,159229,1,2,0
45428,6,2,159233,159233,159235,0,2,4
45429,5,2,159238,159238,159240,0,2,3
45430,1,1,159239,159240,159241,1,2,0
45431,1,3,159240,159241,159244,1,4,0
45432,5,2,159245,159245,159247,0,2,1
45433,5,3,159250,159250,159253,0,3,3
45434,1,2,159251,159253,159255,2,4,0
45435,6,2,159257,159257,159259,0,2,2
45436,4,1,159261,159261,159262,0,1,2
45437,2,2,159263,159263,159265,0,2,1
45438,4,1,159267,159267,159268,0,1,2
45439,2,3,159269,159269,159272,0,3,1
45440,5,3,159274,159274,159277,0,3,2
45441,6,2,159280,159280,159282,0,2,3
45442,4,2,159284,159284,159286,0,2,2
45443,5,2,159289,159289,159291,0,2,3
45444,1,3,159290,159291,159294,1,4,0
45445,4,1,159294,159294,159295,0,1,0
45446,3,1,159297,159297,159298,0,1,2
45447,6,2,159303,159303,159305,0,2,5
45448,4,1,159307,159307,159308,0,1,2
45449,3,1,159310,159310,159311,0,1,2
45450,4,1,159314,159314,159315,0,1,3
45451,4,3,159318,159318,159321,0,3,3
45452,1,3,159319,159321,159324,2,5,0
45453,1,1,159320,159324,159325,4,5,0
45454,5,2,159325,159325,159327,0,2,0
45455,4,2,159329,159329,159331,0,2,2
45456,2,3,159331,159331,159334,0,3,0
45457,3,1,159334,159334,159335,0,1,0
45458,4,1,159338,159338,159339,0,1,3
45459,6,1,159344,159344,159345,0,1,5
45460,6,1,159350,159350,159351,0,1,5
45461,4,3,159354,159354,159357,0,3,3
45462,3,3,159357,159357,159360,0,3,0
45463,1,1,159358,159360,159361,2,3,0
45464,6,1,159364,159364,159365,0,1,3
45465,1,3,159365,159365,159368,0,3,0
45466,6,3,159371,159371,159374,0,3,3
45467,3,1,159374,159374,159375,0,1,0
45468,6,1,159380,159380,159381,0,1,5
45469,2,2,159382,159382,159384,0,2,1
45470,6,3,159388,159388,159391,0,3,4
45471,4,2,159392,159392,159394,0,2,1
45472,2,1,159394,159394,159395,0,1,0
45473,1,2,159395,159395,159397,0,2,0
45474,3,2,159398,159398,159400,0,2,1
45475,6,2,159404,159404,159406,0,2,4
45476,2,2,159406,159406,159408,0,2,0
45477,1,1,159407,159408,159409,1,2,0
45478,1,1,159408,159409,159410,1,2,0
45479,4,3,159412,159412,159415,0,3,2
45480,3,2,159415,159415,159417,0,2,0
45481,5,1,159420,159420,159421,0,1,3
45482,5,2,159425,159425,159427,0,2,4
45483,6,3,159431,159431,159434,0,3,4
45484,5,1,159436,159436,159437,0,1,2
45485,6,1,159442,159442,159443,0,1,5
45486,3,1,159445,159445,159446,0,1,2
45487,3,3,159448,159448,159451,0,3,2
45488,6,2,159454,159454,159456,0,2,3
45489,5,3,159459,159459,159462,0,3,3
45490,3,2,159462,159462,159464,0,2,0
45491,1,2,159463,159464,159466,1,3,0
45492,3,2,159466,159466,159468,0,2,0
45493,4,2,159470,159470,159472,0,2,2
45494,3,1,159473,159473,159474,0,1,1
45495,4,1,159477,159477,159478,0,1,3
45496,6,2,159483,159483,159485,0,2,5
45497,3,3,159486,159486,159489,0,3,1
45498,5,1,159491,159491,159492,0,1,2
45499,6,3,159497,159497,159500,0,3,5
45500,6,3,159503,159503,159506,0,3,3
45501,5,1,159508,159508,159509,0,1,2
45502,4,3,159512,159512,159515,0,3,3
45503,5,3,159517,159517,159520,0,3,2
45504,6,2,159523,159523,159525,0,2,3
45505,2,3,159525,159525,159528,0,3,0
45506,1,2,159526,159528,159530,2,4,0
45507,5,1,159531,159531,159532,0,1,1
45508,5,3,159536,159536,159539,0,3,4
45509,2,3,159538,159539,159542,1,4,0
45510,1,2,159539,159542,159544,3,5,0
45511,1,3,159540,159544,159547,4,7,0
45512,4,3,159544,159547,159550,3,6,0
45513,3,2,159547,159550,159552,3,5,0
45514,6,2,159553,159553,159555,0,2,1
45515,5,2,159558,159558,159560,0,2,3
45516,2,2,159560,159560,159562,0,2,0
45517,5,2,159565,159565,159567,0,2,3
45518,3,3,159568,159568,159571,0,3,1
45519,5,2,159573,159573,159575,0,2,2
45520,3,1,159576,159576,159577,0,1,1
45521,5,2,159581,159581,159583,0,2,4
45522,5,2,159586,159586,159588,0,2,3
45523,3,1,159589,159589,159590,0,1,1
45524,2,2,159591,159591,159593,0,2,1
45525,2,2,159593,159593,159595,0,2,0
45526,1,2,159594,159595,159597,1,3,0
45527,5,2,159599,159599,159601,0,2,2
45528,5,3,159604,159604,159607,0,3,3
45529,4,1,159608,159608,159609,0,1,1
45530,2,1,159610,159610,159611,0,1,1
45531,2,1,159612,159612,159613,0,1,1
45532,6,1,159618,159618,159619,0,1,5
45533,1,3,159619,159619,159622,0,3,0
45534,4,2,159623,159623,159625,0,2,1
45535,3,1,159626,159626,159627,0,1,1
45536,2,3,159628,159628,159631,0,3,1
45537,4,2,159632,159632,159634,0,2,1
45538,6,2,159638,159638,159640,0,2,4
45539,4,2,159642,159642,159644,0,2,2
45540,6,2,159648,159648,159650,0,2,4
45541,2,1,159650,159650,159651,0,1,0
45542,4,2,159654,159654,159656,0,2,3
45543,2,3,159656,159656,159659,0,3,0
45544,4,2,159660,159660,159662,0,2,1
45545,6,3,159666,159666,159669,0,3,4
45546,6,2,159672,159672,159674,0,2,3
45547,1,2,159673,159674,159676,1,3,0
45548,2,3,159675,159676,159679,1,4,0
45549,4,2,159679,159679,159681,0,2,0
45550,1,3,159680,159681,159684,1,4,0
45551,3,1,159683,159684,159685,1,2,0
45552,4,1,159687,159687,159688,0,1,2
45553,2,3,159689,159689,159692,0,3,1
45554,2,3,159691,159692,159695,1,4,0
45555,1,3,159692,159695,159698,3,6,0
45556,6,1,159698,159698,159699,0,1,0
45557,4,1,159702,159702,159703,0,1,3
45558,4,2,159706,159706,159708,0,2,3
45559,3,1,159709,159709,159710,0,1,1
45560,3,2,159712,159712,159714,0,2,2
45561,5,1,159717,159717,159718,0,1,3
45562,1,2,159718,159718,159720,0,2,0
45563,1,1,159719,159720,159721,1,2,0
45564,6,3,159725,159725,159728,0,3,4
45565,2,1,159727,159728,159729,1,2,0
45566,3,3,159730,159730,159733,0,3,1
45567,5,2,159735,159735,159737,0,2,2
45568,4,1,159739,159739,159740,0,1,2
45569,3,3,159742,159742,159745,0,3,2
45570,3,3,159745,159745,159748,0,3,0
45571,5,1,159750,159750,159751,0,1,2
45572,5,1,159755,159755,159756,0,1,4
45573,5,3,159760,159760,159763,0,3,4
45574,4,3,159764,159764,159767,0,3,1
45575,3,3,159767,159767,159770,0,3,0
45576,6,1,159773,159773,159774,0,1,3
45577,2,3,159775,159775,159778,0,3,1
45578,6,1,159781,159781,159782,0,1,3
45579,2,1,159783,159783,159784,0,1,1
45580,2,2,159785,159785,159787,0,2,1
45581,6,1,159791,159791,159792,0,1,4
45582,1,2,159792,159792,159794,0,2,0
45583,2,3,159794,159794,159797,0,3,0
45584,1,3,159795,159797,159800,2,5,0
45585,5,3,159800,159800,159803,0,3,0
45586,2,2,159802,159803,159805,1,3,0
45587,4,2,159806,159806,159808,0,2,1
45588,1,3,159807,159808,159811,1,4,0
45589,6,2,159813,159813,159815,0,2,2
45590,5,2,159818,159818,159820,0,2,3
45591,2,1,159820,159820,159821,0,1,0
45592,6,1,159826,159826,159827,0,1,5
45593,1,2,159827,159827,159829,0,2,0
45594,4,2,159831,159831,159833,0,2,2
45595,1,2,159832,159833,159835,1,3,0
45596,5,1,159837,159837,159838,0,1,2
45597,4,1,159841,159841,159842,0,1,3
45598,6,3,159847,159847,159850,0,3,5
45599,4,1,159851,159851,159852,0,1,1
45600,5,3,159856,159856,159859,0,3,4
45601,5,1,159861,159861,159862,0,1,2
45602,2,1,159863,159863,159864,0,1,1
45603,6,2,159869,159869,159871,0,2,5
45604,1,3,159870,159871,159874,1,4,0
45605,2,2,159872,159874,159876,2,4,0
45606,1,1,159873,159876,159877,3,4,0
45607,2,3,159875,159877,159880,2,5,0
45608,3,3,159878,159880,159883,2,5,0
45609,1,3,159879,159883,159886,4,7,0
45610,1,2,159880,159886,159888,6,8,0
45611,3,1,159883,159888,159889,5,6,0
45612,4,1,159887,159889,159890,2,3,0
45613,4,2,159891,159891,159893,0,2,1
45614,1,3,159892,159893,159896,1,4,0
45615,5,1,159897,159897,159898,0,1,1
45616,3,2,159900,159900,159902,0,2,2
45617,4,1,159904,159904,159905,0,1,2
45618,6,1,159910,159910,159911,0,1,5
45619,1,2,159911,159911,159913,0,2,0
45620,5,2,159916,159916,159918,0,2,3
45621,6,2,159922,159922,159924,0,2,4
45622,3,2,159925,159925,159927,0,2,1
45623,1,2,159926,159927,159929,1,3,0
45624,2,2,159928,159929,159931,1,3,0
45625,2,3,159930,159931,159934,1,4,0
45626,1,2,159931,159934,159936,3,5,0
45627,4,2,159935,159936,159938,1,3,0
45628,5,2,159940,159940,159942,0,2,2
45629,2,2,159942,159942,159944,0,2,0
45630,5,3,159947,159947,159950,0,3,3
45631,6,2,159953,159953,159955,0,2,3
45632,2,1,159955,159955,159956,0,1,0
45633,4,1,159959,159959,159960,0,1,3
45634,5,2,159964,159964,159966,0,2,4
45635,2,2,159966,159966,159968,0,2,0
45636,6,3,159972,159972,159975,0,3,4
45637,3,2,159975,159975,159977,0,2,0
45638,4,1,159979,159979,159980,0,1,2
45639,6,1,159985,159985,159986,0,1,5
45640,4,3,159989,159989,159992,0,3,3
45641,4,1,159993,159993,159994,0,1,1
45642,4,1,159997,159997,159998,0,1,3
45643,5,3,160002,160002,160005,0,3,4
45644,1,3,160003,160005,160008,2,5,0
45645,6,3,160009,160009,160012,0,3,1
45646,6,1,160015,160015,160016,0,1,3
45647,4,3,160019,160019,160022,0,3,3
45648,6,3,160025,160025,160028,0,3,3
45649,1,3,160026,160028,160031,2,5,0
45650,3,1,160029,160031,160032,2,3,0
45651,2,1,160031,160032,160033,1,2,0
45652,6,3,160037,160037,160040,0,3,4
45653,6,1,160043,160043,160044,0,1,3
45654,4,1,160047,160047,160048,0,1,3
45655,6,1,160053,160053,160054,0,1,5
45656,4,2,160057,160057,160059,0,2,3
45657,6,1,160063,160063,160064,0,1,4
45658,2,1,160065,160065,160066,0,1,1
45659,2,3,160067,160067,160070,0,3,1
45660,3,3,160070,160070,160073,0,3,0
45661,3,3,160073,160073,160076,0,3,0
45662,4,2,160077,160077,160079,0,2,1
45663,1,2,160078,160079,160081,1,3,0
45664,6,2,160084,160084,160086,0,2,3
45665,2,3,160086,160086,160089,0,3,0
45666,4,3,160090,160090,160093,0,3,1
45667,3,3,160093,160093,160096,0,3,0
45668,1,1,160094,160096,160097,2,3,0
45669,3,2,160097,160097,160099,0,2,0
45670,6,3,160103,160103,160106,0,3,4
45671,4,2,160107,160107,160109,0,2,1
45672,4,3,160111,160111,160114,0,3,2
45673,5,3,160116,160116,160119,0,3,2
45674,1,2,160117,160119,160121,2,4,0
45675,2,3,160119,160121,160124,2,5,0
45676,4,1,160123,160124,160125,1,2,0
45677,3,3,160126,160126,160129,0,3,1
45678,2,3,160128,160129,160132,1,4,0
45679,4,3,160132,160132,160135,0,3,0
45680,3,3,160135,160135,160138,0,3,0
45681,6,2,160141,160141,160143,0,2,3
45682,5,1,160146,160146,160147,0,1,3
45683,3,1,160149,160149,160150,0,1,2
45684,5,3,160154,160154,160157,0,3,4
45685,1,2,160155,160157,160159,2,4,0
45686,2,3,160157,160159,160162,2,5,0
45687,4,1,160161,160162,160163,1,2,0
45688,1,1,160162,160163,160164,1,2,0
45689,2,2,160164,160164,160166,0,2,0
45690,6,1,160170,160170,160171,0,1,4
45691,2,1,160172,160172,160173,0,1,1
45692,4,2,160176,160176,160178,0,2,3
45693,3,1,160179,160179,160180,0,1,1
45694,6,1,160185,160185,160186,0,1,5
45695,5,2,160190,160190,160192,0,2,4
45696,2,1,160192,160192,160193,0,1,0
45697,4,2,160196,160196,160198,0,2,3
45698,2,3,160198,160198,160201,0,3,0
45699,5,1,160203,160203,160204,0,1,2
45700,1,2,160204,160204,160206,0,2,0
45701,5,3,160209,160209,160212,0,3,3
45702,4,1,160213,160213,160214,0,1,1
45703,4,2,160217,160217,160219,0,2,3
45704,1,3,160218,160219,160222,1,4,0
45705,2,3,160220,160222,160225,2,5,0
45706,2,2,160222,160225,160227,3,5,0
45707,5,2,160227,160227,160229,0,2,0
45708,3,1,160230,160230,160231,0,1,1
45709,2,1,160232,160232,160233,0,1,1
45710,3,3,160235,160235,160238,0,3,2
45711,5,3,160240,160240,160243,0,3,2
45712,6,3,160246,160246,160249,0,3,3
45713,6,3,160252,160252,160255,0,3,3
45714,2,2,160254,160255,160257,1,3,0
45715,1,3,160255,160257,160260,2,5,0
45716,6,1,160261,160261,160262,0,1,1
45717,5,1,160266,160266,160267,0,1,4
45718,6,1,160272,160272,160273,0,1,5
45719,4,2,160276,160276,160278,0,2,3
45720,3,3,160279,160279,160282,0,3,1
45721,6,3,160285,160285,160288,0,3,3
45722,3,3,160288,160288,160291,0,3,0
45723,4,2,160292,160292,160294,0,2,1
45724,6,1,160298,160298,160299,0,1,4
45725,3,2,160301,160301,160303,0,2,2
45726,1,2,160302,160303,160305,1,3,0
45727,2,3,160304,160305,160308,1,4,0
45728,6,3,160310,160310,160313,0,3,2
45729,3,3,160313,160313,160316,0,3,0
45730,3,3,160316,160316,160319,0,3,0
45731,6,1,160322,160322,160323,0,1,3
45732,1,3,160323,160323,160326,0,3,0
45733,6,2,160329,160329,160331,0,2,3
45734,2,3,160331,160331,160334,0,3,0
45735,1,1,160332,160334,160335,2,3,0
45736,1,1,160333,160335,160336,2,3,0
45737,2,2,160335,160336,160338,1,3,0
45738,3,3,160338,160338,160341,0,3,0
45739,5,3,160343,160343,160346,0,3,2
45740,5,2,160348,160348,160350,0,2,2
45741,3,2,160351,160351,160353,0,2,1
45742,5,2,160356,160356,160358,0,2,3
45743,5,2,160361,160361,160363,0,2,3
45744,5,1,160366,160366,160367,0,1,3
45745,6,2,160372,160372,160374,0,2,5
45746,3,1,160375,160375,160376,0,1,1
45747,5,3,160380,160380,160383,0,3,4
45748,5,2,160385,160385,160387,0,2,2
45749,5,2,160390,160390,160392,0,2,3
45750,2,2,160392,160392,160394,0,2,0
45751,5,1,160397,160397,160398,0,1,3
45752,5,3,160402,160402,160405,0,3,4
45753,3,3,160405,160405,160408,0,3,0
45754,5,3,160410,160410,160413,0,3,2
45755,2,3,160412,160413,160416,1,4,0
45756,3,2,160415,160416,160418,1,3,0
45757,1,2,160416,160418,160420,2,4,0
45758,3,3,160419,160420,160423,1,4,0
45759,1,1,160420,160423,160424,3,4,0
45760,4,2,160424,160424,160426,0,2,0
45761,5,2,160429,160429,160431,0,2,3
45762,6,1,160435,160435,160436,0,1,4
45763,5,1,160440,160440,160441,0,1,4
45764,6,3,160446,160446,160449,0,3,5
45765,6,2,160452,160452,160454,0,2,3
45766,5,2,160457,160457,160459,0,2,3
45767,1,2,160458,160459,160461,1,3,0
45768,5,3,160463,160463,160466,0,3,2
45769,3,3,160466,160466,160469,0,3,0
45770,1,3,160467,160469,160472,2,5,0
45771,3,3,160470,160472,160475,2,5,0
45772,2,2,160472,160475,160477,3,5,0
45773,1,2,160473,160477,160479,4,6,0
45774,6,1,160479,160479,160480,0,1,0
45775,1,3,160480,160480,160483,0,3,0
45776,5,3,160485,160485,160488,0,3,2
45777,1,2,160486,160488,160490,2,4,0
45778,1,2,160487,160490,160492,3,5,0
45779,4,3,160491,160492,160495,1,4,0
45780,1,3,160492,160495,160498,3,6,0
45781,5,1,160497,160498,160499,1,2,0
45782,2,1,160499,160499,160500,0,1,0
45783,4,2,160503,160503,160505,0,2,3
45784,4,2,160507,160507,160509,0,2,2
45785,6,1,160513,160513,160514,0,1,4
45786,2,1,160515,160515,160516,0,1,1
45787,6,3,160521,160521,160524,0,3,5
45788,2,3,160523,160524,160527,1,4,0
45789,2,3,160525,160527,160530,2,5,0
45790,4,3,160529,160530,160533,1,4,0
45791,5,1,160534,160534,160535,0,1,1
45792,3,1,160537,160537,160538,0,1,2
45793,6,2,160543,160543,160545,0,2,5
45794,5,1,160548,160548,160549,0,1,3
45795,6,3,160554,160554,160557,0,3,5
45796,6,2,160560,160560,160562,0,2,3
45797,2,1,160562,160562,160563,0,1,0
45798,5,3,160567,160567,160570,0,3,4
45799,1,3,160568,160570,160573,2,5,0
45800,2,1,160570,160573,160574,3,4,0
45801,4,1,160574,160574,160575,0,1,0
45802,2,3,160576,160576,160579,0,3,1
45803,5,1,160581,160581,160582,0,1,2
45804,3,1,160584,160584,160585,0,1,2
45805,3,3,160587,160587,160590,0,3,2
45806,2,1,160589,160590,160591,1,2,0
45807,4,2,160593,160593,160595,0,2,2
45808,6,2,160599,160599,160601,0,2,4
45809,2,3,160601,160601,160604,0,3,0
45810,5,1,160606,160606,160607,0,1,2
45811,4,1,160610,160610,160611,0,1,3
45812,4,3,160614,160614,160617,0,3,3
45813,1,1,160615,160617,160618,2,3,0
45814,3,1,160618,160618,160619,0,1,0
45815,3,1,160621,160621,160622,0,1,2
45816,2,3,160623,160623,160626,0,3,1
45817,4,2,160627,160627,160629,0,2,1
45818,1,2,160628,160629,160631,1,3,0
45819,1,3,160629,160631,160634,2,5,0
45820,1,2,160630,160634,160636,4,6,0
45821,3,2,160633,160636,160638,3,5,0
45822,4,2,160637,160638,160640,1,3,0
45823,1,3,160638,160640,160643,2,5,0
45824,4,2,160642,160643,160645,1,3,0
45825,3,1,160645,160645,160646,0,1,0
45826,6,1,160651,160651,160652,0,1,5
45827,5,1,160656,160656,160657,0,1,4
45828,1,2,160657,160657,160659,0,2,0
45829,4,2,160661,160661,160663,0,2,2
45830,5,3,160666,160666,160669,0,3,3
45831,6,2,160672,160672,160674,0,2,3
45832,4,1,160676,160676,160677,0,1,2
45833,4,1,160680,160680,160681,0,1,3
45834,2,1,160682,160682,160683,0,1,1
45835,4,2,160686,160686,160688,0,2,3
45836,5,3,160691,160691,160694,0,3,3
45837,1,3,160692,160694,160697,2,5,0
45838,2,2,160694,160697,160699,3,5,0
45839,5,2,160699,160699,160701,0,2,0
45840,4,2,160703,160703,160705,0,2,2
45841,6,2,160709,160709,160711,0,2,4
45842,6,1,160715,160715,160716,0,1,4
45843,6,3,160721,160721,160724,0,3,5
45844,6,1,160727,160727,160728,0,1,3
45845,2,1,160729,160729,160730,0,1,1
45846,4,1,160733,160733,160734,0,1,3
45847,5,2,160738,160738,160740,0,2,4
45848,1,3,160739,160740,160743,1,4,0
45849,2,1,160741,160743,160744,2,3,0
45850,2,2,160743,160744,160746,1,3,0
45851,1,3,160744,160746,160749,2,5,0
45852,1,3,160745,160749,160752,4,7,0
45853,4,3,160749,160752,160755,3,6,0
45854,4,2,160753,160755,160757,2,4,0
45855,1,2,160754,160757,160759,3,5,0
45856,1,2,160755,160759,160761,4,6,0
45857,1,2,160756,160761,160763,5,7,0
45858,5,2,160761,160763,160765,2,4,0
45859,3,3,160764,160765,160768,1,4,0
45860,5,3,160769,160769,160772,0,3,1
45861,2,2,160771,160772,160774,1,3,0
45862,4,2,160775,160775,160777,0,2,1
45863,3,1,160778,160778,160779,0,1,1
45864,3,1,160781,160781,160782,0,1,2
45865,6,2,160787,160787,160789,0,2,5
45866,5,2,160792,160792,160794,0,2,3
45867,4,3,160796,160796,160799,0,3,2
45868,5,2,160801,160801,160803,0,2,2
45869,2,3,160803,160803,160806,0,3,0
45870,1,1,160804,160806,160807,2,3,0
45871,3,2,160807,160807,160809,0,2,0
45872,2,1,160809,160809,160810,0,1,0
45873,4,2,160813,160813,160815,0,2,3
45874,6,3,160819,160819,160822,0,3,4
45875,4,1,160823,160823,160824,0,1,1
45876,1,1,160824,160824,160825,0,1,0
45877,5,3,160829,160829,160832,0,3,4
45878,3,3,160832,160832,160835,0,3,0
45879,6,2,160838,160838,160840,0,2,3
45880,1,3,160839,160840,160843,1,4,0
45881,3,3,160842,160843,160846,1,4,0
45882,2,2,160844,160846,160848,2,4,0
45883,1,3,160845,160848,160851,3,6,0
45884,5,3,160850,160851,160854,1,4,0
45885,4,2,160854,160854,160856,0,2,0
45886,4,2,160858,160858,160860,0,2,2
45887,6,2,160864,160864,160866,0,2,4
45888,2,2,160866,160866,160868,0,2,0
45889,1,2,160867,160868,160870,1,3,0
45890,3,1,160870,160870,160871,0,1,0
45891,2,3,160872,160872,160875,0,3,1
45892,6,2,160878,160878,160880,0,2,3
45893,2,2,160880,160880,160882,0,2,0
45894,6,3,160886,160886,160889,0,3,4
45895,3,2,160889,160889,160891,0,2,0
45896,3,2,160892,160892,160894,0,2,1
45897,6,1,160898,160898,160899,0,1,4
45898,5,1,160903,160903,160904,0,1,4
45899,3,1,160906,160906,160907,0,1,2
45900,4,1,160910,160910,160911,0,1,3
45901,2,2,160912,160912,160914,0,2,1
45902,4,3,160916,160916,160919,0,3,2
45903,5,3,160921,160921,160924,0,3,2
45904,2,2,160923,160924,160926,1,3,0
45905,2,2,160925,160926,160928,1,3,0
45906,6,2,160931,160931,160933,0,2,3
45907,1,1,160932,160933,160934,1,2,0
45908,5,3,160937,160937,160940,0,3,3
45909,3,1,160940,160940,160941,0,1,0
45910,3,3,160943,160943,160946,0,3,2
45911,2,1,160945,160946,160947,1,2,0
45912,6,3,160951,160951,160954,0,3,4
45913,1,1,160952,160954,160955,2,3,0
45914,5,1,160957,160957,160958,0,1,2
45915,3,1,160960,160960,160961,0,1,2
45916,3,2,160963,160963,160965,0,2,2
45917,2,1,160965,160965,160966,0,1,0
45918,1,1,160966,160966,160967,0,1,0
45919,6,1,160972,160972,160973,0,1,5
45920,6,1,160978,160978,160979,0,1,5
45921,1,1,160979,160979,160980,0,1,0
45922,1,3,160980,160980,160983,0,3,0
45923,1,2,160981,160983,160985,2,4,0
45924,5,2,160986,160986,160988,0,2,1
45925,3,3,160989,160989,160992,0,3,1
45926,4,2,160993,160993,160995,0,2,1
45927,6,3,160999,160999,161002,0,3,4
45928,4,3,161003,161003,161006,0,3,1
45929,4,3,161007,161007,161010,0,3,1
45930,1,3,161008,161010,161013,2,5,0
45931,3,1,161011,161013,161014,2,3,0
45932,3,2,161014,161014,161016,0,2,0
45933,2,3,161016,161016,161019,0,3,0
45934,5,3,161021,161021,161024,0,3,2
45935,2,3,161023,161024,161027,1,4,0
45936,6,2,161029,161029,161031,0,2,2
45937,5,1,161034,161034,161035,0,1,3
45938,6,3,161040,161040,161043,0,3,5
45939,2,1,161042,161043,161044,1,2,0
45940,5,1,161047,161047,161048,0,1,3
45941,3,1,161050,161050,161051,0,1,2
45942,2,2,161052,161052,161054,0,2,1
45943,5,3,161057,161057,161060,0,3,3
45944,4,1,161061,161061,161062,0,1,1
45945,3,3,161064,161064,161067,0,3,2
45946,2,2,161066,161067,161069,1,3,0
45947,4,3,161070,161070,161073,0,3,1
45948,1,3,161071,161073,161076,2,5,0
45949,3,2,161074,161076,161078,2,4,0
45950,5,2,161079,161079,161081,0,2,1
45951,6,2,161085,161085,161087,0,2,4
45952,6,2,161091,161091,161093,0,2,4
45953,1,2,161092,161093,161095,1,3,0
45954,4,3,161096,161096,161099,0,3,1
45955,2,3,161098,161099,161102,1,4,0
45956,3,1,161101,161102,161103,1,2,0
45957,1,2,161102,161103,161105,1,3,0
45958,2,2,161104,161105,161107,1,3,0
45959,2,2,161106,161107,161109,1,3,0
45960,3,1,161109,161109,161110,0,1,0
45961,5,3,161114,161114,161117,0,3,4
45962,5,3,161119,161119,161122,0,3,2
45963,5,1,161124,161124,161125,0,1,2
45964,1,3,161125,161125,161128,0,3,0
45965,5,3,161130,161130,161133,0,3,2
45966,4,2,161134,161134,161136,0,2,1
45967,6,2,161140,161140,161142,0,2,4
45968,2,2,161142,161142,161144,0,2,0
45969,6,3,161148,161148,161151,0,3,4
45970,2,2,161150,161151,161153,1,3,0
45971,6,3,161156,161156,161159,0,3,3
45972,3,3,161159,161159,161162,0,3,0
45973,5,3,161164,161164,161167,0,3,2
45974,6,1,161170,161170,161171,0,1,3
45975,1,1,161171,161171,161172,0,1,0
45976,5,1,161176,161176,161177,0,1,4
45977,2,3,161178,161178,161181,0,3,1
45978,2,1,161180,161181,161182,1,2,0
45979,1,3,161181,161182,161185,1,4,0
45980,5,3,161186,161186,161189,0,3,1
45981,2,2,161188,161189,161191,1,3,0
45982,5,2,161193,161193,161195,0,2,2
45983,1,2,161194,161195,161197,1,3,0
45984,3,3,161197,161197,161200,0,3,0
45985,1,3,161198,161200,161203,2,5,0
45986,5,1,161203,161203,161204,0,1,0
45987,2,2,161205,161205,161207,0,2,1
45988,5,3,161210,161210,161213,0,3,3
45989,5,1,161215,161215,161216,0,1,2
45990,4,2,161219,161219,161221,0,2,3
45991,6,3,161225,161225,161228,0,3,4
45992,1,2,161226,161228,161230,2,4,0
45993,5,1,161231,161231,161232,0,1,1
45994,2,1,161233,161233,161234,0,1,1
45995,6,2,161239,161239,161241,0,2,5
45996,2,2,161241,161241,161243,0,2,0
45997,1,1,161242,161243,161244,1,2,0
45998,6,1,161248,161248,161249,0,1,4
45999,1,3,161249,161249,161252,0,3,0
46000,4,2,161253,161253,161255,0,2,1
46001,4,1,161257,161257,161258,0,1,2
46002,5,2,161262,161262,161264,0,2,4
46003,5,1,161267,161267,161268,0,1,3
46004,6,1,161273,161273,161274,0,1,5
46005,6,3,161279,161279,161282,0,3,5
46006,4,3,161283,161283,161286,0,3,1
46007,3,2,161286,161286,161288,0,2,0
46008,4,1,161290,161290,161291,0,1,2
46009,2,2,161292,161292,161294,0,2,1
46010,4,2,161296,161296,161298,0,2,2
46011,1,1,161297,161298,161299,1,2,0
46012,5,1,161302,161302,161303,0,1,3
46013,2,2,161304,161304,161306,0,2,1
46014,5,2,161309,161309,161311,0,2,3
46015,4,2,161313,161313,161315,0,2,2
46016,5,2,161318,161318,161320,0,2,3
46017,6,3,161324,161324,161327,0,3,4
46018,3,1,161327,161327,161328,0,1,0
46019,6,3,161333,161333,161336,0,3,5
46020,3,2,161336,161336,161338,0,2,0
46021,1,2,161337,161338,161340,1,3,0
46022,4,2,161341,161341,161343,0,2,1
46023,3,2,161344,161344,161346,0,2,1
46024,4,1,161348,161348,161349,0,1,2
46025,6,3,161354,161354,161357,0,3,5
46026,1,1,161355,161357,161358,2,3,0
46027,1,3,161356,161358,161361,2,5,0
46028,4,3,161360,161361,161364,1,4,0
46029,3,2,161363,161364,161366,1,3,0
46030,1,1,161364,161366,161367,2,3,0
46031,2,3,161366,161367,161370,1,4,0
46032,6,1,161372,161372,161373,0,1,2
46033,3,1,161375,161375,161376,0,1,2
46034,5,3,161380,161380,161383,0,3,4
46035,6,3,161386,161386,161389,0,3,3
46036,3,3,161389,161389,161392,0,3,0
46037,2,3,161391,161392,161395,1,4,0
46038,6,3,161397,161397,161400,0,3,2
46039,1,2,161398,161400,161402,2,4,0
46040,3,1,161401,161402,161403,1,2,0
46041,3,2,161404,161404,161406,0,2,1
46042,5,3,161409,161409,161412,0,3,3
46043,3,1,161412,161412,161413,0,1,0
46044,2,2,161414,161414,161416,0,2,1
46045,1,2,161415,161416,161418,1,3,0
46046,4,3,161419,161419,161422,0,3,1
46047,6,3,161425,161425,161428,0,3,3
46048,1,1,161426,161428,161429,2,3,0
46049,1,3,161427,161429,161432,2,5,0
46050,4,3,161431,161432,161435,1,4,0
46051,6,2,161437,161437,161439,0,2,2
46052,6,1,161443,161443,161444,0,1,4
46053,4,1,161447,161447,161448,0,1,3
46054,3,2,161450,161450,161452,0,2,2
46055,5,2,161455,161455,161457,0,2,3
46056,5,3,161460,161460,161463,0,3,3
46057,6,2,161466,161466,161468,0,2,3
46058,1,1,161467,161468,161469,1,2,0
46059,2,2,161469,161469,161471,0,2,0
46060,3,2,161472,161472,161474,0,2,1
46061,4,1,161476,161476,161477,0,1,2
46062,5,1,161481,161481,161482,0,1,4
46063,4,1,161485,161485,161486,0,1,3
46064,4,1,161489,161489,161490,0,1,3
46065,6,1,161495,161495,161496,0,1,5
46066,6,3,161501,161501,161504,0,3,5
46067,3,2,161504,161504,161506,0,2,0
46068,6,3,161510,161510,161513,0,3,4
46069,4,3,161514,161514,161517,0,3,1
46070,2,1,161516,161517,161518,1,2,0
46071,4,1,161520,161520,161521,0,1,2
46072,5,3,161525,161525,161528,0,3,4
46073,3,2,161528,161528,161530,0,2,0
46074,2,1,161530,161530,161531,0,1,0
46075,3,1,161533,161533,161534,0,1,2
46076,2,2,161535,161535,161537,0,2,1
46077,2,1,161537,161537,161538,0,1,0
46078,4,1,161541,161541,161542,0,1,3
46079,6,1,161547,161547,161548,0,1,5
46080,3,2,161550,161550,161552,0,2,2
46081,5,3,161555,161555,161558,0,3,3
46082,2,1,161557,161558,161559,1,2,0
46083,6,2,161563,161563,161565,0,2,4
46084,2,2,161565,161565,161567,0,2,0
46085,5,1,161570,161570,161571,0,1,3
46086,3,3,161573,161573,161576,0,3,2
46087,3,2,161576,161576,161578,0,2,0
46088,2,2,161578,161578,161580,0,2,0
46089,2,1,161580,161580,161581,0,1,0
46090,6,3,161586,161586,161589,0,3,5
46091,5,1,161591,161591,161592,0,1,2
46092,5,1,161596,161596,161597,0,1,4
46093,6,1,161602,161602,161603,0,1,5
46094,4,3,161606,161606,161609,0,3,3
46095,2,1,161608,161609,161610,1,2,0
46096,2,3,161610,161610,161613,0,3,0
46097,1,3,161611,161613,161616,2,5,0
46098,2,1,161613,161616,161617,3,4,0
46099,3,3,161616,161617,161620,1,4,0
46100,1,1,161617,161620,161621,3,4,0
46101,3,1,161620,161621,161622,1,2,0
46102,4,1,161624,161624,161625,0,1,2
46103,1,1,161625,161625,161626,0,1,0
46104,2,3,161627,161627,161630,0,3,1
46105,4,1,161631,161631,161632,0,1,1
46106,6,1,161637,161637,161638,0,1,5
46107,4,3,161641,161641,161644,0,3,3
46108,6,1,161647,161647,161648,0,1,3
46109,6,1,161653,161653,161654,0,1,5
46110,4,2,161657,161657,161659,0,2,3
46111,4,2,161661,161661,161663,0,2,2
46112,2,1,161663,161663,161664,0,1,0
46113,1,1,161664,161664,161665,0,1,0
46114,1,2,161665,161665,161667,0,2,0
46115,6,3,161671,161671,161674,0,3,4
46116,4,3,161675,161675,161678,0,3,1
46117,1,2,161676,161678,161680,2,4,0
46118,5,2,161681,161681,161683,0,2,1
46119,2,3,161683,161683,161686,0,3,0
46120,3,3,161686,161686,161689,0,3,0
46121,3,3,161689,161689,161692,0,3,0
46122,6,3,161695,161695,161698,0,3,3
46123,5,2,161700,161700,161702,0,2,2
46124,2,1,161702,161702,161703,0,1,0
46125,4,1,161706,161706,161707,0,1,3
46126,1,1,161707,161707,161708,0,1,0
46127,6,1,161713,161713,161714,0,1,5
46128,4,1,161717,161717,161718,0,1,3
46129,1,1,161718,161718,161719,0,1,0
46130,3,3,161721,161721,161724,0,3,2
46131,4,2,161725,161725,161727,0,2,1
46132,4,3,161729,161729,161732,0,3,2
46133,3,1,161732,161732,161733,0,1,0
46134,5,2,161737,161737,161739,0,2,4
46135,4,1,161741,161741,161742,0,1,2
46136,5,2,161746,161746,161748,0,2,4
46137,2,3,161748,161748,161751,0,3,0
46138,3,2,161751,161751,161753,0,2,0
46139,1,2,161752,161753,161755,1,3,0
46140,3,2,161755,161755,161757,0,2,0
46141,3,1,161758,161758,161759,0,1,1
46142,1,1,161759,161759,161760,0,1,0
46143,5,1,161764,161764,161765,0,1,4
46144,4,2,161768,161768,161770,0,2,3
46145,2,1,161770,161770,161771,0,1,0
46146,2,3,161772,161772,161775,0,3,1
46147,1,3,161773,161775,161778,2,5,0
46148,2,3,161775,161778,161781,3,6,0
46149,2,2,161777,161781,161783,4,6,0
46150,1,3,161778,161783,161786,5,8,0
46151,4,3,161782,161786,161789,4,7,0
46152,2,3,161784,161789,161792,5,8,0
46153,5,1,161789,161792,161793,3,4,0
46154,1,2,161790,161793,161795,3,5,0
46155,6,1,161796,161796,161797,0,1,1
46156,2,2,161798,161798,161800,0,2,1
46157,2,1,161800,161800,161801,0,1,0
46158,6,2,161806,161806,161808,0,2,5
46159,6,3,161812,161812,161815,0,3,4
46160,1,1,161813,161815,161816,2,3,0
46161,5,2,161818,161818,161820,0,2,2
46162,5,3,161823,161823,161826,0,3,3
46163,2,2,161825,161826,161828,1,3,0
46164,6,3,161831,161831,161834,0,3,3
46165,2,1,161833,161834,161835,1,2,0
46166,2,3,161835,161835,161838,0,3,0
46167,3,3,161838,161838,161841,0,3,0
46168,5,3,161843,161843,161846,0,3,2
46169,5,3,161848,161848,161851,0,3,2
46170,3,2,161851,161851,161853,0,2,0
46171,4,2,161855,161855,161857,0,2,2
46172,6,2,161861,161861,161863,0,2,4
46173,2,2,161863,161863,161865,0,2,0
46174,6,2,161869,161869,161871,0,2,4
46175,4,1,161873,161873,161874,0,1,2
46176,5,1,161878,161878,161879,0,1,4
46177,3,2,161881,161881,161883,0,2,2
46178,5,1,161886,161886,161887,0,1,3
46179,2,2,161888,161888,161890,0,2,1
46180,5,3,161893,161893,161896,0,3,3
46181,4,1,161897,161897,161898,0,1,1
46182,5,1,161902,161902,161903,0,1,4
46183,6,2,161908,161908,161910,0,2,5
46184,1,3,161909,161910,161913,1,4,0
46185,2,1,161911,161913,161914,2,3,0
46186,3,3,161914,161914,161917,0,3,0
46187,3,1,161917,161917,161918,0,1,0
46188,3,1,161920,161920,161921,0,1,2
46189,4,3,161924,161924,161927,0,3,3
46190,5,3,161929,161929,161932,0,3,2
46191,1,2,161930,161932,161934,2,4,0
46192,3,3,161933,161934,161937,1,4,0
46193,4,1,161937,161937,161938,0,1,0
46194,1,2,161938,161938,161940,0,2,0
46195,2,3,161940,161940,161943,0,3,0
46196,1,2,161941,161943,161945,2,4,0
46197,2,3,161943,161945,161948,2,5,0
46198,6,1,161949,161949,161950,0,1,1
46199,3,1,161952,161952,161953,0,1,2
46200,4,3,161956,161956,161959,0,3,3
46201,2,3,161958,161959,161962,1,4,0
46202,4,1,161962,161962,161963,0,1,0
46203,5,1,161967,161967,161968,0,1,4
46204,1,3,161968,161968,161971,0,3,0
46205,6,3,161974,161974,161977,0,3,3
46206,3,2,161977,161977,161979,0,2,0
46207,1,3,161978,161979,161982,1,4,0
46208,1,1,161979,161982,161983,3,4,0
46209,6,2,161985,161985,161987,0,2,2
46210,6,1,161991,161991,161992,0,1,4
46211,1,2,161992,161992,161994,0,2,0
46212,1,2,161993,161994,161996,1,3,0
46213,1,1,161994,161996,161997,2,3,0
46214,1,2,161995,161997,161999,2,4,0
46215,2,2,161997,161999,162001,2,4,0
46216,2,1,161999,162001,162002,2,3,0
46217,4,2,162003,162003,162005,0,2,1
46218,2,2,162005,162005,162007,0,2,0
46219,1,1,162006,162007,162008,1,2,0
46220,6,2,162012,162012,162014,0,2,4
46221,6,3,162018,162018,162021,0,3,4
46222,5,3,162023,162023,162026,0,3,2
46223,6,2,162029,162029,162031,0,2,3
46224,6,1,162035,162035,162036,0,1,4
46225,3,1,162038,162038,162039,0,1,2
46226,5,3,162043,162043,162046,0,3,4
46227,6,1,162049,162049,162050,0,1,3
46228,5,2,162054,162054,162056,0,2,4
46229,2,1,162056,162056,162057,0,1,0
46230,6,2,162062,162062,162064,0,2,5
46231,4,1,162066,162066,162067,0,1,2
46232,6,3,162072,162072,162075,0,3,5
46233,4,3,162076,162076,162079,0,3,1
46234,6,1,162082,162082,162083,0,1,3
46235,6,3,162088,162088,162091,0,3,5
46236,2,2,162090,162091,162093,1,3,0
46237,2,3,162092,162093,162096,1,4,0
46238,4,3,162096,162096,162099,0,3,0
46239,4,2,162100,162100,162102,0,2,1
46240,1,2,162101,162102,162104,1,3,0
46241,4,2,162105,162105,162107,0,2,1
46242,6,3,162111,162111,162114,0,3,4
46243,5,3,162116,162116,162119,0,3,2
46244,6,1,162122,162122,162123,0,1,3
46245,4,2,162126,162126,162128,0,2,3
46246,5,1,162131,162131,162132,0,1,3
46247,5,2,162136,162136,162138,0,2,4
46248,1,2,162137,162138,162140,1,3,0
46249,5,2,162142,162142,162144,0,2,2
46250,5,1,162147,162147,162148,0,1,3
46251,4,1,162151,162151,162152,0,1,3
46252,3,3,162154,162154,162157,0,3,2
46253,1,3,162155,162157,162160,2,5,0
46254,4,3,162159,162160,162163,1,4,0
46255,5,2,162164,162164,162166,0,2,1
46256,1,2,162165,162166,162168,1,3,0
46257,1,2,162166,162168,162170,2,4,0
46258,6,3,162172,162172,162175,0,3,2
46259,5,1,162177,162177,162178,0,1,2
46260,5,3,162182,162182,162185,0,3,4
46261,1,2,162183,162185,162187,2,4,0
46262,6,3,162189,162189,162192,0,3,2
46263,6,3,162195,162195,162198,0,3,3
46264,2,1,162197,162198,162199,1,2,0
46265,5,3,162202,162202,162205,0,3,3
46266,2,3,162204,162205,162208,1,4,0
46267,2,3,162206,162208,162211,2,5,0
46268,1,1,162207,162211,162212,4,5,0
46269,6,2,162213,162213,162215,0,2,1
46270,3,2,162216,162216,162218,0,2,1
46271,2,2,162218,162218,162220,0,2,0
46272,3,2,162221,162221,162223,0,2,1
46273,5,3,162226,162226,162229,0,3,3
46274,4,1,162230,162230,162231,0,1,1
46275,5,2,162235,162235,162237,0,2,4
46276,5,3,162240,162240,162243,0,3,3
46277,2,2,162242,162243,162245,1,3,0
46278,3,3,162245,162245,162248,0,3,0
46279,1,1,162246,162248,162249,2,3,0
46280,1,1,162247,162249,162250,2,3,0
46281,3,2,162250,162250,162252,0,2,0
46282,3,1,162253,162253,162254,0,1,1
46283,6,3,162259,162259,162262,0,3,5
46284,6,3,162265,162265,162268,0,3,3
46285,2,2,162267,162268,162270,1,3,0
46286,3,2,162270,162270,162272,0,2,0
46287,2,2,162272,162272,162274,0,2,0
46288,2,2,162274,162274,162276,0,2,0
46289,3,3,162277,162277,162280,0,3,1
46290,1,2,162278,162280,162282,2,4,0
46291,4,1,162282,162282,162283,0,1,0
46292,5,3,162287,162287,162290,0,3,4
46293,4,3,162291,162291,162294,0,3,1
46294,1,3,162292,162294,162297,2,5,0
46295,5,2,162297,162297,162299,0,2,0
46296,1,2,162298,162299,162301,1,3,0
46297,3,3,162301,162301,162304,0,3,0
46298,4,1,162305,162305,162306,0,1,1
46299,5,2,162310,162310,162312,0,2,4
46300,2,2,162312,162312,162314,0,2,0
46301,1,2,162313,162314,162316,1,3,0
46302,5,2,162318,162318,162320,0,2,2
46303,1,3,162319,162320,162323,1,4,0
46304,4,3,162323,162323,162326,0,3,0
46305,4,3,162327,162327,162330,0,3,1
46306,1,2,162328,162330,162332,2,4,0
46307,2,1,162330,162332,162333,2,3,0
46308,3,3,162333,162333,162336,0,3,0
46309,4,3,162337,162337,162340,0,3,1
46310,3,1,162340,162340,162341,0,1,0
46311,2,3,162342,162342,162345,0,3,1
46312,4,1,162346,162346,162347,0,1,1
46313,1,3,162347,162347,162350,0,3,0
46314,3,3,162350,162350,162353,0,3,0
46315,1,3,162351,162353,162356,2,5,0
46316,5,2,162356,162356,162358,0,2,0
46317,3,1,162359,162359,162360,0,1,1
46318,4,3,162363,162363,162366,0,3,3
46319,3,3,162366,162366,162369,0,3,0
46320,2,2,162368,162369,162371,1,3,0
46321,6,1,162374,162374,162375,0,1,3
46322,4,3,162378,162378,162381,0,3,3
46323,6,1,162384,162384,162385,0,1,3
46324,5,2,162389,162389,162391,0,2,4
46325,1,1,162390,162391,162392,1,2,0
46326,6,1,162396,162396,162397,0,1,4
46327,3,2,162399,162399,162401,0,2,2
46328,4,1,162403,162403,162404,0,1,2
46329,6,2,162409,162409,162411,0,2,5
46330,5,2,162414,162414,162416,0,2,3
46331,3,3,162417,162417,162420,0,3,1
46332,6,3,162423,162423,162426,0,3,3
46333,6,1,162429,162429,162430,0,1,3
46334,5,3,162434,162434,162437,0,3,4
46335,6,1,162440,162440,162441,0,1,3
46336,4,3,162444,162444,162447,0,3,3
46337,4,2,162448,162448,162450,0,2,1
46338,5,3,162453,162453,162456,0,3,3
46339,5,2,162458,162458,162460,0,2,2
46340,1,1,162459,162460,162461,1,2,0
46341,6,2,162465,162465,162467,0,2,4
46342,6,3,162471,162471,162474,0,3,4
46343,2,2,162473,162474,162476,1,3,0
46344,1,2,162474,162476,162478,2,4,0
46345,4,1,162478,162478,162479,0,1,0
46346,4,3,162482,162482,162485,0,3,3
46347,1,1,162483,162485,162486,2,3,0
46348,6,3,162489,162489,162492,0,3,3
46349,3,2,162492,162492,162494,0,2,0
46350,2,3,162494,162494,162497,0,3,0
46351,3,1,162497,162497,162498,0,1,0
46352,1,3,162498,162498,162501,0,3,0
46353,1,3,162499,162501,162504,2,5,0
46354,6,3,162505,162505,162508,0,3,1
46355,1,3,162506,162508,162511,2,5,0
46356,6,3,162512,162512,162515,0,3,1
46357,1,1,162513,162515,162516,2,3,0
46358,2,1,162515,162516,162517,1,2,0
46359,2,1,162517,162517,162518,0,1,0
46360,4,1,162521,162521,162522,0,1,3
46361,4,3,162525,162525,162528,0,3,3
46362,3,1,162528,162528,162529,0,1,0
46363,2,1,162530,162530,162531,0,1,1
46364,5,3,162535,162535,162538,0,3,4
46365,4,3,162539,162539,162542,0,3,1
46366,2,2,162541,162542,162544,1,3,0
46367,3,1,162544,162544,162545,0,1,0
46368,1,3,162545,162545,162548,0,3,0
46369,6,2,162551,162551,162553,0,2,3
46370,2,3,162553,162553,162556,0,3,0
46371,2,2,162555,162556,162558,1,3,0
46372,3,1,162558,162558,162559,0,1,0
46373,4,1,162562,162562,162563,0,1,3
46374,5,3,162567,162567,162570,0,3,4
46375,6,2,162573,162573,162575,0,2,3
46376,2,1,162575,162575,162576,0,1,0
46377,4,3,162579,162579,162582,0,3,3
46378,6,2,162585,162585,162587,0,2,3
46379,1,3,162586,162587,162590,1,4,0
46380,2,3,162588,162590,162593,2,5,0
46381,1,3,162589,162593,162596,4,7,0
46382,3,1,162592,162596,162597,4,5,0
46383,4,2,162596,162597,162599,1,3,0
46384,3,1,162599,162599,162600,0,1,0
46385,3,2,162602,162602,162604,0,2,2
46386,6,1,162608,162608,162609,0,1,4
46387,2,3,162610,162610,162613,0,3,1
46388,1,3,162611,162613,162616,2,5,0
46389,2,2,162613,162616,162618,3,5,0
46390,3,2,162616,162618,162620,2,4,0
46391,4,3,162620,162620,162623,0,3,0
46392,2,2,162622,162623,162625,1,3,0
46393,2,3,162624,162625,162628,1,4,0
46394,6,3,162630,162630,162633,0,3,2
46395,5,3,162635,162635,162638,0,3,2
46396,4,2,162639,162639,162641,0,2,1
46397,3,3,162642,162642,162645,0,3,1
46398,6,3,162648,162648,162651,0,3,3
46399,2,3,162650,162651,162654,1,4,0
46400,3,1,162653,162654,162655,1,2,0
46401,1,3,162654,162655,162658,1,4,0
46402,5,2,162659,162659,162661,0,2,1
46403,2,2,162661,162661,162663,0,2,0
46404,2,1,162663,162663,162664,0,1,0
46405,6,2,162669,162669,162671,0,2,5
46406,1,3,162670,162671,162674,1,4,0
46407,6,2,162676,162676,162678,0,2,2
46408,5,3,162681,162681,162684,0,3,3
46409,6,2,162687,162687,162689,0,2,3
46410,4,1,162691,162691,162692,0,1,2
46411,3,1,162694,162694,162695,0,1,2
46412,5,3,162699,162699,162702,0,3,4
46413,6,1,162705,162705,162706,0,1,3
46414,1,1,162706,162706,162707,0,1,0
46415,4,1,162710,162710,162711,0,1,3
46416,6,3,162716,162716,162719,0,3,5
46417,3,1,162719,162719,162720,0,1,0
46418,4,3,162723,162723,162726,0,3,3
46419,5,2,162728,162728,162730,0,2,2
46420,6,1,162734,162734,162735,0,1,4
46421,5,2,162739,162739,162741,0,2,4
46422,6,1,162745,162745,162746,0,1,4
46423,4,3,162749,162749,162752,0,3,3
46424,3,1,162752,162752,162753,0,1,0
46425,2,3,162754,162754,162757,0,3,1
46426,2,1,162756,162757,162758,1,2,0
46427,1,3,162757,162758,162761,1,4,0
46428,5,1,162762,162762,162763,0,1,1
46429,3,2,162765,162765,162767,0,2,2
46430,2,3,162767,162767,162770,0,3,0
46431,6,2,162773,162773,162775,0,2,3
46432,5,2,162778,162778,162780,0,2,3
46433,2,2,162780,162780,162782,0,2,0
46434,1,2,162781,162782,162784,1,3,0
46435,4,3,162785,162785,162788,0,3,1
46436,2,2,162787,162788,162790,1,3,0
46437,4,3,162791,162791,162794,0,3,1
46438,5,3,162796,162796,162799,0,3,2
46439,3,1,162799,162799,162800,0,1,0
46440,5,3,162804,162804,162807,0,3,4
46441,6,1,162810,162810,162811,0,1,3
46442,2,3,162812,162812,162815,0,3,1
46443,3,2,162815,162815,162817,0,2,0
46444,2,3,162817,162817,162820,0,3,0
46445,4,1,162821,162821,162822,0,1,1
46446,3,2,162824,162824,162826,0,2,2
46447,1,1,162825,162826,162827,1,2,0
46448,2,3,162827,162827,162830,0,3,0
46449,3,2,162830,162830,162832,0,2,0
46450,2,2,162832,162832,162834,0,2,0
46451,3,2,162835,162835,162837,0,2,1
46452,5,2,162840,162840,162842,0,2,3
46453,3,1,162843,162843,162844,0,1,1
46454,4,2,162847,162847,162849,0,2,3
46455,5,2,162852,162852,162854,0,2,3
46456,4,3,162856,162856,162859,0,3,2
46457,1,3,162857,162859,162862,2,5,0
46458,3,1,162860,162862,162863,2,3,0
46459,2,2,162862,162863,162865,1,3,0
46460,3,3,162865,162865,162868,0,3,0
46461,2,1,162867,162868,162869,1,2,0
46462,6,3,162873,162873,162876,0,3,4
46463,1,3,162874,162876,162879,2,5,0
46464,2,3,162876,162879,162882,3,6,0
46465,3,3,162879,162882,162885,3,6,0
46466,4,1,162883,162885,162886,2,3,0
46467,6,3,162889,162889,162892,0,3,3
46468,6,3,162895,162895,162898,0,3,3
46469,4,3,162899,162899,162902,0,3,1
46470,6,2,162905,162905,162907,0,2,3
46471,3,3,162908,162908,162911,0,3,1
46472,5,3,162913,162913,162916,0,3,2
46473,1,2,162914,162916,162918,2,4,0
46474,5,2,162919,162919,162921,0,2,1
46475,2,1,162921,162921,162922,0,1,0
46476,5,1,162926,162926,162927,0,1,4
46477,3,3,162929,162929,162932,0,3,2
46478,4,2,162933,162933,162935,0,2,1
46479,4,2,162937,162937,162939,0,2,2
46480,4,1,162941,162941,162942,0,1,2
46481,2,1,162943,162943,162944,0,1,1
46482,5,2,162948,162948,162950,0,2,4
46483,5,3,162953,162953,162956,0,3,3
46484,3,1,162956,162956,162957,0,1,0
46485,5,1,162961,162961,162962,0,1,4
46486,1,1,162962,162962,162963,0,1,0
46487,6,1,162968,162968,162969,0,1,5
46488,2,2,162970,162970,162972,0,2,1
46489,1,3,162971,162972,162975,1,4,0
46490,4,2,162975,162975,162977,0,2,0
46491,2,1,162977,162977,162978,0,1,0
46492,5,2,162982,162982,162984,0,2,4
46493,1,2,162983,162984,162986,1,3,0
46494,4,3,162987,162987,162990,0,3,1
46495,6,2,162993,162993,162995,0,2,3
46496,5,3,162998,162998,163001,0,3,3
46497,4,1,163002,163002,163003,0,1,1
46498,5,1,163007,163007,163008,0,1,4
46499,2,2,163009,163009,163011,0,2,1
46500,1,3,163010,163011,163014,1,4,0
46501,6,2,163016,163016,163018,0,2,2
46502,6,3,163022,163022,163025,0,3,4
46503,2,3,163024,163025,163028,1,4,0
46504,3,1,163027,163028,163029,1,2,0
46505,4,2,163031,163031,163033,0,2,2
46506,5,1,163036,163036,163037,0,1,3
46507,6,3,163042,163042,163045,0,3,5
46508,5,2,163047,163047,163049,0,2,2
46509,2,1,163049,163049,163050,0,1,0
46510,5,3,163054,163054,163057,0,3,4
46511,2,3,163056,163057,163060,1,4,0
46512,6,2,163062,163062,163064,0,2,2
46513,1,2,163063,163064,163066,1,3,0
46514,6,3,163069,163069,163072,0,3,3
46515,1,3,163070,163072,163075,2,5,0
46516,5,2,163075,163075,163077,0,2,0
46517,1,3,163076,163077,163080,1,4,0
46518,2,3,163078,163080,163083,2,5,0
46519,4,1,163082,163083,163084,1,2,0
46520,2,2,163084,163084,163086,0,2,0
46521,4,3,163088,163088,163091,0,3,2
46522,6,2,163094,163094,163096,0,2,3
46523,2,3,163096,163096,163099,0,3,0
46524,2,3,163098,163099,163102,1,4,0
46525,1,3,163099,163102,163105,3,6,0
46526,5,1,163104,163105,163106,1,2,0
46527,3,3,163107,163107,163110,0,3,1
46528,1,2,163108,163110,163112,2,4,0
46529,3,3,163111,163112,163115,1,4,0
46530,5,1,163116,163116,163117,0,1,1
46531,6,2,163122,163122,163124,0,2,5
46532,3,2,163125,163125,163127,0,2,1
46533,2,3,163127,163127,163130,0,3,0
46534,5,2,163132,163132,163134,0,2,2
46535,5,2,163137,163137,163139,0,2,3
46536,6,1,163143,163143,163144,0,1,4
46537,1,1,163144,163144,163145,0,1,0
46538,2,2,163146,163146,163148,0,2,1
46539,1,2,163147,163148,163150,1,3,0
46540,3,2,163150,163150,163152,0,2,0
46541,2,3,163152,163152,163155,0,3,0
46542,2,3,163154,163155,163158,1,4,0
46543,4,3,163158,163158,163161,0,3,0
46544,1,3,163159,163161,163164,2,5,0
46545,4,3,163163,163164,163167,1,4,0
46546,1,1,163164,163167,163168,3,4,0
46547,1,1,163165,163168,163169,3,4,0
46548,1,2,163166,163169,163171,3,5,0
46549,6,2,163172,163172,163174,0,2,1
46550,3,1,163175,163175,163176,0,1,1
46551,2,3,163177,163177,163180,0,3,1
46552,6,3,163183,163183,163186,0,3,3
46553,1,2,163184,163186,163188,2,4,0
46554,2,1,163186,163188,163189,2,3,0
46555,4,3,163190,163190,163193,0,3,1
46556,1,1,163191,163193,163194,2,3,0
46557,2,2,163193,163194,163196,1,3,0
46558,6,1,163199,163199,163200,0,1,3
46559,1,2,163200,163200,163202,0,2,0
46560,4,2,163204,163204,163206,0,2,2
46561,1,1,163205,163206,163207,1,2,0
46562,1,2,163206,163207,163209,1,3,0
46563,1,1,163207,163209,163210,2,3,0
46564,4,2,163211,163211,163213,0,2,1
46565,3,2,163214,163214,163216,0,2,1
46566,3,2,163217,163217,163219,0,2,1
46567,6,2,163223,163223,163225,0,2,4
46568,3,3,163226,163226,163229,0,3,1
46569,4,3,163230,163230,163233,0,3,1
46570,3,3,163233,163233,163236,0,3,0
46571,4,3,163237,163237,163240,0,3,1
46572,1,1,163238,163240,163241,2,3,0
46573,2,2,163240,163241,163243,1,3,0
46574,1,3,163241,163243,163246,2,5,0
46575,3,2,163244,163246,163248,2,4,0
46576,5,3,163249,163249,163252,0,3,1
46577,3,2,163252,163252,163254,0,2,0
46578,1,3,163253,163254,163257,1,4,0
46579,3,2,163256,163257,163259,1,3,0
46580,4,2,163260,163260,163262,0,2,1
46581,1,2,163261,163262,163264,1,3,0
46582,6,1,163267,163267,163268,0,1,3
46583,4,2,163271,163271,163273,0,2,3
46584,5,1,163276,163276,163277,0,1,3
46585,6,2,163282,163282,163284,0,2,5
46586,4,3,163286,163286,163289,0,3,2
46587,1,1,163287,163289,163290,2,3,0
46588,1,3,163288,163290,163293,2,5,0
46589,2,3,163290,163293,163296,3,6,0
46590,5,3,163295,163296,163299,1,4,0
46591,5,2,163300,163300,163302,0,2,1
46592,4,1,163304,163304,163305,0,1,2
46593,1,3,163305,163305,163308,0,3,0
46594,6,3,163311,163311,163314,0,3,3
46595,2,2,163313,163314,163316,1,3,0
46596,1,1,163314,163316,163317,2,3,0
46597,2,2,163316,163317,163319,1,3,0
46598,6,1,163322,163322,163323,0,1,3
46599,1,3,163323,163323,163326,0,3,0
46600,3,2,163326,163326,163328,0,2,0
46601,1,2,163327,163328,163330,1,3,0
46602,3,1,163330,163330,163331,0,1,0
46603,4,2,163334,163334,163336,0,2,3
46604,6,3,163340,163340,163343,0,3,4
46605,3,1,163343,163343,163344,0,1,0
46606,3,1,163346,163346,163347,0,1,2
46607,2,2,163348,163348,163350,0,2,1
46608,6,2,163354,163354,163356,0,2,4
46609,3,2,163357,163357,163359,0,2,1
46610,5,2,163362,163362,163364,0,2,3
46611,1,2,163363,163364,163366,1,3,0
46612,1,3,163364,163366,163369,2,5,0
46613,2,1,163366,163369,163370,3,4,0
46614,3,1,163369,163370,163371,1,2,0
46615,6,1,163375,163375,163376,0,1,4
46616,1,3,163376,163376,163379,0,3,0
46617,2,3,163378,163379,163382,1,4,0
46618,4,2,163382,163382,163384,0,2,0
46619,5,2,163387,163387,163389,0,2,3
46620,1,2,163388,163389,163391,1,3,0
46621,1,1,163389,163391,163392,2,3,0
46622,2,3,163391,163392,163395,1,4,0
46623,3,2,163394,163395,163397,1,3,0
46624,6,2,163400,163400,163402,0,2,3
46625,1,3,163401,163402,163405,1,4,0
46626,6,3,163407,163407,163410,0,3,2
46627,6,3,163413,163413,163416,0,3,3
46628,3,3,163416,163416,163419,0,3,0
46629,1,3,163417,163419,163422,2,5,0
46630,2,1,163419,163422,163423,3,4,0
46631,4,2,163423,163423,163425,0,2,0
46632,6,1,163429,163429,163430,0,1,4
46633,5,1,163434,163434,163435,0,1,4
46634,1,2,163435,163435,163437,0,2,0
46635,5,2,163440,163440,163442,0,2,3
46636,2,2,163442,163442,163444,0,2,0
46637,6,3,163448,163448,163451,0,3,4
46638,4,3,163452,163452,163455,0,3,1
46639,6,3,163458,163458,163461,0,3,3
46640,4,2,163462,163462,163464,0,2,1
46641,3,3,163465,163465,163468,0,3,1
46642,1,3,163466,163468,163471,2,5,0
46643,1,1,163467,163471,163472,4,5,0
46644,4,2,163471,163472,163474,1,3,0
46645,3,3,163474,163474,163477,0,3,0
46646,4,1,163478,163478,163479,0,1,1
46647,1,2,163479,163479,163481,0,2,0
46648,6,2,163485,163485,163487,0,2,4
46649,4,3,163489,163489,163492,0,3,2
46650,5,1,163494,163494,163495,0,1,2
46651,2,1,163496,163496,163497,0,1,1
46652,5,3,163501,163501,163504,0,3,4
46653,5,1,163506,163506,163507,0,1,2
46654,1,1,163507,163507,163508,0,1,0
46655,5,3,163512,163512,163515,0,3,4
46656,2,3,163514,163515,163518,1,4,0
46657,1,3,163515,163518,163521,3,6,0
46658,4,3,163519,163521,163524,2,5,0
46659,2,2,163521,163524,163526,3,5,0
46660,3,1,163524,163526,163527,2,3,0
46661,6,1,163530,163530,163531,0,1,3
46662,2,2,163532,163532,163534,0,2,1
46663,1,3,163533,163534,163537,1,4,0
46664,3,1,163536,163537,163538,1,2,0
46665,3,2,163539,163539,163541,0,2,1
46666,6,1,163545,163545,163546,0,1,4
46667,5,2,163550,163550,163552,0,2,4
46668,1,3,163551,163552,163555,1,4,0
46669,2,1,163553,163555,163556,2,3,0
46670,3,2,163556,163556,163558,0,2,0
46671,3,2,163559,163559,163561,0,2,1
46672,2,1,163561,163561,163562,0,1,0
46673,5,3,163566,163566,163569,0,3,4
46674,6,1,163572,163572,163573,0,1,3
46675,3,1,163575,163575,163576,0,1,2
46676,4,1,163579,163579,163580,0,1,3
46677,5,1,163584,163584,163585,0,1,4
46678,6,1,163590,163590,163591,0,1,5
46679,2,1,163592,163592,163593,0,1,1
46680,6,2,163598,163598,163600,0,2,5
46681,4,1,163602,163602,163603,0,1,2
46682,4,3,163606,163606,163609,0,3,3
46683,1,1,163607,163609,163610,2,3,0
46684,6,2,163613,163613,163615,0,2,3
46685,4,3,163617,163617,163620,0,3,2
46686,6,3,163623,163623,163626,0,3,3
46687,5,3,163628,163628,163631,0,3,2
46688,6,2,163634,163634,163636,0,2,3
46689,6,3,163640,163640,163643,0,3,4
46690,6,3,163646,163646,163649,0,3,3
46691,5,3,163651,163651,163654,0,3,2
46692,4,1,163655,163655,163656,0,1,1
46693,2,1,163657,163657,163658,0,1,1
46694,6,2,163663,163663,163665,0,2,5
46695,4,2,163667,163667,163669,0,2,2
46696,3,2,163670,163670,163672,0,2,1
46697,4,2,163674,163674,163676,0,2,2
46698,6,1,163680,163680,163681,0,1,4
46699,1,1,163681,163681,163682,0,1,0
46700,6,2,163687,163687,163689,0,2,5
46701,5,1,163692,163692,163693,0,1,3
46702,3,3,163695,163695,163698,0,3,2
46703,2,3,163697,163698,163701,1,4,0
46704,6,2,163703,163703,163705,0,2,2
46705,1,2,163704,163705,163707,1,3,0
46706,1,1,163705,163707,163708,2,3,0
46707,1,3,163706,163708,163711,2,5,0
46708,3,2,163709,163711,163713,2,4,0
46709,6,3,163715,163715,163718,0,3,2
46710,4,3,163719,163719,163722,0,3,1
46711,1,1,163720,163722,163723,2,3,0
46712,6,2,163726,163726,163728,0,2,3
46713,2,1,163728,163728,163729,0,1,0
46714,4,3,163732,163732,163735,0,3,3
46715,5,3,163737,163737,163740,0,3,2
46716,6,1,163743,163743,163744,0,1,3
46717,6,2,163749,163749,163751,0,2,5
46718,3,3,163752,163752,163755,0,3,1
46719,4,2,163756,163756,163758,0,2,1
46720,1,1,163757,163758,163759,1,2,0
46721,2,2,163759,163759,163761,0,2,0
46722,3,2,163762,163762,163764,0,2,1
46723,4,1,163766,163766,163767,0,1,2
46724,6,2,163772,163772,163774,0,2,5
46725,1,2,163773,163774,163776,1,3,0
46726,5,3,163778,163778,163781,0,3,2
46727,3,2,163781,163781,163783,0,2,0
46728,4,3,163785,163785,163788,0,3,2
46729,4,2,163789,163789,163791,0,2,1
46730,4,2,163793,163793,163795,0,2,2
46731,5,1,163798,163798,163799,0,1,3
46732,5,3,163803,163803,163806,0,3,4
46733,3,1,163806,163806,163807,0,1,0
46734,3,1,163809,163809,163810,0,1,2
46735,5,3,163814,163814,163817,0,3,4
46736,4,3,163818,163818,163821,0,3,1
46737,5,2,163823,163823,163825,0,2,2
46738,4,2,163827,163827,163829,0,2,2
46739,4,1,163831,163831,163832,0,1,2
46740,6,3,163837,163837,163840,0,3,5
46741,6,2,163843,163843,163845,0,2,3
46742,6,2,163849,163849,163851,0,2,4
46743,2,1,163851,163851,163852,0,1,0
46744,5,3,163856,163856,163859,0,3,4
46745,6,2,163862,163862,163864,0,2,3
46746,2,2,163864,163864,163866,0,2,0
46747,6,2,163870,163870,163872,0,2,4
46748,4,1,163874,163874,163875,0,1,2
46749,6,1,163880,163880,163881,0,1,5
46750,1,1,163881,163881,163882,0,1,0
46751,5,1,163886,163886,163887,0,1,4
46752,4,2,163890,163890,163892,0,2,3
46753,3,2,163893,163893,163895,0,2,1
46754,2,3,163895,163895,163898,0,3,0
46755,4,2,163899,163899,163901,0,2,1
46756,2,1,163901,163901,163902,0,1,0
46757,4,3,163905,163905,163908,0,3,3
46758,4,3,163909,163909,163912,0,3,1
46759,3,3,163912,163912,163915,0,3,0
46760,3,3,163915,163915,163918,0,3,0
46761,3,1,163918,163918,163919,0,1,0
46762,2,3,163920,163920,163923,0,3,1
46763,4,2,163924,163924,163926,0,2,1
46764,5,2,163929,163929,163931,0,2,3
46765,6,1,163935,163935,163936,0,1,4
46766,6,1,163941,163941,163942,0,1,5
46767,5,1,163946,163946,163947,0,1,4
46768,1,1,163947,163947,163948,0,1,0
46769,3,3,163950,163950,163953,0,3,2
46770,5,1,163955,163955,163956,0,1,2
46771,4,1,163959,163959,163960,0,1,3
46772,6,3,163965,163965,163968,0,3,5
46773,3,1,163968,163968,163969,0,1,0
46774,1,3,163969,163969,163972,0,3,0
46775,6,3,163975,163975,163978,0,3,3
46776,4,1,163979,163979,163980,0,1,1
46777,6,2,163985,163985,163987,0,2,5
46778,3,2,163988,163988,163990,0,2,1
46779,3,1,163991,163991,163992,0,1,1
46780,5,1,163996,163996,163997,0,1,4
46781,5,1,164001,164001,164002,0,1,4
46782,5,3,164006,164006,164009,0,3,4
46783,6,2,164012,164012,164014,0,2,3
46784,4,3,164016,164016,164019,0,3,2
46785,2,1,164018,164019,164020,1,2,0
46786,4,2,164022,164022,164024,0,2,2
46787,3,2,164025,164025,164027,0,2,1
46788,2,3,164027,164027,164030,0,3,0
46789,1,2,164028,164030,164032,2,4,0
46790,1,1,164029,164032,164033,3,4,0
46791,5,3,164034,164034,164037,0,3,1
46792,5,1,164039,164039,164040,0,1,2
46793,2,2,164041,164041,164043,0,2,1
46794,6,2,164047,164047,164049,0,2,4
46795,1,3,164048,164049,164052,1,4,0
46796,5,3,164053,164053,164056,0,3,1
46797,1,2,164054,164056,164058,2,4,0
46798,1,2,164055,164058,164060,3,5,0
46799,4,3,164059,164060,164063,1,4,0
46800,5,1,164064,164064,164065,0,1,1
46801,4,3,164068,164068,164071,0,3,3
46802,5,3,164073,164073,164076,0,3,2
46803,2,1,164075,164076,164077,1,2,0
46804,1,3,164076,164077,164080,1,4,0
46805,1,3,164077,164080,164083,3,6,0
46806,4,1,164081,164083,164084,2,3,0
46807,6,1,164087,164087,164088,0,1,3
46808,4,2,164091,164091,164093,0,2,3
46809,5,3,164096,164096,164099,0,3,3
46810,3,1,164099,164099,164100,0,1,0
46811,5,2,164104,164104,164106,0,2,4
46812,2,3,164106,164106,164109,0,3,0
46813,1,2,164107,164109,164111,2,4,0
46814,1,1,164108,164111,164112,3,4,0
46815,1,2,164109,164112,164114,3,5,0
46816,6,2,164115,164115,164117,0,2,1
46817,3,2,164118,164118,164120,0,2,1
46818,4,2,164122,164122,164124,0,2,2
46819,1,1,164123,164124,164125,1,2,0
46820,2,3,164125,164125,164128,0,3,0
46821,4,3,164129,164129,164132,0,3,1
46822,4,3,164133,164133,164136,0,3,1
46823,3,1,164136,164136,164137,0,1,0
46824,1,2,164137,164137,164139,0,2,0
46825,3,1,164140,164140,164141,0,1,1
46826,1,3,164141,164141,164144,0,3,0
46827,6,2,164147,164147,164149,0,2,3
46828,4,1,164151,164151,164152,0,1,2
46829,5,2,164156,164156,164158,0,2,4
46830,6,1,164162,164162,164163,0,1,4
46831,4,1,164166,164166,164167,0,1,3
46832,6,2,164172,164172,164174,0,2,5
46833,2,3,164174,164174,164177,0,3,0
46834,4,3,164178,164178,164181,0,3,1
46835,5,1,164183,164183,164184,0,1,2
46836,1,2,164184,164184,164186,0,2,0
46837,2,3,164186,164186,164189,0,3,0
46838,1,2,164187,164189,164191,2,4,0
46839,2,1,164189,164191,164192,2,3,0
46840,5,3,164194,164194,164197,0,3,2
46841,3,1,164197,164197,164198,0,1,0
46842,1,2,164198,164198,164200,0,2,0
46843,2,2,164200,164200,164202,0,2,0
46844,5,1,164205,164205,164206,0,1,3
46845,6,1,164211,164211,164212,0,1,5
46846,1,1,164212,164212,164213,0,1,0
46847,3,1,164215,164215,164216,0,1,2
46848,5,3,164220,164220,164223,0,3,4
46849,5,2,164225,164225,164227,0,2,2
46850,3,1,164228,164228,164229,0,1,1
46851,1,1,164229,164229,164230,0,1,0
46852,3,3,164232,164232,164235,0,3,2
46853,6,2,164238,164238,164240,0,2,3
46854,2,3,164240,164240,164243,0,3,0
46855,4,1,164244,164244,164245,0,1,1
46856,2,2,164246,164246,164248,0,2,1
46857,5,3,164251,164251,164254,0,3,3
46858,4,2,164255,164255,164257,0,2,1
46859,3,2,164258,164258,164260,0,2,1
46860,2,1,164260,164260,164261,0,1,0
46861,4,3,164264,164264,164267,0,3,3
46862,1,2,164265,164267,164269,2,4,0
46863,4,3,164269,164269,164272,0,3,0
46864,6,2,164275,164275,164277,0,2,3
46865,5,3,164280,164280,164283,0,3,3
46866,4,1,164284,164284,164285,0,1,1
46867,5,1,164289,164289,164290,0,1,4
46868,2,2,164291,164291,164293,0,2,1
46869,1,1,164292,164293,164294,1,2,0
46870,6,1,164298,164298,164299,0,1,4
46871,5,3,164303,164303,164306,0,3,4
46872,3,3,164306,164306,164309,0,3,0
46873,5,3,164311,164311,164314,0,3,2
46874,6,1,164317,164317,164318,0,1,3
46875,3,2,164320,164320,164322,0,2,2
46876,1,1,164321,164322,164323,1,2,0
46877,3,3,164324,164324,164327,0,3,1
46878,5,2,164329,164329,164331,0,2,2
46879,4,3,164333,164333,164336,0,3,2
46880,2,1,164335,164336,164337,1,2,0
46881,1,1,164336,164337,164338,1,2,0
46882,6,2,164342,164342,164344,0,2,4
46883,2,1,164344,164344,164345,0,1,0
46884,2,3,164346,164346,164349,0,3,1
46885,3,3,164349,164349,164352,0,3,0
46886,2,2,164351,164352,164354,1,3,0
46887,6,2,164357,164357,164359,0,2,3
46888,3,1,164360,164360,164361,0,1,1
46889,2,3,164362,164362,164365,0,3,1
46890,2,1,164364,164365,164366,1,2,0
46891,3,1,164367,164367,164368,0,1,1
46892,4,3,164371,164371,164374,0,3,3
46893,4,3,164375,164375,164378,0,3,1
46894,2,1,164377,164378,164379,1,2,0
46895,5,2,164382,164382,164384,0,2,3
46896,2,1,164384,164384,164385,0,1,0
46897,6,2,164390,164390,164392,0,2,5
46898,5,3,164395,164395,164398,0,3,3
46899,4,2,164399,164399,164401,0,2,1
46900,2,3,164401,164401,164404,0,3,0
46901,5,3,164406,164406,164409,0,3,2
46902,4,2,164410,164410,164412,0,2,1
46903,2,1,164412,164412,164413,0,1,0
46904,1,3,164413,164413,164416,0,3,0
46905,3,1,164416,164416,164417,0,1,0
46906,4,1,164420,164420,164421,0,1,3
46907,6,2,164426,164426,164428,0,2,5
46908,3,3,164429,164429,164432,0,3,1
46909,4,1,164433,164433,164434,0,1,1
46910,2,1,164435,164435,164436,0,1,1
46911,1,2,164436,164436,164438,0,2,0
46912,4,3,164440,164440,164443,0,3,2
46913,4,1,164444,164444,164445,0,1,1
46914,4,2,164448,164448,164450,0,2,3
46915,5,2,164453,164453,164455,0,2,3
46916,1,3,164454,164455,164458,1,4,0
46917,1,1,164455,164458,164459,3,4,0
46918,6,1,164461,164461,164462,0,1,2
46919,2,2,164463,164463,164465,0,2,1
46920,2,3,164465,164465,164468,0,3,0
46921,3,2,164468,164468,164470,0,2,0
46922,3,2,164471,164471,164473,0,2,1
46923,5,3,164476,164476,164479,0,3,3
46924,4,1,164480,164480,164481,0,1,1
46925,6,2,164486,164486,164488,0,2,5
46926,3,2,164489,164489,164491,0,2,1
46927,6,1,164495,164495,164496,0,1,4
46928,6,2,164501,164501,164503,0,2,5
46929,5,3,164506,164506,164509,0,3,3
46930,5,2,164511,164511,164513,0,2,2
46931,2,3,164513,164513,164516,0,3,0
46932,1,3,164514,164516,164519,2,5,0
46933,4,1,164518,164519,164520,1,2,0
46934,1,3,164519,164520,164523,1,4,0
46935,2,1,164521,164523,164524,2,3,0
46936,4,3,164525,164525,164528,0,3,1
46937,3,3,164528,164528,164531,0,3,0
46938,1,2,164529,164531,164533,2,4,0
46939,1,3,164530,164533,164536,3,6,0
46940,3,3,164533,164536,164539,3,6,0
46941,5,3,164538,164539,164542,1,4,0
46942,4,3,164542,164542,164545,0,3,0
46943,5,2,164547,164547,164549,0,2,2
46944,2,1,164549,164549,164550,0,1,0
46945,2,2,164551,164551,164553,0,2,1
46946,6,1,164557,164557,164558,0,1,4
46947,1,2,164558,164558,164560,0,2,0
46948,1,1,164559,164560,164561,1,2,0
46949,5,2,164564,164564,164566,0,2,3
46950,4,1,164568,164568,164569,0,1,2
46951,3,3,164571,164571,164574,0,3,2
46952,5,2,164576,164576,164578,0,2,2
46953,2,2,164578,164578,164580,0,2,0
46954,1,2,164579,164580,164582,1,3,0
46955,1,2,164580,164582,164584,2,4,0
46956,3,1,164583,164584,164585,1,2,0
46957,5,2,164588,164588,164590,0,2,3
46958,1,2,164589,164590,164592,1,3,0
46959,4,1,164593,164593,164594,0,1,1
46960,1,3,164594,164594,164597,0,3,0
46961,2,1,164596,164597,164598,1,2,0
46962,3,1,164599,164599,164600,0,1,1
46963,6,1,164605,164605,164606,0,1,5
46964,1,2,164606,164606,164608,0,2,0
46965,2,2,164608,164608,164610,0,2,0
46966,5,1,164613,164613,164614,0,1,3
46967,6,2,164619,164619,164621,0,2,5
46968,6,2,164625,164625,164627,0,2,4
46969,4,3,164629,164629,164632,0,3,2
46970,3,3,164632,164632,164635,0,3,0
46971,3,2,164635,164635,164637,0,2,0
46972,5,1,164640,164640,164641,0,1,3
46973,5,1,164645,164645,164646,0,1,4
46974,4,1,164649,164649,164650,0,1,3
46975,4,1,164653,164653,164654,0,1,3
46976,5,2,164658,164658,164660,0,2,4
46977,6,1,164664,164664,164665,0,1,4
46978,2,1,164666,164666,164667,0,1,1
46979,1,2,164667,164667,164669,0,2,0
46980,4,1,164671,164671,164672,0,1,2
46981,2,3,164673,164673,164676,0,3,1
46982,4,3,164677,164677,164680,0,3,1
46983,5,1,164682,164682,164683,0,1,2
46984,1,2,164683,164683,164685,0,2,0
46985,6,1,164689,164689,164690,0,1,4
46986,1,2,164690,164690,164692,0,2,0
46987,4,3,164694,164694,164697,0,3,2
46988,4,3,164698,164698,164701,0,3,1
46989,4,2,164702,164702,164704,0,2,1
46990,3,1,164705,164705,164706,0,1,1
46991,5,2,164710,164710,164712,0,2,4
46992,5,2,164715,164715,164717,0,2,3
46993,2,1,164717,164717,164718,0,1,0
46994,3,3,164720,164720,164723,0,3,2
46995,1,2,164721,164723,164725,2,4,0
46996,6,3,164727,164727,164730,0,3,2
46997,2,2,164729,164730,164732,1,3,0
46998,2,3,164731,164732,164735,1,4,0
46999,5,1,164736,164736,164737,0,1,1
47000,1,2,164737,164737,164739,0,2,0
47001,1,2,164738,164739,164741,1,3,0
47002,4,1,164742,164742,164743,0,1,1
47003,4,2,164746,164746,164748,0,2,3
47004,6,2,164752,164752,164754,0,2,4
47005,6,2,164758,164758,164760,0,2,4
47006,6,1,164764,164764,164765,0,1,4
47007,6,3,164770,164770,164773,0,3,5
47008,5,2,164775,164775,164777,0,2,2
47009,6,1,164781,164781,164782,0,1,4
47010,5,3,164786,164786,164789,0,3,4
47011,3,2,164789,164789,164791,0,2,0
47012,2,2,164791,164791,164793,0,2,0
47013,6,1,164797,164797,164798,0,1,4
47014,5,2,164802,164802,164804,0,2,4
47015,6,3,164808,164808,164811,0,3,4
47016,5,2,164813,164813,164815,0,2,2
47017,6,3,164819,164819,164822,0,3,4
47018,5,1,164824,164824,164825,0,1,2
47019,5,3,164829,164829,164832,0,3,4
47020,1,1,164830,164832,164833,2,3,0
47021,2,1,164832,164833,164834,1,2,0
47022,5,1,164837,164837,164838,0,1,3
47023,4,2,164841,164841,164843,0,2,3
47024,5,1,164846,164846,164847,0,1,3
47025,2,3,164848,164848,164851,0,3,1
47026,1,1,164849,164851,164852,2,3,0
47027,3,1,164852,164852,164853,0,1,0
47028,3,3,164855,164855,164858,0,3,2
47029,2,2,164857,164858,164860,1,3,0
47030,2,3,164859,164860,164863,1,4,0
47031,5,2,164864,164864,164866,0,2,1
47032,3,3,164867,164867,164870,0,3,1
47033,1,1,164868,164870,164871,2,3,0
47034,3,2,164871,164871,164873,0,2,0
47035,4,1,164875,164875,164876,0,1,2
47036,3,3,164878,164878,164881,0,3,2
47037,6,3,164884,164884,164887,0,3,3
47038,6,1,164890,164890,164891,0,1,3
47039,6,1,164896,164896,164897,0,1,5
47040,2,3,164898,164898,164901,0,3,1
47041,6,2,164904,164904,164906,0,2,3
47042,5,3,164909,164909,164912,0,3,3
47043,5,2,164914,164914,164916,0,2,2
47044,4,1,164918,164918,164919,0,1,2
47045,4,2,164922,164922,164924,0,2,3
47046,2,2,164924,164924,164926,0,2,0
47047,5,1,164929,164929,164930,0,1,3
47048,1,3,164930,164930,164933,0,3,0
47049,3,1,164933,164933,164934,0,1,0
47050,6,2,164939,164939,164941,0,2,5
47051,2,1,164941,164941,164942,0,1,0
47052,3,1,164944,164944,164945,0,1,2
47053,3,1,164947,164947,164948,0,1,2
47054,1,3,164948,164948,164951,0,3,0
47055,6,2,164954,164954,164956,0,2,3
47056,5,2,164959,164959,164961,0,2,3
47057,4,1,164963,164963,164964,0,1,2
47058,5,3,164968,164968,164971,0,3,4
47059,4,1,164972,164972,164973,0,1,1
47060,1,2,164973,164973,164975,0,2,0
47061,1,2,164974,164975,164977,1,3,0
47062,5,3,164979,164979,164982,0,3,2
47063,4,1,164983,164983,164984,0,1,1
47064,1,3,164984,164984,164987,0,3,0
47065,2,2,164986,164987,164989,1,3,0
47066,2,2,164988,164989,164991,1,3,0
47067,5,1,164993,164993,164994,0,1,2
47068,3,1,164996,164996,164997,0,1,2
47069,2,2,164998,164998,165000,0,2,1
47070,1,3,164999,165000,165003,1,4,0
47071,6,1,165005,165005,165006,0,1,2
47072,1,1,165006,165006,165007,0,1,0
47073,5,2,165011,165011,165013,0,2,4
47074,5,3,165016,165016,165019,0,3,3
47075,2,1,165018,165019,165020,1,2,0
47076,3,1,165021,165021,165022,0,1,1
47077,1,1,165022,165022,165023,0,1,0
47078,6,1,165028,165028,165029,0,1,5
47079,2,2,165030,165030,165032,0,2,1
47080,4,2,165034,165034,165036,0,2,2
47081,5,2,165039,165039,165041,0,2,3
47082,1,1,165040,165041,165042,1,2,0
47083,3,2,165043,165043,165045,0,2,1
47084,5,2,165048,165048,165050,0,2,3
47085,4,2,165052,165052,165054,0,2,2
47086,4,2,165056,165056,165058,0,2,2
47087,1,3,165057,165058,165061,1,4,0
47088,5,1,165062,165062,165063,0,1,1
47089,3,1,165065,165065,165066,0,1,2
47090,4,2,165069,165069,165071,0,2,3
47091,2,1,165071,165071,165072,0,1,0
47092,1,1,165072,165072,165073,0,1,0
47093,3,1,165075,165075,165076,0,1,2
47094,2,3,165077,165077,165080,0,3,1
47095,3,2,165080,165080,165082,0,2,0
47096,5,3,165085,165085,165088,0,3,3
47097,4,1,165089,165089,165090,0,1,1
47098,1,1,165090,165090,165091,0,1,0
47099,1,3,165091,165091,165094,0,3,0
47100,5,3,165096,165096,165099,0,3,2
47101,3,1,165099,165099,165100,0,1,0
47102,1,1,165100,165100,165101,0,1,0
47103,6,1,165106,165106,165107,0,1,5
47104,4,3,165110,165110,165113,0,3,3
47105,3,2,165113,165113,165115,0,2,0
47106,5,1,165118,165118,165119,0,1,3
47107,1,2,165119,165119,165121,0,2,0
47108,1,2,165120,165121,165123,1,3,0
47109,2,2,165122,165123,165125,1,3,0
47110,5,1,165127,165127,165128,0,1,2
47111,6,2,165133,165133,165135,0,2,5
47112,5,2,165138,165138,165140,0,2,3
47113,2,2,165140,165140,165142,0,2,0
47114,3,3,165143,165143,165146,0,3,1
47115,2,1,165145,165146,165147,1,2,0
47116,6,1,165151,165151,165152,0,1,4
47117,6,1,165157,165157,165158,0,1,5
47118,4,1,165161,165161,165162,0,1,3
47119,6,3,165167,165167,165170,0,3,5
47120,1,3,165168,165170,165173,2,5,0
47121,1,1,165169,165173,165174,4,5,0
47122,3,2,165172,165174,165176,2,4,0
47123,5,3,165177,165177,165180,0,3,1
47124,5,2,165182,165182,165184,0,2,2
47125,4,3,165186,165186,165189,0,3,2
47126,5,2,165191,165191,165193,0,2,2
47127,3,3,165194,165194,165197,0,3,1
47128,6,3,165200,165200,165203,0,3,3
47129,1,2,165201,165203,165205,2,4,0
47130,2,1,165203,165205,165206,2,3,0
47131,2,2,165205,165206,165208,1,3,0
47132,6,1,165211,165211,165212,0,1,3
47133,5,1,165216,165216,165217,0,1,4
47134,6,1,165222,165222,165223,0,1,5
47135,4,3,165226,165226,165229,0,3,3
47136,4,1,165230,165230,165231,0,1,1
47137,5,2,165235,165235,165237,0,2,4
47138,5,3,165240,165240,165243,0,3,3
47139,6,3,165246,165246,165249,0,3,3
47140,1,2,165247,165249,165251,2,4,0
47141,6,3,165253,165253,165256,0,3,2
47142,2,1,165255,165256,165257,1,2,0
47143,4,3,165259,165259,165262,0,3,2
47144,5,1,165264,165264,165265,0,1,2
47145,1,2,165265,165265,165267,0,2,0
47146,2,1,165267,165267,165268,0,1,0
47147,5,1,165272,165272,165273,0,1,4
47148,1,3,165273,165273,165276,0,3,0
47149,6,2,165279,165279,165281,0,2,3
47150,1,2,165280,165281,165283,1,3,0
47151,5,2,165285,165285,165287,0,2,2
47152,4,2,165289,165289,165291,0,2,2
47153,5,1,165294,165294,165295,0,1,3
47154,6,3,165300,165300,165303,0,3,5
47155,5,2,165305,165305,165307,0,2,2
47156,1,2,165306,165307,165309,1,3,0
47157,2,1,165308,165309,165310,1,2,0
47158,1,3,165309,165310,165313,1,4,0
47159,3,1,165312,165313,165314,1,2,0
47160,4,2,165316,165316,165318,0,2,2
47161,2,2,165318,165318,165320,0,2,0
47162,2,2,165320,165320,165322,0,2,0
47163,5,2,165325,165325,165327,0,2,3
47164,2,3,165327,165327,165330,0,3,0
47165,3,1,165330,165330,165331,0,1,0
47166,5,3,165335,165335,165338,0,3,4
47167,5,1,165340,165340,165341,0,1,2
47168,1,3,165341,165341,165344,0,3,0
47169,6,3,165347,165347,165350,0,3,3
47170,6,3,165353,165353,165356,0,3,3
47171,5,3,165358,165358,165361,0,3,2
47172,1,3,165359,165361,165364,2,5,0
47173,6,1,165365,165365,165366,0,1,1
47174,1,3,165366,165366,165369,0,3,0
47175,1,2,165367,165369,165371,2,4,0
47176,1,1,165368,165371,165372,3,4,0
47177,2,1,165370,165372,165373,2,3,0
47178,1,1,165371,165373,165374,2,3,0
47179,2,1,165373,165374,165375,1,2,0
47180,3,1,165376,165376,165377,0,1,1
47181,5,1,165381,165381,165382,0,1,4
47182,6,1,165387,165387,165388,0,1,5
47183,3,1,165390,165390,165391,0,1,2
47184,2,3,165392,165392,165395,0,3,1
47185,4,1,165396,165396,165397,0,1,1
47186,6,3,165402,165402,165405,0,3,5
47187,3,3,165405,165405,165408,0,3,0
47188,5,3,165410,165410,165413,0,3,2
47189,4,1,165414,165414,165415,0,1,1
47190,1,1,165415,165415,165416,0,1,0
47191,3,2,165418,165418,165420,0,2,2
47192,2,1,165420,165420,165421,0,1,0
47193,6,3,165426,165426,165429,0,3,5
47194,4,2,165430,165430,165432,0,2,1
47195,4,3,165434,165434,165437,0,3,2
47196,4,1,165438,165438,165439,0,1,1
47197,1,1,165439,165439,165440,0,1,0
47198,5,2,165444,165444,165446,0,2,4
47199,2,3,165446,165446,165449,0,3,0
47200,3,2,165449,165449,165451,0,2,0
47201,2,2,165451,165451,165453,0,2,0
47202,3,1,165454,165454,165455,0,1,1
47203,6,1,165460,165460,165461,0,1,5
47204,4,3,165464,165464,165467,0,3,3
47205,4,3,165468,165468,165471,0,3,1
47206,5,2,165473,165473,165475,0,2,2
47207,3,1,165476,165476,165477,0,1,1
47208,2,3,165478,165478,165481,0,3,1
47209,2,3,165480,165481,165484,1,4,0
47210,4,1,165484,165484,165485,0,1,0
47211,5,3,165489,165489,165492,0,3,4
47212,3,2,165492,165492,165494,0,2,0
47213,3,1,165495,165495,165496,0,1,1
47214,2,3,165497,165497,165500,0,3,1
47215,2,2,165499,165500,165502,1,3,0
47216,1,2,165500,165502,165504,2,4,0
47217,6,1,165506,165506,165507,0,1,2
47218,4,3,165510,165510,165513,0,3,3
47219,3,3,165513,165513,165516,0,3,0
47220,2,3,165515,165516,165519,1,4,0
47221,4,1,165519,165519,165520,0,1,0
47222,4,1,165523,165523,165524,0,1,3
47223,4,2,165527,165527,165529,0,2,3
47224,6,2,165533,165533,165535,0,2,4
47225,6,1,165539,165539,165540,0,1,4
47226,2,3,165541,165541,165544,0,3,1
47227,1,1,165542,165544,165545,2,3,0
47228,5,1,165547,165547,165548,0,1,2
47229,2,2,165549,165549,165551,0,2,1
47230,3,2,165552,165552,165554,0,2,1
47231,1,1,165553,165554,165555,1,2,0
47232,3,3,165556,165556,165559,0,3,1
47233,5,1,165561,165561,165562,0,1,2
47234,5,2,165566,165566,165568,0,2,4
47235,5,3,165571,165571,165574,0,3,3
47236,3,3,165574,165574,165577,0,3,0
47237,1,1,165575,165577,165578,2,3,0
47238,2,2,165577,165578,165580,1,3,0
47239,3,1,165580,165580,165581,0,1,0
47240,6,2,165586,165586,165588,0,2,5
47241,4,3,165590,165590,165593,0,3,2
47242,1,1,165591,165593,165594,2,3,0
47243,4,1,165595,165595,165596,0,1,1
47244,4,3,165599,165599,165602,0,3,3
47245,6,1,165605,165605,165606,0,1,3
47246,6,1,165611,165611,165612,0,1,5
47247,6,1,165617,165617,165618,0,1,5
47248,1,3,165618,165618,165621,0,3,0
47249,3,2,165621,165621,165623,0,2,0
47250,2,3,165623,165623,165626,0,3,0
47251,2,2,165625,165626,165628,1,3,0
47252,1,2,165626,165628,165630,2,4,0
47253,6,2,165632,165632,165634,0,2,2
47254,2,2,165634,165634,165636,0,2,0
47255,1,2,165635,165636,165638,1,3,0
47256,3,2,165638,165638,165640,0,2,0
47257,6,2,165644,165644,165646,0,2,4
47258,2,2,165646,165646,165648,0,2,0
47259,1,3,165647,165648,165651,1,4,0
47260,2,2,165649,165651,165653,2,4,0
47261,5,3,165654,165654,165657,0,3,1
47262,6,3,165660,165660,165663,0,3,3
47263,1,3,165661,165663,165666,2,5,0
47264,5,1,165666,165666,165667,0,1,0
47265,2,1,165668,165668,165669,0,1,1
47266,4,3,165672,165672,165675,0,3,3
47267,4,3,165676,165676,165679,0,3,1
47268,3,3,165679,165679,165682,0,3,0
47269,5,2,165684,165684,165686,0,2,2
47270,1,3,165685,165686,165689,1,4,0
47271,6,2,165691,165691,165693,0,2,2
47272,6,1,165697,165697,165698,0,1,4
47273,3,3,165700,165700,165703,0,3,2
47274,6,2,165706,165706,165708,0,2,3
47275,5,3,165711,165711,165714,0,3,3
47276,2,1,165713,165714,165715,1,2,0
47277,4,2,165717,165717,165719,0,2,2
47278,1,2,165718,165719,165721,1,3,0
47279,3,1,165721,165721,165722,0,1,0
47280,1,3,165722,165722,165725,0,3,0
47281,3,2,165725,165725,165727,0,2,0
47282,5,1,165730,165730,165731,0,1,3
47283,1,2,165731,165731,165733,0,2,0
47284,2,1,165733,165733,165734,0,1,0
47285,4,1,165737,165737,165738,0,1,3
47286,6,3,165743,165743,165746,0,3,5
47287,3,2,165746,165746,165748,0,2,0
47288,4,1,165750,165750,165751,0,1,2
47289,3,1,165753,165753,165754,0,1,2
47290,5,1,165758,165758,165759,0,1,4
47291,2,2,165760,165760,165762,0,2,1
47292,3,3,165763,165763,165766,0,3,1
47293,5,3,165768,165768,165771,0,3,2
47294,4,3,165772,165772,165775,0,3,1
47295,4,1,165776,165776,165777,0,1,1
47296,1,1,165777,165777,165778,0,1,0
47297,1,1,165778,165778,165779,0,1,0
47298,4,2,165782,165782,165784,0,2,3
47299,3,2,165785,165785,165787,0,2,1
47300,2,2,165787,165787,165789,0,2,0
47301,6,3,165793,165793,165796,0,3,4
47302,2,3,165795,165796,165799,1,4,0
47303,1,2,165796,165799,165801,3,5,0
47304,4,1,165800,165801,165802,1,2,0
47305,1,2,165801,165802,165804,1,3,0
47306,3,1,165804,165804,165805,0,1,0
47307,3,2,165807,165807,165809,0,2,2
47308,5,1,165812,165812,165813,0,1,3
47309,4,3,165816,165816,165819,0,3,3
47310,3,3,165819,165819,165822,0,3,0
47311,1,3,165820,165822,165825,2,5,0
47312,6,1,165826,165826,165827,0,1,1
47313,1,2,165827,165827,165829,0,2,0
47314,2,2,165829,165829,165831,0,2,0
47315,5,3,165834,165834,165837,0,3,3
47316,6,1,165840,165840,165841,0,1,3
47317,5,2,165845,165845,165847,0,2,4
47318,6,1,165851,165851,165852,0,1,4
47319,4,2,165855,165855,165857,0,2,3
47320,3,2,165858,165858,165860,0,2,1
47321,2,2,165860,165860,165862,0,2,0
47322,2,3,165862,165862,165865,0,3,0
47323,3,1,165865,165865,165866,0,1,0
47324,3,1,165868,165868,165869,0,1,2
47325,4,2,165872,165872,165874,0,2,3
47326,2,2,165874,165874,165876,0,2,0
47327,5,2,165879,165879,165881,0,2,3
47328,6,2,165885,165885,165887,0,2,4
47329,1,2,165886,165887,165889,1,3,0
47330,2,1,165888,165889,165890,1,2,0
47331,3,3,165891,165891,165894,0,3,1
47332,2,2,165893,165894,165896,1,3,0
47333,3,3,165896,165896,165899,0,3,0
47334,1,1,165897,165899,165900,2,3,0
47335,5,3,165902,165902,165905,0,3,2
47336,4,3,165906,165906,165909,0,3,1
47337,4,2,165910,165910,165912,0,2,1
47338,5,1,165915,165915,165916,0,1,3
47339,1,2,165916,165916,165918,0,2,0
47340,6,1,165922,165922,165923,0,1,4
47341,2,1,165924,165924,165925,0,1,1
47342,5,3,165929,165929,165932,0,3,4
47343,1,2,165930,165932,165934,2,4,0
47344,4,2,165934,165934,165936,0,2,0
47345,6,2,165940,165940,165942,0,2,4
47346,2,2,165942,165942,165944,0,2,0
47347,1,1,165943,165944,165945,1,2,0
47348,6,2,165949,165949,165951,0,2,4
47349,5,3,165954,165954,165957,0,3,3
47350,5,3,165959,165959,165962,0,3,2
47351,4,2,165963,165963,165965,0,2,1
47352,2,3,165965,165965,165968,0,3,0
47353,2,3,165967,165968,165971,1,4,0
47354,3,1,165970,165971,165972,1,2,0
47355,3,2,165973,165973,165975,0,2,1
47356,2,2,165975,165975,165977,0,2,0
47357,6,1,165981,165981,165982,0,1,4
47358,5,3,165986,165986,165989,0,3,4
47359,3,2,165989,165989,165991,0,2,0
47360,1,2,165990,165991,165993,1,3,0
47361,1,3,165991,165993,165996,2,5,0
47362,2,3,165993,165996,165999,3,6,0
47363,2,3,165995,165999,166002,4,7,0
47364,2,2,165997,166002,166004,5,7,0
47365,5,3,166002,166004,166007,2,5,0
47366,4,1,166006,166007,166008,1,2,0
47367,6,3,166012,166012,166015,0,3,4
47368,4,3,166016,166016,166019,0,3,1
47369,4,1,166020,166020,166021,0,1,1
47370,4,2,166024,166024,166026,0,2,3
47371,6,2,166030,166030,166032,0,2,4
47372,5,3,166035,166035,166038,0,3,3
47373,5,3,166040,166040,166043,0,3,2
47374,1,2,166041,166043,166045,2,4,0
47375,2,3,166043,166045,166048,2,5,0
47376,1,3,166044,166048,166051,4,7,0
47377,6,1,166050,166051,166052,1,2,0
47378,3,3,166053,166053,166056,0,3,1
47379,3,1,166056,166056,166057,0,1,0
47380,3,2,166059,166059,166061,0,2,2
47381,3,3,166062,166062,166065,0,3,1
47382,1,2,166063,166065,166067,2,4,0
47383,6,3,166069,166069,166072,0,3,2
47384,1,3,166070,166072,166075,2,5,0
47385,2,3,166072,166075,166078,3,6,0
47386,1,3,166073,166078,166081,5,8,0
47387,3,2,166076,166081,166083,5,7,0
47388,6,3,166082,166083,166086,1,4,0
47389,1,1,166083,166086,166087,3,4,0
47390,2,1,166085,166087,166088,2,3,0
47391,6,1,166091,166091,166092,0,1,3
47392,3,2,166094,166094,166096,0,2,2
47393,5,2,166099,166099,166101,0,2,3
47394,3,1,166102,166102,166103,0,1,1
47395,3,2,166105,166105,166107,0,2,2
47396,1,2,166106,166107,166109,1,3,0
47397,4,3,166110,166110,166113,0,3,1
47398,4,3,166114,166114,166117,0,3,1
47399,3,3,166117,166117,166120,0,3,0
47400,4,2,166121,166121,166123,0,2,1
47401,5,2,166126,166126,166128,0,2,3
47402,1,1,166127,166128,166129,1,2,0
47403,4,3,166131,166131,166134,0,3,2
47404,3,1,166134,166134,166135,0,1,0
47405,6,1,166140,166140,166141,0,1,5
47406,6,3,166146,166146,166149,0,3,5
47407,1,2,166147,166149,166151,2,4,0
47408,5,3,166152,166152,166155,0,3,1
47409,6,2,166158,166158,166160,0,2,3
47410,2,1,166160,166160,166161,0,1,0
47411,1,1,166161,166161,166162,0,1,0
47412,1,3,166162,166162,166165,0,3,0
47413,2,2,166164,166165,166167,1,3,0
47414,3,3,166167,166167,166170,0,3,0
47415,6,2,166173,166173,166175,0,2,3
47416,4,2,166177,166177,166179,0,2,2
47417,2,3,166179,166179,166182,0,3,0
47418,1,1,166180,166182,166183,2,3,0
47419,4,1,166184,166184,166185,0,1,1
47420,2,2,166186,166186,166188,0,2,1
47421,3,3,166189,166189,166192,0,3,1
47422,5,2,166194,166194,166196,0,2,2
47423,1,3,166195,166196,166199,1,4,0
47424,6,1,166201,166201,166202,0,1,2
47425,2,2,166203,166203,166205,0,2,1
47426,1,1,166204,166205,166206,1,2,0
47427,4,2,166208,166208,166210,0,2,2
47428,6,1,166214,166214,166215,0,1,4
47429,1,2,166215,166215,166217,0,2,0
47430,1,1,166216,166217,166218,1,2,0
47431,1,1,166217,166218,166219,1,2,0
47432,6,2,166223,166223,166225,0,2,4
47433,6,3,166229,166229,166232,0,3,4
47434,6,2,166235,166235,166237,0,2,3
47435,1,3,166236,166237,166240,1,4,0
47436,2,2,166238,166240,166242,2,4,0
47437,2,3,166240,166242,166245,2,5,0
47438,3,2,166243,166245,166247,2,4,0
47439,4,1,166247,166247,166248,0,1,0
47440,5,1,166252,166252,166253,0,1,4
47441,5,3,166257,166257,166260,0,3,4
47442,4,2,166261,166261,166263,0,2,1
47443,5,2,166266,166266,166268,0,2,3
47444,3,1,166269,166269,166270,0,1,1
47445,1,3,166270,166270,166273,0,3,0
47446,6,3,166276,166276,166279,0,3,3
47447,5,3,166281,166281,166284,0,3,2
47448,2,2,166283,166284,166286,1,3,0
47449,3,1,166286,166286,166287,0,1,0
47450,2,3,166288,166288,166291,0,3,1
47451,4,2,166292,166292,166294,0,2,1
47452,4,2,166296,166296,166298,0,2,2
47453,2,2,166298,166298,166300,0,2,0
47454,4,3,166302,166302,166305,0,3,2
47455,4,1,166306,166306,166307,0,1,1
47456,5,3,166311,166311,166314,0,3,4
47457,3,1,166314,166314,166315,0,1,0
47458,3,3,166317,166317,166320,0,3,2
47459,1,2,166318,166320,166322,2,4,0
47460,4,3,166322,166322,166325,0,3,0
47461,6,1,166328,166328,166329,0,1,3
47462,3,2,166331,166331,166333,0,2,2
47463,3,1,166334,166334,166335,0,1,1
47464,2,1,166336,166336,166337,0,1,1
47465,4,1,166340,166340,166341,0,1,3
47466,2,3,166342,166342,166345,0,3,1
47467,3,1,166345,166345,166346,0,1,0
47468,1,2,166346,166346,166348,0,2,0
47469,4,1,166350,166350,166351,0,1,2
47470,6,2,166356,166356,166358,0,2,5
47471,4,3,166360,166360,166363,0,3,2
47472,5,1,166365,166365,166366,0,1,2
47473,5,3,166370,166370,166373,0,3,4
47474,5,2,166375,166375,166377,0,2,2
47475,1,1,166376,166377,166378,1,2,0
47476,6,1,166382,166382,166383,0,1,4
47477,6,3,166388,166388,166391,0,3,5
47478,4,3,166392,166392,166395,0,3,1
47479,4,2,166396,166396,166398,0,2,1
47480,6,1,166402,166402,166403,0,1,4
47481,6,3,166408,166408,166411,0,3,5
47482,3,1,166411,166411,166412,0,1,0
47483,1,1,166412,166412,166413,0,1,0
47484,4,2,166416,166416,166418,0,2,3
47485,6,2,166422,166422,166424,0,2,4
47486,6,3,166428,166428,166431,0,3,4
47487,6,2,166434,166434,166436,0,2,3
47488,6,2,166440,166440,166442,0,2,4
47489,5,3,166445,166445,166448,0,3,3
47490,1,1,166446,166448,166449,2,3,0
47491,5,1,166451,166451,166452,0,1,2
47492,1,2,166452,166452,166454,0,2,0
47493,2,3,166454,166454,166457,0,3,0
47494,4,2,166458,166458,166460,0,2,1
47495,4,2,166462,166462,166464,0,2,2
47496,1,3,166463,166464,166467,1,4,0
47497,6,2,166469,166469,166471,0,2,2
47498,2,2,166471,166471,166473,0,2,0
47499,6,2,166477,166477,166479,0,2,4
47500,3,3,166480,166480,166483,0,3,1
47501,3,2,166483,166483,166485,0,2,0
47502,6,2,166489,166489,166491,0,2,4
47503,4,2,166493,166493,166495,0,2,2
47504,3,1,166496,166496,166497,0,1,1
47505,6,1,166502,166502,166503,0,1,5
47506,5,3,166507,166507,166510,0,3,4
47507,6,1,166513,166513,166514,0,1,3
47508,2,2,166515,166515,166517,0,2,1
47509,3,2,166518,166518,166520,0,2,1
47510,1,1,166519,166520,166521,1,2,0
47511,6,2,166525,166525,166527,0,2,4
47512,1,2,166526,166527,166529,1,3,0
47513,2,2,166528,166529,166531,1,3,0
47514,2,3,166530,166531,166534,1,4,0
47515,6,3,166536,166536,166539,0,3,2
47516,4,3,166540,166540,166543,0,3,1
47517,1,2,166541,166543,166545,2,4,0
47518,2,1,166543,166545,166546,2,3,0
47519,3,3,166546,166546,166549,0,3,0
47520,3,2,166549,166549,166551,0,2,0
47521,4,1,166553,166553,166554,0,1,2
47522,2,2,166555,166555,166557,0,2,1
47523,2,1,166557,166557,166558,0,1,0
47524,6,3,166563,166563,166566,0,3,5
47525,5,1,166568,166568,166569,0,1,2
47526,5,2,166573,166573,166575,0,2,4
47527,2,1,166575,166575,166576,0,1,0
47528,4,2,166579,166579,166581,0,2,3
47529,2,2,166581,166581,166583,0,2,0
47530,4,3,166585,166585,166588,0,3,2
47531,1,3,166586,166588,166591,2,5,0
47532,5,1,166591,166591,166592,0,1,0
47533,5,3,166596,166596,166599,0,3,4
47534,1,3,166597,166599,166602,2,5,0
47535,2,1,166599,166602,166603,3,4,0
47536,4,2,166603,166603,166605,0,2,0
47537,3,1,166606,166606,166607,0,1,1
47538,5,1,166611,166611,166612,0,1,4
47539,1,3,166612,166612,166615,0,3,0
47540,4,1,166616,166616,166617,0,1,1
47541,3,1,166619,166619,166620,0,1,2
47542,6,3,166625,166625,166628,0,3,5
47543,4,3,166629,166629,166632,0,3,1
47544,1,3,166630,166632,166635,2,5,0
47545,5,2,166635,166635,166637,0,2,0
47546,2,1,166637,166637,166638,0,1,0
47547,1,3,166638,166638,166641,0,3,0
47548,4,1,166642,166642,166643,0,1,1
47549,1,3,166643,166643,166646,0,3,0
47550,1,1,166644,166646,166647,2,3,0
47551,4,1,166648,166648,166649,0,1,1
47552,3,1,166651,166651,166652,0,1,2
47553,3,1,166654,166654,166655,0,1,2
47554,5,3,166659,166659,166662,0,3,4
47555,6,3,166665,166665,166668,0,3,3
47556,4,3,166669,166669,166672,0,3,1
47557,1,2,166670,166672,166674,2,4,0
47558,6,2,166676,166676,166678,0,2,2
47559,5,3,166681,166681,166684,0,3,3
47560,2,3,166683,166684,166687,1,4,0
47561,3,2,166686,166687,166689,1,3,0
47562,1,1,166687,166689,166690,2,3,0
47563,5,2,166692,166692,166694,0,2,2
47564,5,2,166697,166697,166699,0,2,3
47565,6,3,166703,166703,166706,0,3,4
47566,5,2,166708,166708,166710,0,2,2
47567,5,1,166713,166713,166714,0,1,3
47568,6,3,166719,166719,166722,0,3,5
47569,4,2,166723,166723,166725,0,2,1
47570,4,3,166727,166727,166730,0,3,2
47571,2,3,166729,166730,166733,1,4,0
47572,2,3,166731,166733,166736,2,5,0
47573,3,3,166734,166736,166739,2,5,0
47574,4,1,166738,166739,166740,1,2,0
47575,3,1,166741,166741,166742,0,1,1
47576,6,3,166747,166747,166750,0,3,5
47577,6,2,166753,166753,166755,0,2,3
47578,5,2,166758,166758,166760,0,2,3
47579,2,1,166760,166760,166761,0,1,0
47580,4,1,166764,166764,166765,0,1,3
47581,1,2,166765,166765,166767,0,2,0
47582,2,1,166767,166767,166768,0,1,0
47583,5,2,166772,166772,166774,0,2,4
47584,1,1,166773,166774,166775,1,2,0
47585,4,1,166777,166777,166778,0,1,2
47586,3,2,166780,166780,166782,0,2,2
47587,2,1,166782,166782,166783,0,1,0
47588,4,2,166786,166786,166788,0,2,3
47589,4,2,166790,166790,166792,0,2,2
47590,6,2,166796,166796,166798,0,2,4
47591,1,2,166797,166798,166800,1,3,0
47592,3,1,166800,166800,166801,0,1,0
47593,5,1,166805,166805,166806,0,1,4
47594,3,1,166808,166808,166809,0,1,2
47595,2,3,166810,166810,166813,0,3,1
47596,3,1,166813,166813,166814,0,1,0
47597,5,3,166818,166818,166821,0,3,4
47598,5,2,166823,166823,166825,0,2,2
47599,3,3,166826,166826,166829,0,3,1
47600,2,1,166828,166829,166830,1,2,0
47601,4,3,166832,166832,166835,0,3,2
47602,5,3,166837,166837,166840,0,3,2
47603,1,3,166838,166840,166843,2,5,0
47604,1,2,166839,166843,166845,4,6,0
47605,1,1,166840,166845,166846,5,6,0
47606,2,2,166842,166846,166848,4,6,0
47607,2,1,166844,166848,166849,4,5,0
47608,3,3,166847,166849,166852,2,5,0
47609,2,1,166849,166852,166853,3,4,0
47610,2,2,166851,166853,166855,2,4,0
47611,4,2,166855,166855,166857,0,2,0
47612,1,1,166856,166857,166858,1,2,0
47613,2,2,166858,166858,166860,0,2,0
47614,3,1,166861,166861,166862,0,1,1
47615,4,1,166865,166865,166866,0,1,3
47616,1,2,166866,166866,166868,0,2,0
47617,6,2,166872,166872,166874,0,2,4
47618,4,3,166876,166876,166879,0,3,2
47619,1,1,166877,166879,166880,2,3,0
47620,5,3,166882,166882,166885,0,3,2
47621,6,3,166888,166888,166891,0,3,3
47622,5,3,166893,166893,166896,0,3,2
47623,4,2,166897,166897,166899,0,2,1
47624,3,2,166900,166900,166902,0,2,1
47625,5,2,166905,166905,166907,0,2,3
47626,1,2,166906,166907,166909,1,3,0
47627,1,3,166907,166909,166912,2,5,0
47628,3,3,166910,166912,166915,2,5,0
47629,5,2,166915,166915,166917,0,2,0
47630,4,2,166919,166919,166921,0,2,2
47631,3,1,166922,166922,166923,0,1,1
47632,5,2,166927,166927,166929,0,2,4
47633,4,3,166931,166931,166934,0,3,2
47634,4,2,166935,166935,166937,0,2,1
47635,5,2,166940,166940,166942,0,2,3
47636,3,2,166943,166943,166945,0,2,1
47637,2,1,166945,166945,166946,0,1,0
47638,6,3,166951,166951,166954,0,3,5
47639,2,1,166953,166954,166955,1,2,0
47640,6,2,166959,166959,166961,0,2,4
47641,2,3,166961,166961,166964,0,3,0
47642,6,3,166967,166967,166970,0,3,3
47643,5,2,166972,166972,166974,0,2,2
47644,4,1,166976,166976,166977,0,1,2
47645,4,1,166980,166980,166981,0,1,3
47646,2,1,166982,166982,166983,0,1,1
47647,2,3,166984,166984,166987,0,3,1
47648,1,1,166985,166987,166988,2,3,0
47649,5,1,166990,166990,166991,0,1,2
47650,2,3,166992,166992,166995,0,3,1
47651,4,2,166996,166996,166998,0,2,1
47652,5,2,167001,167001,167003,0,2,3
47653,6,1,167007,167007,167008,0,1,4
47654,4,1,167011,167011,167012,0,1,3
47655,4,2,167015,167015,167017,0,2,3
47656,2,3,167017,167017,167020,0,3,0
47657,2,3,167019,167020,167023,1,4,0
47658,6,2,167025,167025,167027,0,2,2
47659,4,1,167029,167029,167030,0,1,2
47660,4,1,167033,167033,167034,0,1,3
47661,4,3,167037,167037,167040,0,3,3
47662,1,2,167038,167040,167042,2,4,0
47663,1,1,167039,167042,167043,3,4,0
47664,3,1,167042,167043,167044,1,2,0
47665,3,2,167045,167045,167047,0,2,1
47666,6,3,167051,167051,167054,0,3,4
47667,4,2,167055,167055,167057,0,2,1
47668,2,3,167057,167057,167060,0,3,0
47669,5,2,167062,167062,167064,0,2,2
47670,2,3,167064,167064,167067,0,3,0
47671,5,2,167069,167069,167071,0,2,2
47672,4,3,167073,167073,167076,0,3,2
47673,6,2,167079,167079,167081,0,2,3
47674,1,1,167080,167081,167082,1,2,0
47675,4,1,167084,167084,167085,0,1,2
47676,1,3,167085,167085,167088,0,3,0
47677,1,1,167086,167088,167089,2,3,0
47678,4,2,167090,167090,167092,0,2,1
47679,4,2,167094,167094,167096,0,2,2
47680,5,2,167099,167099,167101,0,2,3
47681,4,1,167103,167103,167104,0,1,2
47682,2,1,167105,167105,167106,0,1,1
47683,2,2,167107,167107,167109,0,2,1
47684,3,3,167110,167110,167113,0,3,1
47685,4,3,167114,167114,167117,0,3,1
47686,4,2,167118,167118,167120,0,2,1
47687,3,2,167121,167121,167123,0,2,1
47688,1,2,167122,167123,167125,1,3,0
47689,4,2,167126,167126,167128,0,2,1
47690,3,1,167129,167129,167130,0,1,1
47691,2,1,167131,167131,167132,0,1,1
47692,4,3,167135,167135,167138,0,3,3
47693,4,2,167139,167139,167141,0,2,1
47694,4,1,167143,167143,167144,0,1,2
47695,4,3,167147,167147,167150,0,3,3
47696,2,2,167149,167150,167152,1,3,0
47697,6,3,167155,167155,167158,0,3,3
47698,6,3,167161,167161,167164,0,3,3
47699,2,1,167163,167164,167165,1,2,0
47700,3,3,167166,167166,167169,0,3,1
47701,4,2,167170,167170,167172,0,2,1
47702,6,2,167176,167176,167178,0,2,4
47703,5,1,167181,167181,167182,0,1,3
47704,2,2,167183,167183,167185,0,2,1
47705,3,2,167186,167186,167188,0,2,1
47706,5,3,167191,167191,167194,0,3,3
47707,5,1,167196,167196,167197,0,1,2
47708,1,1,167197,167197,167198,0,1,0
47709,1,3,167198,167198,167201,0,3,0
47710,2,3,167200,167201,167204,1,4,0
47711,4,2,167204,167204,167206,0,2,0
47712,6,1,167210,167210,167211,0,1,4
47713,2,2,167212,167212,167214,0,2,1
47714,1,2,167213,167214,167216,1,3,0
47715,4,1,167217,167217,167218,0,1,1
47716,5,2,167222,167222,167224,0,2,4
47717,2,1,167224,167224,167225,0,1,0
47718,1,2,167225,167225,167227,0,2,0
47719,5,2,167230,167230,167232,0,2,3
47720,4,3,167234,167234,167237,0,3,2
47721,4,3,167238,167238,167241,0,3,1
47722,3,3,167241,167241,167244,0,3,0
47723,3,3,167244,167244,167247,0,3,0
47724,4,1,167248,167248,167249,0,1,1
47725,2,1,167250,167250,167251,0,1,1
47726,6,3,167256,167256,167259,0,3,5
47727,5,3,167261,167261,167264,0,3,2
47728,1,3,167262,167264,167267,2,5,0
47729,3,3,167265,167267,167270,2,5,0
47730,3,2,167268,167270,167272,2,4,0
47731,3,3,167271,167272,167275,1,4,0
47732,6,3,167277,167277,167280,0,3,2
47733,6,1,167283,167283,167284,0,1,3
47734,5,3,167288,167288,167291,0,3,4
47735,5,3,167293,167293,167296,0,3,2
47736,1,3,167294,167296,167299,2,5,0
47737,2,2,167296,167299,167301,3,5,0
47738,4,3,167300,167301,167304,1,4,0
47739,4,1,167304,167304,167305,0,1,0
47740,6,2,167310,167310,167312,0,2,5
47741,1,1,167311,167312,167313,1,2,0
47742,2,1,167313,167313,167314,0,1,0
47743,4,3,167317,167317,167320,0,3,3
47744,6,3,167323,167323,167326,0,3,3
47745,2,1,167325,167326,167327,1,2,0
47746,3,2,167328,167328,167330,0,2,1
47747,5,3,167333,167333,167336,0,3,3
47748,1,2,167334,167336,167338,2,4,0
47749,4,1,167338,167338,167339,0,1,0
47750,5,1,167343,167343,167344,0,1,4
47751,1,3,167344,167344,167347,0,3,0
47752,3,3,167347,167347,167350,0,3,0
47753,2,3,167349,167350,167353,1,4,0
47754,2,1,167351,167353,167354,2,3,0
47755,3,2,167354,167354,167356,0,2,0
47756,4,3,167358,167358,167361,0,3,2
47757,2,2,167360,167361,167363,1,3,0
47758,4,2,167364,167364,167366,0,2,1
47759,6,3,167370,167370,167373,0,3,4
47760,3,2,167373,167373,167375,0,2,0
47761,1,3,167374,167375,167378,1,4,0
47762,4,1,167378,167378,167379,0,1,0
47763,4,1,167382,167382,167383,0,1,3
47764,2,3,167384,167384,167387,0,3,1
47765,6,1,167390,167390,167391,0,1,3
47766,6,1,167396,167396,167397,0,1,5
47767,1,2,167397,167397,167399,0,2,0
47768,6,3,167403,167403,167406,0,3,4
47769,4,1,167407,167407,167408,0,1,1
47770,4,3,167411,167411,167414,0,3,3
47771,5,3,167416,167416,167419,0,3,2
47772,4,3,167420,167420,167423,0,3,1
47773,6,1,167426,167426,167427,0,1,3
47774,6,1,167432,167432,167433,0,1,5
47775,3,3,167435,167435,167438,0,3,2
47776,4,3,167439,167439,167442,0,3,1
47777,6,3,167445,167445,167448,0,3,3
47778,5,3,167450,167450,167453,0,3,2
47779,3,3,167453,167453,167456,0,3,0
47780,4,2,167457,167457,167459,0,2,1
47781,1,2,167458,167459,167461,1,3,0
47782,6,2,167464,167464,167466,0,2,3
47783,3,1,167467,167467,167468,0,1,1
47784,6,1,167473,167473,167474,0,1,5
47785,1,2,167474,167474,167476,0,2,0
47786,3,2,167477,167477,167479,0,2,1
47787,6,3,167483,167483,167486,0,3,4
47788,3,2,167486,167486,167488,0,2,0
47789,4,2,167490,167490,167492,0,2,2
47790,3,3,167493,167493,167496,0,3,1
47791,4,3,167497,167497,167500,0,3,1
47792,1,3,167498,167500,167503,2,5,0
47793,3,2,167501,167503,167505,2,4,0
47794,1,2,167502,167505,167507,3,5,0
47795,5,1,167507,167507,167508,0,1,0
47796,3,1,167510,167510,167511,0,1,2
47797,3,2,167513,167513,167515,0,2,2
47798,4,2,167517,167517,167519,0,2,2
47799,3,1,167520,167520,167521,0,1,1
47800,4,1,167524,167524,167525,0,1,3
47801,5,3,167529,167529,167532,0,3,4
47802,5,1,167534,167534,167535,0,1,2
47803,4,2,167538,167538,167540,0,2,3
47804,2,3,167540,167540,167543,0,3,0
47805,1,1,167541,167543,167544,2,3,0
47806,6,1,167547,167547,167548,0,1,3
47807,6,2,167553,167553,167555,0,2,5
47808,6,2,167559,167559,167561,0,2,4
47809,4,2,167563,167563,167565,0,2,2
47810,6,3,167569,167569,167572,0,3,4
47811,2,1,167571,167572,167573,1,2,0
47812,4,2,167575,167575,167577,0,2,2
47813,5,3,167580,167580,167583,0,3,3
47814,4,3,167584,167584,167587,0,3,1
47815,6,3,167590,167590,167593,0,3,3
47816,1,2,167591,167593,167595,2,4,0
47817,6,3,167597,167597,167600,0,3,2
47818,4,1,167601,167601,167602,0,1,1
47819,2,2,167603,167603,167605,0,2,1
47820,6,1,167609,167609,167610,0,1,4
47821,1,1,167610,167610,167611,0,1,0
47822,1,1,167611,167611,167612,0,1,0
47823,5,3,167616,167616,167619,0,3,4
47824,6,1,167622,167622,167623,0,1,3
47825,4,3,167626,167626,167629,0,3,3
47826,3,2,167629,167629,167631,0,2,0
47827,6,2,167635,167635,167637,0,2,4
47828,4,2,167639,167639,167641,0,2,2
47829,5,2,167644,167644,167646,0,2,3
47830,6,2,167650,167650,167652,0,2,4
47831,2,1,167652,167652,167653,0,1,0
47832,1,3,167653,167653,167656,0,3,0
47833,5,1,167658,167658,167659,0,1,2
47834,5,3,167663,167663,167666,0,3,4
47835,3,3,167666,167666,167669,0,3,0
47836,3,2,167669,167669,167671,0,2,0
47837,3,1,167672,167672,167673,0,1,1
47838,4,3,167676,167676,167679,0,3,3
47839,1,2,167677,167679,167681,2,4,0
47840,4,1,167681,167681,167682,0,1,0
47841,4,1,167685,167685,167686,0,1,3
47842,1,2,167686,167686,167688,0,2,0
47843,6,3,167692,167692,167695,0,3,4
47844,3,3,167695,167695,167698,0,3,0
47845,4,2,167699,167699,167701,0,2,1
47846,5,1,167704,167704,167705,0,1,3
47847,6,3,167710,167710,167713,0,3,5
47848,4,1,167714,167714,167715,0,1,1
47849,4,2,167718,167718,167720,0,2,3
47850,3,3,167721,167721,167724,0,3,1
47851,5,2,167726,167726,167728,0,2,2
47852,5,2,167731,167731,167733,0,2,3
47853,5,3,167736,167736,167739,0,3,3
47854,2,2,167738,167739,167741,1,3,0
47855,4,3,167742,167742,167745,0,3,1
47856,5,2,167747,167747,167749,0,2,2
47857,3,2,167750,167750,167752,0,2,1
47858,1,1,167751,167752,167753,1,2,0
47859,5,3,167756,167756,167759,0,3,3
47860,6,2,167762,167762,167764,0,2,3
47861,3,1,167765,167765,167766,0,1,1
47862,5,3,167770,167770,167773,0,3,4
47863,2,1,167772,167773,167774,1,2,0
47864,6,3,167778,167778,167781,0,3,4
47865,3,2,167781,167781,167783,0,2,0
47866,1,3,167782,167783,167786,1,4,0
47867,1,3,167783,167786,167789,3,6,0
47868,3,1,167786,167789,167790,3,4,0
47869,4,3,167790,167790,167793,0,3,0
47870,2,1,167792,167793,167794,1,2,0
47871,4,2,167796,167796,167798,0,2,2
47872,3,3,167799,167799,167802,0,3,1
47873,1,2,167800,167802,167804,2,4,0
47874,1,3,167801,167804,167807,3,6,0
47875,3,3,167804,167807,167810,3,6,0
47876,1,3,167805,167810,167813,5,8,0
47877,4,2,167809,167813,167815,4,6,0
47878,2,3,167811,167815,167818,4,7,0
47879,2,3,167813,167818,167821,5,8,0
47880,2,3,167815,167821,167824,6,9,0
47881,1,1,167816,167824,167825,8,9,0
47882,6,3,167822,167825,167828,3,6,0
47883,2,2,167824,167828,167830,4,6,0
47884,4,1,167828,167830,167831,2,3,0
47885,3,2,167831,167831,167833,0,2,0
47886,3,2,167834,167834,167836,0,2,1
47887,4,2,167838,167838,167840,0,2,2
47888,6,1,167844,167844,167845,0,1,4
47889,2,3,167846,167846,167849,0,3,1
47890,6,3,167852,167852,167855,0,3,3
47891,1,3,167853,167855,167858,2,5,0
47892,1,1,167854,167858,167859,4,5,0
47893,6,2,167860,167860,167862,0,2,1
47894,6,2,167866,167866,167868,0,2,4
47895,1,3,167867,167868,167871,1,4,0
47896,5,1,167872,167872,167873,0,1,1
47897,2,3,167874,167874,167877,0,3,1
47898,5,2,167879,167879,167881,0,2,2
47899,6,2,167885,167885,167887,0,2,4
47900,2,2,167887,167887,167889,0,2,0
47901,6,2,167893,167893,167895,0,2,4
47902,3,2,167896,167896,167898,0,2,1
47903,5,3,167901,167901,167904,0,3,3
47904,6,3,167907,167907,167910,0,3,3
47905,6,2,167913,167913,167915,0,2,3
47906,6,2,167919,167919,167921,0,2,4
47907,1,2,167920,167921,167923,1,3,0
47908,6,2,167926,167926,167928,0,2,3
47909,6,1,167932,167932,167933,0,1,4
47910,2,1,167934,167934,167935,0,1,1
47911,1,2,167935,167935,167937,0,2,0
47912,5,3,167940,167940,167943,0,3,3
47913,3,1,167943,167943,167944,0,1,0
47914,4,2,167947,167947,167949,0,2,3
47915,1,2,167948,167949,167951,1,3,0
47916,5,1,167953,167953,167954,0,1,2
47917,6,3,167959,167959,167962,0,3,5
47918,5,2,167964,167964,167966,0,2,2
47919,5,2,167969,167969,167971,0,2,3
47920,4,1,167973,167973,167974,0,1,2
47921,3,3,167976,167976,167979,0,3,2
47922,3,2,167979,167979,167981,0,2,0
47923,4,3,167983,167983,167986,0,3,2
47924,5,3,167988,167988,167991,0,3,2
47925,5,2,167993,167993,167995,0,2,2
47926,2,3,167995,167995,167998,0,3,0
47927,6,1,168001,168001,168002,0,1,3
47928,5,1,168006,168006,168007,0,1,4
47929,5,1,168011,168011,168012,0,1,4
47930,4,2,168015,168015,168017,0,2,3
47931,5,1,168020,168020,168021,0,1,3
47932,5,1,168025,168025,168026,0,1,4
47933,3,1,168028,168028,168029,0,1,2
47934,5,2,168033,168033,168035,0,2,4
47935,6,3,168039,168039,168042,0,3,4
47936,5,1,168044,168044,168045,0,1,2
47937,2,3,168046,168046,168049,0,3,1
47938,1,3,168047,168049,168052,2,5,0
47939,2,3,168049,168052,168055,3,6,0
47940,6,2,168055,168055,168057,0,2,0
47941,3,2,168058,168058,168060,0,2,1
47942,5,1,168063,168063,168064,0,1,3
47943,1,3,168064,168064,168067,0,3,0
47944,2,1,168066,168067,168068,1,2,0
47945,6,3,168072,168072,168075,0,3,4
47946,2,3,168074,168075,168078,1,4,0
47947,5,2,168079,168079,168081,0,2,1
47948,6,2,168085,168085,168087,0,2,4
47949,6,2,168091,168091,168093,0,2,4
47950,3,1,168094,168094,168095,0,1,1
47951,3,2,168097,168097,168099,0,2,2
47952,1,1,168098,168099,168100,1,2,0
47953,3,3,168101,168101,168104,0,3,1
47954,4,3,168105,168105,168108,0,3,1
47955,4,1,168109,168109,168110,0,1,1
47956,6,2,168115,168115,168117,0,2,5
47957,3,2,168118,168118,168120,0,2,1
47958,2,3,168120,168120,168123,0,3,0
47959,5,2,168125,168125,168127,0,2,2
47960,3,1,168128,168128,168129,0,1,1
47961,5,1,168133,168133,168134,0,1,4
47962,3,1,168136,168136,168137,0,1,2
47963,1,1,168137,168137,168138,0,1,0
47964,2,3,168139,168139,168142,0,3,1
47965,2,3,168141,168142,168145,1,4,0
47966,4,2,168145,168145,168147,0,2,0
47967,1,3,168146,168147,168150,1,4,0
47968,3,3,168149,168150,168153,1,4,0
47969,1,3,168150,168153,168156,3,6,0
47970,5,2,168155,168156,168158,1,3,0
47971,5,2,168160,168160,168162,0,2,2
47972,4,3,168164,168164,168167,0,3,2
47973,1,1,168165,168167,168168,2,3,0
47974,4,1,168169,168169,168170,0,1,1
47975,5,3,168174,168174,168177,0,3,4
47976,6,1,168180,168180,168181,0,1,3
47977,6,3,168186,168186,168189,0,3,5
47978,4,3,168190,168190,168193,0,3,1
47979,2,1,168192,168193,168194,1,2,0
47980,2,2,168194,168194,168196,0,2,0
47981,1,3,168195,168196,168199,1,4,0
47982,4,2,168199,168199,168201,0,2,0
47983,1,3,168200,168201,168204,1,4,0
47984,3,2,168203,168204,168206,1,3,0
47985,2,3,168205,168206,168209,1,4,0
47986,5,2,168210,168210,168212,0,2,1
47987,1,1,168211,168212,168213,1,2,0
47988,3,3,168214,168214,168217,0,3,1
47989,4,2,168218,168218,168220,0,2,1
47990,5,1,168223,168223,168224,0,1,3
47991,2,3,168225,168225,168228,0,3,1
47992,2,3,168227,168228,168231,1,4,0
47993,2,2,168229,168231,168233,2,4,0
47994,5,1,168234,168234,168235,0,1,1
47995,5,2,168239,168239,168241,0,2,4
47996,3,1,168242,168242,168243,0,1,1
47997,1,2,168243,168243,168245,0,2,0
47998,6,2,168249,168249,168251,0,2,4
47999,1,3,168250,168251,168254,1,4,0
48000,6,3,168256,168256,168259,0,3,2
48001,4,3,168260,168260,168263,0,3,1
48002,5,1,168265,168265,168266,0,1,2
48003,5,3,168270,168270,168273,0,3,4
48004,6,3,168276,168276,168279,0,3,3
48005,3,1,168279,168279,168280,0,1,0
48006,1,1,168280,168280,168281,0,1,0
48007,5,3,168285,168285,168288,0,3,4
48008,2,2,168287,168288,168290,1,3,0
48009,5,3,168292,168292,168295,0,3,2
48010,1,3,168293,168295,168298,2,5,0
48011,5,3,168298,168298,168301,0,3,0
48012,2,2,168300,168301,168303,1,3,0
48013,2,2,168302,168303,168305,1,3,0
48014,4,2,168306,168306,168308,0,2,1
48015,1,1,168307,168308,168309,1,2,0
48016,5,3,168312,168312,168315,0,3,3
48017,6,2,168318,168318,168320,0,2,3
48018,4,3,168322,168322,168325,0,3,2
48019,1,2,168323,168325,168327,2,4,0
48020,6,1,168329,168329,168330,0,1,2
48021,6,1,168335,168335,168336,0,1,5
48022,6,2,168341,168341,168343,0,2,5
48023,1,2,168342,168343,168345,1,3,0
48024,5,1,168347,168347,168348,0,1,2
48025,2,3,168349,168349,168352,0,3,1
48026,1,1,168350,168352,168353,2,3,0
48027,2,2,168352,168353,168355,1,3,0
48028,5,2,168357,168357,168359,0,2,2
48029,5,2,168362,168362,168364,0,2,3
48030,1,2,168363,168364,168366,1,3,0
48031,6,3,168369,168369,168372,0,3,3
48032,5,2,168374,168374,168376,0,2,2
48033,5,3,168379,168379,168382,0,3,3
48034,6,2,168385,168385,168387,0,2,3
48035,6,3,168391,168391,168394,0,3,4
48036,5,2,168396,168396,168398,0,2,2
48037,2,2,168398,168398,168400,0,2,0
48038,1,2,168399,168400,168402,1,3,0
48039,1,1,168400,168402,168403,2,3,0
48040,3,2,168403,168403,168405,0,2,0
48041,5,2,168408,168408,168410,0,2,3
48042,6,3,168414,168414,168417,0,3,4
48043,2,1,168416,168417,168418,1,2,0
48044,6,2,168422,168422,168424,0,2,4
48045,2,3,168424,168424,168427,0,3,0
48046,3,1,168427,168427,168428,0,1,0
48047,1,1,168428,168428,168429,0,1,0
48048,1,3,168429,168429,168432,0,3,0
48049,3,3,168432,168432,168435,0,3,0
48050,5,2,168437,168437,168439,0,2,2
48051,6,1,168443,168443,168444,0,1,4
48052,3,2,168446,168446,168448,0,2,2
48053,6,3,168452,168452,168455,0,3,4
48054,3,2,168455,168455,168457,0,2,0
48055,4,1,168459,168459,168460,0,1,2
48056,2,1,168461,168461,168462,0,1,1
48057,6,1,168467,168467,168468,0,1,5
48058,6,3,168473,168473,168476,0,3,5
48059,6,1,168479,168479,168480,0,1,3
48060,5,2,168484,168484,168486,0,2,4
48061,1,1,168485,168486,168487,1,2,0
48062,5,3,168490,168490,168493,0,3,3
48063,1,1,168491,168493,168494,2,3,0
48064,5,3,168496,168496,168499,0,3,2
48065,2,3,168498,168499,168502,1,4,0
48066,5,1,168503,168503,168504,0,1,1
48067,3,2,168506,168506,168508,0,2,2
48068,5,1,168511,168511,168512,0,1,3
48069,4,1,168515,168515,168516,0,1,3
48070,1,1,168516,168516,168517,0,1,0
48071,6,1,168522,168522,168523,0,1,5
48072,6,3,168528,168528,168531,0,3,5
48073,4,3,168532,168532,168535,0,3,1
48074,2,3,168534,168535,168538,1,4,0
48075,3,2,168537,168538,168540,1,3,0
48076,6,1,168543,168543,168544,0,1,3
48077,4,1,168547,168547,168548,0,1,3
48078,2,1,168549,168549,168550,0,1,1
48079,6,1,168555,168555,168556,0,1,5
48080,4,2,168559,168559,168561,0,2,3
48081,1,2,168560,168561,168563,1,3,0
48082,2,1,168562,168563,168564,1,2,0
48083,1,3,168563,168564,168567,1,4,0
48084,4,1,168567,168567,168568,0,1,0
48085,1,2,168568,168568,168570,0,2,0
48086,3,1,168571,168571,168572,0,1,1
48087,4,2,168575,168575,168577,0,2,3
48088,6,2,168581,168581,168583,0,2,4
48089,3,2,168584,168584,168586,0,2,1
48090,3,2,168587,168587,168589,0,2,1
48091,6,3,168593,168593,168596,0,3,4
48092,2,2,168595,168596,168598,1,3,0
48093,4,2,168599,168599,168601,0,2,1
48094,1,2,168600,168601,168603,1,3,0
48095,5,1,168605,168605,168606,0,1,2
48096,3,2,168608,168608,168610,0,2,2
48097,6,3,168614,168614,168617,0,3,4
48098,4,3,168618,168618,168621,0,3,1
48099,1,3,168619,168621,168624,2,5,0
48100,5,1,168624,168624,168625,0,1,0
48101,4,1,168628,168628,168629,0,1,3
48102,5,2,168633,168633,168635,0,2,4
48103,3,1,168636,168636,168637,0,1,1
48104,1,3,168637,168637,168640,0,3,0
48105,5,2,168642,168642,168644,0,2,2
48106,2,2,168644,168644,168646,0,2,0
48107,4,3,168648,168648,168651,0,3,2
48108,1,1,168649,168651,168652,2,3,0
48109,1,1,168650,168652,168653,2,3,0
48110,4,1,168654,168654,168655,0,1,1
48111,2,1,168656,168656,168657,0,1,1
48112,6,1,168662,168662,168663,0,1,5
48113,3,2,168665,168665,168667,0,2,2
48114,2,3,168667,168667,168670,0,3,0
48115,5,1,168672,168672,168673,0,1,2
48116,3,1,168675,168675,168676,0,1,2
48117,1,1,168676,168676,168677,0,1,0
48118,6,3,168682,168682,168685,0,3,5
48119,3,2,168685,168685,168687,0,2,0
48120,4,2,168689,168689,168691,0,2,2
48121,5,3,168694,168694,168697,0,3,3
48122,2,2,168696,168697,168699,1,3,0
48123,4,3,168700,168700,168703,0,3,1
48124,4,2,168704,168704,168706,0,2,1
48125,4,2,168708,168708,168710,0,2,2
48126,6,3,168714,168714,168717,0,3,4
48127,3,1,168717,168717,168718,0,1,0
48128,6,2,168723,168723,168725,0,2,5
48129,3,2,168726,168726,168728,0,2,1
48130,5,1,168731,168731,168732,0,1,3
48131,5,2,168736,168736,168738,0,2,4
48132,2,3,168738,168738,168741,0,3,0
48133,3,1,168741,168741,168742,0,1,0
48134,6,2,168747,168747,168749,0,2,5
48135,6,3,168753,168753,168756,0,3,4
48136,3,3,168756,168756,168759,0,3,0
48137,6,2,168762,168762,168764,0,2,3
48138,5,3,168767,168767,168770,0,3,3
48139,3,1,168770,168770,168771,0,1,0
48140,5,3,168775,168775,168778,0,3,4
48141,5,2,168780,168780,168782,0,2,2
48142,4,1,168784,168784,168785,0,1,2
48143,3,3,168787,168787,168790,0,3,2
48144,5,3,168792,168792,168795,0,3,2
48145,5,3,168797,168797,168800,0,3,2
48146,1,1,168798,168800,168801,2,3,0
48147,6,3,168804,168804,168807,0,3,3
48148,6,1,168810,168810,168811,0,1,3
48149,4,3,168814,168814,168817,0,3,3
48150,6,1,168820,168820,168821,0,1,3
48151,2,1,168822,168822,168823,0,1,1
48152,3,1,168825,168825,168826,0,1,2
48153,2,2,168827,168827,168829,0,2,1
48154,5,3,168832,168832,168835,0,3,3
48155,6,3,168838,168838,168841,0,3,3
48156,5,1,168843,168843,168844,0,1,2
48157,3,3,168846,168846,168849,0,3,2
48158,5,3,168851,168851,168854,0,3,2
48159,5,3,168856,168856,168859,0,3,2
48160,6,2,168862,168862,168864,0,2,3
48161,3,2,168865,168865,168867,0,2,1
48162,1,3,168866,168867,168870,1,4,0
48163,1,1,168867,168870,168871,3,4,0
48164,1,1,168868,168871,168872,3,4,0
48165,4,3,168872,168872,168875,0,3,0
48166,1,3,168873,168875,168878,2,5,0
48167,1,2,168874,168878,168880,4,6,0
48168,6,1,168880,168880,168881,0,1,0
48169,6,3,168886,168886,168889,0,3,5
48170,1,3,168887,168889,168892,2,5,0
48171,2,1,168889,168892,168893,3,4,0
48172,6,2,168895,168895,168897,0,2,2
48173,5,1,168900,168900,168901,0,1,3
48174,4,1,168904,168904,168905,0,1,3
48175,1,1,168905,168905,168906,0,1,0
48176,4,2,168909,168909,168911,0,2,3
48177,6,1,168915,168915,168916,0,1,4
48178,3,2,168918,168918,168920,0,2,2
48179,3,1,168921,168921,168922,0,1,1
48180,1,3,168922,168922,168925,0,3,0
48181,4,3,168926,168926,168929,0,3,1
48182,6,2,168932,168932,168934,0,2,3
48183,1,3,168933,168934,168937,1,4,0
48184,3,1,168936,168937,168938,1,2,0
48185,2,1,168938,168938,168939,0,1,0
48186,3,2,168941,168941,168943,0,2,2
48187,1,3,168942,168943,168946,1,4,0
48188,6,1,168948,168948,168949,0,1,2
48189,5,3,168953,168953,168956,0,3,4
48190,3,3,168956,168956,168959,0,3,0
48191,1,1,168957,168959,168960,2,3,0
48192,4,3,168961,168961,168964,0,3,1
48193,1,2,168962,168964,168966,2,4,0
48194,2,3,168964,168966,168969,2,5,0
48195,5,3,168969,168969,168972,0,3,0
48196,2,3,168971,168972,168975,1,4,0
48197,3,2,168974,168975,168977,1,3,0
48198,6,3,168980,168980,168983,0,3,3
48199,2,1,168982,168983,168984,1,2,0
48200,2,3,168984,168984,168987,0,3,0
48201,2,2,168986,168987,168989,1,3,0
48202,5,3,168991,168991,168994,0,3,2
48203,4,2,168995,168995,168997,0,2,1
48204,6,3,169001,169001,169004,0,3,4
48205,3,3,169004,169004,169007,0,3,0
48206,5,1,169009,169009,169010,0,1,2
48207,1,3,169010,169010,169013,0,3,0
48208,6,3,169016,169016,169019,0,3,3
48209,6,2,169022,169022,169024,0,2,3
48210,1,3,169023,169024,169027,1,4,0
48211,2,1,169025,169027,169028,2,3,0
48212,2,3,169027,169028,169031,1,4,0
48213,5,3,169032,169032,169035,0,3,1
48214,5,2,169037,169037,169039,0,2,2
48215,1,1,169038,169039,169040,1,2,0
48216,2,2,169040,169040,169042,0,2,0
48217,6,2,169046,169046,169048,0,2,4
48218,1,1,169047,169048,169049,1,2,0
48219,6,2,169053,169053,169055,0,2,4
48220,5,1,169058,169058,169059,0,1,3
48221,3,3,169061,169061,169064,0,3,2
48222,2,1,169063,169064,169065,1,2,0
48223,3,1,169066,169066,169067,0,1,1
48224,2,3,169068,169068,169071,0,3,1
48225,5,1,169073,169073,169074,0,1,2
48226,5,1,169078,169078,169079,0,1,4
48227,5,3,169083,169083,169086,0,3,4
48228,1,3,169084,169086,169089,2,5,0
48229,6,1,169090,169090,169091,0,1,1
48230,1,1,169091,169091,169092,0,1,0
48231,5,3,169096,169096,169099,0,3,4
48232,4,2,169100,169100,169102,0,2,1
48233,6,1,169106,169106,169107,0,1,4
48234,6,3,169112,169112,169115,0,3,5
48235,1,3,169113,169115,169118,2,5,0
48236,2,1,169115,169118,169119,3,4,0
48237,3,3,169118,169119,169122,1,4,0
48238,2,3,169120,169122,169125,2,5,0
48239,5,3,169125,169125,169128,0,3,0
48240,2,3,169127,169128,169131,1,4,0
48241,3,3,169130,169131,169134,1,4,0
48242,6,2,169136,169136,169138,0,2,2
48243,1,2,169137,169138,169140,1,3,0
48244,5,3,169142,169142,169145,0,3,2
48245,2,2,169144,169145,169147,1,3,0
48246,6,1,169150,169150,169151,0,1,3
48247,3,2,169153,169153,169155,0,2,2
48248,6,2,169159,169159,169161,0,2,4
48249,2,2,169161,169161,169163,0,2,0
48250,1,2,169162,169163,169165,1,3,0
48251,5,3,169167,169167,169170,0,3,2
48252,3,1,169170,169170,169171,0,1,0
48253,4,3,169174,169174,169177,0,3,3
48254,5,1,169179,169179,169180,0,1,2
48255,4,3,169183,169183,169186,0,3,3
48256,5,3,169188,169188,169191,0,3,2
48257,2,2,169190,169191,169193,1,3,0
48258,2,3,169192,169193,169196,1,4,0
48259,5,3,169197,169197,169200,0,3,1
48260,5,1,169202,169202,169203,0,1,2
48261,5,3,169207,169207,169210,0,3,4
48262,6,2,169213,169213,169215,0,2,3
48263,4,2,169217,169217,169219,0,2,2
48264,1,3,169218,169219,169222,1,4,0
48265,6,1,169224,169224,169225,0,1,2
48266,3,1,169227,169227,169228,0,1,2
48267,2,1,169229,169229,169230,0,1,1
48268,2,2,169231,169231,169233,0,2,1
48269,5,3,169236,169236,169239,0,3,3
48270,1,3,169237,169239,169242,2,5,0
48271,2,1,169239,169242,169243,3,4,0
48272,2,1,169241,169243,169244,2,3,0
48273,1,3,169242,169244,169247,2,5,0
48274,6,2,169248,169248,169250,0,2,1
48275,1,1,169249,169250,169251,1,2,0
48276,1,3,169250,169251,169254,1,4,0
48277,5,1,169255,169255,169256,0,1,1
48278,4,1,169259,169259,169260,0,1,3
48279,6,1,169265,169265,169266,0,1,5
48280,1,2,169266,169266,169268,0,2,0
48281,3,3,169269,169269,169272,0,3,1
48282,3,2,169272,169272,169274,0,2,0
48283,1,1,169273,169274,169275,1,2,0
48284,3,3,169276,169276,169279,0,3,1
48285,6,1,169282,169282,169283,0,1,3
48286,6,1,169288,169288,169289,0,1,5
48287,5,2,169293,169293,169295,0,2,4
48288,5,1,169298,169298,169299,0,1,3
48289,4,1,169302,169302,169303,0,1,3
48290,5,1,169307,169307,169308,0,1,4
48291,3,1,169310,169310,169311,0,1,2
48292,6,1,169316,169316,169317,0,1,5
48293,6,1,169322,169322,169323,0,1,5
48294,2,1,169324,169324,169325,0,1,1
48295,5,2,169329,169329,169331,0,2,4
48296,5,1,169334,169334,169335,0,1,3
48297,4,3,169338,169338,169341,0,3,3
48298,1,1,169339,169341,169342,2,3,0
48299,4,3,169343,169343,169346,0,3,1
48300,6,2,169349,169349,169351,0,2,3
48301,6,3,169355,169355,169358,0,3,4
48302,6,2,169361,169361,169363,0,2,3
48303,4,1,169365,169365,169366,0,1,2
48304,3,3,169368,169368,169371,0,3,2
48305,6,3,169374,169374,169377,0,3,3
48306,3,2,169377,169377,169379,0,2,0
48307,1,2,169378,169379,169381,1,3,0
48308,4,3,169382,169382,169385,0,3,1
48309,6,3,169388,169388,169391,0,3,3
48310,5,3,169393,169393,169396,0,3,2
48311,2,2,169395,169396,169398,1,3,0
48312,3,1,169398,169398,169399,0,1,0
48313,5,1,169403,169403,169404,0,1,4
48314,5,3,169408,169408,169411,0,3,4
48315,2,2,169410,169411,169413,1,3,0
48316,6,2,169416,169416,169418,0,2,3
48317,5,1,169421,169421,169422,0,1,3
48318,3,1,169424,169424,169425,0,1,2
48319,4,2,169428,169428,169430,0,2,3
48320,5,2,169433,169433,169435,0,2,3
48321,3,1,169436,169436,169437,0,1,1
48322,1,1,169437,169437,169438,0,1,0
48323,4,3,169441,169441,169444,0,3,3
48324,6,1,169447,169447,169448,0,1,3
48325,3,1,169450,169450,169451,0,1,2
48326,2,2,169452,169452,169454,0,2,1
48327,5,3,169457,169457,169460,0,3,3
48328,2,2,169459,169460,169462,1,3,0
48329,5,3,169464,169464,169467,0,3,2
48330,3,1,169467,169467,169468,0,1,0
48331,1,2,169468,169468,169470,0,2,0
48332,2,1,169470,169470,169471,0,1,0
48333,2,1,169472,169472,169473,0,1,1
48334,3,1,169475,169475,169476,0,1,2
48335,4,3,169479,169479,169482,0,3,3
48336,6,1,169485,169485,169486,0,1,3
48337,6,1,169491,169491,169492,0,1,5
48338,5,2,169496,169496,169498,0,2,4
48339,6,1,169502,169502,169503,0,1,4
48340,5,3,169507,169507,169510,0,3,4
48341,2,2,169509,169510,169512,1,3,0
48342,2,2,169511,169512,169514,1,3,0
48343,6,2,169517,169517,169519,0,2,3
48344,5,3,169522,169522,169525,0,3,3
48345,1,3,169523,169525,169528,2,5,0
48346,6,2,169529,169529,169531,0,2,1
48347,1,1,169530,169531,169532,1,2,0
48348,4,2,169534,169534,169536,0,2,2
48349,3,2,169537,169537,169539,0,2,1
48350,2,2,169539,169539,169541,0,2,0
48351,2,2,169541,169541,169543,0,2,0
48352,5,3,169546,169546,169549,0,3,3
48353,3,1,169549,169549,169550,0,1,0
48354,6,1,169555,169555,169556,0,1,5
48355,2,3,169557,169557,169560,0,3,1
48356,6,3,169563,169563,169566,0,3,3
48357,6,3,169569,169569,169572,0,3,3
48358,6,2,169575,169575,169577,0,2,3
48359,4,3,169579,169579,169582,0,3,2
48360,1,1,169580,169582,169583,2,3,0
48361,6,3,169586,169586,169589,0,3,3
48362,1,2,169587,169589,169591,2,4,0
48363,5,3,169592,169592,169595,0,3,1
48364,2,3,169594,169595,169598,1,4,0
48365,3,3,169597,169598,169601,1,4,0
48366,3,3,169600,169601,169604,1,4,0
48367,1,2,169601,169604,169606,3,5,0
48368,1,1,169602,169606,169607,4,5,0
48369,3,2,169605,169607,169609,2,4,0
48370,2,3,169607,169609,169612,2,5,0
48371,6,3,169613,169613,169616,0,3,1
48372,3,1,169616,169616,169617,0,1,0
48373,5,1,169621,169621,169622,0,1,4
48374,5,3,169626,169626,169629,0,3,4
48375,5,3,169631,169631,169634,0,3,2
48376,3,1,169634,169634,169635,0,1,0
48377,1,3,169635,169635,169638,0,3,0
48378,2,1,169637,169638,169639,1,2,0
48379,6,3,169643,169643,169646,0,3,4
48380,3,1,169646,169646,169647,0,1,0
48381,2,3,169648,169648,169651,0,3,1
48382,2,1,169650,169651,169652,1,2,0
48383,3,3,169653,169653,169656,0,3,1
48384,2,1,169655,169656,169657,1,2,0
48385,4,1,169659,169659,169660,0,1,2
48386,4,3,169663,169663,169666,0,3,3
48387,5,2,169668,169668,169670,0,2,2
48388,1,2,169669,169670,169672,1,3,0
48389,6,3,169675,169675,169678,0,3,3
48390,6,1,169681,169681,169682,0,1,3
48391,3,3,169684,169684,169687,0,3,2
48392,1,2,169685,169687,169689,2,4,0
48393,4,3,169689,169689,169692,0,3,0
48394,2,2,169691,169692,169694,1,3,0
48395,6,3,169697,169697,169700,0,3,3
48396,1,3,169698,169700,169703,2,5,0
48397,4,1,169702,169703,169704,1,2,0
48398,1,3,169703,169704,169707,1,4,0
48399,1,2,169704,169707,169709,3,5,0
48400,2,3,169706,169709,169712,3,6,0
48401,1,2,169707,169712,169714,5,7,0
48402,2,2,169709,169714,169716,5,7,0
48403,1,3,169710,169716,169719,6,9,0
48404,1,2,169711,169719,169721,8,10,0
48405,1,3,169712,169721,169724,9,12,0
48406,3,1,169715,169724,169725,9,10,0
48407,6,1,169721,169725,169726,4,5,0
48408,3,2,169724,169726,169728,2,4,0
48409,2,2,169726,169728,169730,2,4,0
48410,5,2,169731,169731,169733,0,2,1
48411,5,2,169736,169736,169738,0,2,3
48412,5,1,169741,169741,169742,0,1,3
48413,6,2,169747,169747,169749,0,2,5
48414,3,3,169750,169750,169753,0,3,1
48415,6,1,169756,169756,169757,0,1,3
48416,6,3,169762,169762,169765,0,3,5
48417,5,2,169767,169767,169769,0,2,2
48418,6,3,169773,169773,169776,0,3,4
48419,6,2,169779,169779,169781,0,2,3
48420,4,1,169783,169783,169784,0,1,2
48421,5,2,169788,169788,169790,0,2,4
48422,6,3,169794,169794,169797,0,3,4
48423,4,2,169798,169798,169800,0,2,1
48424,2,1,169800,169800,169801,0,1,0
48425,1,2,169801,169801,169803,0,2,0
48426,3,1,169804,169804,169805,0,1,1
48427,2,3,169806,169806,169809,0,3,1
48428,5,2,169811,169811,169813,0,2,2
48429,2,2,169813,169813,169815,0,2,0
48430,6,2,169819,169819,169821,0,2,4
48431,5,2,169824,169824,169826,0,2,3
48432,3,2,169827,169827,169829,0,2,1
48433,1,2,169828,169829,169831,1,3,0
48434,2,3,169830,169831,169834,1,4,0
48435,4,3,169834,169834,169837,0,3,0
48436,5,2,169839,169839,169841,0,2,2
48437,4,2,169843,169843,169845,0,2,2
48438,1,2,169844,169845,169847,1,3,0
48439,5,1,169849,169849,169850,0,1,2
48440,5,1,169854,169854,169855,0,1,4
48441,4,3,169858,169858,169861,0,3,3
48442,4,1,169862,169862,169863,0,1,1
48443,4,3,169866,169866,169869,0,3,3
48444,6,2,169872,169872,169874,0,2,3
48445,2,2,169874,169874,169876,0,2,0
48446,1,3,169875,169876,169879,1,4,0
48447,4,1,169879,169879,169880,0,1,0
48448,2,1,169881,169881,169882,0,1,1
48449,2,1,169883,169883,169884,0,1,1
48450,2,1,169885,169885,169886,0,1,1
48451,5,3,169890,169890,169893,0,3,4
48452,4,1,169894,169894,169895,0,1,1
48453,5,1,169899,169899,169900,0,1,4
48454,2,3,169901,169901,169904,0,3,1
48455,5,3,169906,169906,169909,0,3,2
48456,2,3,169908,169909,169912,1,4,0
48457,4,2,169912,169912,169914,0,2,0
48458,3,3,169915,169915,169918,0,3,1
48459,3,2,169918,169918,169920,0,2,0
48460,5,2,169923,169923,169925,0,2,3
48461,1,1,169924,169925,169926,1,2,0
48462,4,2,169928,169928,169930,0,2,2
48463,6,1,169934,169934,169935,0,1,4
48464,2,2,169936,169936,169938,0,2,1
48465,1,2,169937,169938,169940,1,3,0
48466,6,2,169943,169943,169945,0,2,3
48467,5,3,169948,169948,169951,0,3,3
48468,3,2,169951,169951,169953,0,2,0
48469,3,1,169954,169954,169955,0,1,1
48470,4,3,169958,169958,169961,0,3,3
48471,4,1,169962,169962,169963,0,1,1
48472,5,1,169967,169967,169968,0,1,4
48473,5,2,169972,169972,169974,0,2,4
48474,4,1,169976,169976,169977,0,1,2
48475,3,1,169979,169979,169980,0,1,2
48476,3,1,169982,169982,169983,0,1,2
48477,3,1,169985,169985,169986,0,1,2
48478,4,2,169989,169989,169991,0,2,3
48479,1,1,169990,169991,169992,1,2,0
48480,2,3,169992,169992,169995,0,3,0
48481,5,3,169997,169997,170000,0,3,2
48482,2,2,169999,170000,170002,1,3,0
48483,4,1,170003,170003,170004,0,1,1
48484,6,2,170009,170009,170011,0,2,5
48485,2,3,170011,170011,170014,0,3,0
48486,4,2,170015,170015,170017,0,2,1
48487,3,1,170018,170018,170019,0,1,1
48488,3,3,170021,170021,170024,0,3,2
48489,2,2,170023,170024,170026,1,3,0
48490,4,2,170027,170027,170029,0,2,1
48491,6,3,170033,170033,170036,0,3,4
48492,4,3,170037,170037,170040,0,3,1
48493,6,3,170043,170043,170046,0,3,3
48494,3,2,170046,170046,170048,0,2,0
48495,1,2,170047,170048,170050,1,3,0
48496,4,2,170051,170051,170053,0,2,1
48497,1,2,170052,170053,170055,1,3,0
48498,3,2,170055,170055,170057,0,2,0
48499,2,3,170057,170057,170060,0,3,0
48500,6,1,170063,170063,170064,0,1,3
48501,3,2,170066,170066,170068,0,2,2
48502,2,3,170068,170068,170071,0,3,0
48503,3,1,170071,170071,170072,0,1,0
48504,5,2,170076,170076,170078,0,2,4
48505,3,1,170079,170079,170080,0,1,1
48506,4,3,170083,170083,170086,0,3,3
48507,6,3,170089,170089,170092,0,3,3
48508,2,2,170091,170092,170094,1,3,0
48509,4,1,170095,170095,170096,0,1,1
48510,3,1,170098,170098,170099,0,1,2
48511,4,3,170102,170102,170105,0,3,3
48512,6,3,170108,170108,170111,0,3,3
48513,5,1,170113,170113,170114,0,1,2
48514,2,2,170115,170115,170117,0,2,1
48515,5,1,170120,170120,170121,0,1,3
48516,3,1,170123,170123,170124,0,1,2
48517,1,2,170124,170124,170126,0,2,0
48518,4,2,170128,170128,170130,0,2,2
48519,2,1,170130,170130,170131,0,1,0
48520,2,2,170132,170132,170134,0,2,1
48521,2,1,170134,170134,170135,0,1,0
48522,2,2,170136,170136,170138,0,2,1
48523,4,2,170140,170140,170142,0,2,2
48524,3,2,170143,170143,170145,0,2,1
48525,2,3,170145,170145,170148,0,3,0
48526,4,3,170149,170149,170152,0,3,1
48527,1,2,170150,170152,170154,2,4,0
48528,4,3,170154,170154,170157,0,3,0
48529,6,3,170160,170160,170163,0,3,3
48530,2,1,170162,170163,170164,1,2,0
48531,4,2,170166,170166,170168,0,2,2
48532,6,2,170172,170172,170174,0,2,4
48533,4,2,170176,170176,170178,0,2,2
48534,3,3,170179,170179,170182,0,3,1
48535,4,1,170183,170183,170184,0,1,1
48536,6,3,170189,170189,170192,0,3,5
48537,2,2,170191,170192,170194,1,3,0
48538,1,3,170192,170194,170197,2,5,0
48539,1,3,170193,170197,170200,4,7,0
48540,5,2,170198,170200,170202,2,4,0
48541,5,1,170203,170203,170204,0,1,1
48542,4,3,170207,170207,170210,0,3,3
48543,1,3,170208,170210,170213,2,5,0
48544,1,3,170209,170213,170216,4,7,0
48545,1,1,170210,170216,170217,6,7,0
48546,6,1,170216,170217,170218,1,2,0
48547,3,2,170219,170219,170221,0,2,1
48548,2,2,170221,170221,170223,0,2,0
48549,6,1,170227,170227,170228,0,1,4
48550,4,3,170231,170231,170234,0,3,3
48551,6,2,170237,170237,170239,0,2,3
48552,1,2,170238,170239,170241,1,3,0
48553,3,3,170241,170241,170244,0,3,0
48554,4,3,170245,170245,170248,0,3,1
48555,2,2,170247,170248,170250,1,3,0
48556,3,2,170250,170250,170252,0,2,0
48557,6,2,170256,170256,170258,0,2,4
48558,5,2,170261,170261,170263,0,2,3
48559,5,3,170266,170266,170269,0,3,3
48560,4,3,170270,170270,170273,0,3,1
48561,1,1,170271,170273,170274,2,3,0
48562,4,2,170275,170275,170277,0,2,1
48563,2,2,170277,170277,170279,0,2,0
48564,1,1,170278,170279,170280,1,2,0
48565,4,1,170282,170282,170283,0,1,2
48566,1,3,170283,170283,170286,0,3,0
48567,1,1,170284,170286,170287,2,3,0
48568,5,2,170289,170289,170291,0,2,2
48569,5,3,170294,170294,170297,0,3,3
48570,6,1,170300,170300,170301,0,1,3
48571,3,2,170303,170303,170305,0,2,2
48572,5,1,170308,170308,170309,0,1,3
48573,4,1,170312,170312,170313,0,1,3
48574,3,3,170315,170315,170318,0,3,2
48575,5,2,170320,170320,170322,0,2,2
48576,5,3,170325,170325,170328,0,3,3
48577,4,1,170329,170329,170330,0,1,1
48578,5,2,170334,170334,170336,0,2,4
48579,2,2,170336,170336,170338,0,2,0
48580,3,2,170339,170339,170341,0,2,1
48581,6,1,170345,170345,170346,0,1,4
48582,2,1,170347,170347,170348,0,1,1
48583,5,2,170352,170352,170354,0,2,4
48584,1,3,170353,170354,170357,1,4,0
48585,3,1,170356,170357,170358,1,2,0
48586,3,2,170359,170359,170361,0,2,1
48587,2,3,170361,170361,170364,0,3,0
48588,5,1,170366,170366,170367,0,1,2
48589,2,1,170368,170368,170369,0,1,1
48590,2,1,170370,170370,170371,0,1,1
48591,6,1,170376,170376,170377,0,1,5
48592,5,3,170381,170381,170384,0,3,4
48593,2,3,170383,170384,170387,1,4,0
48594,4,3,170387,170387,170390,0,3,0
48595,1,3,170388,170390,170393,2,5,0
48596,4,3,170392,170393,170396,1,4,0
48597,1,1,170393,170396,170397,3,4,0
48598,3,1,170396,170397,170398,1,2,0
48599,5,3,170401,170401,170404,0,3,3
48600,4,1,170405,170405,170406,0,1,1
48601,3,1,170408,170408,170409,0,1,2
48602,5,3,170413,170413,170416,0,3,4
48603,1,1,170414,170416,170417,2,3,0
48604,3,1,170417,170417,170418,0,1,0
48605,3,3,170420,170420,170423,0,3,2
48606,5,3,170425,170425,170428,0,3,2
48607,6,1,170431,170431,170432,0,1,3
48608,2,2,170433,170433,170435,0,2,1
48609,5,2,170438,170438,170440,0,2,3
48610,5,3,170443,170443,170446,0,3,3
48611,4,1,170447,170447,170448,0,1,1
48612,5,2,170452,170452,170454,0,2,4
48613,6,3,170458,170458,170461,0,3,4
48614,4,2,170462,170462,170464,0,2,1
48615,2,1,170464,170464,170465,0,1,0
48616,6,3,170470,170470,170473,0,3,5
48617,6,2,170476,170476,170478,0,2,3
48618,4,2,170480,170480,170482,0,2,2
48619,4,1,170484,170484,170485,0,1,2
48620,5,1,170489,170489,170490,0,1,4
48621,6,3,170495,170495,170498,0,3,5
48622,5,3,170500,170500,170503,0,3,2
48623,3,2,170503,170503,170505,0,2,0
48624,3,2,170506,170506,170508,0,2,1
48625,1,3,170507,170508,170511,1,4,0
48626,1,2,170508,170511,170513,3,5,0
48627,3,1,170511,170513,170514,2,3,0
48628,5,3,170516,170516,170519,0,3,2
48629,2,1,170518,170519,170520,1,2,0
48630,5,1,170523,170523,170524,0,1,3
48631,5,3,170528,170528,170531,0,3,4
48632,1,2,170529,170531,170533,2,4,0
48633,4,2,170533,170533,170535,0,2,0
48634,6,1,170539,170539,170540,0,1,4
48635,4,3,170543,170543,170546,0,3,3
48636,4,3,170547,170547,170550,0,3,1
48637,6,3,170553,170553,170556,0,3,3
48638,4,2,170557,170557,170559,0,2,1
48639,5,1,170562,170562,170563,0,1,3
48640,2,3,170564,170564,170567,0,3,1
48641,6,2,170570,170570,170572,0,2,3
48642,4,1,170574,170574,170575,0,1,2
48643,6,3,170580,170580,170583,0,3,5
48644,6,2,170586,170586,170588,0,2,3
48645,4,1,170590,170590,170591,0,1,2
48646,3,1,170593,170593,170594,0,1,2
48647,1,2,170594,170594,170596,0,2,0
48648,3,2,170597,170597,170599,0,2,1
48649,2,2,170599,170599,170601,0,2,0
48650,4,1,170603,170603,170604,0,1,2
48651,4,3,170607,170607,170610,0,3,3
48652,6,3,170613,170613,170616,0,3,3
48653,1,2,170614,170616,170618,2,4,0
48654,6,3,170620,170620,170623,0,3,2
48655,4,3,170624,170624,170627,0,3,1
48656,5,2,170629,170629,170631,0,2,2
48657,1,2,170630,170631,170633,1,3,0
48658,2,2,170632,170633,170635,1,3,0
48659,1,3,170633,170635,170638,2,5,0
48660,3,1,170636,170638,170639,2,3,0
48661,3,2,170639,170639,170641,0,2,0
48662,2,2,170641,170641,170643,0,2,0
48663,5,2,170646,170646,170648,0,2,3
48664,4,2,170650,170650,170652,0,2,2
48665,3,3,170653,170653,170656,0,3,1
48666,2,3,170655,170656,170659,1,4,0
48667,3,3,170658,170659,170662,1,4,0
48668,2,1,170660,170662,170663,2,3,0
48669,1,2,170661,170663,170665,2,4,0
48670,2,2,170663,170665,170667,2,4,0
48671,5,1,170668,170668,170669,0,1,1
48672,1,2,170669,170669,170671,0,2,0
48673,5,3,170674,170674,170677,0,3,3
48674,6,3,170680,170680,170683,0,3,3
48675,5,3,170685,170685,170688,0,3,2
48676,2,3,170687,170688,170691,1,4,0
48677,3,2,170690,170691,170693,1,3,0
48678,5,1,170695,170695,170696,0,1,2
48679,4,2,170699,170699,170701,0,2,3
48680,1,1,170700,170701,170702,1,2,0
48681,4,3,170704,170704,170707,0,3,2
48682,1,2,170705,170707,170709,2,4,0
48683,1,2,170706,170709,170711,3,5,0
48684,3,1,170709,170711,170712,2,3,0
48685,3,1,170712,170712,170713,0,1,0
48686,3,1,170715,170715,170716,0,1,2
48687,4,3,170719,170719,170722,0,3,3
48688,4,3,170723,170723,170726,0,3,1
48689,4,1,170727,170727,170728,0,1,1
48690,4,1,170731,170731,170732,0,1,3
48691,4,1,170735,170735,170736,0,1,3
48692,3,2,170738,170738,170740,0,2,2
48693,6,2,170744,170744,170746,0,2,4
48694,1,2,170745,170746,170748,1,3,0
48695,4,1,170749,170749,170750,0,1,1
48696,3,1,170752,170752,170753,0,1,2
48697,3,2,170755,170755,170757,0,2,2
48698,4,3,170759,170759,170762,0,3,2
48699,5,1,170764,170764,170765,0,1,2
48700,5,3,170769,170769,170772,0,3,4
48701,5,2,170774,170774,170776,0,2,2
48702,2,1,170776,170776,170777,0,1,0
48703,5,2,170781,170781,170783,0,2,4
48704,5,2,170786,170786,170788,0,2,3
48705,6,2,170792,170792,170794,0,2,4
48706,4,2,170796,170796,170798,0,2,2
48707,1,1,170797,170798,170799,1,2,0
48708,4,3,170801,170801,170804,0,3,2
48709,3,1,170804,170804,170805,0,1,0
48710,2,1,170806,170806,170807,0,1,1
48711,6,1,170812,170812,170813,0,1,5
48712,3,2,170815,170815,170817,0,2,2
48713,3,2,170818,170818,170820,0,2,1
48714,3,2,170821,170821,170823,0,2,1
48715,6,2,170827,170827,170829,0,2,4
48716,6,3,170833,170833,170836,0,3,4
48717,1,3,170834,170836,170839,2,5,0
48718,6,2,170840,170840,170842,0,2,1
48719,5,2,170845,170845,170847,0,2,3
48720,6,2,170851,170851,170853,0,2,4
48721,3,1,170854,170854,170855,0,1,1
48722,4,1,170858,170858,170859,0,1,3
48723,2,3,170860,170860,170863,0,3,1
48724,2,1,170862,170863,170864,1,2,0
48725,1,1,170863,170864,170865,1,2,0
48726,3,1,170866,170866,170867,0,1,1
48727,4,1,170870,170870,170871,0,1,3
48728,3,3,170873,170873,170876,0,3,2
48729,1,3,170874,170876,170879,2,5,0
48730,1,2,170875,170879,170881,4,6,0
48731,6,1,170881,170881,170882,0,1,0
48732,2,2,170883,170883,170885,0,2,1
48733,2,3,170885,170885,170888,0,3,0
48734,1,3,170886,170888,170891,2,5,0
48735,2,1,170888,170891,170892,3,4,0
48736,1,1,170889,170892,170893,3,4,0
48737,3,1,170892,170893,170894,1,2,0
48738,5,3,170897,170897,170900,0,3,3
48739,3,3,170900,170900,170903,0,3,0
48740,2,2,170902,170903,170905,1,3,0
48741,5,3,170907,170907,170910,0,3,2
48742,2,1,170909,170910,170911,1,2,0
48743,1,3,170910,170911,170914,1,4,0
48744,5,1,170915,170915,170916,0,1,1
48745,1,2,170916,170916,170918,0,2,0
48746,1,3,170917,170918,170921,1,4,0
48747,2,3,170919,170921,170924,2,5,0
48748,3,1,170922,170924,170925,2,3,0
48749,4,3,170926,170926,170929,0,3,1
48750,4,3,170930,170930,170933,0,3,1
48751,5,1,170935,170935,170936,0,1,2
48752,4,2,170939,170939,170941,0,2,3
48753,4,3,170943,170943,170946,0,3,2
48754,2,3,170945,170946,170949,1,4,0
48755,6,1,170951,170951,170952,0,1,2
48756,1,3,170952,170952,170955,0,3,0
48757,4,2,170956,170956,170958,0,2,1
48758,2,3,170958,170958,170961,0,3,0
48759,1,3,170959,170961,170964,2,5,0
48760,6,2,170965,170965,170967,0,2,1
48761,1,2,170966,170967,170969,1,3,0
48762,3,3,170969,170969,170972,0,3,0
48763,2,3,170971,170972,170975,1,4,0
48764,4,2,170975,170975,170977,0,2,0
48765,5,3,170980,170980,170983,0,3,3
48766,4,1,170984,170984,170985,0,1,1
48767,4,1,170988,170988,170989,0,1,3
48768,6,2,170994,170994,170996,0,2,5
48769,6,2,171000,171000,171002,0,2,4
48770,4,2,171004,171004,171006,0,2,2
48771,4,3,171008,171008,171011,0,3,2
48772,2,1,171010,171011,171012,1,2,0
48773,1,1,171011,171012,171013,1,2,0
48774,6,1,171017,171017,171018,0,1,4
48775,5,2,171022,171022,171024,0,2,4
48776,2,3,171024,171024,171027,0,3,0
48777,5,3,171029,171029,171032,0,3,2
48778,5,2,171034,171034,171036,0,2,2
48779,6,2,171040,171040,171042,0,2,4
48780,1,2,171041,171042,171044,1,3,0
48781,1,1,171042,171044,171045,2,3,0
48782,4,3,171046,171046,171049,0,3,1
48783,5,1,171051,171051,171052,0,1,2
48784,4,1,171055,171055,171056,0,1,3
48785,4,3,171059,171059,171062,0,3,3
48786,3,2,171062,171062,171064,0,2,0
48787,1,1,171063,171064,171065,1,2,0
48788,6,3,171069,171069,171072,0,3,4
48789,5,2,171074,171074,171076,0,2,2
48790,5,2,171079,171079,171081,0,2,3
48791,3,2,171082,171082,171084,0,2,1
48792,5,2,171087,171087,171089,0,2,3
48793,1,2,171088,171089,171091,1,3,0
48794,6,2,171094,171094,171096,0,2,3
48795,2,1,171096,171096,171097,0,1,0
48796,5,2,171101,171101,171103,0,2,4
48797,4,2,171105,171105,171107,0,2,2
48798,2,2,171107,171107,171109,0,2,0
48799,4,2,171111,171111,171113,0,2,2
48800,3,1,171114,171114,171115,0,1,1
48801,4,1,171118,171118,171119,0,1,3
48802,1,3,171119,171119,171122,0,3,0
48803,2,3,171121,171122,171125,1,4,0
48804,4,2,171125,171125,171127,0,2,0
48805,5,2,171130,171130,171132,0,2,3
48806,1,2,171131,171132,171134,1,3,0
48807,6,2,171137,171137,171139,0,2,3
48808,1,2,171138,171139,171141,1,3,0
48809,5,3,171143,171143,171146,0,3,2
48810,5,1,171148,171148,171149,0,1,2
48811,4,2,171152,171152,171154,0,2,3
48812,6,1,171158,171158,171159,0,1,4
48813,3,1,171161,171161,171162,0,1,2
48814,4,3,171165,171165,171168,0,3,3
48815,2,3,171167,171168,171171,1,4,0
48816,5,1,171172,171172,171173,0,1,1
48817,5,1,171177,171177,171178,0,1,4
48818,5,1,171182,171182,171183,0,1,4
48819,5,3,171187,171187,171190,0,3,4
48820,2,3,171189,171190,171193,1,4,0
48821,4,3,171193,171193,171196,0,3,0
48822,6,3,171199,171199,171202,0,3,3
48823,6,2,171205,171205,171207,0,2,3
48824,6,2,171211,171211,171213,0,2,4
48825,6,3,171217,171217,171220,0,3,4
48826,5,2,171222,171222,171224,0,2,2
48827,5,1,171227,171227,171228,0,1,3
48828,3,1,171230,171230,171231,0,1,2
48829,3,2,171233,171233,171235,0,2,2
48830,5,1,171238,171238,171239,0,1,3
48831,2,1,171240,171240,171241,0,1,1
48832,1,2,171241,171241,171243,0,2,0
48833,3,2,171244,171244,171246,0,2,1
48834,4,2,171248,171248,171250,0,2,2
48835,3,3,171251,171251,171254,0,3,1
48836,3,2,171254,171254,171256,0,2,0
48837,5,1,171259,171259,171260,0,1,3
48838,5,2,171264,171264,171266,0,2,4
48839,1,1,171265,171266,171267,1,2,0
48840,4,3,171269,171269,171272,0,3,2
48841,4,2,171273,171273,171275,0,2,1
48842,3,1,171276,171276,171277,0,1,1
48843,2,3,171278,171278,171281,0,3,1
48844,4,2,171282,171282,171284,0,2,1
48845,2,1,171284,171284,171285,0,1,0
48846,6,3,171290,171290,171293,0,3,5
48847,1,2,171291,171293,171295,2,4,0
48848,5,2,171296,171296,171298,0,2,1
48849,6,2,171302,171302,171304,0,2,4
48850,4,2,171306,171306,171308,0,2,2
48851,4,1,171310,171310,171311,0,1,2
48852,1,3,171311,171311,171314,0,3,0
48853,4,1,171315,171315,171316,0,1,1
48854,4,1,171319,171319,171320,0,1,3
48855,6,2,171325,171325,171327,0,2,5
48856,5,2,171330,171330,171332,0,2,3
48857,6,2,171336,171336,171338,0,2,4
48858,6,3,171342,171342,171345,0,3,4
48859,3,2,171345,171345,171347,0,2,0
48860,4,2,171349,171349,171351,0,2,2
48861,4,1,171353,171353,171354,0,1,2
48862,2,1,171355,171355,171356,0,1,1
48863,4,2,171359,171359,171361,0,2,3
48864,4,3,171363,171363,171366,0,3,2
48865,4,2,171367,171367,171369,0,2,1
48866,1,3,171368,171369,171372,1,4,0
48867,6,2,171374,171374,171376,0,2,2
48868,2,1,171376,171376,171377,0,1,0
48869,3,3,171379,171379,171382,0,3,2
48870,6,1,171385,171385,171386,0,1,3
48871,6,2,171391,171391,171393,0,2,5
48872,5,1,171396,171396,171397,0,1,3
48873,3,2,171399,171399,171401,0,2,2
48874,3,1,171402,171402,171403,0,1,1
48875,5,3,171407,171407,171410,0,3,4
48876,3,2,171410,171410,171412,0,2,0
48877,6,1,171416,171416,171417,0,1,4
48878,4,1,171420,171420,171421,0,1,3
48879,1,3,171421,171421,171424,0,3,0
48880,4,1,171425,171425,171426,0,1,1
48881,1,3,171426,171426,171429,0,3,0
48882,2,3,171428,171429,171432,1,4,0
48883,4,2,171432,171432,171434,0,2,0
48884,3,1,171435,171435,171436,0,1,1
48885,2,2,171437,171437,171439,0,2,1
48886,3,1,171440,171440,171441,0,1,1
48887,1,3,171441,171441,171444,0,3,0
48888,4,1,171445,171445,171446,0,1,1
48889,2,2,171447,171447,171449,0,2,1
48890,6,2,171453,171453,171455,0,2,4
48891,4,3,171457,171457,171460,0,3,2
48892,1,2,171458,171460,171462,2,4,0
48893,2,1,171460,171462,171463,2,3,0
48894,1,3,171461,171463,171466,2,5,0
48895,5,1,171466,171466,171467,0,1,0
48896,5,1,171471,171471,171472,0,1,4
48897,6,1,171477,171477,171478,0,1,5
48898,1,2,171478,171478,171480,0,2,0
48899,4,2,171482,171482,171484,0,2,2
48900,5,1,171487,171487,171488,0,1,3
48901,5,1,171492,171492,171493,0,1,4
48902,5,1,171497,171497,171498,0,1,4
48903,4,3,171501,171501,171504,0,3,3
48904,6,1,171507,171507,171508,0,1,3
48905,6,3,171513,171513,171516,0,3,5
48906,1,2,171514,171516,171518,2,4,0
48907,3,3,171517,171518,171521,1,4,0
48908,6,2,171523,171523,171525,0,2,2
48909,2,2,171525,171525,171527,0,2,0
48910,2,3,171527,171527,171530,0,3,0
48911,6,1,171533,171533,171534,0,1,3
48912,1,2,171534,171534,171536,0,2,0
48913,5,1,171539,171539,171540,0,1,3
48914,1,1,171540,171540,171541,0,1,0
48915,1,1,171541,171541,171542,0,1,0
48916,3,3,171544,171544,171547,0,3,2
48917,3,3,171547,171547,171550,0,3,0
48918,4,3,171551,171551,171554,0,3,1
48919,6,3,171557,171557,171560,0,3,3
48920,2,3,171559,171560,171563,1,4,0
48921,3,1,171562,171563,171564,1,2,0
48922,6,3,171568,171568,171571,0,3,4
48923,2,1,171570,171571,171572,1,2,0
48924,4,2,171574,171574,171576,0,2,2
48925,3,2,171577,171577,171579,0,2,1
48926,3,3,171580,171580,171583,0,3,1
48927,5,2,171585,171585,171587,0,2,2
48928,5,1,171590,171590,171591,0,1,3
48929,3,3,171593,171593,171596,0,3,2
48930,1,1,171594,171596,171597,2,3,0
48931,6,2,171600,171600,171602,0,2,3
48932,4,1,171604,171604,171605,0,1,2
48933,2,2,171606,171606,171608,0,2,1
48934,4,1,171610,171610,171611,0,1,2
48935,2,3,171612,171612,171615,0,3,1
48936,6,1,171618,171618,171619,0,1,3
48937,2,1,171620,171620,171621,0,1,1
48938,5,1,171625,171625,171626,0,1,4
48939,5,3,171630,171630,171633,0,3,4
48940,2,3,171632,171633,171636,1,4,0
48941,3,2,171635,171636,171638,1,3,0
48942,5,3,171640,171640,171643,0,3,2
48943,1,3,171641,171643,171646,2,5,0
48944,1,2,171642,171646,171648,4,6,0
48945,3,1,171645,171648,171649,3,4,0
48946,2,2,171647,171649,171651,2,4,0
48947,1,3,171648,171651,171654,3,6,0
48948,1,2,171649,171654,171656,5,7,0
48949,4,3,171653,171656,171659,3,6,0
48950,4,2,171657,171659,171661,2,4,0
48951,4,2,171661,171661,171663,0,2,0
48952,1,2,171662,171663,171665,1,3,0
48953,4,3,171666,171666,171669,0,3,1
48954,2,3,171668,171669,171672,1,4,0
48955,6,3,171674,171674,171677,0,3,2
48956,6,3,171680,171680,171683,0,3,3
48957,3,3,171683,171683,171686,0,3,0
48958,5,1,171688,171688,171689,0,1,2
48959,4,1,171692,171692,171693,0,1,3
48960,3,2,171695,171695,171697,0,2,2
48961,2,3,171697,171697,171700,0,3,0
48962,1,1,171698,171700,171701,2,3,0
48963,1,1,171699,171701,171702,2,3,0
48964,1,3,171700,171702,171705,2,5,0
48965,1,1,171701,171705,171706,4,5,0
48966,6,3,171707,171707,171710,0,3,1
48967,2,2,171709,171710,171712,1,3,0
48968,6,2,171715,171715,171717,0,2,3
48969,2,1,171717,171717,171718,0,1,0
48970,3,1,171720,171720,171721,0,1,2
48971,5,3,171725,171725,171728,0,3,4
48972,1,3,171726,171728,171731,2,5,0
48973,3,3,171729,171731,171734,2,5,0
48974,2,2,171731,171734,171736,3,5,0
48975,6,3,171737,171737,171740,0,3,1
48976,5,2,171742,171742,171744,0,2,2
48977,5,3,171747,171747,171750,0,3,3
48978,4,2,171751,171751,171753,0,2,1
48979,2,3,171753,171753,171756,0,3,0
48980,1,1,171754,171756,171757,2,3,0
48981,3,2,171757,171757,171759,0,2,0
48982,1,1,171758,171759,171760,1,2,0
48983,5,2,171763,171763,171765,0,2,3
48984,3,2,171766,171766,171768,0,2,1
48985,6,3,171772,171772,171775,0,3,4
48986,3,3,171775,171775,171778,0,3,0
48987,1,1,171776,171778,171779,2,3,0
48988,2,1,171778,171779,171780,1,2,0
48989,6,1,171784,171784,171785,0,1,4
48990,4,1,171788,171788,171789,0,1,3
48991,3,2,171791,171791,171793,0,2,2
48992,5,1,171796,171796,171797,0,1,3
48993,2,1,171798,171798,171799,0,1,1
48994,1,3,171799,171799,171802,0,3,0
48995,6,3,171805,171805,171808,0,3,3
48996,6,1,171811,171811,171812,0,1,3
48997,3,3,171814,171814,171817,0,3,2
48998,2,3,171816,171817,171820,1,4,0
48999,5,3,171821,171821,171824,0,3,1
49000,3,3,171824,171824,171827,0,3,0
49001,3,2,171827,171827,171829,0,2,0
49002,3,3,171830,171830,171833,0,3,1
49003,1,1,171831,171833,171834,2,3,0
49004,6,1,171837,171837,171838,0,1,3
49005,3,1,171840,171840,171841,0,1,2
49006,2,3,171842,171842,171845,0,3,1
49007,3,2,171845,171845,171847,0,2,0
49008,2,2,171847,171847,171849,0,2,0
49009,6,1,171853,171853,171854,0,1,4
49010,1,3,171854,171854,171857,0,3,0
49011,6,2,171860,171860,171862,0,2,3
49012,6,1,171866,171866,171867,0,1,4
49013,5,3,171871,171871,171874,0,3,4
49014,5,2,171876,171876,171878,0,2,2
49015,6,2,171882,171882,171884,0,2,4
49016,1,3,171883,171884,171887,1,4,0
49017,5,2,171888,171888,171890,0,2,1
49018,2,1,171890,171890,171891,0,1,0
49019,1,3,171891,171891,171894,0,3,0
49020,1,2,171892,171894,171896,2,4,0
49021,2,1,171894,171896,171897,2,3,0
49022,2,1,171896,171897,171898,1,2,0
49023,6,1,171902,171902,171903,0,1,4
49024,6,1,171908,171908,171909,0,1,5
49025,4,2,171912,171912,171914,0,2,3
49026,2,3,171914,171914,171917,0,3,0
49027,5,3,171919,171919,171922,0,3,2
49028,2,2,171921,171922,171924,1,3,0
49029,2,2,171923,171924,171926,1,3,0
49030,6,2,171929,171929,171931,0,2,3
49031,6,3,171935,171935,171938,0,3,4
49032,3,2,171938,171938,171940,0,2,0
49033,3,2,171941,171941,171943,0,2,1
49034,2,2,171943,171943,171945,0,2,0
49035,3,2,171946,171946,171948,0,2,1
49036,3,2,171949,171949,171951,0,2,1
49037,6,3,171955,171955,171958,0,3,4
49038,4,1,171959,171959,171960,0,1,1
49039,2,1,171961,171961,171962,0,1,1
49040,3,3,171964,171964,171967,0,3,2
49041,6,3,171970,171970,171973,0,3,3
49042,1,1,171971,171973,171974,2,3,0
49043,1,1,171972,171974,171975,2,3,0
49044,6,3,171978,171978,171981,0,3,3
49045,1,1,171979,171981,171982,2,3,0
49046,5,1,171984,171984,171985,0,1,2
49047,3,1,171987,171987,171988,0,1,2
49048,5,3,171992,171992,171995,0,3,4
49049,3,3,171995,171995,171998,0,3,0
49050,5,2,172000,172000,172002,0,2,2
49051,6,1,172006,172006,172007,0,1,4
49052,1,1,172007,172007,172008,0,1,0
49053,1,3,172008,172008,172011,0,3,0
49054,4,2,172012,172012,172014,0,2,1
49055,5,1,172017,172017,172018,0,1,3
49056,6,1,172023,172023,172024,0,1,5
49057,2,3,172025,172025,172028,0,3,1
49058,6,2,172031,172031,172033,0,2,3
49059,6,3,172037,172037,172040,0,3,4
49060,2,1,172039,172040,172041,1,2,0
49061,6,1,172045,172045,172046,0,1,4
49062,4,1,172049,172049,172050,0,1,3
49063,3,3,172052,172052,172055,0,3,2
49064,6,1,172058,172058,172059,0,1,3
49065,5,2,172063,172063,172065,0,2,4
49066,4,2,172067,172067,172069,0,2,2
49067,1,3,172068,172069,172072,1,4,0
49068,5,2,172073,172073,172075,0,2,1
49069,4,3,172077,172077,172080,0,3,2
49070,1,1,172078,172080,172081,2,3,0
49071,5,1,172083,172083,172084,0,1,2
49072,1,3,172084,172084,172087,0,3,0
49073,3,3,172087,172087,172090,0,3,0
49074,6,2,172093,172093,172095,0,2,3
49075,2,3,172095,172095,172098,0,3,0
49076,3,2,172098,172098,172100,0,2,0
49077,3,3,172101,172101,172104,0,3,1
49078,4,3,172105,172105,172108,0,3,1
49079,6,2,172111,172111,172113,0,2,3
49080,2,3,172113,172113,172116,0,3,0
49081,6,1,172119,172119,172120,0,1,3
49082,4,2,172123,172123,172125,0,2,3
49083,4,2,172127,172127,172129,0,2,2
49084,3,2,172130,172130,172132,0,2,1
49085,4,2,172134,172134,172136,0,2,2
49086,4,3,172138,172138,172141,0,3,2
49087,1,3,172139,172141,172144,2,5,0
49088,3,3,172142,172144,172147,2,5,0
49089,3,3,172145,172147,172150,2,5,0
49090,5,2,172150,172150,172152,0,2,0
49091,4,1,172154,172154,172155,0,1,2
49092,1,3,172155,172155,172158,0,3,0
49093,2,1,172157,172158,172159,1,2,0
49094,3,2,172160,172160,172162,0,2,1
49095,5,3,172165,172165,172168,0,3,3
49096,1,3,172166,172168,172171,2,5,0
49097,6,2,172172,172172,172174,0,2,1
49098,4,1,172176,172176,172177,0,1,2
49099,1,3,172177,172177,172180,0,3,0
49100,3,1,172180,172180,172181,0,1,0
49101,1,2,172181,172181,172183,0,2,0
49102,4,1,172185,172185,172186,0,1,2
49103,6,2,172191,172191,172193,0,2,5
49104,6,2,172197,172197,172199,0,2,4
49105,5,2,172202,172202,172204,0,2,3
49106,2,3,172204,172204,172207,0,3,0
49107,1,1,172205,172207,172208,2,3,0
49108,2,1,172207,172208,172209,1,2,0
49109,4,3,172211,172211,172214,0,3,2
49110,2,1,172213,172214,172215,1,2,0
49111,3,1,172216,172216,172217,0,1,1
49112,3,2,172219,172219,172221,0,2,2
49113,2,1,172221,172221,172222,0,1,0
49114,5,2,172226,172226,172228,0,2,4
49115,5,2,172231,172231,172233,0,2,3
49116,2,1,172233,172233,172234,0,1,0
49117,5,2,172238,172238,172240,0,2,4
49118,2,2,172240,172240,172242,0,2,0
49119,5,2,172245,172245,172247,0,2,3
49120,5,3,172250,172250,172253,0,3,3
49121,4,1,172254,172254,172255,0,1,1
49122,5,3,172259,172259,172262,0,3,4
49123,1,3,172260,172262,172265,2,5,0
49124,6,2,172266,172266,172268,0,2,1
49125,5,3,172271,172271,172274,0,3,3
49126,6,2,172277,172277,172279,0,2,3
49127,1,3,172278,172279,172282,1,4,0
49128,1,1,172279,172282,172283,3,4,0
49129,4,1,172283,172283,172284,0,1,0
49130,2,2,172285,172285,172287,0,2,1
49131,4,3,172289,172289,172292,0,3,2
49132,3,2,172292,172292,172294,0,2,0
49133,6,2,172298,172298,172300,0,2,4
49134,3,2,172301,172301,172303,0,2,1
49135,2,3,172303,172303,172306,0,3,0
49136,5,3,172308,172308,172311,0,3,2
49137,6,2,172314,172314,172316,0,2,3
49138,3,3,172317,172317,172320,0,3,1
49139,5,2,172322,172322,172324,0,2,2
49140,1,3,172323,172324,172327,1,4,0
49141,4,3,172327,172327,172330,0,3,0
49142,5,2,172332,172332,172334,0,2,2
49143,5,3,172337,172337,172340,0,3,3
49144,3,2,172340,172340,172342,0,2,0
49145,4,2,172344,172344,172346,0,2,2
49146,6,3,172350,172350,172353,0,3,4
49147,1,3,172351,172353,172356,2,5,0
49148,2,1,172353,172356,172357,3,4,0
49149,2,1,172355,172357,172358,2,3,0
49150,2,2,172357,172358,172360,1,3,0
49151,4,1,172361,172361,172362,0,1,1
49152,5,2,172366,172366,172368,0,2,4
49153,1,2,172367,172368,172370,1,3,0
49154,5,2,172372,172372,172374,0,2,2
49155,3,1,172375,172375,172376,0,1,1
49156,1,3,172376,172376,172379,0,3,0
49157,5,1,172381,172381,172382,0,1,2
49158,4,3,172385,172385,172388,0,3,3
49159,2,3,172387,172388,172391,1,4,0
49160,2,3,172389,172391,172394,2,5,0
49161,3,2,172392,172394,172396,2,4,0
49162,5,1,172397,172397,172398,0,1,1
49163,1,3,172398,172398,172401,0,3,0
49164,4,2,172402,172402,172404,0,2,1
49165,1,1,172403,172404,172405,1,2,0
49166,6,1,172409,172409,172410,0,1,4
49167,4,2,172413,172413,172415,0,2,3
49168,6,3,172419,172419,172422,0,3,4
49169,6,2,172425,172425,172427,0,2,3
49170,5,3,172430,172430,172433,0,3,3
49171,3,1,172433,172433,172434,0,1,0
49172,3,2,172436,172436,172438,0,2,2
49173,5,1,172441,172441,172442,0,1,3
49174,6,2,172447,172447,172449,0,2,5
49175,4,3,172451,172451,172454,0,3,2
49176,2,3,172453,172454,172457,1,4,0
49177,4,3,172457,172457,172460,0,3,0
49178,1,2,172458,172460,172462,2,4,0
49179,2,2,172460,172462,172464,2,4,0
49180,6,2,172466,172466,172468,0,2,2
49181,6,2,172472,172472,172474,0,2,4
49182,3,2,172475,172475,172477,0,2,1
49183,1,3,172476,172477,172480,1,4,0
49184,3,3,172479,172480,172483,1,4,0
49185,2,1,172481,172483,172484,2,3,0
49186,1,1,172482,172484,172485,2,3,0
49187,5,1,172487,172487,172488,0,1,2
49188,2,1,172489,172489,172490,0,1,1
49189,6,2,172495,172495,172497,0,2,5
49190,4,2,172499,172499,172501,0,2,2
49191,3,3,172502,172502,172505,0,3,1
49192,3,1,172505,172505,172506,0,1,0
49193,4,2,172509,172509,172511,0,2,3
49194,5,2,172514,172514,172516,0,2,3
49195,6,3,172520,172520,172523,0,3,4
49196,3,1,172523,172523,172524,0,1,0
49197,2,2,172525,172525,172527,0,2,1
49198,5,1,172530,172530,172531,0,1,3
49199,3,3,172533,172533,172536,0,3,2
49200,4,3,172537,172537,172540,0,3,1
49201,3,1,172540,172540,172541,0,1,0
49202,6,2,172546,172546,172548,0,2,5
49203,2,1,172548,172548,172549,0,1,0
49204,6,1,172554,172554,172555,0,1,5
49205,3,2,172557,172557,172559,0,2,2
49206,4,3,172561,172561,172564,0,3,2
49207,1,1,172562,172564,172565,2,3,0
49208,5,2,172567,172567,172569,0,2,2
49209,5,3,172572,172572,172575,0,3,3
49210,2,3,172574,172575,172578,1,4,0
49211,2,2,172576,172578,172580,2,4,0
49212,5,2,172581,172581,172583,0,2,1
49213,2,2,172583,172583,172585,0,2,0
49214,2,1,172585,172585,172586,0,1,0
49215,3,1,172588,172588,172589,0,1,2
49216,4,1,172592,172592,172593,0,1,3
49217,4,3,172596,172596,172599,0,3,3
49218,6,1,172602,172602,172603,0,1,3
49219,2,1,172604,172604,172605,0,1,1
49220,6,2,172610,172610,172612,0,2,5
49221,5,2,172615,172615,172617,0,2,3
49222,5,3,172620,172620,172623,0,3,3
49223,5,3,172625,172625,172628,0,3,2
49224,6,1,172631,172631,172632,0,1,3
49225,4,1,172635,172635,172636,0,1,3
49226,1,3,172636,172636,172639,0,3,0
49227,2,3,172638,172639,172642,1,4,0
49228,4,3,172642,172642,172645,0,3,0
49229,5,1,172647,172647,172648,0,1,2
49230,2,1,172649,172649,172650,0,1,1
49231,6,3,172655,172655,172658,0,3,5
49232,6,3,172661,172661,172664,0,3,3
49233,1,2,172662,172664,172666,2,4,0
49234,2,1,172664,172666,172667,2,3,0
49235,6,2,172670,172670,172672,0,2,3
49236,3,3,172673,172673,172676,0,3,1
49237,4,1,172677,172677,172678,0,1,1
49238,6,2,172683,172683,172685,0,2,5
49239,3,3,172686,172686,172689,0,3,1
49240,5,3,172691,172691,172694,0,3,2
49241,1,1,172692,172694,172695,2,3,0
49242,1,3,172693,172695,172698,2,5,0
49243,1,1,172694,172698,172699,4,5,0
49244,3,3,172697,172699,172702,2,5,0
49245,4,2,172701,172702,172704,1,3,0
49246,1,3,172702,172704,172707,2,5,0
49247,3,1,172705,172707,172708,2,3,0
49248,3,3,172708,172708,172711,0,3,0
49249,6,2,172714,172714,172716,0,2,3
49250,4,1,172718,172718,172719,0,1,2
49251,1,3,172719,172719,172722,0,3,0
49252,1,1,172720,172722,172723,2,3,0
49253,2,2,172722,172723,172725,1,3,0
49254,3,2,172725,172725,172727,0,2,0
49255,6,1,172731,172731,172732,0,1,4
49256,1,1,172732,172732,172733,0,1,0
49257,5,3,172737,172737,172740,0,3,4
49258,4,3,172741,172741,172744,0,3,1
49259,6,3,172747,172747,172750,0,3,3
49260,6,3,172753,172753,172756,0,3,3
49261,6,2,172759,172759,172761,0,2,3
49262,3,2,172762,172762,172764,0,2,1
49263,6,1,172768,172768,172769,0,1,4
49264,3,3,172771,172771,172774,0,3,2
49265,2,3,172773,172774,172777,1,4,0
49266,6,1,172779,172779,172780,0,1,2
49267,1,2,172780,172780,172782,0,2,0
49268,5,1,172785,172785,172786,0,1,3
49269,2,2,172787,172787,172789,0,2,1
49270,5,1,172792,172792,172793,0,1,3
49271,2,1,172794,172794,172795,0,1,1
49272,5,2,172799,172799,172801,0,2,4
49273,2,1,172801,172801,172802,0,1,0
49274,3,1,172804,172804,172805,0,1,2
49275,2,1,172806,172806,172807,0,1,1
49276,4,2,172810,172810,172812,0,2,3
49277,2,3,172812,172812,172815,0,3,0
49278,6,1,172818,172818,172819,0,1,3
49279,4,3,172822,172822,172825,0,3,3
49280,2,3,172824,172825,172828,1,4,0
49281,1,1,172825,172828,172829,3,4,0
49282,1,3,172826,172829,172832,3,6,0
49283,5,1,172831,172832,172833,1,2,0
49284,6,2,172837,172837,172839,0,2,4
49285,6,3,172843,172843,172846,0,3,4
49286,4,3,172847,172847,172850,0,3,1
49287,5,3,172852,172852,172855,0,3,2
49288,3,1,172855,172855,172856,0,1,0
49289,2,3,172857,172857,172860,0,3,1
49290,6,2,172863,172863,172865,0,2,3
49291,6,3,172869,172869,172872,0,3,4
49292,5,1,172874,172874,172875,0,1,2
49293,1,2,172875,172875,172877,0,2,0
49294,1,2,172876,172877,172879,1,3,0
49295,3,2,172879,172879,172881,0,2,0
49296,1,2,172880,172881,172883,1,3,0
49297,4,3,172884,172884,172887,0,3,1
49298,5,3,172889,172889,172892,0,3,2
49299,2,3,172891,172892,172895,1,4,0
49300,2,1,172893,172895,172896,2,3,0
49301,2,1,172895,172896,172897,1,2,0
49302,4,1,172899,172899,172900,0,1,2
49303,1,1,172900,172900,172901,0,1,0
49304,5,3,172905,172905,172908,0,3,4
49305,3,2,172908,172908,172910,0,2,0
49306,3,1,172911,172911,172912,0,1,1
49307,4,1,172915,172915,172916,0,1,3
49308,5,2,172920,172920,172922,0,2,4
49309,6,3,172926,172926,172929,0,3,4
49310,5,2,172931,172931,172933,0,2,2
49311,4,2,172935,172935,172937,0,2,2
49312,3,3,172938,172938,172941,0,3,1
49313,1,3,172939,172941,172944,2,5,0
49314,3,1,172942,172944,172945,2,3,0
49315,4,2,172946,172946,172948,0,2,1
49316,1,1,172947,172948,172949,1,2,0
49317,1,2,172948,172949,172951,1,3,0
49318,2,1,172950,172951,172952,1,2,0
49319,4,2,172954,172954,172956,0,2,2
49320,4,3,172958,172958,172961,0,3,2
49321,2,1,172960,172961,172962,1,2,0
49322,1,2,172961,172962,172964,1,3,0
49323,4,3,172965,172965,172968,0,3,1
49324,6,2,172971,172971,172973,0,2,3
49325,2,2,172973,172973,172975,0,2,0
49326,1,3,172974,172975,172978,1,4,0
49327,6,1,172980,172980,172981,0,1,2
49328,5,2,172985,172985,172987,0,2,4
49329,4,3,172989,172989,172992,0,3,2
49330,3,2,172992,172992,172994,0,2,0
49331,6,2,172998,172998,173000,0,2,4
49332,5,2,173003,173003,173005,0,2,3
49333,3,1,173006,173006,173007,0,1,1
49334,6,1,173012,173012,173013,0,1,5
49335,1,1,173013,173013,173014,0,1,0
49336,5,1,173018,173018,173019,0,1,4
49337,6,1,173024,173024,173025,0,1,5
49338,6,3,173030,173030,173033,0,3,5
49339,5,2,173035,173035,173037,0,2,2
49340,4,2,173039,173039,173041,0,2,2
49341,2,2,173041,173041,173043,0,2,0
49342,4,3,173045,173045,173048,0,3,2
49343,2,2,173047,173048,173050,1,3,0
49344,1,1,173048,173050,173051,2,3,0
49345,4,1,173052,173052,173053,0,1,1
49346,2,1,173054,173054,173055,0,1,1
49347,5,2,173059,173059,173061,0,2,4
49348,4,2,173063,173063,173065,0,2,2
49349,1,1,173064,173065,173066,1,2,0
49350,4,1,173068,173068,173069,0,1,2
49351,3,1,173071,173071,173072,0,1,2
49352,6,1,173077,173077,173078,0,1,5
49353,4,3,173081,173081,173084,0,3,3
49354,3,1,173084,173084,173085,0,1,0
49355,6,3,173090,173090,173093,0,3,5
49356,1,3,173091,173093,173096,2,5,0
49357,6,2,173097,173097,173099,0,2,1
49358,5,1,173102,173102,173103,0,1,3
49359,3,2,173105,173105,173107,0,2,2
49360,4,3,173109,173109,173112,0,3,2
49361,4,3,173113,173113,173116,0,3,1
49362,4,1,173117,173117,173118,0,1,1
49363,5,3,173122,173122,173125,0,3,4
49364,1,1,173123,173125,173126,2,3,0
49365,4,1,173127,173127,173128,0,1,1
49366,6,2,173133,173133,173135,0,2,5
49367,4,2,173137,173137,173139,0,2,2
49368,2,2,173139,173139,173141,0,2,0
49369,4,1,173143,173143,173144,0,1,2
49370,4,2,173147,173147,173149,0,2,3
49371,3,3,173150,173150,173153,0,3,1
49372,1,3,173151,173153,173156,2,5,0
49373,3,1,173154,173156,173157,2,3,0
49374,3,1,173157,173157,173158,0,1,0
49375,6,1,173163,173163,173164,0,1,5
49376,1,3,173164,173164,173167,0,3,0
49377,2,2,173166,173167,173169,1,3,0
49378,1,1,173167,173169,173170,2,3,0
49379,1,1,173168,173170,173171,2,3,0
49380,5,1,173173,173173,173174,0,1,2
49381,1,3,173174,173174,173177,0,3,0
49382,3,3,173177,173177,173180,0,3,0
49383,1,1,173178,173180,173181,2,3,0
49384,2,3,173180,173181,173184,1,4,0
49385,1,3,173181,173184,173187,3,6,0
49386,6,1,173187,173187,173188,0,1,0
49387,2,3,173189,173189,173192,0,3,1
49388,2,1,173191,173192,173193,1,2,0
49389,1,3,173192,173193,173196,1,4,0
49390,6,1,173198,173198,173199,0,1,2
49391,3,1,173201,173201,173202,0,1,2
49392,1,1,173202,173202,173203,0,1,0
49393,6,2,173208,173208,173210,0,2,5
49394,6,2,173214,173214,173216,0,2,4
49395,3,2,173217,173217,173219,0,2,1
49396,2,2,173219,173219,173221,0,2,0
49397,5,1,173224,173224,173225,0,1,3
49398,1,2,173225,173225,173227,0,2,0
49399,2,1,173227,173227,173228,0,1,0
49400,5,3,173232,173232,173235,0,3,4
49401,2,1,173234,173235,173236,1,2,0
49402,2,3,173236,173236,173239,0,3,0
49403,3,1,173239,173239,173240,0,1,0
49404,2,3,173241,173241,173244,0,3,1
49405,2,2,173243,173244,173246,1,3,0
49406,6,1,173249,173249,173250,0,1,3
49407,4,3,173253,173253,173256,0,3,3
49408,4,3,173257,173257,173260,0,3,1
49409,5,3,173262,173262,173265,0,3,2
49410,3,3,173265,173265,173268,0,3,0
49411,3,3,173268,173268,173271,0,3,0
49412,6,3,173274,173274,173277,0,3,3
49413,6,2,173280,173280,173282,0,2,3
49414,3,2,173283,173283,173285,0,2,1
49415,5,1,173288,173288,173289,0,1,3
49416,4,2,173292,173292,173294,0,2,3
49417,5,3,173297,173297,173300,0,3,3
49418,5,3,173302,173302,173305,0,3,2
49419,4,2,173306,173306,173308,0,2,1
49420,2,1,173308,173308,173309,0,1,0
49421,4,1,173312,173312,173313,0,1,3
49422,3,2,173315,173315,173317,0,2,2
49423,6,3,173321,173321,173324,0,3,4
49424,3,2,173324,173324,173326,0,2,0
49425,6,3,173330,173330,173333,0,3,4
49426,2,2,173332,173333,173335,1,3,0
49427,2,3,173334,173335,173338,1,4,0
49428,6,3,173340,173340,173343,0,3,2
49429,6,3,173346,173346,173349,0,3,3
49430,1,2,173347,173349,173351,2,4,0
49431,4,2,173351,173351,173353,0,2,0
49432,3,3,173354,173354,173357,0,3,1
49433,2,3,173356,173357,173360,1,4,0
49434,1,1,173357,173360,173361,3,4,0
49435,5,1,173362,173362,173363,0,1,1
49436,4,2,173366,173366,173368,0,2,3
49437,2,1,173368,173368,173369,0,1,0
49438,6,2,173374,173374,173376,0,2,5
49439,4,1,173378,173378,173379,0,1,2
49440,2,1,173380,173380,173381,0,1,1
49441,2,2,173382,173382,173384,0,2,1
49442,5,2,173387,173387,173389,0,2,3
49443,1,3,173388,173389,173392,1,4,0
49444,6,2,173394,173394,173396,0,2,2
49445,3,2,173397,173397,173399,0,2,1
49446,1,1,173398,173399,173400,1,2,0
49447,3,2,173401,173401,173403,0,2,1
49448,4,3,173405,173405,173408,0,3,2
49449,3,1,173408,173408,173409,0,1,0
49450,6,2,173414,173414,173416,0,2,5
49451,5,2,173419,173419,173421,0,2,3
49452,3,1,173422,173422,173423,0,1,1
49453,1,3,173423,173423,173426,0,3,0
49454,5,2,173428,173428,173430,0,2,2
49455,6,3,173434,173434,173437,0,3,4
49456,6,1,173440,173440,173441,0,1,3
49457,1,3,173441,173441,173444,0,3,0
49458,5,3,173446,173446,173449,0,3,2
49459,4,3,173450,173450,173453,0,3,1
49460,4,1,173454,173454,173455,0,1,1
49461,5,1,173459,173459,173460,0,1,4
49462,2,1,173461,173461,173462,0,1,1
49463,2,2,173463,173463,173465,0,2,1
49464,5,1,173468,173468,173469,0,1,3
49465,1,2,173469,173469,173471,0,2,0
49466,2,3,173471,173471,173474,0,3,0
49467,3,1,173474,173474,173475,0,1,0
49468,3,3,173477,173477,173480,0,3,2
49469,6,1,173483,173483,173484,0,1,3
49470,6,1,173489,173489,173490,0,1,5
49471,6,3,173495,173495,173498,0,3,5
49472,6,3,173501,173501,173504,0,3,3
49473,3,1,173504,173504,173505,0,1,0
49474,6,2,173510,173510,173512,0,2,5
49475,4,3,173514,173514,173517,0,3,2
49476,4,3,173518,173518,173521,0,3,1
49477,6,2,173524,173524,173526,0,2,3
49478,2,1,173526,173526,173527,0,1,0
49479,4,3,173530,173530,173533,0,3,3
49480,2,3,173532,173533,173536,1,4,0
49481,6,1,173538,173538,173539,0,1,2
49482,3,1,173541,173541,173542,0,1,2
49483,4,2,173545,173545,173547,0,2,3
49484,3,1,173548,173548,173549,0,1,1
49485,5,3,173553,173553,173556,0,3,4
49486,3,1,173556,173556,173557,0,1,0
49487,4,1,173560,173560,173561,0,1,3
49488,1,2,173561,173561,173563,0,2,0
49489,3,1,173564,173564,173565,0,1,1
49490,3,3,173567,173567,173570,0,3,2
49491,6,1,173573,173573,173574,0,1,3
49492,5,1,173578,173578,173579,0,1,4
49493,1,2,173579,173579,173581,0,2,0
49494,4,2,173583,173583,173585,0,2,2
49495,3,2,173586,173586,173588,0,2,1
49496,6,2,173592,173592,173594,0,2,4
49497,3,1,173595,173595,173596,0,1,1
49498,6,3,173601,173601,173604,0,3,5
49499,3,3,173604,173604,173607,0,3,0
49500,4,3,173608,173608,173611,0,3,1
49501,1,2,173609,173611,173613,2,4,0
49502,6,1,173615,173615,173616,0,1,2
49503,2,2,173617,173617,173619,0,2,1
49504,1,1,173618,173619,173620,1,2,0
49505,2,2,173620,173620,173622,0,2,0
49506,2,2,173622,173622,173624,0,2,0
49507,3,2,173625,173625,173627,0,2,1
49508,2,2,173627,173627,173629,0,2,0
49509,3,1,173630,173630,173631,0,1,1
49510,4,1,173634,173634,173635,0,1,3
49511,4,3,173638,173638,173641,0,3,3
49512,3,2,173641,173641,173643,0,2,0
49513,2,2,173643,173643,173645,0,2,0
49514,1,1,173644,173645,173646,1,2,0
49515,2,2,173646,173646,173648,0,2,0
49516,5,1,173651,173651,173652,0,1,3
49517,2,2,173653,173653,173655,0,2,1
49518,6,3,173659,173659,173662,0,3,4
49519,3,1,173662,173662,173663,0,1,0
49520,6,2,173668,173668,173670,0,2,5
49521,1,2,173669,173670,173672,1,3,0
49522,2,1,173671,173672,173673,1,2,0
49523,1,1,173672,173673,173674,1,2,0
49524,3,3,173675,173675,173678,0,3,1
49525,6,2,173681,173681,173683,0,2,3
49526,3,3,173684,173684,173687,0,3,1
49527,2,2,173686,173687,173689,1,3,0
49528,4,1,173690,173690,173691,0,1,1
49529,2,1,173692,173692,173693,0,1,1
49530,1,3,173693,173693,173696,0,3,0
49531,1,3,173694,173696,173699,2,5,0
49532,5,3,173699,173699,173702,0,3,0
49533,2,2,173701,173702,173704,1,3,0
49534,2,1,173703,173704,173705,1,2,0
49535,1,1,173704,173705,173706,1,2,0
49536,1,1,173705,173706,173707,1,2,0
49537,3,1,173708,173708,173709,0,1,1
49538,6,3,173714,173714,173717,0,3,5
49539,3,1,173717,173717,173718,0,1,0
49540,2,2,173719,173719,173721,0,2,1
49541,4,3,173723,173723,173726,0,3,2
49542,3,2,173726,173726,173728,0,2,0
49543,1,1,173727,173728,173729,1,2,0
49544,4,2,173731,173731,173733,0,2,2
49545,5,1,173736,173736,173737,0,1,3
49546,6,2,173742,173742,173744,0,2,5
49547,1,2,173743,173744,173746,1,3,0
49548,6,2,173749,173749,173751,0,2,3
49549,4,1,173753,173753,173754,0,1,2
49550,3,1,173756,173756,173757,0,1,2
49551,3,1,173759,173759,173760,0,1,2
49552,6,2,173765,173765,173767,0,2,5
49553,4,2,173769,173769,173771,0,2,2
49554,2,2,173771,173771,173773,0,2,0
49555,6,2,173777,173777,173779,0,2,4
49556,5,2,173782,173782,173784,0,2,3
49557,5,1,173787,173787,173788,0,1,3
49558,2,2,173789,173789,173791,0,2,1
49559,5,1,173794,173794,173795,0,1,3
49560,2,3,173796,173796,173799,0,3,1
49561,6,3,173802,173802,173805,0,3,3
49562,1,2,173803,173805,173807,2,4,0
49563,2,1,173805,173807,173808,2,3,0
49564,5,3,173810,173810,173813,0,3,2
49565,4,1,173814,173814,173815,0,1,1
49566,2,3,173816,173816,173819,0,3,1
49567,2,1,173818,173819,173820,1,2,0
49568,4,1,173822,173822,173823,0,1,2
49569,2,1,173824,173824,173825,0,1,1
49570,5,1,173829,173829,173830,0,1,4
49571,5,1,173834,173834,173835,0,1,4
49572,1,1,173835,173835,173836,0,1,0
49573,6,2,173841,173841,173843,0,2,5
49574,5,2,173846,173846,173848,0,2,3
49575,4,1,173850,173850,173851,0,1,2
49576,1,3,173851,173851,173854,0,3,0
49577,6,3,173857,173857,173860,0,3,3
49578,4,1,173861,173861,173862,0,1,1
49579,1,1,173862,173862,173863,0,1,0
49580,2,1,173864,173864,173865,0,1,1
49581,6,3,173870,173870,173873,0,3,5
49582,1,1,173871,173873,173874,2,3,0
49583,2,3,173873,173874,173877,1,4,0
49584,3,3,173876,173877,173880,1,4,0
49585,5,1,173881,173881,173882,0,1,1
49586,2,2,173883,173883,173885,0,2,1
49587,6,1,173889,173889,173890,0,1,4
49588,2,1,173891,173891,173892,0,1,1
49589,5,2,173896,173896,173898,0,2,4
49590,2,2,173898,173898,173900,0,2,0
49591,6,2,173904,173904,173906,0,2,4
49592,1,1,173905,173906,173907,1,2,0
49593,3,3,173908,173908,173911,0,3,1
49594,2,1,173910,173911,173912,1,2,0
49595,2,1,173912,173912,173913,0,1,0
49596,2,3,173914,173914,173917,0,3,1
49597,5,3,173919,173919,173922,0,3,2
49598,1,1,173920,173922,173923,2,3,0
49599,1,3,173921,173923,173926,2,5,0
49600,3,3,173924,173926,173929,2,5,0
49601,2,1,173926,173929,173930,3,4,0
49602,3,2,173929,173930,173932,1,3,0
49603,6,2,173935,173935,173937,0,2,3
49604,2,2,173937,173937,173939,0,2,0
49605,3,1,173940,173940,173941,0,1,1
49606,2,1,173942,173942,173943,0,1,1
49607,6,1,173948,173948,173949,0,1,5
49608,6,2,173954,173954,173956,0,2,5
49609,3,3,173957,173957,173960,0,3,1
49610,6,2,173963,173963,173965,0,2,3
49611,6,3,173969,173969,173972,0,3,4
49612,3,3,173972,173972,173975,0,3,0
49613,4,1,173976,173976,173977,0,1,1
49614,1,1,173977,173977,173978,0,1,0
49615,4,3,173981,173981,173984,0,3,3
49616,5,1,173986,173986,173987,0,1,2
49617,6,2,173992,173992,173994,0,2,5
49618,1,2,173993,173994,173996,1,3,0
49619,2,2,173995,173996,173998,1,3,0
49620,2,3,173997,173998,174001,1,4,0
49621,2,2,173999,174001,174003,2,4,0
49622,3,3,174002,174003,174006,1,4,0
49623,6,3,174008,174008,174011,0,3,2
49624,2,3,174010,174011,174014,1,4,0
49625,5,2,174015,174015,174017,0,2,1
49626,2,1,174017,174017,174018,0,1,0
49627,5,1,174022,174022,174023,0,1,4
49628,5,1,174027,174027,174028,0,1,4
49629,6,3,174033,174033,174036,0,3,5
49630,2,2,174035,174036,174038,1,3,0
49631,2,1,174037,174038,174039,1,2,0
49632,4,2,174041,174041,174043,0,2,2
49633,2,1,174043,174043,174044,0,1,0
49634,3,3,174046,174046,174049,0,3,2
49635,2,2,174048,174049,174051,1,3,0
49636,5,3,174053,174053,174056,0,3,2
49637,6,1,174059,174059,174060,0,1,3
49638,2,3,174061,174061,174064,0,3,1
49639,3,3,174064,174064,174067,0,3,0
49640,2,3,174066,174067,174070,1,4,0
49641,6,3,174072,174072,174075,0,3,2
49642,6,2,174078,174078,174080,0,2,3
49643,3,3,174081,174081,174084,0,3,1
49644,3,2,174084,174084,174086,0,2,0
49645,2,3,174086,174086,174089,0,3,0
49646,3,1,174089,174089,174090,0,1,0
49647,6,1,174095,174095,174096,0,1,5
49648,3,2,174098,174098,174100,0,2,2
49649,2,1,174100,174100,174101,0,1,0
49650,3,3,174103,174103,174106,0,3,2
49651,5,2,174108,174108,174110,0,2,2
49652,1,2,174109,174110,174112,1,3,0
49653,1,2,174110,174112,174114,2,4,0
49654,6,2,174116,174116,174118,0,2,2
49655,3,1,174119,174119,174120,0,1,1
49656,3,1,174122,174122,174123,0,1,2
49657,2,2,174124,174124,174126,0,2,1
49658,1,1,174125,174126,174127,1,2,0
49659,6,2,174131,174131,174133,0,2,4
49660,4,1,174135,174135,174136,0,1,2
49661,3,2,174138,174138,174140,0,2,2
49662,3,2,174141,174141,174143,0,2,1
49663,4,2,174145,174145,174147,0,2,2
49664,5,2,174150,174150,174152,0,2,3
49665,3,1,174153,174153,174154,0,1,1
49666,2,3,174155,174155,174158,0,3,1
49667,2,2,174157,174158,174160,1,3,0
49668,5,3,174162,174162,174165,0,3,2
49669,3,1,174165,174165,174166,0,1,0
49670,2,1,174167,174167,174168,0,1,1
49671,6,1,174173,174173,174174,0,1,5
49672,3,3,174176,174176,174179,0,3,2
49673,3,2,174179,174179,174181,0,2,0
49674,4,1,174183,174183,174184,0,1,2
49675,5,2,174188,174188,174190,0,2,4
49676,2,2,174190,174190,174192,0,2,0
49677,5,1,174195,174195,174196,0,1,3
49678,2,1,174197,174197,174198,0,1,1
49679,4,1,174201,174201,174202,0,1,3
49680,6,1,174207,174207,174208,0,1,5
49681,5,2,174212,174212,174214,0,2,4
49682,5,3,174217,174217,174220,0,3,3
49683,1,2,174218,174220,174222,2,4,0
49684,4,2,174222,174222,174224,0,2,0
49685,3,2,174225,174225,174227,0,2,1
49686,1,1,174226,174227,174228,1,2,0
49687,6,2,174232,174232,174234,0,2,4
49688,1,1,174233,174234,174235,1,2,0
49689,6,2,174239,174239,174241,0,2,4
49690,2,1,174241,174241,174242,0,1,0
49691,1,2,174242,174242,174244,0,2,0
49692,4,2,174246,174246,174248,0,2,2
49693,1,3,174247,174248,174251,1,4,0
49694,2,1,174249,174251,174252,2,3,0
49695,6,1,174255,174255,174256,0,1,3
49696,2,3,174257,174257,174260,0,3,1
49697,6,1,174263,174263,174264,0,1,3
49698,6,2,174269,174269,174271,0,2,5
49699,2,2,174271,174271,174273,0,2,0
49700,1,2,174272,174273,174275,1,3,0
49701,5,3,174277,174277,174280,0,3,2
49702,2,3,174279,174280,174283,1,4,0
49703,6,1,174285,174285,174286,0,1,2
49704,1,2,174286,174286,174288,0,2,0
49705,4,3,174290,174290,174293,0,3,2
49706,4,2,174294,174294,174296,0,2,1
49707,5,2,174299,174299,174301,0,2,3
49708,6,3,174305,174305,174308,0,3,4
49709,4,3,174309,174309,174312,0,3,1
49710,2,2,174311,174312,174314,1,3,0
49711,6,2,174317,174317,174319,0,2,3
49712,1,1,174318,174319,174320,1,2,0
49713,4,1,174322,174322,174323,0,1,2
49714,2,1,174324,174324,174325,0,1,1
49715,1,1,174325,174325,174326,0,1,0
49716,1,3,174326,174326,174329,0,3,0
49717,3,1,174329,174329,174330,0,1,0
49718,5,2,174334,174334,174336,0,2,4
49719,4,3,174338,174338,174341,0,3,2
49720,5,3,174343,174343,174346,0,3,2
49721,5,1,174348,174348,174349,0,1,2
49722,2,2,174350,174350,174352,0,2,1
49723,2,3,174352,174352,174355,0,3,0
49724,1,2,174353,174355,174357,2,4,0
49725,5,1,174358,174358,174359,0,1,1
49726,1,3,174359,174359,174362,0,3,0
49727,2,3,174361,174362,174365,1,4,0
49728,4,3,174365,174365,174368,0,3,0
49729,3,3,174368,174368,174371,0,3,0
49730,4,3,174372,174372,174375,0,3,1
49731,2,2,174374,174375,174377,1,3,0
49732,3,3,174377,174377,174380,0,3,0
49733,5,1,174382,174382,174383,0,1,2
49734,6,3,174388,174388,174391,0,3,5
49735,3,2,174391,174391,174393,0,2,0
49736,4,3,174395,174395,174398,0,3,2
49737,3,3,174398,174398,174401,0,3,0
49738,5,2,174403,174403,174405,0,2,2
49739,3,2,174406,174406,174408,0,2,1
49740,4,2,174410,174410,174412,0,2,2
49741,3,3,174413,174413,174416,0,3,1
49742,5,1,174418,174418,174419,0,1,2
49743,2,3,174420,174420,174423,0,3,1
49744,2,2,174422,174423,174425,1,3,0
49745,6,2,174428,174428,174430,0,2,3
49746,3,1,174431,174431,174432,0,1,1
49747,6,2,174437,174437,174439,0,2,5
49748,4,3,174441,174441,174444,0,3,2
49749,6,3,174447,174447,174450,0,3,3
49750,3,1,174450,174450,174451,0,1,0
49751,2,1,174452,174452,174453,0,1,1
49752,1,1,174453,174453,174454,0,1,0
49753,1,1,174454,174454,174455,0,1,0
49754,3,1,174457,174457,174458,0,1,2
49755,2,3,174459,174459,174462,0,3,1
49756,2,3,174461,174462,174465,1,4,0
49757,2,2,174463,174465,174467,2,4,0
49758,6,2,174469,174469,174471,0,2,2
49759,1,3,174470,174471,174474,1,4,0
49760,2,2,174472,174474,174476,2,4,0
49761,5,2,174477,174477,174479,0,2,1
49762,6,3,174483,174483,174486,0,3,4
49763,6,2,174489,174489,174491,0,2,3
49764,6,3,174495,174495,174498,0,3,4
49765,1,3,174496,174498,174501,2,5,0
49766,4,1,174500,174501,174502,1,2,0
49767,4,1,174504,174504,174505,0,1,2
49768,3,3,174507,174507,174510,0,3,2
49769,5,1,174512,174512,174513,0,1,2
49770,4,3,174516,174516,174519,0,3,3
49771,4,2,174520,174520,174522,0,2,1
49772,6,2,174526,174526,174528,0,2,4
49773,6,1,174532,174532,174533,0,1,4
49774,6,2,174538,174538,174540,0,2,5
49775,5,3,174543,174543,174546,0,3,3
49776,2,3,174545,174546,174549,1,4,0
49777,2,3,174547,174549,174552,2,5,0
49778,4,2,174551,174552,174554,1,3,0
49779,3,1,174554,174554,174555,0,1,0
49780,4,1,174558,174558,174559,0,1,3
49781,3,1,174561,174561,174562,0,1,2
49782,6,3,174567,174567,174570,0,3,5
49783,4,1,174571,174571,174572,0,1,1
49784,6,1,174577,174577,174578,0,1,5
49785,3,3,174580,174580,174583,0,3,2
49786,5,3,174585,174585,174588,0,3,2
49787,6,3,174591,174591,174594,0,3,3
49788,2,2,174593,174594,174596,1,3,0
49789,5,2,174598,174598,174600,0,2,2
49790,1,1,174599,174600,174601,1,2,0
49791,3,3,174602,174602,174605,0,3,1
49792,3,1,174605,174605,174606,0,1,0
49793,5,3,174610,174610,174613,0,3,4
49794,3,1,174613,174613,174614,0,1,0
49795,3,1,174616,174616,174617,0,1,2
49796,1,2,174617,174617,174619,0,2,0
49797,6,3,174623,174623,174626,0,3,4
49798,2,3,174625,174626,174629,1,4,0
49799,3,2,174628,174629,174631,1,3,0
49800,2,2,174630,174631,174633,1,3,0
49801,3,2,174633,174633,174635,0,2,0
49802,6,1,174639,174639,174640,0,1,4
49803,3,2,174642,174642,174644,0,2,2
49804,2,3,174644,174644,174647,0,3,0
49805,4,3,174648,174648,174651,0,3,1
49806,6,1,174654,174654,174655,0,1,3
49807,5,2,174659,174659,174661,0,2,4
49808,2,2,174661,174661,174663,0,2,0
49809,2,2,174663,174663,174665,0,2,0
49810,2,1,174665,174665,174666,0,1,0
49811,4,1,174669,174669,174670,0,1,3
49812,1,2,174670,174670,174672,0,2,0
49813,4,2,174674,174674,174676,0,2,2
49814,6,1,174680,174680,174681,0,1,4
49815,5,3,174685,174685,174688,0,3,4
49816,5,3,174690,174690,174693,0,3,2
49817,2,2,174692,174693,174695,1,3,0
49818,1,3,174693,174695,174698,2,5,0
49819,3,2,174696,174698,174700,2,4,0
49820,4,1,174700,174700,174701,0,1,0
49821,4,3,174704,174704,174707,0,3,3
49822,5,3,174709,174709,174712,0,3,2
49823,6,2,174715,174715,174717,0,2,3
49824,2,3,174717,174717,174720,0,3,0
49825,6,3,174723,174723,174726,0,3,3
49826,2,1,174725,174726,174727,1,2,0
49827,4,3,174729,174729,174732,0,3,2
49828,6,3,174735,174735,174738,0,3,3
49829,5,1,174740,174740,174741,0,1,2
49830,6,3,174746,174746,174749,0,3,5
49831,2,2,174748,174749,174751,1,3,0
49832,3,1,174751,174751,174752,0,1,0
49833,1,1,174752,174752,174753,0,1,0
49834,4,1,174756,174756,174757,0,1,3
49835,4,2,174760,174760,174762,0,2,3
49836,5,3,174765,174765,174768,0,3,3
49837,5,1,174770,174770,174771,0,1,2
49838,1,2,174771,174771,174773,0,2,0
49839,3,2,174774,174774,174776,0,2,1
49840,4,3,174778,174778,174781,0,3,2
49841,3,2,174781,174781,174783,0,2,0
49842,3,2,174784,174784,174786,0,2,1
49843,1,3,174785,174786,174789,1,4,0
49844,5,3,174790,174790,174793,0,3,1
49845,1,3,174791,174793,174796,2,5,0
49846,4,1,174795,174796,174797,1,2,0
49847,5,3,174800,174800,174803,0,3,3
49848,1,3,174801,174803,174806,2,5,0
49849,6,2,174807,174807,174809,0,2,1
49850,4,1,174811,174811,174812,0,1,2
49851,4,1,174815,174815,174816,0,1,3
49852,6,1,174821,174821,174822,0,1,5
49853,1,1,174822,174822,174823,0,1,0
49854,3,1,174825,174825,174826,0,1,2
49855,4,3,174829,174829,174832,0,3,3
49856,1,2,174830,174832,174834,2,4,0
49857,6,1,174836,174836,174837,0,1,2
49858,3,3,174839,174839,174842,0,3,2
49859,2,2,174841,174842,174844,1,3,0
49860,1,2,174842,174844,174846,2,4,0
49861,5,2,174847,174847,174849,0,2,1
49862,3,1,174850,174850,174851,0,1,1
49863,6,2,174856,174856,174858,0,2,5
49864,4,2,174860,174860,174862,0,2,2
49865,4,1,174864,174864,174865,0,1,2
49866,4,1,174868,174868,174869,0,1,3
49867,6,3,174874,174874,174877,0,3,5
49868,3,1,174877,174877,174878,0,1,0
49869,4,1,174881,174881,174882,0,1,3
49870,5,3,174886,174886,174889,0,3,4
49871,2,2,174888,174889,174891,1,3,0
49872,1,3,174889,174891,174894,2,5,0
49873,6,3,174895,174895,174898,0,3,1
49874,2,1,174897,174898,174899,1,2,0
49875,1,3,174898,174899,174902,1,4,0
49876,3,3,174901,174902,174905,1,4,0
49877,6,3,174907,174907,174910,0,3,2
49878,5,2,174912,174912,174914,0,2,2
49879,3,3,174915,174915,174918,0,3,1
49880,1,1,174916,174918,174919,2,3,0
49881,1,2,174917,174919,174921,2,4,0
49882,6,2,174923,174923,174925,0,2,2
49883,6,1,174929,174929,174930,0,1,4
49884,6,2,174935,174935,174937,0,2,5
49885,2,3,174937,174937,174940,0,3,0
49886,4,2,174941,174941,174943,0,2,1
49887,2,2,174943,174943,174945,0,2,0
49888,5,1,174948,174948,174949,0,1,3
49889,3,1,174951,174951,174952,0,1,2
49890,6,2,174957,174957,174959,0,2,5
49891,2,3,174959,174959,174962,0,3,0
49892,6,1,174965,174965,174966,0,1,3
49893,6,2,174971,174971,174973,0,2,5
49894,4,1,174975,174975,174976,0,1,2
49895,2,2,174977,174977,174979,0,2,1
49896,4,2,174981,174981,174983,0,2,2
49897,4,3,174985,174985,174988,0,3,2
49898,6,1,174991,174991,174992,0,1,3
49899,6,3,174997,174997,175000,0,3,5
49900,5,3,175002,175002,175005,0,3,2
49901,5,1,175007,175007,175008,0,1,2
49902,1,1,175008,175008,175009,0,1,0
49903,3,2,175011,175011,175013,0,2,2
49904,5,3,175016,175016,175019,0,3,3
49905,3,2,175019,175019,175021,0,2,0
49906,5,1,175024,175024,175025,0,1,3
49907,3,2,175027,175027,175029,0,2,2
49908,5,2,175032,175032,175034,0,2,3
49909,6,2,175038,175038,175040,0,2,4
49910,3,2,175041,175041,175043,0,2,1
49911,4,2,175045,175045,175047,0,2,2
49912,4,2,175049,175049,175051,0,2,2
49913,3,1,175052,175052,175053,0,1,1
49914,6,3,175058,175058,175061,0,3,5
49915,1,1,175059,175061,175062,2,3,0
49916,5,1,175064,175064,175065,0,1,2
49917,2,3,175066,175066,175069,0,3,1
49918,2,3,175068,175069,175072,1,4,0
49919,3,1,175071,175072,175073,1,2,0
49920,1,2,175072,175073,175075,1,3,0
49921,5,2,175077,175077,175079,0,2,2
49922,5,1,175082,175082,175083,0,1,3
49923,5,3,175087,175087,175090,0,3,4
49924,3,1,175090,175090,175091,0,1,0
49925,1,1,175091,175091,175092,0,1,0
49926,3,3,175094,175094,175097,0,3,2
49927,1,2,175095,175097,175099,2,4,0
49928,4,1,175099,175099,175100,0,1,0
49929,5,3,175104,175104,175107,0,3,4
49930,6,1,175110,175110,175111,0,1,3
49931,6,3,175116,175116,175119,0,3,5
49932,2,2,175118,175119,175121,1,3,0
49933,3,2,175121,175121,175123,0,2,0
49934,3,1,175124,175124,175125,0,1,1
49935,3,1,175127,175127,175128,0,1,2
49936,5,1,175132,175132,175133,0,1,4
49937,6,3,175138,175138,175141,0,3,5
49938,5,3,175143,175143,175146,0,3,2
49939,2,2,175145,175146,175148,1,3,0
49940,3,1,175148,175148,175149,0,1,0
49941,1,2,175149,175149,175151,0,2,0
49942,6,2,175155,175155,175157,0,2,4
49943,3,1,175158,175158,175159,0,1,1
49944,6,2,175164,175164,175166,0,2,5
49945,3,3,175167,175167,175170,0,3,1
49946,3,3,175170,175170,175173,0,3,0
49947,2,1,175172,175173,175174,1,2,0
49948,5,3,175177,175177,175180,0,3,3
49949,6,2,175183,175183,175185,0,2,3
49950,1,2,175184,175185,175187,1,3,0
49951,5,1,175189,175189,175190,0,1,2
49952,1,2,175190,175190,175192,0,2,0
49953,1,1,175191,175192,175193,1,2,0
49954,2,3,175193,175193,175196,0,3,0
49955,3,2,175196,175196,175198,0,2,0
49956,3,1,175199,175199,175200,0,1,1
49957,1,3,175200,175200,175203,0,3,0
49958,6,3,175206,175206,175209,0,3,3
49959,5,3,175211,175211,175214,0,3,2
49960,3,3,175214,175214,175217,0,3,0
49961,4,3,175218,175218,175221,0,3,1
49962,2,1,175220,175221,175222,1,2,0
49963,6,3,175226,175226,175229,0,3,4
49964,4,1,175230,175230,175231,0,1,1
49965,4,1,175234,175234,175235,0,1,3
49966,2,2,175236,175236,175238,0,2,1
49967,5,3,175241,175241,175244,0,3,3
49968,1,2,175242,175244,175246,2,4,0
49969,4,2,175246,175246,175248,0,2,0
49970,4,1,175250,175250,175251,0,1,2
49971,5,2,175255,175255,175257,0,2,4
49972,1,2,175256,175257,175259,1,3,0
49973,1,2,175257,175259,175261,2,4,0
49974,1,2,175258,175261,175263,3,5,0
49975,6,2,175264,175264,175266,0,2,1
49976,2,2,175266,175266,175268,0,2,0
49977,4,3,175270,175270,175273,0,3,2
49978,2,2,175272,175273,175275,1,3,0
49979,5,1,175277,175277,175278,0,1,2
49980,1,3,175278,175278,175281,0,3,0
49981,3,2,175281,175281,175283,0,2,0
49982,4,2,175285,175285,175287,0,2,2
49983,3,2,175288,175288,175290,0,2,1
49984,2,1,175290,175290,175291,0,1,0
49985,4,3,175294,175294,175297,0,3,3
49986,2,3,175296,175297,175300,1,4,0
49987,1,3,175297,175300,175303,3,6,0
49988,2,2,175299,175303,175305,4,6,0
49989,5,2,175304,175305,175307,1,3,0
49990,1,1,175305,175307,175308,2,3,0
49991,1,3,175306,175308,175311,2,5,0
49992,4,1,175310,175311,175312,1,2,0
49993,3,1,175313,175313,175314,0,1,1
49994,3,1,175316,175316,175317,0,1,2
49995,3,1,175319,175319,175320,0,1,2
49996,6,1,175325,175325,175326,0,1,5
49997,5,3,175330,175330,175333,0,3,4
49998,6,1,175336,175336,175337,0,1,3
49999,1,3,175337,175337,175340,0,3,0
50000,3,3,175340,175340,175343,0,3,0
50001,2,2,175342,175343,175345,1,3,0
50002,1,2,175343,175345,175347,2,4,0
50003,3,3,175346,175347,175350,1,4,0
50004,2,1,175348,175350,175351,2,3,0
50005,6,2,175354,175354,175356,0,2,3
50006,1,3,175355,175356,175359,1,4,0
50007,1,2,175356,175359,175361,3,5,0
50008,3,2,175359,175361,175363,2,4,0
50009,3,1,175362,175363,175364,1,2,0
50010,5,2,175367,175367,175369,0,2,3
50011,6,3,175373,175373,175376,0,3,4
50012,1,3,175374,175376,175379,2,5,0
50013,6,1,175380,175380,175381,0,1,1
50014,1,1,175381,175381,175382,0,1,0
50015,3,1,175384,175384,175385,0,1,2
50016,2,2,175386,175386,175388,0,2,1
50017,2,3,175388,175388,175391,0,3,0
50018,1,2,175389,175391,175393,2,4,0
50019,1,1,175390,175393,175394,3,4,0
50020,3,2,175393,175394,175396,1,3,0
50021,2,1,175395,175396,175397,1,2,0
50022,1,3,175396,175397,175400,1,4,0
50023,1,3,175397,175400,175403,3,6,0
50024,6,1,175403,175403,175404,0,1,0
50025,5,3,175408,175408,175411,0,3,4
50026,2,2,175410,175411,175413,1,3,0
50027,2,2,175412,175413,175415,1,3,0
50028,2,3,175414,175415,175418,1,4,0
50029,4,1,175418,175418,175419,0,1,0
50030,2,2,175420,175420,175422,0,2,1
50031,4,2,175424,175424,175426,0,2,2
50032,2,1,175426,175426,175427,0,1,0
50033,1,3,175427,175427,175430,0,3,0
50034,2,2,175429,175430,175432,1,3,0
50035,5,2,175434,175434,175436,0,2,2
50036,3,2,175437,175437,175439,0,2,1
50037,6,3,175443,175443,175446,0,3,4
50038,5,3,175448,175448,175451,0,3,2
50039,5,1,175453,175453,175454,0,1,2
50040,4,2,175457,175457,175459,0,2,3
50041,3,2,175460,175460,175462,0,2,1
50042,3,3,175463,175463,175466,0,3,1
50043,5,3,175468,175468,175471,0,3,2
50044,2,1,175470,175471,175472,1,2,0
50045,5,2,175475,175475,175477,0,2,3
50046,3,1,175478,175478,175479,0,1,1
50047,3,2,175481,175481,175483,0,2,2
50048,6,2,175487,175487,175489,0,2,4
50049,2,1,175489,175489,175490,0,1,0
50050,3,2,175492,175492,175494,0,2,2
50051,3,1,175495,175495,175496,0,1,1
50052,3,1,175498,175498,175499,0,1,2
50053,6,2,175504,175504,175506,0,2,5
50054,2,1,175506,175506,175507,0,1,0
50055,1,1,175507,175507,175508,0,1,0
50056,1,2,175508,175508,175510,0,2,0
50057,2,1,175510,175510,175511,0,1,0
50058,5,2,175515,175515,175517,0,2,4
50059,1,1,175516,175517,175518,1,2,0
50060,2,1,175518,175518,175519,0,1,0
50061,1,3,175519,175519,175522,0,3,0
50062,5,2,175524,175524,175526,0,2,2
50063,2,3,175526,175526,175529,0,3,0
50064,2,1,175528,175529,175530,1,2,0
50065,6,3,175534,175534,175537,0,3,4
50066,2,1,175536,175537,175538,1,2,0
50067,4,2,175540,175540,175542,0,2,2
50068,4,2,175544,175544,175546,0,2,2
50069,5,2,175549,175549,175551,0,2,3
50070,5,3,175554,175554,175557,0,3,3
50071,2,1,175556,175557,175558,1,2,0
50072,6,2,175562,175562,175564,0,2,4
50073,4,2,175566,175566,175568,0,2,2
50074,5,2,175571,175571,175573,0,2,3
50075,5,1,175576,175576,175577,0,1,3
50076,3,3,175579,175579,175582,0,3,2
50077,2,2,175581,175582,175584,1,3,0
50078,1,2,175582,175584,175586,2,4,0
50079,5,1,175587,175587,175588,0,1,1
50080,3,2,175590,175590,175592,0,2,2
50081,1,1,175591,175592,175593,1,2,0
50082,6,3,175597,175597,175600,0,3,4
50083,1,2,175598,175600,175602,2,4,0
50084,5,2,175603,175603,175605,0,2,1
50085,5,3,175608,175608,175611,0,3,3
50086,4,3,175612,175612,175615,0,3,1
50087,4,1,175616,175616,175617,0,1,1
50088,5,3,175621,175621,175624,0,3,4
50089,3,2,175624,175624,175626,0,2,0
50090,6,3,175630,175630,175633,0,3,4
50091,6,2,175636,175636,175638,0,2,3
50092,6,1,175642,175642,175643,0,1,4
50093,2,2,175644,175644,175646,0,2,1
50094,6,2,175650,175650,175652,0,2,4
50095,3,2,175653,175653,175655,0,2,1
50096,5,1,175658,175658,175659,0,1,3
50097,5,1,175663,175663,175664,0,1,4
50098,1,2,175664,175664,175666,0,2,0
50099,6,3,175670,175670,175673,0,3,4
50100,1,3,175671,175673,175676,2,5,0
50101,5,3,175676,175676,175679,0,3,0
50102,5,3,175681,175681,175684,0,3,2
50103,3,2,175684,175684,175686,0,2,0
50104,2,2,175686,175686,175688,0,2,0
50105,3,2,175689,175689,175691,0,2,1
50106,4,2,175693,175693,175695,0,2,2
50107,2,2,175695,175695,175697,0,2,0
50108,4,3,175699,175699,175702,0,3,2
50109,1,1,175700,175702,175703,2,3,0
50110,1,3,175701,175703,175706,2,5,0
50111,5,3,175706,175706,175709,0,3,0
50112,3,3,175709,175709,175712,0,3,0
50113,6,3,175715,175715,175718,0,3,3
50114,3,3,175718,175718,175721,0,3,0
50115,5,1,175723,175723,175724,0,1,2
50116,3,2,175726,175726,175728,0,2,2
50117,1,3,175727,175728,175731,1,4,0
50118,3,3,175730,175731,175734,1,4,0
50119,5,2,175735,175735,175737,0,2,1
50120,4,2,175739,175739,175741,0,2,2
50121,2,2,175741,175741,175743,0,2,0
50122,3,1,175744,175744,175745,0,1,1
50123,5,3,175749,175749,175752,0,3,4
50124,5,2,175754,175754,175756,0,2,2
50125,5,3,175759,175759,175762,0,3,3
50126,1,3,175760,175762,175765,2,5,0
50127,5,3,175765,175765,175768,0,3,0
50128,5,2,175770,175770,175772,0,2,2
50129,3,1,175773,175773,175774,0,1,1
50130,6,3,175779,175779,175782,0,3,5
50131,2,3,175781,175782,175785,1,4,0
50132,4,2,175785,175785,175787,0,2,0
50133,3,3,175788,175788,175791,0,3,1
50134,2,1,175790,175791,175792,1,2,0
50135,3,1,175793,175793,175794,0,1,1
50136,3,3,175796,175796,175799,0,3,2
50137,1,2,175797,175799,175801,2,4,0
50138,3,2,175800,175801,175803,1,3,0
50139,5,3,175805,175805,175808,0,3,2
50140,4,2,175809,175809,175811,0,2,1
50141,1,3,175810,175811,175814,1,4,0
50142,4,1,175814,175814,175815,0,1,0
50143,4,2,175818,175818,175820,0,2,3
50144,4,3,175822,175822,175825,0,3,2
50145,3,2,175825,175825,175827,0,2,0
50146,1,1,175826,175827,175828,1,2,0
50147,2,2,175828,175828,175830,0,2,0
50148,5,3,175833,175833,175836,0,3,3
50149,3,2,175836,175836,175838,0,2,0
50150,1,2,175837,175838,175840,1,3,0
50151,4,1,175841,175841,175842,0,1,1
50152,2,1,175843,175843,175844,0,1,1
50153,3,1,175846,175846,175847,0,1,2
50154,1,1,175847,175847,175848,0,1,0
50155,5,2,175852,175852,175854,0,2,4
50156,2,1,175854,175854,175855,0,1,0
50157,6,2,175860,175860,175862,0,2,5
50158,4,1,175864,175864,175865,0,1,2
50159,5,1,175869,175869,175870,0,1,4
50160,6,2,175875,175875,175877,0,2,5
50161,1,3,175876,175877,175880,1,4,0
50162,6,1,175882,175882,175883,0,1,2
50163,1,1,175883,175883,175884,0,1,0
50164,6,3,175889,175889,175892,0,3,5
50165,2,3,175891,175892,175895,1,4,0
50166,5,3,175896,175896,175899,0,3,1
50167,1,1,175897,175899,175900,2,3,0
50168,2,2,175899,175900,175902,1,3,0
50169,5,2,175904,175904,175906,0,2,2
50170,2,2,175906,175906,175908,0,2,0
50171,5,1,175911,175911,175912,0,1,3
50172,1,1,175912,175912,175913,0,1,0
50173,4,1,175916,175916,175917,0,1,3
50174,1,1,175917,175917,175918,0,1,0
50175,5,2,175922,175922,175924,0,2,4
50176,5,3,175927,175927,175930,0,3,3
50177,6,2,175933,175933,175935,0,2,3
50178,3,1,175936,175936,175937,0,1,1
50179,6,1,175942,175942,175943,0,1,5
50180,2,3,175944,175944,175947,0,3,1
50181,6,3,175950,175950,175953,0,3,3
50182,5,3,175955,175955,175958,0,3,2
50183,2,1,175957,175958,175959,1,2,0
50184,6,2,175963,175963,175965,0,2,4
50185,6,1,175969,175969,175970,0,1,4
50186,2,2,175971,175971,175973,0,2,1
50187,6,2,175977,175977,175979,0,2,4
50188,1,1,175978,175979,175980,1,2,0
50189,5,2,175983,175983,175985,0,2,3
50190,3,3,175986,175986,175989,0,3,1
50191,2,3,175988,175989,175992,1,4,0
50192,2,1,175990,175992,175993,2,3,0
50193,5,2,175995,175995,175997,0,2,2
50194,5,2,176000,176000,176002,0,2,3
50195,3,3,176003,176003,176006,0,3,1
50196,2,2,176005,176006,176008,1,3,0
50197,2,2,176007,176008,176010,1,3,0
50198,5,3,176012,176012,176015,0,3,2
50199,3,2,176015,176015,176017,0,2,0
50200,2,1,176017,176017,176018,0,1,0
50201,3,2,176020,176020,176022,0,2,2
50202,2,3,176022,176022,176025,0,3,0
50203,5,3,176027,176027,176030,0,3,2
50204,1,2,176028,176030,176032,2,4,0
50205,2,3,176030,176032,176035,2,5,0
50206,1,1,176031,176035,176036,4,5,0
50207,2,1,176033,176036,176037,3,4,0
50208,4,2,176037,176037,176039,0,2,0
50209,5,1,176042,176042,176043,0,1,3
50210,1,2,176043,176043,176045,0,2,0
50211,2,2,176045,176045,176047,0,2,0
50212,3,3,176048,176048,176051,0,3,1
50213,1,1,176049,176051,176052,2,3,0
50214,4,3,176053,176053,176056,0,3,1
50215,3,1,176056,176056,176057,0,1,0
50216,2,1,176058,176058,176059,0,1,1
50217,1,1,176059,176059,176060,0,1,0
50218,4,1,176063,176063,176064,0,1,3
50219,5,1,176068,176068,176069,0,1,4
50220,1,3,176069,176069,176072,0,3,0
50221,4,1,176073,176073,176074,0,1,1
50222,2,3,176075,176075,176078,0,3,1
50223,5,2,176080,176080,176082,0,2,2
50224,4,2,176084,176084,176086,0,2,2
50225,1,2,176085,176086,176088,1,3,0
50226,1,2,176086,176088,176090,2,4,0
50227,6,2,176092,176092,176094,0,2,2
50228,3,3,176095,176095,176098,0,3,1
50229,6,1,176101,176101,176102,0,1,3
50230,6,1,176107,176107,176108,0,1,5
50231,5,1,176112,176112,176113,0,1,4
50232,5,3,176117,176117,176120,0,3,4
50233,5,2,176122,176122,176124,0,2,2
50234,3,3,176125,176125,176128,0,3,1
50235,2,1,176127,176128,176129,1,2,0
50236,1,1,176128,176129,176130,1,2,0
50237,5,2,176133,176133,176135,0,2,3
50238,6,1,176139,176139,176140,0,1,4
50239,4,1,176143,176143,176144,0,1,3
50240,1,1,176144,176144,176145,0,1,0
50241,6,1,176150,176150,176151,0,1,5
50242,1,1,176151,176151,176152,0,1,0
50243,3,2,176154,176154,176156,0,2,2
50244,1,1,176155,176156,176157,1,2,0
50245,1,3,176156,176157,176160,1,4,0
50246,1,2,176157,176160,176162,3,5,0
50247,4,3,176161,176162,176165,1,4,0
50248,4,3,176165,176165,176168,0,3,0
50249,4,1,176169,176169,176170,0,1,1
50250,2,1,176171,176171,176172,0,1,1
50251,5,2,176176,176176,176178,0,2,4
50252,2,3,176178,176178,176181,0,3,0
50253,4,3,176182,176182,176185,0,3,1
50254,2,1,176184,176185,176186,1,2,0
50255,5,2,176189,176189,176191,0,2,3
50256,5,3,176194,176194,176197,0,3,3
50257,2,2,176196,176197,176199,1,3,0
50258,6,1,176202,176202,176203,0,1,3
50259,1,3,176203,176203,176206,0,3,0
50260,6,2,176209,176209,176211,0,2,3
50261,2,2,176211,176211,176213,0,2,0
50262,6,1,176217,176217,176218,0,1,4
50263,1,2,176218,176218,176220,0,2,0
50264,5,2,176223,176223,176225,0,2,3
50265,1,3,176224,176225,176228,1,4,0
50266,2,2,176226,176228,176230,2,4,0
50267,2,1,176228,176230,176231,2,3,0
50268,5,1,176233,176233,176234,0,1,2
50269,1,3,176234,176234,176237,0,3,0
50270,2,1,176236,176237,176238,1,2,0
50271,3,3,176239,176239,176242,0,3,1
50272,2,1,176241,176242,176243,1,2,0
50273,1,2,176242,176243,176245,1,3,0
50274,3,3,176245,176245,176248,0,3,0
50275,6,2,176251,176251,176253,0,2,3
50276,5,1,176256,176256,176257,0,1,3
50277,6,1,176262,176262,176263,0,1,5
50278,1,3,176263,176263,176266,0,3,0
50279,4,2,176267,176267,176269,0,2,1
50280,1,2,176268,176269,176271,1,3,0
50281,5,3,176273,176273,176276,0,3,2
50282,4,2,176277,176277,176279,0,2,1
50283,5,1,176282,176282,176283,0,1,3
50284,2,2,176284,176284,176286,0,2,1
50285,1,3,176285,176286,176289,1,4,0
50286,1,3,176286,176289,176292,3,6,0
50287,4,2,176290,176292,176294,2,4,0
50288,1,2,176291,176294,176296,3,5,0
50289,1,2,176292,176296,176298,4,6,0
50290,3,3,176295,176298,176301,3,6,0
50291,5,1,176300,176301,176302,1,2,0
50292,1,3,176301,176302,176305,1,4,0
50293,5,1,176306,176306,176307,0,1,1
50294,5,3,176311,176311,176314,0,3,4
50295,6,1,176317,176317,176318,0,1,3
50296,1,1,176318,176318,176319,0,1,0
50297,3,1,176321,176321,176322,0,1,2
50298,4,3,176325,176325,176328,0,3,3
50299,2,3,176327,176328,176331,1,4,0
50300,6,1,176333,176333,176334,0,1,2
50301,4,1,176337,176337,176338,0,1,3
50302,5,2,176342,176342,176344,0,2,4
50303,1,1,176343,176344,176345,1,2,0
50304,3,1,176346,176346,176347,0,1,1
50305,1,3,176347,176347,176350,0,3,0
50306,3,2,176350,176350,176352,0,2,0
50307,2,1,176352,176352,176353,0,1,0
50308,6,2,176358,176358,176360,0,2,5
50309,3,2,176361,176361,176363,0,2,1
50310,3,3,176364,176364,176367,0,3,1
50311,1,2,176365,176367,176369,2,4,0
50312,2,3,176367,176369,176372,2,5,0
50313,1,2,176368,176372,176374,4,6,0
50314,3,3,176371,176374,176377,3,6,0
50315,4,2,176375,176377,176379,2,4,0
50316,5,3,176380,176380,176383,0,3,1
50317,4,1,176384,176384,176385,0,1,1
50318,1,2,176385,176385,176387,0,2,0
50319,6,1,176391,176391,176392,0,1,4
50320,4,3,176395,176395,176398,0,3,3
50321,2,1,176397,176398,176399,1,2,0
50322,6,1,176403,176403,176404,0,1,4
50323,3,2,176406,176406,176408,0,2,2
50324,5,1,176411,176411,176412,0,1,3
50325,1,3,176412,176412,176415,0,3,0
50326,4,3,176416,176416,176419,0,3,1
50327,1,3,176417,176419,176422,2,5,0
50328,3,1,176420,176422,176423,2,3,0
50329,3,2,176423,176423,176425,0,2,0
50330,5,2,176428,176428,176430,0,2,3
50331,5,1,176433,176433,176434,0,1,3
50332,3,2,176436,176436,176438,0,2,2
50333,2,2,176438,176438,176440,0,2,0
50334,6,1,176444,176444,176445,0,1,4
50335,2,3,176446,176446,176449,0,3,1
50336,2,2,176448,176449,176451,1,3,0
50337,2,1,176450,176451,176452,1,2,0
50338,5,3,176455,176455,176458,0,3,3
50339,5,2,176460,176460,176462,0,2,2
50340,1,3,176461,176462,176465,1,4,0
50341,5,1,176466,176466,176467,0,1,1
50342,2,1,176468,176468,176469,0,1,1
50343,6,2,176474,176474,176476,0,2,5
50344,1,1,176475,176476,176477,1,2,0
50345,4,3,176479,176479,176482,0,3,2
50346,4,1,176483,176483,176484,0,1,1
50347,4,2,176487,176487,176489,0,2,3
50348,3,2,176490,176490,176492,0,2,1
50349,5,3,176495,176495,176498,0,3,3
50350,2,1,176497,176498,176499,1,2,0
50351,4,3,176501,176501,176504,0,3,2
50352,1,3,176502,176504,176507,2,5,0
50353,3,2,176505,176507,176509,2,4,0
50354,6,3,176511,176511,176514,0,3,2
50355,4,1,176515,176515,176516,0,1,1
50356,4,1,176519,176519,176520,0,1,3
50357,2,1,176521,176521,176522,0,1,1
50358,2,2,176523,176523,176525,0,2,1
50359,1,2,176524,176525,176527,1,3,0
50360,6,1,176530,176530,176531,0,1,3
50361,5,3,176535,176535,176538,0,3,4
50362,5,2,176540,176540,176542,0,2,2
50363,6,1,176546,176546,176547,0,1,4
50364,5,1,176551,176551,176552,0,1,4
50365,6,1,176557,176557,176558,0,1,5
50366,2,3,176559,176559,176562,0,3,1
50367,2,1,176561,176562,176563,1,2,0
50368,6,1,176567,176567,176568,0,1,4
50369,1,2,176568,176568,176570,0,2,0
50370,5,2,176573,176573,176575,0,2,3
50371,2,2,176575,176575,176577,0,2,0
50372,2,2,176577,176577,176579,0,2,0
50373,1,2,176578,176579,176581,1,3,0
50374,5,3,176583,176583,176586,0,3,2
50375,6,3,176589,176589,176592,0,3,3
50376,5,1,176594,176594,176595,0,1,2
50377,4,3,176598,176598,176601,0,3,3
50378,1,2,176599,176601,176603,2,4,0
50379,1,1,176600,176603,176604,3,4,0
50380,1,2,176601,176604,176606,3,5,0
50381,6,2,176607,176607,176609,0,2,1
50382,4,3,176611,176611,176614,0,3,2
50383,5,1,176616,176616,176617,0,1,2
50384,6,1,176622,176622,176623,0,1,5
50385,4,3,176626,176626,176629,0,3,3
50386,4,2,176630,176630,176632,0,2,1
50387,3,1,176633,176633,176634,0,1,1
50388,3,1,176636,176636,176637,0,1,2
50389,4,1,176640,176640,176641,0,1,3
50390,6,1,176646,176646,176647,0,1,5
50391,6,2,176652,176652,176654,0,2,5
50392,3,2,176655,176655,176657,0,2,1
50393,4,3,176659,176659,176662,0,3,2
50394,4,1,176663,176663,176664,0,1,1
50395,3,2,176666,176666,176668,0,2,2
50396,2,3,176668,176668,176671,0,3,0
50397,4,1,176672,176672,176673,0,1,1
50398,1,1,176673,176673,176674,0,1,0
50399,2,2,176675,176675,176677,0,2,1
50400,5,3,176680,176680,176683,0,3,3
50401,4,1,176684,176684,176685,0,1,1
50402,1,1,176685,176685,176686,0,1,0
50403,2,3,176687,176687,176690,0,3,1
50404,5,1,176692,176692,176693,0,1,2
50405,6,3,176698,176698,176701,0,3,5
50406,6,3,176704,176704,176707,0,3,3
50407,6,2,176710,176710,176712,0,2,3
50408,5,3,176715,176715,176718,0,3,3
50409,2,1,176717,176718,176719,1,2,0
50410,4,1,176721,176721,176722,0,1,2
50411,3,2,176724,176724,176726,0,2,2
50412,6,2,176730,176730,176732,0,2,4
50413,3,2,176733,176733,176735,0,2,1
50414,1,3,176734,176735,176738,1,4,0
50415,4,3,176738,176738,176741,0,3,0
50416,1,1,176739,176741,176742,2,3,0
50417,5,3,176744,176744,176747,0,3,2
50418,1,3,176745,176747,176750,2,5,0
50419,6,1,176751,176751,176752,0,1,1
50420,5,2,176756,176756,176758,0,2,4
50421,1,3,176757,176758,176761,1,4,0
50422,1,3,176758,176761,176764,3,6,0
50423,6,1,176764,176764,176765,0,1,0
50424,2,3,176766,176766,176769,0,3,1
50425,5,1,176771,176771,176772,0,1,2
50426,2,1,176773,176773,176774,0,1,1
50427,4,3,176777,176777,176780,0,3,3
50428,4,2,176781,176781,176783,0,2,1
50429,6,1,176787,176787,176788,0,1,4
50430,1,3,176788,176788,176791,0,3,0
50431,5,3,176793,176793,176796,0,3,2
50432,3,3,176796,176796,176799,0,3,0
50433,4,2,176800,176800,176802,0,2,1
50434,2,1,176802,176802,176803,0,1,0
50435,4,3,176806,176806,176809,0,3,3
50436,3,1,176809,176809,176810,0,1,0
50437,6,2,176815,176815,176817,0,2,5
50438,2,1,176817,176817,176818,0,1,0
50439,4,3,176821,176821,176824,0,3,3
50440,3,2,176824,176824,176826,0,2,0
50441,4,3,176828,176828,176831,0,3,2
50442,4,3,176832,176832,176835,0,3,1
50443,1,2,176833,176835,176837,2,4,0
50444,2,3,176835,176837,176840,2,5,0
50445,5,2,176840,176840,176842,0,2,0
50446,2,1,176842,176842,176843,0,1,0
50447,4,1,176846,176846,176847,0,1,3
50448,4,2,176850,176850,176852,0,2,3
50449,5,3,176855,176855,176858,0,3,3
50450,3,2,176858,176858,176860,0,2,0
50451,2,2,176860,176860,176862,0,2,0
50452,1,1,176861,176862,176863,1,2,0
50453,4,3,176865,176865,176868,0,3,2
50454,4,1,176869,176869,176870,0,1,1
50455,5,1,176874,176874,176875,0,1,4
50456,5,3,176879,176879,176882,0,3,4
50457,1,2,176880,176882,176884,2,4,0
50458,5,1,176885,176885,176886,0,1,1
50459,4,3,176889,176889,176892,0,3,3
50460,1,2,176890,176892,176894,2,4,0
50461,1,3,176891,176894,176897,3,6,0
50462,6,2,176897,176897,176899,0,2,0
50463,4,2,176901,176901,176903,0,2,2
50464,5,2,176906,176906,176908,0,2,3
50465,5,1,176911,176911,176912,0,1,3
50466,4,1,176915,176915,176916,0,1,3
50467,6,2,176921,176921,176923,0,2,5
50468,4,3,176925,176925,176928,0,3,2
50469,3,1,176928,176928,176929,0,1,0
50470,4,3,176932,176932,176935,0,3,3
50471,6,3,176938,176938,176941,0,3,3
50472,3,1,176941,176941,176942,0,1,0
50473,4,1,176945,176945,176946,0,1,3
50474,2,1,176947,176947,176948,0,1,1
50475,4,1,176951,176951,176952,0,1,3
50476,6,2,176957,176957,176959,0,2,5
50477,1,1,176958,176959,176960,1,2,0
50478,3,2,176961,176961,176963,0,2,1
50479,4,1,176965,176965,176966,0,1,2
50480,5,3,176970,176970,176973,0,3,4
50481,6,3,176976,176976,176979,0,3,3
50482,3,1,176979,176979,176980,0,1,0
50483,5,1,176984,176984,176985,0,1,4
50484,6,3,176990,176990,176993,0,3,5
50485,3,2,176993,176993,176995,0,2,0
50486,6,2,176999,176999,177001,0,2,4
50487,6,3,177005,177005,177008,0,3,4
50488,4,2,177009,177009,177011,0,2,1
50489,2,1,177011,177011,177012,0,1,0
50490,6,3,177017,177017,177020,0,3,5
50491,6,1,177023,177023,177024,0,1,3
50492,6,2,177029,177029,177031,0,2,5
50493,4,2,177033,177033,177035,0,2,2
50494,1,1,177034,177035,177036,1,2,0
50495,2,3,177036,177036,177039,0,3,0
50496,4,1,177040,177040,177041,0,1,1
50497,3,1,177043,177043,177044,0,1,2
50498,1,3,177044,177044,177047,0,3,0
50499,1,3,177045,177047,177050,2,5,0
50500,2,1,177047,177050,177051,3,4,0
50501,4,2,177051,177051,177053,0,2,0
50502,6,3,177057,177057,177060,0,3,4
50503,4,3,177061,177061,177064,0,3,1
50504,6,3,177067,177067,177070,0,3,3
50505,3,2,177070,177070,177072,0,2,0
50506,5,1,177075,177075,177076,0,1,3
50507,4,2,177079,177079,177081,0,2,3
50508,5,2,177084,177084,177086,0,2,3
50509,5,2,177089,177089,177091,0,2,3
50510,6,3,177095,177095,177098,0,3,4
50511,6,2,177101,177101,177103,0,2,3
50512,2,1,177103,177103,177104,0,1,0
50513,2,3,177105,177105,177108,0,3,1
50514,4,3,177109,177109,177112,0,3,1
50515,1,1,177110,177112,177113,2,3,0
50516,4,3,177114,177114,177117,0,3,1
50517,5,1,177119,177119,177120,0,1,2
50518,4,3,177123,177123,177126,0,3,3
50519,3,3,177126,177126,177129,0,3,0
50520,5,1,177131,177131,177132,0,1,2
50521,5,3,177136,177136,177139,0,3,4
50522,6,3,177142,177142,177145,0,3,3
50523,4,3,177146,177146,177149,0,3,1
50524,4,1,177150,177150,177151,0,1,1
50525,2,1,177152,177152,177153,0,1,1
50526,4,1,177156,177156,177157,0,1,3
50527,4,1,177160,177160,177161,0,1,3
50528,2,3,177162,177162,177165,0,3,1
50529,2,3,177164,177165,177168,1,4,0
50530,1,2,177165,177168,177170,3,5,0
50531,6,1,177171,177171,177172,0,1,1
50532,4,2,177175,177175,177177,0,2,3
50533,2,1,177177,177177,177178,0,1,0
50534,2,1,177179,177179,177180,0,1,1
50535,3,1,177182,177182,177183,0,1,2
50536,5,2,177187,177187,177189,0,2,4
50537,2,2,177189,177189,177191,0,2,0
50538,4,2,177193,177193,177195,0,2,2
50539,2,2,177195,177195,177197,0,2,0
50540,4,3,177199,177199,177202,0,3,2
50541,5,3,177204,177204,177207,0,3,2
50542,3,1,177207,177207,177208,0,1,0
50543,6,2,177213,177213,177215,0,2,5
50544,6,2,177219,177219,177221,0,2,4
50545,1,1,177220,177221,177222,1,2,0
50546,1,1,177221,177222,177223,1,2,0
50547,3,2,177224,177224,177226,0,2,1
50548,4,3,177228,177228,177231,0,3,2
50549,3,2,177231,177231,177233,0,2,0
50550,1,3,177232,177233,177236,1,4,0
50551,2,3,177234,177236,177239,2,5,0
50552,6,1,177240,177240,177241,0,1,1
50553,4,2,177244,177244,177246,0,2,3
50554,4,3,177248,177248,177251,0,3,2
50555,5,3,177253,177253,177256,0,3,2
50556,6,3,177259,177259,177262,0,3,3
50557,5,1,177264,177264,177265,0,1,2
50558,1,1,177265,177265,177266,0,1,0
50559,2,1,177267,177267,177268,0,1,1
50560,1,3,177268,177268,177271,0,3,0
50561,6,2,177274,177274,177276,0,2,3
50562,1,2,177275,177276,177278,1,3,0
50563,1,3,177276,177278,177281,2,5,0
50564,1,1,177277,177281,177282,4,5,0
50565,3,1,177280,177282,177283,2,3,0
50566,4,3,177284,177284,177287,0,3,1
50567,2,2,177286,177287,177289,1,3,0
50568,6,3,177292,177292,177295,0,3,3
50569,4,3,177296,177296,177299,0,3,1
50570,5,2,177301,177301,177303,0,2,2
50571,2,3,177303,177303,177306,0,3,0
50572,5,3,177308,177308,177311,0,3,2
50573,6,1,177314,177314,177315,0,1,3
50574,3,2,177317,177317,177319,0,2,2
50575,3,1,177320,177320,177321,0,1,1
50576,2,3,177322,177322,177325,0,3,1
50577,2,3,177324,177325,177328,1,4,0
50578,6,3,177330,177330,177333,0,3,2
50579,2,3,177332,177333,177336,1,4,0
50580,2,1,177334,177336,177337,2,3,0
50581,6,2,177340,177340,177342,0,2,3
50582,2,3,177342,177342,177345,0,3,0
50583,4,1,177346,177346,177347,0,1,1
50584,2,3,177348,177348,177351,0,3,1
50585,4,1,177352,177352,177353,0,1,1
50586,6,2,177358,177358,177360,0,2,5
50587,4,3,177362,177362,177365,0,3,2
50588,6,3,177368,177368,177371,0,3,3
50589,4,3,177372,177372,177375,0,3,1
50590,6,3,177378,177378,177381,0,3,3
50591,1,2,177379,177381,177383,2,4,0
50592,1,1,177380,177383,177384,3,4,0
50593,2,1,177382,177384,177385,2,3,0
50594,6,1,177388,177388,177389,0,1,3
50595,1,2,177389,177389,177391,0,2,0
50596,6,3,177395,177395,177398,0,3,4
50597,2,2,177397,177398,177400,1,3,0
50598,3,1,177400,177400,177401,0,1,0
50599,6,1,177406,177406,177407,0,1,5
50600,4,1,177410,177410,177411,0,1,3
50601,1,1,177411,177411,177412,0,1,0
50602,2,2,177413,177413,177415,0,2,1
50603,6,3,177419,177419,177422,0,3,4
50604,4,1,177423,177423,177424,0,1,1
50605,3,2,177426,177426,177428,0,2,2
50606,1,3,177427,177428,177431,1,4,0
50607,5,3,177432,177432,177435,0,3,1
50608,1,3,177433,177435,177438,2,5,0
50609,2,1,177435,177438,177439,3,4,0
50610,4,3,177439,177439,177442,0,3,0
50611,3,3,177442,177442,177445,0,3,0
50612,6,2,177448,177448,177450,0,2,3
50613,2,3,177450,177450,177453,0,3,0
50614,1,2,177451,177453,177455,2,4,0
50615,4,2,177455,177455,177457,0,2,0
50616,2,3,177457,177457,177460,0,3,0
50617,2,2,177459,177460,177462,1,3,0
50618,1,2,177460,177462,177464,2,4,0
50619,1,2,177461,177464,177466,3,5,0
50620,3,3,177464,177466,177469,2,5,0
50621,5,2,177469,177469,177471,0,2,0
50622,4,2,177473,177473,177475,0,2,2
50623,4,3,177477,177477,177480,0,3,2
50624,2,1,177479,177480,177481,1,2,0
50625,4,2,177483,177483,177485,0,2,2
50626,4,1,177487,177487,177488,0,1,2
50627,3,1,177490,177490,177491,0,1,2
50628,2,2,177492,177492,177494,0,2,1
50629,5,2,177497,177497,177499,0,2,3
50630,4,1,177501,177501,177502,0,1,2
50631,1,1,177502,177502,177503,0,1,0
50632,1,1,177503,177503,177504,0,1,0
50633,5,1,177508,177508,177509,0,1,4
50634,6,1,177514,177514,177515,0,1,5
50635,5,1,177519,177519,177520,0,1,4
50636,6,1,177525,177525,177526,0,1,5
50637,5,1,177530,177530,177531,0,1,4
50638,2,1,177532,177532,177533,0,1,1
50639,1,3,177533,177533,177536,0,3,0
50640,3,2,177536,177536,177538,0,2,0
50641,2,1,177538,177538,177539,0,1,0
50642,4,2,177542,177542,177544,0,2,3
50643,1,3,177543,177544,177547,1,4,0
50644,5,1,177548,177548,177549,0,1,1
50645,3,2,177551,177551,177553,0,2,2
50646,2,2,177553,177553,177555,0,2,0
50647,4,3,177557,177557,177560,0,3,2
50648,1,1,177558,177560,177561,2,3,0
50649,2,2,177560,177561,177563,1,3,0
50650,1,3,177561,177563,177566,2,5,0
50651,3,3,177564,177566,177569,2,5,0
50652,1,1,177565,177569,177570,4,5,0
50653,5,2,177570,177570,177572,0,2,0
50654,5,2,177575,177575,177577,0,2,3
50655,1,1,177576,177577,177578,1,2,0
50656,4,3,177580,177580,177583,0,3,2
50657,5,3,177585,177585,177588,0,3,2
50658,4,1,177589,177589,177590,0,1,1
50659,2,2,177591,177591,177593,0,2,1
50660,5,3,177596,177596,177599,0,3,3
50661,2,2,177598,177599,177601,1,3,0
50662,5,2,177603,177603,177605,0,2,2
50663,3,3,177606,177606,177609,0,3,1
50664,6,2,177612,177612,177614,0,2,3
50665,1,3,177613,177614,177617,1,4,0
50666,3,3,177616,177617,177620,1,4,0
50667,6,2,177622,177622,177624,0,2,2
50668,5,3,177627,177627,177630,0,3,3
50669,3,2,177630,177630,177632,0,2,0
50670,4,1,177634,177634,177635,0,1,2
50671,3,1,177637,177637,177638,0,1,2
50672,1,3,177638,177638,177641,0,3,0
50673,1,2,177639,177641,177643,2,4,0
50674,1,3,177640,177643,177646,3,6,0
50675,2,1,177642,177646,177647,4,5,0
50676,4,1,177646,177647,177648,1,2,0
50677,5,2,177651,177651,177653,0,2,3
50678,4,3,177655,177655,177658,0,3,2
50679,3,2,177658,177658,177660,0,2,0
50680,3,1,177661,177661,177662,0,1,1
50681,5,2,177666,177666,177668,0,2,4
50682,4,3,177670,177670,177673,0,3,2
50683,4,3,177674,177674,177677,0,3,1
50684,2,3,177676,177677,177680,1,4,0
50685,4,2,177680,177680,177682,0,2,0
50686,2,1,177682,177682,177683,0,1,0
50687,6,1,177688,177688,177689,0,1,5
50688,6,3,177694,177694,177697,0,3,5
50689,3,2,177697,177697,177699,0,2,0
50690,4,1,177701,177701,177702,0,1,2
50691,1,3,177702,177702,177705,0,3,0
50692,4,2,177706,177706,177708,0,2,1
50693,5,1,177711,177711,177712,0,1,3
50694,6,1,177717,177717,177718,0,1,5
50695,6,1,177723,177723,177724,0,1,5
50696,4,3,177727,177727,177730,0,3,3
50697,4,3,177731,177731,177734,0,3,1
50698,6,3,177737,177737,177740,0,3,3
50699,6,2,177743,177743,177745,0,2,3
50700,3,3,177746,177746,177749,0,3,1
50701,5,2,177751,177751,177753,0,2,2
50702,4,1,177755,177755,177756,0,1,2
50703,6,2,177761,177761,177763,0,2,5
50704,3,3,177764,177764,177767,0,3,1
50705,1,1,177765,177767,177768,2,3,0
50706,1,3,177766,177768,177771,2,5,0
50707,2,2,177768,177771,177773,3,5,0
50708,1,2,177769,177773,177775,4,6,0
50709,2,3,177771,177775,177778,4,7,0
50710,5,2,177776,177778,177780,2,4,0
50711,5,2,177781,177781,177783,0,2,1
50712,6,3,177787,177787,177790,0,3,4
50713,2,2,177789,177790,177792,1,3,0
50714,3,1,177792,177792,177793,0,1,0
50715,6,3,177798,177798,177801,0,3,5
50716,1,3,177799,177801,177804,2,5,0
50717,3,1,177802,177804,177805,2,3,0
50718,5,1,177807,177807,177808,0,1,2
50719,6,3,177813,177813,177816,0,3,5
50720,3,2,177816,177816,177818,0,2,0
50721,3,3,177819,177819,177822,0,3,1
50722,4,3,177823,177823,177826,0,3,1
50723,6,3,177829,177829,177832,0,3,3
50724,5,1,177834,177834,177835,0,1,2
50725,1,2,177835,177835,177837,0,2,0
50726,6,1,177841,177841,177842,0,1,4
50727,1,3,177842,177842,177845,0,3,0
50728,3,3,177845,177845,177848,0,3,0
50729,6,3,177851,177851,177854,0,3,3
50730,6,2,177857,177857,177859,0,2,3
50731,1,3,177858,177859,177862,1,4,0
50732,1,3,177859,177862,177865,3,6,0
50733,1,1,177860,177865,177866,5,6,0
50734,2,3,177862,177866,177869,4,7,0
50735,1,1,177863,177869,177870,6,7,0
50736,1,2,177864,177870,177872,6,8,0
50737,2,1,177866,177872,177873,6,7,0
50738,1,1,177867,177873,177874,6,7,0
50739,5,3,177872,177874,177877,2,5,0
50740,1,3,177873,177877,177880,4,7,0
50741,1,3,177874,177880,177883,6,9,0
50742,4,1,177878,177883,177884,5,6,0
50743,4,2,177882,177884,177886,2,4,0
50744,1,1,177883,177886,177887,3,4,0
50745,3,1,177886,177887,177888,1,2,0
50746,1,3,177887,177888,177891,1,4,0
50747,1,1,177888,177891,177892,3,4,0
50748,2,1,177890,177892,177893,2,3,0
50749,6,1,177896,177896,177897,0,1,3
50750,1,1,177897,177897,177898,0,1,0
50751,2,2,177899,177899,177901,0,2,1
50752,5,2,177904,177904,177906,0,2,3
50753,2,1,177906,177906,177907,0,1,0
50754,2,2,177908,177908,177910,0,2,1
50755,6,1,177914,177914,177915,0,1,4
50756,6,3,177920,177920,177923,0,3,5
50757,4,1,177924,177924,177925,0,1,1
50758,1,3,177925,177925,177928,0,3,0
50759,3,2,177928,177928,177930,0,2,0
50760,1,2,177929,177930,177932,1,3,0
50761,1,3,177930,177932,177935,2,5,0
50762,1,2,177931,177935,177937,4,6,0
50763,3,2,177934,177937,177939,3,5,0
50764,6,1,177940,177940,177941,0,1,1
50765,2,1,177942,177942,177943,0,1,1
50766,1,3,177943,177943,177946,0,3,0
50767,1,3,177944,177946,177949,2,5,0
50768,4,2,177948,177949,177951,1,3,0
50769,2,2,177950,177951,177953,1,3,0
50770,1,1,177951,177953,177954,2,3,0
50771,5,3,177956,177956,177959,0,3,2
50772,4,1,177960,177960,177961,0,1,1
50773,3,1,177963,177963,177964,0,1,2
50774,1,2,177964,177964,177966,0,2,0
50775,1,2,177965,177966,177968,1,3,0
50776,5,1,177970,177970,177971,0,1,2
50777,1,1,177971,177971,177972,0,1,0
50778,4,1,177975,177975,177976,0,1,3
50779,3,2,177978,177978,177980,0,2,2
50780,6,3,177984,177984,177987,0,3,4
50781,6,2,177990,177990,177992,0,2,3
50782,5,2,177995,177995,177997,0,2,3
50783,2,2,177997,177997,177999,0,2,0
50784,6,1,178003,178003,178004,0,1,4
50785,6,2,178009,178009,178011,0,2,5
50786,3,3,178012,178012,178015,0,3,1
50787,6,3,178018,178018,178021,0,3,3
50788,1,2,178019,178021,178023,2,4,0
50789,2,3,178021,178023,178026,2,5,0
50790,5,1,178026,178026,178027,0,1,0
50791,6,2,178032,178032,178034,0,2,5
50792,6,3,178038,178038,178041,0,3,4
50793,3,3,178041,178041,178044,0,3,0
50794,3,2,178044,178044,178046,0,2,0
50795,6,1,178050,178050,178051,0,1,4
50796,2,3,178052,178052,178055,0,3,1
50797,5,2,178057,178057,178059,0,2,2
50798,6,1,178063,178063,178064,0,1,4
50799,6,1,178069,178069,178070,0,1,5
50800,6,1,178075,178075,178076,0,1,5
50801,2,3,178077,178077,178080,0,3,1
50802,5,1,178082,178082,178083,0,1,2
50803,5,3,178087,178087,178090,0,3,4
50804,1,1,178088,178090,178091,2,3,0
50805,4,1,178092,178092,178093,0,1,1
50806,4,2,178096,178096,178098,0,2,3
50807,1,2,178097,178098,178100,1,3,0
50808,1,3,178098,178100,178103,2,5,0
50809,3,3,178101,178103,178106,2,5,0
50810,6,2,178107,178107,178109,0,2,1
50811,2,2,178109,178109,178111,0,2,0
50812,4,1,178113,178113,178114,0,1,2
50813,1,2,178114,178114,178116,0,2,0
50814,4,2,178118,178118,178120,0,2,2
50815,3,1,178121,178121,178122,0,1,1
50816,2,2,178123,178123,178125,0,2,1
50817,3,3,178126,178126,178129,0,3,1
50818,4,1,178130,178130,178131,0,1,1
50819,4,3,178134,178134,178137,0,3,3
50820,5,1,178139,178139,178140,0,1,2
50821,3,3,178142,178142,178145,0,3,2
50822,6,1,178148,178148,178149,0,1,3
50823,4,2,178152,178152,178154,0,2,3
50824,5,1,178157,178157,178158,0,1,3
50825,2,1,178159,178159,178160,0,1,1
50826,3,3,178162,178162,178165,0,3,2
50827,4,2,178166,178166,178168,0,2,1
50828,2,3,178168,178168,178171,0,3,0
50829,5,1,178173,178173,178174,0,1,2
50830,3,3,178176,178176,178179,0,3,2
50831,5,1,178181,178181,178182,0,1,2
50832,2,2,178183,178183,178185,0,2,1
50833,4,2,178187,178187,178189,0,2,2
50834,6,2,178193,178193,178195,0,2,4
50835,3,2,178196,178196,178198,0,2,1
50836,5,3,178201,178201,178204,0,3,3
50837,1,3,178202,178204,178207,2,5,0
50838,2,3,178204,178207,178210,3,6,0
50839,2,2,178206,178210,178212,4,6,0
50840,5,3,178211,178212,178215,1,4,0
50841,1,2,178212,178215,178217,3,5,0
50842,1,3,178213,178217,178220,4,7,0
50843,3,3,178216,178220,178223,4,7,0
50844,1,2,178217,178223,178225,6,8,0
50845,6,2,178223,178225,178227,2,4,0
50846,3,1,178226,178227,178228,1,2,0
50847,2,3,178228,178228,178231,0,3,0
50848,4,3,178232,178232,178235,0,3,1
50849,2,2,178234,178235,178237,1,3,0
50850,2,3,178236,178237,178240,1,4,0
50851,6,3,178242,178242,178245,0,3,2
50852,6,1,178248,178248,178249,0,1,3
50853,4,3,178252,178252,178255,0,3,3
50854,4,3,178256,178256,178259,0,3,1
50855,6,2,178262,178262,178264,0,2,3
50856,2,1,178264,178264,178265,0,1,0
50857,3,3,178267,178267,178270,0,3,2
50858,1,2,178268,178270,178272,2,4,0
50859,4,2,178272,178272,178274,0,2,0
50860,6,1,178278,178278,178279,0,1,4
50861,1,2,178279,178279,178281,0,2,0
50862,6,2,178285,178285,178287,0,2,4
50863,5,1,178290,178290,178291,0,1,3
50864,6,3,178296,178296,178299,0,3,5
50865,6,2,178302,178302,178304,0,2,3
50866,1,3,178303,178304,178307,1,4,0
50867,2,3,178305,178307,178310,2,5,0
50868,4,1,178309,178310,178311,1,2,0
50869,6,1,178315,178315,178316,0,1,4
50870,3,2,178318,178318,178320,0,2,2
50871,6,2,178324,178324,178326,0,2,4
50872,6,2,178330,178330,178332,0,2,4
50873,1,3,178331,178332,178335,1,4,0
50874,5,2,178336,178336,178338,0,2,1
50875,2,1,178338,178338,178339,0,1,0
50876,4,3,178342,178342,178345,0,3,3
50877,3,3,178345,178345,178348,0,3,0
50878,5,3,178350,178350,178353,0,3,2
50879,4,1,178354,178354,178355,0,1,1
50880,1,2,178355,178355,178357,0,2,0
50881,6,1,178361,178361,178362,0,1,4
50882,5,1,178366,178366,178367,0,1,4
50883,2,1,178368,178368,178369,0,1,1
50884,3,1,178371,178371,178372,0,1,2
50885,6,2,178377,178377,178379,0,2,5
50886,4,1,178381,178381,178382,0,1,2
50887,5,2,178386,178386,178388,0,2,4
50888,1,1,178387,178388,178389,1,2,0
50889,6,3,178393,178393,178396,0,3,4
50890,1,3,178394,178396,178399,2,5,0
50891,6,2,178400,178400,178402,0,2,1
50892,4,1,178404,178404,178405,0,1,2
50893,1,1,178405,178405,178406,0,1,0
50894,5,1,178410,178410,178411,0,1,4
50895,5,1,178415,178415,178416,0,1,4
50896,6,2,178421,178421,178423,0,2,5
50897,3,2,178424,178424,178426,0,2,1
50898,4,3,178428,178428,178431,0,3,2
50899,5,1,178433,178433,178434,0,1,2
50900,1,3,178434,178434,178437,0,3,0
50901,2,3,178436,178437,178440,1,4,0
50902,2,2,178438,178440,178442,2,4,0
50903,2,3,178440,178442,178445,2,5,0
50904,1,3,178441,178445,178448,4,7,0
50905,3,2,178444,178448,178450,4,6,0
50906,2,1,178446,178450,178451,4,5,0
50907,6,3,178452,178452,178455,0,3,1
50908,3,2,178455,178455,178457,0,2,0
50909,2,1,178457,178457,178458,0,1,0
50910,2,1,178459,178459,178460,0,1,1
50911,6,3,178465,178465,178468,0,3,5
50912,6,1,178471,178471,178472,0,1,3
50913,6,2,178477,178477,178479,0,2,5
50914,3,3,178480,178480,178483,0,3,1
50915,6,2,178486,178486,178488,0,2,3
50916,2,1,178488,178488,178489,0,1,0
50917,2,3,178490,178490,178493,0,3,1
50918,2,2,178492,178493,178495,1,3,0
50919,4,3,178496,178496,178499,0,3,1
50920,1,3,178497,178499,178502,2,5,0
50921,5,1,178502,178502,178503,0,1,0
50922,3,3,178505,178505,178508,0,3,2
50923,1,3,178506,178508,178511,2,5,0
50924,6,3,178512,178512,178515,0,3,1
50925,1,1,178513,178515,178516,2,3,0
50926,4,2,178517,178517,178519,0,2,1
50927,5,1,178522,178522,178523,0,1,3
50928,1,3,178523,178523,178526,0,3,0
50929,2,1,178525,178526,178527,1,2,0
50930,1,1,178526,178527,178528,1,2,0
50931,2,1,178528,178528,178529,0,1,0
50932,1,1,178529,178529,178530,0,1,0
50933,5,1,178534,178534,178535,0,1,4
50934,3,1,178537,178537,178538,0,1,2
50935,3,2,178540,178540,178542,0,2,2
50936,6,3,178546,178546,178549,0,3,4
50937,6,3,178552,178552,178555,0,3,3
50938,6,2,178558,178558,178560,0,2,3
50939,5,1,178563,178563,178564,0,1,3
50940,3,1,178566,178566,178567,0,1,2
50941,4,2,178570,178570,178572,0,2,3
50942,6,3,178576,178576,178579,0,3,4
50943,6,3,178582,178582,178585,0,3,3
50944,5,2,178587,178587,178589,0,2,2
50945,3,2,178590,178590,178592,0,2,1
50946,6,1,178596,178596,178597,0,1,4
50947,5,3,178601,178601,178604,0,3,4
50948,2,1,178603,178604,178605,1,2,0
50949,5,2,178608,178608,178610,0,2,3
50950,1,3,178609,178610,178613,1,4,0
50951,3,2,178612,178613,178615,1,3,0
50952,3,1,178615,178615,178616,0,1,0
50953,1,3,178616,178616,178619,0,3,0
50954,4,1,178620,178620,178621,0,1,1
50955,1,1,178621,178621,178622,0,1,0
50956,4,3,178625,178625,178628,0,3,3
50957,5,2,178630,178630,178632,0,2,2
50958,6,2,178636,178636,178638,0,2,4
50959,6,3,178642,178642,178645,0,3,4
50960,4,1,178646,178646,178647,0,1,1
50961,3,3,178649,178649,178652,0,3,2
50962,1,2,178650,178652,178654,2,4,0
50963,1,2,178651,178654,178656,3,5,0
50964,1,3,178652,178656,178659,4,7,0
50965,4,1,178656,178659,178660,3,4,0
50966,2,1,178658,178660,178661,2,3,0
50967,1,2,178659,178661,178663,2,4,0
50968,4,1,178663,178663,178664,0,1,0
50969,6,1,178669,178669,178670,0,1,5
50970,1,1,178670,178670,178671,0,1,0
50971,1,2,178671,178671,178673,0,2,0
50972,2,2,178673,178673,178675,0,2,0
50973,1,2,178674,178675,178677,1,3,0
50974,1,2,178675,178677,178679,2,4,0
50975,5,3,178680,178680,178683,0,3,1
50976,1,1,178681,178683,178684,2,3,0
50977,2,3,178683,178684,178687,1,4,0
50978,4,3,178687,178687,178690,0,3,0
50979,2,3,178689,178690,178693,1,4,0
50980,2,2,178691,178693,178695,2,4,0
50981,4,3,178695,178695,178698,0,3,0
50982,4,1,178699,178699,178700,0,1,1
50983,6,3,178705,178705,178708,0,3,5
50984,3,2,178708,178708,178710,0,2,0
50985,2,3,178710,178710,178713,0,3,0
50986,5,2,178715,178715,178717,0,2,2
50987,5,1,178720,178720,178721,0,1,3
50988,6,2,178726,178726,178728,0,2,5
50989,2,1,178728,178728,178729,0,1,0
50990,2,2,178730,178730,178732,0,2,1
50991,1,2,178731,178732,178734,1,3,0
50992,4,2,178735,178735,178737,0,2,1
50993,1,2,178736,178737,178739,1,3,0
50994,3,1,178739,178739,178740,0,1,0
50995,1,2,178740,178740,178742,0,2,0
50996,4,2,178744,178744,178746,0,2,2
50997,3,3,178747,178747,178750,0,3,1
50998,6,1,178753,178753,178754,0,1,3
50999,3,2,178756,178756,178758,0,2,2
51000,5,1,178761,178761,178762,0,1,3
51001,2,3,178763,178763,178766,0,3,1
51002,2,2,178765,178766,178768,1,3,0
51003,1,2,178766,178768,178770,2,4,0
51004,2,1,178768,178770,178771,2,3,0
51005,5,3,178773,178773,178776,0,3,2
51006,6,2,178779,178779,178781,0,2,3
51007,6,3,178785,178785,178788,0,3,4
51008,1,2,178786,178788,178790,2,4,0
51009,5,3,178791,178791,178794,0,3,1
51010,2,3,178793,178794,178797,1,4,0
51011,3,1,178796,178797,178798,1,2,0
51012,4,2,178800,178800,178802,0,2,2
51013,2,1,178802,178802,178803,0,1,0
51014,6,3,178808,178808,178811,0,3,5
51015,4,2,178812,178812,178814,0,2,1
51016,1,2,178813,178814,178816,1,3,0
51017,3,1,178816,178816,178817,0,1,0
51018,5,2,178821,178821,178823,0,2,4
51019,4,3,178825,178825,178828,0,3,2
51020,3,1,178828,178828,178829,0,1,0
51021,2,2,178830,178830,178832,0,2,1
51022,6,2,178836,178836,178838,0,2,4
51023,4,2,178840,178840,178842,0,2,2
51024,2,1,178842,178842,178843,0,1,0
51025,6,1,178848,178848,178849,0,1,5
51026,2,3,178850,178850,178853,0,3,1
51027,1,3,178851,178853,178856,2,5,0
51028,2,3,178853,178856,178859,3,6,0
51029,3,2,178856,178859,178861,3,5,0
51030,5,3,178861,178861,178864,0,3,0
51031,2,3,178863,178864,178867,1,4,0
51032,4,1,178867,178867,178868,0,1,0
51033,4,1,178871,178871,178872,0,1,3
51034,6,1,178877,178877,178878,0,1,5
51035,5,1,178882,178882,178883,0,1,4
51036,5,2,178887,178887,178889,0,2,4
51037,3,3,178890,178890,178893,0,3,1
51038,5,3,178895,178895,178898,0,3,2
51039,2,1,178897,178898,178899,1,2,0
51040,5,1,178902,178902,178903,0,1,3
51041,3,3,178905,178905,178908,0,3,2
51042,6,3,178911,178911,178914,0,3,3
51043,6,2,178917,178917,178919,0,2,3
51044,6,1,178923,178923,178924,0,1,4
51045,3,2,178926,178926,178928,0,2,2
51046,2,2,178928,178928,178930,0,2,0
51047,6,1,178934,178934,178935,0,1,4
51048,2,2,178936,178936,178938,0,2,1
51049,3,1,178939,178939,178940,0,1,1
51050,5,2,178944,178944,178946,0,2,4
51051,2,3,178946,178946,178949,0,3,0
51052,3,3,178949,178949,178952,0,3,0
51053,3,2,178952,178952,178954,0,2,0
51054,3,1,178955,178955,178956,0,1,1
51055,4,2,178959,178959,178961,0,2,3
51056,4,1,178963,178963,178964,0,1,2
51057,1,1,178964,178964,178965,0,1,0
51058,2,2,178966,178966,178968,0,2,1
51059,3,1,178969,178969,178970,0,1,1
51060,2,3,178971,178971,178974,0,3,1
51061,1,2,178972,178974,178976,2,4,0
51062,5,3,178977,178977,178980,0,3,1
51063,6,1,178983,178983,178984,0,1,3
51064,2,1,178985,178985,178986,0,1,1
51065,2,2,178987,178987,178989,0,2,1
51066,5,3,178992,178992,178995,0,3,3
51067,3,3,178995,178995,178998,0,3,0
51068,4,1,178999,178999,179000,0,1,1
51069,5,2,179004,179004,179006,0,2,4
51070,4,3,179008,179008,179011,0,3,2
51071,3,2,179011,179011,179013,0,2,0
51072,3,3,179014,179014,179017,0,3,1
51073,5,3,179019,179019,179022,0,3,2
51074,6,2,179025,179025,179027,0,2,3
51075,4,1,179029,179029,179030,0,1,2
51076,2,2,179031,179031,179033,0,2,1
51077,5,3,179036,179036,179039,0,3,3
51078,4,3,179040,179040,179043,0,3,1
51079,6,2,179046,179046,179048,0,2,3
51080,5,2,179051,179051,179053,0,2,3
51081,4,2,179055,179055,179057,0,2,2
51082,6,1,179061,179061,179062,0,1,4
51083,6,3,179067,179067,179070,0,3,5
51084,6,2,179073,179073,179075,0,2,3
51085,1,3,179074,179075,179078,1,4,0
51086,3,3,179077,179078,179081,1,4,0
51087,2,1,179079,179081,179082,2,3,0
51088,6,3,179085,179085,179088,0,3,3
51089,4,2,179089,179089,179091,0,2,1
51090,4,3,179093,179093,179096,0,3,2
51091,5,1,179098,179098,179099,0,1,2
51092,1,2,179099,179099,179101,0,2,0
51093,4,2,179103,179103,179105,0,2,2
51094,4,1,179107,179107,179108,0,1,2
51095,2,2,179109,179109,179111,0,2,1
51096,3,2,179112,179112,179114,0,2,1
51097,1,3,179113,179114,179117,1,4,0
51098,1,2,179114,179117,179119,3,5,0
51099,5,1,179119,179119,179120,0,1,0
51100,2,2,179121,179121,179123,0,2,1
51101,2,3,179123,179123,179126,0,3,0
51102,3,2,179126,179126,179128,0,2,0
51103,4,2,179130,179130,179132,0,2,2
51104,5,1,179135,179135,179136,0,1,3
51105,2,1,179137,179137,179138,0,1,1
51106,4,3,179141,179141,179144,0,3,3
51107,1,1,179142,179144,179145,2,3,0
51108,4,3,179146,179146,179149,0,3,1
51109,1,3,179147,179149,179152,2,5,0
51110,5,1,179152,179152,179153,0,1,0
51111,5,1,179157,179157,179158,0,1,4
51112,6,2,179163,179163,179165,0,2,5
51113,3,2,179166,179166,179168,0,2,1
51114,3,3,179169,179169,179172,0,3,1
51115,5,2,179174,179174,179176,0,2,2
51116,4,1,179178,179178,179179,0,1,2
51117,5,2,179183,179183,179185,0,2,4
51118,5,3,179188,179188,179191,0,3,3
51119,2,1,179190,179191,179192,1,2,0
51120,4,1,179194,179194,179195,0,1,2
51121,6,3,179200,179200,179203,0,3,5
51122,4,3,179204,179204,179207,0,3,1
51123,1,3,179205,179207,179210,2,5,0
51124,5,2,179210,179210,179212,0,2,0
51125,6,2,179216,179216,179218,0,2,4
51126,6,3,179222,179222,179225,0,3,4
51127,5,2,179227,179227,179229,0,2,2
51128,2,2,179229,179229,179231,0,2,0
51129,1,2,179230,179231,179233,1,3,0
51130,5,2,179235,179235,179237,0,2,2
51131,3,2,179238,179238,179240,0,2,1
51132,5,1,179243,179243,179244,0,1,3
51133,2,2,179245,179245,179247,0,2,1
51134,6,1,179251,179251,179252,0,1,4
51135,2,2,179253,179253,179255,0,2,1
51136,3,1,179256,179256,179257,0,1,1
51137,4,3,179260,179260,179263,0,3,3
51138,5,2,179265,179265,179267,0,2,2
51139,6,2,179271,179271,179273,0,2,4
51140,1,1,179272,179273,179274,1,2,0
51141,4,1,179276,179276,179277,0,1,2
51142,1,2,179277,179277,179279,0,2,0
51143,3,2,179280,179280,179282,0,2,1
51144,2,3,179282,179282,179285,0,3,0
51145,1,3,179283,179285,179288,2,5,0
51146,3,2,179286,179288,179290,2,4,0
51147,2,3,179288,179290,179293,2,5,0
51148,1,3,179289,179293,179296,4,7,0
51149,4,2,179293,179296,179298,3,5,0
51150,4,2,179297,179298,179300,1,3,0
51151,2,1,179299,179300,179301,1,2,0
51152,4,3,179303,179303,179306,0,3,2
51153,6,1,179309,179309,179310,0,1,3
51154,1,3,179310,179310,179313,0,3,0
51155,1,3,179311,179313,179316,2,5,0
51156,3,1,179314,179316,179317,2,3,0
51157,1,1,179315,179317,179318,2,3,0
51158,6,2,179321,179321,179323,0,2,3
51159,6,2,179327,179327,179329,0,2,4
51160,6,3,179333,179333,179336,0,3,4
51161,4,1,179337,179337,179338,0,1,1
51162,3,3,179340,179340,179343,0,3,2
51163,2,3,179342,179343,179346,1,4,0
51164,6,1,179348,179348,179349,0,1,2
51165,5,1,179353,179353,179354,0,1,4
51166,2,3,179355,179355,179358,0,3,1
51167,6,3,179361,179361,179364,0,3,3
51168,5,2,179366,179366,179368,0,2,2
51169,2,1,179368,179368,179369,0,1,0
51170,6,1,179374,179374,179375,0,1,5
51171,6,2,179380,179380,179382,0,2,5
51172,2,2,179382,179382,179384,0,2,0
51173,4,1,179386,179386,179387,0,1,2
51174,3,3,179389,179389,179392,0,3,2
51175,5,2,179394,179394,179396,0,2,2
51176,1,2,179395,179396,179398,1,3,0
51177,4,1,179399,179399,179400,0,1,1
51178,3,1,179402,179402,179403,0,1,2
51179,1,3,179403,179403,179406,0,3,0
51180,1,1,179404,179406,179407,2,3,0
51181,6,3,179410,179410,179413,0,3,3
51182,1,1,179411,179413,179414,2,3,0
51183,5,3,179416,179416,179419,0,3,2
51184,2,3,179418,179419,179422,1,4,0
51185,1,3,179419,179422,179425,3,6,0
51186,4,2,179423,179425,179427,2,4,0
51187,2,3,179425,179427,179430,2,5,0
51188,5,2,179430,179430,179432,0,2,0
51189,5,2,179435,179435,179437,0,2,3
51190,5,3,179440,179440,179443,0,3,3
51191,3,2,179443,179443,179445,0,2,0
51192,3,1,179446,179446,179447,0,1,1
51193,6,2,179452,179452,179454,0,2,5
51194,3,3,179455,179455,179458,0,3,1
51195,4,2,179459,179459,179461,0,2,1
51196,4,3,179463,179463,179466,0,3,2
51197,5,1,179468,179468,179469,0,1,2
51198,3,2,179471,179471,179473,0,2,2
51199,3,3,179474,179474,179477,0,3,1
51200,6,1,179480,179480,179481,0,1,3
51201,5,1,179485,179485,179486,0,1,4
51202,4,1,179489,179489,179490,0,1,3
51203,5,2,179494,179494,179496,0,2,4
51204,3,3,179497,179497,179500,0,3,1
51205,1,3,179498,179500,179503,2,5,0
51206,3,3,179501,179503,179506,2,5,0
51207,2,3,179503,179506,179509,3,6,0
51208,6,1,179509,179509,179510,0,1,0
51209,1,3,179510,179510,179513,0,3,0
51210,2,1,179512,179513,179514,1,2,0
51211,5,2,179517,179517,179519,0,2,3
51212,1,3,179518,179519,179522,1,4,0
51213,5,1,179523,179523,179524,0,1,1
51214,4,3,179527,179527,179530,0,3,3
51215,4,2,179531,179531,179533,0,2,1
51216,6,3,179537,179537,179540,0,3,4
51217,1,3,179538,179540,179543,2,5,0
51218,3,2,179541,179543,179545,2,4,0
51219,2,1,179543,179545,179546,2,3,0
51220,6,1,179549,179549,179550,0,1,3
51221,3,3,179552,179552,179555,0,3,2
51222,4,1,179556,179556,179557,0,1,1
51223,2,1,179558,179558,179559,0,1,1
51224,1,2,179559,179559,179561,0,2,0
51225,4,2,179563,179563,179565,0,2,2
51226,2,2,179565,179565,179567,0,2,0
51227,4,2,179569,179569,179571,0,2,2
51228,4,2,179573,179573,179575,0,2,2
51229,3,1,179576,179576,179577,0,1,1
51230,3,3,179579,179579,179582,0,3,2
51231,5,2,179584,179584,179586,0,2,2
51232,6,1,179590,179590,179591,0,1,4
51233,1,1,179591,179591,179592,0,1,0
51234,1,1,179592,179592,179593,0,1,0
51235,6,1,179598,179598,179599,0,1,5
51236,4,2,179602,179602,179604,0,2,3
51237,1,2,179603,179604,179606,1,3,0
51238,6,2,179609,179609,179611,0,2,3
51239,3,2,179612,179612,179614,0,2,1
51240,1,2,179613,179614,179616,1,3,0
51241,4,3,179617,179617,179620,0,3,1
51242,1,3,179618,179620,179623,2,5,0
51243,6,1,179624,179624,179625,0,1,1
51244,3,1,179627,179627,179628,0,1,2
51245,1,3,179628,179628,179631,0,3,0
51246,5,2,179633,179633,179635,0,2,2
51247,5,2,179638,179638,179640,0,2,3
51248,1,3,179639,179640,179643,1,4,0
51249,1,3,179640,179643,179646,3,6,0
51250,2,2,179642,179646,179648,4,6,0
51251,3,3,179645,179648,179651,3,6,0
51252,4,1,179649,179651,179652,2,3,0
51253,6,3,179655,179655,179658,0,3,3
51254,1,1,179656,179658,179659,2,3,0
51255,5,3,179661,179661,179664,0,3,2
51256,3,1,179664,179664,179665,0,1,0
51257,2,2,179666,179666,179668,0,2,1
51258,2,3,179668,179668,179671,0,3,0
51259,6,2,179674,179674,179676,0,2,3
51260,4,1,179678,179678,179679,0,1,2
51261,2,2,179680,179680,179682,0,2,1
51262,3,2,179683,179683,179685,0,2,1
51263,1,1,179684,179685,179686,1,2,0
51264,2,2,179686,179686,179688,0,2,0
51265,6,3,179692,179692,179695,0,3,4
51266,4,3,179696,179696,179699,0,3,1
51267,1,3,179697,179699,179702,2,5,0
51268,2,1,179699,179702,179703,3,4,0
51269,4,3,179703,179703,179706,0,3,0
51270,2,1,179705,179706,179707,1,2,0
51271,6,3,179711,179711,179714,0,3,4
51272,6,2,179717,179717,179719,0,2,3
51273,3,2,179720,179720,179722,0,2,1
51274,2,1,179722,179722,179723,0,1,0
51275,3,3,179725,179725,179728,0,3,2
51276,6,3,179731,179731,179734,0,3,3
51277,2,1,179733,179734,179735,1,2,0
51278,3,2,179736,179736,179738,0,2,1
51279,5,2,179741,179741,179743,0,2,3
51280,4,2,179745,179745,179747,0,2,2
51281,6,1,179751,179751,179752,0,1,4
51282,6,1,179757,179757,179758,0,1,5
51283,4,2,179761,179761,179763,0,2,3
51284,3,1,179764,179764,179765,0,1,1
51285,5,2,179769,179769,179771,0,2,4
51286,4,3,179773,179773,179776,0,3,2
51287,1,3,179774,179776,179779,2,5,0
51288,1,2,179775,179779,179781,4,6,0
51289,1,2,179776,179781,179783,5,7,0
51290,5,3,179781,179783,179786,2,5,0
51291,4,2,179785,179786,179788,1,3,0
51292,1,3,179786,179788,179791,2,5,0
51293,6,2,179792,179792,179794,0,2,1
51294,4,1,179796,179796,179797,0,1,2
51295,6,2,179802,179802,179804,0,2,5
51296,1,3,179803,179804,179807,1,4,0
51297,3,1,179806,179807,179808,1,2,0
51298,4,3,179810,179810,179813,0,3,2
51299,5,1,179815,179815,179816,0,1,2
51300,3,2,179818,179818,179820,0,2,2
51301,2,1,179820,179820,179821,0,1,0
51302,3,2,179823,179823,179825,0,2,2
51303,4,2,179827,179827,179829,0,2,2
51304,1,3,179828,179829,179832,1,4,0
51305,5,2,179833,179833,179835,0,2,1
51306,6,1,179839,179839,179840,0,1,4
51307,2,3,179841,179841,179844,0,3,1
51308,3,3,179844,179844,179847,0,3,0
51309,3,2,179847,179847,179849,0,2,0
51310,3,2,179850,179850,179852,0,2,1
51311,3,3,179853,179853,179856,0,3,1
51312,2,3,179855,179856,179859,1,4,0
51313,1,1,179856,179859,179860,3,4,0
51314,4,3,179860,179860,179863,0,3,0
51315,2,2,179862,179863,179865,1,3,0
51316,1,1,179863,179865,179866,2,3,0
51317,5,1,179868,179868,179869,0,1,2
51318,6,2,179874,179874,179876,0,2,5
51319,1,2,179875,179876,179878,1,3,0
51320,2,2,179877,179878,179880,1,3,0
51321,3,1,179880,179880,179881,0,1,0
51322,3,3,179883,179883,179886,0,3,2
51323,1,3,179884,179886,179889,2,5,0
51324,1,1,179885,179889,179890,4,5,0
51325,1,1,179886,179890,179891,4,5,0
51326,2,3,179888,179891,179894,3,6,0
51327,2,3,179890,179894,179897,4,7,0
51328,3,2,179893,179897,179899,4,6,0
51329,1,2,179894,179899,179901,5,7,0
51330,6,2,179900,179901,179903,1,3,0
51331,2,1,179902,179903,179904,1,2,0
51332,5,2,179907,179907,179909,0,2,3
51333,1,2,179908,179909,179911,1,3,0
51334,6,3,179914,179914,179917,0,3,3
51335,6,1,179920,179920,179921,0,1,3
51336,2,1,179922,179922,179923,0,1,1
51337,2,3,179924,179924,179927,0,3,1
51338,2,2,179926,179927,179929,1,3,0
51339,2,2,179928,179929,179931,1,3,0
51340,5,3,179933,179933,179936,0,3,2
51341,3,2,179936,179936,179938,0,2,0
51342,5,2,179941,179941,179943,0,2,3
51343,3,2,179944,179944,179946,0,2,1
51344,1,3,179945,179946,179949,1,4,0
51345,4,1,179949,179949,179950,0,1,0
51346,5,2,179954,179954,179956,0,2,4
51347,2,2,179956,179956,179958,0,2,0
51348,2,1,179958,179958,179959,0,1,0
51349,6,3,179964,179964,179967,0,3,5
51350,5,2,179969,179969,179971,0,2,2
51351,2,3,179971,179971,179974,0,3,0
51352,3,2,179974,179974,179976,0,2,0
51353,6,1,179980,179980,179981,0,1,4
51354,2,1,179982,179982,179983,0,1,1
51355,1,3,179983,179983,179986,0,3,0
51356,4,2,179987,179987,179989,0,2,1
51357,2,1,179989,179989,179990,0,1,0
51358,5,3,179994,179994,179997,0,3,4
51359,4,2,179998,179998,180000,0,2,1
51360,4,1,180002,180002,180003,0,1,2
51361,5,1,180007,180007,180008,0,1,4
51362,1,1,180008,180008,180009,0,1,0
51363,3,3,180011,180011,180014,0,3,2
51364,2,3,180013,180014,180017,1,4,0
51365,2,3,180015,180017,180020,2,5,0
51366,2,3,180017,180020,180023,3,6,0
51367,5,1,180022,180023,180024,1,2,0
51368,4,1,180026,180026,180027,0,1,2
51369,5,3,180031,180031,180034,0,3,4
51370,3,2,180034,180034,180036,0,2,0
51371,2,2,180036,180036,180038,0,2,0
51372,3,2,180039,180039,180041,0,2,1
51373,3,1,180042,180042,180043,0,1,1
51374,2,2,180044,180044,180046,0,2,1
51375,4,2,180048,180048,180050,0,2,2
51376,2,3,180050,180050,180053,0,3,0
51377,6,3,180056,180056,180059,0,3,3
51378,4,1,180060,180060,180061,0,1,1
51379,4,2,180064,180064,180066,0,2,3
51380,6,2,180070,180070,180072,0,2,4
51381,1,2,180071,180072,180074,1,3,0
51382,1,2,180072,180074,180076,2,4,0
51383,6,3,180078,180078,180081,0,3,2
51384,1,1,180079,180081,180082,2,3,0
51385,4,3,180083,180083,180086,0,3,1
51386,1,3,180084,180086,180089,2,5,0
51387,2,3,180086,180089,180092,3,6,0
51388,6,2,180092,180092,180094,0,2,0
51389,5,1,180097,180097,180098,0,1,3
51390,3,2,180100,180100,180102,0,2,2
51391,6,2,180106,180106,180108,0,2,4
51392,3,3,180109,180109,180112,0,3,1
51393,1,3,180110,180112,180115,2,5,0
51394,6,3,180116,180116,180119,0,3,1
51395,3,2,180119,180119,180121,0,2,0
51396,3,1,180122,180122,180123,0,1,1
51397,3,1,180125,180125,180126,0,1,2
51398,1,3,180126,180126,180129,0,3,0
51399,3,1,180129,180129,180130,0,1,0
51400,1,1,180130,180130,180131,0,1,0
51401,4,3,180134,180134,180137,0,3,3
51402,2,3,180136,180137,180140,1,4,0
51403,2,3,180138,180140,180143,2,5,0
51404,5,1,180143,180143,180144,0,1,0
51405,2,2,180145,180145,180147,0,2,1
51406,4,2,180149,180149,180151,0,2,2
51407,3,3,180152,180152,180155,0,3,1
51408,6,1,180158,180158,180159,0,1,3
51409,1,1,180159,180159,180160,0,1,0
51410,3,3,180162,180162,180165,0,3,2
51411,2,3,180164,180165,180168,1,4,0
51412,1,2,180165,180168,180170,3,5,0
51413,5,2,180170,180170,180172,0,2,0
51414,3,3,180173,180173,180176,0,3,1
51415,1,1,180174,180176,180177,2,3,0
51416,6,1,180180,180180,180181,0,1,3
51417,6,2,180186,180186,180188,0,2,5
51418,5,1,180191,180191,180192,0,1,3
51419,4,2,180195,180195,180197,0,2,3
51420,4,2,180199,180199,180201,0,2,2
51421,4,1,180203,180203,180204,0,1,2
51422,3,1,180206,180206,180207,0,1,2
51423,5,3,180211,180211,180214,0,3,4
51424,2,1,180213,180214,180215,1,2,0
51425,1,3,180214,180215,180218,1,4,0
51426,3,3,180217,180218,180221,1,4,0
51427,3,2,180220,180221,180223,1,3,0
51428,2,3,180222,180223,180226,1,4,0
51429,5,2,180227,180227,180229,0,2,1
51430,6,3,180233,180233,180236,0,3,4
51431,5,1,180238,180238,180239,0,1,2
51432,3,2,180241,180241,180243,0,2,2
51433,4,1,180245,180245,180246,0,1,2
51434,4,1,180249,180249,180250,0,1,3
51435,5,2,180254,180254,180256,0,2,4
51436,4,2,180258,180258,180260,0,2,2
51437,5,1,180263,180263,180264,0,1,3
51438,4,3,180267,180267,180270,0,3,3
51439,1,1,180268,180270,180271,2,3,0
51440,1,3,180269,180271,180274,2,5,0
51441,4,1,180273,180274,180275,1,2,0
51442,6,2,180279,180279,180281,0,2,4
51443,3,1,180282,180282,180283,0,1,1
51444,3,2,180285,180285,180287,0,2,2
51445,5,1,180290,180290,180291,0,1,3
51446,3,2,180293,180293,180295,0,2,2
51447,6,2,180299,180299,180301,0,2,4
51448,2,1,180301,180301,180302,0,1,0
51449,1,3,180302,180302,180305,0,3,0
51450,2,3,180304,180305,180308,1,4,0
51451,3,2,180307,180308,180310,1,3,0
51452,5,1,180312,180312,180313,0,1,2
51453,2,1,180314,180314,180315,0,1,1
51454,2,3,180316,180316,180319,0,3,1
51455,5,1,180321,180321,180322,0,1,2
51456,3,2,180324,180324,180326,0,2,2
51457,6,3,180330,180330,180333,0,3,4
51458,5,3,180335,180335,180338,0,3,2
51459,2,3,180337,180338,180341,1,4,0
51460,5,3,180342,180342,180345,0,3,1
51461,2,2,180344,180345,180347,1,3,0
51462,6,2,180350,180350,180352,0,2,3
51463,4,2,180354,180354,180356,0,2,2
51464,2,2,180356,180356,180358,0,2,0
51465,2,3,180358,180358,180361,0,3,0
51466,6,1,180364,180364,180365,0,1,3
51467,6,3,180370,180370,180373,0,3,5
51468,3,1,180373,180373,180374,0,1,0
51469,1,1,180374,180374,180375,0,1,0
51470,3,2,180377,180377,180379,0,2,2
51471,4,3,180381,180381,180384,0,3,2
51472,3,1,180384,180384,180385,0,1,0
51473,4,2,180388,180388,180390,0,2,3
51474,6,2,180394,180394,180396,0,2,4
51475,3,1,180397,180397,180398,0,1,1
51476,2,1,180399,180399,180400,0,1,1
51477,2,3,180401,180401,180404,0,3,1
51478,5,3,180406,180406,180409,0,3,2
51479,5,1,180411,180411,180412,0,1,2
51480,2,3,180413,180413,180416,0,3,1
51481,3,2,180416,180416,180418,0,2,0
51482,3,3,180419,180419,180422,0,3,1
51483,4,3,180423,180423,180426,0,3,1
51484,4,3,180427,180427,180430,0,3,1
51485,3,1,180430,180430,180431,0,1,0
51486,3,3,180433,180433,180436,0,3,2
51487,3,2,180436,180436,180438,0,2,0
51488,6,1,180442,180442,180443,0,1,4
51489,1,1,180443,180443,180444,0,1,0
51490,3,2,180446,180446,180448,0,2,2
51491,6,1,180452,180452,180453,0,1,4
51492,1,1,180453,180453,180454,0,1,0
51493,3,3,180456,180456,180459,0,3,2
51494,6,2,180462,180462,180464,0,2,3
51495,6,3,180468,180468,180471,0,3,4
51496,4,3,180472,180472,180475,0,3,1
51497,4,2,180476,180476,180478,0,2,1
51498,1,3,180477,180478,180481,1,4,0
51499,3,3,180480,180481,180484,1,4,0
51500,3,2,180483,180484,180486,1,3,0
51501,6,3,180489,180489,180492,0,3,3
51502,5,2,180494,180494,180496,0,2,2
51503,2,3,180496,180496,180499,0,3,0
51504,5,3,180501,180501,180504,0,3,2
51505,3,2,180504,180504,180506,0,2,0
51506,6,1,180510,180510,180511,0,1,4
51507,5,3,180515,180515,180518,0,3,4
51508,3,1,180518,180518,180519,0,1,0
51509,1,3,180519,180519,180522,0,3,0
51510,4,3,180523,180523,180526,0,3,1
51511,6,1,180529,180529,180530,0,1,3
51512,4,2,180533,180533,180535,0,2,3
51513,1,2,180534,180535,180537,1,3,0
51514,2,3,180536,180537,180540,1,4,0
51515,1,3,180537,180540,180543,3,6,0
51516,5,3,180542,180543,180546,1,4,0
51517,3,3,180545,180546,180549,1,4,0
51518,6,1,180551,180551,180552,0,1,2
51519,4,2,180555,180555,180557,0,2,3
51520,4,1,180559,180559,180560,0,1,2
51521,2,3,180561,180561,180564,0,3,1
51522,5,1,180566,180566,180567,0,1,2
51523,5,3,180571,180571,180574,0,3,4
51524,1,3,180572,180574,180577,2,5,0
51525,1,1,180573,180577,180578,4,5,0
51526,4,2,180577,180578,180580,1,3,0
51527,4,2,180581,180581,180583,0,2,1
51528,3,2,180584,180584,180586,0,2,1
51529,1,1,180585,180586,180587,1,2,0
51530,3,3,180588,180588,180591,0,3,1
51531,4,1,180592,180592,180593,0,1,1
51532,3,3,180595,180595,180598,0,3,2
51533,5,1,180600,180600,180601,0,1,2
51534,6,2,180606,180606,180608,0,2,5
51535,1,2,180607,180608,180610,1,3,0
51536,6,2,180613,180613,180615,0,2,3
51537,1,2,180614,180615,180617,1,3,0
51538,1,3,180615,180617,180620,2,5,0
51539,1,1,180616,180620,180621,4,5,0
51540,3,2,180619,180621,180623,2,4,0
51541,1,2,180620,180623,180625,3,5,0
51542,2,2,180622,180625,180627,3,5,0
51543,4,3,180626,180627,180630,1,4,0
51544,3,1,180629,180630,180631,1,2,0
51545,3,2,180632,180632,180634,0,2,1
51546,1,1,180633,180634,180635,1,2,0
51547,5,1,180638,180638,180639,0,1,3
51548,6,3,180644,180644,180647,0,3,5
51549,1,3,180645,180647,180650,2,5,0
51550,2,1,180647,180650,180651,3,4,0
51551,4,1,180651,180651,180652,0,1,0
51552,5,3,180656,180656,180659,0,3,4
51553,1,3,180657,180659,180662,2,5,0
51554,6,1,180663,180663,180664,0,1,1
51555,1,2,180664,180664,180666,0,2,0
51556,1,1,180665,180666,180667,1,2,0
51557,2,2,180667,180667,180669,0,2,0
51558,6,3,180673,180673,180676,0,3,4
51559,6,3,180679,180679,180682,0,3,3
51560,2,1,180681,180682,180683,1,2,0
51561,6,2,180687,180687,180689,0,2,4
51562,1,1,180688,180689,180690,1,2,0
51563,6,1,180694,180694,180695,0,1,4
51564,6,3,180700,180700,180703,0,3,5
51565,4,1,180704,180704,180705,0,1,1
51566,1,1,180705,180705,180706,0,1,0
51567,5,1,180710,180710,180711,0,1,4
51568,4,2,180714,180714,180716,0,2,3
51569,2,2,180716,180716,180718,0,2,0
51570,1,1,180717,180718,180719,1,2,0
51571,1,3,180718,180719,180722,1,4,0
51572,4,2,180722,180722,180724,0,2,0
51573,1,1,180723,180724,180725,1,2,0
51574,3,1,180726,180726,180727,0,1,1
51575,6,3,180732,180732,180735,0,3,5
51576,4,2,180736,180736,180738,0,2,1
51577,3,2,180739,180739,180741,0,2,1
51578,4,3,180743,180743,180746,0,3,2
51579,5,2,180748,180748,180750,0,2,2
51580,4,2,180752,180752,180754,0,2,2
51581,6,1,180758,180758,180759,0,1,4
51582,4,2,180762,180762,180764,0,2,3
51583,5,2,180767,180767,180769,0,2,3
51584,2,3,180769,180769,180772,0,3,0
51585,4,2,180773,180773,180775,0,2,1
51586,2,2,180775,180775,180777,0,2,0
51587,4,1,180779,180779,180780,0,1,2
51588,2,3,180781,180781,180784,0,3,1
51589,1,3,180782,180784,180787,2,5,0
51590,2,2,180784,180787,180789,3,5,0
51591,1,3,180785,180789,180792,4,7,0
51592,5,2,180790,180792,180794,2,4,0
51593,3,2,180793,180794,180796,1,3,0
51594,4,2,180797,180797,180799,0,2,1
51595,4,3,180801,180801,180804,0,3,2
51596,4,1,180805,180805,180806,0,1,1
51597,3,1,180808,180808,180809,0,1,2
51598,2,2,180810,180810,180812,0,2,1
51599,5,1,180815,180815,180816,0,1,3
51600,4,3,180819,180819,180822,0,3,3
51601,6,3,180825,180825,180828,0,3,3
51602,3,2,180828,180828,180830,0,2,0
51603,1,1,180829,180830,180831,1,2,0
51604,4,3,180833,180833,180836,0,3,2
51605,5,1,180838,180838,180839,0,1,2
51606,3,2,180841,180841,180843,0,2,2
51607,5,2,180846,180846,180848,0,2,3
51608,4,1,180850,180850,180851,0,1,2
51609,6,3,180856,180856,180859,0,3,5
51610,6,1,180862,180862,180863,0,1,3
51611,3,2,180865,180865,180867,0,2,2
51612,5,2,180870,180870,180872,0,2,3
51613,4,2,180874,180874,180876,0,2,2
51614,6,2,180880,180880,180882,0,2,4
51615,2,3,180882,180882,180885,0,3,0
51616,1,1,180883,180885,180886,2,3,0
51617,3,3,180886,180886,180889,0,3,0
51618,1,2,180887,180889,180891,2,4,0
51619,2,1,180889,180891,180892,2,3,0
51620,2,1,180891,180892,180893,1,2,0
51621,5,1,180896,180896,180897,0,1,3
51622,4,2,180900,180900,180902,0,2,3
51623,5,1,180905,180905,180906,0,1,3
51624,1,2,180906,180906,180908,0,2,0
51625,2,1,180908,180908,180909,0,1,0
51626,6,1,180914,180914,180915,0,1,5
51627,3,2,180917,180917,180919,0,2,2
51628,3,1,180920,180920,180921,0,1,1
51629,2,2,180922,180922,180924,0,2,1
51630,6,2,180928,180928,180930,0,2,4
51631,3,2,180931,180931,180933,0,2,1
51632,3,2,180934,180934,180936,0,2,1
51633,1,3,180935,180936,180939,1,4,0
51634,5,3,180940,180940,180943,0,3,1
51635,2,1,180942,180943,180944,1,2,0
51636,5,1,180947,180947,180948,0,1,3
51637,5,2,180952,180952,180954,0,2,4
51638,3,2,180955,180955,180957,0,2,1
51639,1,2,180956,180957,180959,1,3,0
51640,3,3,180959,180959,180962,0,3,0
51641,2,1,180961,180962,180963,1,2,0
51642,6,3,180967,180967,180970,0,3,4
51643,4,3,180971,180971,180974,0,3,1
51644,5,1,180976,180976,180977,0,1,2
51645,2,1,180978,180978,180979,0,1,1
51646,2,3,180980,180980,180983,0,3,1
51647,6,3,180986,180986,180989,0,3,3
51648,3,1,180989,180989,180990,0,1,0
51649,4,1,180993,180993,180994,0,1,3
51650,5,1,180998,180998,180999,0,1,4
51651,6,1,181004,181004,181005,0,1,5
51652,4,2,181008,181008,181010,0,2,3
51653,5,2,181013,181013,181015,0,2,3
51654,3,1,181016,181016,181017,0,1,1
51655,3,1,181019,181019,181020,0,1,2
51656,2,2,181021,181021,181023,0,2,1
51657,5,1,181026,181026,181027,0,1,3
51658,1,2,181027,181027,181029,0,2,0
51659,6,1,181033,181033,181034,0,1,4
51660,1,3,181034,181034,181037,0,3,0
51661,6,2,181040,181040,181042,0,2,3
51662,5,1,181045,181045,181046,0,1,3
51663,1,3,181046,181046,181049,0,3,0
51664,3,3,181049,181049,181052,0,3,0
51665,2,3,181051,181052,181055,1,4,0
51666,6,1,181057,181057,181058,0,1,2
51667,5,1,181062,181062,181063,0,1,4
51668,2,1,181064,181064,181065,0,1,1
51669,6,2,181070,181070,181072,0,2,5
51670,6,2,181076,181076,181078,0,2,4
51671,2,1,181078,181078,181079,0,1,0
51672,3,1,181081,181081,181082,0,1,2
51673,3,1,181084,181084,181085,0,1,2
51674,4,2,181088,181088,181090,0,2,3
51675,2,1,181090,181090,181091,0,1,0
51676,5,3,181095,181095,181098,0,3,4
51677,3,2,181098,181098,181100,0,2,0
51678,6,3,181104,181104,181107,0,3,4
51679,1,1,181105,181107,181108,2,3,0
51680,4,3,181109,181109,181112,0,3,1
51681,3,3,181112,181112,181115,0,3,0
51682,4,3,181116,181116,181119,0,3,1
51683,5,1,181121,181121,181122,0,1,2
51684,3,3,181124,181124,181127,0,3,2
51685,1,2,181125,181127,181129,2,4,0
51686,3,1,181128,181129,181130,1,2,0
51687,1,1,181129,181130,181131,1,2,0
51688,5,3,181134,181134,181137,0,3,3
51689,3,2,181137,181137,181139,0,2,0
51690,3,1,181140,181140,181141,0,1,1
51691,2,1,181142,181142,181143,0,1,1
51692,4,3,181146,181146,181149,0,3,3
51693,2,1,181148,181149,181150,1,2,0
51694,4,1,181152,181152,181153,0,1,2
51695,1,1,181153,181153,181154,0,1,0
51696,6,1,181159,181159,181160,0,1,5
51697,6,1,181165,181165,181166,0,1,5
51698,2,3,181167,181167,181170,0,3,1
51699,1,1,181168,181170,181171,2,3,0
51700,5,1,181173,181173,181174,0,1,2
51701,3,2,181176,181176,181178,0,2,2
51702,1,3,181177,181178,181181,1,4,0
51703,4,2,181181,181181,181183,0,2,0
51704,4,2,181185,181185,181187,0,2,2
51705,3,2,181188,181188,181190,0,2,1
51706,6,2,181194,181194,181196,0,2,4
51707,2,3,181196,181196,181199,0,3,0
51708,6,3,181202,181202,181205,0,3,3
51709,1,2,181203,181205,181207,2,4,0
51710,3,1,181206,181207,181208,1,2,0
51711,1,3,181207,181208,181211,1,4,0
51712,1,3,181208,181211,181214,3,6,0
51713,6,1,181214,181214,181215,0,1,0
51714,2,1,181216,181216,181217,0,1,1
51715,2,3,181218,181218,181221,0,3,1
51716,5,1,181223,181223,181224,0,1,2
51717,4,3,181227,181227,181230,0,3,3
51718,4,3,181231,181231,181234,0,3,1
51719,4,2,181235,181235,181237,0,2,1
51720,2,1,181237,181237,181238,0,1,0
51721,2,1,181239,181239,181240,0,1,1
51722,1,2,181240,181240,181242,0,2,0
51723,1,1,181241,181242,181243,1,2,0
51724,3,1,181244,181244,181245,0,1,1
51725,1,3,181245,181245,181248,0,3,0
51726,6,1,181251,181251,181252,0,1,3
51727,3,1,181254,181254,181255,0,1,2
51728,1,1,181255,181255,181256,0,1,0
51729,1,2,181256,181256,181258,0,2,0
51730,6,3,181262,181262,181265,0,3,4
51731,3,3,181265,181265,181268,0,3,0
51732,4,2,181269,181269,181271,0,2,1
51733,4,3,181273,181273,181276,0,3,2
51734,5,1,181278,181278,181279,0,1,2
51735,5,3,181283,181283,181286,0,3,4
51736,4,3,181287,181287,181290,0,3,1
51737,3,3,181290,181290,181293,0,3,0
51738,6,2,181296,181296,181298,0,2,3
51739,2,3,181298,181298,181301,0,3,0
51740,5,2,181303,181303,181305,0,2,2
51741,3,2,181306,181306,181308,0,2,1
51742,3,1,181309,181309,181310,0,1,1
51743,1,1,181310,181310,181311,0,1,0
51744,2,1,181312,181312,181313,0,1,1
51745,4,3,181316,181316,181319,0,3,3
51746,3,1,181319,181319,181320,0,1,0
51747,6,2,181325,181325,181327,0,2,5
51748,5,3,181330,181330,181333,0,3,3
51749,4,1,181334,181334,181335,0,1,1
51750,5,1,181339,181339,181340,0,1,4
51751,6,1,181345,181345,181346,0,1,5
51752,2,1,181347,181347,181348,0,1,1
51753,5,1,181352,181352,181353,0,1,4
51754,3,1,181355,181355,181356,0,1,2
51755,1,1,181356,181356,181357,0,1,0
51756,5,1,181361,181361,181362,0,1,4
51757,5,3,181366,181366,181369,0,3,4
51758,6,2,181372,181372,181374,0,2,3
51759,5,2,181377,181377,181379,0,2,3
51760,6,3,181383,181383,181386,0,3,4
51761,3,1,181386,181386,181387,0,1,0
51762,1,2,181387,181387,181389,0,2,0
51763,4,1,181391,181391,181392,0,1,2
51764,1,1,181392,181392,181393,0,1,0
51765,4,2,181396,181396,181398,0,2,3
51766,6,3,181402,181402,181405,0,3,4
51767,2,2,181404,181405,181407,1,3,0
51768,2,3,181406,181407,181410,1,4,0
51769,1,3,181407,181410,181413,3,6,0
51770,3,2,181410,181413,181415,3,5,0
51771,3,3,181413,181415,181418,2,5,0
51772,6,2,181419,181419,181421,0,2,1
51773,4,1,181423,181423,181424,0,1,2
51774,1,1,181424,181424,181425,0,1,0
51775,1,3,181425,181425,181428,0,3,0
51776,1,3,181426,181428,181431,2,5,0
51777,6,1,181432,181432,181433,0,1,1
51778,3,3,181435,181435,181438,0,3,2
51779,1,2,181436,181438,181440,2,4,0
51780,2,1,181438,181440,181441,2,3,0
51781,4,1,181442,181442,181443,0,1,1
51782,4,3,181446,181446,181449,0,3,3
51783,1,1,181447,181449,181450,2,3,0
51784,1,3,181448,181450,181453,2,5,0
51785,3,3,181451,181453,181456,2,5,0
51786,1,2,181452,181456,181458,4,6,0
51787,4,3,181456,181458,181461,2,5,0
51788,1,3,181457,181461,181464,4,7,0
51789,2,2,181459,181464,181466,5,7,0
51790,6,2,181465,181466,181468,1,3,0
51791,2,3,181467,181468,181471,1,4,0
51792,4,3,181471,181471,181474,0,3,0
51793,6,1,181477,181477,181478,0,1,3
51794,4,3,181481,181481,181484,0,3,3
51795,3,3,181484,181484,181487,0,3,0
51796,3,1,181487,181487,181488,0,1,0
51797,4,3,181491,181491,181494,0,3,3
51798,4,1,181495,181495,181496,0,1,1
51799,6,3,181501,181501,181504,0,3,5
51800,2,2,181503,181504,181506,1,3,0
51801,6,3,181509,181509,181512,0,3,3
51802,2,2,181511,181512,181514,1,3,0
51803,2,1,181513,181514,181515,1,2,0
51804,5,3,181518,181518,181521,0,3,3
51805,1,1,181519,181521,181522,2,3,0
51806,1,2,181520,181522,181524,2,4,0
51807,4,3,181524,181524,181527,0,3,0
51808,6,1,181530,181530,181531,0,1,3
51809,3,3,181533,181533,181536,0,3,2
51810,2,2,181535,181536,181538,1,3,0
51811,3,2,181538,181538,181540,0,2,0
51812,4,3,181542,181542,181545,0,3,2
51813,1,2,181543,181545,181547,2,4,0
51814,5,3,181548,181548,181551,0,3,1
51815,1,2,181549,181551,181553,2,4,0
51816,4,1,181553,181553,181554,0,1,0
51817,3,2,181556,181556,181558,0,2,2
51818,6,2,181562,181562,181564,0,2,4
51819,5,1,181567,181567,181568,0,1,3
51820,4,3,181571,181571,181574,0,3,3
51821,4,2,181575,181575,181577,0,2,1
51822,1,3,181576,181577,181580,1,4,0
51823,2,2,181578,181580,181582,2,4,0
51824,1,2,181579,181582,181584,3,5,0
51825,3,3,181582,181584,181587,2,5,0
51826,1,3,181583,181587,181590,4,7,0
51827,4,3,181587,181590,181593,3,6,0
51828,6,3,181593,181593,181596,0,3,0
51829,6,2,181599,181599,181601,0,2,3
51830,2,2,181601,181601,181603,0,2,0
51831,5,3,181606,181606,181609,0,3,3
51832,3,2,181609,181609,181611,0,2,0
51833,5,2,181614,181614,181616,0,2,3
51834,5,3,181619,181619,181622,0,3,3
51835,4,2,181623,181623,181625,0,2,1
51836,4,2,181627,181627,181629,0,2,2
51837,5,3,181632,181632,181635,0,3,3
51838,3,3,181635,181635,181638,0,3,0
51839,1,1,181636,181638,181639,2,3,0
51840,5,1,181641,181641,181642,0,1,2
51841,5,3,181646,181646,181649,0,3,4
51842,6,3,181652,181652,181655,0,3,3
51843,5,2,181657,181657,181659,0,2,2
51844,1,2,181658,181659,181661,1,3,0
51845,1,2,181659,181661,181663,2,4,0
51846,5,1,181664,181664,181665,0,1,1
51847,5,1,181669,181669,181670,0,1,4
51848,1,2,181670,181670,181672,0,2,0
51849,1,3,181671,181672,181675,1,4,0
51850,6,2,181677,181677,181679,0,2,2
51851,5,1,181682,181682,181683,0,1,3
51852,4,2,181686,181686,181688,0,2,3
51853,3,1,181689,181689,181690,0,1,1
51854,3,1,181692,181692,181693,0,1,2
51855,1,2,181693,181693,181695,0,2,0
51856,2,2,181695,181695,181697,0,2,0
51857,3,1,181698,181698,181699,0,1,1
51858,4,3,181702,181702,181705,0,3,3
51859,3,3,181705,181705,181708,0,3,0
51860,5,3,181710,181710,181713,0,3,2
51861,5,1,181715,181715,181716,0,1,2
51862,4,1,181719,181719,181720,0,1,3
51863,1,1,181720,181720,181721,0,1,0
51864,1,3,181721,181721,181724,0,3,0
51865,2,3,181723,181724,181727,1,4,0
51866,2,3,181725,181727,181730,2,5,0
51867,1,2,181726,181730,181732,4,6,0
51868,6,3,181732,181732,181735,0,3,0
51869,1,2,181733,181735,181737,2,4,0
51870,4,3,181737,181737,181740,0,3,0
51871,3,3,181740,181740,181743,0,3,0
51872,6,3,181746,181746,181749,0,3,3
51873,4,1,181750,181750,181751,0,1,1
51874,5,2,181755,181755,181757,0,2,4
51875,1,3,181756,181757,181760,1,4,0
51876,3,1,181759,181760,181761,1,2,0
51877,2,1,181761,181761,181762,0,1,0
51878,4,2,181765,181765,181767,0,2,3
51879,1,1,181766,181767,181768,1,2,0
51880,5,2,181771,181771,181773,0,2,3
51881,2,2,181773,181773,181775,0,2,0
51882,5,1,181778,181778,181779,0,1,3
51883,6,2,181784,181784,181786,0,2,5
51884,1,2,181785,181786,181788,1,3,0
51885,3,2,181788,181788,181790,0,2,0
51886,4,1,181792,181792,181793,0,1,2
51887,6,3,181798,181798,181801,0,3,5
51888,5,2,181803,181803,181805,0,2,2
51889,2,1,181805,181805,181806,0,1,0
51890,6,1,181811,181811,181812,0,1,5
51891,4,2,181815,181815,181817,0,2,3
51892,3,2,181818,181818,181820,0,2,1
51893,1,3,181819,181820,181823,1,4,0
51894,5,3,181824,181824,181827,0,3,1
51895,2,3,181826,181827,181830,1,4,0
51896,2,3,181828,181830,181833,2,5,0
51897,3,1,181831,181833,181834,2,3,0
51898,6,2,181837,181837,181839,0,2,3
51899,2,1,181839,181839,181840,0,1,0
51900,2,1,181841,181841,181842,0,1,1
51901,4,2,181845,181845,181847,0,2,3
51902,4,2,181849,181849,181851,0,2,2
51903,5,1,181854,181854,181855,0,1,3
51904,4,2,181858,181858,181860,0,2,3
51905,3,2,181861,181861,181863,0,2,1
51906,1,2,181862,181863,181865,1,3,0
51907,6,3,181868,181868,181871,0,3,3
51908,6,3,181874,181874,181877,0,3,3
51909,5,1,181879,181879,181880,0,1,2
51910,1,2,181880,181880,181882,0,2,0
51911,5,3,181885,181885,181888,0,3,3
51912,2,2,181887,181888,181890,1,3,0
51913,6,3,181893,181893,181896,0,3,3
51914,6,3,181899,181899,181902,0,3,3
51915,2,1,181901,181902,181903,1,2,0
51916,4,1,181905,181905,181906,0,1,2
51917,3,2,181908,181908,181910,0,2,2
51918,2,2,181910,181910,181912,0,2,0
51919,1,3,181911,181912,181915,1,4,0
51920,6,3,181917,181917,181920,0,3,2
51921,6,1,181923,181923,181924,0,1,3
51922,1,1,181924,181924,181925,0,1,0
51923,2,2,181926,181926,181928,0,2,1
51924,4,2,181930,181930,181932,0,2,2
51925,1,2,181931,181932,181934,1,3,0
51926,5,2,181936,181936,181938,0,2,2
51927,3,2,181939,181939,181941,0,2,1
51928,5,2,181944,181944,181946,0,2,3
51929,2,1,181946,181946,181947,0,1,0
51930,6,2,181952,181952,181954,0,2,5
51931,3,3,181955,181955,181958,0,3,1
51932,4,3,181959,181959,181962,0,3,1
51933,2,2,181961,181962,181964,1,3,0
51934,1,2,181962,181964,181966,2,4,0
51935,6,2,181968,181968,181970,0,2,2
51936,6,2,181974,181974,181976,0,2,4
51937,3,1,181977,181977,181978,0,1,1
51938,1,3,181978,181978,181981,0,3,0
51939,6,2,181984,181984,181986,0,2,3
51940,6,3,181990,181990,181993,0,3,4
51941,3,3,181993,181993,181996,0,3,0
51942,3,1,181996,181996,181997,0,1,0
51943,4,2,182000,182000,182002,0,2,3
51944,6,2,182006,182006,182008,0,2,4
51945,4,1,182010,182010,182011,0,1,2
51946,2,1,182012,182012,182013,0,1,1
51947,5,1,182017,182017,182018,0,1,4
51948,2,1,182019,182019,182020,0,1,1
51949,5,1,182024,182024,182025,0,1,4
51950,2,2,182026,182026,182028,0,2,1
51951,3,2,182029,182029,182031,0,2,1
51952,6,1,182035,182035,182036,0,1,4
51953,5,2,182040,182040,182042,0,2,4
51954,3,2,182043,182043,182045,0,2,1
51955,5,2,182048,182048,182050,0,2,3
51956,1,3,182049,182050,182053,1,4,0
51957,3,3,182052,182053,182056,1,4,0
51958,4,2,182056,182056,182058,0,2,0
51959,4,3,182060,182060,182063,0,3,2
51960,2,2,182062,182063,182065,1,3,0
51961,4,3,182066,182066,182069,0,3,1
51962,4,2,182070,182070,182072,0,2,1
51963,4,1,182074,182074,182075,0,1,2
51964,2,1,182076,182076,182077,0,1,1
51965,4,1,182080,182080,182081,0,1,3
51966,4,2,182084,182084,182086,0,2,3
51967,5,3,182089,182089,182092,0,3,3
51968,5,1,182094,182094,182095,0,1,2
51969,5,2,182099,182099,182101,0,2,4
51970,1,3,182100,182101,182104,1,4,0
51971,6,2,182106,182106,182108,0,2,2
51972,5,3,182111,182111,182114,0,3,3
51973,2,2,182113,182114,182116,1,3,0
51974,3,1,182116,182116,182117,0,1,0
51975,2,1,182118,182118,182119,0,1,1
51976,3,1,182121,182121,182122,0,1,2
51977,2,2,182123,182123,182125,0,2,1
51978,3,3,182126,182126,182129,0,3,1
51979,5,1,182131,182131,182132,0,1,2
51980,1,2,182132,182132,182134,0,2,0
51981,4,1,182136,182136,182137,0,1,2
51982,2,2,182138,182138,182140,0,2,1
51983,4,2,182142,182142,182144,0,2,2
51984,6,3,182148,182148,182151,0,3,4
51985,2,2,182150,182151,182153,1,3,0
51986,5,2,182155,182155,182157,0,2,2
51987,5,3,182160,182160,182163,0,3,3
51988,4,1,182164,182164,182165,0,1,1
51989,5,2,182169,182169,182171,0,2,4
51990,1,2,182170,182171,182173,1,3,0
51991,4,1,182174,182174,182175,0,1,1
51992,5,3,182179,182179,182182,0,3,4
51993,6,3,182185,182185,182188,0,3,3
51994,4,3,182189,182189,182192,0,3,1
51995,2,1,182191,182192,182193,1,2,0
51996,4,2,182195,182195,182197,0,2,2
51997,5,3,182200,182200,182203,0,3,3
51998,4,3,182204,182204,182207,0,3,1
51999,4,2,182208,182208,182210,0,2,1
52000,5,3,182213,182213,182216,0,3,3
52001,6,1,182219,182219,182220,0,1,3
52002,5,3,182224,182224,182227,0,3,4
52003,3,1,182227,182227,182228,0,1,0
52004,3,2,182230,182230,182232,0,2,2
52005,1,3,182231,182232,182235,1,4,0
52006,5,1,182236,182236,182237,0,1,1
52007,5,2,182241,182241,182243,0,2,4
52008,1,3,182242,182243,182246,1,4,0
52009,6,3,182248,182248,182251,0,3,2
52010,5,2,182253,182253,182255,0,2,2
52011,6,2,182259,182259,182261,0,2,4
52012,5,2,182264,182264,182266,0,2,3
52013,2,2,182266,182266,182268,0,2,0
52014,2,3,182268,182268,182271,0,3,0
52015,3,3,182271,182271,182274,0,3,0
52016,3,3,182274,182274,182277,0,3,0
52017,2,2,182276,182277,182279,1,3,0
52018,5,1,182281,182281,182282,0,1,2
52019,3,1,182284,182284,182285,0,1,2
52020,4,3,182288,182288,182291,0,3,3
52021,3,3,182291,182291,182294,0,3,0
52022,4,2,182295,182295,182297,0,2,1
52023,3,3,182298,182298,182301,0,3,1
52024,2,2,182300,182301,182303,1,3,0
52025,6,2,182306,182306,182308,0,2,3
52026,5,1,182311,182311,182312,0,1,3
52027,2,2,182313,182313,182315,0,2,1
52028,2,2,182315,182315,182317,0,2,0
52029,1,2,182316,182317,182319,1,3,0
52030,4,1,182320,182320,182321,0,1,1
52031,5,1,182325,182325,182326,0,1,4
52032,2,2,182327,182327,182329,0,2,1
52033,3,2,182330,182330,182332,0,2,1
52034,2,2,182332,182332,182334,0,2,0
52035,5,3,182337,182337,182340,0,3,3
52036,1,2,182338,182340,182342,2,4,0
52037,1,3,182339,182342,182345,3,6,0
52038,4,2,182343,182345,182347,2,4,0
52039,2,3,182345,182347,182350,2,5,0
52040,6,3,182351,182351,182354,0,3,1
52041,6,1,182357,182357,182358,0,1,3
52042,2,3,182359,182359,182362,0,3,1
52043,1,1,182360,182362,182363,2,3,0
52044,3,2,182363,182363,182365,0,2,0
52045,2,3,182365,182365,182368,0,3,0
52046,2,2,182367,182368,182370,1,3,0
52047,2,1,182369,182370,182371,1,2,0
52048,2,3,182371,182371,182374,0,3,0
52049,6,1,182377,182377,182378,0,1,3
52050,2,1,182379,182379,182380,0,1,1
52051,5,2,182384,182384,182386,0,2,4
52052,3,3,182387,182387,182390,0,3,1
52053,3,1,182390,182390,182391,0,1,0
52054,2,3,182392,182392,182395,0,3,1
52055,5,2,182397,182397,182399,0,2,2
52056,2,2,182399,182399,182401,0,2,0
52057,3,3,182402,182402,182405,0,3,1
52058,4,3,182406,182406,182409,0,3,1
52059,5,2,182411,182411,182413,0,2,2
52060,5,1,182416,182416,182417,0,1,3
52061,5,3,182421,182421,182424,0,3,4
52062,4,3,182425,182425,182428,0,3,1
52063,5,2,182430,182430,182432,0,2,2
52064,3,3,182433,182433,182436,0,3,1
52065,2,3,182435,182436,182439,1,4,0
52066,1,2,182436,182439,182441,3,5,0
52067,3,2,182439,182441,182443,2,4,0
52068,3,3,182442,182443,182446,1,4,0
52069,4,2,182446,182446,182448,0,2,0
52070,6,3,182452,182452,182455,0,3,4
52071,2,3,182454,182455,182458,1,4,0
52072,5,2,182459,182459,182461,0,2,1
52073,3,1,182462,182462,182463,0,1,1
52074,2,3,182464,182464,182467,0,3,1
52075,6,3,182470,182470,182473,0,3,3
52076,3,1,182473,182473,182474,0,1,0
52077,3,1,182476,182476,182477,0,1,2
52078,6,3,182482,182482,182485,0,3,5
52079,6,2,182488,182488,182490,0,2,3
52080,2,2,182490,182490,182492,0,2,0
52081,2,3,182492,182492,182495,0,3,0
52082,6,1,182498,182498,182499,0,1,3
52083,5,2,182503,182503,182505,0,2,4
52084,1,3,182504,182505,182508,1,4,0
52085,5,2,182509,182509,182511,0,2,1
52086,2,2,182511,182511,182513,0,2,0
52087,6,3,182517,182517,182520,0,3,4
52088,1,3,182518,182520,182523,2,5,0
52089,1,1,182519,182523,182524,4,5,0
52090,1,2,182520,182524,182526,4,6,0
52091,6,1,182526,182526,182527,0,1,0
52092,3,2,182529,182529,182531,0,2,2
52093,2,2,182531,182531,182533,0,2,0
52094,6,2,182537,182537,182539,0,2,4
52095,2,1,182539,182539,182540,0,1,0
52096,5,2,182544,182544,182546,0,2,4
52097,3,3,182547,182547,182550,0,3,1
52098,1,3,182548,182550,182553,2,5,0
52099,3,2,182551,182553,182555,2,4,0
52100,6,2,182557,182557,182559,0,2,2
52101,4,1,182561,182561,182562,0,1,2
52102,5,1,182566,182566,182567,0,1,4
52103,3,3,182569,182569,182572,0,3,2
52104,1,1,182570,182572,182573,2,3,0
52105,6,3,182576,182576,182579,0,3,3
52106,2,3,182578,182579,182582,1,4,0
52107,5,2,182583,182583,182585,0,2,1
52108,4,1,182587,182587,182588,0,1,2
52109,5,2,182592,182592,182594,0,2,4
52110,6,2,182598,182598,182600,0,2,4
52111,6,1,182604,182604,182605,0,1,4
52112,5,1,182609,182609,182610,0,1,4
52113,2,2,182611,182611,182613,0,2,1
52114,6,3,182617,182617,182620,0,3,4
52115,2,2,182619,182620,182622,1,3,0
52116,1,3,182620,182622,182625,2,5,0
52117,1,2,182621,182625,182627,4,6,0
52118,3,3,182624,182627,182630,3,6,0
52119,6,1,182630,182630,182631,0,1,0
52120,6,1,182636,182636,182637,0,1,5
52121,6,1,182642,182642,182643,0,1,5
52122,3,3,182645,182645,182648,0,3,2
52123,1,1,182646,182648,182649,2,3,0
52124,4,2,182650,182650,182652,0,2,1
52125,5,3,182655,182655,182658,0,3,3
52126,3,3,182658,182658,182661,0,3,0
52127,3,2,182661,182661,182663,0,2,0
52128,6,2,182667,182667,182669,0,2,4
52129,2,1,182669,182669,182670,0,1,0
52130,5,1,182674,182674,182675,0,1,4
52131,2,1,182676,182676,182677,0,1,1
52132,4,1,182680,182680,182681,0,1,3
52133,3,3,182683,182683,182686,0,3,2
52134,1,1,182684,182686,182687,2,3,0
52135,2,2,182686,182687,182689,1,3,0
52136,2,2,182688,182689,182691,1,3,0
52137,4,1,182692,182692,182693,0,1,1
52138,5,1,182697,182697,182698,0,1,4
52139,6,1,182703,182703,182704,0,1,5
52140,6,3,182709,182709,182712,0,3,5
52141,2,2,182711,182712,182714,1,3,0
52142,4,2,182715,182715,182717,0,2,1
52143,5,1,182720,182720,182721,0,1,3
52144,4,3,182724,182724,182727,0,3,3
52145,3,2,182727,182727,182729,0,2,0
52146,4,1,182731,182731,182732,0,1,2
52147,2,2,182733,182733,182735,0,2,1
52148,2,3,182735,182735,182738,0,3,0
52149,1,2,182736,182738,182740,2,4,0
52150,4,1,182740,182740,182741,0,1,0
52151,2,3,182742,182742,182745,0,3,1
52152,4,3,182746,182746,182749,0,3,1
52153,5,1,182751,182751,182752,0,1,2
52154,2,2,182753,182753,182755,0,2,1
52155,3,2,182756,182756,182758,0,2,1
52156,2,1,182758,182758,182759,0,1,0
52157,5,1,182763,182763,182764,0,1,4
52158,2,1,182765,182765,182766,0,1,1
52159,6,2,182771,182771,182773,0,2,5
52160,3,2,182774,182774,182776,0,2,1
52161,6,1,182780,182780,182781,0,1,4
52162,2,3,182782,182782,182785,0,3,1
52163,1,2,182783,182785,182787,2,4,0
52164,6,3,182789,182789,182792,0,3,2
52165,6,3,182795,182795,182798,0,3,3
52166,6,3,182801,182801,182804,0,3,3
52167,6,1,182807,182807,182808,0,1,3
52168,5,2,182812,182812,182814,0,2,4
52169,6,1,182818,182818,182819,0,1,4
52170,2,1,182820,182820,182821,0,1,1
52171,3,1,182823,182823,182824,0,1,2
52172,3,2,182826,182826,182828,0,2,2
52173,4,1,182830,182830,182831,0,1,2
52174,1,3,182831,182831,182834,0,3,0
52175,4,2,182835,182835,182837,0,2,1
52176,5,3,182840,182840,182843,0,3,3
52177,2,1,182842,182843,182844,1,2,0
52178,5,3,182847,182847,182850,0,3,3
52179,2,1,182849,182850,182851,1,2,0
52180,1,1,182850,182851,182852,1,2,0
52181,2,1,182852,182852,182853,0,1,0
52182,1,2,182853,182853,182855,0,2,0
52183,3,3,182856,182856,182859,0,3,1
52184,6,1,182862,182862,182863,0,1,3
52185,2,2,182864,182864,182866,0,2,1
52186,2,2,182866,182866,182868,0,2,0
52187,6,3,182872,182872,182875,0,3,4
52188,3,3,182875,182875,182878,0,3,0
52189,6,1,182881,182881,182882,0,1,3
52190,1,3,182882,182882,182885,0,3,0
52191,6,2,182888,182888,182890,0,2,3
52192,2,2,182890,182890,182892,0,2,0
52193,5,2,182895,182895,182897,0,2,3
52194,1,1,182896,182897,182898,1,2,0
52195,6,2,182902,182902,182904,0,2,4
52196,2,1,182904,182904,182905,0,1,0
52197,6,3,182910,182910,182913,0,3,5
52198,1,2,182911,182913,182915,2,4,0
52199,6,1,182917,182917,182918,0,1,2
52200,6,1,182923,182923,182924,0,1,5
52201,6,1,182929,182929,182930,0,1,5
52202,4,1,182933,182933,182934,0,1,3
52203,5,3,182938,182938,182941,0,3,4
52204,4,3,182942,182942,182945,0,3,1
52205,2,1,182944,182945,182946,1,2,0
52206,2,2,182946,182946,182948,0,2,0
52207,6,1,182952,182952,182953,0,1,4
52208,2,1,182954,182954,182955,0,1,1
52209,2,2,182956,182956,182958,0,2,1
52210,6,3,182962,182962,182965,0,3,4
52211,6,2,182968,182968,182970,0,2,3
52212,6,1,182974,182974,182975,0,1,4
52213,5,2,182979,182979,182981,0,2,4
52214,3,2,182982,182982,182984,0,2,1
52215,3,3,182985,182985,182988,0,3,1
52216,4,3,182989,182989,182992,0,3,1
52217,3,2,182992,182992,182994,0,2,0
52218,3,3,182995,182995,182998,0,3,1
52219,3,1,182998,182998,182999,0,1,0
52220,2,2,183000,183000,183002,0,2,1
52221,3,2,183003,183003,183005,0,2,1
52222,2,1,183005,183005,183006,0,1,0
52223,4,3,183009,183009,183012,0,3,3
52224,3,2,183012,183012,183014,0,2,0
52225,4,2,183016,183016,183018,0,2,2
52226,5,2,183021,183021,183023,0,2,3
52227,3,2,183024,183024,183026,0,2,1
52228,2,3,183026,183026,183029,0,3,0
52229,3,1,183029,183029,183030,0,1,0
52230,5,3,183034,183034,183037,0,3,4
52231,1,3,183035,183037,183040,2,5,0
52232,3,1,183038,183040,183041,2,3,0
52233,3,3,183041,183041,183044,0,3,0
52234,2,3,183043,183044,183047,1,4,0
52235,4,1,183047,183047,183048,0,1,0
52236,2,3,183049,183049,183052,0,3,1
52237,2,3,183051,183052,183055,1,4,0
52238,5,1,183056,183056,183057,0,1,1
52239,4,1,183060,183060,183061,0,1,3
52240,6,1,183066,183066,183067,0,1,5
52241,1,2,183067,183067,183069,0,2,0
52242,2,2,183069,183069,183071,0,2,0
52243,5,1,183074,183074,183075,0,1,3
52244,6,3,183080,183080,183083,0,3,5
52245,3,3,183083,183083,183086,0,3,0
52246,1,2,183084,183086,183088,2,4,0
52247,5,2,183089,183089,183091,0,2,1
52248,3,3,183092,183092,183095,0,3,1
52249,6,3,183098,183098,183101,0,3,3
52250,1,1,183099,183101,183102,2,3,0
52251,4,2,183103,183103,183105,0,2,1
52252,5,2,183108,183108,183110,0,2,3
52253,2,2,183110,183110,183112,0,2,0
52254,5,3,183115,183115,183118,0,3,3
52255,4,2,183119,183119,183121,0,2,1
52256,5,3,183124,183124,183127,0,3,3
52257,1,3,183125,183127,183130,2,5,0
52258,6,2,183131,183131,183133,0,2,1
52259,1,2,183132,183133,183135,1,3,0
52260,1,3,183133,183135,183138,2,5,0
52261,6,3,183139,183139,183142,0,3,1
52262,5,2,183144,183144,183146,0,2,2
52263,6,2,183150,183150,183152,0,2,4
52264,4,3,183154,183154,183157,0,3,2
52265,4,1,183158,183158,183159,0,1,1
52266,5,2,183163,183163,183165,0,2,4
52267,3,2,183166,183166,183168,0,2,1
52268,4,1,183170,183170,183171,0,1,2
52269,2,2,183172,183172,183174,0,2,1
52270,1,3,183173,183174,183177,1,4,0
52271,2,2,183175,183177,183179,2,4,0
52272,5,2,183180,183180,183182,0,2,1
52273,3,3,183183,183183,183186,0,3,1
52274,3,1,183186,183186,183187,0,1,0
52275,2,3,183188,183188,183191,0,3,1
52276,4,1,183192,183192,183193,0,1,1
52277,1,1,183193,183193,183194,0,1,0
52278,1,2,183194,183194,183196,0,2,0
52279,4,3,183198,183198,183201,0,3,2
52280,2,2,183200,183201,183203,1,3,0
52281,2,3,183202,183203,183206,1,4,0
52282,3,2,183205,183206,183208,1,3,0
52283,1,2,183206,183208,183210,2,4,0
52284,2,2,183208,183210,183212,2,4,0
52285,6,2,183214,183214,183216,0,2,2
52286,4,1,183218,183218,183219,0,1,2
52287,4,2,183222,183222,183224,0,2,3
52288,4,3,183226,183226,183229,0,3,2
52289,6,3,183232,183232,183235,0,3,3
52290,2,2,183234,183235,183237,1,3,0
52291,6,3,183240,183240,183243,0,3,3
52292,2,1,183242,183243,183244,1,2,0
52293,1,1,183243,183244,183245,1,2,0
52294,2,2,183245,183245,183247,0,2,0
52295,1,2,183246,183247,183249,1,3,0
52296,4,1,183250,183250,183251,0,1,1
52297,2,2,183252,183252,183254,0,2,1
52298,2,3,183254,183254,183257,0,3,0
52299,4,2,183258,183258,183260,0,2,1
52300,3,2,183261,183261,183263,0,2,1
52301,6,2,183267,183267,183269,0,2,4
52302,4,2,183271,183271,183273,0,2,2
52303,3,1,183274,183274,183275,0,1,1
52304,6,3,183280,183280,183283,0,3,5
52305,6,3,183286,183286,183289,0,3,3
52306,4,2,183290,183290,183292,0,2,1
52307,5,1,183295,183295,183296,0,1,3
52308,2,3,183297,183297,183300,0,3,1
52309,6,3,183303,183303,183306,0,3,3
52310,4,3,183307,183307,183310,0,3,1
52311,4,2,183311,183311,183313,0,2,1
52312,6,1,183317,183317,183318,0,1,4
52313,3,3,183320,183320,183323,0,3,2
52314,4,3,183324,183324,183327,0,3,1
52315,1,3,183325,183327,183330,2,5,0
52316,3,3,183328,183330,183333,2,5,0
52317,1,3,183329,183333,183336,4,7,0
52318,1,3,183330,183336,183339,6,9,0
52319,5,1,183335,183339,183340,4,5,0
52320,3,1,183338,183340,183341,2,3,0
52321,4,1,183342,183342,183343,0,1,1
52322,1,3,183343,183343,183346,0,3,0
52323,6,1,183349,183349,183350,0,1,3
52324,5,2,183354,183354,183356,0,2,4
52325,5,3,183359,183359,183362,0,3,3
52326,5,1,183364,183364,183365,0,1,2
52327,3,1,183367,183367,183368,0,1,2
52328,5,2,183372,183372,183374,0,2,4
52329,4,3,183376,183376,183379,0,3,2
52330,5,1,183381,183381,183382,0,1,2
52331,3,3,183384,183384,183387,0,3,2
52332,4,2,183388,183388,183390,0,2,1
52333,5,2,183393,183393,183395,0,2,3
52334,6,1,183399,183399,183400,0,1,4
52335,4,1,183403,183403,183404,0,1,3
52336,3,1,183406,183406,183407,0,1,2
52337,4,3,183410,183410,183413,0,3,3
52338,6,2,183416,183416,183418,0,2,3
52339,2,2,183418,183418,183420,0,2,0
52340,4,3,183422,183422,183425,0,3,2
52341,3,3,183425,183425,183428,0,3,0
52342,1,1,183426,183428,183429,2,3,0
52343,6,1,183432,183432,183433,0,1,3
52344,5,3,183437,183437,183440,0,3,4
52345,5,3,183442,183442,183445,0,3,2
52346,1,3,183443,183445,183448,2,5,0
52347,1,3,183444,183448,183451,4,7,0
52348,3,1,183447,183451,183452,4,5,0
52349,1,3,183448,183452,183455,4,7,0
52350,6,1,183454,183455,183456,1,2,0
52351,1,3,183455,183456,183459,1,4,0
52352,4,2,183459,183459,183461,0,2,0
52353,2,1,183461,183461,183462,0,1,0
52354,5,1,183466,183466,183467,0,1,4
52355,6,2,183472,183472,183474,0,2,5
52356,6,3,183478,183478,183481,0,3,4
52357,5,3,183483,183483,183486,0,3,2
52358,5,2,183488,183488,183490,0,2,2
52359,3,1,183491,183491,183492,0,1,1
52360,1,1,183492,183492,183493,0,1,0
52361,2,3,183494,183494,183497,0,3,1
52362,1,1,183495,183497,183498,2,3,0
52363,4,3,183499,183499,183502,0,3,1
52364,6,2,183505,183505,183507,0,2,3
52365,4,1,183509,183509,183510,0,1,2
52366,1,1,183510,183510,183511,0,1,0
52367,4,3,183514,183514,183517,0,3,3
52368,2,2,183516,183517,183519,1,3,0
52369,3,1,183519,183519,183520,0,1,0
52370,5,1,183524,183524,183525,0,1,4
52371,1,2,183525,183525,183527,0,2,0
52372,4,1,183529,183529,183530,0,1,2
52373,2,2,183531,183531,183533,0,2,1
52374,2,2,183533,183533,183535,0,2,0
52375,5,1,183538,183538,183539,0,1,3
52376,3,1,183541,183541,183542,0,1,2
52377,1,2,183542,183542,183544,0,2,0
52378,2,3,183544,183544,183547,0,3,0
52379,5,1,183549,183549,183550,0,1,2
52380,4,1,183553,183553,183554,0,1,3
52381,3,3,183556,183556,183559,0,3,2
52382,5,1,183561,183561,183562,0,1,2
52383,4,2,183565,183565,183567,0,2,3
52384,5,1,183570,183570,183571,0,1,3
52385,6,3,183576,183576,183579,0,3,5
52386,3,1,183579,183579,183580,0,1,0
52387,5,2,183584,183584,183586,0,2,4
52388,4,2,183588,183588,183590,0,2,2
52389,6,2,183594,183594,183596,0,2,4
52390,3,1,183597,183597,183598,0,1,1
52391,3,1,183600,183600,183601,0,1,2
52392,4,2,183604,183604,183606,0,2,3
52393,4,2,183608,183608,183610,0,2,2
52394,1,1,183609,183610,183611,1,2,0
52395,2,1,183611,183611,183612,0,1,0
52396,6,3,183617,183617,183620,0,3,5
52397,4,3,183621,183621,183624,0,3,1
52398,1,3,183622,183624,183627,2,5,0
52399,3,2,183625,183627,183629,2,4,0
52400,3,3,183628,183629,183632,1,4,0
52401,4,1,183632,183632,183633,0,1,0
52402,3,3,183635,183635,183638,0,3,2
52403,2,3,183637,183638,183641,1,4,0
52404,5,3,183642,183642,183645,0,3,1
52405,6,3,183648,183648,183651,0,3,3
52406,3,2,183651,183651,183653,0,2,0
52407,2,2,183653,183653,183655,0,2,0
52408,6,3,183659,183659,183662,0,3,4
52409,4,2,183663,183663,183665,0,2,1
52410,6,2,183669,183669,183671,0,2,4
52411,1,3,183670,183671,183674,1,4,0
52412,4,1,183674,183674,183675,0,1,0
52413,3,1,183677,183677,183678,0,1,2
52414,5,1,183682,183682,183683,0,1,4
52415,3,2,183685,183685,183687,0,2,2
52416,3,3,183688,183688,183691,0,3,1
52417,5,1,183693,183693,183694,0,1,2
52418,2,3,183695,183695,183698,0,3,1
52419,4,2,183699,183699,183701,0,2,1
52420,5,2,183704,183704,183706,0,2,3
52421,5,2,183709,183709,183711,0,2,3
52422,1,3,183710,183711,183714,1,4,0
52423,6,3,183716,183716,183719,0,3,2
52424,6,1,183722,183722,183723,0,1,3
52425,6,2,183728,183728,183730,0,2,5
52426,6,1,183734,183734,183735,0,1,4
52427,1,3,183735,183735,183738,0,3,0
52428,1,1,183736,183738,183739,2,3,0
52429,2,3,183738,183739,183742,1,4,0
52430,5,3,183743,183743,183746,0,3,1
52431,1,2,183744,183746,183748,2,4,0
52432,6,2,183750,183750,183752,0,2,2
52433,6,2,183756,183756,183758,0,2,4
52434,5,1,183761,183761,183762,0,1,3
52435,3,2,183764,183764,183766,0,2,2
52436,6,1,183770,183770,183771,0,1,4
52437,3,3,183773,183773,183776,0,3,2
52438,1,1,183774,183776,183777,2,3,0
52439,1,1,183775,183777,183778,2,3,0
52440,6,2,183781,183781,183783,0,2,3
52441,4,1,183785,183785,183786,0,1,2
52442,6,3,183791,183791,183794,0,3,5
52443,4,2,183795,183795,183797,0,2,1
52444,3,1,183798,183798,183799,0,1,1
52445,2,3,183800,183800,183803,0,3,1
52446,2,1,183802,183803,183804,1,2,0
52447,2,3,183804,183804,183807,0,3,0
52448,6,1,183810,183810,183811,0,1,3
52449,2,1,183812,183812,183813,0,1,1
52450,3,3,183815,183815,183818,0,3,2
52451,4,3,183819,183819,183822,0,3,1
52452,6,3,183825,183825,183828,0,3,3
52453,6,1,183831,183831,183832,0,1,3
52454,4,2,183835,183835,183837,0,2,3
52455,5,2,183840,183840,183842,0,2,3
52456,2,3,183842,183842,183845,0,3,0
52457,4,1,183846,183846,183847,0,1,1
52458,2,3,183848,183848,183851,0,3,1
52459,4,2,183852,183852,183854,0,2,1
52460,3,3,183855,183855,183858,0,3,1
52461,4,1,183859,183859,183860,0,1,1
52462,2,1,183861,183861,183862,0,1,1
52463,5,1,183866,183866,183867,0,1,4
52464,1,3,183867,183867,183870,0,3,0
52465,2,3,183869,183870,183873,1,4,0
52466,6,1,183875,183875,183876,0,1,2
52467,2,2,183877,183877,183879,0,2,1
52468,4,2,183881,183881,183883,0,2,2
52469,6,2,183887,183887,183889,0,2,4
52470,1,2,183888,183889,183891,1,3,0
52471,6,2,183894,183894,183896,0,2,3
52472,5,2,183899,183899,183901,0,2,3
52473,5,3,183904,183904,183907,0,3,3
52474,5,2,183909,183909,183911,0,2,2
52475,2,2,183911,183911,183913,0,2,0
52476,3,1,183914,183914,183915,0,1,1
52477,2,3,183916,183916,183919,0,3,1
52478,6,3,183922,183922,183925,0,3,3
52479,5,1,183927,183927,183928,0,1,2
52480,3,1,183930,183930,183931,0,1,2
52481,4,1,183934,183934,183935,0,1,3
52482,6,1,183940,183940,183941,0,1,5
52483,6,2,183946,183946,183948,0,2,5
52484,2,1,183948,183948,183949,0,1,0
52485,5,2,183953,183953,183955,0,2,4
52486,2,3,183955,183955,183958,0,3,0
52487,1,3,183956,183958,183961,2,5,0
52488,3,2,183959,183961,183963,2,4,0
52489,2,2,183961,183963,183965,2,4,0
52490,2,3,183963,183965,183968,2,5,0
52491,2,3,183965,183968,183971,3,6,0
52492,5,2,183970,183971,183973,1,3,0
52493,3,2,183973,183973,183975,0,2,0
52494,6,3,183979,183979,183982,0,3,4
52495,5,2,183984,183984,183986,0,2,2
52496,4,2,183988,183988,183990,0,2,2
52497,2,2,183990,183990,183992,0,2,0
52498,2,1,183992,183992,183993,0,1,0
52499,3,3,183995,183995,183998,0,3,2
52500,5,3,184000,184000,184003,0,3,2
52501,6,2,184006,184006,184008,0,2,3
52502,4,1,184010,184010,184011,0,1,2
52503,3,2,184013,184013,184015,0,2,2
52504,4,1,184017,184017,184018,0,1,2
52505,3,3,184020,184020,184023,0,3,2
52506,4,1,184024,184024,184025,0,1,1
52507,1,1,184025,184025,184026,0,1,0
52508,4,1,184029,184029,184030,0,1,3
52509,2,3,184031,184031,184034,0,3,1
52510,6,1,184037,184037,184038,0,1,3
52511,1,3,184038,184038,184041,0,3,0
52512,3,2,184041,184041,184043,0,2,0
52513,3,1,184044,184044,184045,0,1,1
52514,1,2,184045,184045,184047,0,2,0
52515,2,3,184047,184047,184050,0,3,0
52516,1,2,184048,184050,184052,2,4,0
52517,3,3,184051,184052,184055,1,4,0
52518,5,1,184056,184056,184057,0,1,1
52519,6,3,184062,184062,184065,0,3,5
52520,6,1,184068,184068,184069,0,1,3
52521,4,2,184072,184072,184074,0,2,3
52522,5,3,184077,184077,184080,0,3,3
52523,1,3,184078,184080,184083,2,5,0
52524,3,3,184081,184083,184086,2,5,0
52525,5,3,184086,184086,184089,0,3,0
52526,2,2,184088,184089,184091,1,3,0
52527,2,3,184090,184091,184094,1,4,0
52528,1,2,184091,184094,184096,3,5,0
52529,6,3,184097,184097,184100,0,3,1
52530,5,3,184102,184102,184105,0,3,2
52531,2,2,184104,184105,184107,1,3,0
52532,5,2,184109,184109,184111,0,2,2
52533,4,1,184113,184113,184114,0,1,2
52534,1,1,184114,184114,184115,0,1,0
52535,2,3,184116,184116,184119,0,3,1
52536,2,3,184118,184119,184122,1,4,0
52537,6,2,184124,184124,184126,0,2,2
52538,3,2,184127,184127,184129,0,2,1
52539,4,3,184131,184131,184134,0,3,2
52540,5,2,184136,184136,184138,0,2,2
52541,6,1,184142,184142,184143,0,1,4
52542,3,3,184145,184145,184148,0,3,2
52543,2,2,184147,184148,184150,1,3,0
52544,3,1,184150,184150,184151,0,1,0
52545,1,2,184151,184151,184153,0,2,0
52546,2,3,184153,184153,184156,0,3,0
52547,6,2,184159,184159,184161,0,2,3
52548,5,2,184164,184164,184166,0,2,3
52549,5,2,184169,184169,184171,0,2,3
52550,3,1,184172,184172,184173,0,1,1
52551,1,2,184173,184173,184175,0,2,0
52552,6,3,184179,184179,184182,0,3,4
52553,3,2,184182,184182,184184,0,2,0
52554,4,3,184186,184186,184189,0,3,2
52555,4,2,184190,184190,184192,0,2,1
52556,4,1,184194,184194,184195,0,1,2
52557,1,3,184195,184195,184198,0,3,0
52558,6,3,184201,184201,184204,0,3,3
52559,4,1,184205,184205,184206,0,1,1
52560,5,3,184210,184210,184213,0,3,4
52561,3,2,184213,184213,184215,0,2,0
52562,5,1,184218,184218,184219,0,1,3
52563,1,2,184219,184219,184221,0,2,0
52564,6,3,184225,184225,184228,0,3,4
52565,5,2,184230,184230,184232,0,2,2
52566,2,1,184232,184232,184233,0,1,0
52567,6,3,184238,184238,184241,0,3,5
52568,4,3,184242,184242,184245,0,3,1
52569,1,1,184243,184245,184246,2,3,0
52570,1,2,184244,184246,184248,2,4,0
52571,2,1,184246,184248,184249,2,3,0
52572,1,3,184247,184249,184252,2,5,0
52573,1,1,184248,184252,184253,4,5,0
52574,3,2,184251,184253,184255,2,4,0
52575,6,2,184257,184257,184259,0,2,2
52576,4,2,184261,184261,184263,0,2,2
52577,6,1,184267,184267,184268,0,1,4
52578,3,2,184270,184270,184272,0,2,2
52579,2,2,184272,184272,184274,0,2,0
52580,1,3,184273,184274,184277,1,4,0
52581,4,1,184277,184277,184278,0,1,0
52582,6,1,184283,184283,184284,0,1,5
52583,1,2,184284,184284,184286,0,2,0
52584,4,1,184288,184288,184289,0,1,2
52585,3,2,184291,184291,184293,0,2,2
52586,2,1,184293,184293,184294,0,1,0
52587,1,3,184294,184294,184297,0,3,0
52588,6,2,184300,184300,184302,0,2,3
52589,1,2,184301,184302,184304,1,3,0
52590,4,1,184305,184305,184306,0,1,1
52591,2,3,184307,184307,184310,0,3,1
52592,4,1,184311,184311,184312,0,1,1
52593,5,1,184316,184316,184317,0,1,4
52594,5,2,184321,184321,184323,0,2,4
52595,5,1,184326,184326,184327,0,1,3
52596,3,2,184329,184329,184331,0,2,2
52597,4,1,184333,184333,184334,0,1,2
52598,4,3,184337,184337,184340,0,3,3
52599,1,1,184338,184340,184341,2,3,0
52600,2,2,184340,184341,184343,1,3,0
52601,6,1,184346,184346,184347,0,1,3
52602,1,3,184347,184347,184350,0,3,0
52603,6,1,184353,184353,184354,0,1,3
52604,2,2,184355,184355,184357,0,2,1
52605,6,1,184361,184361,184362,0,1,4
52606,2,2,184363,184363,184365,0,2,1
52607,5,1,184368,184368,184369,0,1,3
52608,1,3,184369,184369,184372,0,3,0
52609,1,1,184370,184372,184373,2,3,0
52610,1,1,184371,184373,184374,2,3,0
52611,4,3,184375,184375,184378,0,3,1
52612,4,1,184379,184379,184380,0,1,1
52613,4,3,184383,184383,184386,0,3,3
52614,3,2,184386,184386,184388,0,2,0
52615,4,1,184390,184390,184391,0,1,2
52616,6,1,184396,184396,184397,0,1,5
52617,4,1,184400,184400,184401,0,1,3
52618,4,1,184404,184404,184405,0,1,3
52619,3,3,184407,184407,184410,0,3,2
52620,1,1,184408,184410,184411,2,3,0
52621,2,2,184410,184411,184413,1,3,0
52622,2,3,184412,184413,184416,1,4,0
52623,2,3,184414,184416,184419,2,5,0
52624,4,1,184418,184419,184420,1,2,0
52625,1,1,184419,184420,184421,1,2,0
52626,4,3,184423,184423,184426,0,3,2
52627,3,3,184426,184426,184429,0,3,0
52628,5,1,184431,184431,184432,0,1,2
52629,5,2,184436,184436,184438,0,2,4
52630,2,3,184438,184438,184441,0,3,0
52631,6,3,184444,184444,184447,0,3,3
52632,6,1,184450,184450,184451,0,1,3
52633,4,3,184454,184454,184457,0,3,3
52634,2,1,184456,184457,184458,1,2,0
52635,3,3,184459,184459,184462,0,3,1
52636,3,1,184462,184462,184463,0,1,0
52637,4,3,184466,184466,184469,0,3,3
52638,4,3,184470,184470,184473,0,3,1
52639,4,3,184474,184474,184477,0,3,1
52640,2,3,184476,184477,184480,1,4,0
52641,6,2,184482,184482,184484,0,2,2
52642,3,2,184485,184485,184487,0,2,1
52643,3,2,184488,184488,184490,0,2,1
52644,5,1,184493,184493,184494,0,1,3
52645,5,2,184498,184498,184500,0,2,4
52646,4,3,184502,184502,184505,0,3,2
52647,3,2,184505,184505,184507,0,2,0
52648,2,2,184507,184507,184509,0,2,0
52649,1,1,184508,184509,184510,1,2,0
52650,4,2,184512,184512,184514,0,2,2
52651,4,3,184516,184516,184519,0,3,2
52652,3,1,184519,184519,184520,0,1,0
52653,1,2,184520,184520,184522,0,2,0
52654,1,1,184521,184522,184523,1,2,0
52655,5,1,184526,184526,184527,0,1,3
52656,3,1,184529,184529,184530,0,1,2
52657,1,1,184530,184530,184531,0,1,0
52658,5,3,184535,184535,184538,0,3,4
52659,4,3,184539,184539,184542,0,3,1
52660,5,3,184544,184544,184547,0,3,2
52661,2,2,184546,184547,184549,1,3,0
52662,1,1,184547,184549,184550,2,3,0
52663,2,3,184549,184550,184553,1,4,0
52664,6,2,184555,184555,184557,0,2,2
52665,4,3,184559,184559,184562,0,3,2
52666,2,3,184561,184562,184565,1,4,0
52667,2,2,184563,184565,184567,2,4,0
52668,6,2,184569,184569,184571,0,2,2
52669,6,1,184575,184575,184576,0,1,4
52670,5,3,184580,184580,184583,0,3,4
52671,5,1,184585,184585,184586,0,1,2
52672,2,3,184587,184587,184590,0,3,1
52673,3,3,184590,184590,184593,0,3,0
52674,5,3,184595,184595,184598,0,3,2
52675,1,1,184596,184598,184599,2,3,0
52676,5,1,184601,184601,184602,0,1,2
52677,6,1,184607,184607,184608,0,1,5
52678,3,1,184610,184610,184611,0,1,2
52679,4,1,184614,184614,184615,0,1,3
52680,2,3,184616,184616,184619,0,3,1
52681,3,3,184619,184619,184622,0,3,0
52682,5,2,184624,184624,184626,0,2,2
52683,4,2,184628,184628,184630,0,2,2
52684,1,3,184629,184630,184633,1,4,0
52685,5,3,184634,184634,184637,0,3,1
52686,4,2,184638,184638,184640,0,2,1
52687,1,2,184639,184640,184642,1,3,0
52688,4,2,184643,184643,184645,0,2,1
52689,1,2,184644,184645,184647,1,3,0
52690,2,2,184646,184647,184649,1,3,0
52691,2,3,184648,184649,184652,1,4,0
52692,2,3,184650,184652,184655,2,5,0
52693,4,3,184654,184655,184658,1,4,0
52694,3,2,184657,184658,184660,1,3,0
52695,4,3,184661,184661,184664,0,3,1
52696,2,1,184663,184664,184665,1,2,0
52697,4,1,184667,184667,184668,0,1,2
52698,2,1,184669,184669,184670,0,1,1
52699,4,1,184673,184673,184674,0,1,3
52700,3,3,184676,184676,184679,0,3,2
52701,1,3,184677,184679,184682,2,5,0
52702,2,2,184679,184682,184684,3,5,0
52703,4,1,184683,184684,184685,1,2,0
52704,2,2,184685,184685,184687,0,2,0
52705,3,2,184688,184688,184690,0,2,1
52706,3,1,184691,184691,184692,0,1,1
52707,5,3,184696,184696,184699,0,3,4
52708,1,1,184697,184699,184700,2,3,0
52709,1,1,184698,184700,184701,2,3,0
52710,4,1,184702,184702,184703,0,1,1
52711,1,2,184703,184703,184705,0,2,0
52712,2,2,184705,184705,184707,0,2,0
52713,1,1,184706,184707,184708,1,2,0
52714,1,1,184707,184708,184709,1,2,0
52715,5,3,184712,184712,184715,0,3,3
52716,6,2,184718,184718,184720,0,2,3
52717,4,3,184722,184722,184725,0,3,2
52718,5,1,184727,184727,184728,0,1,2
52719,6,1,184733,184733,184734,0,1,5
52720,3,1,184736,184736,184737,0,1,2
52721,6,1,184742,184742,184743,0,1,5
52722,3,2,184745,184745,184747,0,2,2
52723,5,1,184750,184750,184751,0,1,3
52724,2,2,184752,184752,184754,0,2,1
52725,2,3,184754,184754,184757,0,3,0
52726,5,2,184759,184759,184761,0,2,2
52727,5,1,184764,184764,184765,0,1,3
52728,3,3,184767,184767,184770,0,3,2
52729,1,2,184768,184770,184772,2,4,0
52730,1,2,184769,184772,184774,3,5,0
52731,4,1,184773,184774,184775,1,2,0
52732,1,3,184774,184775,184778,1,4,0
52733,2,1,184776,184778,184779,2,3,0
52734,1,2,184777,184779,184781,2,4,0
52735,3,1,184780,184781,184782,1,2,0
52736,2,2,184782,184782,184784,0,2,0
52737,6,3,184788,184788,184791,0,3,4
52738,1,1,184789,184791,184792,2,3,0
52739,4,2,184793,184793,184795,0,2,1
52740,6,2,184799,184799,184801,0,2,4
52741,4,2,184803,184803,184805,0,2,2
52742,6,2,184809,184809,184811,0,2,4
52743,2,1,184811,184811,184812,0,1,0
52744,4,2,184815,184815,184817,0,2,3
52745,4,2,184819,184819,184821,0,2,2
52746,4,1,184823,184823,184824,0,1,2
52747,1,2,184824,184824,184826,0,2,0
52748,2,3,184826,184826,184829,0,3,0
52749,1,3,184827,184829,184832,2,5,0
52750,3,1,184830,184832,184833,2,3,0
52751,3,2,184833,184833,184835,0,2,0
52752,4,1,184837,184837,184838,0,1,2
52753,3,3,184840,184840,184843,0,3,2
52754,6,2,184846,184846,184848,0,2,3
52755,3,3,184849,184849,184852,0,3,1
52756,5,3,184854,184854,184857,0,3,2
52757,4,2,184858,184858,184860,0,2,1
52758,4,1,184862,184862,184863,0,1,2
52759,6,3,184868,184868,184871,0,3,5
52760,2,3,184870,184871,184874,1,4,0
52761,3,1,184873,184874,184875,1,2,0
52762,2,1,184875,184875,184876,0,1,0
52763,2,3,184877,184877,184880,0,3,1
52764,6,2,184883,184883,184885,0,2,3
52765,3,1,184886,184886,184887,0,1,1
52766,2,1,184888,184888,184889,0,1,1
52767,6,3,184894,184894,184897,0,3,5
52768,1,1,184895,184897,184898,2,3,0
52769,1,3,184896,184898,184901,2,5,0
52770,6,1,184902,184902,184903,0,1,1
52771,6,1,184908,184908,184909,0,1,5
52772,3,1,184911,184911,184912,0,1,2
52773,2,1,184913,184913,184914,0,1,1
52774,2,1,184915,184915,184916,0,1,1
52775,3,3,184918,184918,184921,0,3,2
52776,4,1,184922,184922,184923,0,1,1
52777,6,1,184928,184928,184929,0,1,5
52778,2,3,184930,184930,184933,0,3,1
52779,2,3,184932,184933,184936,1,4,0
52780,3,1,184935,184936,184937,1,2,0
52781,6,2,184941,184941,184943,0,2,4
52782,1,3,184942,184943,184946,1,4,0
52783,2,2,184944,184946,184948,2,4,0
52784,3,1,184947,184948,184949,1,2,0
52785,2,1,184949,184949,184950,0,1,0
52786,3,3,184952,184952,184955,0,3,2
52787,4,3,184956,184956,184959,0,3,1
52788,5,2,184961,184961,184963,0,2,2
52789,2,1,184963,184963,184964,0,1,0
52790,4,2,184967,184967,184969,0,2,3
52791,4,3,184971,184971,184974,0,3,2
52792,5,1,184976,184976,184977,0,1,2
52793,5,3,184981,184981,184984,0,3,4
52794,6,1,184987,184987,184988,0,1,3
52795,6,3,184993,184993,184996,0,3,5
52796,5,1,184998,184998,184999,0,1,2
52797,4,3,185002,185002,185005,0,3,3
52798,1,2,185003,185005,185007,2,4,0
52799,5,2,185008,185008,185010,0,2,1
52800,3,3,185011,185011,185014,0,3,1
52801,1,1,185012,185014,185015,2,3,0
52802,2,3,185014,185015,185018,1,4,0
52803,1,1,185015,185018,185019,3,4,0
52804,4,2,185019,185019,185021,0,2,0
52805,2,3,185021,185021,185024,0,3,0
52806,5,1,185026,185026,185027,0,1,2
52807,4,3,185030,185030,185033,0,3,3
52808,6,1,185036,185036,185037,0,1,3
52809,2,3,185038,185038,185041,0,3,1
52810,2,3,185040,185041,185044,1,4,0
52811,1,3,185041,185044,185047,3,6,0
52812,1,2,185042,185047,185049,5,7,0
52813,4,3,185046,185049,185052,3,6,0
52814,3,1,185049,185052,185053,3,4,0
52815,6,1,185055,185055,185056,0,1,2
52816,2,2,185057,185057,185059,0,2,1
52817,1,1,185058,185059,185060,1,2,0
52818,4,3,185062,185062,185065,0,3,2
52819,6,2,185068,185068,185070,0,2,3
52820,3,2,185071,185071,185073,0,2,1
52821,3,3,185074,185074,185077,0,3,1
52822,2,3,185076,185077,185080,1,4,0
52823,4,2,185080,185080,185082,0,2,0
52824,2,2,185082,185082,185084,0,2,0
52825,4,3,185086,185086,185089,0,3,2
52826,5,1,185091,185091,185092,0,1,2
52827,2,2,185093,185093,185095,0,2,1
52828,6,2,185099,185099,185101,0,2,4
52829,6,1,185105,185105,185106,0,1,4
52830,5,1,185110,185110,185111,0,1,4
52831,1,3,185111,185111,185114,0,3,0
52832,1,1,185112,185114,185115,2,3,0
52833,3,2,185115,185115,185117,0,2,0
52834,2,2,185117,185117,185119,0,2,0
52835,3,1,185120,185120,185121,0,1,1
52836,4,2,185124,185124,185126,0,2,3
52837,5,1,185129,185129,185130,0,1,3
52838,4,1,185133,185133,185134,0,1,3
52839,3,1,185136,185136,185137,0,1,2
52840,5,2,185141,185141,185143,0,2,4
52841,2,1,185143,185143,185144,0,1,0
52842,2,2,185145,185145,185147,0,2,1
52843,3,1,185148,185148,185149,0,1,1
52844,4,1,185152,185152,185153,0,1,3
52845,4,3,185156,185156,185159,0,3,3
52846,5,3,185161,185161,185164,0,3,2
52847,4,1,185165,185165,185166,0,1,1
52848,6,1,185171,185171,185172,0,1,5
52849,5,2,185176,185176,185178,0,2,4
52850,1,1,185177,185178,185179,1,2,0
52851,2,2,185179,185179,185181,0,2,0
52852,6,3,185185,185185,185188,0,3,4
52853,3,1,185188,185188,185189,0,1,0
52854,2,2,185190,185190,185192,0,2,1
52855,5,1,185195,185195,185196,0,1,3
52856,1,1,185196,185196,185197,0,1,0
52857,6,2,185202,185202,185204,0,2,5
52858,4,2,185206,185206,185208,0,2,2
52859,1,1,185207,185208,185209,1,2,0
52860,5,3,185212,185212,185215,0,3,3
52861,5,2,185217,185217,185219,0,2,2
52862,5,2,185222,185222,185224,0,2,3
52863,4,1,185226,185226,185227,0,1,2
52864,4,3,185230,185230,185233,0,3,3
52865,3,1,185233,185233,185234,0,1,0
52866,3,2,185236,185236,185238,0,2,2
52867,3,3,185239,185239,185242,0,3,1
52868,3,2,185242,185242,185244,0,2,0
52869,5,1,185247,185247,185248,0,1,3
52870,3,3,185250,185250,185253,0,3,2
52871,2,3,185252,185253,185256,1,4,0
52872,5,2,185257,185257,185259,0,2,1
52873,1,3,185258,185259,185262,1,4,0
52874,1,2,185259,185262,185264,3,5,0
52875,1,2,185260,185264,185266,4,6,0
52876,5,3,185265,185266,185269,1,4,0
52877,3,1,185268,185269,185270,1,2,0
52878,6,3,185274,185274,185277,0,3,4
52879,5,2,185279,185279,185281,0,2,2
52880,5,3,185284,185284,185287,0,3,3
52881,4,3,185288,185288,185291,0,3,1
52882,5,3,185293,185293,185296,0,3,2
52883,6,3,185299,185299,185302,0,3,3
52884,1,2,185300,185302,185304,2,4,0
52885,4,2,185304,185304,185306,0,2,0
52886,1,2,185305,185306,185308,1,3,0
52887,5,1,185310,185310,185311,0,1,2
52888,4,2,185314,185314,185316,0,2,3
52889,3,1,185317,185317,185318,0,1,1
52890,1,1,185318,185318,185319,0,1,0
52891,3,3,185321,185321,185324,0,3,2
52892,2,3,185323,185324,185327,1,4,0
52893,5,2,185328,185328,185330,0,2,1
52894,4,1,185332,185332,185333,0,1,2
52895,5,3,185337,185337,185340,0,3,4
52896,4,1,185341,185341,185342,0,1,1
52897,1,2,185342,185342,185344,0,2,0
52898,2,2,185344,185344,185346,0,2,0
52899,5,3,185349,185349,185352,0,3,3
52900,4,3,185353,185353,185356,0,3,1
52901,5,2,185358,185358,185360,0,2,2
52902,2,1,185360,185360,185361,0,1,0
52903,6,2,185366,185366,185368,0,2,5
52904,5,2,185371,185371,185373,0,2,3
52905,3,3,185374,185374,185377,0,3,1
52906,3,2,185377,185377,185379,0,2,0
52907,1,2,185378,185379,185381,1,3,0
52908,2,3,185380,185381,185384,1,4,0
52909,2,2,185382,185384,185386,2,4,0
52910,3,3,185385,185386,185389,1,4,0
52911,2,2,185387,185389,185391,2,4,0
52912,3,3,185390,185391,185394,1,4,0
52913,3,2,185393,185394,185396,1,3,0
52914,3,1,185396,185396,185397,0,1,0
52915,6,1,185402,185402,185403,0,1,5
52916,6,1,185408,185408,185409,0,1,5
52917,4,3,185412,185412,185415,0,3,3
52918,1,2,185413,185415,185417,2,4,0
52919,4,1,185417,185417,185418,0,1,0
52920,5,3,185422,185422,185425,0,3,4
52921,6,2,185428,185428,185430,0,2,3
52922,5,3,185433,185433,185436,0,3,3
52923,1,2,185434,185436,185438,2,4,0
52924,6,2,185440,185440,185442,0,2,2
52925,3,3,185443,185443,185446,0,3,1
52926,3,3,185446,185446,185449,0,3,0
52927,4,3,185450,185450,185453,0,3,1
52928,5,3,185455,185455,185458,0,3,2
52929,3,2,185458,185458,185460,0,2,0
52930,2,2,185460,185460,185462,0,2,0
52931,3,1,185463,185463,185464,0,1,1
52932,6,3,185469,185469,185472,0,3,5
52933,6,1,185475,185475,185476,0,1,3
52934,1,2,185476,185476,185478,0,2,0
52935,6,3,185482,185482,185485,0,3,4
52936,5,2,185487,185487,185489,0,2,2
52937,1,2,185488,185489,185491,1,3,0
52938,5,2,185493,185493,185495,0,2,2
52939,6,2,185499,185499,185501,0,2,4
52940,3,2,185502,185502,185504,0,2,1
52941,2,3,185504,185504,185507,0,3,0
52942,3,1,185507,185507,185508,0,1,0
52943,1,3,185508,185508,185511,0,3,0
52944,4,2,185512,185512,185514,0,2,1
52945,2,2,185514,185514,185516,0,2,0
52946,1,3,185515,185516,185519,1,4,0
52947,5,2,185520,185520,185522,0,2,1
52948,5,2,185525,185525,185527,0,2,3
52949,4,2,185529,185529,185531,0,2,2
52950,4,1,185533,185533,185534,0,1,2
52951,1,3,185534,185534,185537,0,3,0
52952,6,2,185540,185540,185542,0,2,3
52953,6,3,185546,185546,185549,0,3,4
52954,5,3,185551,185551,185554,0,3,2
52955,4,2,185555,185555,185557,0,2,1
52956,5,1,185560,185560,185561,0,1,3
52957,2,3,185562,185562,185565,0,3,1
52958,2,3,185564,185565,185568,1,4,0
52959,1,1,185565,185568,185569,3,4,0
52960,6,3,185571,185571,185574,0,3,2
52961,1,1,185572,185574,185575,2,3,0
52962,3,3,185575,185575,185578,0,3,0
52963,4,2,185579,185579,185581,0,2,1
52964,4,1,185583,185583,185584,0,1,2
52965,4,3,185587,185587,185590,0,3,3
52966,5,3,185592,185592,185595,0,3,2
52967,5,2,185597,185597,185599,0,2,2
52968,5,2,185602,185602,185604,0,2,3
52969,3,1,185605,185605,185606,0,1,1
52970,4,3,185609,185609,185612,0,3,3
52971,5,2,185614,185614,185616,0,2,2
52972,1,1,185615,185616,185617,1,2,0
52973,1,3,185616,185617,185620,1,4,0
52974,3,3,185619,185620,185623,1,4,0
52975,4,3,185623,185623,185626,0,3,0
52976,2,1,185625,185626,185627,1,2,0
52977,1,2,185626,185627,185629,1,3,0
52978,6,1,185632,185632,185633,0,1,3
52979,2,2,185634,185634,185636,0,2,1
52980,4,3,185638,185638,185641,0,3,2
52981,4,2,185642,185642,185644,0,2,1
52982,4,3,185646,185646,185649,0,3,2
52983,5,2,185651,185651,185653,0,2,2
52984,4,2,185655,185655,185657,0,2,2
52985,6,2,185661,185661,185663,0,2,4
52986,5,3,185666,185666,185669,0,3,3
52987,6,3,185672,185672,185675,0,3,3
52988,3,3,185675,185675,185678,0,3,0
52989,4,2,185679,185679,185681,0,2,1
52990,4,3,185683,185683,185686,0,3,2
52991,4,2,185687,185687,185689,0,2,1
52992,5,3,185692,185692,185695,0,3,3
52993,1,1,185693,185695,185696,2,3,0
52994,3,3,185696,185696,185699,0,3,0
52995,6,1,185702,185702,185703,0,1,3
52996,1,3,185703,185703,185706,0,3,0
52997,1,2,185704,185706,185708,2,4,0
52998,5,1,185709,185709,185710,0,1,1
52999,1,3,185710,185710,185713,0,3,0
53000,6,2,185716,185716,185718,0,2,3
53001,5,3,185721,185721,185724,0,3,3
53002,4,2,185725,185725,185727,0,2,1
53003,6,3,185731,185731,185734,0,3,4
53004,5,2,185736,185736,185738,0,2,2
53005,2,1,185738,185738,185739,0,1,0
53006,1,3,185739,185739,185742,0,3,0
53007,4,1,185743,185743,185744,0,1,1
53008,3,3,185746,185746,185749,0,3,2
53009,1,2,185747,185749,185751,2,4,0
53010,5,2,185752,185752,185754,0,2,1
53011,3,2,185755,185755,185757,0,2,1
53012,4,1,185759,185759,185760,0,1,2
53013,2,1,185761,185761,185762,0,1,1
53014,4,3,185765,185765,185768,0,3,3
53015,1,1,185766,185768,185769,2,3,0
53016,2,2,185768,185769,185771,1,3,0
53017,6,2,185774,185774,185776,0,2,3
53018,2,3,185776,185776,185779,0,3,0
53019,5,2,185781,185781,185783,0,2,2
53020,6,1,185787,185787,185788,0,1,4
53021,5,1,185792,185792,185793,0,1,4
53022,1,3,185793,185793,185796,0,3,0
53023,1,2,185794,185796,185798,2,4,0
53024,2,3,185796,185798,185801,2,5,0
53025,5,2,185801,185801,185803,0,2,0
53026,3,1,185804,185804,185805,0,1,1
53027,4,3,185808,185808,185811,0,3,3
53028,6,3,185814,185814,185817,0,3,3
53029,1,3,185815,185817,185820,2,5,0
53030,2,1,185817,185820,185821,3,4,0
53031,6,1,185823,185823,185824,0,1,2
53032,6,1,185829,185829,185830,0,1,5
53033,5,2,185834,185834,185836,0,2,4
53034,6,2,185840,185840,185842,0,2,4
53035,6,2,185846,185846,185848,0,2,4
53036,4,3,185850,185850,185853,0,3,2
53037,2,3,185852,185853,185856,1,4,0
53038,1,1,185853,185856,185857,3,4,0
53039,5,2,185858,185858,185860,0,2,1
53040,5,3,185863,185863,185866,0,3,3
53041,6,1,185869,185869,185870,0,1,3
53042,2,3,185871,185871,185874,0,3,1
53043,4,2,185875,185875,185877,0,2,1
53044,2,1,185877,185877,185878,0,1,0
53045,6,2,185883,185883,185885,0,2,5
53046,5,3,185888,185888,185891,0,3,3
53047,5,1,185893,185893,185894,0,1,2
53048,2,1,185895,185895,185896,0,1,1
53049,5,2,185900,185900,185902,0,2,4
53050,2,2,185902,185902,185904,0,2,0
53051,2,2,185904,185904,185906,0,2,0
53052,3,3,185907,185907,185910,0,3,1
53053,2,2,185909,185910,185912,1,3,0
53054,3,2,185912,185912,185914,0,2,0
53055,1,1,185913,185914,185915,1,2,0
53056,6,3,185919,185919,185922,0,3,4
53057,1,2,185920,185922,185924,2,4,0
53058,4,1,185924,185924,185925,0,1,0
53059,3,3,185927,185927,185930,0,3,2
53060,5,1,185932,185932,185933,0,1,2
53061,6,2,185938,185938,185940,0,2,5
53062,6,3,185944,185944,185947,0,3,4
53063,2,1,185946,185947,185948,1,2,0
53064,3,3,185949,185949,185952,0,3,1
53065,4,1,185953,185953,185954,0,1,1
53066,3,1,185956,185956,185957,0,1,2
53067,4,1,185960,185960,185961,0,1,3
53068,2,2,185962,185962,185964,0,2,1
53069,1,2,185963,185964,185966,1,3,0
53070,2,1,185965,185966,185967,1,2,0
53071,2,3,185967,185967,185970,0,3,0
53072,2,3,185969,185970,185973,1,4,0
53073,1,1,185970,185973,185974,3,4,0
53074,5,2,185975,185975,185977,0,2,1
53075,2,3,185977,185977,185980,0,3,0
53076,6,1,185983,185983,185984,0,1,3
53077,3,3,185986,185986,185989,0,3,2
53078,3,2,185989,185989,185991,0,2,0
53079,5,3,185994,185994,185997,0,3,3
53080,2,2,185996,185997,185999,1,3,0
53081,2,1,185998,185999,186000,1,2,0
53082,5,2,186003,186003,186005,0,2,3
53083,3,1,186006,186006,186007,0,1,1
53084,3,3,186009,186009,186012,0,3,2
53085,6,2,186015,186015,186017,0,2,3
53086,3,2,186018,186018,186020,0,2,1
53087,1,2,186019,186020,186022,1,3,0
53088,4,2,186023,186023,186025,0,2,1
53089,4,2,186027,186027,186029,0,2,2
53090,5,2,186032,186032,186034,0,2,3
53091,6,1,186038,186038,186039,0,1,4
53092,5,2,186043,186043,186045,0,2,4
53093,6,1,186049,186049,186050,0,1,4
53094,6,2,186055,186055,186057,0,2,5
53095,6,3,186061,186061,186064,0,3,4
53096,4,3,186065,186065,186068,0,3,1
53097,6,2,186071,186071,186073,0,2,3
53098,3,2,186074,186074,186076,0,2,1
53099,6,2,186080,186080,186082,0,2,4
53100,4,1,186084,186084,186085,0,1,2
53101,3,1,186087,186087,186088,0,1,2
53102,6,2,186093,186093,186095,0,2,5
53103,1,3,186094,186095,186098,1,4,0
53104,1,3,186095,186098,186101,3,6,0
53105,1,1,186096,186101,186102,5,6,0
53106,3,3,186099,186102,186105,3,6,0
53107,2,3,186101,186105,186108,4,7,0
53108,2,2,186103,186108,186110,5,7,0
53109,6,2,186109,186110,186112,1,3,0
53110,3,1,186112,186112,186113,0,1,0
53111,2,3,186114,186114,186117,0,3,1
53112,2,2,186116,186117,186119,1,3,0
53113,2,3,186118,186119,186122,1,4,0
53114,6,3,186124,186124,186127,0,3,2
53115,2,3,186126,186127,186130,1,4,0
53116,3,3,186129,186130,186133,1,4,0
53117,5,2,186134,186134,186136,0,2,1
53118,1,3,186135,186136,186139,1,4,0
53119,2,1,186137,186139,186140,2,3,0
53120,3,2,186140,186140,186142,0,2,0
53121,1,1,186141,186142,186143,1,2,0
53122,1,3,186142,186143,186146,1,4,0
53123,5,2,186147,186147,186149,0,2,1
53124,3,2,186150,186150,186152,0,2,1
53125,3,2,186153,186153,186155,0,2,1
53126,1,3,186154,186155,186158,1,4,0
53127,3,3,186157,186158,186161,1,4,0
53128,6,3,186163,186163,186166,0,3,2
53129,3,2,186166,186166,186168,0,2,0
53130,6,3,186172,186172,186175,0,3,4
53131,1,2,186173,186175,186177,2,4,0
53132,3,2,186176,186177,186179,1,3,0
53133,5,3,186181,186181,186184,0,3,2
53134,4,2,186185,186185,186187,0,2,1
53135,1,3,186186,186187,186190,1,4,0
53136,4,3,186190,186190,186193,0,3,0
53137,3,2,186193,186193,186195,0,2,0
53138,2,2,186195,186195,186197,0,2,0
53139,6,2,186201,186201,186203,0,2,4
53140,5,3,186206,186206,186209,0,3,3
53141,1,2,186207,186209,186211,2,4,0
53142,2,3,186209,186211,186214,2,5,0
53143,1,3,186210,186214,186217,4,7,0
53144,5,3,186215,186217,186220,2,5,0
53145,6,3,186221,186221,186224,0,3,1
53146,4,2,186225,186225,186227,0,2,1
53147,3,1,186228,186228,186229,0,1,1
53148,4,3,186232,186232,186235,0,3,3
53149,3,2,186235,186235,186237,0,2,0
53150,1,2,186236,186237,186239,1,3,0
53151,4,1,186240,186240,186241,0,1,1
53152,4,1,186244,186244,186245,0,1,3
53153,6,2,186250,186250,186252,0,2,5
53154,6,1,186256,186256,186257,0,1,4
53155,5,1,186261,186261,186262,0,1,4
53156,5,3,186266,186266,186269,0,3,4
53157,3,1,186269,186269,186270,0,1,0
53158,5,1,186274,186274,186275,0,1,4
53159,2,1,186276,186276,186277,0,1,1
53160,5,2,186281,186281,186283,0,2,4
53161,3,2,186284,186284,186286,0,2,1
53162,2,3,186286,186286,186289,0,3,0
53163,1,2,186287,186289,186291,2,4,0
53164,4,1,186291,186291,186292,0,1,0
53165,6,2,186297,186297,186299,0,2,5
53166,3,1,186300,186300,186301,0,1,1
53167,1,1,186301,186301,186302,0,1,0
53168,2,3,186303,186303,186306,0,3,1
53169,1,3,186304,186306,186309,2,5,0
53170,6,3,186310,186310,186313,0,3,1
53171,1,1,186311,186313,186314,2,3,0
53172,6,2,186317,186317,186319,0,2,3
53173,5,1,186322,186322,186323,0,1,3
53174,5,3,186327,186327,186330,0,3,4
53175,2,3,186329,186330,186333,1,4,0
53176,1,2,186330,186333,186335,3,5,0
53177,1,1,186331,186335,186336,4,5,0
53178,1,2,186332,186336,186338,4,6,0
53179,1,3,186333,186338,186341,5,8,0
53180,6,2,186339,186341,186343,2,4,0
53181,4,1,186343,186343,186344,0,1,0
53182,6,3,186349,186349,186352,0,3,5
53183,5,1,186354,186354,186355,0,1,2
53184,3,1,186357,186357,186358,0,1,2
53185,3,1,186360,186360,186361,0,1,2
53186,3,2,186363,186363,186365,0,2,2
53187,1,1,186364,186365,186366,1,2,0
53188,4,3,186368,186368,186371,0,3,2
53189,4,2,186372,186372,186374,0,2,1
53190,1,2,186373,186374,186376,1,3,0
53191,3,1,186376,186376,186377,0,1,0
53192,2,2,186378,186378,186380,0,2,1
53193,3,2,186381,186381,186383,0,2,1
53194,5,2,186386,186386,186388,0,2,3
53195,3,2,186389,186389,186391,0,2,1
53196,4,2,186393,186393,186395,0,2,2
53197,3,1,186396,186396,186397,0,1,1
53198,1,2,186397,186397,186399,0,2,0
53199,1,3,186398,186399,186402,1,4,0
53200,2,2,186400,186402,186404,2,4,0
53201,4,3,186404,186404,186407,0,3,0
53202,1,2,186405,186407,186409,2,4,0
53203,4,2,186409,186409,186411,0,2,0
53204,2,2,186411,186411,186413,0,2,0
53205,3,3,186414,186414,186417,0,3,1
53206,4,1,186418,186418,186419,0,1,1
53207,2,2,186420,186420,186422,0,2,1
53208,3,2,186423,186423,186425,0,2,1
53209,1,2,186424,186425,186427,1,3,0
53210,4,2,186428,186428,186430,0,2,1
53211,6,2,186434,186434,186436,0,2,4
53212,5,3,186439,186439,186442,0,3,3
53213,4,3,186443,186443,186446,0,3,1
53214,6,3,186449,186449,186452,0,3,3
53215,4,2,186453,186453,186455,0,2,1
53216,2,1,186455,186455,186456,0,1,0
53217,4,3,186459,186459,186462,0,3,3
53218,1,3,186460,186462,186465,2,5,0
53219,2,3,186462,186465,186468,3,6,0
53220,5,3,186467,186468,186471,1,4,0
53221,1,1,186468,186471,186472,3,4,0
53222,5,1,186473,186473,186474,0,1,1
53223,3,2,186476,186476,186478,0,2,2
53224,4,2,186480,186480,186482,0,2,2
53225,2,2,186482,186482,186484,0,2,0
53226,5,1,186487,186487,186488,0,1,3
53227,4,3,186491,186491,186494,0,3,3
53228,6,2,186497,186497,186499,0,2,3
53229,2,3,186499,186499,186502,0,3,0
53230,1,3,186500,186502,186505,2,5,0
53231,6,1,186506,186506,186507,0,1,1
53232,1,3,186507,186507,186510,0,3,0
53233,4,1,186511,186511,186512,0,1,1
53234,2,1,186513,186513,186514,0,1,1
53235,1,1,186514,186514,186515,0,1,0
53236,5,1,186519,186519,186520,0,1,4
53237,6,3,186525,186525,186528,0,3,5
53238,2,3,186527,186528,186531,1,4,0
53239,1,3,186528,186531,186534,3,6,0
53240,1,1,186529,186534,186535,5,6,0
53241,4,2,186533,186535,186537,2,4,0
53242,6,3,186539,186539,186542,0,3,2
53243,2,3,186541,186542,186545,1,4,0
53244,1,3,186542,186545,186548,3,6,0
53245,2,1,186544,186548,186549,4,5,0
53246,2,3,186546,186549,186552,3,6,0
53247,5,2,186551,186552,186554,1,3,0
53248,1,1,186552,186554,186555,2,3,0
53249,1,2,186553,186555,186557,2,4,0
53250,5,1,186558,186558,186559,0,1,1
53251,6,2,186564,186564,186566,0,2,5
53252,2,1,186566,186566,186567,0,1,0
53253,3,2,186569,186569,186571,0,2,2
53254,6,3,186575,186575,186578,0,3,4
53255,6,2,186581,186581,186583,0,2,3
53256,3,1,186584,186584,186585,0,1,1
53257,6,2,186590,186590,186592,0,2,5
53258,6,2,186596,186596,186598,0,2,4
53259,6,3,186602,186602,186605,0,3,4
53260,4,1,186606,186606,186607,0,1,1
53261,2,2,186608,186608,186610,0,2,1
53262,3,3,186611,186611,186614,0,3,1
53263,4,3,186615,186615,186618,0,3,1
53264,5,1,186620,186620,186621,0,1,2
53265,4,1,186624,186624,186625,0,1,3
53266,6,1,186630,186630,186631,0,1,5
53267,3,1,186633,186633,186634,0,1,2
53268,2,3,186635,186635,186638,0,3,1
53269,1,2,186636,186638,186640,2,4,0
53270,4,3,186640,186640,186643,0,3,0
53271,6,3,186646,186646,186649,0,3,3
53272,2,2,186648,186649,186651,1,3,0
53273,5,2,186653,186653,186655,0,2,2
53274,6,2,186659,186659,186661,0,2,4
53275,3,1,186662,186662,186663,0,1,1
53276,2,1,186664,186664,186665,0,1,1
53277,6,3,186670,186670,186673,0,3,5
53278,1,2,186671,186673,186675,2,4,0
53279,2,2,186673,186675,186677,2,4,0
53280,1,3,186674,186677,186680,3,6,0
53281,4,3,186678,186680,186683,2,5,0
53282,2,2,186680,186683,186685,3,5,0
53283,1,3,186681,186685,186688,4,7,0
53284,4,1,186685,186688,186689,3,4,0
53285,6,2,186691,186691,186693,0,2,2
53286,3,3,186694,186694,186697,0,3,1
53287,4,1,186698,186698,186699,0,1,1
53288,1,1,186699,186699,186700,0,1,0
53289,2,3,186701,186701,186704,0,3,1
53290,3,3,186704,186704,186707,0,3,0
53291,3,2,186707,186707,186709,0,2,0
53292,4,3,186711,186711,186714,0,3,2
53293,3,3,186714,186714,186717,0,3,0
53294,4,2,186718,186718,186720,0,2,1
53295,5,3,186723,186723,186726,0,3,3
53296,1,1,186724,186726,186727,2,3,0
53297,1,2,186725,186727,186729,2,4,0
53298,5,2,186730,186730,186732,0,2,1
53299,6,2,186736,186736,186738,0,2,4
53300,6,1,186742,186742,186743,0,1,4
53301,3,3,186745,186745,186748,0,3,2
53302,1,2,186746,186748,186750,2,4,0
53303,4,3,186750,186750,186753,0,3,0
53304,6,1,186756,186756,186757,0,1,3
53305,3,3,186759,186759,186762,0,3,2
53306,2,2,186761,186762,186764,1,3,0
53307,3,1,186764,186764,186765,0,1,0
53308,2,1,186766,186766,186767,0,1,1
53309,2,3,186768,186768,186771,0,3,1
53310,6,3,186774,186774,186777,0,3,3
53311,3,3,186777,186777,186780,0,3,0
53312,4,2,186781,186781,186783,0,2,1
53313,5,2,186786,186786,186788,0,2,3
53314,2,2,186788,186788,186790,0,2,0
53315,3,1,186791,186791,186792,0,1,1
53316,4,1,186795,186795,186796,0,1,3
53317,4,3,186799,186799,186802,0,3,3
53318,2,3,186801,186802,186805,1,4,0
53319,4,2,186805,186805,186807,0,2,0
53320,5,3,186810,186810,186813,0,3,3
53321,2,2,186812,186813,186815,1,3,0
53322,3,2,186815,186815,186817,0,2,0
53323,1,3,186816,186817,186820,1,4,0
53324,3,1,186819,186820,186821,1,2,0
53325,5,2,186824,186824,186826,0,2,3
53326,1,3,186825,186826,186829,1,4,0
53327,2,1,186827,186829,186830,2,3,0
53328,5,1,186832,186832,186833,0,1,2
53329,4,2,186836,186836,186838,0,2,3
53330,5,2,186841,186841,186843,0,2,3
53331,4,1,186845,186845,186846,0,1,2
53332,3,3,186848,186848,186851,0,3,2
53333,6,2,186854,186854,186856,0,2,3
53334,6,1,186860,186860,186861,0,1,4
53335,5,2,186865,186865,186867,0,2,4
53336,4,3,186869,186869,186872,0,3,2
53337,3,1,186872,186872,186873,0,1,0
53338,5,3,186877,186877,186880,0,3,4
53339,2,1,186879,186880,186881,1,2,0
53340,4,1,186883,186883,186884,0,1,2
53341,4,2,186887,186887,186889,0,2,3
53342,3,3,186890,186890,186893,0,3,1
53343,3,1,186893,186893,186894,0,1,0
53344,3,3,186896,186896,186899,0,3,2
53345,5,2,186901,186901,186903,0,2,2
53346,3,3,186904,186904,186907,0,3,1
53347,2,2,186906,186907,186909,1,3,0
53348,6,3,186912,186912,186915,0,3,3
53349,1,2,186913,186915,186917,2,4,0
53350,2,2,186915,186917,186919,2,4,0
53351,5,3,186920,186920,186923,0,3,1
53352,1,3,186921,186923,186926,2,5,0
53353,4,2,186925,186926,186928,1,3,0
53354,3,1,186928,186928,186929,0,1,0
53355,5,2,186933,186933,186935,0,2,4
53356,1,1,186934,186935,186936,1,2,0
53357,3,3,186937,186937,186940,0,3,1
53358,5,1,186942,186942,186943,0,1,2
53359,4,2,186946,186946,186948,0,2,3
53360,5,3,186951,186951,186954,0,3,3
53361,3,2,186954,186954,186956,0,2,0
53362,3,3,186957,186957,186960,0,3,1
53363,6,3,186963,186963,186966,0,3,3
53364,2,1,186965,186966,186967,1,2,0
53365,2,1,186967,186967,186968,0,1,0
53366,2,1,186969,186969,186970,0,1,1
53367,6,2,186975,186975,186977,0,2,5
53368,4,1,186979,186979,186980,0,1,2
53369,1,3,186980,186980,186983,0,3,0
53370,6,3,186986,186986,186989,0,3,3
53371,4,1,186990,186990,186991,0,1,1
53372,1,2,186991,186991,186993,0,2,0
53373,1,2,186992,186993,186995,1,3,0
53374,4,2,186996,186996,186998,0,2,1
53375,6,2,187002,187002,187004,0,2,4
53376,5,3,187007,187007,187010,0,3,3
53377,1,2,187008,187010,187012,2,4,0
53378,3,2,187011,187012,187014,1,3,0
53379,3,3,187014,187014,187017,0,3,0
53380,1,3,187015,187017,187020,2,5,0
53381,5,1,187020,187020,187021,0,1,0
53382,2,2,187022,187022,187024,0,2,1
53383,2,1,187024,187024,187025,0,1,0
53384,3,3,187027,187027,187030,0,3,2
53385,4,3,187031,187031,187034,0,3,1
53386,4,3,187035,187035,187038,0,3,1
53387,6,2,187041,187041,187043,0,2,3
53388,5,2,187046,187046,187048,0,2,3
53389,2,2,187048,187048,187050,0,2,0
53390,2,3,187050,187050,187053,0,3,0
53391,6,2,187056,187056,187058,0,2,3
53392,5,3,187061,187061,187064,0,3,3
53393,2,1,187063,187064,187065,1,2,0
53394,2,1,187065,187065,187066,0,1,0
53395,5,1,187070,187070,187071,0,1,4
53396,1,3,187071,187071,187074,0,3,0
53397,1,2,187072,187074,187076,2,4,0
53398,6,3,187078,187078,187081,0,3,2
53399,5,3,187083,187083,187086,0,3,2
53400,4,3,187087,187087,187090,0,3,1
53401,2,2,187089,187090,187092,1,3,0
53402,4,1,187093,187093,187094,0,1,1
53403,4,1,187097,187097,187098,0,1,3
53404,5,1,187102,187102,187103,0,1,4
53405,6,2,187108,187108,187110,0,2,5
53406,5,3,187113,187113,187116,0,3,3
53407,6,1,187119,187119,187120,0,1,3
53408,6,2,187125,187125,187127,0,2,5
53409,5,1,187130,187130,187131,0,1,3
53410,1,1,187131,187131,187132,0,1,0
53411,2,1,187133,187133,187134,0,1,1
53412,1,2,187134,187134,187136,0,2,0
53413,5,1,187139,187139,187140,0,1,3
53414,1,3,187140,187140,187143,0,3,0
53415,1,3,187141,187143,187146,2,5,0
53416,2,1,187143,187146,187147,3,4,0
53417,4,3,187147,187147,187150,0,3,0
53418,4,2,187151,187151,187153,0,2,1
53419,6,1,187157,187157,187158,0,1,4
53420,5,2,187162,187162,187164,0,2,4
53421,1,1,187163,187164,187165,1,2,0
53422,5,3,187168,187168,187171,0,3,3
53423,1,3,187169,187171,187174,2,5,0
53424,2,1,187171,187174,187175,3,4,0
53425,3,3,187174,187175,187178,1,4,0
53426,3,2,187177,187178,187180,1,3,0
53427,2,3,187179,187180,187183,1,4,0
53428,1,1,187180,187183,187184,3,4,0
53429,6,3,187186,187186,187189,0,3,2
53430,5,1,187191,187191,187192,0,1,2
53431,1,2,187192,187192,187194,0,2,0
53432,4,3,187196,187196,187199,0,3,2
53433,4,3,187200,187200,187203,0,3,1
53434,1,1,187201,187203,187204,2,3,0
53435,4,1,187205,187205,187206,0,1,1
53436,6,2,187211,187211,187213,0,2,5
53437,6,1,187217,187217,187218,0,1,4
53438,1,1,187218,187218,187219,0,1,0
53439,3,1,187221,187221,187222,0,1,2
53440,4,2,187225,187225,187227,0,2,3
53441,2,1,187227,187227,187228,0,1,0
53442,4,3,187231,187231,187234,0,3,3
53443,2,2,187233,187234,187236,1,3,0
53444,5,2,187238,187238,187240,0,2,2
53445,2,2,187240,187240,187242,0,2,0
53446,3,1,187243,187243,187244,0,1,1
53447,6,1,187249,187249,187250,0,1,5
53448,6,3,187255,187255,187258,0,3,5
53449,4,2,187259,187259,187261,0,2,1
53450,3,2,187262,187262,187264,0,2,1
53451,6,3,187268,187268,187271,0,3,4
53452,5,3,187273,187273,187276,0,3,2
53453,5,2,187278,187278,187280,0,2,2
53454,5,3,187283,187283,187286,0,3,3
53455,4,1,187287,187287,187288,0,1,1
53456,4,2,187291,187291,187293,0,2,3
53457,4,1,187295,187295,187296,0,1,2
53458,5,2,187300,187300,187302,0,2,4
53459,6,3,187306,187306,187309,0,3,4
53460,2,1,187308,187309,187310,1,2,0
53461,4,3,187312,187312,187315,0,3,2
53462,2,2,187314,187315,187317,1,3,0
53463,2,2,187316,187317,187319,1,3,0
53464,2,1,187318,187319,187320,1,2,0
53465,6,3,187324,187324,187327,0,3,4
53466,1,1,187325,187327,187328,2,3,0
53467,2,1,187327,187328,187329,1,2,0
53468,6,3,187333,187333,187336,0,3,4
53469,2,2,187335,187336,187338,1,3,0
53470,6,1,187341,187341,187342,0,1,3
53471,6,3,187347,187347,187350,0,3,5
53472,3,3,187350,187350,187353,0,3,0
53473,3,2,187353,187353,187355,0,2,0
53474,5,1,187358,187358,187359,0,1,3
53475,1,2,187359,187359,187361,0,2,0
53476,4,3,187363,187363,187366,0,3,2
53477,3,2,187366,187366,187368,0,2,0
53478,5,1,187371,187371,187372,0,1,3
53479,2,3,187373,187373,187376,0,3,1
53480,1,2,187374,187376,187378,2,4,0
53481,1,1,187375,187378,187379,3,4,0
53482,1,3,187376,187379,187382,3,6,0
53483,1,2,187377,187382,187384,5,7,0
53484,5,2,187382,187384,187386,2,4,0
53485,3,3,187385,187386,187389,1,4,0
53486,1,3,187386,187389,187392,3,6,0
53487,5,1,187391,187392,187393,1,2,0
53488,1,2,187392,187393,187395,1,3,0
53489,4,1,187396,187396,187397,0,1,1
53490,4,2,187400,187400,187402,0,2,3
53491,6,2,187406,187406,187408,0,2,4
53492,3,2,187409,187409,187411,0,2,1
53493,6,2,187415,187415,187417,0,2,4
53494,5,1,187420,187420,187421,0,1,3
53495,6,1,187426,187426,187427,0,1,5
53496,5,1,187431,187431,187432,0,1,4
53497,1,3,187432,187432,187435,0,3,0
53498,2,2,187434,187435,187437,1,3,0
53499,6,1,187440,187440,187441,0,1,3
53500,5,3,187445,187445,187448,0,3,4
53501,3,2,187448,187448,187450,0,2,0
53502,1,1,187449,187450,187451,1,2,0
53503,2,2,187451,187451,187453,0,2,0
53504,4,3,187455,187455,187458,0,3,2
53505,1,2,187456,187458,187460,2,4,0
53506,4,2,187460,187460,187462,0,2,0
53507,2,1,187462,187462,187463,0,1,0
53508,4,3,187466,187466,187469,0,3,3
53509,4,2,187470,187470,187472,0,2,1
53510,4,2,187474,187474,187476,0,2,2
53511,6,2,187480,187480,187482,0,2,4
53512,2,2,187482,187482,187484,0,2,0
53513,3,3,187485,187485,187488,0,3,1
53514,5,3,187490,187490,187493,0,3,2
53515,5,3,187495,187495,187498,0,3,2
53516,6,3,187501,187501,187504,0,3,3
53517,4,1,187505,187505,187506,0,1,1
53518,1,2,187506,187506,187508,0,2,0
53519,6,1,187512,187512,187513,0,1,4
53520,1,3,187513,187513,187516,0,3,0
53521,1,3,187514,187516,187519,2,5,0
53522,1,2,187515,187519,187521,4,6,0
53523,3,1,187518,187521,187522,3,4,0
53524,5,2,187523,187523,187525,0,2,1
53525,3,2,187526,187526,187528,0,2,1
53526,6,2,187532,187532,187534,0,2,4
53527,2,3,187534,187534,187537,0,3,0
53528,4,1,187538,187538,187539,0,1,1
53529,1,3,187539,187539,187542,0,3,0
53530,1,1,187540,187542,187543,2,3,0
53531,6,1,187546,187546,187547,0,1,3
53532,5,3,187551,187551,187554,0,3,4
53533,4,2,187555,187555,187557,0,2,1
53534,1,1,187556,187557,187558,1,2,0
53535,6,2,187562,187562,187564,0,2,4
53536,4,3,187566,187566,187569,0,3,2
53537,5,1,187571,187571,187572,0,1,2
53538,3,3,187574,187574,187577,0,3,2
53539,1,2,187575,187577,187579,2,4,0
53540,4,1,187579,187579,187580,0,1,0
53541,3,3,187582,187582,187585,0,3,2
53542,1,3,187583,187585,187588,2,5,0
53543,3,1,187586,187588,187589,2,3,0
53544,6,2,187592,187592,187594,0,2,3
53545,1,3,187593,187594,187597,1,4,0
53546,4,3,187597,187597,187600,0,3,0
53547,2,1,187599,187600,187601,1,2,0
53548,2,1,187601,187601,187602,0,1,0
53549,2,2,187603,187603,187605,0,2,1
53550,2,1,187605,187605,187606,0,1,0
53551,5,2,187610,187610,187612,0,2,4
53552,2,1,187612,187612,187613,0,1,0
53553,4,2,187616,187616,187618,0,2,3
53554,6,1,187622,187622,187623,0,1,4
53555,2,1,187624,187624,187625,0,1,1
53556,1,2,187625,187625,187627,0,2,0
53557,2,1,187627,187627,187628,0,1,0
53558,3,2,187630,187630,187632,0,2,2
53559,1,3,187631,187632,187635,1,4,0
53560,2,1,187633,187635,187636,2,3,0
53561,1,1,187634,187636,187637,2,3,0
53562,2,2,187636,187637,187639,1,3,0
53563,3,1,187639,187639,187640,0,1,0
53564,5,2,187644,187644,187646,0,2,4
53565,2,3,187646,187646,187649,0,3,0
53566,4,2,187650,187650,187652,0,2,1
53567,5,2,187655,187655,187657,0,2,3
53568,5,1,187660,187660,187661,0,1,3
53569,2,3,187662,187662,187665,0,3,1
53570,3,2,187665,187665,187667,0,2,0
53571,3,3,187668,187668,187671,0,3,1
53572,2,1,187670,187671,187672,1,2,0
53573,1,2,187671,187672,187674,1,3,0
53574,2,1,187673,187674,187675,1,2,0
53575,4,2,187677,187677,187679,0,2,2
53576,5,1,187682,187682,187683,0,1,3
53577,5,1,187687,187687,187688,0,1,4
53578,4,2,187691,187691,187693,0,2,3
53579,4,3,187695,187695,187698,0,3,2
53580,1,2,187696,187698,187700,2,4,0
53581,4,2,187700,187700,187702,0,2,0
53582,3,2,187703,187703,187705,0,2,1
53583,4,2,187707,187707,187709,0,2,2
53584,1,3,187708,187709,187712,1,4,0
53585,3,3,187711,187712,187715,1,4,0
53586,2,1,187713,187715,187716,2,3,0
53587,1,2,187714,187716,187718,2,4,0
53588,2,2,187716,187718,187720,2,4,0
53589,3,1,187719,187720,187721,1,2,0
53590,1,3,187720,187721,187724,1,4,0
53591,5,3,187725,187725,187728,0,3,1
53592,5,1,187730,187730,187731,0,1,2
53593,3,1,187733,187733,187734,0,1,2
53594,2,1,187735,187735,187736,0,1,1
53595,4,3,187739,187739,187742,0,3,3
53596,6,3,187745,187745,187748,0,3,3
53597,2,3,187747,187748,187751,1,4,0
53598,6,2,187753,187753,187755,0,2,2
53599,2,1,187755,187755,187756,0,1,0
53600,4,1,187759,187759,187760,0,1,3
53601,4,1,187763,187763,187764,0,1,3
53602,6,2,187769,187769,187771,0,2,5
53603,5,3,187774,187774,187777,0,3,3
53604,4,3,187778,187778,187781,0,3,1
53605,5,3,187783,187783,187786,0,3,2
53606,3,2,187786,187786,187788,0,2,0
53607,2,3,187788,187788,187791,0,3,0
53608,5,1,187793,187793,187794,0,1,2
53609,3,1,187796,187796,187797,0,1,2
53610,1,1,187797,187797,187798,0,1,0
53611,1,1,187798,187798,187799,0,1,0
53612,1,3,187799,187799,187802,0,3,0
53613,1,3,187800,187802,187805,2,5,0
53614,2,3,187802,187805,187808,3,6,0
53615,4,2,187806,187808,187810,2,4,0
53616,2,3,187808,187810,187813,2,5,0
53617,5,1,187813,187813,187814,0,1,0
53618,2,2,187815,187815,187817,0,2,1
53619,5,2,187820,187820,187822,0,2,3
53620,5,1,187825,187825,187826,0,1,3
53621,5,1,187830,187830,187831,0,1,4
53622,4,3,187834,187834,187837,0,3,3
53623,2,1,187836,187837,187838,1,2,0
53624,3,3,187839,187839,187842,0,3,1
53625,6,1,187845,187845,187846,0,1,3
53626,1,2,187846,187846,187848,0,2,0
53627,1,1,187847,187848,187849,1,2,0
53628,1,2,187848,187849,187851,1,3,0
53629,6,3,187854,187854,187857,0,3,3
53630,3,3,187857,187857,187860,0,3,0
53631,1,1,187858,187860,187861,2,3,0
53632,4,3,187862,187862,187865,0,3,1
53633,3,3,187865,187865,187868,0,3,0
53634,3,3,187868,187868,187871,0,3,0
53635,5,3,187873,187873,187876,0,3,2
53636,4,2,187877,187877,187879,0,2,1
53637,3,1,187880,187880,187881,0,1,1
53638,5,2,187885,187885,187887,0,2,4
53639,6,3,187891,187891,187894,0,3,4
53640,5,2,187896,187896,187898,0,2,2
53641,4,1,187900,187900,187901,0,1,2
53642,3,1,187903,187903,187904,0,1,2
53643,1,1,187904,187904,187905,0,1,0
53644,3,1,187907,187907,187908,0,1,2
53645,1,1,187908,187908,187909,0,1,0
53646,3,1,187911,187911,187912,0,1,2
53647,4,1,187915,187915,187916,0,1,3
53648,5,3,187920,187920,187923,0,3,4
53649,6,3,187926,187926,187929,0,3,3
53650,2,1,187928,187929,187930,1,2,0
53651,4,3,187932,187932,187935,0,3,2
53652,4,2,187936,187936,187938,0,2,1
53653,2,3,187938,187938,187941,0,3,0
53654,5,2,187943,187943,187945,0,2,2
53655,1,3,187944,187945,187948,1,4,0
53656,4,3,187948,187948,187951,0,3,0
53657,1,3,187949,187951,187954,2,5,0
53658,6,1,187955,187955,187956,0,1,1
53659,2,1,187957,187957,187958,0,1,1
53660,2,2,187959,187959,187961,0,2,1
53661,1,2,187960,187961,187963,1,3,0
53662,1,3,187961,187963,187966,2,5,0
53663,6,3,187967,187967,187970,0,3,1
53664,2,1,187969,187970,187971,1,2,0
53665,5,2,187974,187974,187976,0,2,3
53666,1,2,187975,187976,187978,1,3,0
53667,6,1,187981,187981,187982,0,1,3
53668,6,3,187987,187987,187990,0,3,5
53669,1,2,187988,187990,187992,2,4,0
53670,6,3,187994,187994,187997,0,3,2
53671,4,2,187998,187998,188000,0,2,1
53672,1,3,187999,188000,188003,1,4,0
53673,6,1,188005,188005,188006,0,1,2
53674,2,2,188007,188007,188009,0,2,1
53675,6,2,188013,188013,188015,0,2,4
53676,4,2,188017,188017,188019,0,2,2
53677,6,3,188023,188023,188026,0,3,4
53678,6,3,188029,188029,188032,0,3,3
53679,2,1,188031,188032,188033,1,2,0
53680,4,2,188035,188035,188037,0,2,2
53681,4,1,188039,188039,188040,0,1,2
53682,5,3,188044,188044,188047,0,3,4
53683,5,2,188049,188049,188051,0,2,2
53684,5,3,188054,188054,188057,0,3,3
53685,4,3,188058,188058,188061,0,3,1
53686,5,3,188063,188063,188066,0,3,2
53687,3,2,188066,188066,188068,0,2,0
53688,6,1,188072,188072,188073,0,1,4
53689,5,3,188077,188077,188080,0,3,4
53690,3,1,188080,188080,188081,0,1,0
53691,1,2,188081,188081,188083,0,2,0
53692,6,1,188087,188087,188088,0,1,4
53693,4,2,188091,188091,188093,0,2,3
53694,3,2,188094,188094,188096,0,2,1
53695,5,3,188099,188099,188102,0,3,3
53696,5,3,188104,188104,188107,0,3,2
53697,6,1,188110,188110,188111,0,1,3
53698,1,1,188111,188111,188112,0,1,0
53699,2,2,188113,188113,188115,0,2,1
53700,5,2,188118,188118,188120,0,2,3
53701,3,3,188121,188121,188124,0,3,1
53702,1,3,188122,188124,188127,2,5,0
53703,5,3,188127,188127,188130,0,3,0
53704,4,3,188131,188131,188134,0,3,1
53705,3,2,188134,188134,188136,0,2,0
53706,1,2,188135,188136,188138,1,3,0
53707,4,2,188139,188139,188141,0,2,1
53708,3,3,188142,188142,188145,0,3,1
53709,3,1,188145,188145,188146,0,1,0
53710,5,3,188150,188150,188153,0,3,4
53711,5,3,188155,188155,188158,0,3,2
53712,2,3,188157,188158,188161,1,4,0
53713,5,2,188162,188162,188164,0,2,1
53714,4,3,188166,188166,188169,0,3,2
53715,2,1,188168,188169,188170,1,2,0
53716,5,1,188173,188173,188174,0,1,3
53717,4,3,188177,188177,188180,0,3,3
53718,2,2,188179,188180,188182,1,3,0
53719,2,2,188181,188182,188184,1,3,0
53720,6,2,188187,188187,188189,0,2,3
53721,4,2,188191,188191,188193,0,2,2
53722,6,1,188197,188197,188198,0,1,4
53723,5,2,188202,188202,188204,0,2,4
53724,6,3,188208,188208,188211,0,3,4
53725,1,3,188209,188211,188214,2,5,0
53726,4,1,188213,188214,188215,1,2,0
53727,3,3,188216,188216,188219,0,3,1
53728,3,2,188219,188219,188221,0,2,0
53729,4,1,188223,188223,188224,0,1,2
53730,6,2,188229,188229,188231,0,2,5
53731,6,2,188235,188235,188237,0,2,4
53732,1,1,188236,188237,188238,1,2,0
53733,1,1,188237,188238,188239,1,2,0
53734,2,1,188239,188239,188240,0,1,0
53735,2,3,188241,188241,188244,0,3,1
53736,4,1,188245,188245,188246,0,1,1
53737,3,3,188248,188248,188251,0,3,2
53738,3,3,188251,188251,188254,0,3,0
53739,1,1,188252,188254,188255,2,3,0
53740,3,1,188255,188255,188256,0,1,0
53741,6,3,188261,188261,188264,0,3,5
53742,3,2,188264,188264,188266,0,2,0
53743,5,1,188269,188269,188270,0,1,3
53744,2,2,188271,188271,188273,0,2,1
53745,6,2,188277,188277,188279,0,2,4
53746,5,3,188282,188282,188285,0,3,3
53747,3,3,188285,188285,188288,0,3,0
53748,6,3,188291,188291,188294,0,3,3
53749,1,3,188292,188294,188297,2,5,0
53750,4,3,188296,188297,188300,1,4,0
53751,1,1,188297,188300,188301,3,4,0
53752,6,2,188303,188303,188305,0,2,2
53753,5,2,188308,188308,188310,0,2,3
53754,6,1,188314,188314,188315,0,1,4
53755,4,2,188318,188318,188320,0,2,3
53756,4,1,188322,188322,188323,0,1,2
53757,5,1,188327,188327,188328,0,1,4
53758,3,3,188330,188330,188333,0,3,2
53759,2,2,188332,188333,188335,1,3,0
53760,3,2,188335,188335,188337,0,2,0
53761,2,3,188337,188337,188340,0,3,0
53762,3,2,188340,188340,188342,0,2,0
53763,3,1,188343,188343,188344,0,1,1
53764,1,2,188344,188344,188346,0,2,0
53765,1,3,188345,188346,188349,1,4,0
53766,6,3,188351,188351,188354,0,3,2
53767,6,1,188357,188357,188358,0,1,3
53768,1,1,188358,188358,188359,0,1,0
53769,2,1,188360,188360,188361,0,1,1
53770,6,1,188366,188366,188367,0,1,5
53771,1,1,188367,188367,188368,0,1,0
53772,1,2,188368,188368,188370,0,2,0
53773,6,2,188374,188374,188376,0,2,4
53774,5,3,188379,188379,188382,0,3,3
53775,3,2,188382,188382,188384,0,2,0
53776,2,3,188384,188384,188387,0,3,0
53777,6,1,188390,188390,188391,0,1,3
53778,6,1,188396,188396,188397,0,1,5
53779,2,1,188398,188398,188399,0,1,1
53780,2,3,188400,188400,188403,0,3,1
53781,3,1,188403,188403,188404,0,1,0
53782,3,1,188406,188406,188407,0,1,2
53783,2,2,188408,188408,188410,0,2,1
53784,4,1,188412,188412,188413,0,1,2
53785,6,3,188418,188418,188421,0,3,5
53786,4,2,188422,188422,188424,0,2,1
53787,3,1,188425,188425,188426,0,1,1
53788,4,3,188429,188429,188432,0,3,3
53789,6,1,188435,188435,188436,0,1,3
53790,1,2,188436,188436,188438,0,2,0
53791,1,2,188437,188438,188440,1,3,0
53792,1,3,188438,188440,188443,2,5,0
53793,4,2,188442,188443,188445,1,3,0
53794,2,2,188444,188445,188447,1,3,0
53795,2,3,188446,188447,188450,1,4,0
53796,4,3,188450,188450,188453,0,3,0
53797,2,2,188452,188453,188455,1,3,0
53798,2,3,188454,188455,188458,1,4,0
53799,1,3,188455,188458,188461,3,6,0
53800,5,3,188460,188461,188464,1,4,0
53801,4,3,188464,188464,188467,0,3,0
53802,2,1,188466,188467,188468,1,2,0
53803,1,1,188467,188468,188469,1,2,0
53804,5,1,188472,188472,188473,0,1,3
53805,5,3,188477,188477,188480,0,3,4
53806,4,3,188481,188481,188484,0,3,1
53807,4,1,188485,188485,188486,0,1,1
53808,3,2,188488,188488,188490,0,2,2
53809,2,3,188490,188490,188493,0,3,0
53810,2,3,188492,188493,188496,1,4,0
53811,2,3,188494,188496,188499,2,5,0
53812,2,1,188496,188499,188500,3,4,0
53813,6,3,188502,188502,188505,0,3,2
53814,3,2,188505,188505,188507,0,2,0
53815,3,3,188508,188508,188511,0,3,1
53816,1,2,188509,188511,188513,2,4,0
53817,5,2,188514,188514,188516,0,2,1
53818,1,3,188515,188516,188519,1,4,0
53819,5,2,188520,188520,188522,0,2,1
53820,1,2,188521,188522,188524,1,3,0
53821,6,3,188527,188527,188530,0,3,3
53822,1,1,188528,188530,188531,2,3,0
53823,4,3,188532,188532,188535,0,3,1
53824,1,1,188533,188535,188536,2,3,0
53825,2,1,188535,188536,188537,1,2,0
53826,6,1,188541,188541,188542,0,1,4
53827,1,2,188542,188542,188544,0,2,0
53828,5,2,188547,188547,188549,0,2,3
53829,2,1,188549,188549,188550,0,1,0
53830,3,2,188552,188552,188554,0,2,2
53831,1,3,188553,188554,188557,1,4,0
53832,2,3,188555,188557,188560,2,5,0
53833,3,2,188558,188560,188562,2,4,0
53834,2,3,188560,188562,188565,2,5,0
53835,5,2,188565,188565,188567,0,2,0
53836,2,2,188567,188567,188569,0,2,0
53837,2,3,188569,188569,188572,0,3,0
53838,6,3,188575,188575,188578,0,3,3
53839,1,2,188576,188578,188580,2,4,0
53840,4,2,188580,188580,188582,0,2,0
53841,3,1,188583,188583,188584,0,1,1
53842,1,3,188584,188584,188587,0,3,0
53843,6,2,188590,188590,188592,0,2,3
53844,1,3,188591,188592,188595,1,4,0
53845,3,2,188594,188595,188597,1,3,0
53846,1,2,188595,188597,188599,2,4,0
53847,3,1,188598,188599,188600,1,2,0
53848,2,1,188600,188600,188601,0,1,0
53849,4,2,188604,188604,188606,0,2,3
53850,3,2,188607,188607,188609,0,2,1
53851,6,3,188613,188613,188616,0,3,4
53852,1,2,188614,188616,188618,2,4,0
53853,3,1,188617,188618,188619,1,2,0
53854,5,3,188622,188622,188625,0,3,3
53855,4,1,188626,188626,188627,0,1,1
53856,2,2,188628,188628,188630,0,2,1
53857,2,3,188630,188630,188633,0,3,0
53858,2,3,188632,188633,188636,1,4,0
53859,4,3,188636,188636,188639,0,3,0
53860,6,3,188642,188642,188645,0,3,3
53861,6,2,188648,188648,188650,0,2,3
53862,5,2,188653,188653,188655,0,2,3
53863,5,1,188658,188658,188659,0,1,3
53864,3,2,188661,188661,188663,0,2,2
53865,6,2,188667,188667,188669,0,2,4
53866,5,3,188672,188672,188675,0,3,3
53867,3,1,188675,188675,188676,0,1,0
53868,6,2,188681,188681,188683,0,2,5
53869,3,2,188684,188684,188686,0,2,1
53870,2,1,188686,188686,188687,0,1,0
53871,1,2,188687,188687,188689,0,2,0
53872,3,2,188690,188690,188692,0,2,1
53873,5,3,188695,188695,188698,0,3,3
53874,6,2,188701,188701,188703,0,2,3
53875,3,2,188704,188704,188706,0,2,1
53876,6,2,188710,188710,188712,0,2,4
53877,3,2,188713,188713,188715,0,2,1
53878,5,2,188718,188718,188720,0,2,3
53879,2,3,188720,188720,188723,0,3,0
53880,5,1,188725,188725,188726,0,1,2
53881,5,1,188730,188730,188731,0,1,4
53882,1,3,188731,188731,188734,0,3,0
53883,3,1,188734,188734,188735,0,1,0
53884,6,1,188740,188740,188741,0,1,5
53885,2,2,188742,188742,188744,0,2,1
53886,3,2,188745,188745,188747,0,2,1
53887,4,2,188749,188749,188751,0,2,2
53888,1,3,188750,188751,188754,1,4,0
53889,3,3,188753,188754,188757,1,4,0
53890,1,1,188754,188757,188758,3,4,0
53891,5,3,188759,188759,188762,0,3,1
53892,5,3,188764,188764,188767,0,3,2
53893,3,1,188767,188767,188768,0,1,0
53894,5,2,188772,188772,188774,0,2,4
53895,5,1,188777,188777,188778,0,1,3
53896,3,3,188780,188780,188783,0,3,2
53897,3,1,188783,188783,188784,0,1,0
53898,2,2,188785,188785,188787,0,2,1
53899,5,2,188790,188790,188792,0,2,3
53900,5,3,188795,188795,188798,0,3,3
53901,2,1,188797,188798,188799,1,2,0
53902,6,3,188803,188803,188806,0,3,4
53903,3,3,188806,188806,188809,0,3,0
53904,4,3,188810,188810,188813,0,3,1
53905,2,3,188812,188813,188816,1,4,0
53906,1,1,188813,188816,188817,3,4,0
53907,2,1,188815,188817,188818,2,3,0
53908,1,2,188816,188818,188820,2,4,0
53909,2,2,188818,188820,188822,2,4,0
53910,2,2,188820,188822,188824,2,4,0
53911,4,2,188824,188824,188826,0,2,0
53912,6,1,188830,188830,188831,0,1,4
53913,2,2,188832,188832,188834,0,2,1
53914,2,2,188834,188834,188836,0,2,0
53915,6,2,188840,188840,188842,0,2,4
53916,6,2,188846,188846,188848,0,2,4
53917,4,2,188850,188850,188852,0,2,2
53918,3,1,188853,188853,188854,0,1,1
53919,3,1,188856,188856,188857,0,1,2
53920,3,2,188859,188859,188861,0,2,2
53921,5,3,188864,188864,188867,0,3,3
53922,5,2,188869,188869,188871,0,2,2
53923,3,1,188872,188872,188873,0,1,1
53924,4,1,188876,188876,188877,0,1,3
53925,6,3,188882,188882,188885,0,3,5
53926,1,3,188883,188885,188888,2,5,0
53927,5,2,188888,188888,188890,0,2,0
53928,2,2,188890,188890,188892,0,2,0
53929,3,2,188893,188893,188895,0,2,1
53930,5,1,188898,188898,188899,0,1,3
53931,6,1,188904,188904,188905,0,1,5
53932,3,1,188907,188907,188908,0,1,2
53933,5,2,188912,188912,188914,0,2,4
53934,2,2,188914,188914,188916,0,2,0
53935,3,1,188917,188917,188918,0,1,1
53936,6,1,188923,188923,188924,0,1,5
53937,5,3,188928,188928,188931,0,3,4
53938,5,2,188933,188933,188935,0,2,2
53939,2,3,188935,188935,188938,0,3,0
53940,5,1,188940,188940,188941,0,1,2
53941,4,2,188944,188944,188946,0,2,3
53942,6,2,188950,188950,188952,0,2,4
53943,1,3,188951,188952,188955,1,4,0
53944,3,3,188954,188955,188958,1,4,0
53945,2,1,188956,188958,188959,2,3,0
53946,1,3,188957,188959,188962,2,5,0
53947,2,3,188959,188962,188965,3,6,0
53948,3,1,188962,188965,188966,3,4,0
53949,1,1,188963,188966,188967,3,4,0
53950,4,2,188967,188967,188969,0,2,0
53951,3,1,188970,188970,188971,0,1,1
53952,3,1,188973,188973,188974,0,1,2
53953,5,2,188978,188978,188980,0,2,4
53954,5,2,188983,188983,188985,0,2,3
53955,3,2,188986,188986,188988,0,2,1
53956,2,3,188988,188988,188991,0,3,0
53957,4,3,188992,188992,188995,0,3,1
53958,2,1,188994,188995,188996,1,2,0
53959,4,2,188998,188998,189000,0,2,2
53960,3,1,189001,189001,189002,0,1,1
53961,5,3,189006,189006,189009,0,3,4
53962,3,1,189009,189009,189010,0,1,0
53963,6,1,189015,189015,189016,0,1,5
53964,1,1,189016,189016,189017,0,1,0
53965,4,1,189020,189020,189021,0,1,3
53966,4,1,189024,189024,189025,0,1,3
53967,6,2,189030,189030,189032,0,2,5
53968,1,3,189031,189032,189035,1,4,0
53969,1,2,189032,189035,189037,3,5,0
53970,5,2,189037,189037,189039,0,2,0
53971,4,2,189041,189041,189043,0,2,2
53972,4,2,189045,189045,189047,0,2,2
53973,2,1,189047,189047,189048,0,1,0
53974,6,3,189053,189053,189056,0,3,5
53975,3,3,189056,189056,189059,0,3,0
53976,3,1,189059,189059,189060,0,1,0
53977,3,2,189062,189062,189064,0,2,2
53978,5,2,189067,189067,189069,0,2,3
53979,1,3,189068,189069,189072,1,4,0
53980,2,3,189070,189072,189075,2,5,0
53981,3,2,189073,189075,189077,2,4,0
53982,1,1,189074,189077,189078,3,4,0
53983,5,1,189079,189079,189080,0,1,1
53984,4,2,189083,189083,189085,0,2,3
53985,4,1,189087,189087,189088,0,1,2
53986,4,3,189091,189091,189094,0,3,3
53987,5,3,189096,189096,189099,0,3,2
53988,4,1,189100,189100,189101,0,1,1
53989,6,1,189106,189106,189107,0,1,5
53990,4,2,189110,189110,189112,0,2,3
53991,1,2,189111,189112,189114,1,3,0
53992,3,1,189114,189114,189115,0,1,0
53993,1,3,189115,189115,189118,0,3,0
53994,4,2,189119,189119,189121,0,2,1
53995,5,2,189124,189124,189126,0,2,3
53996,3,3,189127,189127,189130,0,3,1
53997,2,1,189129,189130,189131,1,2,0
53998,4,3,189133,189133,189136,0,3,2
53999,4,2,189137,189137,189139,0,2,1
54000,3,1,189140,189140,189141,0,1,1
54001,1,2,189141,189141,189143,0,2,0
54002,1,3,189142,189143,189146,1,4,0
54003,4,3,189146,189146,189149,0,3,0
54004,4,1,189150,189150,189151,0,1,1
54005,6,1,189156,189156,189157,0,1,5
54006,2,1,189158,189158,189159,0,1,1
54007,5,2,189163,189163,189165,0,2,4
54008,1,3,189164,189165,189168,1,4,0
54009,5,3,189169,189169,189172,0,3,1
54010,3,1,189172,189172,189173,0,1,0
54011,5,3,189177,189177,189180,0,3,4
54012,2,3,189179,189180,189183,1,4,0
54013,2,1,189181,189183,189184,2,3,0
54014,1,3,189182,189184,189187,2,5,0
54015,6,3,189188,189188,189191,0,3,1
54016,4,3,189192,189192,189195,0,3,1
54017,2,1,189194,189195,189196,1,2,0
54018,6,1,189200,189200,189201,0,1,4
54019,2,2,189202,189202,189204,0,2,1
54020,3,3,189205,189205,189208,0,3,1
54021,3,1,189208,189208,189209,0,1,0
54022,3,2,189211,189211,189213,0,2,2
54023,2,1,189213,189213,189214,0,1,0
54024,1,3,189214,189214,189217,0,3,0
54025,4,1,189218,189218,189219,0,1,1
54026,5,2,189223,189223,189225,0,2,4
54027,5,1,189228,189228,189229,0,1,3
54028,4,3,189232,189232,189235,0,3,3
54029,5,3,189237,189237,189240,0,3,2
54030,6,1,189243,189243,189244,0,1,3
54031,5,3,189248,189248,189251,0,3,4
54032,4,1,189252,189252,189253,0,1,1
54033,2,1,189254,189254,189255,0,1,1
54034,3,2,189257,189257,189259,0,2,2
54035,3,1,189260,189260,189261,0,1,1
54036,4,1,189264,189264,189265,0,1,3
54037,5,3,189269,189269,189272,0,3,4
54038,6,3,189275,189275,189278,0,3,3
54039,6,3,189281,189281,189284,0,3,3
54040,6,1,189287,189287,189288,0,1,3
54041,3,2,189290,189290,189292,0,2,2
54042,4,1,189294,189294,189295,0,1,2
54043,5,3,189299,189299,189302,0,3,4
54044,5,1,189304,189304,189305,0,1,2
54045,2,1,189306,189306,189307,0,1,1
54046,3,3,189309,189309,189312,0,3,2
54047,5,2,189314,189314,189316,0,2,2
54048,4,3,189318,189318,189321,0,3,2
54049,2,1,189320,189321,189322,1,2,0
54050,5,2,189325,189325,189327,0,2,3
54051,5,3,189330,189330,189333,0,3,3
54052,3,2,189333,189333,189335,0,2,0
54053,1,3,189334,189335,189338,1,4,0
54054,4,2,189338,189338,189340,0,2,0
54055,4,1,189342,189342,189343,0,1,2
54056,2,1,189344,189344,189345,0,1,1
54057,1,1,189345,189345,189346,0,1,0
54058,2,2,189347,189347,189349,0,2,1
54059,2,1,189349,189349,189350,0,1,0
54060,6,2,189355,189355,189357,0,2,5
54061,5,3,189360,189360,189363,0,3,3
54062,6,1,189366,189366,189367,0,1,3
54063,4,1,189370,189370,189371,0,1,3
54064,1,3,189371,189371,189374,0,3,0
54065,2,3,189373,189374,189377,1,4,0
54066,4,1,189377,189377,189378,0,1,0
54067,1,3,189378,189378,189381,0,3,0
54068,1,2,189379,189381,189383,2,4,0
54069,2,2,189381,189383,189385,2,4,0
54070,5,1,189386,189386,189387,0,1,1
54071,3,2,189389,189389,189391,0,2,2
54072,1,2,189390,189391,189393,1,3,0
54073,4,3,189394,189394,189397,0,3,1
54074,1,1,189395,189397,189398,2,3,0
54075,5,2,189400,189400,189402,0,2,2
54076,3,3,189403,189403,189406,0,3,1
54077,2,3,189405,189406,189409,1,4,0
54078,3,1,189408,189409,189410,1,2,0
54079,6,2,189414,189414,189416,0,2,4
54080,5,2,189419,189419,189421,0,2,3
54081,1,2,189420,189421,189423,1,3,0
54082,6,3,189426,189426,189429,0,3,3
54083,5,3,189431,189431,189434,0,3,2
54084,2,1,189433,189434,189435,1,2,0
54085,4,1,189437,189437,189438,0,1,2
54086,1,1,189438,189438,189439,0,1,0
54087,3,1,189441,189441,189442,0,1,2
54088,2,3,189443,189443,189446,0,3,1
54089,4,1,189447,189447,189448,0,1,1
54090,1,2,189448,189448,189450,0,2,0
54091,3,1,189451,189451,189452,0,1,1
54092,3,1,189454,189454,189455,0,1,2
54093,3,2,189457,189457,189459,0,2,2
54094,1,2,189458,189459,189461,1,3,0
54095,3,1,189461,189461,189462,0,1,0
54096,2,1,189463,189463,189464,0,1,1
54097,5,3,189468,189468,189471,0,3,4
54098,5,1,189473,189473,189474,0,1,2
54099,2,3,189475,189475,189478,0,3,1
54100,2,1,189477,189478,189479,1,2,0
54101,4,3,189481,189481,189484,0,3,2
54102,1,1,189482,189484,189485,2,3,0
54103,1,1,189483,189485,189486,2,3,0
54104,6,3,189489,189489,189492,0,3,3
54105,1,3,189490,189492,189495,2,5,0
54106,1,1,189491,189495,189496,4,5,0
54107,5,3,189496,189496,189499,0,3,0
54108,5,2,189501,189501,189503,0,2,2
54109,4,3,189505,189505,189508,0,3,2
54110,4,2,189509,189509,189511,0,2,1
54111,3,3,189512,189512,189515,0,3,1
54112,3,2,189515,189515,189517,0,2,0
54113,4,3,189519,189519,189522,0,3,2
54114,6,2,189525,189525,189527,0,2,3
54115,6,1,189531,189531,189532,0,1,4
54116,5,3,189536,189536,189539,0,3,4
54117,4,2,189540,189540,189542,0,2,1
54118,6,3,189546,189546,189549,0,3,4
54119,6,3,189552,189552,189555,0,3,3
54120,2,2,189554,189555,189557,1,3,0
54121,6,3,189560,189560,189563,0,3,3
54122,6,1,189566,189566,189567,0,1,3
54123,3,1,189569,189569,189570,0,1,2
54124,5,3,189574,189574,189577,0,3,4
54125,6,1,189580,189580,189581,0,1,3
54126,3,3,189583,189583,189586,0,3,2
54127,2,3,189585,189586,189589,1,4,0
54128,3,3,189588,189589,189592,1,4,0
54129,6,1,189594,189594,189595,0,1,2
54130,5,1,189599,189599,189600,0,1,4
54131,1,1,189600,189600,189601,0,1,0
54132,1,2,189601,189601,189603,0,2,0
54133,6,1,189607,189607,189608,0,1,4
54134,5,3,189612,189612,189615,0,3,4
54135,4,1,189616,189616,189617,0,1,1
54136,1,2,189617,189617,189619,0,2,0
54137,6,3,189623,189623,189626,0,3,4
54138,1,3,189624,189626,189629,2,5,0
54139,2,3,189626,189629,189632,3,6,0
54140,5,1,189631,189632,189633,1,2,0
54141,2,2,189633,189633,189635,0,2,0
54142,5,2,189638,189638,189640,0,2,3
54143,2,2,189640,189640,189642,0,2,0
54144,6,2,189646,189646,189648,0,2,4
54145,1,3,189647,189648,189651,1,4,0
54146,3,1,189650,189651,189652,1,2,0
54147,6,2,189656,189656,189658,0,2,4
54148,1,1,189657,189658,189659,1,2,0
54149,6,1,189663,189663,189664,0,1,4
54150,4,2,189667,189667,189669,0,2,3
54151,1,2,189668,189669,189671,1,3,0
54152,2,3,189670,189671,189674,1,4,0
54153,1,1,189671,189674,189675,3,4,0
54154,3,3,189674,189675,189678,1,4,0
54155,5,1,189679,189679,189680,0,1,1
54156,6,3,189685,189685,189688,0,3,5
54157,6,3,189691,189691,189694,0,3,3
54158,5,1,189696,189696,189697,0,1,2
54159,5,2,189701,189701,189703,0,2,4
54160,4,2,189705,189705,189707,0,2,2
54161,1,2,189706,189707,189709,1,3,0
54162,4,1,189710,189710,189711,0,1,1
54163,3,2,189713,189713,189715,0,2,2
54164,2,3,189715,189715,189718,0,3,0
54165,4,1,189719,189719,189720,0,1,1
54166,6,3,189725,189725,189728,0,3,5
54167,3,3,189728,189728,189731,0,3,0
54168,1,2,189729,189731,189733,2,4,0
54169,5,1,189734,189734,189735,0,1,1
54170,2,1,189736,189736,189737,0,1,1
54171,4,2,189740,189740,189742,0,2,3
54172,2,1,189742,189742,189743,0,1,0
54173,5,1,189747,189747,189748,0,1,4
54174,6,3,189753,189753,189756,0,3,5
54175,6,2,189759,189759,189761,0,2,3
54176,3,3,189762,189762,189765,0,3,1
54177,3,1,189765,189765,189766,0,1,0
54178,5,2,189770,189770,189772,0,2,4
54179,1,1,189771,189772,189773,1,2,0
54180,1,1,189772,189773,189774,1,2,0
54181,1,1,189773,189774,189775,1,2,0
54182,1,3,189774,189775,189778,1,4,0
54183,1,2,189775,189778,189780,3,5,0
54184,1,1,189776,189780,189781,4,5,0
54185,4,2,189780,189781,189783,1,3,0
54186,3,1,189783,189783,189784,0,1,0
54187,1,2,189784,189784,189786,0,2,0
54188,3,1,189787,189787,189788,0,1,1
54189,4,3,189791,189791,189794,0,3,3
54190,6,1,189797,189797,189798,0,1,3
54191,3,3,189800,189800,189803,0,3,2
54192,4,2,189804,189804,189806,0,2,1
54193,5,2,189809,189809,189811,0,2,3
54194,6,3,189815,189815,189818,0,3,4
54195,1,3,189816,189818,189821,2,5,0
54196,5,1,189821,189821,189822,0,1,0
54197,2,2,189823,189823,189825,0,2,1
54198,1,1,189824,189825,189826,1,2,0
54199,4,3,189828,189828,189831,0,3,2
54200,3,2,189831,189831,189833,0,2,0
54201,5,1,189836,189836,189837,0,1,3
54202,6,3,189842,189842,189845,0,3,5
54203,5,1,189847,189847,189848,0,1,2
54204,6,1,189853,189853,189854,0,1,5
54205,1,1,189854,189854,189855,0,1,0
54206,6,2,189860,189860,189862,0,2,5
54207,4,1,189864,189864,189865,0,1,2
54208,3,3,189867,189867,189870,0,3,2
54209,3,3,189870,189870,189873,0,3,0
54210,4,1,189874,189874,189875,0,1,1
54211,4,3,189878,189878,189881,0,3,3
54212,1,3,189879,189881,189884,2,5,0
54213,2,3,189881,189884,189887,3,6,0
54214,5,3,189886,189887,189890,1,4,0
54215,6,1,189892,189892,189893,0,1,2
54216,6,3,189898,189898,189901,0,3,5
54217,1,1,189899,189901,189902,2,3,0
54218,3,3,189902,189902,189905,0,3,0
54219,4,2,189906,189906,189908,0,2,1
54220,3,1,189909,189909,189910,0,1,1
54221,3,3,189912,189912,189915,0,3,2
54222,5,1,189917,189917,189918,0,1,2
54223,3,3,189920,189920,189923,0,3,2
54224,4,2,189924,189924,189926,0,2,1
54225,4,3,189928,189928,189931,0,3,2
54226,6,1,189934,189934,189935,0,1,3
54227,2,1,189936,189936,189937,0,1,1
54228,6,1,189942,189942,189943,0,1,5
54229,5,1,189947,189947,189948,0,1,4
54230,5,1,189952,189952,189953,0,1,4
54231,3,2,189955,189955,189957,0,2,2
54232,5,3,189960,189960,189963,0,3,3
54233,4,3,189964,189964,189967,0,3,1
54234,2,3,189966,189967,189970,1,4,0
54235,1,1,189967,189970,189971,3,4,0
54236,6,3,189973,189973,189976,0,3,2
54237,1,3,189974,189976,189979,2,5,0
54238,2,2,189976,189979,189981,3,5,0
54239,3,2,189979,189981,189983,2,4,0
54240,6,3,189985,189985,189988,0,3,2
54241,4,3,189989,189989,189992,0,3,1
54242,5,2,189994,189994,189996,0,2,2
54243,6,1,190000,190000,190001,0,1,4
54244,2,3,190002,190002,190005,0,3,1
54245,3,1,190005,190005,190006,0,1,0
54246,5,1,190010,190010,190011,0,1,4
54247,2,2,190012,190012,190014,0,2,1
54248,5,1,190017,190017,190018,0,1,3
54249,3,2,190020,190020,190022,0,2,2
54250,2,2,190022,190022,190024,0,2,0
54251,6,2,190028,190028,190030,0,2,4
54252,2,2,190030,190030,190032,0,2,0
54253,4,1,190034,190034,190035,0,1,2
54254,2,2,190036,190036,190038,0,2,1
54255,4,3,190040,190040,190043,0,3,2
54256,5,2,190045,190045,190047,0,2,2
54257,2,3,190047,190047,190050,0,3,0
54258,1,1,190048,190050,190051,2,3,0
54259,3,2,190051,190051,190053,0,2,0
54260,6,2,190057,190057,190059,0,2,4
54261,2,2,190059,190059,190061,0,2,0
54262,6,2,190065,190065,190067,0,2,4
54263,2,2,190067,190067,190069,0,2,0
54264,4,3,190071,190071,190074,0,3,2
54265,3,1,190074,190074,190075,0,1,0
54266,4,2,190078,190078,190080,0,2,3
54267,3,3,190081,190081,190084,0,3,1
54268,3,1,190084,190084,190085,0,1,0
54269,6,2,190090,190090,190092,0,2,5
54270,6,2,190096,190096,190098,0,2,4
54271,4,2,190100,190100,190102,0,2,2
54272,6,3,190106,190106,190109,0,3,4
54273,3,2,190109,190109,190111,0,2,0
54274,4,3,190113,190113,190116,0,3,2
54275,4,2,190117,190117,190119,0,2,1
54276,2,2,190119,190119,190121,0,2,0
54277,2,3,190121,190121,190124,0,3,0
54278,1,1,190122,190124,190125,2,3,0
54279,6,1,190128,190128,190129,0,1,3
54280,6,2,190134,190134,190136,0,2,5
54281,5,2,190139,190139,190141,0,2,3
54282,3,1,190142,190142,190143,0,1,1
54283,2,3,190144,190144,190147,0,3,1
54284,1,1,190145,190147,190148,2,3,0
54285,5,2,190150,190150,190152,0,2,2
54286,5,3,190155,190155,190158,0,3,3
54287,2,3,190157,190158,190161,1,4,0
54288,4,3,190161,190161,190164,0,3,0
54289,5,1,190166,190166,190167,0,1,2
54290,4,3,190170,190170,190173,0,3,3
54291,3,1,190173,190173,190174,0,1,0
54292,4,2,190177,190177,190179,0,2,3
54293,1,2,190178,190179,190181,1,3,0
54294,6,1,190184,190184,190185,0,1,3
54295,2,1,190186,190186,190187,0,1,1
54296,5,3,190191,190191,190194,0,3,4
54297,2,1,190193,190194,190195,1,2,0
54298,6,1,190199,190199,190200,0,1,4
54299,4,2,190203,190203,190205,0,2,3
54300,3,1,190206,190206,190207,0,1,1
54301,4,2,190210,190210,190212,0,2,3
54302,6,3,190216,190216,190219,0,3,4
54303,4,3,190220,190220,190223,0,3,1
54304,3,3,190223,190223,190226,0,3,0
54305,4,2,190227,190227,190229,0,2,1
54306,3,1,190230,190230,190231,0,1,1
54307,6,1,190236,190236,190237,0,1,5
54308,6,3,190242,190242,190245,0,3,5
54309,6,3,190248,190248,190251,0,3,3
54310,2,2,190250,190251,190253,1,3,0
54311,6,3,190256,190256,190259,0,3,3
54312,6,3,190262,190262,190265,0,3,3
54313,2,2,190264,190265,190267,1,3,0
54314,4,3,190268,190268,190271,0,3,1
54315,3,3,190271,190271,190274,0,3,0
54316,4,1,190275,190275,190276,0,1,1
54317,4,2,190279,190279,190281,0,2,3
54318,1,3,190280,190281,190284,1,4,0
54319,1,3,190281,190284,190287,3,6,0
54320,1,1,190282,190287,190288,5,6,0
54321,3,2,190285,190288,190290,3,5,0
54322,2,1,190287,190290,190291,3,4,0
54323,4,1,190291,190291,190292,0,1,0
54324,1,2,190292,190292,190294,0,2,0
54325,4,2,190296,190296,190298,0,2,2
54326,3,1,190299,190299,190300,0,1,1
54327,1,2,190300,190300,190302,0,2,0
54328,2,3,190302,190302,190305,0,3,0
54329,6,3,190308,190308,190311,0,3,3
54330,2,3,190310,190311,190314,1,4,0
54331,5,3,190315,190315,190318,0,3,1
54332,5,2,190320,190320,190322,0,2,2
54333,3,1,190323,190323,190324,0,1,1
54334,6,3,190329,190329,190332,0,3,5
54335,2,1,190331,190332,190333,1,2,0
54336,5,2,190336,190336,190338,0,2,3
54337,1,2,190337,190338,190340,1,3,0
54338,4,1,190341,190341,190342,0,1,1
54339,4,3,190345,190345,190348,0,3,3
54340,4,1,190349,190349,190350,0,1,1
54341,6,1,190355,190355,190356,0,1,5
54342,2,3,190357,190357,190360,0,3,1
54343,1,3,190358,190360,190363,2,5,0
54344,6,1,190364,190364,190365,0,1,1
54345,2,1,190366,190366,190367,0,1,1
54346,3,2,190369,190369,190371,0,2,2
54347,4,1,190373,190373,190374,0,1,2
54348,6,2,190379,190379,190381,0,2,5
54349,3,3,190382,190382,190385,0,3,1
54350,2,3,190384,190385,190388,1,4,0
54351,6,3,190390,190390,190393,0,3,2
54352,4,3,190394,190394,190397,0,3,1
54353,5,2,190399,190399,190401,0,2,2
54354,5,2,190404,190404,190406,0,2,3
54355,6,1,190410,190410,190411,0,1,4
54356,6,2,190416,190416,190418,0,2,5
54357,5,2,190421,190421,190423,0,2,3
54358,1,2,190422,190423,190425,1,3,0
54359,1,3,190423,190425,190428,2,5,0
54360,4,2,190427,190428,190430,1,3,0
54361,5,2,190432,190432,190434,0,2,2
54362,1,1,190433,190434,190435,1,2,0
54363,3,1,190436,190436,190437,0,1,1
54364,3,3,190439,190439,190442,0,3,2
54365,5,2,190444,190444,190446,0,2,2
54366,3,3,190447,190447,190450,0,3,1
54367,1,3,190448,190450,190453,2,5,0
54368,2,3,190450,190453,190456,3,6,0
54369,1,2,190451,190456,190458,5,7,0
54370,3,1,190454,190458,190459,4,5,0
54371,5,1,190459,190459,190460,0,1,0
54372,6,1,190465,190465,190466,0,1,5
54373,3,2,190468,190468,190470,0,2,2
54374,2,2,190470,190470,190472,0,2,0
54375,5,2,190475,190475,190477,0,2,3
54376,6,1,190481,190481,190482,0,1,4
54377,2,2,190483,190483,190485,0,2,1
54378,1,2,190484,190485,190487,1,3,0
54379,2,1,190486,190487,190488,1,2,0
54380,3,2,190489,190489,190491,0,2,1
54381,6,3,190495,190495,190498,0,3,4
54382,6,2,190501,190501,190503,0,2,3
54383,2,3,190503,190503,190506,0,3,0
54384,2,3,190505,190506,190509,1,4,0
54385,1,2,190506,190509,190511,3,5,0
54386,6,1,190512,190512,190513,0,1,1
54387,2,1,190514,190514,190515,0,1,1
54388,5,3,190519,190519,190522,0,3,4
54389,6,2,190525,190525,190527,0,2,3
54390,1,1,190526,190527,190528,1,2,0
54391,3,2,190529,190529,190531,0,2,1
54392,1,2,190530,190531,190533,1,3,0
54393,4,2,190534,190534,190536,0,2,1
54394,1,3,190535,190536,190539,1,4,0
54395,2,1,190537,190539,190540,2,3,0
54396,5,3,190542,190542,190545,0,3,2
54397,5,1,190547,190547,190548,0,1,2
54398,6,3,190553,190553,190556,0,3,5
54399,5,1,190558,190558,190559,0,1,2
54400,5,1,190563,190563,190564,0,1,4
54401,6,3,190569,190569,190572,0,3,5
54402,3,2,190572,190572,190574,0,2,0
54403,3,2,190575,190575,190577,0,2,1
54404,3,2,190578,190578,190580,0,2,1
54405,4,1,190582,190582,190583,0,1,2
54406,6,2,190588,190588,190590,0,2,5
54407,6,1,190594,190594,190595,0,1,4
54408,3,1,190597,190597,190598,0,1,2
54409,3,1,190600,190600,190601,0,1,2
54410,5,2,190605,190605,190607,0,2,4
54411,6,3,190611,190611,190614,0,3,4
54412,4,1,190615,190615,190616,0,1,1
54413,5,2,190620,190620,190622,0,2,4
54414,1,2,190621,190622,190624,1,3,0
54415,4,3,190625,190625,190628,0,3,1
54416,5,3,190630,190630,190633,0,3,2
54417,1,2,190631,190633,190635,2,4,0
54418,1,2,190632,190635,190637,3,5,0
54419,2,3,190634,190637,190640,3,6,0
54420,6,3,190640,190640,190643,0,3,0
54421,1,1,190641,190643,190644,2,3,0
54422,6,2,190647,190647,190649,0,2,3
54423,3,2,190650,190650,190652,0,2,1
54424,4,3,190654,190654,190657,0,3,2
54425,3,3,190657,190657,190660,0,3,0
54426,1,1,190658,190660,190661,2,3,0
54427,2,2,190660,190661,190663,1,3,0
54428,4,2,190664,190664,190666,0,2,1
54429,3,3,190667,190667,190670,0,3,1
54430,5,1,190672,190672,190673,0,1,2
54431,5,2,190677,190677,190679,0,2,4
54432,4,1,190681,190681,190682,0,1,2
54433,3,1,190684,190684,190685,0,1,2
54434,4,3,190688,190688,190691,0,3,3
54435,3,3,190691,190691,190694,0,3,0
54436,1,1,190692,190694,190695,2,3,0
54437,6,3,190698,190698,190701,0,3,3
54438,3,2,190701,190701,190703,0,2,0
54439,4,2,190705,190705,190707,0,2,2
54440,1,3,190706,190707,190710,1,4,0
54441,2,3,190708,190710,190713,2,5,0
54442,6,3,190714,190714,190717,0,3,1
54443,3,3,190717,190717,190720,0,3,0
54444,4,1,190721,190721,190722,0,1,1
54445,3,3,190724,190724,190727,0,3,2
54446,4,2,190728,190728,190730,0,2,1
54447,6,2,190734,190734,190736,0,2,4
54448,3,3,190737,190737,190740,0,3,1
54449,1,2,190738,190740,190742,2,4,0
54450,1,3,190739,190742,190745,3,6,0
54451,2,1,190741,190745,190746,4,5,0
54452,2,2,190743,190746,190748,3,5,0
54453,2,2,190745,190748,190750,3,5,0
54454,1,3,190746,190750,190753,4,7,0
54455,6,3,190752,190753,190756,1,4,0
54456,1,1,190753,190756,190757,3,4,0
54457,6,3,190759,190759,190762,0,3,2
54458,5,3,190764,190764,190767,0,3,2
54459,5,1,190769,190769,190770,0,1,2
54460,6,2,190775,190775,190777,0,2,5
54461,4,3,190779,190779,190782,0,3,2
54462,6,2,190785,190785,190787,0,2,3
54463,5,3,190790,190790,190793,0,3,3
54464,4,2,190794,190794,190796,0,2,1
54465,2,3,190796,190796,190799,0,3,0
54466,4,3,190800,190800,190803,0,3,1
54467,5,2,190805,190805,190807,0,2,2
54468,4,3,190809,190809,190812,0,3,2
54469,2,1,190811,190812,190813,1,2,0
54470,2,3,190813,190813,190816,0,3,0
54471,5,3,190818,190818,190821,0,3,2
54472,5,3,190823,190823,190826,0,3,2
54473,1,1,190824,190826,190827,2,3,0
54474,3,1,190827,190827,190828,0,1,0
54475,4,3,190831,190831,190834,0,3,3
54476,2,2,190833,190834,190836,1,3,0
54477,6,3,190839,190839,190842,0,3,3
54478,4,2,190843,190843,190845,0,2,1
54479,1,2,190844,190845,190847,1,3,0
54480,6,3,190850,190850,190853,0,3,3
54481,1,2,190851,190853,190855,2,4,0
54482,3,2,190854,190855,190857,1,3,0
54483,6,1,190860,190860,190861,0,1,3
54484,6,3,190866,190866,190869,0,3,5
54485,2,1,190868,190869,190870,1,2,0
54486,1,3,190869,190870,190873,1,4,0
54487,4,2,190873,190873,190875,0,2,0
54488,4,3,190877,190877,190880,0,3,2
54489,1,2,190878,190880,190882,2,4,0
54490,3,1,190881,190882,190883,1,2,0
54491,1,3,190882,190883,190886,1,4,0
54492,6,3,190888,190888,190891,0,3,2
54493,3,2,190891,190891,190893,0,2,0
54494,1,2,190892,190893,190895,1,3,0
54495,6,1,190898,190898,190899,0,1,3
54496,2,3,190900,190900,190903,0,3,1
54497,3,2,190903,190903,190905,0,2,0
54498,6,3,190909,190909,190912,0,3,4
54499,5,1,190914,190914,190915,0,1,2
54500,1,2,190915,190915,190917,0,2,0
54501,5,1,190920,190920,190921,0,1,3
54502,3,2,190923,190923,190925,0,2,2
54503,4,3,190927,190927,190930,0,3,2
54504,4,3,190931,190931,190934,0,3,1
54505,3,1,190934,190934,190935,0,1,0
54506,3,3,190937,190937,190940,0,3,2
54507,4,1,190941,190941,190942,0,1,1
54508,4,3,190945,190945,190948,0,3,3
54509,6,2,190951,190951,190953,0,2,3
54510,6,2,190957,190957,190959,0,2,4
54511,4,3,190961,190961,190964,0,3,2
54512,5,2,190966,190966,190968,0,2,2
54513,2,1,190968,190968,190969,0,1,0
54514,6,2,190974,190974,190976,0,2,5
54515,6,2,190980,190980,190982,0,2,4
54516,2,1,190982,190982,190983,0,1,0
54517,1,2,190983,190983,190985,0,2,0
54518,2,1,190985,190985,190986,0,1,0
54519,6,2,190991,190991,190993,0,2,5
54520,1,3,190992,190993,190996,1,4,0
54521,3,3,190995,190996,190999,1,4,0
54522,3,2,190998,190999,191001,1,3,0
54523,3,1,191001,191001,191002,0,1,0
54524,3,1,191004,191004,191005,0,1,2
54525,3,3,191007,191007,191010,0,3,2
54526,2,2,191009,191010,191012,1,3,0
54527,1,1,191010,191012,191013,2,3,0
54528,6,2,191016,191016,191018,0,2,3
54529,3,2,191019,191019,191021,0,2,1
54530,1,3,191020,191021,191024,1,4,0
54531,1,1,191021,191024,191025,3,4,0
54532,1,3,191022,191025,191028,3,6,0
54533,1,3,191023,191028,191031,5,8,0
54534,5,2,191028,191031,191033,3,5,0
54535,2,3,191030,191033,191036,3,6,0
54536,5,3,191035,191036,191039,1,4,0
54537,3,1,191038,191039,191040,1,2,0
54538,2,3,191040,191040,191043,0,3,0
54539,3,2,191043,191043,191045,0,2,0
54540,5,3,191048,191048,191051,0,3,3
54541,1,1,191049,191051,191052,2,3,0
54542,1,2,191050,191052,191054,2,4,0
54543,3,2,191053,191054,191056,1,3,0
54544,5,3,191058,191058,191061,0,3,2
54545,3,3,191061,191061,191064,0,3,0
54546,3,3,191064,191064,191067,0,3,0
54547,1,3,191065,191067,191070,2,5,0
54548,6,1,191071,191071,191072,0,1,1
54549,2,3,191073,191073,191076,0,3,1
54550,4,1,191077,191077,191078,0,1,1
54551,1,3,191078,191078,191081,0,3,0
54552,6,1,191084,191084,191085,0,1,3
54553,4,3,191088,191088,191091,0,3,3
54554,3,1,191091,191091,191092,0,1,0
54555,6,3,191097,191097,191100,0,3,5
54556,4,1,191101,191101,191102,0,1,1
54557,4,1,191105,191105,191106,0,1,3
54558,3,1,191108,191108,191109,0,1,2
54559,2,1,191110,191110,191111,0,1,1
54560,5,3,191115,191115,191118,0,3,4
54561,3,2,191118,191118,191120,0,2,0
54562,5,2,191123,191123,191125,0,2,3
54563,1,3,191124,191125,191128,1,4,0
54564,1,3,191125,191128,191131,3,6,0
54565,3,2,191128,191131,191133,3,5,0
54566,1,2,191129,191133,191135,4,6,0
54567,3,2,191132,191135,191137,3,5,0
54568,6,1,191138,191138,191139,0,1,1
54569,3,1,191141,191141,191142,0,1,2
54570,4,1,191145,191145,191146,0,1,3
54571,5,1,191150,191150,191151,0,1,4
54572,5,2,191155,191155,191157,0,2,4
54573,1,3,191156,191157,191160,1,4,0
54574,5,2,191161,191161,191163,0,2,1
54575,5,3,191166,191166,191169,0,3,3
54576,6,3,191172,191172,191175,0,3,3
54577,2,3,191174,191175,191178,1,4,0
54578,6,2,191180,191180,191182,0,2,2
54579,6,1,191186,191186,191187,0,1,4
54580,3,3,191189,191189,191192,0,3,2
54581,3,2,191192,191192,191194,0,2,0
54582,1,3,191193,191194,191197,1,4,0
54583,5,3,191198,191198,191201,0,3,1
54584,4,3,191202,191202,191205,0,3,1
54585,3,1,191205,191205,191206,0,1,0
54586,1,3,191206,191206,191209,0,3,0
54587,2,3,191208,191209,191212,1,4,0
54588,2,3,191210,191212,191215,2,5,0
54589,2,1,191212,191215,191216,3,4,0
54590,2,3,191214,191216,191219,2,5,0
54591,5,1,191219,191219,191220,0,1,0
54592,1,2,191220,191220,191222,0,2,0
54593,3,2,191223,191223,191225,0,2,1
54594,5,2,191228,191228,191230,0,2,3
54595,3,1,191231,191231,191232,0,1,1
54596,6,1,191237,191237,191238,0,1,5
54597,2,1,191239,191239,191240,0,1,1
54598,6,3,191245,191245,191248,0,3,5
54599,5,2,191250,191250,191252,0,2,2
54600,3,1,191253,191253,191254,0,1,1
54601,5,1,191258,191258,191259,0,1,4
54602,3,1,191261,191261,191262,0,1,2
54603,3,2,191264,191264,191266,0,2,2
54604,5,1,191269,191269,191270,0,1,3
54605,2,1,191271,191271,191272,0,1,1
54606,4,2,191275,191275,191277,0,2,3
54607,2,3,191277,191277,191280,0,3,0
54608,4,3,191281,191281,191284,0,3,1
54609,4,2,191285,191285,191287,0,2,1
54610,2,3,191287,191287,191290,0,3,0
54611,6,1,191293,191293,191294,0,1,3
54612,6,1,191299,191299,191300,0,1,5
54613,6,2,191305,191305,191307,0,2,5
54614,5,1,191310,191310,191311,0,1,3
54615,4,3,191314,191314,191317,0,3,3
54616,3,3,191317,191317,191320,0,3,0
54617,1,2,191318,191320,191322,2,4,0
54618,2,1,191320,191322,191323,2,3,0
54619,4,2,191324,191324,191326,0,2,1
54620,1,3,191325,191326,191329,1,4,0
54621,3,2,191328,191329,191331,1,3,0
54622,6,2,191334,191334,191336,0,2,3
54623,5,3,191339,191339,191342,0,3,3
54624,5,3,191344,191344,191347,0,3,2
54625,4,2,191348,191348,191350,0,2,1
54626,5,3,191353,191353,191356,0,3,3
54627,2,1,191355,191356,191357,1,2,0
54628,5,3,191360,191360,191363,0,3,3
54629,5,3,191365,191365,191368,0,3,2
54630,3,1,191368,191368,191369,0,1,0
54631,2,3,191370,191370,191373,0,3,1
54632,3,2,191373,191373,191375,0,2,0
54633,3,1,191376,191376,191377,0,1,1
54634,6,3,191382,191382,191385,0,3,5
54635,1,1,191383,191385,191386,2,3,0
54636,2,3,191385,191386,191389,1,4,0
54637,6,2,191391,191391,191393,0,2,2
54638,3,1,191394,191394,191395,0,1,1
54639,1,1,191395,191395,191396,0,1,0
54640,4,1,191399,191399,191400,0,1,3
54641,3,2,191402,191402,191404,0,2,2
54642,6,3,191408,191408,191411,0,3,4
54643,3,2,191411,191411,191413,0,2,0
54644,5,2,191416,191416,191418,0,2,3
54645,2,2,191418,191418,191420,0,2,0
54646,5,1,191423,191423,191424,0,1,3
54647,2,2,191425,191425,191427,0,2,1
54648,2,3,191427,191427,191430,0,3,0
54649,5,1,191432,191432,191433,0,1,2
54650,6,3,191438,191438,191441,0,3,5
54651,4,1,191442,191442,191443,0,1,1
54652,1,2,191443,191443,191445,0,2,0
54653,1,1,191444,191445,191446,1,2,0
54654,1,2,191445,191446,191448,1,3,0
54655,4,3,191449,191449,191452,0,3,1
54656,5,1,191454,191454,191455,0,1,2
54657,3,2,191457,191457,191459,0,2,2
54658,4,3,191461,191461,191464,0,3,2
54659,2,1,191463,191464,191465,1,2,0
54660,4,2,191467,191467,191469,0,2,2
54661,4,3,191471,191471,191474,0,3,2
54662,3,3,191474,191474,191477,0,3,0
54663,6,2,191480,191480,191482,0,2,3
54664,6,1,191486,191486,191487,0,1,4
54665,1,3,191487,191487,191490,0,3,0
54666,3,2,191490,191490,191492,0,2,0
54667,5,2,191495,191495,191497,0,2,3
54668,3,2,191498,191498,191500,0,2,1
54669,2,3,191500,191500,191503,0,3,0
54670,6,2,191506,191506,191508,0,2,3
54671,3,1,191509,191509,191510,0,1,1
54672,5,1,191514,191514,191515,0,1,4
54673,6,3,191520,191520,191523,0,3,5
54674,4,3,191524,191524,191527,0,3,1
54675,1,3,191525,191527,191530,2,5,0
54676,3,2,191528,191530,191532,2,4,0
54677,1,3,191529,191532,191535,3,6,0
54678,6,1,191535,191535,191536,0,1,0
54679,6,2,191541,191541,191543,0,2,5
54680,2,2,191543,191543,191545,0,2,0
54681,1,3,191544,191545,191548,1,4,0
54682,2,1,191546,191548,191549,2,3,0
54683,2,1,191548,191549,191550,1,2,0
54684,2,2,191550,191550,191552,0,2,0
54685,3,1,191553,191553,191554,0,1,1
54686,1,2,191554,191554,191556,0,2,0
54687,6,3,191560,191560,191563,0,3,4
54688,2,2,191562,191563,191565,1,3,0
54689,5,2,191567,191567,191569,0,2,2
54690,4,3,191571,191571,191574,0,3,2
54691,4,1,191575,191575,191576,0,1,1
54692,2,1,191577,191577,191578,0,1,1
54693,2,2,191579,191579,191581,0,2,1
54694,5,1,191584,191584,191585,0,1,3
54695,2,3,191586,191586,191589,0,3,1
54696,1,2,191587,191589,191591,2,4,0
54697,5,3,191592,191592,191595,0,3,1
54698,1,2,191593,191595,191597,2,4,0
54699,3,2,191596,191597,191599,1,3,0
54700,1,2,191597,191599,191601,2,4,0
54701,6,3,191603,191603,191606,0,3,2
54702,1,3,191604,191606,191609,2,5,0
54703,1,3,191605,191609,191612,4,7,0
54704,3,3,191608,191612,191615,4,7,0
54705,5,3,191613,191615,191618,2,5,0
54706,1,1,191614,191618,191619,4,5,0
54707,1,1,191615,191619,191620,4,5,0
54708,5,2,191620,191620,191622,0,2,0
54709,2,2,191622,191622,191624,0,2,0
54710,6,3,191628,191628,191631,0,3,4
54711,1,2,191629,191631,191633,2,4,0
54712,4,2,191633,191633,191635,0,2,0
54713,5,3,191638,191638,191641,0,3,3
54714,4,1,191642,191642,191643,0,1,1
54715,1,2,191643,191643,191645,0,2,0
54716,2,2,191645,191645,191647,0,2,0
54717,2,2,191647,191647,191649,0,2,0
54718,5,2,191652,191652,191654,0,2,3
54719,3,1,191655,191655,191656,0,1,1
54720,2,3,191657,191657,191660,0,3,1
54721,6,1,191663,191663,191664,0,1,3
54722,2,3,191665,191665,191668,0,3,1
54723,6,3,191671,191671,191674,0,3,3
54724,6,3,191677,191677,191680,0,3,3
54725,4,2,191681,191681,191683,0,2,1
54726,1,1,191682,191683,191684,1,2,0
54727,2,1,191684,191684,191685,0,1,0
54728,2,3,191686,191686,191689,0,3,1
54729,5,1,191691,191691,191692,0,1,2
54730,3,2,191694,191694,191696,0,2,2
54731,2,1,191696,191696,191697,0,1,0
54732,2,1,191698,191698,191699,0,1,1
54733,6,3,191704,191704,191707,0,3,5
54734,4,1,191708,191708,191709,0,1,1
54735,4,2,191712,191712,191714,0,2,3
54736,4,2,191716,191716,191718,0,2,2
54737,1,3,191717,191718,191721,1,4,0
54738,6,3,191723,191723,191726,0,3,2
54739,6,1,191729,191729,191730,0,1,3
54740,3,2,191732,191732,191734,0,2,2
54741,4,1,191736,191736,191737,0,1,2
54742,3,2,191739,191739,191741,0,2,2
54743,3,1,191742,191742,191743,0,1,1
54744,2,1,191744,191744,191745,0,1,1
54745,5,2,191749,191749,191751,0,2,4
54746,5,3,191754,191754,191757,0,3,3
54747,2,2,191756,191757,191759,1,3,0
54748,2,3,191758,191759,191762,1,4,0
54749,2,1,191760,191762,191763,2,3,0
54750,4,2,191764,191764,191766,0,2,1
54751,2,2,191766,191766,191768,0,2,0
54752,4,1,191770,191770,191771,0,1,2
54753,5,1,191775,191775,191776,0,1,4
54754,1,1,191776,191776,191777,0,1,0
54755,3,3,191779,191779,191782,0,3,2
54756,3,2,191782,191782,191784,0,2,0
54757,1,1,191783,191784,191785,1,2,0
54758,6,3,191789,191789,191792,0,3,4
54759,5,3,191794,191794,191797,0,3,2
54760,2,2,191796,191797,191799,1,3,0
54761,6,1,191802,191802,191803,0,1,3
54762,4,3,191806,191806,191809,0,3,3
54763,4,2,191810,191810,191812,0,2,1
54764,1,3,191811,191812,191815,1,4,0
54765,4,1,191815,191815,191816,0,1,0
54766,2,1,191817,191817,191818,0,1,1
54767,5,3,191822,191822,191825,0,3,4
54768,1,3,191823,191825,191828,2,5,0
54769,3,2,191826,191828,191830,2,4,0
54770,1,2,191827,191830,191832,3,5,0
54771,2,1,191829,191832,191833,3,4,0
54772,3,2,191832,191833,191835,1,3,0
54773,4,1,191836,191836,191837,0,1,1
54774,3,3,191839,191839,191842,0,3,2
54775,4,1,191843,191843,191844,0,1,1
54776,5,1,191848,191848,191849,0,1,4
54777,5,2,191853,191853,191855,0,2,4
54778,2,2,191855,191855,191857,0,2,0
54779,4,3,191859,191859,191862,0,3,2
54780,5,2,191864,191864,191866,0,2,2
54781,5,3,191869,191869,191872,0,3,3
54782,4,1,191873,191873,191874,0,1,1
54783,4,3,191877,191877,191880,0,3,3
54784,6,3,191883,191883,191886,0,3,3
54785,1,1,191884,191886,191887,2,3,0
54786,4,1,191888,191888,191889,0,1,1
54787,1,3,191889,191889,191892,0,3,0
54788,3,3,191892,191892,191895,0,3,0
54789,4,1,191896,191896,191897,0,1,1
54790,6,3,191902,191902,191905,0,3,5
54791,6,3,191908,191908,191911,0,3,3
54792,6,1,191914,191914,191915,0,1,3
54793,5,2,191919,191919,191921,0,2,4
54794,5,2,191924,191924,191926,0,2,3
54795,3,2,191927,191927,191929,0,2,1
54796,1,2,191928,191929,191931,1,3,0
54797,3,3,191931,191931,191934,0,3,0
54798,5,1,191936,191936,191937,0,1,2
54799,6,1,191942,191942,191943,0,1,5
54800,6,1,191948,191948,191949,0,1,5
54801,1,3,191949,191949,191952,0,3,0
54802,5,1,191954,191954,191955,0,1,2
54803,6,1,191960,191960,191961,0,1,5
54804,6,3,191966,191966,191969,0,3,5
54805,3,3,191969,191969,191972,0,3,0
54806,1,2,191970,191972,191974,2,4,0
54807,2,3,191972,191974,191977,2,5,0
54808,4,2,191976,191977,191979,1,3,0
54809,3,1,191979,191979,191980,0,1,0
54810,3,1,191982,191982,191983,0,1,2
54811,4,1,191986,191986,191987,0,1,3
54812,2,2,191988,191988,191990,0,2,1
54813,5,2,191993,191993,191995,0,2,3
54814,3,2,191996,191996,191998,0,2,1
54815,1,2,191997,191998,192000,1,3,0
54816,5,3,192002,192002,192005,0,3,2
54817,4,3,192006,192006,192009,0,3,1
54818,1,1,192007,192009,192010,2,3,0
54819,2,1,192009,192010,192011,1,2,0
54820,6,2,192015,192015,192017,0,2,4
54821,5,3,192020,192020,192023,0,3,3
54822,2,2,192022,192023,192025,1,3,0
54823,1,2,192023,192025,192027,2,4,0
54824,3,3,192026,192027,192030,1,4,0
54825,6,2,192032,192032,192034,0,2,2
54826,4,2,192036,192036,192038,0,2,2
54827,4,3,192040,192040,192043,0,3,2
54828,1,2,192041,192043,192045,2,4,0
54829,3,1,192044,192045,192046,1,2,0
54830,4,1,192048,192048,192049,0,1,2
54831,3,2,192051,192051,192053,0,2,2
54832,4,3,192055,192055,192058,0,3,2
54833,5,2,192060,192060,192062,0,2,2
54834,5,2,192065,192065,192067,0,2,3
54835,1,2,192066,192067,192069,1,3,0
54836,1,3,192067,192069,192072,2,5,0
54837,4,1,192071,192072,192073,1,2,0
54838,3,1,192074,192074,192075,0,1,1
54839,5,3,192079,192079,192082,0,3,4
54840,5,2,192084,192084,192086,0,2,2
54841,1,3,192085,192086,192089,1,4,0
54842,6,1,192091,192091,192092,0,1,2
54843,6,2,192097,192097,192099,0,2,5
54844,6,1,192103,192103,192104,0,1,4
54845,4,2,192107,192107,192109,0,2,3
54846,2,2,192109,192109,192111,0,2,0
54847,3,3,192112,192112,192115,0,3,1
54848,5,2,192117,192117,192119,0,2,2
54849,1,3,192118,192119,192122,1,4,0
54850,5,3,192123,192123,192126,0,3,1
54851,2,2,192125,192126,192128,1,3,0
54852,4,1,192129,192129,192130,0,1,1
54853,2,1,192131,192131,192132,0,1,1
54854,1,3,192132,192132,192135,0,3,0
54855,1,2,192133,192135,192137,2,4,0
54856,6,1,192139,192139,192140,0,1,2
54857,4,3,192143,192143,192146,0,3,3
54858,6,2,192149,192149,192151,0,2,3
54859,5,2,192154,192154,192156,0,2,3
54860,1,3,192155,192156,192159,1,4,0
54861,5,1,192160,192160,192161,0,1,1
54862,6,2,192166,192166,192168,0,2,5
54863,2,3,192168,192168,192171,0,3,0
54864,4,2,192172,192172,192174,0,2,1
54865,6,1,192178,192178,192179,0,1,4
54866,1,3,192179,192179,192182,0,3,0
54867,2,2,192181,192182,192184,1,3,0
54868,2,3,192183,192184,192187,1,4,0
54869,4,2,192187,192187,192189,0,2,0
54870,1,2,192188,192189,192191,1,3,0
54871,2,3,192190,192191,192194,1,4,0
54872,2,2,192192,192194,192196,2,4,0
54873,4,1,192196,192196,192197,0,1,0
54874,5,2,192201,192201,192203,0,2,4
54875,6,2,192207,192207,192209,0,2,4
54876,2,2,192209,192209,192211,0,2,0
54877,6,1,192215,192215,192216,0,1,4
54878,2,3,192217,192217,192220,0,3,1
54879,4,2,192221,192221,192223,0,2,1
54880,2,1,192223,192223,192224,0,1,0
54881,3,1,192226,192226,192227,0,1,2
54882,4,1,192230,192230,192231,0,1,3
54883,3,3,192233,192233,192236,0,3,2
54884,6,2,192239,192239,192241,0,2,3
54885,5,2,192244,192244,192246,0,2,3
54886,3,3,192247,192247,192250,0,3,1
54887,3,3,192250,192250,192253,0,3,0
54888,2,2,192252,192253,192255,1,3,0
54889,2,3,192254,192255,192258,1,4,0
54890,2,3,192256,192258,192261,2,5,0
54891,4,1,192260,192261,192262,1,2,0
54892,5,2,192265,192265,192267,0,2,3
54893,1,3,192266,192267,192270,1,4,0
54894,1,3,192267,192270,192273,3,6,0
54895,3,1,192270,192273,192274,3,4,0
54896,4,3,192274,192274,192277,0,3,0
54897,3,2,192277,192277,192279,0,2,0
54898,2,2,192279,192279,192281,0,2,0
54899,2,2,192281,192281,192283,0,2,0
54900,1,2,192282,192283,192285,1,3,0
54901,3,2,192285,192285,192287,0,2,0
54902,5,3,192290,192290,192293,0,3,3
54903,5,1,192295,192295,192296,0,1,2
54904,6,1,192301,192301,192302,0,1,5
54905,2,3,192303,192303,192306,0,3,1
54906,3,2,192306,192306,192308,0,2,0
54907,2,2,192308,192308,192310,0,2,0
54908,4,1,192312,192312,192313,0,1,2
54909,6,3,192318,192318,192321,0,3,5
54910,2,3,192320,192321,192324,1,4,0
54911,6,1,192326,192326,192327,0,1,2
54912,2,3,192328,192328,192331,0,3,1
54913,5,3,192333,192333,192336,0,3,2
54914,1,2,192334,192336,192338,2,4,0
54915,5,1,192339,192339,192340,0,1,1
54916,5,3,192344,192344,192347,0,3,4
54917,2,3,192346,192347,192350,1,4,0
54918,4,3,192350,192350,192353,0,3,0
54919,4,2,192354,192354,192356,0,2,1
54920,5,2,192359,192359,192361,0,2,3
54921,5,1,192364,192364,192365,0,1,3
54922,1,2,192365,192365,192367,0,2,0
54923,3,3,192368,192368,192371,0,3,1
54924,2,3,192370,192371,192374,1,4,0
54925,4,3,192374,192374,192377,0,3,0
54926,4,3,192378,192378,192381,0,3,1
54927,6,2,192384,192384,192386,0,2,3
54928,3,2,192387,192387,192389,0,2,1
54929,1,2,192388,192389,192391,1,3,0
54930,4,2,192392,192392,192394,0,2,1
54931,2,2,192394,192394,192396,0,2,0
54932,5,2,192399,192399,192401,0,2,3
54933,3,2,192402,192402,192404,0,2,1
54934,3,3,192405,192405,192408,0,3,1
54935,2,1,192407,192408,192409,1,2,0
54936,6,3,192413,192413,192416,0,3,4
54937,2,2,192415,192416,192418,1,3,0
54938,4,3,192419,192419,192422,0,3,1
54939,5,3,192424,192424,192427,0,3,2
54940,1,2,192425,192427,192429,2,4,0
54941,2,2,192427,192429,192431,2,4,0
54942,5,1,192432,192432,192433,0,1,1
54943,5,3,192437,192437,192440,0,3,4
54944,3,1,192440,192440,192441,0,1,0
54945,1,2,192441,192441,192443,0,2,0
54946,3,1,192444,192444,192445,0,1,1
54947,3,2,192447,192447,192449,0,2,2
54948,2,2,192449,192449,192451,0,2,0
54949,5,1,192454,192454,192455,0,1,3
54950,1,2,192455,192455,192457,0,2,0
54951,6,1,192461,192461,192462,0,1,4
54952,1,3,192462,192462,192465,0,3,0
54953,4,3,192466,192466,192469,0,3,1
54954,1,1,192467,192469,192470,2,3,0
54955,6,3,192473,192473,192476,0,3,3
54956,1,2,192474,192476,192478,2,4,0
54957,6,3,192480,192480,192483,0,3,2
54958,5,2,192485,192485,192487,0,2,2
54959,2,3,192487,192487,192490,0,3,0
54960,1,1,192488,192490,192491,2,3,0
54961,4,3,192492,192492,192495,0,3,1
54962,6,1,192498,192498,192499,0,1,3
54963,3,1,192501,192501,192502,0,1,2
54964,2,3,192503,192503,192506,0,3,1
54965,1,3,192504,192506,192509,2,5,0
54966,4,3,192508,192509,192512,1,4,0
54967,6,1,192514,192514,192515,0,1,2
54968,3,2,192517,192517,192519,0,2,2
54969,6,1,192523,192523,192524,0,1,4
54970,5,1,192528,192528,192529,0,1,4
54971,4,2,192532,192532,192534,0,2,3
54972,2,2,192534,192534,192536,0,2,0
54973,3,1,192537,192537,192538,0,1,1
54974,6,3,192543,192543,192546,0,3,5
54975,6,3,192549,192549,192552,0,3,3
54976,6,1,192555,192555,192556,0,1,3
54977,4,2,192559,192559,192561,0,2,3
54978,6,3,192565,192565,192568,0,3,4
54979,2,1,192567,192568,192569,1,2,0
54980,3,3,192570,192570,192573,0,3,1
54981,3,1,192573,192573,192574,0,1,0
54982,2,1,192575,192575,192576,0,1,1
54983,1,1,192576,192576,192577,0,1,0
54984,6,2,192582,192582,192584,0,2,5
54985,5,1,192587,192587,192588,0,1,3
54986,6,3,192593,192593,192596,0,3,5
54987,1,2,192594,192596,192598,2,4,0
54988,1,3,192595,192598,192601,3,6,0
54989,5,3,192600,192601,192604,1,4,0
54990,6,3,192606,192606,192609,0,3,2
54991,3,2,192609,192609,192611,0,2,0
54992,3,1,192612,192612,192613,0,1,1
54993,5,3,192617,192617,192620,0,3,4
54994,5,3,192622,192622,192625,0,3,2
54995,4,1,192626,192626,192627,0,1,1
54996,1,3,192627,192627,192630,0,3,0
54997,6,1,192633,192633,192634,0,1,3
54998,2,2,192635,192635,192637,0,2,1
54999,3,1,192638,192638,192639,0,1,1
55000,4,1,192642,192642,192643,0,1,3
55001,2,1,192644,192644,192645,0,1,1
55002,4,1,192648,192648,192649,0,1,3
55003,2,3,192650,192650,192653,0,3,1
55004,1,1,192651,192653,192654,2,3,0
55005,4,2,192655,192655,192657,0,2,1
55006,5,2,192660,192660,192662,0,2,3
55007,1,3,192661,192662,192665,1,4,0
55008,1,1,192662,192665,192666,3,4,0
55009,3,2,192665,192666,192668,1,3,0
55010,4,3,192669,192669,192672,0,3,1
55011,5,1,192674,192674,192675,0,1,2
55012,3,2,192677,192677,192679,0,2,2
55013,6,1,192683,192683,192684,0,1,4
55014,1,3,192684,192684,192687,0,3,0
55015,5,1,192689,192689,192690,0,1,2
55016,5,2,192694,192694,192696,0,2,4
55017,1,3,192695,192696,192699,1,4,0
55018,2,3,192697,192699,192702,2,5,0
55019,4,2,192701,192702,192704,1,3,0
55020,5,1,192706,192706,192707,0,1,2
55021,1,3,192707,192707,192710,0,3,0
55022,5,3,192712,192712,192715,0,3,2
55023,1,1,192713,192715,192716,2,3,0
55024,3,2,192716,192716,192718,0,2,0
55025,6,1,192722,192722,192723,0,1,4
55026,1,1,192723,192723,192724,0,1,0
55027,2,2,192725,192725,192727,0,2,1
55028,3,3,192728,192728,192731,0,3,1
55029,1,3,192729,192731,192734,2,5,0
55030,5,2,192734,192734,192736,0,2,0
55031,1,3,192735,192736,192739,1,4,0
55032,2,1,192737,192739,192740,2,3,0
55033,1,1,192738,192740,192741,2,3,0
55034,2,2,192740,192741,192743,1,3,0
55035,3,3,192743,192743,192746,0,3,0
55036,3,2,192746,192746,192748,0,2,0
55037,3,3,192749,192749,192752,0,3,1
55038,3,1,192752,192752,192753,0,1,0
55039,4,2,192756,192756,192758,0,2,3
55040,1,1,192757,192758,192759,1,2,0
55041,2,3,192759,192759,192762,0,3,0
55042,2,2,192761,192762,192764,1,3,0
55043,3,1,192764,192764,192765,0,1,0
55044,6,3,192770,192770,192773,0,3,5
55045,4,3,192774,192774,192777,0,3,1
55046,5,1,192779,192779,192780,0,1,2
55047,6,1,192785,192785,192786,0,1,5
55048,6,2,192791,192791,192793,0,2,5
55049,3,2,192794,192794,192796,0,2,1
55050,4,3,192798,192798,192801,0,3,2
55051,1,3,192799,192801,192804,2,5,0
55052,1,2,192800,192804,192806,4,6,0
55053,4,1,192804,192806,192807,2,3,0
55054,4,1,192808,192808,192809,0,1,1
55055,6,3,192814,192814,192817,0,3,5
55056,3,2,192817,192817,192819,0,2,0
55057,6,3,192823,192823,192826,0,3,4
55058,3,3,192826,192826,192829,0,3,0
55059,2,3,192828,192829,192832,1,4,0
55060,4,3,192832,192832,192835,0,3,0
55061,2,1,192834,192835,192836,1,2,0
55062,4,1,192838,192838,192839,0,1,2
55063,2,3,192840,192840,192843,0,3,1
55064,5,1,192845,192845,192846,0,1,2
55065,4,1,192849,192849,192850,0,1,3
55066,4,2,192853,192853,192855,0,2,3
55067,5,2,192858,192858,192860,0,2,3
55068,6,2,192864,192864,192866,0,2,4
55069,3,3,192867,192867,192870,0,3,1
55070,3,3,192870,192870,192873,0,3,0
55071,5,1,192875,192875,192876,0,1,2
55072,3,1,192878,192878,192879,0,1,2
55073,2,1,192880,192880,192881,0,1,1
55074,3,2,192883,192883,192885,0,2,2
55075,3,2,192886,192886,192888,0,2,1
55076,1,3,192887,192888,192891,1,4,0
55077,1,1,192888,192891,192892,3,4,0
55078,1,1,192889,192892,192893,3,4,0
55079,2,1,192891,192893,192894,2,3,0
55080,4,2,192895,192895,192897,0,2,1
55081,1,3,192896,192897,192900,1,4,0
55082,3,2,192899,192900,192902,1,3,0
55083,1,1,192900,192902,192903,2,3,0
55084,2,3,192902,192903,192906,1,4,0
55085,2,2,192904,192906,192908,2,4,0
55086,2,2,192906,192908,192910,2,4,0
55087,1,3,192907,192910,192913,3,6,0
55088,6,2,192913,192913,192915,0,2,0
55089,6,2,192919,192919,192921,0,2,4
55090,5,1,192924,192924,192925,0,1,3
55091,2,3,192926,192926,192929,0,3,1
55092,1,1,192927,192929,192930,2,3,0
55093,5,2,192932,192932,192934,0,2,2
55094,1,3,192933,192934,192937,1,4,0
55095,3,2,192936,192937,192939,1,3,0
55096,5,3,192941,192941,192944,0,3,2
55097,3,3,192944,192944,192947,0,3,0
55098,5,3,192949,192949,192952,0,3,2
55099,3,3,192952,192952,192955,0,3,0
55100,1,2,192953,192955,192957,2,4,0
55101,2,2,192955,192957,192959,2,4,0
55102,5,1,192960,192960,192961,0,1,1
55103,3,1,192963,192963,192964,0,1,2
55104,2,3,192965,192965,192968,0,3,1
55105,4,3,192969,192969,192972,0,3,1
55106,2,1,192971,192972,192973,1,2,0
55107,6,2,192977,192977,192979,0,2,4
55108,1,3,192978,192979,192982,1,4,0
55109,4,1,192982,192982,192983,0,1,0
55110,3,1,192985,192985,192986,0,1,2
55111,1,1,192986,192986,192987,0,1,0
55112,4,3,192990,192990,192993,0,3,3
55113,4,3,192994,192994,192997,0,3,1
55114,6,3,193000,193000,193003,0,3,3
55115,3,1,193003,193003,193004,0,1,0
55116,3,3,193006,193006,193009,0,3,2
55117,2,2,193008,193009,193011,1,3,0
55118,4,3,193012,193012,193015,0,3,1
55119,4,3,193016,193016,193019,0,3,1
55120,6,3,193022,193022,193025,0,3,3
55121,5,2,193027,193027,193029,0,2,2
55122,3,2,193030,193030,193032,0,2,1
55123,2,2,193032,193032,193034,0,2,0
55124,1,1,193033,193034,193035,1,2,0
55125,1,1,193034,193035,193036,1,2,0
55126,5,1,193039,193039,193040,0,1,3
55127,3,1,193042,193042,193043,0,1,2
55128,4,2,193046,193046,193048,0,2,3
55129,6,2,193052,193052,193054,0,2,4
55130,2,1,193054,193054,193055,0,1,0
55131,6,2,193060,193060,193062,0,2,5
55132,3,3,193063,193063,193066,0,3,1
55133,1,2,193064,193066,193068,2,4,0
55134,1,2,193065,193068,193070,3,5,0
55135,6,3,193071,193071,193074,0,3,1
55136,3,3,193074,193074,193077,0,3,0
55137,1,2,193075,193077,193079,2,4,0
55138,2,2,193077,193079,193081,2,4,0
55139,2,1,193079,193081,193082,2,3,0
55140,5,1,193084,193084,193085,0,1,2
55141,4,3,193088,193088,193091,0,3,3
55142,5,3,193093,193093,193096,0,3,2
55143,5,3,193098,193098,193101,0,3,2
55144,2,3,193100,193101,193104,1,4,0
55145,3,1,193103,193104,193105,1,2,0
55146,1,3,193104,193105,193108,1,4,0
55147,6,3,193110,193110,193113,0,3,2
55148,2,1,193112,193113,193114,1,2,0
55149,3,1,193115,193115,193116,0,1,1
55150,6,3,193121,193121,193124,0,3,5
55151,6,3,193127,193127,193130,0,3,3
55152,4,3,193131,193131,193134,0,3,1
55153,2,2,193133,193134,193136,1,3,0
55154,2,2,193135,193136,193138,1,3,0
55155,2,3,193137,193138,193141,1,4,0
55156,4,3,193141,193141,193144,0,3,0
55157,4,1,193145,193145,193146,0,1,1
55158,5,2,193150,193150,193152,0,2,4
55159,5,3,193155,193155,193158,0,3,3
55160,5,3,193160,193160,193163,0,3,2
55161,4,2,193164,193164,193166,0,2,1
55162,3,2,193167,193167,193169,0,2,1
55163,6,1,193173,193173,193174,0,1,4
55164,1,2,193174,193174,193176,0,2,0
55165,6,3,193180,193180,193183,0,3,4
55166,3,1,193183,193183,193184,0,1,0
55167,6,3,193189,193189,193192,0,3,5
55168,5,1,193194,193194,193195,0,1,2
55169,3,1,193197,193197,193198,0,1,2
55170,6,2,193203,193203,193205,0,2,5
55171,6,3,193209,193209,193212,0,3,4
55172,1,1,193210,193212,193213,2,3,0
55173,5,2,193215,193215,193217,0,2,2
55174,5,3,193220,193220,193223,0,3,3
55175,6,3,193226,193226,193229,0,3,3
55176,2,2,193228,193229,193231,1,3,0
55177,4,3,193232,193232,193235,0,3,1
55178,1,3,193233,193235,193238,2,5,0
55179,4,3,193237,193238,193241,1,4,0
55180,4,1,193241,193241,193242,0,1,0
55181,1,1,193242,193242,193243,0,1,0
55182,2,1,193244,193244,193245,0,1,1
55183,1,1,193245,193245,193246,0,1,0
55184,4,1,193249,193249,193250,0,1,3
55185,3,2,193252,193252,193254,0,2,2
55186,1,2,193253,193254,193256,1,3,0
55187,1,1,193254,193256,193257,2,3,0
55188,6,3,193260,193260,193263,0,3,3
55189,6,2,193266,193266,193268,0,2,3
55190,1,3,193267,193268,193271,1,4,0
55191,3,3,193270,193271,193274,1,4,0
55192,5,2,193275,193275,193277,0,2,1
55193,5,1,193280,193280,193281,0,1,3
55194,4,3,193284,193284,193287,0,3,3
55195,1,2,193285,193287,193289,2,4,0
55196,4,1,193289,193289,193290,0,1,0
55197,2,2,193291,193291,193293,0,2,1
55198,3,1,193294,193294,193295,0,1,1
55199,1,2,193295,193295,193297,0,2,0
55200,5,3,193300,193300,193303,0,3,3
55201,2,1,193302,193303,193304,1,2,0
55202,5,1,193307,193307,193308,0,1,3
55203,3,1,193310,193310,193311,0,1,2
55204,2,1,193312,193312,193313,0,1,1
55205,1,3,193313,193313,193316,0,3,0
55206,2,3,193315,193316,193319,1,4,0
55207,5,2,193320,193320,193322,0,2,1
55208,6,2,193326,193326,193328,0,2,4
55209,1,1,193327,193328,193329,1,2,0
55210,1,1,193328,193329,193330,1,2,0
55211,1,2,193329,193330,193332,1,3,0
55212,2,3,193331,193332,193335,1,4,0
55213,4,3,193335,193335,193338,0,3,0
55214,5,1,193340,193340,193341,0,1,2
55215,1,3,193341,193341,193344,0,3,0
55216,1,2,193342,193344,193346,2,4,0
55217,5,3,193347,193347,193350,0,3,1
55218,3,2,193350,193350,193352,0,2,0
55219,2,1,193352,193352,193353,0,1,0
55220,2,2,193354,193354,193356,0,2,1
55221,2,1,193356,193356,193357,0,1,0
55222,1,2,193357,193357,193359,0,2,0
55223,3,3,193360,193360,193363,0,3,1
55224,2,2,193362,193363,193365,1,3,0
55225,5,2,193367,193367,193369,0,2,2
55226,6,2,193373,193373,193375,0,2,4
55227,2,3,193375,193375,193378,0,3,0
55228,5,3,193380,193380,193383,0,3,2
55229,3,2,193383,193383,193385,0,2,0
55230,1,2,193384,193385,193387,1,3,0
55231,3,3,193387,193387,193390,0,3,0
55232,2,1,193389,193390,193391,1,2,0
55233,2,2,193391,193391,193393,0,2,0
55234,3,1,193394,193394,193395,0,1,1
55235,2,2,193396,193396,193398,0,2,1
55236,2,3,193398,193398,193401,0,3,0
55237,2,3,193400,193401,193404,1,4,0
55238,2,2,193402,193404,193406,2,4,0
55239,5,3,193407,193407,193410,0,3,1
55240,1,2,193408,193410,193412,2,4,0
55241,4,3,193412,193412,193415,0,3,0
55242,3,2,193415,193415,193417,0,2,0
55243,2,1,193417,193417,193418,0,1,0
55244,3,1,193420,193420,193421,0,1,2
55245,5,3,193425,193425,193428,0,3,4
55246,1,1,193426,193428,193429,2,3,0
55247,4,3,193430,193430,193433,0,3,1
55248,6,1,193436,193436,193437,0,1,3
55249,6,3,193442,193442,193445,0,3,5
55250,1,2,193443,193445,193447,2,4,0
55251,3,3,193446,193447,193450,1,4,0
55252,3,1,193449,193450,193451,1,2,0
55253,4,1,193453,193453,193454,0,1,2
55254,5,2,193458,193458,193460,0,2,4
55255,2,3,193460,193460,193463,0,3,0
55256,3,1,193463,193463,193464,0,1,0
55257,5,3,193468,193468,193471,0,3,4
55258,6,3,193474,193474,193477,0,3,3
55259,1,1,193475,193477,193478,2,3,0
55260,3,1,193478,193478,193479,0,1,0
55261,1,3,193479,193479,193482,0,3,0
55262,4,2,193483,193483,193485,0,2,1
55263,5,1,193488,193488,193489,0,1,3
55264,5,3,193493,193493,193496,0,3,4
55265,4,3,193497,193497,193500,0,3,1
55266,4,2,193501,193501,193503,0,2,1
55267,1,2,193502,193503,193505,1,3,0
55268,5,2,193507,193507,193509,0,2,2
55269,3,3,193510,193510,193513,0,3,1
55270,6,2,193516,193516,193518,0,2,3
55271,1,1,193517,193518,193519,1,2,0
55272,4,1,193521,193521,193522,0,1,2
55273,5,1,193526,193526,193527,0,1,4
55274,2,3,193528,193528,193531,0,3,1
55275,5,3,193533,193533,193536,0,3,2
55276,3,3,193536,193536,193539,0,3,0
55277,2,3,193538,193539,193542,1,4,0
55278,4,1,193542,193542,193543,0,1,0
55279,2,3,193544,193544,193547,0,3,1
55280,6,1,193550,193550,193551,0,1,3
55281,2,3,193552,193552,193555,0,3,1
55282,1,2,193553,193555,193557,2,4,0
55283,6,3,193559,193559,193562,0,3,2
55284,5,1,193564,193564,193565,0,1,2
55285,6,1,193570,193570,193571,0,1,5
55286,5,3,193575,193575,193578,0,3,4
55287,3,1,193578,193578,193579,0,1,0
55288,1,2,193579,193579,193581,0,2,0
55289,1,3,193580,193581,193584,1,4,0
55290,5,1,193585,193585,193586,0,1,1
55291,1,2,193586,193586,193588,0,2,0
55292,6,2,193592,193592,193594,0,2,4
55293,6,1,193598,193598,193599,0,1,4
55294,6,2,193604,193604,193606,0,2,5
55295,6,3,193610,193610,193613,0,3,4
55296,2,2,193612,193613,193615,1,3,0
55297,2,1,193614,193615,193616,1,2,0
55298,6,1,193620,193620,193621,0,1,4
55299,2,2,193622,193622,193624,0,2,1
55300,6,1,193628,193628,193629,0,1,4
55301,5,1,193633,193633,193634,0,1,4
55302,2,1,193635,193635,193636,0,1,1
55303,6,3,193641,193641,193644,0,3,5
55304,3,1,193644,193644,193645,0,1,0
55305,4,3,193648,193648,193651,0,3,3
55306,4,2,193652,193652,193654,0,2,1
55307,6,2,193658,193658,193660,0,2,4
55308,5,1,193663,193663,193664,0,1,3
55309,1,2,193664,193664,193666,0,2,0
55310,4,2,193668,193668,193670,0,2,2
55311,3,3,193671,193671,193674,0,3,1
55312,3,1,193674,193674,193675,0,1,0
55313,6,1,193680,193680,193681,0,1,5
55314,6,2,193686,193686,193688,0,2,5
55315,5,2,193691,193691,193693,0,2,3
55316,3,2,193694,193694,193696,0,2,1
55317,3,3,193697,193697,193700,0,3,1
55318,1,3,193698,193700,193703,2,5,0
55319,5,2,193703,193703,193705,0,2,0
55320,6,3,193709,193709,193712,0,3,4
55321,1,2,193710,193712,193714,2,4,0
55322,1,3,193711,193714,193717,3,6,0
55323,5,3,193716,193717,193720,1,4,0
55324,3,3,193719,193720,193723,1,4,0
55325,3,1,193722,193723,193724,1,2,0
55326,4,3,193726,193726,193729,0,3,2
55327,1,2,193727,193729,193731,2,4,0
55328,6,1,193733,193733,193734,0,1,2
55329,5,3,193738,193738,193741,0,3,4
55330,5,2,193743,193743,193745,0,2,2
55331,2,1,193745,193745,193746,0,1,0
55332,5,2,193750,193750,193752,0,2,4
55333,1,1,193751,193752,193753,1,2,0
55334,5,3,193756,193756,193759,0,3,3
55335,4,1,193760,193760,193761,0,1,1
55336,1,2,193761,193761,193763,0,2,0
55337,4,3,193765,193765,193768,0,3,2
55338,5,3,193770,193770,193773,0,3,2
55339,3,2,193773,193773,193775,0,2,0
55340,3,1,193776,193776,193777,0,1,1
55341,4,2,193780,193780,193782,0,2,3
55342,3,1,193783,193783,193784,0,1,1
55343,5,1,193788,193788,193789,0,1,4
55344,6,3,193794,193794,193797,0,3,5
55345,3,3,193797,193797,193800,0,3,0
55346,2,2,193799,193800,193802,1,3,0
55347,4,3,193803,193803,193806,0,3,1
55348,1,3,193804,193806,193809,2,5,0
55349,1,1,193805,193809,193810,4,5,0
55350,1,3,193806,193810,193813,4,7,0
55351,3,3,193809,193813,193816,4,7,0
55352,4,1,193813,193816,193817,3,4,0
55353,3,3,193816,193817,193820,1,4,0
55354,6,3,193822,193822,193825,0,3,2
55355,2,1,193824,193825,193826,1,2,0
55356,2,1,193826,193826,193827,0,1,0
55357,1,3,193827,193827,193830,0,3,0
55358,3,3,193830,193830,193833,0,3,0
55359,6,2,193836,193836,193838,0,2,3
55360,3,2,193839,193839,193841,0,2,1
55361,2,3,193841,193841,193844,0,3,0
55362,4,3,193845,193845,193848,0,3,1
55363,1,2,193846,193848,193850,2,4,0
55364,5,3,193851,193851,193854,0,3,1
55365,2,1,193853,193854,193855,1,2,0
55366,3,3,193856,193856,193859,0,3,1
55367,1,2,193857,193859,193861,2,4,0
55368,5,2,193862,193862,193864,0,2,1
55369,3,2,193865,193865,193867,0,2,1
55370,5,1,193870,193870,193871,0,1,3
55371,5,1,193875,193875,193876,0,1,4
55372,3,1,193878,193878,193879,0,1,2
55373,5,3,193883,193883,193886,0,3,4
55374,2,3,193885,193886,193889,1,4,0
55375,3,3,193888,193889,193892,1,4,0
55376,6,3,193894,193894,193897,0,3,2
55377,6,2,193900,193900,193902,0,2,3
55378,4,2,193904,193904,193906,0,2,2
55379,6,3,193910,193910,193913,0,3,4
55380,5,1,193915,193915,193916,0,1,2
55381,6,1,193921,193921,193922,0,1,5
55382,2,3,193923,193923,193926,0,3,1
55383,3,1,193926,193926,193927,0,1,0
55384,4,3,193930,193930,193933,0,3,3
55385,4,1,193934,193934,193935,0,1,1
55386,4,1,193938,193938,193939,0,1,3
55387,3,1,193941,193941,193942,0,1,2
55388,2,2,193943,193943,193945,0,2,1
55389,2,3,193945,193945,193948,0,3,0
55390,1,2,193946,193948,193950,2,4,0
55391,4,1,193950,193950,193951,0,1,0
55392,1,3,193951,193951,193954,0,3,0
55393,4,3,193955,193955,193958,0,3,1
55394,4,3,193959,193959,193962,0,3,1
55395,3,2,193962,193962,193964,0,2,0
55396,1,3,193963,193964,193967,1,4,0
55397,3,1,193966,193967,193968,1,2,0
55398,6,3,193972,193972,193975,0,3,4
55399,4,3,193976,193976,193979,0,3,1
55400,1,3,193977,193979,193982,2,5,0
55401,5,3,193982,193982,193985,0,3,0
55402,1,2,193983,193985,193987,2,4,0
55403,6,1,193989,193989,193990,0,1,2
55404,6,2,193995,193995,193997,0,2,5
55405,4,2,193999,193999,194001,0,2,2
55406,5,3,194004,194004,194007,0,3,3
55407,2,3,194006,194007,194010,1,4,0
55408,5,3,194011,194011,194014,0,3,1
55409,3,3,194014,194014,194017,0,3,0
55410,4,2,194018,194018,194020,0,2,1
55411,2,1,194020,194020,194021,0,1,0
55412,6,2,194026,194026,194028,0,2,5
55413,3,3,194029,194029,194032,0,3,1
55414,6,3,194035,194035,194038,0,3,3
55415,2,2,194037,194038,194040,1,3,0
55416,4,1,194041,194041,194042,0,1,1
55417,6,3,194047,194047,194050,0,3,5
55418,3,3,194050,194050,194053,0,3,0
55419,5,1,194055,194055,194056,0,1,2
55420,2,3,194057,194057,194060,0,3,1
55421,1,2,194058,194060,194062,2,4,0
55422,2,2,194060,194062,194064,2,4,0
55423,1,3,194061,194064,194067,3,6,0
55424,2,3,194063,194067,194070,4,7,0
55425,6,1,194069,194070,194071,1,2,0
55426,1,2,194070,194071,194073,1,3,0
55427,5,3,194075,194075,194078,0,3,2
55428,1,2,194076,194078,194080,2,4,0
55429,2,3,194078,194080,194083,2,5,0
55430,6,2,194084,194084,194086,0,2,1
55431,1,3,194085,194086,194089,1,4,0
55432,4,1,194089,194089,194090,0,1,0
55433,3,2,194092,194092,194094,0,2,2
55434,6,2,194098,194098,194100,0,2,4
55435,6,2,194104,194104,194106,0,2,4
55436,3,2,194107,194107,194109,0,2,1
55437,5,1,194112,194112,194113,0,1,3
55438,5,2,194117,194117,194119,0,2,4
55439,5,3,194122,194122,194125,0,3,3
55440,6,2,194128,194128,194130,0,2,3
55441,3,2,194131,194131,194133,0,2,1
55442,4,2,194135,194135,194137,0,2,2
55443,2,2,194137,194137,194139,0,2,0
55444,4,2,194141,194141,194143,0,2,2
55445,3,3,194144,194144,194147,0,3,1
55446,2,3,194146,194147,194150,1,4,0
55447,6,1,194152,194152,194153,0,1,2
55448,3,1,194155,194155,194156,0,1,2
55449,6,1,194161,194161,194162,0,1,5
55450,1,1,194162,194162,194163,0,1,0
55451,4,1,194166,194166,194167,0,1,3
55452,5,2,194171,194171,194173,0,2,4
55453,1,1,194172,194173,194174,1,2,0
55454,6,2,194178,194178,194180,0,2,4
55455,5,2,194183,194183,194185,0,2,3
55456,3,2,194186,194186,194188,0,2,1
55457,1,1,194187,194188,194189,1,2,0
55458,4,3,194191,194191,194194,0,3,2
55459,1,1,194192,194194,194195,2,3,0
55460,1,2,194193,194195,194197,2,4,0
55461,4,2,194197,194197,194199,0,2,0
55462,4,2,194201,194201,194203,0,2,2
55463,2,3,194203,194203,194206,0,3,0
55464,4,1,194207,194207,194208,0,1,1
55465,5,2,194212,194212,194214,0,2,4
55466,1,2,194213,194214,194216,1,3,0
55467,3,1,194216,194216,194217,0,1,0
55468,3,3,194219,194219,194222,0,3,2
55469,2,1,194221,194222,194223,1,2,0
55470,4,1,194225,194225,194226,0,1,2
55471,4,1,194229,194229,194230,0,1,3
55472,5,1,194234,194234,194235,0,1,4
55473,4,2,194238,194238,194240,0,2,3
55474,2,1,194240,194240,194241,0,1,0
55475,6,1,194246,194246,194247,0,1,5
55476,1,1,194247,194247,194248,0,1,0
55477,6,3,194253,194253,194256,0,3,5
55478,6,1,194259,194259,194260,0,1,3
55479,2,1,194261,194261,194262,0,1,1
55480,5,3,194266,194266,194269,0,3,4
55481,5,3,194271,194271,194274,0,3,2
55482,6,3,194277,194277,194280,0,3,3
55483,2,3,194279,194280,194283,1,4,0
55484,5,1,194284,194284,194285,0,1,1
55485,4,3,194288,194288,194291,0,3,3
55486,1,2,194289,194291,194293,2,4,0
55487,5,1,194294,194294,194295,0,1,1
55488,3,1,194297,194297,194298,0,1,2
55489,5,1,194302,194302,194303,0,1,4
55490,5,3,194307,194307,194310,0,3,4
55491,6,3,194313,194313,194316,0,3,3
55492,3,2,194316,194316,194318,0,2,0
55493,3,3,194319,194319,194322,0,3,1
55494,3,3,194322,194322,194325,0,3,0
55495,3,2,194325,194325,194327,0,2,0
55496,2,3,194327,194327,194330,0,3,0
55497,2,1,194329,194330,194331,1,2,0
55498,6,2,194335,194335,194337,0,2,4
55499,3,3,194338,194338,194341,0,3,1
55500,3,2,194341,194341,194343,0,2,0
55501,1,2,194342,194343,194345,1,3,0
55502,4,2,194346,194346,194348,0,2,1
55503,4,1,194350,194350,194351,0,1,2
55504,2,1,194352,194352,194353,0,1,1
55505,6,1,194358,194358,194359,0,1,5
55506,1,1,194359,194359,194360,0,1,0
55507,1,2,194360,194360,194362,0,2,0
55508,2,3,194362,194362,194365,0,3,0
55509,2,2,194364,194365,194367,1,3,0
55510,2,2,194366,194367,194369,1,3,0
55511,1,3,194367,194369,194372,2,5,0
55512,4,2,194371,194372,194374,1,3,0
55513,2,2,194373,194374,194376,1,3,0
55514,2,1,194375,194376,194377,1,2,0
55515,5,2,194380,194380,194382,0,2,3
55516,4,3,194384,194384,194387,0,3,2
55517,2,2,194386,194387,194389,1,3,0
55518,4,3,194390,194390,194393,0,3,1
55519,1,3,194391,194393,194396,2,5,0
55520,3,3,194394,194396,194399,2,5,0
55521,6,1,194400,194400,194401,0,1,1
55522,2,2,194402,194402,194404,0,2,1
55523,1,1,194403,194404,194405,1,2,0
55524,1,1,194404,194405,194406,1,2,0
55525,6,1,194410,194410,194411,0,1,4
55526,1,2,194411,194411,194413,0,2,0
55527,1,1,194412,194413,194414,1,2,0
55528,1,2,194413,194414,194416,1,3,0
55529,5,1,194418,194418,194419,0,1,2
55530,5,2,194423,194423,194425,0,2,4
55531,3,3,194426,194426,194429,0,3,1
55532,5,3,194431,194431,194434,0,3,2
55533,1,3,194432,194434,194437,2,5,0
55534,4,1,194436,194437,194438,1,2,0
55535,2,2,194438,194438,194440,0,2,0
55536,3,3,194441,194441,194444,0,3,1
55537,4,1,194445,194445,194446,0,1,1
55538,2,2,194447,194447,194449,0,2,1
55539,1,3,194448,194449,194452,1,4,0
55540,1,1,194449,194452,194453,3,4,0
55541,5,1,194454,194454,194455,0,1,1
55542,6,1,194460,194460,194461,0,1,5
55543,5,2,194465,194465,194467,0,2,4
55544,5,2,194470,194470,194472,0,2,3
55545,2,3,194472,194472,194475,0,3,0
55546,1,1,194473,194475,194476,2,3,0
55547,1,3,194474,194476,194479,2,5,0
55548,2,2,194476,194479,194481,3,5,0
55549,2,1,194478,194481,194482,3,4,0
55550,3,1,194481,194482,194483,1,2,0
55551,5,1,194486,194486,194487,0,1,3
55552,6,2,194492,194492,194494,0,2,5
55553,2,1,194494,194494,194495,0,1,0
55554,5,3,194499,194499,194502,0,3,4
55555,1,2,194500,194502,194504,2,4,0
55556,2,3,194502,194504,194507,2,5,0
55557,6,2,194508,194508,194510,0,2,1
55558,5,3,194513,194513,194516,0,3,3
55559,1,1,194514,194516,194517,2,3,0
55560,1,3,194515,194517,194520,2,5,0
55561,2,1,194517,194520,194521,3,4,0
55562,5,3,194522,194522,194525,0,3,1
55563,4,3,194526,194526,194529,0,3,1
55564,1,2,194527,194529,194531,2,4,0
55565,4,2,194531,194531,194533,0,2,0
55566,1,3,194532,194533,194536,1,4,0
55567,6,1,194538,194538,194539,0,1,2
55568,2,3,194540,194540,194543,0,3,1
55569,2,2,194542,194543,194545,1,3,0
55570,4,1,194546,194546,194547,0,1,1
55571,2,3,194548,194548,194551,0,3,1
55572,1,1,194549,194551,194552,2,3,0
55573,4,2,194553,194553,194555,0,2,1
55574,2,2,194555,194555,194557,0,2,0
55575,6,3,194561,194561,194564,0,3,4
55576,5,3,194566,194566,194569,0,3,2
55577,1,1,194567,194569,194570,2,3,0
55578,4,3,194571,194571,194574,0,3,1
55579,5,2,194576,194576,194578,0,2,2
55580,2,1,194578,194578,194579,0,1,0
55581,1,2,194579,194579,194581,0,2,0
55582,1,1,194580,194581,194582,1,2,0
55583,6,1,194586,194586,194587,0,1,4
55584,3,1,194589,194589,194590,0,1,2
55585,2,2,194591,194591,194593,0,2,1
55586,1,1,194592,194593,194594,1,2,0
55587,5,1,194597,194597,194598,0,1,3
55588,4,1,194601,194601,194602,0,1,3
55589,3,2,194604,194604,194606,0,2,2
55590,1,2,194605,194606,194608,1,3,0
55591,1,2,194606,194608,194610,2,4,0
55592,2,2,194608,194610,194612,2,4,0
55593,1,3,194609,194612,194615,3,6,0
55594,5,2,194614,194615,194617,1,3,0
55595,6,1,194620,194620,194621,0,1,3
55596,2,3,194622,194622,194625,0,3,1
55597,2,3,194624,194625,194628,1,4,0
55598,4,1,194628,194628,194629,0,1,0
55599,3,1,194631,194631,194632,0,1,2
55600,1,3,194632,194632,194635,0,3,0
55601,2,2,194634,194635,194637,1,3,0
55602,5,2,194639,194639,194641,0,2,2
55603,3,3,194642,194642,194645,0,3,1
55604,1,2,194643,194645,194647,2,4,0
55605,3,3,194646,194647,194650,1,4,0
55606,4,1,194650,194650,194651,0,1,0
55607,1,3,194651,194651,194654,0,3,0
55608,1,3,194652,194654,194657,2,5,0
55609,4,3,194656,194657,194660,1,4,0
55610,3,1,194659,194660,194661,1,2,0
55611,6,2,194665,194665,194667,0,2,4
55612,6,3,194671,194671,194674,0,3,4
55613,2,2,194673,194674,194676,1,3,0
55614,1,2,194674,194676,194678,2,4,0
55615,6,2,194680,194680,194682,0,2,2
55616,4,1,194684,194684,194685,0,1,2
55617,3,2,194687,194687,194689,0,2,2
55618,3,1,194690,194690,194691,0,1,1
55619,4,2,194694,194694,194696,0,2,3
55620,2,1,194696,194696,194697,0,1,0
55621,5,1,194701,194701,194702,0,1,4
55622,1,3,194702,194702,194705,0,3,0
55623,1,1,194703,194705,194706,2,3,0
55624,4,2,194707,194707,194709,0,2,1
55625,1,3,194708,194709,194712,1,4,0
55626,6,1,194714,194714,194715,0,1,2
55627,4,1,194718,194718,194719,0,1,3
55628,3,2,194721,194721,194723,0,2,2
55629,2,1,194723,194723,194724,0,1,0
55630,4,3,194727,194727,194730,0,3,3
55631,5,3,194732,194732,194735,0,3,2
55632,6,3,194738,194738,194741,0,3,3
55633,5,3,194743,194743,194746,0,3,2
55634,1,2,194744,194746,194748,2,4,0
55635,6,2,194750,194750,194752,0,2,2
55636,2,1,194752,194752,194753,0,1,0
55637,3,3,194755,194755,194758,0,3,2
55638,4,2,194759,194759,194761,0,2,1
55639,2,1,194761,194761,194762,0,1,0
55640,2,3,194763,194763,194766,0,3,1
55641,4,3,194767,194767,194770,0,3,1
55642,6,2,194773,194773,194775,0,2,3
55643,4,3,194777,194777,194780,0,3,2
55644,6,2,194783,194783,194785,0,2,3
55645,2,3,194785,194785,194788,0,3,0
55646,5,1,194790,194790,194791,0,1,2
55647,6,1,194796,194796,194797,0,1,5
55648,2,1,194798,194798,194799,0,1,1
55649,6,3,194804,194804,194807,0,3,5
55650,6,1,194810,194810,194811,0,1,3
55651,5,3,194815,194815,194818,0,3,4
55652,3,2,194818,194818,194820,0,2,0
55653,1,2,194819,194820,194822,1,3,0
55654,5,3,194824,194824,194827,0,3,2
55655,5,2,194829,194829,194831,0,2,2
55656,3,2,194832,194832,194834,0,2,1
55657,6,2,194838,194838,194840,0,2,4
55658,5,2,194843,194843,194845,0,2,3
55659,5,2,194848,194848,194850,0,2,3
55660,1,1,194849,194850,194851,1,2,0
55661,2,2,194851,194851,194853,0,2,0
55662,3,1,194854,194854,194855,0,1,1
55663,3,2,194857,194857,194859,0,2,2
55664,3,3,194860,194860,194863,0,3,1
55665,3,2,194863,194863,194865,0,2,0
55666,1,2,194864,194865,194867,1,3,0
55667,2,2,194866,194867,194869,1,3,0
55668,4,1,194870,194870,194871,0,1,1
55669,2,3,194872,194872,194875,0,3,1
55670,3,3,194875,194875,194878,0,3,0
55671,4,2,194879,194879,194881,0,2,1
55672,5,2,194884,194884,194886,0,2,3
55673,4,1,194888,194888,194889,0,1,2
55674,2,1,194890,194890,194891,0,1,1
55675,6,1,194896,194896,194897,0,1,5
55676,4,1,194900,194900,194901,0,1,3
55677,4,1,194904,194904,194905,0,1,3
55678,2,1,194906,194906,194907,0,1,1
55679,3,1,194909,194909,194910,0,1,2
55680,2,2,194911,194911,194913,0,2,1
55681,2,3,194913,194913,194916,0,3,0
55682,4,3,194917,194917,194920,0,3,1
55683,1,2,194918,194920,194922,2,4,0
55684,5,3,194923,194923,194926,0,3,1
55685,1,2,194924,194926,194928,2,4,0
55686,3,3,194927,194928,194931,1,4,0
55687,1,2,194928,194931,194933,3,5,0
55688,4,3,194932,194933,194936,1,4,0
55689,1,1,194933,194936,194937,3,4,0
55690,4,3,194937,194937,194940,0,3,0
55691,5,1,194942,194942,194943,0,1,2
55692,6,1,194948,194948,194949,0,1,5
55693,5,2,194953,194953,194955,0,2,4
55694,4,2,194957,194957,194959,0,2,2
55695,3,2,194960,194960,194962,0,2,1
55696,5,1,194965,194965,194966,0,1,3
55697,6,3,194971,194971,194974,0,3,5
55698,4,3,194975,194975,194978,0,3,1
55699,4,2,194979,194979,194981,0,2,1
55700,5,1,194984,194984,194985,0,1,3
55701,6,2,194990,194990,194992,0,2,5
55702,2,3,194992,194992,194995,0,3,0
55703,5,2,194997,194997,194999,0,2,2
55704,5,2,195002,195002,195004,0,2,3
55705,1,3,195003,195004,195007,1,4,0
55706,2,2,195005,195007,195009,2,4,0
55707,5,1,195010,195010,195011,0,1,1
55708,6,3,195016,195016,195019,0,3,5
55709,1,2,195017,195019,195021,2,4,0
55710,4,3,195021,195021,195024,0,3,0
55711,3,3,195024,195024,195027,0,3,0
55712,4,2,195028,195028,195030,0,2,1
55713,3,2,195031,195031,195033,0,2,1
55714,3,3,195034,195034,195037,0,3,1
55715,4,3,195038,195038,195041,0,3,1
55716,5,3,195043,195043,195046,0,3,2
55717,4,3,195047,195047,195050,0,3,1
55718,4,2,195051,195051,195053,0,2,1
55719,3,1,195054,195054,195055,0,1,1
55720,6,1,195060,195060,195061,0,1,5
55721,4,3,195064,195064,195067,0,3,3
55722,2,1,195066,195067,195068,1,2,0
55723,3,2,195069,195069,195071,0,2,1
55724,2,3,195071,195071,195074,0,3,0
55725,2,3,195073,195074,195077,1,4,0
55726,6,1,195079,195079,195080,0,1,2
55727,5,3,195084,195084,195087,0,3,4
55728,2,1,195086,195087,195088,1,2,0
55729,3,3,195089,195089,195092,0,3,1
55730,6,3,195095,195095,195098,0,3,3
55731,4,1,195099,195099,195100,0,1,1
55732,6,2,195105,195105,195107,0,2,5
55733,5,1,195110,195110,195111,0,1,3
55734,3,2,195113,195113,195115,0,2,2
55735,6,2,195119,195119,195121,0,2,4
55736,2,2,195121,195121,195123,0,2,0
55737,1,3,195122,195123,195126,1,4,0
55738,1,3,195123,195126,195129,3,6,0
55739,1,3,195124,195129,195132,5,8,0
55740,1,2,195125,195132,195134,7,9,0
55741,1,1,195126,195134,195135,8,9,0
55742,1,2,195127,195135,195137,8,10,0
55743,2,2,195129,195137,195139,8,10,0
55744,3,3,195132,195139,195142,7,10,0
55745,3,1,195135,195142,195143,7,8,0
55746,5,1,195140,195143,195144,3,4,0
55747,3,2,195143,195144,195146,1,3,0
55748,5,1,195148,195148,195149,0,1,2
55749,1,2,195149,195149,195151,0,2,0
55750,1,1,195150,195151,195152,1,2,0
55751,6,2,195156,195156,195158,0,2,4
55752,3,3,195159,195159,195162,0,3,1
55753,6,3,195165,195165,195168,0,3,3
55754,5,2,195170,195170,195172,0,2,2
55755,6,2,195176,195176,195178,0,2,4
55756,5,3,195181,195181,195184,0,3,3
55757,5,3,195186,195186,195189,0,3,2
55758,4,1,195190,195190,195191,0,1,1
55759,5,2,195195,195195,195197,0,2,4
55760,3,3,195198,195198,195201,0,3,1
55761,5,2,195203,195203,195205,0,2,2
55762,5,1,195208,195208,195209,0,1,3
55763,5,1,195213,195213,195214,0,1,4
55764,2,1,195215,195215,195216,0,1,1
55765,2,3,195217,195217,195220,0,3,1
55766,4,2,195221,195221,195223,0,2,1
55767,3,1,195224,195224,195225,0,1,1
55768,4,1,195228,195228,195229,0,1,3
55769,2,3,195230,195230,195233,0,3,1
55770,3,1,195233,195233,195234,0,1,0
55771,2,3,195235,195235,195238,0,3,1
55772,2,2,195237,195238,195240,1,3,0
55773,2,1,195239,195240,195241,1,2,0
55774,2,1,195241,195241,195242,0,1,0
55775,6,1,195247,195247,195248,0,1,5
55776,1,1,195248,195248,195249,0,1,0
55777,2,2,195250,195250,195252,0,2,1
55778,2,1,195252,195252,195253,0,1,0
55779,3,2,195255,195255,195257,0,2,2
55780,6,3,195261,195261,195264,0,3,4
55781,5,1,195266,195266,195267,0,1,2
55782,5,3,195271,195271,195274,0,3,4
55783,5,3,195276,195276,195279,0,3,2
55784,1,3,195277,195279,195282,2,5,0
55785,6,2,195283,195283,195285,0,2,1
55786,6,1,195289,195289,195290,0,1,4
55787,4,3,195293,195293,195296,0,3,3
55788,2,3,195295,195296,195299,1,4,0
55789,4,1,195299,195299,195300,0,1,0
55790,5,1,195304,195304,195305,0,1,4
55791,4,3,195308,195308,195311,0,3,3
55792,5,3,195313,195313,195316,0,3,2
55793,5,2,195318,195318,195320,0,2,2
55794,1,2,195319,195320,195322,1,3,0
55795,3,2,195322,195322,195324,0,2,0
55796,4,1,195326,195326,195327,0,1,2
55797,6,2,195332,195332,195334,0,2,5
55798,1,1,195333,195334,195335,1,2,0
55799,5,1,195338,195338,195339,0,1,3
55800,5,1,195343,195343,195344,0,1,4
55801,5,2,195348,195348,195350,0,2,4
55802,2,2,195350,195350,195352,0,2,0
55803,6,3,195356,195356,195359,0,3,4
55804,6,1,195362,195362,195363,0,1,3
55805,6,2,195368,195368,195370,0,2,5
55806,2,3,195370,195370,195373,0,3,0
55807,2,2,195372,195373,195375,1,3,0
55808,3,2,195375,195375,195377,0,2,0
55809,1,3,195376,195377,195380,1,4,0
55810,4,2,195380,195380,195382,0,2,0
55811,4,3,195384,195384,195387,0,3,2
55812,5,2,195389,195389,195391,0,2,2
55813,3,3,195392,195392,195395,0,3,1
55814,3,1,195395,195395,195396,0,1,0
55815,3,3,195398,195398,195401,0,3,2
55816,6,3,195404,195404,195407,0,3,3
55817,3,1,195407,195407,195408,0,1,0
55818,6,3,195413,195413,195416,0,3,5
55819,5,2,195418,195418,195420,0,2,2
55820,4,1,195422,195422,195423,0,1,2
55821,5,2,195427,195427,195429,0,2,4
55822,3,1,195430,195430,195431,0,1,1
55823,1,2,195431,195431,195433,0,2,0
55824,1,3,195432,195433,195436,1,4,0
55825,3,2,195435,195436,195438,1,3,0
55826,4,2,195439,195439,195441,0,2,1
55827,1,2,195440,195441,195443,1,3,0
55828,6,1,195446,195446,195447,0,1,3
55829,5,3,195451,195451,195454,0,3,4
55830,6,3,195457,195457,195460,0,3,3
55831,3,3,195460,195460,195463,0,3,0
55832,3,2,195463,195463,195465,0,2,0
55833,5,3,195468,195468,195471,0,3,3
55834,3,3,195471,195471,195474,0,3,0
55835,2,3,195473,195474,195477,1,4,0
55836,5,2,195478,195478,195480,0,2,1
55837,6,2,195484,195484,195486,0,2,4
55838,2,1,195486,195486,195487,0,1,0
55839,3,3,195489,195489,195492,0,3,2
55840,4,3,195493,195493,195496,0,3,1
55841,5,1,195498,195498,195499,0,1,2
55842,4,2,195502,195502,195504,0,2,3
55843,2,3,195504,195504,195507,0,3,0
55844,5,2,195509,195509,195511,0,2,2
55845,3,3,195512,195512,195515,0,3,1
55846,4,2,195516,195516,195518,0,2,1
55847,4,3,195520,195520,195523,0,3,2
55848,3,3,195523,195523,195526,0,3,0
55849,4,1,195527,195527,195528,0,1,1
55850,2,2,195529,195529,195531,0,2,1
55851,5,2,195534,195534,195536,0,2,3
55852,6,3,195540,195540,195543,0,3,4
55853,2,1,195542,195543,195544,1,2,0
55854,3,1,195545,195545,195546,0,1,1
55855,3,3,195548,195548,195551,0,3,2
55856,4,2,195552,195552,195554,0,2,1
55857,4,2,195556,195556,195558,0,2,2
55858,2,3,195558,195558,195561,0,3,0
55859,2,2,195560,195561,195563,1,3,0
55860,1,3,195561,195563,195566,2,5,0
55861,3,3,195564,195566,195569,2,5,0
55862,2,2,195566,195569,195571,3,5,0
55863,5,3,195571,195571,195574,0,3,0
55864,5,2,195576,195576,195578,0,2,2
55865,1,3,195577,195578,195581,1,4,0
55866,1,1,195578,195581,195582,3,4,0
55867,3,1,195581,195582,195583,1,2,0
55868,4,3,195585,195585,195588,0,3,2
55869,5,2,195590,195590,195592,0,2,2
55870,2,1,195592,195592,195593,0,1,0
55871,6,2,195598,195598,195600,0,2,5
55872,5,2,195603,195603,195605,0,2,3
55873,6,1,195609,195609,195610,0,1,4
55874,2,2,195611,195611,195613,0,2,1
55875,4,3,195615,195615,195618,0,3,2
55876,5,3,195620,195620,195623,0,3,2
55877,3,2,195623,195623,195625,0,2,0
55878,2,1,195625,195625,195626,0,1,0
55879,1,1,195626,195626,195627,0,1,0
55880,5,2,195631,195631,195633,0,2,4
55881,6,3,195637,195637,195640,0,3,4
55882,6,2,195643,195643,195645,0,2,3
55883,3,3,195646,195646,195649,0,3,1
55884,3,2,195649,195649,195651,0,2,0
55885,1,3,195650,195651,195654,1,4,0
55886,2,3,195652,195654,195657,2,5,0
55887,4,1,195656,195657,195658,1,2,0
55888,2,3,195658,195658,195661,0,3,0
55889,1,2,195659,195661,195663,2,4,0
55890,3,3,195662,195663,195666,1,4,0
55891,1,2,195663,195666,195668,3,5,0
55892,4,3,195667,195668,195671,1,4,0
55893,2,1,195669,195671,195672,2,3,0
55894,3,1,195672,195672,195673,0,1,0
55895,3,2,195675,195675,195677,0,2,2
55896,3,2,195678,195678,195680,0,2,1
55897,3,2,195681,195681,195683,0,2,1
55898,2,3,195683,195683,195686,0,3,0
55899,5,2,195688,195688,195690,0,2,2
55900,2,1,195690,195690,195691,0,1,0
55901,1,1,195691,195691,195692,0,1,0
55902,2,2,195693,195693,195695,0,2,1
55903,5,3,195698,195698,195701,0,3,3
55904,3,3,195701,195701,195704,0,3,0
55905,1,2,195702,195704,195706,2,4,0
55906,3,2,195705,195706,195708,1,3,0
55907,4,1,195709,195709,195710,0,1,1
55908,1,1,195710,195710,195711,0,1,0
55909,6,2,195716,195716,195718,0,2,5
55910,5,3,195721,195721,195724,0,3,3
55911,2,1,195723,195724,195725,1,2,0
55912,5,3,195728,195728,195731,0,3,3
55913,3,3,195731,195731,195734,0,3,0
55914,3,3,195734,195734,195737,0,3,0
55915,2,1,195736,195737,195738,1,2,0
55916,3,1,195739,195739,195740,0,1,1
55917,5,2,195744,195744,195746,0,2,4
55918,1,2,195745,195746,195748,1,3,0
55919,1,2,195746,195748,195750,2,4,0
55920,2,3,195748,195750,195753,2,5,0
55921,5,1,195753,195753,195754,0,1,0
55922,3,2,195756,195756,195758,0,2,2
55923,2,1,195758,195758,195759,0,1,0
55924,1,2,195759,195759,195761,0,2,0
55925,6,1,195765,195765,195766,0,1,4
55926,5,1,195770,195770,195771,0,1,4
55927,4,3,195774,195774,195777,0,3,3
55928,6,1,195780,195780,195781,0,1,3
55929,3,3,195783,195783,195786,0,3,2
55930,2,2,195785,195786,195788,1,3,0
55931,3,1,195788,195788,195789,0,1,0
55932,5,2,195793,195793,195795,0,2,4
55933,3,2,195796,195796,195798,0,2,1
55934,2,2,195798,195798,195800,0,2,0
55935,3,2,195801,195801,195803,0,2,1
55936,4,2,195805,195805,195807,0,2,2
55937,5,1,195810,195810,195811,0,1,3
55938,1,3,195811,195811,195814,0,3,0
55939,3,3,195814,195814,195817,0,3,0
55940,5,2,195819,195819,195821,0,2,2
55941,4,2,195823,195823,195825,0,2,2
55942,3,2,195826,195826,195828,0,2,1
55943,6,1,195832,195832,195833,0,1,4
55944,2,1,195834,195834,195835,0,1,1
55945,5,3,195839,195839,195842,0,3,4
55946,1,2,195840,195842,195844,2,4,0
55947,6,2,195846,195846,195848,0,2,2
55948,1,3,195847,195848,195851,1,4,0
55949,5,1,195852,195852,195853,0,1,1
55950,1,3,195853,195853,195856,0,3,0
55951,3,1,195856,195856,195857,0,1,0
55952,4,3,195860,195860,195863,0,3,3
55953,4,2,195864,195864,195866,0,2,1
55954,5,1,195869,195869,195870,0,1,3
55955,1,1,195870,195870,195871,0,1,0
55956,3,1,195873,195873,195874,0,1,2
55957,1,1,195874,195874,195875,0,1,0
55958,2,2,195876,195876,195878,0,2,1
55959,1,1,195877,195878,195879,1,2,0
55960,1,1,195878,195879,195880,1,2,0
55961,6,2,195884,195884,195886,0,2,4
55962,4,1,195888,195888,195889,0,1,2
55963,1,3,195889,195889,195892,0,3,0
55964,4,3,195893,195893,195896,0,3,1
55965,6,1,195899,195899,195900,0,1,3
55966,3,3,195902,195902,195905,0,3,2
55967,3,3,195905,195905,195908,0,3,0
55968,6,2,195911,195911,195913,0,2,3
55969,2,3,195913,195913,195916,0,3,0
55970,2,3,195915,195916,195919,1,4,0
55971,1,1,195916,195919,195920,3,4,0
55972,2,1,195918,195920,195921,2,3,0
55973,5,3,195923,195923,195926,0,3,2
55974,6,3,195929,195929,195932,0,3,3
55975,5,3,195934,195934,195937,0,3,2
55976,3,2,195937,195937,195939,0,2,0
55977,5,2,195942,195942,195944,0,2,3
55978,2,3,195944,195944,195947,0,3,0
55979,2,3,195946,195947,195950,1,4,0
55980,1,1,195947,195950,195951,3,4,0
55981,1,1,195948,195951,195952,3,4,0
55982,1,2,195949,195952,195954,3,5,0
55983,5,3,195954,195954,195957,0,3,0
55984,3,3,195957,195957,195960,0,3,0
55985,6,2,195963,195963,195965,0,2,3
55986,2,2,195965,195965,195967,0,2,0
55987,3,3,195968,195968,195971,0,3,1
55988,3,3,195971,195971,195974,0,3,0
55989,1,3,195972,195974,195977,2,5,0
55990,6,1,195978,195978,195979,0,1,1
55991,3,2,195981,195981,195983,0,2,2
55992,3,2,195984,195984,195986,0,2,1
55993,1,2,195985,195986,195988,1,3,0
55994,4,3,195989,195989,195992,0,3,1
55995,4,1,195993,195993,195994,0,1,1
55996,4,3,195997,195997,196000,0,3,3
55997,6,3,196003,196003,196006,0,3,3
55998,1,3,196004,196006,196009,2,5,0
55999,1,2,196005,196009,196011,4,6,0
56000,3,3,196008,196011,196014,3,6,0
56001,1,3,196009,196014,196017,5,8,0
56002,5,1,196014,196017,196018,3,4,0
56003,2,1,196016,196018,196019,2,3,0
56004,6,3,196022,196022,196025,0,3,3
56005,1,3,196023,196025,196028,2,5,0
56006,3,2,196026,196028,196030,2,4,0
56007,6,2,196032,196032,196034,0,2,2
56008,5,3,196037,196037,196040,0,3,3
56009,5,1,196042,196042,196043,0,1,2
56010,5,1,196047,196047,196048,0,1,4
56011,1,2,196048,196048,196050,0,2,0
56012,2,1,196050,196050,196051,0,1,0
56013,2,1,196052,196052,196053,0,1,1
56014,5,3,196057,196057,196060,0,3,4
56015,1,3,196058,196060,196063,2,5,0
56016,3,1,196061,196063,196064,2,3,0
56017,6,2,196067,196067,196069,0,2,3
56018,1,2,196068,196069,196071,1,3,0
56019,5,2,196073,196073,196075,0,2,2
56020,2,1,196075,196075,196076,0,1,0
56021,5,2,196080,196080,196082,0,2,4
56022,4,2,196084,196084,196086,0,2,2
56023,1,3,196085,196086,196089,1,4,0
56024,4,2,196089,196089,196091,0,2,0
56025,1,2,196090,196091,196093,1,3,0
56026,4,1,196094,196094,196095,0,1,1
56027,5,2,196099,196099,196101,0,2,4
56028,5,2,196104,196104,196106,0,2,3
56029,6,2,196110,196110,196112,0,2,4
56030,5,1,196115,196115,196116,0,1,3
56031,3,1,196118,196118,196119,0,1,2
56032,4,1,196122,196122,196123,0,1,3
56033,6,1,196128,196128,196129,0,1,5
56034,5,3,196133,196133,196136,0,3,4
56035,4,1,196137,196137,196138,0,1,1
56036,2,1,196139,196139,196140,0,1,1
56037,5,1,196144,196144,196145,0,1,4
56038,1,3,196145,196145,196148,0,3,0
56039,4,2,196149,196149,196151,0,2,1
56040,5,2,196154,196154,196156,0,2,3
56041,2,3,196156,196156,196159,0,3,0
56042,3,3,196159,196159,196162,0,3,0
56043,6,3,196165,196165,196168,0,3,3
56044,3,1,196168,196168,196169,0,1,0
56045,3,3,196171,196171,196174,0,3,2
56046,5,2,196176,196176,196178,0,2,2
56047,2,3,196178,196178,196181,0,3,0
56048,1,3,196179,196181,196184,2,5,0
56049,6,2,196185,196185,196187,0,2,1
56050,5,1,196190,196190,196191,0,1,3
56051,5,3,196195,196195,196198,0,3,4
56052,2,2,196197,196198,196200,1,3,0
56053,2,1,196199,196200,196201,1,2,0
56054,4,1,196203,196203,196204,0,1,2
56055,2,1,196205,196205,196206,0,1,1
56056,1,2,196206,196206,196208,0,2,0
56057,2,2,196208,196208,196210,0,2,0
56058,4,1,196212,196212,196213,0,1,2
56059,3,3,196215,196215,196218,0,3,2
56060,2,2,196217,196218,196220,1,3,0
56061,1,2,196218,196220,196222,2,4,0
56062,2,3,196220,196222,196225,2,5,0
56063,5,2,196225,196225,196227,0,2,0
56064,3,3,196228,196228,196231,0,3,1
56065,6,1,196234,196234,196235,0,1,3
56066,1,2,196235,196235,196237,0,2,0
56067,1,2,196236,196237,196239,1,3,0
56068,3,2,196239,196239,196241,0,2,0
56069,2,3,196241,196241,196244,0,3,0
56070,5,3,196246,196246,196249,0,3,2
56071,5,3,196251,196251,196254,0,3,2
56072,2,2,196253,196254,196256,1,3,0
56073,6,3,196259,196259,196262,0,3,3
56074,3,2,196262,196262,196264,0,2,0
56075,4,1,196266,196266,196267,0,1,2
56076,3,1,196269,196269,196270,0,1,2
56077,3,1,196272,196272,196273,0,1,2
56078,4,3,196276,196276,196279,0,3,3
56079,4,1,196280,196280,196281,0,1,1
56080,5,2,196285,196285,196287,0,2,4
56081,2,1,196287,196287,196288,0,1,0
56082,2,2,196289,196289,196291,0,2,1
56083,1,2,196290,196291,196293,1,3,0
56084,5,3,196295,196295,196298,0,3,2
56085,4,2,196299,196299,196301,0,2,1
56086,2,1,196301,196301,196302,0,1,0
56087,2,3,196303,196303,196306,0,3,1
56088,6,1,196309,196309,196310,0,1,3
56089,5,3,196314,196314,196317,0,3,4
56090,1,3,196315,196317,196320,2,5,0
56091,4,3,196319,196320,196323,1,4,0
56092,3,2,196322,196323,196325,1,3,0
56093,5,3,196327,196327,196330,0,3,2
56094,5,3,196332,196332,196335,0,3,2
56095,5,1,196337,196337,196338,0,1,2
56096,1,3,196338,196338,196341,0,3,0
56097,5,1,196343,196343,196344,0,1,2
56098,1,3,196344,196344,196347,0,3,0
56099,1,2,196345,196347,196349,2,4,0
56100,6,3,196351,196351,196354,0,3,2
56101,6,3,196357,196357,196360,0,3,3
56102,4,3,196361,196361,196364,0,3,1
56103,2,2,196363,196364,196366,1,3,0
56104,5,2,196368,196368,196370,0,2,2
56105,5,3,196373,196373,196376,0,3,3
56106,2,2,196375,196376,196378,1,3,0
56107,4,3,196379,196379,196382,0,3,1
56108,6,3,196385,196385,196388,0,3,3
56109,6,1,196391,196391,196392,0,1,3
56110,6,2,196397,196397,196399,0,2,5
56111,3,1,196400,196400,196401,0,1,1
56112,2,3,196402,196402,196405,0,3,1
56113,6,2,196408,196408,196410,0,2,3
56114,1,3,196409,196410,196413,1,4,0
56115,4,1,196413,196413,196414,0,1,0
56116,1,2,196414,196414,196416,0,2,0
56117,3,3,196417,196417,196420,0,3,1
56118,2,2,196419,196420,196422,1,3,0
56119,6,2,196425,196425,196427,0,2,3
56120,3,1,196428,196428,196429,0,1,1
56121,2,1,196430,196430,196431,0,1,1
56122,1,3,196431,196431,196434,0,3,0
56123,3,1,196434,196434,196435,0,1,0
56124,5,1,196439,196439,196440,0,1,4
56125,1,2,196440,196440,196442,0,2,0
56126,2,2,196442,196442,196444,0,2,0
56127,2,3,196444,196444,196447,0,3,0
56128,1,1,196445,196447,196448,2,3,0
56129,4,1,196449,196449,196450,0,1,1
56130,4,1,196453,196453,196454,0,1,3
56131,1,2,196454,196454,196456,0,2,0
56132,2,1,196456,196456,196457,0,1,0
56133,3,2,196459,196459,196461,0,2,2
56134,2,2,196461,196461,196463,0,2,0
56135,6,1,196467,196467,196468,0,1,4
56136,2,3,196469,196469,196472,0,3,1
56137,5,2,196474,196474,196476,0,2,2
56138,2,2,196476,196476,196478,0,2,0
56139,3,2,196479,196479,196481,0,2,1
56140,3,3,196482,196482,196485,0,3,1
56141,6,2,196488,196488,196490,0,2,3
56142,4,2,196492,196492,196494,0,2,2
56143,4,1,196496,196496,196497,0,1,2
56144,3,2,196499,196499,196501,0,2,2
56145,4,1,196503,196503,196504,0,1,2
56146,4,1,196507,196507,196508,0,1,3
56147,1,3,196508,196508,196511,0,3,0
56148,2,1,196510,196511,196512,1,2,0
56149,2,2,196512,196512,196514,0,2,0
56150,1,1,196513,196514,196515,1,2,0
56151,5,2,196518,196518,196520,0,2,3
56152,6,3,196524,196524,196527,0,3,4
56153,2,3,196526,196527,196530,1,4,0
56154,2,2,196528,196530,196532,2,4,0
56155,5,3,196533,196533,196536,0,3,1
56156,2,3,196535,196536,196539,1,4,0
56157,4,3,196539,196539,196542,0,3,0
56158,3,2,196542,196542,196544,0,2,0
56159,5,2,196547,196547,196549,0,2,3
56160,3,3,196550,196550,196553,0,3,1
56161,5,3,196555,196555,196558,0,3,2
56162,5,1,196560,196560,196561,0,1,2
56163,1,1,196561,196561,196562,0,1,0
56164,6,2,196567,196567,196569,0,2,5
56165,1,1,196568,196569,196570,1,2,0
56166,4,2,196572,196572,196574,0,2,2
56167,5,2,196577,196577,196579,0,2,3
56168,1,2,196578,196579,196581,1,3,0
56169,6,1,196584,196584,196585,0,1,3
56170,6,1,196590,196590,196591,0,1,5
56171,4,2,196594,196594,196596,0,2,3
56172,6,1,196600,196600,196601,0,1,4
56173,1,1,196601,196601,196602,0,1,0
56174,1,1,196602,196602,196603,0,1,0
56175,3,2,196605,196605,196607,0,2,2
56176,3,2,196608,196608,196610,0,2,1
56177,4,2,196612,196612,196614,0,2,2
56178,6,1,196618,196618,196619,0,1,4
56179,4,3,196622,196622,196625,0,3,3
56180,4,3,196626,196626,196629,0,3,1
56181,2,1,196628,196629,196630,1,2,0
56182,4,2,196632,196632,196634,0,2,2
56183,3,1,196635,196635,196636,0,1,1
56184,5,1,196640,196640,196641,0,1,4
56185,3,1,196643,196643,196644,0,1,2
56186,2,1,196645,196645,196646,0,1,1
56187,6,1,196651,196651,196652,0,1,5
56188,4,2,196655,196655,196657,0,2,3
56189,3,2,196658,196658,196660,0,2,1
56190,2,3,196660,196660,196663,0,3,0
56191,6,1,196666,196666,196667,0,1,3
56192,1,3,196667,196667,196670,0,3,0
56193,3,1,196670,196670,196671,0,1,0
56194,4,2,196674,196674,196676,0,2,3
56195,3,2,196677,196677,196679,0,2,1
56196,3,1,196680,196680,196681,0,1,1
56197,2,3,196682,196682,196685,0,3,1
56198,3,2,196685,196685,196687,0,2,0
56199,5,3,196690,196690,196693,0,3,3
56200,6,3,196696,196696,196699,0,3,3
56201,6,3,196702,196702,196705,0,3,3
56202,1,2,196703,196705,196707,2,4,0
56203,2,3,196705,196707,196710,2,5,0
56204,2,3,196707,196710,196713,3,6,0
56205,1,1,196708,196713,196714,5,6,0
56206,1,3,196709,196714,196717,5,8,0
56207,4,2,196713,196717,196719,4,6,0
56208,1,2,196714,196719,196721,5,7,0
56209,5,2,196719,196721,196723,2,4,0
56210,6,1,196725,196725,196726,0,1,2
56211,4,3,196729,196729,196732,0,3,3
56212,6,2,196735,196735,196737,0,2,3
56213,6,2,196741,196741,196743,0,2,4
56214,1,2,196742,196743,196745,1,3,0
56215,6,2,196748,196748,196750,0,2,3
56216,6,1,196754,196754,196755,0,1,4
56217,3,2,196757,196757,196759,0,2,2
56218,3,3,196760,196760,196763,0,3,1
56219,1,2,196761,196763,196765,2,4,0
56220,6,2,196767,196767,196769,0,2,2
56221,4,3,196771,196771,196774,0,3,2
56222,1,2,196772,196774,196776,2,4,0
56223,1,1,196773,196776,196777,3,4,0
56224,6,2,196779,196779,196781,0,2,2
56225,6,3,196785,196785,196788,0,3,4
56226,3,1,196788,196788,196789,0,1,0
56227,3,1,196791,196791,196792,0,1,2
56228,1,1,196792,196792,196793,0,1,0
56229,4,3,196796,196796,196799,0,3,3
56230,6,3,196802,196802,196805,0,3,3
56231,2,3,196804,196805,196808,1,4,0
56232,4,1,196808,196808,196809,0,1,0
56233,3,3,196811,196811,196814,0,3,2
56234,2,2,196813,196814,196816,1,3,0
56235,1,3,196814,196816,196819,2,5,0
56236,4,1,196818,196819,196820,1,2,0
56237,3,1,196821,196821,196822,0,1,1
56238,3,1,196824,196824,196825,0,1,2
56239,6,1,196830,196830,196831,0,1,5
56240,4,1,196834,196834,196835,0,1,3
56241,1,2,196835,196835,196837,0,2,0
56242,3,1,196838,196838,196839,0,1,1
56243,5,1,196843,196843,196844,0,1,4
56244,6,3,196849,196849,196852,0,3,5
56245,2,1,196851,196852,196853,1,2,0
56246,2,1,196853,196853,196854,0,1,0
56247,2,2,196855,196855,196857,0,2,1
56248,3,2,196858,196858,196860,0,2,1
56249,6,2,196864,196864,196866,0,2,4
56250,5,1,196869,196869,196870,0,1,3
56251,2,1,196871,196871,196872,0,1,1
56252,4,2,196875,196875,196877,0,2,3
56253,5,2,196880,196880,196882,0,2,3
56254,2,3,196882,196882,196885,0,3,0
56255,1,1,196883,196885,196886,2,3,0
56256,5,2,196888,196888,196890,0,2,2
56257,1,2,196889,196890,196892,1,3,0
56258,4,1,196893,196893,196894,0,1,1
56259,6,2,196899,196899,196901,0,2,5
56260,5,1,196904,196904,196905,0,1,3
56261,4,3,196908,196908,196911,0,3,3
56262,2,1,196910,196911,196912,1,2,0
56263,5,2,196915,196915,196917,0,2,3
56264,4,3,196919,196919,196922,0,3,2
56265,3,2,196922,196922,196924,0,2,0
56266,2,2,196924,196924,196926,0,2,0
56267,5,3,196929,196929,196932,0,3,3
56268,3,1,196932,196932,196933,0,1,0
56269,1,2,196933,196933,196935,0,2,0
56270,1,2,196934,196935,196937,1,3,0
56271,2,2,196936,196937,196939,1,3,0
56272,3,2,196939,196939,196941,0,2,0
56273,6,2,196945,196945,196947,0,2,4
56274,1,1,196946,196947,196948,1,2,0
56275,1,2,196947,196948,196950,1,3,0
56276,4,2,196951,196951,196953,0,2,1
56277,3,3,196954,196954,196957,0,3,1
56278,5,3,196959,196959,196962,0,3,2
56279,6,1,196965,196965,196966,0,1,3
56280,4,2,196969,196969,196971,0,2,3
56281,4,1,196973,196973,196974,0,1,2
56282,1,1,196974,196974,196975,0,1,0
56283,3,2,196977,196977,196979,0,2,2
56284,4,1,196981,196981,196982,0,1,2
56285,4,3,196985,196985,196988,0,3,3
56286,6,2,196991,196991,196993,0,2,3
56287,2,2,196993,196993,196995,0,2,0
56288,2,1,196995,196995,196996,0,1,0
56289,5,2,197000,197000,197002,0,2,4
56290,4,3,197004,197004,197007,0,3,2
56291,1,1,197005,197007,197008,2,3,0
56292,2,3,197007,197008,197011,1,4,0
56293,2,2,197009,197011,197013,2,4,0
56294,4,2,197013,197013,197015,0,2,0
56295,2,1,197015,197015,197016,0,1,0
56296,6,3,197021,197021,197024,0,3,5
56297,6,2,197027,197027,197029,0,2,3
56298,5,3,197032,197032,197035,0,3,3
56299,2,3,197034,197035,197038,1,4,0
56300,2,1,197036,197038,197039,2,3,0
56301,2,1,197038,197039,197040,1,2,0
56302,5,3,197043,197043,197046,0,3,3
56303,6,3,197049,197049,197052,0,3,3
56304,6,2,197055,197055,197057,0,2,3
56305,1,3,197056,197057,197060,1,4,0
56306,2,3,197058,197060,197063,2,5,0
56307,1,1,197059,197063,197064,4,5,0
56308,3,3,197062,197064,197067,2,5,0
56309,3,1,197065,197067,197068,2,3,0
56310,2,1,197067,197068,197069,1,2,0
56311,5,1,197072,197072,197073,0,1,3
56312,6,2,197078,197078,197080,0,2,5
56313,3,3,197081,197081,197084,0,3,1
56314,3,3,197084,197084,197087,0,3,0
56315,1,2,197085,197087,197089,2,4,0
56316,3,3,197088,197089,197092,1,4,0
56317,2,1,197090,197092,197093,2,3,0
56318,1,1,197091,197093,197094,2,3,0
56319,1,2,197092,197094,197096,2,4,0
56320,6,2,197098,197098,197100,0,2,2
56321,1,2,197099,197100,197102,1,3,0
56322,2,3,197101,197102,197105,1,4,0
56323,6,2,197107,197107,197109,0,2,2
56324,2,2,197109,197109,197111,0,2,0
56325,4,3,197113,197113,197116,0,3,2
56326,2,2,197115,197116,197118,1,3,0
56327,5,3,197120,197120,197123,0,3,2
56328,6,3,197126,197126,197129,0,3,3
56329,3,1,197129,197129,197130,0,1,0
56330,2,3,197131,197131,197134,0,3,1
56331,2,3,197133,197134,197137,1,4,0
56332,5,1,197138,197138,197139,0,1,1
56333,6,1,197144,197144,197145,0,1,5
56334,4,1,197148,197148,197149,0,1,3
56335,2,3,197150,197150,197153,0,3,1
56336,5,1,197155,197155,197156,0,1,2
56337,6,1,197161,197161,197162,0,1,5
56338,3,2,197164,197164,197166,0,2,2
56339,3,3,197167,197167,197170,0,3,1
56340,3,1,197170,197170,197171,0,1,0
56341,3,1,197173,197173,197174,0,1,2
56342,3,3,197176,197176,197179,0,3,2
56343,3,1,197179,197179,197180,0,1,0
56344,3,2,197182,197182,197184,0,2,2
56345,5,1,197187,197187,197188,0,1,3
56346,2,2,197189,197189,197191,0,2,1
56347,3,1,197192,197192,197193,0,1,1
56348,3,2,197195,197195,197197,0,2,2
56349,1,2,197196,197197,197199,1,3,0
56350,5,3,197201,197201,197204,0,3,2
56351,1,3,197202,197204,197207,2,5,0
56352,3,2,197205,197207,197209,2,4,0
56353,4,1,197209,197209,197210,0,1,0
56354,4,2,197213,197213,197215,0,2,3
56355,3,3,197216,197216,197219,0,3,1
56356,1,2,197217,197219,197221,2,4,0
56357,3,2,197220,197221,197223,1,3,0
56358,6,1,197226,197226,197227,0,1,3
56359,2,2,197228,197228,197230,0,2,1
56360,5,1,197233,197233,197234,0,1,3
56361,5,1,197238,197238,197239,0,1,4
56362,4,1,197242,197242,197243,0,1,3
56363,2,1,197244,197244,197245,0,1,1
56364,3,3,197247,197247,197250,0,3,2
56365,4,3,197251,197251,197254,0,3,1
56366,2,2,197253,197254,197256,1,3,0
56367,4,1,197257,197257,197258,0,1,1
56368,5,1,197262,197262,197263,0,1,4
56369,1,1,197263,197263,197264,0,1,0
56370,3,3,197266,197266,197269,0,3,2
56371,5,3,197271,197271,197274,0,3,2
56372,5,2,197276,197276,197278,0,2,2
56373,5,2,197281,197281,197283,0,2,3
56374,5,2,197286,197286,197288,0,2,3
56375,1,3,197287,197288,197291,1,4,0
56376,3,2,197290,197291,197293,1,3,0
56377,3,3,197293,197293,197296,0,3,0
56378,2,3,197295,197296,197299,1,4,0
56379,6,2,197301,197301,197303,0,2,2
56380,5,1,197306,197306,197307,0,1,3
56381,4,3,197310,197310,197313,0,3,3
56382,4,1,197314,197314,197315,0,1,1
56383,5,2,197319,197319,197321,0,2,4
56384,2,2,197321,197321,197323,0,2,0
56385,5,2,197326,197326,197328,0,2,3
56386,1,1,197327,197328,197329,1,2,0
56387,6,3,197333,197333,197336,0,3,4
56388,4,3,197337,197337,197340,0,3,1
56389,4,1,197341,197341,197342,0,1,1
56390,5,3,197346,197346,197349,0,3,4
56391,2,2,197348,197349,197351,1,3,0
56392,4,2,197352,197352,197354,0,2,1
56393,4,1,197356,197356,197357,0,1,2
56394,2,2,197358,197358,197360,0,2,1
56395,6,2,197364,197364,197366,0,2,4
56396,1,3,197365,197366,197369,1,4,0
56397,3,1,197368,197369,197370,1,2,0
56398,1,1,197369,197370,197371,1,2,0
56399,4,2,197373,197373,197375,0,2,2
56400,4,1,197377,197377,197378,0,1,2
56401,4,2,197381,197381,197383,0,2,3
56402,3,1,197384,197384,197385,0,1,1
56403,6,1,197390,197390,197391,0,1,5
56404,1,3,197391,197391,197394,0,3,0
56405,1,3,197392,197394,197397,2,5,0
56406,1,2,197393,197397,197399,4,6,0
56407,1,2,197394,197399,197401,5,7,0
56408,3,3,197397,197401,197404,4,7,0
56409,4,3,197401,197404,197407,3,6,0
56410,6,1,197407,197407,197408,0,1,0
56411,2,1,197409,197409,197410,0,1,1
56412,5,1,197414,197414,197415,0,1,4
56413,2,3,197416,197416,197419,0,3,1
56414,1,2,197417,197419,197421,2,4,0
56415,2,1,197419,197421,197422,2,3,0
56416,6,1,197425,197425,197426,0,1,3
56417,3,3,197428,197428,197431,0,3,2
56418,2,2,197430,197431,197433,1,3,0
56419,1,3,197431,197433,197436,2,5,0
56420,6,1,197437,197437,197438,0,1,1
56421,1,2,197438,197438,197440,0,2,0
56422,6,2,197444,197444,197446,0,2,4
56423,6,1,197450,197450,197451,0,1,4
56424,5,2,197455,197455,197457,0,2,4
56425,5,1,197460,197460,197461,0,1,3
56426,6,1,197466,197466,197467,0,1,5
56427,3,2,197469,197469,197471,0,2,2
56428,5,2,197474,197474,197476,0,2,3
56429,1,1,197475,197476,197477,1,2,0
56430,2,3,197477,197477,197480,0,3,0
56431,2,3,197479,197480,197483,1,4,0
56432,4,3,197483,197483,197486,0,3,0
56433,6,2,197489,197489,197491,0,2,3
56434,3,2,197492,197492,197494,0,2,1
56435,3,2,197495,197495,197497,0,2,1
56436,4,3,197499,197499,197502,0,3,2
56437,1,2,197500,197502,197504,2,4,0
56438,5,3,197505,197505,197508,0,3,1
56439,3,2,197508,197508,197510,0,2,0
56440,2,2,197510,197510,197512,0,2,0
56441,5,3,197515,197515,197518,0,3,3
56442,3,1,197518,197518,197519,0,1,0
56443,3,3,197521,197521,197524,0,3,2
56444,6,1,197527,197527,197528,0,1,3
56445,2,3,197529,197529,197532,0,3,1
56446,5,1,197534,197534,197535,0,1,2
56447,5,3,197539,197539,197542,0,3,4
56448,4,3,197543,197543,197546,0,3,1
56449,6,1,197549,197549,197550,0,1,3
56450,3,1,197552,197552,197553,0,1,2
56451,2,2,197554,197554,197556,0,2,1
56452,2,1,197556,197556,197557,0,1,0
56453,3,3,197559,197559,197562,0,3,2
56454,4,3,197563,197563,197566,0,3,1
56455,3,1,197566,197566,197567,0,1,0
56456,6,1,197572,197572,197573,0,1,5
56457,1,1,197573,197573,197574,0,1,0
56458,1,3,197574,197574,197577,0,3,0
56459,5,1,197579,197579,197580,0,1,2
56460,6,3,197585,197585,197588,0,3,5
56461,5,1,197590,197590,197591,0,1,2
56462,2,1,197592,197592,197593,0,1,1
56463,3,1,197595,197595,197596,0,1,2
56464,3,3,197598,197598,197601,0,3,2
56465,4,3,197602,197602,197605,0,3,1
56466,6,1,197608,197608,197609,0,1,3
56467,5,2,197613,197613,197615,0,2,4
56468,2,3,197615,197615,197618,0,3,0
56469,1,2,197616,197618,197620,2,4,0
56470,1,1,197617,197620,197621,3,4,0
56471,4,2,197621,197621,197623,0,2,0
56472,3,2,197624,197624,197626,0,2,1
56473,1,3,197625,197626,197629,1,4,0
56474,3,3,197628,197629,197632,1,4,0
56475,6,2,197634,197634,197636,0,2,2
56476,2,3,197636,197636,197639,0,3,0
56477,3,1,197639,197639,197640,0,1,0
56478,6,3,197645,197645,197648,0,3,5
56479,6,2,197651,197651,197653,0,2,3
56480,2,1,197653,197653,197654,0,1,0
56481,5,2,197658,197658,197660,0,2,4
56482,2,3,197660,197660,197663,0,3,0
56483,1,3,197661,197663,197666,2,5,0
56484,3,3,197664,197666,197669,2,5,0
56485,4,1,197668,197669,197670,1,2,0
56486,2,1,197670,197670,197671,0,1,0
56487,5,3,197675,197675,197678,0,3,4
56488,5,1,197680,197680,197681,0,1,2
56489,3,3,197683,197683,197686,0,3,2
56490,1,2,197684,197686,197688,2,4,0
56491,5,3,197689,197689,197692,0,3,1
56492,3,3,197692,197692,197695,0,3,0
56493,3,1,197695,197695,197696,0,1,0
56494,3,1,197698,197698,197699,0,1,2
56495,6,1,197704,197704,197705,0,1,5
56496,3,2,197707,197707,197709,0,2,2
56497,1,3,197708,197709,197712,1,4,0
56498,5,3,197713,197713,197716,0,3,1
56499,1,3,197714,197716,197719,2,5,0
56500,1,1,197715,197719,197720,4,5,0
56501,4,2,197719,197720,197722,1,3,0
56502,2,1,197721,197722,197723,1,2,0
56503,3,1,197724,197724,197725,0,1,1
56504,4,2,197728,197728,197730,0,2,3
56505,3,3,197731,197731,197734,0,3,1
56506,1,2,197732,197734,197736,2,4,0
56507,5,1,197737,197737,197738,0,1,1
56508,3,2,197740,197740,197742,0,2,2
56509,3,2,197743,197743,197745,0,2,1
56510,2,2,197745,197745,197747,0,2,0
56511,1,1,197746,197747,197748,1,2,0
56512,5,3,197751,197751,197754,0,3,3
56513,1,3,197752,197754,197757,2,5,0
56514,6,1,197758,197758,197759,0,1,1
56515,5,1,197763,197763,197764,0,1,4
56516,3,2,197766,197766,197768,0,2,2
56517,5,2,197771,197771,197773,0,2,3
56518,4,3,197775,197775,197778,0,3,2
56519,6,3,197781,197781,197784,0,3,3
56520,3,3,197784,197784,197787,0,3,0
56521,6,2,197790,197790,197792,0,2,3
56522,1,2,197791,197792,197794,1,3,0
56523,1,2,197792,197794,197796,2,4,0
56524,4,3,197796,197796,197799,0,3,0
56525,2,3,197798,197799,197802,1,4,0
56526,4,2,197802,197802,197804,0,2,0
56527,4,1,197806,197806,197807,0,1,2
56528,1,3,197807,197807,197810,0,3,0
56529,3,2,197810,197810,197812,0,2,0
56530,5,1,197815,197815,197816,0,1,3
56531,3,1,197818,197818,197819,0,1,2
56532,4,1,197822,197822,197823,0,1,3
56533,4,1,197826,197826,197827,0,1,3
56534,3,2,197829,197829,197831,0,2,2
56535,5,2,197834,197834,197836,0,2,3
56536,3,2,197837,197837,197839,0,2,1
56537,2,2,197839,197839,197841,0,2,0
56538,4,1,197843,197843,197844,0,1,2
56539,3,3,197846,197846,197849,0,3,2
56540,1,2,197847,197849,197851,2,4,0
56541,2,2,197849,197851,197853,2,4,0
56542,1,1,197850,197853,197854,3,4,0
56543,5,2,197855,197855,197857,0,2,1
56544,5,2,197860,197860,197862,0,2,3
56545,5,3,197865,197865,197868,0,3,3
56546,6,1,197871,197871,197872,0,1,3
56547,3,1,197874,197874,197875,0,1,2
56548,3,3,197877,197877,197880,0,3,2
56549,3,3,197880,197880,197883,0,3,0
56550,2,1,197882,197883,197884,1,2,0
56551,1,3,197883,197884,197887,1,4,0
56552,1,1,197884,197887,197888,3,4,0
56553,6,2,197890,197890,197892,0,2,2
56554,1,3,197891,197892,197895,1,4,0
56555,5,2,197896,197896,197898,0,2,1
56556,1,3,197897,197898,197901,1,4,0
56557,5,3,197902,197902,197905,0,3,1
56558,4,3,197906,197906,197909,0,3,1
56559,5,1,197911,197911,197912,0,1,2
56560,1,3,197912,197912,197915,0,3,0
56561,3,1,197915,197915,197916,0,1,0
56562,6,1,197921,197921,197922,0,1,5
56563,5,3,197926,197926,197929,0,3,4
56564,6,2,197932,197932,197934,0,2,3
56565,4,3,197936,197936,197939,0,3,2
56566,3,3,197939,197939,197942,0,3,0
56567,4,1,197943,197943,197944,0,1,1
56568,6,1,197949,197949,197950,0,1,5
56569,2,3,197951,197951,197954,0,3,1
56570,6,1,197957,197957,197958,0,1,3
56571,2,2,197959,197959,197961,0,2,1
56572,1,3,197960,197961,197964,1,4,0
56573,3,1,197963,197964,197965,1,2,0
56574,6,2,197969,197969,197971,0,2,4
56575,2,3,197971,197971,197974,0,3,0
56576,5,3,197976,197976,197979,0,3,2
56577,2,3,197978,197979,197982,1,4,0
56578,2,3,197980,197982,197985,2,5,0
56579,6,1,197986,197986,197987,0,1,1
56580,5,3,197991,197991,197994,0,3,4
56581,4,1,197995,197995,197996,0,1,1
56582,3,3,197998,197998,198001,0,3,2
56583,2,3,198000,198001,198004,1,4,0
56584,3,1,198003,198004,198005,1,2,0
56585,5,3,198008,198008,198011,0,3,3
56586,6,2,198014,198014,198016,0,2,3
56587,3,2,198017,198017,198019,0,2,1
56588,5,3,198022,198022,198025,0,3,3
56589,3,3,198025,198025,198028,0,3,0
56590,5,3,198030,198030,198033,0,3,2
56591,2,1,198032,198033,198034,1,2,0
56592,2,1,198034,198034,198035,0,1,0
56593,2,3,198036,198036,198039,0,3,1
56594,4,2,198040,198040,198042,0,2,1
56595,5,3,198045,198045,198048,0,3,3
56596,2,2,198047,198048,198050,1,3,0
56597,3,2,198050,198050,198052,0,2,0
56598,4,1,198054,198054,198055,0,1,2
56599,6,2,198060,198060,198062,0,2,5
56600,6,3,198066,198066,198069,0,3,4
56601,6,2,198072,198072,198074,0,2,3
56602,2,2,198074,198074,198076,0,2,0
56603,3,3,198077,198077,198080,0,3,1
56604,2,1,198079,198080,198081,1,2,0
56605,2,1,198081,198081,198082,0,1,0
56606,5,1,198086,198086,198087,0,1,4
56607,1,1,198087,198087,198088,0,1,0
56608,4,3,198091,198091,198094,0,3,3
56609,5,2,198096,198096,198098,0,2,2
56610,3,3,198099,198099,198102,0,3,1
56611,4,1,198103,198103,198104,0,1,1
56612,4,1,198107,198107,198108,0,1,3
56613,2,1,198109,198109,198110,0,1,1
56614,3,3,198112,198112,198115,0,3,2
56615,3,3,198115,198115,198118,0,3,0
56616,6,2,198121,198121,198123,0,2,3
56617,4,3,198125,198125,198128,0,3,2
56618,5,3,198130,198130,198133,0,3,2
56619,4,3,198134,198134,198137,0,3,1
56620,2,1,198136,198137,198138,1,2,0
56621,5,2,198141,198141,198143,0,2,3
56622,1,1,198142,198143,198144,1,2,0
56623,5,3,198147,198147,198150,0,3,3
56624,1,1,198148,198150,198151,2,3,0
56625,4,2,198152,198152,198154,0,2,1
56626,3,1,198155,198155,198156,0,1,1
56627,1,3,198156,198156,198159,0,3,0
56628,5,1,198161,198161,198162,0,1,2
56629,3,2,198164,198164,198166,0,2,2
56630,6,2,198170,198170,198172,0,2,4
56631,5,2,198175,198175,198177,0,2,3
56632,1,3,198176,198177,198180,1,4,0
56633,1,2,198177,198180,198182,3,5,0
56634,5,1,198182,198182,198183,0,1,0
56635,2,1,198184,198184,198185,0,1,1
56636,1,1,198185,198185,198186,0,1,0
56637,1,1,198186,198186,198187,0,1,0
56638,3,1,198189,198189,198190,0,1,2
56639,2,1,198191,198191,198192,0,1,1
56640,2,3,198193,198193,198196,0,3,1
56641,5,2,198198,198198,198200,0,2,2
56642,1,3,198199,198200,198203,1,4,0
56643,5,1,198204,198204,198205,0,1,1
56644,4,2,198208,198208,198210,0,2,3
56645,2,1,198210,198210,198211,0,1,0
56646,3,1,198213,198213,198214,0,1,2
56647,5,2,198218,198218,198220,0,2,4
56648,5,1,198223,198223,198224,0,1,3
56649,2,2,198225,198225,198227,0,2,1
56650,5,1,198230,198230,198231,0,1,3
56651,3,3,198233,198233,198236,0,3,2
56652,5,3,198238,198238,198241,0,3,2
56653,2,3,198240,198241,198244,1,4,0
56654,5,1,198245,198245,198246,0,1,1
56655,5,1,198250,198250,198251,0,1,4
56656,4,2,198254,198254,198256,0,2,3
56657,2,1,198256,198256,198257,0,1,0
56658,3,2,198259,198259,198261,0,2,2
56659,5,3,198264,198264,198267,0,3,3
56660,3,2,198267,198267,198269,0,2,0
56661,6,1,198273,198273,198274,0,1,4
56662,2,3,198275,198275,198278,0,3,1
56663,1,1,198276,198278,198279,2,3,0
56664,5,1,198281,198281,198282,0,1,2
56665,4,2,198285,198285,198287,0,2,3
56666,4,3,198289,198289,198292,0,3,2
56667,4,2,198293,198293,198295,0,2,1
56668,1,1,198294,198295,198296,1,2,0
56669,1,1,198295,198296,198297,1,2,0
56670,3,1,198298,198298,198299,0,1,1
56671,5,2,198303,198303,198305,0,2,4
56672,1,2,198304,198305,198307,1,3,0
56673,4,1,198308,198308,198309,0,1,1
56674,6,2,198314,198314,198316,0,2,5
56675,6,1,198320,198320,198321,0,1,4
56676,2,3,198322,198322,198325,0,3,1
56677,4,3,198326,198326,198329,0,3,1
56678,4,1,198330,198330,198331,0,1,1
56679,4,3,198334,198334,198337,0,3,3
56680,1,2,198335,198337,198339,2,4,0
56681,1,1,198336,198339,198340,3,4,0
56682,4,1,198340,198340,198341,0,1,0
56683,6,1,198346,198346,198347,0,1,5
56684,5,1,198351,198351,198352,0,1,4
56685,2,2,198353,198353,198355,0,2,1
56686,3,2,198356,198356,198358,0,2,1
56687,3,3,198359,198359,198362,0,3,1
56688,5,1,198364,198364,198365,0,1,2
56689,4,2,198368,198368,198370,0,2,3
56690,2,1,198370,198370,198371,0,1,0
56691,4,3,198374,198374,198377,0,3,3
56692,2,3,198376,198377,198380,1,4,0
56693,3,3,198379,198380,198383,1,4,0
56694,1,2,198380,198383,198385,3,5,0
56695,3,2,198383,198385,198387,2,4,0
56696,6,2,198389,198389,198391,0,2,2
56697,6,1,198395,198395,198396,0,1,4
56698,6,3,198401,198401,198404,0,3,5
56699,1,2,198402,198404,198406,2,4,0
56700,1,1,198403,198406,198407,3,4,0
56701,4,3,198407,198407,198410,0,3,0
56702,4,2,198411,198411,198413,0,2,1
56703,2,1,198413,198413,198414,0,1,0
56704,1,2,198414,198414,198416,0,2,0
56705,3,2,198417,198417,198419,0,2,1
56706,3,1,198420,198420,198421,0,1,1
56707,5,3,198425,198425,198428,0,3,4
56708,6,2,198431,198431,198433,0,2,3
56709,4,1,198435,198435,198436,0,1,2
56710,3,2,198438,198438,198440,0,2,2
56711,2,3,198440,198440,198443,0,3,0
56712,3,1,198443,198443,198444,0,1,0
56713,6,1,198449,198449,198450,0,1,5
56714,5,1,198454,198454,198455,0,1,4
56715,3,3,198457,198457,198460,0,3,2
56716,3,1,198460,198460,198461,0,1,0
56717,1,2,198461,198461,198463,0,2,0
56718,4,2,198465,198465,198467,0,2,2
56719,5,3,198470,198470,198473,0,3,3
56720,3,2,198473,198473,198475,0,2,0
56721,1,3,198474,198475,198478,1,4,0
56722,1,1,198475,198478,198479,3,4,0
56723,4,2,198479,198479,198481,0,2,0
56724,2,2,198481,198481,198483,0,2,0
56725,6,2,198487,198487,198489,0,2,4
56726,6,1,198493,198493,198494,0,1,4
56727,1,2,198494,198494,198496,0,2,0
56728,4,1,198498,198498,198499,0,1,2
56729,6,1,198504,198504,198505,0,1,5
56730,1,1,198505,198505,198506,0,1,0
56731,5,3,198510,198510,198513,0,3,4
56732,6,1,198516,198516,198517,0,1,3
56733,2,1,198518,198518,198519,0,1,1
56734,2,2,198520,198520,198522,0,2,1
56735,2,1,198522,198522,198523,0,1,0
56736,5,1,198527,198527,198528,0,1,4
56737,6,3,198533,198533,198536,0,3,5
56738,6,1,198539,198539,198540,0,1,3
56739,2,2,198541,198541,198543,0,2,1
56740,1,1,198542,198543,198544,1,2,0
56741,5,3,198547,198547,198550,0,3,3
56742,5,3,198552,198552,198555,0,3,2
56743,2,3,198554,198555,198558,1,4,0
56744,4,1,198558,198558,198559,0,1,0
56745,6,3,198564,198564,198567,0,3,5
56746,1,3,198565,198567,198570,2,5,0
56747,5,3,198570,198570,198573,0,3,0
56748,1,3,198571,198573,198576,2,5,0
56749,6,2,198577,198577,198579,0,2,1
56750,1,3,198578,198579,198582,1,4,0
56751,4,1,198582,198582,198583,0,1,0
56752,1,1,198583,198583,198584,0,1,0
56753,5,1,198588,198588,198589,0,1,4
56754,5,3,198593,198593,198596,0,3,4
56755,4,2,198597,198597,198599,0,2,1
56756,5,3,198602,198602,198605,0,3,3
56757,2,3,198604,198605,198608,1,4,0
56758,6,2,198610,198610,198612,0,2,2
56759,6,3,198616,198616,198619,0,3,4
56760,6,2,198622,198622,198624,0,2,3
56761,1,3,198623,198624,198627,1,4,0
56762,6,2,198629,198629,198631,0,2,2
56763,6,3,198635,198635,198638,0,3,4
56764,6,3,198641,198641,198644,0,3,3
56765,6,3,198647,198647,198650,0,3,3
56766,4,3,198651,198651,198654,0,3,1
56767,5,3,198656,198656,198659,0,3,2
56768,1,1,198657,198659,198660,2,3,0
56769,1,2,198658,198660,198662,2,4,0
56770,5,2,198663,198663,198665,0,2,1
56771,6,2,198669,198669,198671,0,2,4
56772,3,2,198672,198672,198674,0,2,1
56773,4,2,198676,198676,198678,0,2,2
56774,6,1,198682,198682,198683,0,1,4
56775,2,2,198684,198684,198686,0,2,1
56776,4,2,198688,198688,198690,0,2,2
56777,4,2,198692,198692,198694,0,2,2
56778,3,2,198695,198695,198697,0,2,1
56779,3,2,198698,198698,198700,0,2,1
56780,1,1,198699,198700,198701,1,2,0
56781,2,1,198701,198701,198702,0,1,0
56782,5,2,198706,198706,198708,0,2,4
56783,6,2,198712,198712,198714,0,2,4
56784,1,1,198713,198714,198715,1,2,0
56785,4,3,198717,198717,198720,0,3,2
56786,6,3,198723,198723,198726,0,3,3
56787,6,3,198729,198729,198732,0,3,3
56788,2,1,198731,198732,198733,1,2,0
56789,5,1,198736,198736,198737,0,1,3
56790,3,2,198739,198739,198741,0,2,2
56791,6,1,198745,198745,198746,0,1,4
56792,6,1,198751,198751,198752,0,1,5
56793,2,1,198753,198753,198754,0,1,1
56794,6,3,198759,198759,198762,0,3,5
56795,6,2,198765,198765,198767,0,2,3
56796,2,1,198767,198767,198768,0,1,0
56797,6,3,198773,198773,198776,0,3,5
56798,1,1,198774,198776,198777,2,3,0
56799,3,3,198777,198777,198780,0,3,0
56800,2,3,198779,198780,198783,1,4,0
56801,3,1,198782,198783,198784,1,2,0
56802,6,1,198788,198788,198789,0,1,4
56803,3,1,198791,198791,198792,0,1,2
56804,6,3,198797,198797,198800,0,3,5
56805,5,1,198802,198802,198803,0,1,2
56806,3,1,198805,198805,198806,0,1,2
56807,2,3,198807,198807,198810,0,3,1
56808,1,1,198808,198810,198811,2,3,0
56809,5,3,198813,198813,198816,0,3,2
56810,3,1,198816,198816,198817,0,1,0
56811,1,3,198817,198817,198820,0,3,0
56812,4,3,198821,198821,198824,0,3,1
56813,4,2,198825,198825,198827,0,2,1
56814,5,2,198830,198830,198832,0,2,3
56815,5,2,198835,198835,198837,0,2,3
56816,4,3,198839,198839,198842,0,3,2
56817,2,3,198841,198842,198845,1,4,0
56818,6,3,198847,198847,198850,0,3,2
56819,5,1,198852,198852,198853,0,1,2
56820,1,1,198853,198853,198854,0,1,0
56821,4,1,198857,198857,198858,0,1,3
56822,6,2,198863,198863,198865,0,2,5
56823,1,2,198864,198865,198867,1,3,0
56824,4,1,198868,198868,198869,0,1,1
56825,2,2,198870,198870,198872,0,2,1
56826,1,2,198871,198872,198874,1,3,0
56827,3,3,198874,198874,198877,0,3,0
56828,1,1,198875,198877,198878,2,3,0
56829,2,2,198877,198878,198880,1,3,0
56830,5,2,198882,198882,198884,0,2,2
56831,3,2,198885,198885,198887,0,2,1
56832,4,2,198889,198889,198891,0,2,2
56833,6,1,198895,198895,198896,0,1,4
56834,5,2,198900,198900,198902,0,2,4
56835,4,1,198904,198904,198905,0,1,2
56836,2,3,198906,198906,198909,0,3,1
56837,5,3,198911,198911,198914,0,3,2
56838,3,1,198914,198914,198915,0,1,0
56839,4,1,198918,198918,198919,0,1,3
56840,2,1,198920,198920,198921,0,1,1
56841,3,1,198923,198923,198924,0,1,2
56842,4,3,198927,198927,198930,0,3,3
56843,6,2,198933,198933,198935,0,2,3
56844,4,3,198937,198937,198940,0,3,2
56845,4,1,198941,198941,198942,0,1,1
56846,6,2,198947,198947,198949,0,2,5
56847,5,1,198952,198952,198953,0,1,3
56848,2,1,198954,198954,198955,0,1,1
56849,5,1,198959,198959,198960,0,1,4
56850,2,2,198961,198961,198963,0,2,1
56851,1,1,198962,198963,198964,1,2,0
56852,6,1,198968,198968,198969,0,1,4
56853,5,3,198973,198973,198976,0,3,4
56854,4,2,198977,198977,198979,0,2,1
56855,5,3,198982,198982,198985,0,3,3
56856,6,3,198988,198988,198991,0,3,3
56857,6,3,198994,198994,198997,0,3,3
56858,4,1,198998,198998,198999,0,1,1
56859,1,1,198999,198999,199000,0,1,0
56860,4,2,199003,199003,199005,0,2,3
56861,3,3,199006,199006,199009,0,3,1
56862,2,2,199008,199009,199011,1,3,0
56863,2,3,199010,199011,199014,1,4,0
56864,4,1,199014,199014,199015,0,1,0
56865,4,3,199018,199018,199021,0,3,3
56866,5,3,199023,199023,199026,0,3,2
56867,4,3,199027,199027,199030,0,3,1
56868,2,2,199029,199030,199032,1,3,0
56869,1,3,199030,199032,199035,2,5,0
56870,2,3,199032,199035,199038,3,6,0
56871,3,3,199035,199038,199041,3,6,0
56872,5,2,199040,199041,199043,1,3,0
56873,4,2,199044,199044,199046,0,2,1
56874,2,2,199046,199046,199048,0,2,0
56875,5,2,199051,199051,199053,0,2,3
56876,1,3,199052,199053,199056,1,4,0
56877,6,3,199058,199058,199061,0,3,2
56878,1,2,199059,199061,199063,2,4,0
56879,1,2,199060,199063,199065,3,5,0
56880,5,2,199065,199065,199067,0,2,0
56881,3,1,199068,199068,199069,0,1,1
56882,6,1,199074,199074,199075,0,1,5
56883,4,2,199078,199078,199080,0,2,3
56884,5,3,199083,199083,199086,0,3,3
56885,6,1,199089,199089,199090,0,1,3
56886,2,3,199091,199091,199094,0,3,1
56887,3,2,199094,199094,199096,0,2,0
56888,4,3,199098,199098,199101,0,3,2
56889,4,2,199102,199102,199104,0,2,1
56890,5,3,199107,199107,199110,0,3,3
56891,4,1,199111,199111,199112,0,1,1
56892,5,1,199116,199116,199117,0,1,4
56893,5,2,199121,199121,199123,0,2,4
56894,5,3,199126,199126,199129,0,3,3
56895,1,2,199127,199129,199131,2,4,0
56896,4,3,199131,199131,199134,0,3,0
56897,2,1,199133,199134,199135,1,2,0
56898,1,3,199134,199135,199138,1,4,0
56899,3,3,199137,199138,199141,1,4,0
56900,3,2,199140,199141,199143,1,3,0
56901,2,2,199142,199143,199145,1,3,0
56902,2,3,199144,199145,199148,1,4,0
56903,3,2,199147,199148,199150,1,3,0
56904,3,1,199150,199150,199151,0,1,0
56905,2,2,199152,199152,199154,0,2,1
56906,1,2,199153,199154,199156,1,3,0
56907,3,2,199156,199156,199158,0,2,0
56908,5,1,199161,199161,199162,0,1,3
56909,4,1,199165,199165,199166,0,1,3
56910,4,2,199169,199169,199171,0,2,3
56911,4,1,199173,199173,199174,0,1,2
56912,6,2,199179,199179,199181,0,2,5
56913,6,3,199185,199185,199188,0,3,4
56914,4,1,199189,199189,199190,0,1,1
56915,6,1,199195,199195,199196,0,1,5
56916,3,3,199198,199198,199201,0,3,2
56917,4,3,199202,199202,199205,0,3,1
56918,2,3,199204,199205,199208,1,4,0
56919,5,3,199209,199209,199212,0,3,1
56920,3,1,199212,199212,199213,0,1,0
56921,6,3,199218,199218,199221,0,3,5
56922,6,2,199224,199224,199226,0,2,3
56923,4,3,199228,199228,199231,0,3,2
56924,4,3,199232,199232,199235,0,3,1
56925,2,1,199234,199235,199236,1,2,0
56926,4,3,199238,199238,199241,0,3,2
56927,4,1,199242,199242,199243,0,1,1
56928,1,2,199243,199243,199245,0,2,0
56929,6,1,199249,199249,199250,0,1,4
56930,1,3,199250,199250,199253,0,3,0
56931,3,3,199253,199253,199256,0,3,0
56932,1,3,199254,199256,199259,2,5,0
56933,6,2,199260,199260,199262,0,2,1
56934,1,2,199261,199262,199264,1,3,0
56935,4,2,199265,199265,199267,0,2,1
56936,3,1,199268,199268,199269,0,1,1
56937,3,3,199271,199271,199274,0,3,2
56938,3,1,199274,199274,199275,0,1,0
56939,4,1,199278,199278,199279,0,1,3
56940,3,2,199281,199281,199283,0,2,2
56941,6,2,199287,199287,199289,0,2,4
56942,5,1,199292,199292,199293,0,1,3
56943,2,1,199294,199294,199295,0,1,1
56944,5,3,199299,199299,199302,0,3,4
56945,6,3,199305,199305,199308,0,3,3
56946,3,1,199308,199308,199309,0,1,0
56947,3,2,199311,199311,199313,0,2,2
56948,5,3,199316,199316,199319,0,3,3
56949,3,1,199319,199319,199320,0,1,0
56950,2,2,199321,199321,199323,0,2,1
56951,6,2,199327,199327,199329,0,2,4
56952,4,3,199331,199331,199334,0,3,2
56953,4,2,199335,199335,199337,0,2,1
56954,4,2,199339,199339,199341,0,2,2
56955,4,2,199343,199343,199345,0,2,2
56956,2,3,199345,199345,199348,0,3,0
56957,1,3,199346,199348,199351,2,5,0
56958,6,3,199352,199352,199355,0,3,1
56959,5,3,199357,199357,199360,0,3,2
56960,4,2,199361,199361,199363,0,2,1
56961,5,2,199366,199366,199368,0,2,3
56962,1,2,199367,199368,199370,1,3,0
56963,1,1,199368,199370,199371,2,3,0
56964,2,3,199370,199371,199374,1,4,0
56965,1,3,199371,199374,199377,3,6,0
56966,3,2,199374,199377,199379,3,5,0
56967,3,2,199377,199379,199381,2,4,0
56968,3,1,199380,199381,199382,1,2,0
56969,1,3,199381,199382,199385,1,4,0
56970,6,3,199387,199387,199390,0,3,2
56971,6,1,199393,199393,199394,0,1,3
56972,6,3,199399,199399,199402,0,3,5
56973,3,3,199402,199402,199405,0,3,0
56974,3,1,199405,199405,199406,0,1,0
56975,1,3,199406,199406,199409,0,3,0
56976,5,2,199411,199411,199413,0,2,2
56977,1,3,199412,199413,199416,1,4,0
56978,3,1,199415,199416,199417,1,2,0
56979,4,1,199419,199419,199420,0,1,2
56980,6,1,199425,199425,199426,0,1,5
56981,3,3,199428,199428,199431,0,3,2
56982,2,3,199430,199431,199434,1,4,0
56983,6,1,199436,199436,199437,0,1,2
56984,5,1,199441,199441,199442,0,1,4
56985,4,3,199445,199445,199448,0,3,3
56986,2,2,199447,199448,199450,1,3,0
56987,3,1,199450,199450,199451,0,1,0
56988,2,3,199452,199452,199455,0,3,1
56989,2,2,199454,199455,199457,1,3,0
56990,5,2,199459,199459,199461,0,2,2
56991,4,1,199463,199463,199464,0,1,2
56992,2,1,199465,199465,199466,0,1,1
56993,1,3,199466,199466,199469,0,3,0
56994,6,3,199472,199472,199475,0,3,3
56995,6,2,199478,199478,199480,0,2,3
56996,6,2,199484,199484,199486,0,2,4
56997,4,2,199488,199488,199490,0,2,2
56998,6,3,199494,199494,199497,0,3,4
56999,3,2,199497,199497,199499,0,2,0
57000,2,1,199499,199499,199500,0,1,0
57001,2,3,199501,199501,199504,0,3,1
57002,1,3,199502,199504,199507,2,5,0
57003,1,1,199503,199507,199508,4,5,0
57004,4,1,199507,199508,199509,1,2,0
57005,3,3,199510,199510,199513,0,3,1
57006,5,2,199515,199515,199517,0,2,2
57007,6,1,199521,199521,199522,0,1,4
57008,4,3,199525,199525,199528,0,3,3
57009,2,2,199527,199528,199530,1,3,0
57010,6,1,199533,199533,199534,0,1,3
57011,4,1,199537,199537,199538,0,1,3
57012,3,1,199540,199540,199541,0,1,2
57013,3,2,199543,199543,199545,0,2,2
57014,1,1,199544,199545,199546,1,2,0
57015,5,3,199549,199549,199552,0,3,3
57016,4,2,199553,199553,199555,0,2,1
57017,5,2,199558,199558,199560,0,2,3
57018,3,1,199561,199561,199562,0,1,1
57019,5,2,199566,199566,199568,0,2,4
57020,4,3,199570,199570,199573,0,3,2
57021,2,1,199572,199573,199574,1,2,0
57022,5,3,199577,199577,199580,0,3,3
57023,6,2,199583,199583,199585,0,2,3
57024,4,2,199587,199587,199589,0,2,2
57025,1,3,199588,199589,199592,1,4,0
57026,4,3,199592,199592,199595,0,3,0
57027,2,1,199594,199595,199596,1,2,0
57028,4,1,199598,199598,199599,0,1,2
57029,2,2,199600,199600,199602,0,2,1
57030,3,2,199603,199603,199605,0,2,1
57031,2,2,199605,199605,199607,0,2,0
57032,3,2,199608,199608,199610,0,2,1
57033,1,3,199609,199610,199613,1,4,0
57034,6,2,199615,199615,199617,0,2,2
57035,6,3,199621,199621,199624,0,3,4
57036,4,3,199625,199625,199628,0,3,1
57037,1,3,199626,199628,199631,2,5,0
57038,4,2,199630,199631,199633,1,3,0
57039,2,3,199632,199633,199636,1,4,0
57040,6,2,199638,199638,199640,0,2,2
57041,5,3,199643,199643,199646,0,3,3
57042,4,1,199647,199647,199648,0,1,1
57043,1,1,199648,199648,199649,0,1,0
57044,5,1,199653,199653,199654,0,1,4
57045,1,1,199654,199654,199655,0,1,0
57046,3,3,199657,199657,199660,0,3,2
57047,5,2,199662,199662,199664,0,2,2
57048,2,3,199664,199664,199667,0,3,0
57049,4,3,199668,199668,199671,0,3,1
57050,5,1,199673,199673,199674,0,1,2
57051,6,3,199679,199679,199682,0,3,5
57052,3,3,199682,199682,199685,0,3,0
57053,4,3,199686,199686,199689,0,3,1
57054,5,1,199691,199691,199692,0,1,2
57055,2,2,199693,199693,199695,0,2,1
57056,3,3,199696,199696,199699,0,3,1
57057,1,1,199697,199699,199700,2,3,0
57058,5,1,199702,199702,199703,0,1,2
57059,6,2,199708,199708,199710,0,2,5
57060,5,1,199713,199713,199714,0,1,3
57061,5,3,199718,199718,199721,0,3,4
57062,5,2,199723,199723,199725,0,2,2
57063,1,1,199724,199725,199726,1,2,0
57064,5,2,199729,199729,199731,0,2,3
57065,6,2,199735,199735,199737,0,2,4
57066,5,3,199740,199740,199743,0,3,3
57067,3,1,199743,199743,199744,0,1,0
57068,4,3,199747,199747,199750,0,3,3
57069,6,1,199753,199753,199754,0,1,3
57070,2,3,199755,199755,199758,0,3,1
57071,2,3,199757,199758,199761,1,4,0
57072,3,2,199760,199761,199763,1,3,0
57073,1,3,199761,199763,199766,2,5,0
57074,3,1,199764,199766,199767,2,3,0
57075,5,2,199769,199769,199771,0,2,2
57076,4,1,199773,199773,199774,0,1,2
57077,2,1,199775,199775,199776,0,1,1
57078,2,3,199777,199777,199780,0,3,1
57079,4,1,199781,199781,199782,0,1,1
57080,2,2,199783,199783,199785,0,2,1
57081,5,2,199788,199788,199790,0,2,3
57082,4,2,199792,199792,199794,0,2,2
57083,3,2,199795,199795,199797,0,2,1
57084,3,1,199798,199798,199799,0,1,1
57085,3,1,199801,199801,199802,0,1,2
57086,2,3,199803,199803,199806,0,3,1
57087,5,3,199808,199808,199811,0,3,2
57088,4,1,199812,199812,199813,0,1,1
57089,4,1,199816,199816,199817,0,1,3
57090,2,1,199818,199818,199819,0,1,1
57091,6,1,199824,199824,199825,0,1,5
57092,1,1,199825,199825,199826,0,1,0
57093,1,1,199826,199826,199827,0,1,0
57094,4,2,199830,199830,199832,0,2,3
57095,5,3,199835,199835,199838,0,3,3
57096,1,2,199836,199838,199840,2,4,0
57097,1,2,199837,199840,199842,3,5,0
57098,5,1,199842,199842,199843,0,1,0
57099,5,2,199847,199847,199849,0,2,4
57100,6,3,199853,199853,199856,0,3,4
57101,6,1,199859,199859,199860,0,1,3
57102,2,3,199861,199861,199864,0,3,1
57103,6,2,199867,199867,199869,0,2,3
57104,1,1,199868,199869,199870,1,2,0
57105,6,1,199874,199874,199875,0,1,4
57106,1,1,199875,199875,199876,0,1,0
57107,3,1,199878,199878,199879,0,1,2
57108,1,2,199879,199879,199881,0,2,0
57109,4,2,199883,199883,199885,0,2,2
57110,2,1,199885,199885,199886,0,1,0
57111,5,2,199890,199890,199892,0,2,4
57112,2,1,199892,199892,199893,0,1,0
57113,1,2,199893,199893,199895,0,2,0
57114,2,3,199895,199895,199898,0,3,0
57115,3,2,199898,199898,199900,0,2,0
57116,6,3,199904,199904,199907,0,3,4
57117,5,1,199909,199909,199910,0,1,2
57118,5,1,199914,199914,199915,0,1,4
57119,3,2,199917,199917,199919,0,2,2
57120,3,1,199920,199920,199921,0,1,1
57121,4,2,199924,199924,199926,0,2,3
57122,2,3,199926,199926,199929,0,3,0
57123,5,2,199931,199931,199933,0,2,2
57124,1,2,199932,199933,199935,1,3,0
57125,3,1,199935,199935,199936,0,1,0
57126,5,2,199940,199940,199942,0,2,4
57127,1,3,199941,199942,199945,1,4,0
57128,6,3,199947,199947,199950,0,3,2
57129,1,1,199948,199950,199951,2,3,0
57130,6,1,199954,199954,199955,0,1,3
57131,2,2,199956,199956,199958,0,2,1
57132,3,3,199959,199959,199962,0,3,1
57133,1,3,199960,199962,199965,2,5,0
57134,1,3,199961,199965,199968,4,7,0
57135,5,1,199966,199968,199969,2,3,0
57136,1,3,199967,199969,199972,2,5,0
57137,6,3,199973,199973,199976,0,3,1
57138,3,2,199976,199976,199978,0,2,0
57139,3,3,199979,199979,199982,0,3,1
57140,2,1,199981,199982,199983,1,2,0
57141,4,2,199985,199985,199987,0,2,2
57142,2,2,199987,199987,199989,0,2,0
57143,6,3,199993,199993,199996,0,3,4
57144,4,2,199997,199997,199999,0,2,1
57145,6,2,200003,200003,200005,0,2,4
57146,5,1,200008,200008,200009,0,1,3
57147,1,2,200009,200009,200011,0,2,0
57148,6,2,200015,200015,200017,0,2,4
57149,5,3,200020,200020,200023,0,3,3
57150,2,1,200022,200023,200024,1,2,0
57151,4,2,200026,200026,200028,0,2,2
57152,6,2,200032,200032,200034,0,2,4
57153,1,3,200033,200034,200037,1,4,0
57154,3,3,200036,200037,200040,1,4,0
57155,6,2,200042,200042,200044,0,2,2
57156,4,1,200046,200046,200047,0,1,2
57157,3,2,200049,200049,200051,0,2,2
57158,2,1,200051,200051,200052,0,1,0
57159,2,3,200053,200053,200056,0,3,1
57160,1,2,200054,200056,200058,2,4,0
57161,1,2,200055,200058,200060,3,5,0
57162,4,2,200059,200060,200062,1,3,0
57163,4,1,200063,200063,200064,0,1,1
57164,3,3,200066,200066,200069,0,3,2
57165,1,1,200067,200069,200070,2,3,0
57166,6,2,200073,200073,200075,0,2,3
57167,6,3,200079,200079,200082,0,3,4
57168,4,3,200083,200083,200086,0,3,1
57169,4,2,200087,200087,200089,0,2,1
57170,6,2,200093,200093,200095,0,2,4
57171,5,2,200098,200098,200100,0,2,3
57172,2,2,200100,200100,200102,0,2,0
57173,5,1,200105,200105,200106,0,1,3
57174,2,2,200107,200107,200109,0,2,1
57175,3,1,200110,200110,200111,0,1,1
57176,2,2,200112,200112,200114,0,2,1
57177,1,1,200113,200114,200115,1,2,0
57178,6,3,200119,200119,200122,0,3,4
57179,5,2,200124,200124,200126,0,2,2
57180,3,3,200127,200127,200130,0,3,1
57181,4,3,200131,200131,200134,0,3,1
57182,4,2,200135,200135,200137,0,2,1
57183,1,2,200136,200137,200139,1,3,0
57184,3,2,200139,200139,200141,0,2,0
57185,3,2,200142,200142,200144,0,2,1
57186,6,1,200148,200148,200149,0,1,4
57187,4,2,200152,200152,200154,0,2,3
57188,5,1,200157,200157,200158,0,1,3
57189,4,2,200161,200161,200163,0,2,3
57190,5,3,200166,200166,200169,0,3,3
57191,2,3,200168,200169,200172,1,4,0
57192,5,1,200173,200173,200174,0,1,1
57193,1,1,200174,200174,200175,0,1,0
57194,3,2,200177,200177,200179,0,2,2
57195,1,2,200178,200179,200181,1,3,0
57196,3,2,200181,200181,200183,0,2,0
57197,2,1,200183,200183,200184,0,1,0
57198,5,2,200188,200188,200190,0,2,4
57199,5,1,200193,200193,200194,0,1,3
57200,1,2,200194,200194,200196,0,2,0
57201,3,1,200197,200197,200198,0,1,1
57202,6,2,200203,200203,200205,0,2,5
57203,3,1,200206,200206,200207,0,1,1
57204,4,1,200210,200210,200211,0,1,3
57205,1,3,200211,200211,200214,0,3,0
57206,6,1,200217,200217,200218,0,1,3
57207,4,1,200221,200221,200222,0,1,3
57208,6,1,200227,200227,200228,0,1,5
57209,2,2,200229,200229,200231,0,2,1
57210,6,3,200235,200235,200238,0,3,4
57211,3,3,200238,200238,200241,0,3,0
57212,2,3,200240,200241,200244,1,4,0
57213,4,1,200244,200244,200245,0,1,0
57214,5,2,200249,200249,200251,0,2,4
57215,5,3,200254,200254,200257,0,3,3
57216,1,3,200255,200257,200260,2,5,0
57217,1,1,200256,200260,200261,4,5,0
57218,2,1,200258,200261,200262,3,4,0
57219,1,3,200259,200262,200265,3,6,0
57220,5,2,200264,200265,200267,1,3,0
57221,6,2,200270,200270,200272,0,2,3
57222,5,1,200275,200275,200276,0,1,3
57223,6,1,200281,200281,200282,0,1,5
57224,2,3,200283,200283,200286,0,3,1
57225,6,2,200289,200289,200291,0,2,3
57226,3,3,200292,200292,200295,0,3,1
57227,6,3,200298,200298,200301,0,3,3
57228,3,2,200301,200301,200303,0,2,0
57229,4,3,200305,200305,200308,0,3,2
57230,2,2,200307,200308,200310,1,3,0
57231,5,1,200312,200312,200313,0,1,2
57232,1,2,200313,200313,200315,0,2,0
57233,1,3,200314,200315,200318,1,4,0
57234,6,1,200320,200320,200321,0,1,2
57235,2,3,200322,200322,200325,0,3,1
57236,2,2,200324,200325,200327,1,3,0
57237,3,2,200327,200327,200329,0,2,0
57238,1,3,200328,200329,200332,1,4,0
57239,3,2,200331,200332,200334,1,3,0
57240,2,1,200333,200334,200335,1,2,0
57241,4,3,200337,200337,200340,0,3,2
57242,5,2,200342,200342,200344,0,2,2
57243,6,2,200348,200348,200350,0,2,4
57244,5,3,200353,200353,200356,0,3,3
57245,5,3,200358,200358,200361,0,3,2
57246,2,1,200360,200361,200362,1,2,0
57247,6,2,200366,200366,200368,0,2,4
57248,5,3,200371,200371,200374,0,3,3
57249,6,2,200377,200377,200379,0,2,3
57250,6,1,200383,200383,200384,0,1,4
57251,6,2,200389,200389,200391,0,2,5
57252,5,1,200394,200394,200395,0,1,3
57253,4,3,200398,200398,200401,0,3,3
57254,2,2,200400,200401,200403,1,3,0
57255,3,2,200403,200403,200405,0,2,0
57256,4,3,200407,200407,200410,0,3,2
57257,5,3,200412,200412,200415,0,3,2
57258,4,2,200416,200416,200418,0,2,1
57259,2,1,200418,200418,200419,0,1,0
57260,1,1,200419,200419,200420,0,1,0
57261,5,1,200424,200424,200425,0,1,4
57262,1,1,200425,200425,200426,0,1,0
57263,2,3,200427,200427,200430,0,3,1
57264,2,2,200429,200430,200432,1,3,0
57265,3,1,200432,200432,200433,0,1,0
57266,1,2,200433,200433,200435,0,2,0
57267,3,3,200436,200436,200439,0,3,1
57268,6,3,200442,200442,200445,0,3,3
57269,2,2,200444,200445,200447,1,3,0
57270,5,2,200449,200449,200451,0,2,2
57271,6,1,200455,200455,200456,0,1,4
57272,5,3,200460,200460,200463,0,3,4
57273,4,3,200464,200464,200467,0,3,1
57274,4,3,200468,200468,200471,0,3,1
57275,6,2,200474,200474,200476,0,2,3
57276,2,1,200476,200476,200477,0,1,0
57277,3,3,200479,200479,200482,0,3,2
57278,5,3,200484,200484,200487,0,3,2
57279,3,3,200487,200487,200490,0,3,0
57280,2,2,200489,200490,200492,1,3,0
57281,2,3,200491,200492,200495,1,4,0
57282,5,1,200496,200496,200497,0,1,1
57283,5,2,200501,200501,200503,0,2,4
57284,2,3,200503,200503,200506,0,3,0
57285,3,3,200506,200506,200509,0,3,0
57286,4,1,200510,200510,200511,0,1,1
57287,4,1,200514,200514,200515,0,1,3
57288,3,3,200517,200517,200520,0,3,2
57289,3,1,200520,200520,200521,0,1,0
57290,3,2,200523,200523,200525,0,2,2
57291,4,2,200527,200527,200529,0,2,2
57292,5,1,200532,200532,200533,0,1,3
57293,3,1,200535,200535,200536,0,1,2
57294,6,1,200541,200541,200542,0,1,5
57295,1,1,200542,200542,200543,0,1,0
57296,5,1,200547,200547,200548,0,1,4
57297,4,2,200551,200551,200553,0,2,3
57298,4,1,200555,200555,200556,0,1,2
57299,3,1,200558,200558,200559,0,1,2
57300,6,2,200564,200564,200566,0,2,5
57301,3,3,200567,200567,200570,0,3,1
57302,4,2,200571,200571,200573,0,2,1
57303,1,3,200572,200573,200576,1,4,0
57304,6,2,200578,200578,200580,0,2,2
57305,3,1,200581,200581,200582,0,1,1
57306,2,2,200583,200583,200585,0,2,1
57307,3,2,200586,200586,200588,0,2,1
57308,2,2,200588,200588,200590,0,2,0
57309,3,3,200591,200591,200594,0,3,1
57310,4,1,200595,200595,200596,0,1,1
57311,1,1,200596,200596,200597,0,1,0
57312,1,1,200597,200597,200598,0,1,0
57313,6,3,200603,200603,200606,0,3,5
57314,4,1,200607,200607,200608,0,1,1
57315,2,1,200609,200609,200610,0,1,1
57316,5,3,200614,200614,200617,0,3,4
57317,3,2,200617,200617,200619,0,2,0
57318,5,3,200622,200622,200625,0,3,3
57319,5,2,200627,200627,200629,0,2,2
57320,2,1,200629,200629,200630,0,1,0
57321,5,2,200634,200634,200636,0,2,4
57322,3,1,200637,200637,200638,0,1,1
57323,6,3,200643,200643,200646,0,3,5
57324,1,1,200644,200646,200647,2,3,0
57325,4,3,200648,200648,200651,0,3,1
57326,6,2,200654,200654,200656,0,2,3
57327,5,3,200659,200659,200662,0,3,3
57328,5,1,200664,200664,200665,0,1,2
57329,2,2,200666,200666,200668,0,2,1
57330,4,2,200670,200670,200672,0,2,2
57331,1,1,200671,200672,200673,1,2,0
57332,2,2,200673,200673,200675,0,2,0
57333,2,1,200675,200675,200676,0,1,0
57334,3,3,200678,200678,200681,0,3,2
57335,6,2,200684,200684,200686,0,2,3
57336,5,2,200689,200689,200691,0,2,3
57337,3,1,200692,200692,200693,0,1,1
57338,3,1,200695,200695,200696,0,1,2
57339,2,1,200697,200697,200698,0,1,1
57340,5,3,200702,200702,200705,0,3,4
57341,5,3,200707,200707,200710,0,3,2
57342,5,3,200712,200712,200715,0,3,2
57343,4,3,200716,200716,200719,0,3,1
57344,5,3,200721,200721,200724,0,3,2
57345,5,3,200726,200726,200729,0,3,2
57346,3,3,200729,200729,200732,0,3,0
57347,1,2,200730,200732,200734,2,4,0
57348,1,3,200731,200734,200737,3,6,0
57349,4,3,200735,200737,200740,2,5,0
57350,4,1,200739,200740,200741,1,2,0
57351,1,2,200740,200741,200743,1,3,0
57352,6,2,200746,200746,200748,0,2,3
57353,2,2,200748,200748,200750,0,2,0
57354,6,1,200754,200754,200755,0,1,4
57355,5,2,200759,200759,200761,0,2,4
57356,2,1,200761,200761,200762,0,1,0
57357,4,3,200765,200765,200768,0,3,3
57358,6,1,200771,200771,200772,0,1,3
57359,5,1,200776,200776,200777,0,1,4
57360,1,1,200777,200777,200778,0,1,0
57361,4,3,200781,200781,200784,0,3,3
57362,4,1,200785,200785,200786,0,1,1
57363,6,1,200791,200791,200792,0,1,5
57364,2,2,200793,200793,200795,0,2,1
57365,5,3,200798,200798,200801,0,3,3
57366,5,3,200803,200803,200806,0,3,2
57367,3,3,200806,200806,200809,0,3,0
57368,6,1,200812,200812,200813,0,1,3
57369,6,2,200818,200818,200820,0,2,5
57370,6,1,200824,200824,200825,0,1,4
57371,1,1,200825,200825,200826,0,1,0
57372,5,3,200830,200830,200833,0,3,4
57373,4,2,200834,200834,200836,0,2,1
57374,2,2,200836,200836,200838,0,2,0
57375,1,1,200837,200838,200839,1,2,0
57376,6,1,200843,200843,200844,0,1,4
57377,2,1,200845,200845,200846,0,1,1
57378,5,2,200850,200850,200852,0,2,4
57379,1,2,200851,200852,200854,1,3,0
57380,6,2,200857,200857,200859,0,2,3
57381,5,2,200862,200862,200864,0,2,3
57382,3,2,200865,200865,200867,0,2,1
57383,6,1,200871,200871,200872,0,1,4
57384,6,2,200877,200877,200879,0,2,5
57385,4,1,200881,200881,200882,0,1,2
57386,3,2,200884,200884,200886,0,2,2
57387,6,3,200890,200890,200893,0,3,4
57388,1,2,200891,200893,200895,2,4,0
57389,3,1,200894,200895,200896,1,2,0
57390,2,1,200896,200896,200897,0,1,0
57391,6,2,200902,200902,200904,0,2,5
57392,1,2,200903,200904,200906,1,3,0
57393,6,1,200909,200909,200910,0,1,3
57394,4,3,200913,200913,200916,0,3,3
57395,4,1,200917,200917,200918,0,1,1
57396,1,1,200918,200918,200919,0,1,0
57397,4,2,200922,200922,200924,0,2,3
57398,1,2,200923,200924,200926,1,3,0
57399,2,3,200925,200926,200929,1,4,0
57400,2,3,200927,200929,200932,2,5,0
57401,5,1,200932,200932,200933,0,1,0
57402,5,1,200937,200937,200938,0,1,4
57403,2,1,200939,200939,200940,0,1,1
57404,1,3,200940,200940,200943,0,3,0
57405,1,3,200941,200943,200946,2,5,0
57406,3,1,200944,200946,200947,2,3,0
57407,3,1,200947,200947,200948,0,1,0
57408,2,2,200949,200949,200951,0,2,1
57409,6,1,200955,200955,200956,0,1,4
57410,1,1,200956,200956,200957,0,1,0
57411,5,3,200961,200961,200964,0,3,4
57412,1,2,200962,200964,200966,2,4,0
57413,6,1,200968,200968,200969,0,1,2
57414,5,2,200973,200973,200975,0,2,4
57415,4,1,200977,200977,200978,0,1,2
57416,5,3,200982,200982,200985,0,3,4
57417,3,1,200985,200985,200986,0,1,0
57418,3,3,200988,200988,200991,0,3,2
57419,2,1,200990,200991,200992,1,2,0
57420,2,3,200992,200992,200995,0,3,0
57421,2,3,200994,200995,200998,1,4,0
57422,1,1,200995,200998,200999,3,4,0
57423,2,3,200997,200999,201002,2,5,0
57424,2,3,200999,201002,201005,3,6,0
57425,4,1,201003,201005,201006,2,3,0
57426,5,2,201008,201008,201010,0,2,2
57427,1,1,201009,201010,201011,1,2,0
57428,3,2,201012,201012,201014,0,2,1
57429,4,1,201016,201016,201017,0,1,2
57430,4,2,201020,201020,201022,0,2,3
57431,1,3,201021,201022,201025,1,4,0
57432,4,3,201025,201025,201028,0,3,0
57433,3,3,201028,201028,201031,0,3,0
57434,6,3,201034,201034,201037,0,3,3
57435,2,3,201036,201037,201040,1,4,0
57436,3,1,201039,201040,201041,1,2,0
57437,2,2,201041,201041,201043,0,2,0
57438,6,1,201047,201047,201048,0,1,4
57439,3,3,201050,201050,201053,0,3,2
57440,3,2,201053,201053,201055,0,2,0
57441,6,3,201059,201059,201062,0,3,4
57442,5,2,201064,201064,201066,0,2,2
57443,5,3,201069,201069,201072,0,3,3
57444,2,1,201071,201072,201073,1,2,0
57445,4,1,201075,201075,201076,0,1,2
57446,1,2,201076,201076,201078,0,2,0
57447,6,3,201082,201082,201085,0,3,4
57448,3,2,201085,201085,201087,0,2,0
57449,2,2,201087,201087,201089,0,2,0
57450,6,2,201093,201093,201095,0,2,4
57451,3,2,201096,201096,201098,0,2,1
57452,2,3,201098,201098,201101,0,3,0
57453,6,1,201104,201104,201105,0,1,3
57454,4,3,201108,201108,201111,0,3,3
57455,5,1,201113,201113,201114,0,1,2
57456,2,2,201115,201115,201117,0,2,1
57457,4,3,201119,201119,201122,0,3,2
57458,3,1,201122,201122,201123,0,1,0
57459,6,1,201128,201128,201129,0,1,5
57460,4,1,201132,201132,201133,0,1,3
57461,3,3,201135,201135,201138,0,3,2
57462,1,2,201136,201138,201140,2,4,0
57463,6,1,201142,201142,201143,0,1,2
57464,3,2,201145,201145,201147,0,2,2
57465,4,2,201149,201149,201151,0,2,2
57466,6,3,201155,201155,201158,0,3,4
57467,5,2,201160,201160,201162,0,2,2
57468,4,3,201164,201164,201167,0,3,2
57469,4,3,201168,201168,201171,0,3,1
57470,2,2,201170,201171,201173,1,3,0
57471,2,1,201172,201173,201174,1,2,0
57472,2,3,201174,201174,201177,0,3,0
57473,6,3,201180,201180,201183,0,3,3
57474,1,2,201181,201183,201185,2,4,0
57475,6,2,201187,201187,201189,0,2,2
57476,3,2,201190,201190,201192,0,2,1
57477,5,1,201195,201195,201196,0,1,3
57478,4,3,201199,201199,201202,0,3,3
57479,4,1,201203,201203,201204,0,1,1
57480,4,1,201207,201207,201208,0,1,3
57481,1,1,201208,201208,201209,0,1,0
57482,3,1,201211,201211,201212,0,1,2
57483,5,2,201216,201216,201218,0,2,4
57484,2,1,201218,201218,201219,0,1,0
57485,2,2,201220,201220,201222,0,2,1
57486,6,2,201226,201226,201228,0,2,4
57487,4,2,201230,201230,201232,0,2,2
57488,1,2,201231,201232,201234,1,3,0
57489,6,1,201237,201237,201238,0,1,3
57490,1,2,201238,201238,201240,0,2,0
57491,2,3,201240,201240,201243,0,3,0
57492,5,2,201245,201245,201247,0,2,2
57493,5,3,201250,201250,201253,0,3,3
57494,4,1,201254,201254,201255,0,1,1
57495,3,2,201257,201257,201259,0,2,2
57496,2,1,201259,201259,201260,0,1,0
57497,4,2,201263,201263,201265,0,2,3
57498,3,3,201266,201266,201269,0,3,1
57499,3,3,201269,201269,201272,0,3,0
57500,5,2,201274,201274,201276,0,2,2
57501,6,3,201280,201280,201283,0,3,4
57502,3,3,201283,201283,201286,0,3,0
57503,5,3,201288,201288,201291,0,3,2
57504,5,1,201293,201293,201294,0,1,2
57505,4,2,201297,201297,201299,0,2,3
57506,4,2,201301,201301,201303,0,2,2
57507,5,2,201306,201306,201308,0,2,3
57508,1,1,201307,201308,201309,1,2,0
57509,3,1,201310,201310,201311,0,1,1
57510,5,2,201315,201315,201317,0,2,4
57511,4,2,201319,201319,201321,0,2,2
57512,6,3,201325,201325,201328,0,3,4
57513,3,3,201328,201328,201331,0,3,0
57514,4,1,201332,201332,201333,0,1,1
57515,6,1,201338,201338,201339,0,1,5
57516,6,3,201344,201344,201347,0,3,5
57517,4,3,201348,201348,201351,0,3,1
57518,4,3,201352,201352,201355,0,3,1
57519,2,1,201354,201355,201356,1,2,0
57520,3,2,201357,201357,201359,0,2,1
57521,2,3,201359,201359,201362,0,3,0
57522,3,1,201362,201362,201363,0,1,0
57523,6,3,201368,201368,201371,0,3,5
57524,4,1,201372,201372,201373,0,1,1
57525,2,1,201374,201374,201375,0,1,1
57526,2,1,201376,201376,201377,0,1,1
57527,5,2,201381,201381,201383,0,2,4
57528,4,3,201385,201385,201388,0,3,2
57529,4,1,201389,201389,201390,0,1,1
57530,6,3,201395,201395,201398,0,3,5
57531,2,1,201397,201398,201399,1,2,0
57532,4,1,201401,201401,201402,0,1,2
57533,6,1,201407,201407,201408,0,1,5
57534,4,2,201411,201411,201413,0,2,3
57535,2,3,201413,201413,201416,0,3,0
57536,3,3,201416,201416,201419,0,3,0
57537,5,1,201421,201421,201422,0,1,2
57538,6,3,201427,201427,201430,0,3,5
57539,1,1,201428,201430,201431,2,3,0
57540,4,1,201432,201432,201433,0,1,1
57541,3,2,201435,201435,201437,0,2,2
57542,4,2,201439,201439,201441,0,2,2
57543,2,1,201441,201441,201442,0,1,0
57544,4,1,201445,201445,201446,0,1,3
57545,6,3,201451,201451,201454,0,3,5
57546,1,1,201452,201454,201455,2,3,0
57547,5,1,201457,201457,201458,0,1,2
57548,5,3,201462,201462,201465,0,3,4
57549,4,2,201466,201466,201468,0,2,1
57550,4,2,201470,201470,201472,0,2,2
57551,4,3,201474,201474,201477,0,3,2
57552,6,3,201480,201480,201483,0,3,3
57553,2,3,201482,201483,201486,1,4,0
57554,4,2,201486,201486,201488,0,2,0
57555,2,3,201488,201488,201491,0,3,0
57556,6,3,201494,201494,201497,0,3,3
57557,5,3,201499,201499,201502,0,3,2
57558,1,1,201500,201502,201503,2,3,0
57559,4,3,201504,201504,201507,0,3,1
57560,2,3,201506,201507,201510,1,4,0
57561,6,2,201512,201512,201514,0,2,2
57562,2,2,201514,201514,201516,0,2,0
57563,5,3,201519,201519,201522,0,3,3
57564,6,2,201525,201525,201527,0,2,3
57565,2,2,201527,201527,201529,0,2,0
57566,6,1,201533,201533,201534,0,1,4
57567,6,2,201539,201539,201541,0,2,5
57568,3,1,201542,201542,201543,0,1,1
57569,1,1,201543,201543,201544,0,1,0
57570,1,1,201544,201544,201545,0,1,0
57571,4,1,201548,201548,201549,0,1,3
57572,1,3,201549,201549,201552,0,3,0
57573,6,1,201555,201555,201556,0,1,3
57574,5,3,201560,201560,201563,0,3,4
57575,5,3,201565,201565,201568,0,3,2
57576,3,1,201568,201568,201569,0,1,0
57577,5,2,201573,201573,201575,0,2,4
57578,4,2,201577,201577,201579,0,2,2
57579,5,1,201582,201582,201583,0,1,3
57580,2,3,201584,201584,201587,0,3,1
57581,6,1,201590,201590,201591,0,1,3
57582,3,2,201593,201593,201595,0,2,2
57583,5,3,201598,201598,201601,0,3,3
57584,2,1,201600,201601,201602,1,2,0
57585,5,3,201605,201605,201608,0,3,3
57586,2,2,201607,201608,201610,1,3,0
57587,4,3,201611,201611,201614,0,3,1
57588,1,3,201612,201614,201617,2,5,0
57589,5,1,201617,201617,201618,0,1,0
57590,3,3,201620,201620,201623,0,3,2
57591,3,3,201623,201623,201626,0,3,0
57592,1,3,201624,201626,201629,2,5,0
57593,3,3,201627,201629,201632,2,5,0
57594,5,1,201632,201632,201633,0,1,0
57595,6,1,201638,201638,201639,0,1,5
57596,5,1,201643,201643,201644,0,1,4
57597,3,2,201646,201646,201648,0,2,2
57598,6,1,201652,201652,201653,0,1,4
57599,6,2,201658,201658,201660,0,2,5
57600,2,3,201660,201660,201663,0,3,0
57601,2,2,201662,201663,201665,1,3,0
57602,5,2,201667,201667,201669,0,2,2
57603,5,1,201672,201672,201673,0,1,3
57604,2,1,201674,201674,201675,0,1,1
57605,5,3,201679,201679,201682,0,3,4
57606,5,3,201684,201684,201687,0,3,2
57607,4,3,201688,201688,201691,0,3,1
57608,5,1,201693,201693,201694,0,1,2
57609,2,2,201695,201695,201697,0,2,1
57610,1,1,201696,201697,201698,1,2,0
57611,5,2,201701,201701,201703,0,2,3
57612,1,2,201702,201703,201705,1,3,0
57613,5,3,201707,201707,201710,0,3,2
57614,1,3,201708,201710,201713,2,5,0
57615,4,3,201712,201713,201716,1,4,0
57616,6,2,201718,201718,201720,0,2,2
57617,4,1,201722,201722,201723,0,1,2
57618,5,2,201727,201727,201729,0,2,4
57619,5,1,201732,201732,201733,0,1,3
57620,3,3,201735,201735,201738,0,3,2
57621,4,2,201739,201739,201741,0,2,1
57622,4,2,201743,201743,201745,0,2,2
57623,6,3,201749,201749,201752,0,3,4
57624,6,3,201755,201755,201758,0,3,3
57625,4,2,201759,201759,201761,0,2,1
57626,4,1,201763,201763,201764,0,1,2
57627,4,2,201767,201767,201769,0,2,3
57628,6,2,201773,201773,201775,0,2,4
57629,3,3,201776,201776,201779,0,3,1
57630,1,3,201777,201779,201782,2,5,0
57631,5,3,201782,201782,201785,0,3,0
57632,2,1,201784,201785,201786,1,2,0
57633,4,3,201788,201788,201791,0,3,2
57634,6,1,201794,201794,201795,0,1,3
57635,4,1,201798,201798,201799,0,1,3
57636,5,3,201803,201803,201806,0,3,4
57637,4,3,201807,201807,201810,0,3,1
57638,3,3,201810,201810,201813,0,3,0
57639,6,3,201816,201816,201819,0,3,3
57640,3,3,201819,201819,201822,0,3,0
57641,4,1,201823,201823,201824,0,1,1
57642,5,1,201828,201828,201829,0,1,4
57643,4,1,201832,201832,201833,0,1,3
57644,1,3,201833,201833,201836,0,3,0
57645,1,2,201834,201836,201838,2,4,0
57646,4,2,201838,201838,201840,0,2,0
57647,3,3,201841,201841,201844,0,3,1
57648,3,3,201844,201844,201847,0,3,0
57649,6,2,201850,201850,201852,0,2,3
57650,6,3,201856,201856,201859,0,3,4
57651,6,3,201862,201862,201865,0,3,3
57652,4,2,201866,201866,201868,0,2,1
57653,5,2,201871,201871,201873,0,2,3
57654,4,1,201875,201875,201876,0,1,2
57655,2,2,201877,201877,201879,0,2,1
57656,1,2,201878,201879,201881,1,3,0
57657,1,3,201879,201881,201884,2,5,0
57658,4,3,201883,201884,201887,1,4,0
57659,3,2,201886,201887,201889,1,3,0
57660,5,3,201891,201891,201894,0,3,2
57661,1,3,201892,201894,201897,2,5,0
57662,6,1,201898,201898,201899,0,1,1
57663,3,1,201901,201901,201902,0,1,2
57664,4,3,201905,201905,201908,0,3,3
57665,1,2,201906,201908,201910,2,4,0
57666,4,1,201910,201910,201911,0,1,0
57667,6,1,201916,201916,201917,0,1,5
57668,1,1,201917,201917,201918,0,1,0
57669,2,1,201919,201919,201920,0,1,1
57670,2,2,201921,201921,201923,0,2,1
57671,3,3,201924,201924,201927,0,3,1
57672,2,3,201926,201927,201930,1,4,0
57673,5,1,201931,201931,201932,0,1,1
57674,2,2,201933,201933,201935,0,2,1
57675,1,2,201934,201935,201937,1,3,0
57676,4,3,201938,201938,201941,0,3,1
57677,5,2,201943,201943,201945,0,2,2
57678,4,2,201947,201947,201949,0,2,2
57679,6,2,201953,201953,201955,0,2,4
57680,1,3,201954,201955,201958,1,4,0
57681,3,2,201957,201958,201960,1,3,0
57682,6,3,201963,201963,201966,0,3,3
57683,3,2,201966,201966,201968,0,2,0
57684,3,2,201969,201969,201971,0,2,1
57685,6,3,201975,201975,201978,0,3,4
57686,3,3,201978,201978,201981,0,3,0
57687,2,3,201980,201981,201984,1,4,0
57688,5,1,201985,201985,201986,0,1,1
57689,1,1,201986,201986,201987,0,1,0
57690,3,1,201989,201989,201990,0,1,2
57691,4,1,201993,201993,201994,0,1,3
57692,2,1,201995,201995,201996,0,1,1
57693,4,2,201999,201999,202001,0,2,3
57694,1,3,202000,202001,202004,1,4,0
57695,2,1,202002,202004,202005,2,3,0
57696,1,1,202003,202005,202006,2,3,0
57697,5,2,202008,202008,202010,0,2,2
57698,5,3,202013,202013,202016,0,3,3
57699,6,2,202019,202019,202021,0,2,3
57700,4,2,202023,202023,202025,0,2,2
57701,5,2,202028,202028,202030,0,2,3
57702,2,2,202030,202030,202032,0,2,0
57703,3,2,202033,202033,202035,0,2,1
57704,2,1,202035,202035,202036,0,1,0
57705,4,1,202039,202039,202040,0,1,3
57706,2,2,202041,202041,202043,0,2,1
57707,3,1,202044,202044,202045,0,1,1
57708,5,2,202049,202049,202051,0,2,4
57709,2,3,202051,202051,202054,0,3,0
57710,6,3,202057,202057,202060,0,3,3
57711,5,3,202062,202062,202065,0,3,2
57712,2,3,202064,202065,202068,1,4,0
57713,2,1,202066,202068,202069,2,3,0
57714,5,2,202071,202071,202073,0,2,2
57715,5,2,202076,202076,202078,0,2,3
57716,4,2,202080,202080,202082,0,2,2
57717,6,2,202086,202086,202088,0,2,4
57718,5,2,202091,202091,202093,0,2,3
57719,2,2,202093,202093,202095,0,2,0
57720,1,3,202094,202095,202098,1,4,0
57721,1,3,202095,202098,202101,3,6,0
57722,3,1,202098,202101,202102,3,4,0
57723,1,3,202099,202102,202105,3,6,0
57724,1,1,202100,202105,202106,5,6,0
57725,4,1,202104,202106,202107,2,3,0
57726,6,2,202110,202110,202112,0,2,3
57727,4,3,202114,202114,202117,0,3,2
57728,1,1,202115,202117,202118,2,3,0
57729,5,3,202120,202120,202123,0,3,2
57730,5,3,202125,202125,202128,0,3,2
57731,4,2,202129,202129,202131,0,2,1
57732,4,1,202133,202133,202134,0,1,2
57733,6,3,202139,202139,202142,0,3,5
57734,4,3,202143,202143,202146,0,3,1
57735,5,3,202148,202148,202151,0,3,2
57736,2,3,202150,202151,202154,1,4,0
57737,4,3,202154,202154,202157,0,3,0
57738,3,3,202157,202157,202160,0,3,0
57739,5,2,202162,202162,202164,0,2,2
57740,4,1,202166,202166,202167,0,1,2
57741,6,1,202172,202172,202173,0,1,5
57742,3,3,202175,202175,202178,0,3,2
57743,6,2,202181,202181,202183,0,2,3
57744,5,2,202186,202186,202188,0,2,3
57745,1,1,202187,202188,202189,1,2,0
57746,6,1,202193,202193,202194,0,1,4
57747,2,3,202195,202195,202198,0,3,1
57748,6,1,202201,202201,202202,0,1,3
57749,5,3,202206,202206,202209,0,3,4
57750,1,2,202207,202209,202211,2,4,0
57751,4,2,202211,202211,202213,0,2,0
57752,4,3,202215,202215,202218,0,3,2
57753,1,2,202216,202218,202220,2,4,0
57754,3,3,202219,202220,202223,1,4,0
57755,5,3,202224,202224,202227,0,3,1
57756,2,3,202226,202227,202230,1,4,0
57757,4,3,202230,202230,202233,0,3,0
57758,5,2,202235,202235,202237,0,2,2
57759,4,3,202239,202239,202242,0,3,2
57760,1,2,202240,202242,202244,2,4,0
57761,3,3,202243,202244,202247,1,4,0
57762,2,1,202245,202247,202248,2,3,0
57763,2,2,202247,202248,202250,1,3,0
57764,2,1,202249,202250,202251,1,2,0
57765,4,3,202253,202253,202256,0,3,2
57766,5,1,202258,202258,202259,0,1,2
57767,3,2,202261,202261,202263,0,2,2
57768,2,1,202263,202263,202264,0,1,0
57769,4,1,202267,202267,202268,0,1,3
57770,2,1,202269,202269,202270,0,1,1
57771,6,2,202275,202275,202277,0,2,5
57772,1,1,202276,202277,202278,1,2,0
57773,5,1,202281,202281,202282,0,1,3
57774,2,1,202283,202283,202284,0,1,1
57775,5,1,202288,202288,202289,0,1,4
57776,2,3,202290,202290,202293,0,3,1
57777,4,2,202294,202294,202296,0,2,1
57778,6,1,202300,202300,202301,0,1,4
57779,4,2,202304,202304,202306,0,2,3
57780,1,2,202305,202306,202308,1,3,0
57781,2,3,202307,202308,202311,1,4,0
57782,2,2,202309,202311,202313,2,4,0
57783,6,1,202315,202315,202316,0,1,2
57784,2,1,202317,202317,202318,0,1,1
57785,3,2,202320,202320,202322,0,2,2
57786,3,3,202323,202323,202326,0,3,1
57787,1,2,202324,202326,202328,2,4,0
57788,4,3,202328,202328,202331,0,3,0
57789,1,1,202329,202331,202332,2,3,0
57790,4,1,202333,202333,202334,0,1,1
57791,1,2,202334,202334,202336,0,2,0
57792,2,2,202336,202336,202338,0,2,0
57793,1,1,202337,202338,202339,1,2,0
57794,3,1,202340,202340,202341,0,1,1
57795,1,2,202341,202341,202343,0,2,0
57796,4,1,202345,202345,202346,0,1,2
57797,1,2,202346,202346,202348,0,2,0
57798,4,2,202350,202350,202352,0,2,2
57799,4,1,202354,202354,202355,0,1,2
57800,1,2,202355,202355,202357,0,2,0
57801,2,2,202357,202357,202359,0,2,0
57802,2,2,202359,202359,202361,0,2,0
57803,4,2,202363,202363,202365,0,2,2
57804,5,3,202368,202368,202371,0,3,3
57805,4,2,202372,202372,202374,0,2,1
57806,2,1,202374,202374,202375,0,1,0
57807,2,2,202376,202376,202378,0,2,1
57808,2,3,202378,202378,202381,0,3,0
57809,5,2,202383,202383,202385,0,2,2
57810,4,3,202387,202387,202390,0,3,2
57811,2,1,202389,202390,202391,1,2,0
57812,1,1,202390,202391,202392,1,2,0
57813,2,2,202392,202392,202394,0,2,0
57814,3,1,202395,202395,202396,0,1,1
57815,6,2,202401,202401,202403,0,2,5
57816,5,3,202406,202406,202409,0,3,3
57817,2,3,202408,202409,202412,1,4,0
57818,4,2,202412,202412,202414,0,2,0
57819,3,3,202415,202415,202418,0,3,1
57820,4,2,202419,202419,202421,0,2,1
57821,4,3,202423,202423,202426,0,3,2
57822,4,2,202427,202427,202429,0,2,1
57823,3,3,202430,202430,202433,0,3,1
57824,6,2,202436,202436,202438,0,2,3
57825,5,2,202441,202441,202443,0,2,3
57826,4,1,202445,202445,202446,0,1,2
57827,3,3,202448,202448,202451,0,3,2
57828,1,1,202449,202451,202452,2,3,0
57829,3,1,202452,202452,202453,0,1,0
57830,3,3,202455,202455,202458,0,3,2
57831,6,3,202461,202461,202464,0,3,3
57832,3,3,202464,202464,202467,0,3,0
57833,3,3,202467,202467,202470,0,3,0
57834,3,2,202470,202470,202472,0,2,0
57835,4,2,202474,202474,202476,0,2,2
57836,4,3,202478,202478,202481,0,3,2
57837,1,3,202479,202481,202484,2,5,0
57838,2,2,202481,202484,202486,3,5,0
57839,2,3,202483,202486,202489,3,6,0
57840,5,3,202488,202489,202492,1,4,0
57841,2,1,202490,202492,202493,2,3,0
57842,4,3,202494,202494,202497,0,3,1
57843,4,3,202498,202498,202501,0,3,1
57844,3,3,202501,202501,202504,0,3,0
57845,3,3,202504,202504,202507,0,3,0
57846,3,3,202507,202507,202510,0,3,0
57847,5,3,202512,202512,202515,0,3,2
57848,1,1,202513,202515,202516,2,3,0
57849,1,2,202514,202516,202518,2,4,0
57850,3,3,202517,202518,202521,1,4,0
57851,1,1,202518,202521,202522,3,4,0
57852,5,3,202523,202523,202526,0,3,1
57853,5,3,202528,202528,202531,0,3,2
57854,6,2,202534,202534,202536,0,2,3
57855,6,1,202540,202540,202541,0,1,4
57856,4,3,202544,202544,202547,0,3,3
57857,1,2,202545,202547,202549,2,4,0
57858,3,3,202548,202549,202552,1,4,0
57859,4,1,202552,202552,202553,0,1,0
57860,2,1,202554,202554,202555,0,1,1
57861,6,1,202560,202560,202561,0,1,5
57862,3,1,202563,202563,202564,0,1,2
57863,3,3,202566,202566,202569,0,3,2
57864,4,3,202570,202570,202573,0,3,1
57865,1,2,202571,202573,202575,2,4,0
57866,3,1,202574,202575,202576,1,2,0
57867,4,3,202578,202578,202581,0,3,2
57868,3,1,202581,202581,202582,0,1,0
57869,5,3,202586,202586,202589,0,3,4
57870,2,1,202588,202589,202590,1,2,0
57871,3,3,202591,202591,202594,0,3,1
57872,4,1,202595,202595,202596,0,1,1
57873,4,3,202599,202599,202602,0,3,3
57874,1,3,202600,202602,202605,2,5,0
57875,1,3,202601,202605,202608,4,7,0
57876,5,1,202606,202608,202609,2,3,0
57877,4,1,202610,202610,202611,0,1,1
57878,6,1,202616,202616,202617,0,1,5
57879,6,2,202622,202622,202624,0,2,5
57880,4,1,202626,202626,202627,0,1,2
57881,5,3,202631,202631,202634,0,3,4
57882,6,3,202637,202637,202640,0,3,3
57883,5,2,202642,202642,202644,0,2,2
57884,4,2,202646,202646,202648,0,2,2
57885,5,1,202651,202651,202652,0,1,3
57886,3,2,202654,202654,202656,0,2,2
57887,1,1,202655,202656,202657,1,2,0
57888,5,3,202660,202660,202663,0,3,3
57889,6,3,202666,202666,202669,0,3,3
57890,2,2,202668,202669,202671,1,3,0
57891,1,1,202669,202671,202672,2,3,0
57892,6,1,202675,202675,202676,0,1,3
57893,5,3,202680,202680,202683,0,3,4
57894,5,2,202685,202685,202687,0,2,2
57895,5,3,202690,202690,202693,0,3,3
57896,5,1,202695,202695,202696,0,1,2
57897,4,2,202699,202699,202701,0,2,3
57898,1,2,202700,202701,202703,1,3,0
57899,6,3,202706,202706,202709,0,3,3
57900,6,1,202712,202712,202713,0,1,3
57901,5,2,202717,202717,202719,0,2,4
57902,3,3,202720,202720,202723,0,3,1
57903,3,3,202723,202723,202726,0,3,0
57904,4,1,202727,202727,202728,0,1,1
57905,2,2,202729,202729,202731,0,2,1
57906,4,1,202733,202733,202734,0,1,2
57907,4,3,202737,202737,202740,0,3,3
57908,1,3,202738,202740,202743,2,5,0
57909,3,2,202741,202743,202745,2,4,0
57910,6,3,202747,202747,202750,0,3,2
57911,2,1,202749,202750,202751,1,2,0
57912,3,2,202752,202752,202754,0,2,1
57913,2,3,202754,202754,202757,0,3,0
57914,2,3,202756,202757,202760,1,4,0
57915,3,3,202759,202760,202763,1,4,0
57916,2,3,202761,202763,202766,2,5,0
57917,4,3,202765,202766,202769,1,4,0
57918,1,2,202766,202769,202771,3,5,0
57919,6,2,202772,202772,202774,0,2,1
57920,3,1,202775,202775,202776,0,1,1
57921,1,3,202776,202776,202779,0,3,0
57922,3,3,202779,202779,202782,0,3,0
57923,1,2,202780,202782,202784,2,4,0
57924,2,3,202782,202784,202787,2,5,0
57925,5,2,202787,202787,202789,0,2,0
57926,4,1,202791,202791,202792,0,1,2
57927,5,3,202796,202796,202799,0,3,4
57928,6,1,202802,202802,202803,0,1,3
57929,5,1,202807,202807,202808,0,1,4
57930,4,2,202811,202811,202813,0,2,3
57931,2,2,202813,202813,202815,0,2,0
57932,4,3,202817,202817,202820,0,3,2
57933,3,3,202820,202820,202823,0,3,0
57934,2,2,202822,202823,202825,1,3,0
57935,2,3,202824,202825,202828,1,4,0
57936,3,1,202827,202828,202829,1,2,0
57937,1,1,202828,202829,202830,1,2,0
57938,4,1,202832,202832,202833,0,1,2
57939,6,3,202838,202838,202841,0,3,5
57940,5,3,202843,202843,202846,0,3,2
57941,2,3,202845,202846,202849,1,4,0
57942,2,2,202847,202849,202851,2,4,0
57943,4,3,202851,202851,202854,0,3,0
57944,6,1,202857,202857,202858,0,1,3
57945,6,2,202863,202863,202865,0,2,5
57946,3,1,202866,202866,202867,0,1,1
57947,6,1,202872,202872,202873,0,1,5
57948,1,1,202873,202873,202874,0,1,0
57949,3,1,202876,202876,202877,0,1,2
57950,1,1,202877,202877,202878,0,1,0
57951,4,2,202881,202881,202883,0,2,3
57952,2,2,202883,202883,202885,0,2,0
57953,5,1,202888,202888,202889,0,1,3
57954,2,2,202890,202890,202892,0,2,1
57955,6,2,202896,202896,202898,0,2,4
57956,4,2,202900,202900,202902,0,2,2
57957,3,3,202903,202903,202906,0,3,1
57958,1,2,202904,202906,202908,2,4,0
57959,5,2,202909,202909,202911,0,2,1
57960,3,3,202912,202912,202915,0,3,1
57961,2,3,202914,202915,202918,1,4,0
57962,3,3,202917,202918,202921,1,4,0
57963,5,2,202922,202922,202924,0,2,1
57964,1,3,202923,202924,202927,1,4,0
57965,4,3,202927,202927,202930,0,3,0
57966,6,1,202933,202933,202934,0,1,3
57967,1,1,202934,202934,202935,0,1,0
57968,1,3,202935,202935,202938,0,3,0
57969,6,2,202941,202941,202943,0,2,3
57970,5,2,202946,202946,202948,0,2,3
57971,4,1,202950,202950,202951,0,1,2
57972,3,2,202953,202953,202955,0,2,2
57973,5,1,202958,202958,202959,0,1,3
57974,3,1,202961,202961,202962,0,1,2
57975,4,2,202965,202965,202967,0,2,3
57976,4,1,202969,202969,202970,0,1,2
57977,5,1,202974,202974,202975,0,1,4
57978,2,2,202976,202976,202978,0,2,1
57979,5,3,202981,202981,202984,0,3,3
57980,1,1,202982,202984,202985,2,3,0
57981,4,3,202986,202986,202989,0,3,1
57982,1,1,202987,202989,202990,2,3,0
57983,5,1,202992,202992,202993,0,1,2
57984,4,3,202996,202996,202999,0,3,3
57985,1,3,202997,202999,203002,2,5,0
57986,6,3,203003,203003,203006,0,3,1
57987,4,3,203007,203007,203010,0,3,1
57988,4,1,203011,203011,203012,0,1,1
57989,6,2,203017,203017,203019,0,2,5
57990,4,3,203021,203021,203024,0,3,2
57991,2,1,203023,203024,203025,1,2,0
57992,6,2,203029,203029,203031,0,2,4
57993,5,1,203034,203034,203035,0,1,3
57994,5,1,203039,203039,203040,0,1,4
57995,5,2,203044,203044,203046,0,2,4
57996,1,1,203045,203046,203047,1,2,0
57997,1,2,203046,203047,203049,1,3,0
57998,2,1,203048,203049,203050,1,2,0
57999,5,2,203053,203053,203055,0,2,3
58000,3,3,203056,203056,203059,0,3,1
58001,3,3,203059,203059,203062,0,3,0
58002,6,1,203065,203065,203066,0,1,3
58003,3,2,203068,203068,203070,0,2,2
58004,3,2,203071,203071,203073,0,2,1
58005,1,1,203072,203073,203074,1,2,0
58006,1,1,203073,203074,203075,1,2,0
58007,6,1,203079,203079,203080,0,1,4
58008,4,2,203083,203083,203085,0,2,3
58009,1,1,203084,203085,203086,1,2,0
58010,2,1,203086,203086,203087,0,1,0
58011,1,1,203087,203087,203088,0,1,0
58012,3,2,203090,203090,203092,0,2,2
58013,4,2,203094,203094,203096,0,2,2
58014,6,3,203100,203100,203103,0,3,4
58015,4,3,203104,203104,203107,0,3,1
58016,4,1,203108,203108,203109,0,1,1
58017,5,3,203113,203113,203116,0,3,4
58018,2,1,203115,203116,203117,1,2,0
58019,6,1,203121,203121,203122,0,1,4
58020,2,2,203123,203123,203125,0,2,1
58021,4,2,203127,203127,203129,0,2,2
58022,2,1,203129,203129,203130,0,1,0
58023,1,3,203130,203130,203133,0,3,0
58024,6,1,203136,203136,203137,0,1,3
58025,5,3,203141,203141,203144,0,3,4
58026,1,2,203142,203144,203146,2,4,0
58027,6,3,203148,203148,203151,0,3,2
58028,3,3,203151,203151,203154,0,3,0
58029,3,3,203154,203154,203157,0,3,0
58030,5,2,203159,203159,203161,0,2,2
58031,3,3,203162,203162,203165,0,3,1
58032,2,3,203164,203165,203168,1,4,0
58033,6,2,203170,203170,203172,0,2,2
58034,4,1,203174,203174,203175,0,1,2
58035,5,1,203179,203179,203180,0,1,4
58036,6,1,203185,203185,203186,0,1,5
58037,5,3,203190,203190,203193,0,3,4
58038,4,3,203194,203194,203197,0,3,1
58039,3,2,203197,203197,203199,0,2,0
58040,6,2,203203,203203,203205,0,2,4
58041,4,1,203207,203207,203208,0,1,2
58042,5,3,203212,203212,203215,0,3,4
58043,4,3,203216,203216,203219,0,3,1
58044,4,3,203220,203220,203223,0,3,1
58045,6,3,203226,203226,203229,0,3,3
58046,6,1,203232,203232,203233,0,1,3
58047,2,1,203234,203234,203235,0,1,1
58048,6,1,203240,203240,203241,0,1,5
58049,3,3,203243,203243,203246,0,3,2
58050,2,2,203245,203246,203248,1,3,0
58051,1,3,203246,203248,203251,2,5,0
58052,6,3,203252,203252,203255,0,3,1
58053,4,3,203256,203256,203259,0,3,1
58054,2,2,203258,203259,203261,1,3,0
58055,3,3,203261,203261,203264,0,3,0
58056,6,3,203267,203267,203270,0,3,3
58057,1,3,203268,203270,203273,2,5,0
58058,4,2,203272,203273,203275,1,3,0
58059,5,3,203277,203277,203280,0,3,2
58060,6,2,203283,203283,203285,0,2,3
58061,3,1,203286,203286,203287,0,1,1
58062,3,1,203289,203289,203290,0,1,2
58063,4,1,203293,203293,203294,0,1,3
58064,1,1,203294,203294,203295,0,1,0
58065,5,1,203299,203299,203300,0,1,4
58066,2,2,203301,203301,203303,0,2,1
58067,3,3,203304,203304,203307,0,3,1
58068,4,2,203308,203308,203310,0,2,1
58069,2,3,203310,203310,203313,0,3,0
58070,6,3,203316,203316,203319,0,3,3
58071,3,2,203319,203319,203321,0,2,0
58072,1,1,203320,203321,203322,1,2,0
58073,5,1,203325,203325,203326,0,1,3
58074,1,1,203326,203326,203327,0,1,0
58075,4,2,203330,203330,203332,0,2,3
58076,1,2,203331,203332,203334,1,3,0
58077,1,3,203332,203334,203337,2,5,0
58078,2,3,203334,203337,203340,3,6,0
58079,2,3,203336,203340,203343,4,7,0
58080,3,2,203339,203343,203345,4,6,0
58081,3,2,203342,203345,203347,3,5,0
58082,5,3,203347,203347,203350,0,3,0
58083,2,3,203349,203350,203353,1,4,0
58084,1,1,203350,203353,203354,3,4,0
58085,1,3,203351,203354,203357,3,6,0
58086,6,1,203357,203357,203358,0,1,0
58087,5,1,203362,203362,203363,0,1,4
58088,5,1,203367,203367,203368,0,1,4
58089,1,2,203368,203368,203370,0,2,0
58090,3,1,203371,203371,203372,0,1,1
58091,6,3,203377,203377,203380,0,3,5
58092,3,3,203380,203380,203383,0,3,0
58093,4,3,203384,203384,203387,0,3,1
58094,2,3,203386,203387,203390,1,4,0
58095,3,1,203389,203390,203391,1,2,0
58096,2,1,203391,203391,203392,0,1,0
58097,1,3,203392,203392,203395,0,3,0
58098,2,2,203394,203395,203397,1,3,0
58099,6,2,203400,203400,203402,0,2,3
58100,3,3,203403,203403,203406,0,3,1
58101,4,3,203407,203407,203410,0,3,1
58102,4,1,203411,203411,203412,0,1,1
58103,2,2,203413,203413,203415,0,2,1
58104,6,2,203419,203419,203421,0,2,4
58105,2,1,203421,203421,203422,0,1,0
58106,1,3,203422,203422,203425,0,3,0
58107,4,1,203426,203426,203427,0,1,1
58108,1,2,203427,203427,203429,0,2,0
58109,5,3,203432,203432,203435,0,3,3
58110,6,2,203438,203438,203440,0,2,3
58111,6,3,203444,203444,203447,0,3,4
58112,6,1,203450,203450,203451,0,1,3
58113,2,1,203452,203452,203453,0,1,1
58114,5,2,203457,203457,203459,0,2,4
58115,6,1,203463,203463,203464,0,1,4
58116,6,2,203469,203469,203471,0,2,5
58117,3,1,203472,203472,203473,0,1,1
58118,5,2,203477,203477,203479,0,2,4
58119,6,2,203483,203483,203485,0,2,4
58120,6,3,203489,203489,203492,0,3,4
58121,2,1,203491,203492,203493,1,2,0
58122,1,2,203492,203493,203495,1,3,0
58123,2,2,203494,203495,203497,1,3,0
58124,5,3,203499,203499,203502,0,3,2
58125,4,3,203503,203503,203506,0,3,1
58126,1,1,203504,203506,203507,2,3,0
58127,5,3,203509,203509,203512,0,3,2
58128,4,2,203513,203513,203515,0,2,1
58129,5,2,203518,203518,203520,0,2,3
58130,5,3,203523,203523,203526,0,3,3
58131,6,2,203529,203529,203531,0,2,3
58132,5,3,203534,203534,203537,0,3,3
58133,5,3,203539,203539,203542,0,3,2
58134,1,1,203540,203542,203543,2,3,0
58135,2,1,203542,203543,203544,1,2,0
58136,6,3,203548,203548,203551,0,3,4
58137,4,1,203552,203552,203553,0,1,1
58138,3,1,203555,203555,203556,0,1,2
58139,6,2,203561,203561,203563,0,2,5
58140,5,1,203566,203566,203567,0,1,3
58141,4,2,203570,203570,203572,0,2,3
58142,2,3,203572,203572,203575,0,3,0
58143,2,3,203574,203575,203578,1,4,0
58144,6,1,203580,203580,203581,0,1,2
58145,3,3,203583,203583,203586,0,3,2
58146,4,3,203587,203587,203590,0,3,1
58147,1,2,203588,203590,203592,2,4,0
58148,5,2,203593,203593,203595,0,2,1
58149,6,2,203599,203599,203601,0,2,4
58150,5,2,203604,203604,203606,0,2,3
58151,2,1,203606,203606,203607,0,1,0
58152,1,3,203607,203607,203610,0,3,0
58153,2,1,203609,203610,203611,1,2,0
58154,5,3,203614,203614,203617,0,3,3
58155,2,2,203616,203617,203619,1,3,0
58156,2,3,203618,203619,203622,1,4,0
58157,3,1,203621,203622,203623,1,2,0
58158,6,3,203627,203627,203630,0,3,4
58159,6,2,203633,203633,203635,0,2,3
58160,1,2,203634,203635,203637,1,3,0
58161,3,1,203637,203637,203638,0,1,0
58162,2,3,203639,203639,203642,0,3,1
58163,6,2,203645,203645,203647,0,2,3
58164,2,3,203647,203647,203650,0,3,0
58165,3,3,203650,203650,203653,0,3,0
58166,5,2,203655,203655,203657,0,2,2
58167,2,2,203657,203657,203659,0,2,0
58168,5,3,203662,203662,203665,0,3,3
58169,5,2,203667,203667,203669,0,2,2
58170,6,1,203673,203673,203674,0,1,4
58171,2,2,203675,203675,203677,0,2,1
58172,3,2,203678,203678,203680,0,2,1
58173,4,2,203682,203682,203684,0,2,2
58174,6,1,203688,203688,203689,0,1,4
58175,2,3,203690,203690,203693,0,3,1
58176,4,1,203694,203694,203695,0,1,1
58177,1,1,203695,203695,203696,0,1,0
58178,6,2,203701,203701,203703,0,2,5
58179,4,3,203705,203705,203708,0,3,2
58180,6,2,203711,203711,203713,0,2,3
58181,4,1,203715,203715,203716,0,1,2
58182,3,2,203718,203718,203720,0,2,2
58183,3,1,203721,203721,203722,0,1,1
58184,4,3,203725,203725,203728,0,3,3
58185,1,2,203726,203728,203730,2,4,0
58186,5,2,203731,203731,203733,0,2,1
58187,1,3,203732,203733,203736,1,4,0
58188,4,3,203736,203736,203739,0,3,0
58189,3,1,203739,203739,203740,0,1,0
58190,6,2,203745,203745,203747,0,2,5
58191,1,2,203746,203747,203749,1,3,0
58192,6,3,203752,203752,203755,0,3,3
58193,3,2,203755,203755,203757,0,2,0
58194,1,2,203756,203757,203759,1,3,0
58195,4,1,203760,203760,203761,0,1,1
58196,5,3,203765,203765,203768,0,3,4
58197,6,3,203771,203771,203774,0,3,3
58198,2,1,203773,203774,203775,1,2,0
58199,3,3,203776,203776,203779,0,3,1
58200,6,1,203782,203782,203783,0,1,3
58201,3,2,203785,203785,203787,0,2,2
58202,1,3,203786,203787,203790,1,4,0
58203,2,1,203788,203790,203791,2,3,0
58204,6,3,203794,203794,203797,0,3,3
58205,4,2,203798,203798,203800,0,2,1
58206,5,1,203803,203803,203804,0,1,3
58207,4,3,203807,203807,203810,0,3,3
58208,6,1,203813,203813,203814,0,1,3
58209,3,3,203816,203816,203819,0,3,2
58210,1,3,203817,203819,203822,2,5,0
58211,5,1,203822,203822,203823,0,1,0
58212,1,2,203823,203823,203825,0,2,0
58213,6,1,203829,203829,203830,0,1,4
58214,2,1,203831,203831,203832,0,1,1
58215,4,1,203835,203835,203836,0,1,3
58216,4,3,203839,203839,203842,0,3,3
58217,3,3,203842,203842,203845,0,3,0
58218,3,2,203845,203845,203847,0,2,0
58219,4,3,203849,203849,203852,0,3,2
58220,3,1,203852,203852,203853,0,1,0
58221,2,3,203854,203854,203857,0,3,1
58222,3,1,203857,203857,203858,0,1,0
58223,5,3,203862,203862,203865,0,3,4
58224,5,2,203867,203867,203869,0,2,2
58225,6,3,203873,203873,203876,0,3,4
58226,3,1,203876,203876,203877,0,1,0
58227,1,1,203877,203877,203878,0,1,0
58228,1,2,203878,203878,203880,0,2,0
58229,1,1,203879,203880,203881,1,2,0
58230,6,3,203885,203885,203888,0,3,4
58231,2,2,203887,203888,203890,1,3,0
58232,4,2,203891,203891,203893,0,2,1
58233,4,3,203895,203895,203898,0,3,2
58234,5,1,203900,203900,203901,0,1,2
58235,6,1,203906,203906,203907,0,1,5
58236,5,1,203911,203911,203912,0,1,4
58237,3,3,203914,203914,203917,0,3,2
58238,6,2,203920,203920,203922,0,2,3
58239,4,2,203924,203924,203926,0,2,2
58240,1,2,203925,203926,203928,1,3,0
58241,1,2,203926,203928,203930,2,4,0
58242,2,2,203928,203930,203932,2,4,0
58243,2,2,203930,203932,203934,2,4,0
58244,1,2,203931,203934,203936,3,5,0
58245,3,3,203934,203936,203939,2,5,0
58246,6,1,203940,203940,203941,0,1,1
58247,5,2,203945,203945,203947,0,2,4
58248,4,2,203949,203949,203951,0,2,2
58249,3,3,203952,203952,203955,0,3,1
58250,2,1,203954,203955,203956,1,2,0
58251,6,2,203960,203960,203962,0,2,4
58252,1,3,203961,203962,203965,1,4,0
58253,2,3,203963,203965,203968,2,5,0
58254,2,2,203965,203968,203970,3,5,0
58255,2,1,203967,203970,203971,3,4,0
58256,5,1,203972,203972,203973,0,1,1
58257,6,2,203978,203978,203980,0,2,5
58258,3,3,203981,203981,203984,0,3,1
58259,2,1,203983,203984,203985,1,2,0
58260,4,3,203987,203987,203990,0,3,2
58261,1,2,203988,203990,203992,2,4,0
58262,2,2,203990,203992,203994,2,4,0
58263,1,2,203991,203994,203996,3,5,0
58264,4,2,203995,203996,203998,1,3,0
58265,3,3,203998,203998,204001,0,3,0
58266,1,3,203999,204001,204004,2,5,0
58267,6,3,204005,204005,204008,0,3,1
58268,6,2,204011,204011,204013,0,2,3
58269,2,3,204013,204013,204016,0,3,0
58270,2,1,204015,204016,204017,1,2,0
58271,1,3,204016,204017,204020,1,4,0
58272,4,3,204020,204020,204023,0,3,0
58273,4,1,204024,204024,204025,0,1,1
58274,3,3,204027,204027,204030,0,3,2
58275,6,2,204033,204033,204035,0,2,3
58276,1,1,204034,204035,204036,1,2,0
58277,3,1,204037,204037,204038,0,1,1
58278,4,3,204041,204041,204044,0,3,3
58279,5,2,204046,204046,204048,0,2,2
58280,2,1,204048,204048,204049,0,1,0
58281,3,2,204051,204051,204053,0,2,2
58282,4,2,204055,204055,204057,0,2,2
58283,2,2,204057,204057,204059,0,2,0
58284,2,1,204059,204059,204060,0,1,0
58285,1,1,204060,204060,204061,0,1,0
58286,4,1,204064,204064,204065,0,1,3
58287,3,3,204067,204067,204070,0,3,2
58288,5,1,204072,204072,204073,0,1,2
58289,3,1,204075,204075,204076,0,1,2
58290,6,2,204081,204081,204083,0,2,5
58291,6,3,204087,204087,204090,0,3,4
58292,4,3,204091,204091,204094,0,3,1
58293,3,3,204094,204094,204097,0,3,0
58294,6,3,204100,204100,204103,0,3,3
58295,2,2,204102,204103,204105,1,3,0
58296,6,2,204108,204108,204110,0,2,3
58297,2,1,204110,204110,204111,0,1,0
58298,6,3,204116,204116,204119,0,3,5
58299,1,2,204117,204119,204121,2,4,0
58300,4,1,204121,204121,204122,0,1,0
58301,6,3,204127,204127,204130,0,3,5
58302,1,1,204128,204130,204131,2,3,0
58303,3,1,204131,204131,204132,0,1,0
58304,3,1,204134,204134,204135,0,1,2
58305,6,1,204140,204140,204141,0,1,5
58306,5,2,204145,204145,204147,0,2,4
58307,6,1,204151,204151,204152,0,1,4
58308,6,1,204157,204157,204158,0,1,5
58309,5,3,204162,204162,204165,0,3,4
58310,4,3,204166,204166,204169,0,3,1
58311,2,1,204168,204169,204170,1,2,0
58312,6,2,204174,204174,204176,0,2,4
58313,5,1,204179,204179,204180,0,1,3
58314,4,1,204183,204183,204184,0,1,3
58315,6,2,204189,204189,204191,0,2,5
58316,5,2,204194,204194,204196,0,2,3
58317,2,2,204196,204196,204198,0,2,0
58318,1,2,204197,204198,204200,1,3,0
58319,6,3,204203,204203,204206,0,3,3
58320,6,1,204209,204209,204210,0,1,3
58321,4,1,204213,204213,204214,0,1,3
58322,2,3,204215,204215,204218,0,3,1
58323,2,3,204217,204218,204221,1,4,0
58324,5,3,204222,204222,204225,0,3,1
58325,1,1,204223,204225,204226,2,3,0
58326,1,3,204224,204226,204229,2,5,0
58327,2,2,204226,204229,204231,3,5,0
58328,5,3,204231,204231,204234,0,3,0
58329,4,3,204235,204235,204238,0,3,1
58330,6,3,204241,204241,204244,0,3,3
58331,4,2,204245,204245,204247,0,2,1
58332,6,1,204251,204251,204252,0,1,4
58333,5,1,204256,204256,204257,0,1,4
58334,1,3,204257,204257,204260,0,3,0
58335,3,3,204260,204260,204263,0,3,0
58336,2,2,204262,204263,204265,1,3,0
58337,2,1,204264,204265,204266,1,2,0
58338,4,1,204268,204268,204269,0,1,2
58339,6,2,204274,204274,204276,0,2,5
58340,5,1,204279,204279,204280,0,1,3
58341,3,1,204282,204282,204283,0,1,2
58342,6,3,204288,204288,204291,0,3,5
58343,5,2,204293,204293,204295,0,2,2
58344,1,2,204294,204295,204297,1,3,0
58345,3,1,204297,204297,204298,0,1,0
58346,6,1,204303,204303,204304,0,1,5
58347,1,1,204304,204304,204305,0,1,0
58348,5,1,204309,204309,204310,0,1,4
58349,3,3,204312,204312,204315,0,3,2
58350,3,3,204315,204315,204318,0,3,0
58351,6,3,204321,204321,204324,0,3,3
58352,4,1,204325,204325,204326,0,1,1
58353,6,2,204331,204331,204333,0,2,5
58354,3,3,204334,204334,204337,0,3,1
58355,2,3,204336,204337,204340,1,4,0
58356,4,2,204340,204340,204342,0,2,0
58357,3,1,204343,204343,204344,0,1,1
58358,4,2,204347,204347,204349,0,2,3
58359,2,1,204349,204349,204350,0,1,0
58360,5,2,204354,204354,204356,0,2,4
58361,4,2,204358,204358,204360,0,2,2
58362,1,2,204359,204360,204362,1,3,0
58363,3,1,204362,204362,204363,0,1,0
58364,5,1,204367,204367,204368,0,1,4
58365,1,1,204368,204368,204369,0,1,0
58366,3,1,204371,204371,204372,0,1,2
58367,2,2,204373,204373,204375,0,2,1
58368,4,1,204377,204377,204378,0,1,2
58369,4,1,204381,204381,204382,0,1,3
58370,5,1,204386,204386,204387,0,1,4
58371,6,3,204392,204392,204395,0,3,5
58372,5,1,204397,204397,204398,0,1,2
58373,4,2,204401,204401,204403,0,2,3
58374,5,1,204406,204406,204407,0,1,3
58375,1,2,204407,204407,204409,0,2,0
58376,3,2,204410,204410,204412,0,2,1
58377,1,2,204411,204412,204414,1,3,0
58378,4,1,204415,204415,204416,0,1,1
58379,6,1,204421,204421,204422,0,1,5
58380,5,2,204426,204426,204428,0,2,4
58381,6,1,204432,204432,204433,0,1,4
58382,1,3,204433,204433,204436,0,3,0
58383,4,2,204437,204437,204439,0,2,1
58384,4,2,204441,204441,204443,0,2,2
58385,5,2,204446,204446,204448,0,2,3
58386,6,1,204452,204452,204453,0,1,4
58387,6,3,204458,204458,204461,0,3,5
58388,5,2,204463,204463,204465,0,2,2
58389,4,2,204467,204467,204469,0,2,2
58390,5,2,204472,204472,204474,0,2,3
58391,1,1,204473,204474,204475,1,2,0
58392,3,3,204476,204476,204479,0,3,1
58393,5,3,204481,204481,204484,0,3,2
58394,2,1,204483,204484,204485,1,2,0
58395,2,3,204485,204485,204488,0,3,0
58396,4,2,204489,204489,204491,0,2,1
58397,2,3,204491,204491,204494,0,3,0
58398,1,1,204492,204494,204495,2,3,0
58399,3,2,204495,204495,204497,0,2,0
58400,4,1,204499,204499,204500,0,1,2
58401,6,2,204505,204505,204507,0,2,5
58402,5,1,204510,204510,204511,0,1,3
58403,6,2,204516,204516,204518,0,2,5
58404,2,3,204518,204518,204521,0,3,0
58405,6,2,204524,204524,204526,0,2,3
58406,3,1,204527,204527,204528,0,1,1
58407,2,2,204529,204529,204531,0,2,1
58408,2,2,204531,204531,204533,0,2,0
58409,4,2,204535,204535,204537,0,2,2
58410,1,3,204536,204537,204540,1,4,0
58411,1,1,204537,204540,204541,3,4,0
58412,2,3,204539,204541,204544,2,5,0
58413,6,1,204545,204545,204546,0,1,1
58414,2,2,204547,204547,204549,0,2,1
58415,6,3,204553,204553,204556,0,3,4
58416,5,2,204558,204558,204560,0,2,2
58417,2,3,204560,204560,204563,0,3,0
58418,2,3,204562,204563,204566,1,4,0
58419,3,2,204565,204566,204568,1,3,0
58420,3,1,204568,204568,204569,0,1,0
58421,4,3,204572,204572,204575,0,3,3
58422,6,3,204578,204578,204581,0,3,3
58423,3,3,204581,204581,204584,0,3,0
58424,3,3,204584,204584,204587,0,3,0
58425,2,2,204586,204587,204589,1,3,0
58426,3,2,204589,204589,204591,0,2,0
58427,1,2,204590,204591,204593,1,3,0
58428,6,2,204596,204596,204598,0,2,3
58429,2,2,204598,204598,204600,0,2,0
58430,2,1,204600,204600,204601,0,1,0
58431,1,1,204601,204601,204602,0,1,0
58432,4,2,204605,204605,204607,0,2,3
58433,5,2,204610,204610,204612,0,2,3
58434,6,3,204616,204616,204619,0,3,4
58435,5,3,204621,204621,204624,0,3,2
58436,6,1,204627,204627,204628,0,1,3
58437,1,1,204628,204628,204629,0,1,0
58438,4,1,204632,204632,204633,0,1,3
58439,1,1,204633,204633,204634,0,1,0
58440,1,1,204634,204634,204635,0,1,0
58441,1,1,204635,204635,204636,0,1,0
58442,3,2,204638,204638,204640,0,2,2
58443,5,3,204643,204643,204646,0,3,3
58444,2,3,204645,204646,204649,1,4,0
58445,2,2,204647,204649,204651,2,4,0
58446,4,2,204651,204651,204653,0,2,0
58447,3,1,204654,204654,204655,0,1,1
58448,2,1,204656,204656,204657,0,1,1
58449,6,3,204662,204662,204665,0,3,5
58450,6,3,204668,204668,204671,0,3,3
58451,2,3,204670,204671,204674,1,4,0
58452,5,2,204675,204675,204677,0,2,1
58453,6,3,204681,204681,204684,0,3,4
58454,4,3,204685,204685,204688,0,3,1
58455,3,2,204688,204688,204690,0,2,0
58456,2,1,204690,204690,204691,0,1,0
58457,2,3,204692,204692,204695,0,3,1
58458,6,2,204698,204698,204700,0,2,3
58459,3,3,204701,204701,204704,0,3,1
58460,2,2,204703,204704,204706,1,3,0
58461,4,1,204707,204707,204708,0,1,1
58462,6,3,204713,204713,204716,0,3,5
58463,5,3,204718,204718,204721,0,3,2
58464,1,3,204719,204721,204724,2,5,0
58465,5,3,204724,204724,204727,0,3,0
58466,1,3,204725,204727,204730,2,5,0
58467,5,1,204730,204730,204731,0,1,0
58468,6,1,204736,204736,204737,0,1,5
58469,2,2,204738,204738,204740,0,2,1
58470,5,3,204743,204743,204746,0,3,3
58471,4,2,204747,204747,204749,0,2,1
58472,1,2,204748,204749,204751,1,3,0
58473,6,1,204754,204754,204755,0,1,3
58474,4,3,204758,204758,204761,0,3,3
58475,4,2,204762,204762,204764,0,2,1
58476,2,1,204764,204764,204765,0,1,0
58477,2,3,204766,204766,204769,0,3,1
58478,4,2,204770,204770,204772,0,2,1
58479,1,1,204771,204772,204773,1,2,0
58480,4,2,204775,204775,204777,0,2,2
58481,5,3,204780,204780,204783,0,3,3
58482,4,1,204784,204784,204785,0,1,1
58483,2,3,204786,204786,204789,0,3,1
58484,1,3,204787,204789,204792,2,5,0
58485,6,2,204793,204793,204795,0,2,1
58486,2,3,204795,204795,204798,0,3,0
58487,5,3,204800,204800,204803,0,3,2
58488,3,2,204803,204803,204805,0,2,0
58489,1,1,204804,204805,204806,1,2,0
58490,1,1,204805,204806,204807,1,2,0
58491,1,2,204806,204807,204809,1,3,0
58492,3,3,204809,204809,204812,0,3,0
58493,3,1,204812,204812,204813,0,1,0
58494,3,1,204815,204815,204816,0,1,2
58495,6,2,204821,204821,204823,0,2,5
58496,4,2,204825,204825,204827,0,2,2
58497,3,3,204828,204828,204831,0,3,1
58498,5,1,204833,204833,204834,0,1,2
58499,5,1,204838,204838,204839,0,1,4
58500,6,1,204844,204844,204845,0,1,5
58501,5,3,204849,204849,204852,0,3,4
58502,3,3,204852,204852,204855,0,3,0
58503,2,1,204854,204855,204856,1,2,0
58504,3,2,204857,204857,204859,0,2,1
58505,6,1,204863,204863,204864,0,1,4
58506,4,2,204867,204867,204869,0,2,3
58507,3,2,204870,204870,204872,0,2,1
58508,6,1,204876,204876,204877,0,1,4
58509,6,1,204882,204882,204883,0,1,5
58510,6,1,204888,204888,204889,0,1,5
58511,3,2,204891,204891,204893,0,2,2
58512,1,1,204892,204893,204894,1,2,0
58513,1,2,204893,204894,204896,1,3,0
58514,5,2,204898,204898,204900,0,2,2
58515,3,3,204901,204901,204904,0,3,1
58516,6,1,204907,204907,204908,0,1,3
58517,1,1,204908,204908,204909,0,1,0
58518,4,3,204912,204912,204915,0,3,3
58519,5,1,204917,204917,204918,0,1,2
58520,1,3,204918,204918,204921,0,3,0
58521,1,3,204919,204921,204924,2,5,0
58522,4,1,204923,204924,204925,1,2,0
58523,2,3,204925,204925,204928,0,3,0
58524,2,1,204927,204928,204929,1,2,0
58525,2,2,204929,204929,204931,0,2,0
58526,2,2,204931,204931,204933,0,2,0
58527,5,3,204936,204936,204939,0,3,3
58528,3,1,204939,204939,204940,0,1,0
58529,1,3,204940,204940,204943,0,3,0
58530,5,1,204945,204945,204946,0,1,2
58531,6,2,204951,204951,204953,0,2,5
58532,2,1,204953,204953,204954,0,1,0
58533,4,1,204957,204957,204958,0,1,3
58534,2,1,204959,204959,204960,0,1,1
58535,2,1,204961,204961,204962,0,1,1
58536,4,3,204965,204965,204968,0,3,3
58537,5,2,204970,204970,204972,0,2,2
58538,1,3,204971,204972,204975,1,4,0
58539,6,1,204977,204977,204978,0,1,2
58540,5,2,204982,204982,204984,0,2,4
58541,4,2,204986,204986,204988,0,2,2
58542,3,2,204989,204989,204991,0,2,1
58543,3,1,204992,204992,204993,0,1,1
58544,6,1,204998,204998,204999,0,1,5
58545,1,3,204999,204999,205002,0,3,0
58546,1,3,205000,205002,205005,2,5,0
58547,5,2,205005,205005,205007,0,2,0
58548,4,2,205009,205009,205011,0,2,2
58549,2,3,205011,205011,205014,0,3,0
58550,4,3,205015,205015,205018,0,3,1
58551,1,3,205016,205018,205021,2,5,0
58552,5,3,205021,205021,205024,0,3,0
58553,1,1,205022,205024,205025,2,3,0
58554,6,2,205028,205028,205030,0,2,3
58555,2,2,205030,205030,205032,0,2,0
58556,1,2,205031,205032,205034,1,3,0
58557,1,1,205032,205034,205035,2,3,0
58558,3,2,205035,205035,205037,0,2,0
58559,1,2,205036,205037,205039,1,3,0
58560,4,2,205040,205040,205042,0,2,1
58561,3,3,205043,205043,205046,0,3,1
58562,3,1,205046,205046,205047,0,1,0
58563,3,1,205049,205049,205050,0,1,2
58564,4,2,205053,205053,205055,0,2,3
58565,5,3,205058,205058,205061,0,3,3
58566,3,3,205061,205061,205064,0,3,0
58567,2,3,205063,205064,205067,1,4,0
58568,5,1,205068,205068,205069,0,1,1
58569,4,1,205072,205072,205073,0,1,3
58570,3,3,205075,205075,205078,0,3,2
58571,3,3,205078,205078,205081,0,3,0
58572,6,1,205084,205084,205085,0,1,3
58573,6,3,205090,205090,205093,0,3,5
58574,5,1,205095,205095,205096,0,1,2
58575,5,1,205100,205100,205101,0,1,4
58576,2,3,205102,205102,205105,0,3,1
58577,4,3,205106,205106,205109,0,3,1
58578,4,1,205110,205110,205111,0,1,1
58579,3,2,205113,205113,205115,0,2,2
58580,3,1,205116,205116,205117,0,1,1
58581,4,3,205120,205120,205123,0,3,3
58582,1,1,205121,205123,205124,2,3,0
58583,4,2,205125,205125,205127,0,2,1
58584,4,2,205129,205129,205131,0,2,2
58585,4,1,205133,205133,205134,0,1,2
58586,4,2,205137,205137,205139,0,2,3
58587,6,3,205143,205143,205146,0,3,4
58588,4,2,205147,205147,205149,0,2,1
58589,6,2,205153,205153,205155,0,2,4
58590,6,1,205159,205159,205160,0,1,4
58591,2,2,205161,205161,205163,0,2,1
58592,1,1,205162,205163,205164,1,2,0
58593,5,2,205167,205167,205169,0,2,3
58594,3,1,205170,205170,205171,0,1,1
58595,5,1,205175,205175,205176,0,1,4
58596,2,2,205177,205177,205179,0,2,1
58597,1,3,205178,205179,205182,1,4,0
58598,6,2,205184,205184,205186,0,2,2
58599,2,1,205186,205186,205187,0,1,0
58600,2,1,205188,205188,205189,0,1,1
58601,5,3,205193,205193,205196,0,3,4
58602,2,2,205195,205196,205198,1,3,0
58603,6,1,205201,205201,205202,0,1,3
58604,3,1,205204,205204,205205,0,1,2
58605,5,1,205209,205209,205210,0,1,4
58606,1,1,205210,205210,205211,0,1,0
58607,3,1,205213,205213,205214,0,1,2
58608,1,2,205214,205214,205216,0,2,0
58609,3,2,205217,205217,205219,0,2,1
58610,5,2,205222,205222,205224,0,2,3
58611,2,1,205224,205224,205225,0,1,0
58612,6,2,205230,205230,205232,0,2,5
58613,2,1,205232,205232,205233,0,1,0
58614,5,3,205237,205237,205240,0,3,4
58615,1,1,205238,205240,205241,2,3,0
58616,5,2,205243,205243,205245,0,2,2
58617,3,1,205246,205246,205247,0,1,1
58618,4,1,205250,205250,205251,0,1,3
58619,4,1,205254,205254,205255,0,1,3
58620,6,3,205260,205260,205263,0,3,5
58621,4,2,205264,205264,205266,0,2,1
58622,3,2,205267,205267,205269,0,2,1
58623,2,2,205269,205269,205271,0,2,0
58624,2,1,205271,205271,205272,0,1,0
58625,3,2,205274,205274,205276,0,2,2
58626,3,1,205277,205277,205278,0,1,1
58627,4,2,205281,205281,205283,0,2,3
58628,6,3,205287,205287,205290,0,3,4
58629,5,1,205292,205292,205293,0,1,2
58630,5,1,205297,205297,205298,0,1,4
58631,2,3,205299,205299,205302,0,3,1
58632,1,2,205300,205302,205304,2,4,0
58633,3,3,205303,205304,205307,1,4,0
58634,4,2,205307,205307,205309,0,2,0
58635,5,2,205312,205312,205314,0,2,3
58636,5,1,205317,205317,205318,0,1,3
58637,5,1,205322,205322,205323,0,1,4
58638,2,2,205324,205324,205326,0,2,1
58639,6,1,205330,205330,205331,0,1,4
58640,6,2,205336,205336,205338,0,2,5
58641,3,2,205339,205339,205341,0,2,1
58642,6,3,205345,205345,205348,0,3,4
58643,1,1,205346,205348,205349,2,3,0
58644,2,3,205348,205349,205352,1,4,0
58645,5,2,205353,205353,205355,0,2,1
58646,6,1,205359,205359,205360,0,1,4
58647,6,3,205365,205365,205368,0,3,5
58648,2,3,205367,205368,205371,1,4,0
58649,3,1,205370,205371,205372,1,2,0
58650,1,1,205371,205372,205373,1,2,0
58651,6,2,205377,205377,205379,0,2,4
58652,2,1,205379,205379,205380,0,1,0
58653,2,1,205381,205381,205382,0,1,1
58654,1,2,205382,205382,205384,0,2,0
58655,1,2,205383,205384,205386,1,3,0
58656,2,3,205385,205386,205389,1,4,0
58657,2,3,205387,205389,205392,2,5,0
58658,4,3,205391,205392,205395,1,4,0
58659,1,2,205392,205395,205397,3,5,0
58660,6,3,205398,205398,205401,0,3,1
58661,1,3,205399,205401,205404,2,5,0
58662,6,2,205405,205405,205407,0,2,1
58663,3,1,205408,205408,205409,0,1,1
58664,2,1,205410,205410,205411,0,1,1
58665,1,2,205411,205411,205413,0,2,0
58666,4,2,205415,205415,205417,0,2,2
58667,1,3,205416,205417,205420,1,4,0
58668,2,1,205418,205420,205421,2,3,0
58669,1,2,205419,205421,205423,2,4,0
58670,1,2,205420,205423,205425,3,5,0
58671,3,1,205423,205425,205426,2,3,0
58672,5,3,205428,205428,205431,0,3,2
58673,4,2,205432,205432,205434,0,2,1
58674,6,3,205438,205438,205441,0,3,4
58675,1,3,205439,205441,205444,2,5,0
58676,1,1,205440,205444,205445,4,5,0
58677,5,2,205445,205445,205447,0,2,0
58678,1,3,205446,205447,205450,1,4,0
58679,4,3,205450,205450,205453,0,3,0
58680,2,3,205452,205453,205456,1,4,0
58681,1,1,205453,205456,205457,3,4,0
58682,2,1,205455,205457,205458,2,3,0
58683,3,2,205458,205458,205460,0,2,0
58684,2,2,205460,205460,205462,0,2,0
58685,4,2,205464,205464,205466,0,2,2
58686,2,1,205466,205466,205467,0,1,0
58687,6,2,205472,205472,205474,0,2,5
58688,5,3,205477,205477,205480,0,3,3
58689,2,3,205479,205480,205483,1,4,0
58690,1,1,205480,205483,205484,3,4,0
58691,4,1,205484,205484,205485,0,1,0
58692,3,2,205487,205487,205489,0,2,2
58693,3,2,205490,205490,205492,0,2,1
58694,1,3,205491,205492,205495,1,4,0
58695,5,2,205496,205496,205498,0,2,1
58696,5,1,205501,205501,205502,0,1,3
58697,2,2,205503,205503,205505,0,2,1
58698,1,3,205504,205505,205508,1,4,0
58699,4,2,205508,205508,205510,0,2,0
58700,1,1,205509,205510,205511,1,2,0
58701,2,2,205511,205511,205513,0,2,0
58702,1,2,205512,205513,205515,1,3,0
58703,2,1,205514,205515,205516,1,2,0
58704,3,1,205517,205517,205518,0,1,1
58705,5,1,205522,205522,205523,0,1,4
58706,3,3,205525,205525,205528,0,3,2
58707,4,3,205529,205529,205532,0,3,1
58708,2,3,205531,205532,205535,1,4,0
58709,4,3,205535,205535,205538,0,3,0
58710,6,2,205541,205541,205543,0,2,3
58711,4,3,205545,205545,205548,0,3,2
58712,1,2,205546,205548,205550,2,4,0
58713,6,1,205552,205552,205553,0,1,2
58714,2,3,205554,205554,205557,0,3,1
58715,3,3,205557,205557,205560,0,3,0
58716,4,1,205561,205561,205562,0,1,1
58717,1,2,205562,205562,205564,0,2,0
58718,5,2,205567,205567,205569,0,2,3
58719,6,1,205573,205573,205574,0,1,4
58720,1,2,205574,205574,205576,0,2,0
58721,5,1,205579,205579,205580,0,1,3
58722,1,1,205580,205580,205581,0,1,0
58723,3,3,205583,205583,205586,0,3,2
58724,6,3,205589,205589,205592,0,3,3
58725,1,3,205590,205592,205595,2,5,0
58726,4,3,205594,205595,205598,1,4,0
58727,1,1,205595,205598,205599,3,4,0
58728,3,2,205598,205599,205601,1,3,0
58729,6,3,205604,205604,205607,0,3,3
58730,6,2,205610,205610,205612,0,2,3
58731,6,1,205616,205616,205617,0,1,4
58732,4,2,205620,205620,205622,0,2,3
58733,6,1,205626,205626,205627,0,1,4
58734,6,1,205632,205632,205633,0,1,5
58735,4,2,205636,205636,205638,0,2,3
58736,6,3,205642,205642,205645,0,3,4
58737,5,3,205647,205647,205650,0,3,2
58738,2,1,205649,205650,205651,1,2,0
58739,6,3,205655,205655,205658,0,3,4
58740,5,1,205660,205660,205661,0,1,2
58741,5,1,205665,205665,205666,0,1,4
58742,4,3,205669,205669,205672,0,3,3
58743,3,2,205672,205672,205674,0,2,0
58744,1,1,205673,205674,205675,1,2,0
58745,4,3,205677,205677,205680,0,3,2
58746,1,2,205678,205680,205682,2,4,0
58747,3,3,205681,205682,205685,1,4,0
58748,3,2,205684,205685,205687,1,3,0
58749,5,1,205689,205689,205690,0,1,2
58750,2,3,205691,205691,205694,0,3,1
58751,2,3,205693,205694,205697,1,4,0
58752,4,3,205697,205697,205700,0,3,0
58753,5,2,205702,205702,205704,0,2,2
58754,4,2,205706,205706,205708,0,2,2
58755,4,2,205710,205710,205712,0,2,2
58756,2,3,205712,205712,205715,0,3,0
58757,1,3,205713,205715,205718,2,5,0
58758,2,3,205715,205718,205721,3,6,0
58759,1,3,205716,205721,205724,5,8,0
58760,1,2,205717,205724,205726,7,9,0
58761,6,1,205723,205726,205727,3,4,0
58762,6,2,205729,205729,205731,0,2,2
58763,2,3,205731,205731,205734,0,3,0
58764,2,3,205733,205734,205737,1,4,0
58765,3,2,205736,205737,205739,1,3,0
58766,6,1,205742,205742,205743,0,1,3
58767,4,1,205746,205746,205747,0,1,3
58768,6,1,205752,205752,205753,0,1,5
58769,4,2,205756,205756,205758,0,2,3
58770,2,1,205758,205758,205759,0,1,0
58771,3,3,205761,205761,205764,0,3,2
58772,4,1,205765,205765,205766,0,1,1
58773,1,2,205766,205766,205768,0,2,0
58774,5,2,205771,205771,205773,0,2,3
58775,2,3,205773,205773,205776,0,3,0
58776,4,2,205777,205777,205779,0,2,1
58777,4,2,205781,205781,205783,0,2,2
58778,4,3,205785,205785,205788,0,3,2
58779,4,2,205789,205789,205791,0,2,1
58780,2,3,205791,205791,205794,0,3,0
58781,2,1,205793,205794,205795,1,2,0
58782,6,2,205799,205799,205801,0,2,4
58783,1,2,205800,205801,205803,1,3,0
58784,3,1,205803,205803,205804,0,1,0
58785,5,1,205808,205808,205809,0,1,4
58786,1,3,205809,205809,205812,0,3,0
58787,3,1,205812,205812,205813,0,1,0
58788,4,1,205816,205816,205817,0,1,3
58789,2,2,205818,205818,205820,0,2,1
58790,4,1,205822,205822,205823,0,1,2
58791,2,1,205824,205824,205825,0,1,1
58792,1,2,205825,205825,205827,0,2,0
58793,1,3,205826,205827,205830,1,4,0
58794,6,3,205832,205832,205835,0,3,2
58795,6,2,205838,205838,205840,0,2,3
58796,6,1,205844,205844,205845,0,1,4
58797,5,2,205849,205849,205851,0,2,4
58798,1,1,205850,205851,205852,1,2,0
58799,5,1,205855,205855,205856,0,1,3
58800,3,2,205858,205858,205860,0,2,2
58801,4,1,205862,205862,205863,0,1,2
58802,4,3,205866,205866,205869,0,3,3
58803,5,1,205871,205871,205872,0,1,2
58804,5,3,205876,205876,205879,0,3,4
58805,4,3,205880,205880,205883,0,3,1
58806,4,1,205884,205884,205885,0,1,1
58807,2,1,205886,205886,205887,0,1,1
58808,5,2,205891,205891,205893,0,2,4
58809,6,3,205897,205897,205900,0,3,4
58810,2,3,205899,205900,205903,1,4,0
58811,2,2,205901,205903,205905,2,4,0
58812,6,2,205907,205907,205909,0,2,2
58813,3,1,205910,205910,205911,0,1,1
58814,3,2,205913,205913,205915,0,2,2
58815,5,3,205918,205918,205921,0,3,3
58816,3,2,205921,205921,205923,0,2,0
58817,6,3,205927,205927,205930,0,3,4
58818,5,2,205932,205932,205934,0,2,2
58819,5,3,205937,205937,205940,0,3,3
58820,3,2,205940,205940,205942,0,2,0
58821,3,1,205943,205943,205944,0,1,1
58822,5,2,205948,205948,205950,0,2,4
58823,6,3,205954,205954,205957,0,3,4
58824,1,1,205955,205957,205958,2,3,0
58825,1,1,205956,205958,205959,2,3,0
58826,3,3,205959,205959,205962,0,3,0
58827,2,1,205961,205962,205963,1,2,0
58828,4,3,205965,205965,205968,0,3,2
58829,5,3,205970,205970,205973,0,3,2
58830,3,3,205973,205973,205976,0,3,0
58831,3,1,205976,205976,205977,0,1,0
58832,2,2,205978,205978,205980,0,2,1
58833,2,3,205980,205980,205983,0,3,0
58834,4,3,205984,205984,205987,0,3,1
58835,2,3,205986,205987,205990,1,4,0
58836,5,1,205991,205991,205992,0,1,1
58837,6,2,205997,205997,205999,0,2,5
58838,4,2,206001,206001,206003,0,2,2
58839,2,2,206003,206003,206005,0,2,0
58840,5,2,206008,206008,206010,0,2,3
58841,6,3,206014,206014,206017,0,3,4
58842,3,3,206017,206017,206020,0,3,0
58843,2,2,206019,206020,206022,1,3,0
58844,4,3,206023,206023,206026,0,3,1
58845,2,3,206025,206026,206029,1,4,0
58846,3,1,206028,206029,206030,1,2,0
58847,2,3,206030,206030,206033,0,3,0
58848,6,3,206036,206036,206039,0,3,3
58849,3,1,206039,206039,206040,0,1,0
58850,1,3,206040,206040,206043,0,3,0
58851,6,1,206046,206046,206047,0,1,3
58852,2,3,206048,206048,206051,0,3,1
58853,6,1,206054,206054,206055,0,1,3
58854,4,3,206058,206058,206061,0,3,3
58855,4,3,206062,206062,206065,0,3,1
58856,3,1,206065,206065,206066,0,1,0
58857,1,1,206066,206066,206067,0,1,0
58858,2,3,206068,206068,206071,0,3,1
58859,5,2,206073,206073,206075,0,2,2
58860,3,2,206076,206076,206078,0,2,1
58861,3,2,206079,206079,206081,0,2,1
58862,3,2,206082,206082,206084,0,2,1
58863,4,1,206086,206086,206087,0,1,2
58864,5,2,206091,206091,206093,0,2,4
58865,6,1,206097,206097,206098,0,1,4
58866,4,3,206101,206101,206104,0,3,3
58867,4,3,206105,206105,206108,0,3,1
58868,1,1,206106,206108,206109,2,3,0
58869,3,1,206109,206109,206110,0,1,0
58870,6,3,206115,206115,206118,0,3,5
58871,1,2,206116,206118,206120,2,4,0
58872,2,1,206118,206120,206121,2,3,0
58873,6,3,206124,206124,206127,0,3,3
58874,6,2,206130,206130,206132,0,2,3
58875,4,3,206134,206134,206137,0,3,2
58876,5,2,206139,206139,206141,0,2,2
58877,5,1,206144,206144,206145,0,1,3
58878,5,2,206149,206149,206151,0,2,4
58879,5,1,206154,206154,206155,0,1,3
58880,3,1,206157,206157,206158,0,1,2
58881,4,2,206161,206161,206163,0,2,3
58882,1,3,206162,206163,206166,1,4,0
58883,5,2,206167,206167,206169,0,2,1
58884,6,3,206173,206173,206176,0,3,4
58885,4,2,206177,206177,206179,0,2,1
58886,6,2,206183,206183,206185,0,2,4
58887,6,1,206189,206189,206190,0,1,4
58888,5,1,206194,206194,206195,0,1,4
58889,3,3,206197,206197,206200,0,3,2
58890,3,1,206200,206200,206201,0,1,0
58891,6,1,206206,206206,206207,0,1,5
58892,3,1,206209,206209,206210,0,1,2
58893,5,2,206214,206214,206216,0,2,4
58894,4,2,206218,206218,206220,0,2,2
58895,3,1,206221,206221,206222,0,1,1
58896,1,2,206222,206222,206224,0,2,0
58897,3,1,206225,206225,206226,0,1,1
58898,6,3,206231,206231,206234,0,3,5
58899,2,2,206233,206234,206236,1,3,0
58900,5,1,206238,206238,206239,0,1,2
58901,1,1,206239,206239,206240,0,1,0
58902,1,3,206240,206240,206243,0,3,0
58903,6,3,206246,206246,206249,0,3,3
58904,2,2,206248,206249,206251,1,3,0
58905,5,1,206253,206253,206254,0,1,2
58906,1,2,206254,206254,206256,0,2,0
58907,2,1,206256,206256,206257,0,1,0
58908,4,1,206260,206260,206261,0,1,3
58909,6,2,206266,206266,206268,0,2,5
58910,6,2,206272,206272,206274,0,2,4
58911,5,2,206277,206277,206279,0,2,3
58912,5,3,206282,206282,206285,0,3,3
58913,5,1,206287,206287,206288,0,1,2
58914,6,2,206293,206293,206295,0,2,5
58915,2,1,206295,206295,206296,0,1,0
58916,1,2,206296,206296,206298,0,2,0
58917,1,3,206297,206298,206301,1,4,0
58918,1,2,206298,206301,206303,3,5,0
58919,6,2,206304,206304,206306,0,2,1
58920,5,1,206309,206309,206310,0,1,3
58921,6,1,206315,206315,206316,0,1,5
58922,3,2,206318,206318,206320,0,2,2
58923,1,1,206319,206320,206321,1,2,0
58924,4,1,206323,206323,206324,0,1,2
58925,6,2,206329,206329,206331,0,2,5
58926,6,1,206335,206335,206336,0,1,4
58927,6,2,206341,206341,206343,0,2,5
58928,3,1,206344,206344,206345,0,1,1
58929,4,3,206348,206348,206351,0,3,3
58930,1,2,206349,206351,206353,2,4,0
58931,6,2,206355,206355,206357,0,2,2
58932,1,3,206356,206357,206360,1,4,0
58933,1,3,206357,206360,206363,3,6,0
58934,2,3,206359,206363,206366,4,7,0
58935,5,3,206364,206366,206369,2,5,0
58936,1,2,206365,206369,206371,4,6,0
58937,1,2,206366,206371,206373,5,7,0
58938,1,1,206367,206373,206374,6,7,0
58939,1,2,206368,206374,206376,6,8,0
58940,6,3,206374,206376,206379,2,5,0
58941,4,3,206378,206379,206382,1,4,0
58942,2,1,206380,206382,206383,2,3,0
58943,1,2,206381,206383,206385,2,4,0
58944,4,3,206385,206385,206388,0,3,0
58945,1,3,206386,206388,206391,2,5,0
58946,3,3,206389,206391,206394,2,5,0
58947,4,1,206393,206394,206395,1,2,0
58948,2,1,206395,206395,206396,0,1,0
58949,6,1,206401,206401,206402,0,1,5
58950,4,2,206405,206405,206407,0,2,3
58951,6,2,206411,206411,206413,0,2,4
58952,5,2,206416,206416,206418,0,2,3
58953,1,3,206417,206418,206421,1,4,0
58954,1,2,206418,206421,206423,3,5,0
58955,5,2,206423,206423,206425,0,2,0
58956,6,3,206429,206429,206432,0,3,4
58957,3,2,206432,206432,206434,0,2,0
58958,5,2,206437,206437,206439,0,2,3
58959,2,1,206439,206439,206440,0,1,0
58960,4,2,206443,206443,206445,0,2,3
58961,6,1,206449,206449,206450,0,1,4
58962,6,3,206455,206455,206458,0,3,5
58963,3,3,206458,206458,206461,0,3,0
58964,1,2,206459,206461,206463,2,4,0
58965,4,2,206463,206463,206465,0,2,0
58966,6,1,206469,206469,206470,0,1,4
58967,5,1,206474,206474,206475,0,1,4
58968,4,2,206478,206478,206480,0,2,3
58969,2,2,206480,206480,206482,0,2,0
58970,1,3,206481,206482,206485,1,4,0
58971,1,3,206482,206485,206488,3,6,0
58972,2,3,206484,206488,206491,4,7,0
58973,6,2,206490,206491,206493,1,3,0
58974,6,1,206496,206496,206497,0,1,3
58975,5,1,206501,206501,206502,0,1,4
58976,6,3,206507,206507,206510,0,3,5
58977,6,2,206513,206513,206515,0,2,3
58978,1,2,206514,206515,206517,1,3,0
58979,2,2,206516,206517,206519,1,3,0
58980,6,1,206522,206522,206523,0,1,3
58981,6,2,206528,206528,206530,0,2,5
58982,2,3,206530,206530,206533,0,3,0
58983,3,3,206533,206533,206536,0,3,0
58984,1,1,206534,206536,206537,2,3,0
58985,4,1,206538,206538,206539,0,1,1
58986,6,3,206544,206544,206547,0,3,5
58987,1,1,206545,206547,206548,2,3,0
58988,1,1,206546,206548,206549,2,3,0
58989,6,3,206552,206552,206555,0,3,3
58990,4,3,206556,206556,206559,0,3,1
58991,4,3,206560,206560,206563,0,3,1
58992,1,3,206561,206563,206566,2,5,0
58993,6,3,206567,206567,206570,0,3,1
58994,3,1,206570,206570,206571,0,1,0
58995,5,2,206575,206575,206577,0,2,4
58996,2,2,206577,206577,206579,0,2,0
58997,5,3,206582,206582,206585,0,3,3
58998,4,1,206586,206586,206587,0,1,1
58999,4,2,206590,206590,206592,0,2,3
59000,5,1,206595,206595,206596,0,1,3
59001,5,2,206600,206600,206602,0,2,4
59002,2,3,206602,206602,206605,0,3,0
59003,2,2,206604,206605,206607,1,3,0
59004,4,1,206608,206608,206609,0,1,1
59005,2,2,206610,206610,206612,0,2,1
59006,3,2,206613,206613,206615,0,2,1
59007,2,1,206615,206615,206616,0,1,0
59008,2,1,206617,206617,206618,0,1,1
59009,2,3,206619,206619,206622,0,3,1
59010,2,1,206621,206622,206623,1,2,0
59011,4,1,206625,206625,206626,0,1,2
59012,3,1,206628,206628,206629,0,1,2
59013,3,1,206631,206631,206632,0,1,2
59014,2,3,206633,206633,206636,0,3,1
59015,5,2,206638,206638,206640,0,2,2
59016,4,3,206642,206642,206645,0,3,2
59017,5,3,206647,206647,206650,0,3,2
59018,1,1,206648,206650,206651,2,3,0
59019,1,3,206649,206651,206654,2,5,0
59020,2,2,206651,206654,206656,3,5,0
59021,4,3,206655,206656,206659,1,4,0
59022,5,1,206660,206660,206661,0,1,1
59023,2,1,206662,206662,206663,0,1,1
59024,1,3,206663,206663,206666,0,3,0
59025,1,3,206664,206666,206669,2,5,0
59026,3,3,206667,206669,206672,2,5,0
59027,1,2,206668,206672,206674,4,6,0
59028,4,3,206672,206674,206677,2,5,0
59029,3,1,206675,206677,206678,2,3,0
59030,2,2,206677,206678,206680,1,3,0
59031,3,3,206680,206680,206683,0,3,0
59032,2,2,206682,206683,206685,1,3,0
59033,4,1,206686,206686,206687,0,1,1
59034,1,2,206687,206687,206689,0,2,0
59035,2,1,206689,206689,206690,0,1,0
59036,1,2,206690,206690,206692,0,2,0
59037,5,2,206695,206695,206697,0,2,3
59038,6,2,206701,206701,206703,0,2,4
59039,1,1,206702,206703,206704,1,2,0
59040,6,3,206708,206708,206711,0,3,4
59041,3,1,206711,206711,206712,0,1,0
59042,3,2,206714,206714,206716,0,2,2
59043,4,3,206718,206718,206721,0,3,2
59044,2,3,206720,206721,206724,1,4,0
59045,3,3,206723,206724,206727,1,4,0
59046,4,2,206727,206727,206729,0,2,0
59047,2,2,206729,206729,206731,0,2,0
59048,2,2,206731,206731,206733,0,2,0
59049,4,3,206735,206735,206738,0,3,2
59050,6,2,206741,206741,206743,0,2,3
59051,5,3,206746,206746,206749,0,3,3
59052,1,1,206747,206749,206750,2,3,0
59053,4,1,206751,206751,206752,0,1,1
59054,6,2,206757,206757,206759,0,2,5
59055,6,2,206763,206763,206765,0,2,4
59056,6,1,206769,206769,206770,0,1,4
59057,5,2,206774,206774,206776,0,2,4
59058,1,1,206775,206776,206777,1,2,0
59059,5,2,206780,206780,206782,0,2,3
59060,3,1,206783,206783,206784,0,1,1
59061,3,3,206786,206786,206789,0,3,2
59062,4,2,206790,206790,206792,0,2,1
59063,2,2,206792,206792,206794,0,2,0
59064,2,3,206794,206794,206797,0,3,0
59065,5,2,206799,206799,206801,0,2,2
59066,2,2,206801,206801,206803,0,2,0
59067,6,1,206807,206807,206808,0,1,4
59068,2,2,206809,206809,206811,0,2,1
59069,3,3,206812,206812,206815,0,3,1
59070,1,2,206813,206815,206817,2,4,0
59071,3,3,206816,206817,206820,1,4,0
59072,5,3,206821,206821,206824,0,3,1
59073,6,1,206827,206827,206828,0,1,3
59074,1,1,206828,206828,206829,0,1,0
59075,4,1,206832,206832,206833,0,1,3
59076,6,2,206838,206838,206840,0,2,5
59077,2,2,206840,206840,206842,0,2,0
59078,6,3,206846,206846,206849,0,3,4
59079,4,3,206850,206850,206853,0,3,1
59080,3,3,206853,206853,206856,0,3,0
59081,1,2,206854,206856,206858,2,4,0
59082,3,2,206857,206858,206860,1,3,0
59083,2,2,206859,206860,206862,1,3,0
59084,3,3,206862,206862,206865,0,3,0
59085,1,1,206863,206865,206866,2,3,0
59086,2,3,206865,206866,206869,1,4,0
59087,2,2,206867,206869,206871,2,4,0
59088,1,1,206868,206871,206872,3,4,0
59089,5,3,206873,206873,206876,0,3,1
59090,1,3,206874,206876,206879,2,5,0
59091,2,2,206876,206879,206881,3,5,0
59092,3,1,206879,206881,206882,2,3,0
59093,3,3,206882,206882,206885,0,3,0
59094,6,3,206888,206888,206891,0,3,3
59095,1,3,206889,206891,206894,2,5,0
59096,6,1,206895,206895,206896,0,1,1
59097,4,2,206899,206899,206901,0,2,3
59098,4,3,206903,206903,206906,0,3,2
59099,6,1,206909,206909,206910,0,1,3
59100,1,2,206910,206910,206912,0,2,0
59101,5,3,206915,206915,206918,0,3,3
59102,3,3,206918,206918,206921,0,3,0
59103,3,1,206921,206921,206922,0,1,0
59104,3,3,206924,206924,206927,0,3,2
59105,4,2,206928,206928,206930,0,2,1
59106,3,1,206931,206931,206932,0,1,1
59107,5,1,206936,206936,206937,0,1,4
59108,4,2,206940,206940,206942,0,2,3
59109,2,1,206942,206942,206943,0,1,0
59110,1,1,206943,206943,206944,0,1,0
59111,3,1,206946,206946,206947,0,1,2
59112,2,3,206948,206948,206951,0,3,1
59113,3,3,206951,206951,206954,0,3,0
59114,2,2,206953,206954,206956,1,3,0
59115,1,1,206954,206956,206957,2,3,0
59116,5,2,206959,206959,206961,0,2,2
59117,1,2,206960,206961,206963,1,3,0
59118,3,2,206963,206963,206965,0,2,0
59119,4,1,206967,206967,206968,0,1,2
59120,2,1,206969,206969,206970,0,1,1
59121,6,1,206975,206975,206976,0,1,5
59122,5,2,206980,206980,206982,0,2,4
59123,3,3,206983,206983,206986,0,3,1
59124,4,1,206987,206987,206988,0,1,1
59125,2,2,206989,206989,206991,0,2,1
59126,6,2,206995,206995,206997,0,2,4
59127,2,2,206997,206997,206999,0,2,0
59128,6,3,207003,207003,207006,0,3,4
59129,4,2,207007,207007,207009,0,2,1
59130,2,2,207009,207009,207011,0,2,0
59131,6,3,207015,207015,207018,0,3,4
59132,1,3,207016,207018,207021,2,5,0
59133,5,1,207021,207021,207022,0,1,0
59134,3,1,207024,207024,207025,0,1,2
59135,5,2,207029,207029,207031,0,2,4
59136,2,1,207031,207031,207032,0,1,0
59137,1,1,207032,207032,207033,0,1,0
59138,5,3,207037,207037,207040,0,3,4
59139,6,1,207043,207043,207044,0,1,3
59140,4,3,207047,207047,207050,0,3,3
59141,4,1,207051,207051,207052,0,1,1
59142,1,1,207052,207052,207053,0,1,0
59143,1,3,207053,207053,207056,0,3,0
59144,5,1,207058,207058,207059,0,1,2
59145,5,2,207063,207063,207065,0,2,4
59146,3,3,207066,207066,207069,0,3,1
59147,3,2,207069,207069,207071,0,2,0
59148,4,3,207073,207073,207076,0,3,2
59149,4,2,207077,207077,207079,0,2,1
59150,4,2,207081,207081,207083,0,2,2
59151,5,1,207086,207086,207087,0,1,3
59152,6,1,207092,207092,207093,0,1,5
59153,3,2,207095,207095,207097,0,2,2
59154,2,1,207097,207097,207098,0,1,0
59155,1,3,207098,207098,207101,0,3,0
59156,5,2,207103,207103,207105,0,2,2
59157,5,1,207108,207108,207109,0,1,3
59158,5,3,207113,207113,207116,0,3,4
59159,2,2,207115,207116,207118,1,3,0
59160,6,1,207121,207121,207122,0,1,3
59161,6,3,207127,207127,207130,0,3,5
59162,5,2,207132,207132,207134,0,2,2
59163,4,1,207136,207136,207137,0,1,2
59164,2,3,207138,207138,207141,0,3,1
59165,1,3,207139,207141,207144,2,5,0
59166,3,1,207142,207144,207145,2,3,0
59167,2,1,207144,207145,207146,1,2,0
59168,2,1,207146,207146,207147,0,1,0
59169,2,3,207148,207148,207151,0,3,1
59170,3,3,207151,207151,207154,0,3,0
59171,5,2,207156,207156,207158,0,2,2
59172,3,3,207159,207159,207162,0,3,1
59173,3,2,207162,207162,207164,0,2,0
59174,6,2,207168,207168,207170,0,2,4
59175,6,3,207174,207174,207177,0,3,4
59176,5,2,207179,207179,207181,0,2,2
59177,1,2,207180,207181,207183,1,3,0
59178,3,1,207183,207183,207184,0,1,0
59179,2,2,207185,207185,207187,0,2,1
59180,2,1,207187,207187,207188,0,1,0
59181,5,3,207192,207192,207195,0,3,4
59182,5,3,207197,207197,207200,0,3,2
59183,3,2,207200,207200,207202,0,2,0
59184,2,3,207202,207202,207205,0,3,0
59185,4,1,207206,207206,207207,0,1,1
59186,4,3,207210,207210,207213,0,3,3
59187,5,1,207215,207215,207216,0,1,2
59188,2,3,207217,207217,207220,0,3,1
59189,5,1,207222,207222,207223,0,1,2
59190,5,3,207227,207227,207230,0,3,4
59191,3,1,207230,207230,207231,0,1,0
59192,2,1,207232,207232,207233,0,1,1
59193,4,3,207236,207236,207239,0,3,3
59194,5,2,207241,207241,207243,0,2,2
59195,5,1,207246,207246,207247,0,1,3
59196,6,2,207252,207252,207254,0,2,5
59197,4,2,207256,207256,207258,0,2,2
59198,1,2,207257,207258,207260,1,3,0
59199,1,2,207258,207260,207262,2,4,0
59200,6,1,207264,207264,207265,0,1,2
59201,6,3,207270,207270,207273,0,3,5
59202,1,2,207271,207273,207275,2,4,0
59203,4,3,207275,207275,207278,0,3,0
59204,2,1,207277,207278,207279,1,2,0
59205,2,2,207279,207279,207281,0,2,0
59206,4,1,207283,207283,207284,0,1,2
59207,3,3,207286,207286,207289,0,3,2
59208,2,1,207288,207289,207290,1,2,0
59209,6,2,207294,207294,207296,0,2,4
59210,5,1,207299,207299,207300,0,1,3
59211,3,1,207302,207302,207303,0,1,2
59212,3,2,207305,207305,207307,0,2,2
59213,3,1,207308,207308,207309,0,1,1
59214,5,2,207313,207313,207315,0,2,4
59215,6,2,207319,207319,207321,0,2,4
59216,4,2,207323,207323,207325,0,2,2
59217,4,1,207327,207327,207328,0,1,2
59218,4,1,207331,207331,207332,0,1,3
59219,1,1,207332,207332,207333,0,1,0
59220,2,1,207334,207334,207335,0,1,1
59221,5,1,207339,207339,207340,0,1,4
59222,3,3,207342,207342,207345,0,3,2
59223,5,2,207347,207347,207349,0,2,2
59224,2,3,207349,207349,207352,0,3,0
59225,4,3,207353,207353,207356,0,3,1
59226,6,1,207359,207359,207360,0,1,3
59227,5,2,207364,207364,207366,0,2,4
59228,1,3,207365,207366,207369,1,4,0
59229,6,3,207371,207371,207374,0,3,2
59230,5,1,207376,207376,207377,0,1,2
59231,6,2,207382,207382,207384,0,2,5
59232,3,3,207385,207385,207388,0,3,1
59233,6,2,207391,207391,207393,0,2,3
59234,5,1,207396,207396,207397,0,1,3
59235,4,3,207400,207400,207403,0,3,3
59236,4,1,207404,207404,207405,0,1,1
59237,5,2,207409,207409,207411,0,2,4
59238,1,3,207410,207411,207414,1,4,0
59239,6,1,207416,207416,207417,0,1,2
59240,6,3,207422,207422,207425,0,3,5
59241,1,1,207423,207425,207426,2,3,0
59242,5,2,207428,207428,207430,0,2,2
59243,3,2,207431,207431,207433,0,2,1
59244,2,3,207433,207433,207436,0,3,0
59245,5,1,207438,207438,207439,0,1,2
59246,2,2,207440,207440,207442,0,2,1
59247,5,2,207445,207445,207447,0,2,3
59248,3,1,207448,207448,207449,0,1,1
59249,3,3,207451,207451,207454,0,3,2
59250,1,1,207452,207454,207455,2,3,0
59251,5,2,207457,207457,207459,0,2,2
59252,2,2,207459,207459,207461,0,2,0
59253,1,2,207460,207461,207463,1,3,0
59254,6,2,207466,207466,207468,0,2,3
59255,1,3,207467,207468,207471,1,4,0
59256,3,1,207470,207471,207472,1,2,0
59257,1,3,207471,207472,207475,1,4,0
59258,2,2,207473,207475,207477,2,4,0
59259,1,3,207474,207477,207480,3,6,0
59260,2,1,207476,207480,207481,4,5,0
59261,6,3,207482,207482,207485,0,3,1
59262,2,3,207484,207485,207488,1,4,0
59263,3,2,207487,207488,207490,1,3,0
59264,2,3,207489,207490,207493,1,4,0
59265,1,2,207490,207493,207495,3,5,0
59266,2,1,207492,207495,207496,3,4,0
59267,1,3,207493,207496,207499,3,6,0
59268,4,1,207497,207499,207500,2,3,0
59269,1,1,207498,207500,207501,2,3,0
59270,4,3,207502,207502,207505,0,3,1
59271,2,2,207504,207505,207507,1,3,0
59272,2,1,207506,207507,207508,1,2,0
59273,3,1,207509,207509,207510,0,1,1
59274,6,2,207515,207515,207517,0,2,5
59275,6,2,207521,207521,207523,0,2,4
59276,6,3,207527,207527,207530,0,3,4
59277,5,2,207532,207532,207534,0,2,2
59278,5,2,207537,207537,207539,0,2,3
59279,3,1,207540,207540,207541,0,1,1
59280,2,1,207542,207542,207543,0,1,1
59281,5,1,207547,207547,207548,0,1,4
59282,4,2,207551,207551,207553,0,2,3
59283,5,1,207556,207556,207557,0,1,3
59284,1,1,207557,207557,207558,0,1,0
59285,5,2,207562,207562,207564,0,2,4
59286,3,3,207565,207565,207568,0,3,1
59287,6,2,207571,207571,207573,0,2,3
59288,5,2,207576,207576,207578,0,2,3
59289,3,1,207579,207579,207580,0,1,1
59290,3,2,207582,207582,207584,0,2,2
59291,5,2,207587,207587,207589,0,2,3
59292,6,2,207593,207593,207595,0,2,4
59293,2,1,207595,207595,207596,0,1,0
59294,1,3,207596,207596,207599,0,3,0
59295,5,3,207601,207601,207604,0,3,2
59296,6,3,207607,207607,207610,0,3,3
59297,4,1,207611,207611,207612,0,1,1
59298,2,2,207613,207613,207615,0,2,1
59299,3,2,207616,207616,207618,0,2,1
59300,5,1,207621,207621,207622,0,1,3
59301,1,2,207622,207622,207624,0,2,0
59302,1,2,207623,207624,207626,1,3,0
59303,5,3,207628,207628,207631,0,3,2
59304,3,3,207631,207631,207634,0,3,0
59305,1,3,207632,207634,207637,2,5,0
59306,2,2,207634,207637,207639,3,5,0
59307,4,2,207638,207639,207641,1,3,0
59308,1,3,207639,207641,207644,2,5,0
59309,5,1,207644,207644,207645,0,1,0
59310,6,2,207650,207650,207652,0,2,5
59311,3,1,207653,207653,207654,0,1,1
59312,1,1,207654,207654,207655,0,1,0
59313,5,1,207659,207659,207660,0,1,4
59314,1,1,207660,207660,207661,0,1,0
59315,5,2,207665,207665,207667,0,2,4
59316,5,1,207670,207670,207671,0,1,3
59317,6,3,207676,207676,207679,0,3,5
59318,2,1,207678,207679,207680,1,2,0
59319,3,2,207681,207681,207683,0,2,1
59320,6,1,207687,207687,207688,0,1,4
59321,4,3,207691,207691,207694,0,3,3
59322,1,1,207692,207694,207695,2,3,0
59323,1,3,207693,207695,207698,2,5,0
59324,1,2,207694,207698,207700,4,6,0
59325,3,2,207697,207700,207702,3,5,0
59326,1,1,207698,207702,207703,4,5,0
59327,6,3,207704,207704,207707,0,3,1
59328,5,3,207709,207709,207712,0,3,2
59329,6,3,207715,207715,207718,0,3,3
59330,5,3,207720,207720,207723,0,3,2
59331,5,2,207725,207725,207727,0,2,2
59332,6,3,207731,207731,207734,0,3,4
59333,6,3,207737,207737,207740,0,3,3
59334,6,2,207743,207743,207745,0,2,3
59335,4,3,207747,207747,207750,0,3,2
59336,1,1,207748,207750,207751,2,3,0
59337,4,3,207752,207752,207755,0,3,1
59338,3,2,207755,207755,207757,0,2,0
59339,6,2,207761,207761,207763,0,2,4
59340,4,1,207765,207765,207766,0,1,2
59341,3,2,207768,207768,207770,0,2,2
59342,1,2,207769,207770,207772,1,3,0
59343,3,1,207772,207772,207773,0,1,0
59344,1,1,207773,207773,207774,0,1,0
59345,2,3,207775,207775,207778,0,3,1
59346,4,1,207779,207779,207780,0,1,1
59347,5,3,207784,207784,207787,0,3,4
59348,4,3,207788,207788,207791,0,3,1
59349,2,1,207790,207791,207792,1,2,0
59350,2,2,207792,207792,207794,0,2,0
59351,1,2,207793,207794,207796,1,3,0
59352,6,3,207799,207799,207802,0,3,3
59353,4,3,207803,207803,207806,0,3,1
59354,4,3,207807,207807,207810,0,3,1
59355,1,1,207808,207810,207811,2,3,0
59356,6,2,207814,207814,207816,0,2,3
59357,6,3,207820,207820,207823,0,3,4
59358,2,3,207822,207823,207826,1,4,0
59359,3,2,207825,207826,207828,1,3,0
59360,6,3,207831,207831,207834,0,3,3
59361,5,2,207836,207836,207838,0,2,2
59362,5,1,207841,207841,207842,0,1,3
59363,3,3,207844,207844,207847,0,3,2
59364,1,3,207845,207847,207850,2,5,0
59365,6,1,207851,207851,207852,0,1,1
59366,1,1,207852,207852,207853,0,1,0
59367,1,3,207853,207853,207856,0,3,0
59368,4,1,207857,207857,207858,0,1,1
59369,1,2,207858,207858,207860,0,2,0
59370,4,1,207862,207862,207863,0,1,2
59371,2,2,207864,207864,207866,0,2,1
59372,6,2,207870,207870,207872,0,2,4
59373,4,1,207874,207874,207875,0,1,2
59374,1,2,207875,207875,207877,0,2,0
59375,2,1,207877,207877,207878,0,1,0
59376,4,3,207881,207881,207884,0,3,3
59377,6,1,207887,207887,207888,0,1,3
59378,6,1,207893,207893,207894,0,1,5
59379,1,2,207894,207894,207896,0,2,0
59380,2,3,207896,207896,207899,0,3,0
59381,4,3,207900,207900,207903,0,3,1
59382,4,3,207904,207904,207907,0,3,1
59383,2,1,207906,207907,207908,1,2,0
59384,3,3,207909,207909,207912,0,3,1
59385,4,2,207913,207913,207915,0,2,1
59386,3,3,207916,207916,207919,0,3,1
59387,6,3,207922,207922,207925,0,3,3
59388,4,3,207926,207926,207929,0,3,1
59389,5,2,207931,207931,207933,0,2,2
59390,2,1,207933,207933,207934,0,1,0
59391,6,3,207939,207939,207942,0,3,5
59392,2,2,207941,207942,207944,1,3,0
59393,4,2,207945,207945,207947,0,2,1
59394,2,3,207947,207947,207950,0,3,0
59395,4,1,207951,207951,207952,0,1,1
59396,2,1,207953,207953,207954,0,1,1
59397,4,3,207957,207957,207960,0,3,3
59398,6,1,207963,207963,207964,0,1,3
59399,5,3,207968,207968,207971,0,3,4
59400,4,1,207972,207972,207973,0,1,1
59401,6,2,207978,207978,207980,0,2,5
59402,3,3,207981,207981,207984,0,3,1
59403,2,1,207983,207984,207985,1,2,0
59404,2,1,207985,207985,207986,0,1,0
59405,1,3,207986,207986,207989,0,3,0
59406,5,1,207991,207991,207992,0,1,2
59407,2,3,207993,207993,207996,0,3,1
59408,2,2,207995,207996,207998,1,3,0
59409,5,2,208000,208000,208002,0,2,2
59410,3,3,208003,208003,208006,0,3,1
59411,4,3,208007,208007,208010,0,3,1
59412,4,3,208011,208011,208014,0,3,1
59413,3,2,208014,208014,208016,0,2,0
59414,3,2,208017,208017,208019,0,2,1
59415,2,2,208019,208019,208021,0,2,0
59416,5,2,208024,208024,208026,0,2,3
59417,4,1,208028,208028,208029,0,1,2
59418,1,3,208029,208029,208032,0,3,0
59419,6,3,208035,208035,208038,0,3,3
59420,1,2,208036,208038,208040,2,4,0
59421,3,3,208039,208040,208043,1,4,0
59422,1,1,208040,208043,208044,3,4,0
59423,5,3,208045,208045,208048,0,3,1
59424,2,1,208047,208048,208049,1,2,0
59425,3,2,208050,208050,208052,0,2,1
59426,5,3,208055,208055,208058,0,3,3
59427,3,3,208058,208058,208061,0,3,0
59428,1,3,208059,208061,208064,2,5,0
59429,4,3,208063,208064,208067,1,4,0
59430,4,1,208067,208067,208068,0,1,0
59431,6,3,208073,208073,208076,0,3,5
59432,6,1,208079,208079,208080,0,1,3
59433,2,1,208081,208081,208082,0,1,1
59434,3,1,208084,208084,208085,0,1,2
59435,1,3,208085,208085,208088,0,3,0
59436,2,1,208087,208088,208089,1,2,0
59437,2,1,208089,208089,208090,0,1,0
59438,3,1,208092,208092,208093,0,1,2
59439,4,3,208096,208096,208099,0,3,3
59440,5,3,208101,208101,208104,0,3,2
59441,2,1,208103,208104,208105,1,2,0
59442,5,3,208108,208108,208111,0,3,3
59443,2,2,208110,208111,208113,1,3,0
59444,4,2,208114,208114,208116,0,2,1
59445,2,2,208116,208116,208118,0,2,0
59446,5,1,208121,208121,208122,0,1,3
59447,5,2,208126,208126,208128,0,2,4
59448,3,3,208129,208129,208132,0,3,1
59449,2,2,208131,208132,208134,1,3,0
59450,3,1,208134,208134,208135,0,1,0
59451,2,3,208136,208136,208139,0,3,1
59452,5,2,208141,208141,208143,0,2,2
59453,1,2,208142,208143,208145,1,3,0
59454,4,2,208146,208146,208148,0,2,1
59455,4,2,208150,208150,208152,0,2,2
59456,6,2,208156,208156,208158,0,2,4
59457,4,1,208160,208160,208161,0,1,2
59458,1,1,208161,208161,208162,0,1,0
59459,6,1,208167,208167,208168,0,1,5
59460,2,3,208169,208169,208172,0,3,1
59461,6,1,208175,208175,208176,0,1,3
59462,5,3,208180,208180,208183,0,3,4
59463,3,3,208183,208183,208186,0,3,0
59464,4,2,208187,208187,208189,0,2,1
59465,2,2,208189,208189,208191,0,2,0
59466,6,3,208195,208195,208198,0,3,4
59467,3,3,208198,208198,208201,0,3,0
59468,5,3,208203,208203,208206,0,3,2
59469,2,1,208205,208206,208207,1,2,0
59470,1,2,208206,208207,208209,1,3,0
59471,4,2,208210,208210,208212,0,2,1
59472,4,3,208214,208214,208217,0,3,2
59473,5,3,208219,208219,208222,0,3,2
59474,2,1,208221,208222,208223,1,2,0
59475,5,1,208226,208226,208227,0,1,3
59476,1,3,208227,208227,208230,0,3,0
59477,3,1,208230,208230,208231,0,1,0
59478,4,2,208234,208234,208236,0,2,3
59479,6,1,208240,208240,208241,0,1,4
59480,5,2,208245,208245,208247,0,2,4
59481,6,1,208251,208251,208252,0,1,4
59482,6,2,208257,208257,208259,0,2,5
59483,1,1,208258,208259,208260,1,2,0
59484,4,1,208262,208262,208263,0,1,2
59485,3,3,208265,208265,208268,0,3,2
59486,3,1,208268,208268,208269,0,1,0
59487,5,2,208273,208273,208275,0,2,4
59488,5,3,208278,208278,208281,0,3,3
59489,6,1,208284,208284,208285,0,1,3
59490,1,1,208285,208285,208286,0,1,0
59491,5,2,208290,208290,208292,0,2,4
59492,5,1,208295,208295,208296,0,1,3
59493,1,3,208296,208296,208299,0,3,0
59494,1,3,208297,208299,208302,2,5,0
59495,6,3,208303,208303,208306,0,3,1
59496,1,2,208304,208306,208308,2,4,0
59497,3,2,208307,208308,208310,1,3,0
59498,2,2,208309,208310,208312,1,3,0
59499,3,3,208312,208312,208315,0,3,0
59500,4,2,208316,208316,208318,0,2,1
59501,1,2,208317,208318,208320,1,3,0
59502,2,1,208319,208320,208321,1,2,0
59503,5,2,208324,208324,208326,0,2,3
59504,3,2,208327,208327,208329,0,2,1
59505,2,1,208329,208329,208330,0,1,0
59506,3,1,208332,208332,208333,0,1,2
59507,5,2,208337,208337,208339,0,2,4
59508,6,1,208343,208343,208344,0,1,4
59509,2,3,208345,208345,208348,0,3,1
59510,2,1,208347,208348,208349,1,2,0
59511,3,1,208350,208350,208351,0,1,1
59512,3,1,208353,208353,208354,0,1,2
59513,1,1,208354,208354,208355,0,1,0
59514,6,2,208360,208360,208362,0,2,5
59515,3,1,208363,208363,208364,0,1,1
59516,3,2,208366,208366,208368,0,2,2
59517,5,2,208371,208371,208373,0,2,3
59518,6,1,208377,208377,208378,0,1,4
59519,1,1,208378,208378,208379,0,1,0
59520,5,1,208383,208383,208384,0,1,4
59521,3,3,208386,208386,208389,0,3,2
59522,4,2,208390,208390,208392,0,2,1
59523,4,2,208394,208394,208396,0,2,2
59524,5,2,208399,208399,208401,0,2,3
59525,6,2,208405,208405,208407,0,2,4
59526,3,2,208408,208408,208410,0,2,1
59527,5,2,208413,208413,208415,0,2,3
59528,6,1,208419,208419,208420,0,1,4
59529,2,3,208421,208421,208424,0,3,1
59530,6,1,208427,208427,208428,0,1,3
59531,5,3,208432,208432,208435,0,3,4
59532,4,2,208436,208436,208438,0,2,1
59533,5,1,208441,208441,208442,0,1,3
59534,1,1,208442,208442,208443,0,1,0
59535,3,1,208445,208445,208446,0,1,2
59536,2,2,208447,208447,208449,0,2,1
59537,5,3,208452,208452,208455,0,3,3
59538,3,3,208455,208455,208458,0,3,0
59539,1,1,208456,208458,208459,2,3,0
59540,3,3,208459,208459,208462,0,3,0
59541,4,1,208463,208463,208464,0,1,1
59542,3,3,208466,208466,208469,0,3,2
59543,2,3,208468,208469,208472,1,4,0
59544,5,3,208473,208473,208476,0,3,1
59545,1,2,208474,208476,208478,2,4,0
59546,2,3,208476,208478,208481,2,5,0
59547,5,2,208481,208481,208483,0,2,0
59548,2,3,208483,208483,208486,0,3,0
59549,1,1,208484,208486,208487,2,3,0
59550,3,3,208487,208487,208490,0,3,0
59551,1,2,208488,208490,208492,2,4,0
59552,3,2,208491,208492,208494,1,3,0
59553,4,2,208495,208495,208497,0,2,1
59554,1,3,208496,208497,208500,1,4,0
59555,4,2,208500,208500,208502,0,2,0
59556,3,2,208503,208503,208505,0,2,1
59557,6,1,208509,208509,208510,0,1,4
59558,5,1,208514,208514,208515,0,1,4
59559,6,2,208520,208520,208522,0,2,5
59560,5,1,208525,208525,208526,0,1,3
59561,5,1,208530,208530,208531,0,1,4
59562,6,1,208536,208536,208537,0,1,5
59563,4,2,208540,208540,208542,0,2,3
59564,3,2,208543,208543,208545,0,2,1
59565,2,3,208545,208545,208548,0,3,0
59566,3,3,208548,208548,208551,0,3,0
59567,3,1,208551,208551,208552,0,1,0
59568,3,3,208554,208554,208557,0,3,2
59569,2,1,208556,208557,208558,1,2,0
59570,5,3,208561,208561,208564,0,3,3
59571,3,3,208564,208564,208567,0,3,0
59572,5,2,208569,208569,208571,0,2,2
59573,5,2,208574,208574,208576,0,2,3
59574,3,3,208577,208577,208580,0,3,1
59575,4,2,208581,208581,208583,0,2,1
59576,4,3,208585,208585,208588,0,3,2
59577,5,2,208590,208590,208592,0,2,2
59578,2,1,208592,208592,208593,0,1,0
59579,5,2,208597,208597,208599,0,2,4
59580,3,3,208600,208600,208603,0,3,1
59581,2,2,208602,208603,208605,1,3,0
59582,1,3,208603,208605,208608,2,5,0
59583,3,1,208606,208608,208609,2,3,0
59584,4,2,208610,208610,208612,0,2,1
59585,4,1,208614,208614,208615,0,1,2
59586,4,3,208618,208618,208621,0,3,3
59587,2,3,208620,208621,208624,1,4,0
59588,1,2,208621,208624,208626,3,5,0
59589,5,2,208626,208626,208628,0,2,0
59590,3,1,208629,208629,208630,0,1,1
59591,5,3,208634,208634,208637,0,3,4
59592,2,2,208636,208637,208639,1,3,0
59593,6,2,208642,208642,208644,0,2,3
59594,5,3,208647,208647,208650,0,3,3
59595,5,2,208652,208652,208654,0,2,2
59596,2,2,208654,208654,208656,0,2,0
59597,1,2,208655,208656,208658,1,3,0
59598,2,2,208657,208658,208660,1,3,0
59599,2,3,208659,208660,208663,1,4,0
59600,6,1,208665,208665,208666,0,1,2
59601,4,1,208669,208669,208670,0,1,3
59602,6,1,208675,208675,208676,0,1,5
59603,4,1,208679,208679,208680,0,1,3
59604,6,1,208685,208685,208686,0,1,5
59605,5,1,208690,208690,208691,0,1,4
59606,2,2,208692,208692,208694,0,2,1
59607,1,2,208693,208694,208696,1,3,0
59608,5,1,208698,208698,208699,0,1,2
59609,6,3,208704,208704,208707,0,3,5
59610,2,2,208706,208707,208709,1,3,0
59611,3,2,208709,208709,208711,0,2,0
59612,5,2,208714,208714,208716,0,2,3
59613,2,2,208716,208716,208718,0,2,0
59614,1,1,208717,208718,208719,1,2,0
59615,1,1,208718,208719,208720,1,2,0
59616,6,2,208724,208724,208726,0,2,4
59617,5,3,208729,208729,208732,0,3,3
59618,3,2,208732,208732,208734,0,2,0
59619,5,1,208737,208737,208738,0,1,3
59620,4,1,208741,208741,208742,0,1,3
59621,6,2,208747,208747,208749,0,2,5
59622,2,1,208749,208749,208750,0,1,0
59623,4,3,208753,208753,208756,0,3,3
59624,2,3,208755,208756,208759,1,4,0
59625,4,1,208759,208759,208760,0,1,0
59626,6,2,208765,208765,208767,0,2,5
59627,1,3,208766,208767,208770,1,4,0
59628,5,1,208771,208771,208772,0,1,1
59629,5,3,208776,208776,208779,0,3,4
59630,2,1,208778,208779,208780,1,2,0
59631,3,1,208781,208781,208782,0,1,1
59632,3,3,208784,208784,208787,0,3,2
59633,2,1,208786,208787,208788,1,2,0
59634,1,1,208787,208788,208789,1,2,0
59635,4,3,208791,208791,208794,0,3,2
59636,4,1,208795,208795,208796,0,1,1
59637,2,3,208797,208797,208800,0,3,1
59638,3,1,208800,208800,208801,0,1,0
59639,2,3,208802,208802,208805,0,3,1
59640,1,1,208803,208805,208806,2,3,0
59641,5,3,208808,208808,208811,0,3,2
59642,5,2,208813,208813,208815,0,2,2
59643,6,3,208819,208819,208822,0,3,4
59644,1,2,208820,208822,208824,2,4,0
59645,6,1,208826,208826,208827,0,1,2
59646,1,1,208827,208827,208828,0,1,0
59647,6,2,208833,208833,208835,0,2,5
59648,2,3,208835,208835,208838,0,3,0
59649,5,3,208840,208840,208843,0,3,2
59650,2,1,208842,208843,208844,1,2,0
59651,4,3,208846,208846,208849,0,3,2
59652,1,2,208847,208849,208851,2,4,0
59653,2,2,208849,208851,208853,2,4,0
59654,3,2,208852,208853,208855,1,3,0
59655,3,3,208855,208855,208858,0,3,0
59656,3,3,208858,208858,208861,0,3,0
59657,2,2,208860,208861,208863,1,3,0
59658,3,3,208863,208863,208866,0,3,0
59659,2,1,208865,208866,208867,1,2,0
59660,2,2,208867,208867,208869,0,2,0
59661,2,3,208869,208869,208872,0,3,0
59662,5,1,208874,208874,208875,0,1,2
59663,6,1,208880,208880,208881,0,1,5
59664,6,2,208886,208886,208888,0,2,5
59665,2,1,208888,208888,208889,0,1,0
59666,2,3,208890,208890,208893,0,3,1
59667,4,2,208894,208894,208896,0,2,1
59668,5,3,208899,208899,208902,0,3,3
59669,4,2,208903,208903,208905,0,2,1
59670,2,3,208905,208905,208908,0,3,0
59671,1,1,208906,208908,208909,2,3,0
59672,2,3,208908,208909,208912,1,4,0
59673,4,3,208912,208912,208915,0,3,0
59674,6,3,208918,208918,208921,0,3,3
59675,1,2,208919,208921,208923,2,4,0
59676,2,3,208921,208923,208926,2,5,0
59677,5,1,208926,208926,208927,0,1,0
59678,3,1,208929,208929,208930,0,1,2
59679,1,1,208930,208930,208931,0,1,0
59680,1,1,208931,208931,208932,0,1,0
59681,3,1,208934,208934,208935,0,1,2
59682,4,3,208938,208938,208941,0,3,3
59683,1,2,208939,208941,208943,2,4,0
59684,5,1,208944,208944,208945,0,1,1
59685,2,3,208946,208946,208949,0,3,1
59686,1,2,208947,208949,208951,2,4,0
59687,2,3,208949,208951,208954,2,5,0
59688,1,2,208950,208954,208956,4,6,0
59689,2,3,208952,208956,208959,4,7,0
59690,4,1,208956,208959,208960,3,4,0
59691,4,2,208960,208960,208962,0,2,0
59692,4,2,208964,208964,208966,0,2,2
59693,6,1,208970,208970,208971,0,1,4
59694,2,3,208972,208972,208975,0,3,1
59695,5,3,208977,208977,208980,0,3,2
59696,1,3,208978,208980,208983,2,5,0
59697,6,3,208984,208984,208987,0,3,1
59698,6,1,208990,208990,208991,0,1,3
59699,4,2,208994,208994,208996,0,2,3
59700,3,3,208997,208997,209000,0,3,1
59701,3,3,209000,209000,209003,0,3,0
59702,5,3,209005,209005,209008,0,3,2
59703,5,3,209010,209010,209013,0,3,2
59704,4,2,209014,209014,209016,0,2,1
59705,1,1,209015,209016,209017,1,2,0
59706,2,3,209017,209017,209020,0,3,0
59707,2,3,209019,209020,209023,1,4,0
59708,3,3,209022,209023,209026,1,4,0
59709,1,3,209023,209026,209029,3,6,0
59710,2,2,209025,209029,209031,4,6,0
59711,1,2,209026,209031,209033,5,7,0
59712,4,1,209030,209033,209034,3,4,0
59713,3,3,209033,209034,209037,1,4,0
59714,1,2,209034,209037,209039,3,5,0
59715,2,1,209036,209039,209040,3,4,0
59716,4,3,209040,209040,209043,0,3,0
59717,3,3,209043,209043,209046,0,3,0
59718,1,3,209044,209046,209049,2,5,0
59719,1,1,209045,209049,209050,4,5,0
59720,4,1,209049,209050,209051,1,2,0
59721,2,2,209051,209051,209053,0,2,0
59722,4,2,209055,209055,209057,0,2,2
59723,5,3,209060,209060,209063,0,3,3
59724,6,3,209066,209066,209069,0,3,3
59725,6,1,209072,209072,209073,0,1,3
59726,2,1,209074,209074,209075,0,1,1
59727,5,2,209079,209079,209081,0,2,4
59728,3,3,209082,209082,209085,0,3,1
59729,6,3,209088,209088,209091,0,3,3
59730,5,1,209093,209093,209094,0,1,2
59731,1,1,209094,209094,209095,0,1,0
59732,6,3,209100,209100,209103,0,3,5
59733,6,2,209106,209106,209108,0,2,3
59734,4,1,209110,209110,209111,0,1,2
59735,5,1,209115,209115,209116,0,1,4
59736,2,3,209117,209117,209120,0,3,1
59737,4,2,209121,209121,209123,0,2,1
59738,1,2,209122,209123,209125,1,3,0
59739,5,2,209127,209127,209129,0,2,2
59740,2,2,209129,209129,209131,0,2,0
59741,4,3,209133,209133,209136,0,3,2
59742,2,1,209135,209136,209137,1,2,0
59743,4,3,209139,209139,209142,0,3,2
59744,5,3,209144,209144,209147,0,3,2
59745,6,2,209150,209150,209152,0,2,3
59746,1,3,209151,209152,209155,1,4,0
59747,4,2,209155,209155,209157,0,2,0
59748,3,3,209158,209158,209161,0,3,1
59749,4,2,209162,209162,209164,0,2,1
59750,5,2,209167,209167,209169,0,2,3
59751,1,1,209168,209169,209170,1,2,0
59752,5,2,209173,209173,209175,0,2,3
59753,4,2,209177,209177,209179,0,2,2
59754,3,1,209180,209180,209181,0,1,1
59755,5,2,209185,209185,209187,0,2,4
59756,5,1,209190,209190,209191,0,1,3
59757,1,1,209191,209191,209192,0,1,0
59758,4,1,209195,209195,209196,0,1,3
59759,3,3,209198,209198,209201,0,3,2
59760,2,1,209200,209201,209202,1,2,0
59761,5,3,209205,209205,209208,0,3,3
59762,2,1,209207,209208,209209,1,2,0
59763,6,3,209213,209213,209216,0,3,4
59764,1,1,209214,209216,209217,2,3,0
59765,5,2,209219,209219,209221,0,2,2
59766,1,1,209220,209221,209222,1,2,0
59767,5,3,209225,209225,209228,0,3,3
59768,4,2,209229,209229,209231,0,2,1
59769,6,1,209235,209235,209236,0,1,4
59770,2,1,209237,209237,209238,0,1,1
59771,1,1,209238,209238,209239,0,1,0
59772,3,2,209241,209241,209243,0,2,2
59773,2,3,209243,209243,209246,0,3,0
59774,6,3,209249,209249,209252,0,3,3
59775,4,2,209253,209253,209255,0,2,1
59776,3,2,209256,209256,209258,0,2,1
59777,6,3,209262,209262,209265,0,3,4
59778,2,2,209264,209265,209267,1,3,0
59779,4,2,209268,209268,209270,0,2,1
59780,4,2,209272,209272,209274,0,2,2
59781,1,3,209273,209274,209277,1,4,0
59782,1,1,209274,209277,209278,3,4,0
59783,6,3,209280,209280,209283,0,3,2
59784,4,2,209284,209284,209286,0,2,1
59785,3,2,209287,209287,209289,0,2,1
59786,6,3,209293,209293,209296,0,3,4
59787,3,1,209296,209296,209297,0,1,0
59788,6,3,209302,209302,209305,0,3,5
59789,5,3,209307,209307,209310,0,3,2
59790,4,3,209311,209311,209314,0,3,1
59791,1,2,209312,209314,209316,2,4,0
59792,4,1,209316,209316,209317,0,1,0
59793,2,2,209318,209318,209320,0,2,1
59794,6,1,209324,209324,209325,0,1,4
59795,2,1,209326,209326,209327,0,1,1
59796,1,3,209327,209327,209330,0,3,0
59797,2,1,209329,209330,209331,1,2,0
59798,6,3,209335,209335,209338,0,3,4
59799,4,2,209339,209339,209341,0,2,1
59800,1,3,209340,209341,209344,1,4,0
59801,1,2,209341,209344,209346,3,5,0
59802,1,2,209342,209346,209348,4,6,0
59803,6,3,209348,209348,209351,0,3,0
59804,1,2,209349,209351,209353,2,4,0
59805,1,3,209350,209353,209356,3,6,0
59806,1,1,209351,209356,209357,5,6,0
59807,1,3,209352,209357,209360,5,8,0
59808,6,1,209358,209360,209361,2,3,0
59809,2,2,209360,209361,209363,1,3,0
59810,1,1,209361,209363,209364,2,3,0
59811,4,1,209365,209365,209366,0,1,1
59812,3,2,209368,209368,209370,0,2,2
59813,6,2,209374,209374,209376,0,2,4
59814,5,1,209379,209379,209380,0,1,3
59815,4,2,209383,209383,209385,0,2,3
59816,5,3,209388,209388,209391,0,3,3
59817,3,3,209391,209391,209394,0,3,0
59818,2,2,209393,209394,209396,1,3,0
59819,2,3,209395,209396,209399,1,4,0
59820,5,2,209400,209400,209402,0,2,1
59821,5,2,209405,209405,209407,0,2,3
59822,3,3,209408,209408,209411,0,3,1
59823,6,1,209414,209414,209415,0,1,3
59824,5,3,209419,209419,209422,0,3,4
59825,4,3,209423,209423,209426,0,3,1
59826,4,2,209427,209427,209429,0,2,1
59827,4,1,209431,209431,209432,0,1,2
59828,5,2,209436,209436,209438,0,2,4
59829,2,1,209438,209438,209439,0,1,0
59830,2,3,209440,209440,209443,0,3,1
59831,6,2,209446,209446,209448,0,2,3
59832,2,1,209448,209448,209449,0,1,0
59833,6,1,209454,209454,209455,0,1,5
59834,3,2,209457,209457,209459,0,2,2
59835,2,3,209459,209459,209462,0,3,0
59836,1,3,209460,209462,209465,2,5,0
59837,3,2,209463,209465,209467,2,4,0
59838,3,3,209466,209467,209470,1,4,0
59839,5,1,209471,209471,209472,0,1,1
59840,3,2,209474,209474,209476,0,2,2
59841,2,3,209476,209476,209479,0,3,0
59842,4,3,209480,209480,209483,0,3,1
59843,5,3,209485,209485,209488,0,3,2
59844,6,1,209491,209491,209492,0,1,3
59845,2,2,209493,209493,209495,0,2,1
59846,6,2,209499,209499,209501,0,2,4
59847,1,2,209500,209501,209503,1,3,0
59848,5,2,209505,209505,209507,0,2,2
59849,2,3,209507,209507,209510,0,3,0
59850,5,3,209512,209512,209515,0,3,2
59851,6,2,209518,209518,209520,0,2,3
59852,4,3,209522,209522,209525,0,3,2
59853,5,2,209527,209527,209529,0,2,2
59854,5,1,209532,209532,209533,0,1,3
59855,6,2,209538,209538,209540,0,2,5
59856,2,1,209540,209540,209541,0,1,0
59857,4,3,209544,209544,209547,0,3,3
59858,2,3,209546,209547,209550,1,4,0
59859,4,1,209550,209550,209551,0,1,0
59860,3,1,209553,209553,209554,0,1,2
59861,4,1,209557,209557,209558,0,1,3
59862,5,3,209562,209562,209565,0,3,4
59863,1,2,209563,209565,209567,2,4,0
59864,3,2,209566,209567,209569,1,3,0
59865,5,2,209571,209571,209573,0,2,2
59866,6,3,209577,209577,209580,0,3,4
59867,4,1,209581,209581,209582,0,1,1
59868,2,3,209583,209583,209586,0,3,1
59869,3,1,209586,209586,209587,0,1,0
59870,5,3,209591,209591,209594,0,3,4
59871,2,1,209593,209594,209595,1,2,0
59872,6,1,209599,209599,209600,0,1,4
59873,6,1,209605,209605,209606,0,1,5
59874,5,3,209610,209610,209613,0,3,4
59875,5,2,209615,209615,209617,0,2,2
59876,6,2,209621,209621,209623,0,2,4
59877,1,1,209622,209623,209624,1,2,0
59878,4,1,209626,209626,209627,0,1,2
59879,1,3,209627,209627,209630,0,3,0
59880,3,2,209630,209630,209632,0,2,0
59881,2,1,209632,209632,209633,0,1,0
59882,5,1,209637,209637,209638,0,1,4
59883,6,1,209643,209643,209644,0,1,5
59884,1,3,209644,209644,209647,0,3,0
59885,3,1,209647,209647,209648,0,1,0
59886,6,3,209653,209653,209656,0,3,5
59887,2,1,209655,209656,209657,1,2,0
59888,3,3,209658,209658,209661,0,3,1
59889,5,1,209663,209663,209664,0,1,2
59890,2,1,209665,209665,209666,0,1,1
59891,5,1,209670,209670,209671,0,1,4
59892,4,1,209674,209674,209675,0,1,3
59893,3,1,209677,209677,209678,0,1,2
59894,1,1,209678,209678,209679,0,1,0
59895,6,3,209684,209684,209687,0,3,5
59896,3,2,209687,209687,209689,0,2,0
59897,1,2,209688,209689,209691,1,3,0
59898,3,3,209691,209691,209694,0,3,0
59899,3,3,209694,209694,209697,0,3,0
59900,6,2,209700,209700,209702,0,2,3
59901,6,3,209706,209706,209709,0,3,4
59902,2,1,209708,209709,209710,1,2,0
59903,4,3,209712,209712,209715,0,3,2
59904,5,2,209717,209717,209719,0,2,2
59905,3,1,209720,209720,209721,0,1,1
59906,6,3,209726,209726,209729,0,3,5
59907,4,3,209730,209730,209733,0,3,1
59908,6,3,209736,209736,209739,0,3,3
59909,5,3,209741,209741,209744,0,3,2
59910,6,1,209747,209747,209748,0,1,3
59911,2,2,209749,209749,209751,0,2,1
59912,3,1,209752,209752,209753,0,1,1
59913,2,2,209754,209754,209756,0,2,1
59914,5,3,209759,209759,209762,0,3,3
59915,4,1,209763,209763,209764,0,1,1
59916,4,2,209767,209767,209769,0,2,3
59917,1,1,209768,209769,209770,1,2,0
59918,3,3,209771,209771,209774,0,3,1
59919,1,2,209772,209774,209776,2,4,0
59920,3,1,209775,209776,209777,1,2,0
59921,2,2,209777,209777,209779,0,2,0
59922,3,2,209780,209780,209782,0,2,1
59923,6,1,209786,209786,209787,0,1,4
59924,2,3,209788,209788,209791,0,3,1
59925,5,2,209793,209793,209795,0,2,2
59926,1,2,209794,209795,209797,1,3,0
59927,4,3,209798,209798,209801,0,3,1
59928,1,1,209799,209801,209802,2,3,0
59929,5,1,209804,209804,209805,0,1,2
59930,6,3,209810,209810,209813,0,3,5
59931,6,1,209816,209816,209817,0,1,3
59932,2,3,209818,209818,209821,0,3,1
59933,2,2,209820,209821,209823,1,3,0
59934,4,2,209824,209824,209826,0,2,1
59935,4,3,209828,209828,209831,0,3,2
59936,3,1,209831,209831,209832,0,1,0
59937,3,2,209834,209834,209836,0,2,2
59938,3,3,209837,209837,209840,0,3,1
59939,6,1,209843,209843,209844,0,1,3
59940,5,2,209848,209848,209850,0,2,4
59941,3,2,209851,209851,209853,0,2,1
59942,6,2,209857,209857,209859,0,2,4
59943,3,3,209860,209860,209863,0,3,1
59944,3,2,209863,209863,209865,0,2,0
59945,6,2,209869,209869,209871,0,2,4
59946,5,3,209874,209874,209877,0,3,3
59947,2,1,209876,209877,209878,1,2,0
59948,6,3,209882,209882,209885,0,3,4
59949,2,1,209884,209885,209886,1,2,0
59950,1,1,209885,209886,209887,1,2,0
59951,5,2,209890,209890,209892,0,2,3
59952,2,2,209892,209892,209894,0,2,0
59953,2,2,209894,209894,209896,0,2,0
59954,3,2,209897,209897,209899,0,2,1
59955,4,2,209901,209901,209903,0,2,2
59956,5,2,209906,209906,209908,0,2,3
59957,4,2,209910,209910,209912,0,2,2
59958,1,2,209911,209912,209914,1,3,0
59959,3,2,209914,209914,209916,0,2,0
59960,6,3,209920,209920,209923,0,3,4
59961,6,1,209926,209926,209927,0,1,3
59962,3,1,209929,209929,209930,0,1,2
59963,5,3,209934,209934,209937,0,3,4
59964,1,3,209935,209937,209940,2,5,0
59965,1,3,209936,209940,209943,4,7,0
59966,5,2,209941,209943,209945,2,4,0
59967,5,1,209946,209946,209947,0,1,1
59968,2,3,209948,209948,209951,0,3,1
59969,6,3,209954,209954,209957,0,3,3
59970,1,1,209955,209957,209958,2,3,0
59971,3,3,209958,209958,209961,0,3,0
59972,1,3,209959,209961,209964,2,5,0
59973,3,1,209962,209964,209965,2,3,0
59974,5,3,209967,209967,209970,0,3,2
59975,1,1,209968,209970,209971,2,3,0
59976,3,2,209971,209971,209973,0,2,0
59977,6,1,209977,209977,209978,0,1,4
59978,2,3,209979,209979,209982,0,3,1
59979,2,3,209981,209982,209985,1,4,0
59980,1,3,209982,209985,209988,3,6,0
59981,4,3,209986,209988,209991,2,5,0
59982,5,3,209991,209991,209994,0,3,0
59983,1,2,209992,209994,209996,2,4,0
59984,6,2,209998,209998,210000,0,2,2
59985,4,2,210002,210002,210004,0,2,2
59986,2,2,210004,210004,210006,0,2,0
59987,1,2,210005,210006,210008,1,3,0
59988,4,1,210009,210009,210010,0,1,1
59989,3,2,210012,210012,210014,0,2,2
59990,1,1,210013,210014,210015,1,2,0
59991,3,3,210016,210016,210019,0,3,1
59992,5,2,210021,210021,210023,0,2,2
59993,5,2,210026,210026,210028,0,2,3
59994,4,2,210030,210030,210032,0,2,2
59995,5,3,210035,210035,210038,0,3,3
59996,6,3,210041,210041,210044,0,3,3
59997,1,1,210042,210044,210045,2,3,0
59998,4,3,210046,210046,210049,0,3,1
59999,2,1,210048,210049,210050,1,2,0
60000,1,1,210049,210050,210051,1,2,0
60001,6,2,210055,210055,210057,0,2,4
60002,5,1,210060,210060,210061,0,1,3
60003,2,3,210062,210062,210065,0,3,1
60004,5,3,210067,210067,210070,0,3,2
60005,1,2,210068,210070,210072,2,4,0
60006,3,1,210071,210072,210073,1,2,0
60007,5,1,210076,210076,210077,0,1,3
60008,2,3,210078,210078,210081,0,3,1
60009,3,3,210081,210081,210084,0,3,0
60010,6,1,210087,210087,210088,0,1,3
60011,5,1,210092,210092,210093,0,1,4
60012,4,2,210096,210096,210098,0,2,3
60013,4,1,210100,210100,210101,0,1,2
60014,5,3,210105,210105,210108,0,3,4
60015,1,2,210106,210108,210110,2,4,0
60016,4,1,210110,210110,210111,0,1,0
60017,1,3,210111,210111,210114,0,3,0
60018,2,1,210113,210114,210115,1,2,0
60019,4,1,210117,210117,210118,0,1,2
60020,6,1,210123,210123,210124,0,1,5
60021,4,2,210127,210127,210129,0,2,3
60022,6,2,210133,210133,210135,0,2,4
60023,3,1,210136,210136,210137,0,1,1
60024,6,2,210142,210142,210144,0,2,5
60025,6,3,210148,210148,210151,0,3,4
60026,1,1,210149,210151,210152,2,3,0
60027,2,2,210151,210152,210154,1,3,0
60028,4,2,210155,210155,210157,0,2,1
60029,4,3,210159,210159,210162,0,3,2
60030,3,3,210162,210162,210165,0,3,0
60031,5,1,210167,210167,210168,0,1,2
60032,4,3,210171,210171,210174,0,3,3
60033,3,2,210174,210174,210176,0,2,0
60034,1,3,210175,210176,210179,1,4,0
60035,1,1,210176,210179,210180,3,4,0
60036,2,2,210178,210180,210182,2,4,0
60037,4,2,210182,210182,210184,0,2,0
60038,1,1,210183,210184,210185,1,2,0
60039,4,1,210187,210187,210188,0,1,2
60040,5,1,210192,210192,210193,0,1,4
60041,4,1,210196,210196,210197,0,1,3
60042,3,3,210199,210199,210202,0,3,2
60043,3,1,210202,210202,210203,0,1,0
60044,1,3,210203,210203,210206,0,3,0
60045,5,2,210208,210208,210210,0,2,2
60046,5,3,210213,210213,210216,0,3,3
60047,4,2,210217,210217,210219,0,2,1
60048,2,1,210219,210219,210220,0,1,0
60049,3,1,210222,210222,210223,0,1,2
60050,2,3,210224,210224,210227,0,3,1
60051,6,1,210230,210230,210231,0,1,3
60052,4,2,210234,210234,210236,0,2,3
60053,2,2,210236,210236,210238,0,2,0
60054,2,3,210238,210238,210241,0,3,0
60055,6,3,210244,210244,210247,0,3,3
60056,5,2,210249,210249,210251,0,2,2
60057,2,2,210251,210251,210253,0,2,0
60058,2,3,210253,210253,210256,0,3,0
60059,2,2,210255,210256,210258,1,3,0
60060,4,1,210259,210259,210260,0,1,1
60061,1,1,210260,210260,210261,0,1,0
60062,1,2,210261,210261,210263,0,2,0
60063,2,1,210263,210263,210264,0,1,0
60064,5,1,210268,210268,210269,0,1,4
60065,2,2,210270,210270,210272,0,2,1
60066,6,1,210276,210276,210277,0,1,4
60067,2,2,210278,210278,210280,0,2,1
60068,1,1,210279,210280,210281,1,2,0
60069,5,2,210284,210284,210286,0,2,3
60070,6,2,210290,210290,210292,0,2,4
60071,4,1,210294,210294,210295,0,1,2
60072,4,1,210298,210298,210299,0,1,3
60073,3,2,210301,210301,210303,0,2,2
60074,4,3,210305,210305,210308,0,3,2
60075,3,1,210308,210308,210309,0,1,0
60076,2,3,210310,210310,210313,0,3,1
60077,3,3,210313,210313,210316,0,3,0
60078,6,1,210319,210319,210320,0,1,3
60079,5,1,210324,210324,210325,0,1,4
60080,4,1,210328,210328,210329,0,1,3
60081,4,1,210332,210332,210333,0,1,3
60082,1,3,210333,210333,210336,0,3,0
60083,2,1,210335,210336,210337,1,2,0
60084,3,2,210338,210338,210340,0,2,1
60085,4,2,210342,210342,210344,0,2,2
60086,6,1,210348,210348,210349,0,1,4
60087,3,2,210351,210351,210353,0,2,2
60088,3,2,210354,210354,210356,0,2,1
60089,6,2,210360,210360,210362,0,2,4
60090,5,1,210365,210365,210366,0,1,3
60091,2,2,210367,210367,210369,0,2,1
60092,3,1,210370,210370,210371,0,1,1
60093,2,3,210372,210372,210375,0,3,1
60094,4,2,210376,210376,210378,0,2,1
60095,6,2,210382,210382,210384,0,2,4
60096,4,2,210386,210386,210388,0,2,2
60097,4,3,210390,210390,210393,0,3,2
60098,3,1,210393,210393,210394,0,1,0
60099,2,2,210395,210395,210397,0,2,1
60100,5,3,210400,210400,210403,0,3,3
60101,3,3,210403,210403,210406,0,3,0
60102,2,3,210405,210406,210409,1,4,0
60103,4,1,210409,210409,210410,0,1,0
60104,2,2,210411,210411,210413,0,2,1
60105,1,3,210412,210413,210416,1,4,0
60106,3,3,210415,210416,210419,1,4,0
60107,2,2,210417,210419,210421,2,4,0
60108,4,1,210421,210421,210422,0,1,0
60109,2,2,210423,210423,210425,0,2,1
60110,4,1,210427,210427,210428,0,1,2
60111,5,2,210432,210432,210434,0,2,4
60112,5,2,210437,210437,210439,0,2,3
60113,3,3,210440,210440,210443,0,3,1
60114,3,3,210443,210443,210446,0,3,0
60115,5,3,210448,210448,210451,0,3,2
60116,6,2,210454,210454,210456,0,2,3
60117,1,3,210455,210456,210459,1,4,0
60118,3,2,210458,210459,210461,1,3,0
60119,1,2,210459,210461,210463,2,4,0
60120,4,2,210463,210463,210465,0,2,0
60121,4,3,210467,210467,210470,0,3,2
60122,6,3,210473,210473,210476,0,3,3
60123,3,2,210476,210476,210478,0,2,0
60124,2,2,210478,210478,210480,0,2,0
60125,1,1,210479,210480,210481,1,2,0
60126,4,3,210483,210483,210486,0,3,2
60127,3,3,210486,210486,210489,0,3,0
60128,5,3,210491,210491,210494,0,3,2
60129,3,1,210494,210494,210495,0,1,0
60130,4,3,210498,210498,210501,0,3,3
60131,5,2,210503,210503,210505,0,2,2
60132,4,3,210507,210507,210510,0,3,2
60133,2,3,210509,210510,210513,1,4,0
60134,6,2,210515,210515,210517,0,2,2
60135,6,3,210521,210521,210524,0,3,4
60136,2,3,210523,210524,210527,1,4,0
60137,3,1,210526,210527,210528,1,2,0
60138,4,2,210530,210530,210532,0,2,2
60139,5,3,210535,210535,210538,0,3,3
60140,3,1,210538,210538,210539,0,1,0
60141,2,2,210540,210540,210542,0,2,1
60142,2,2,210542,210542,210544,0,2,0
60143,5,2,210547,210547,210549,0,2,3
60144,6,1,210553,210553,210554,0,1,4
60145,1,2,210554,210554,210556,0,2,0
60146,1,1,210555,210556,210557,1,2,0
60147,2,3,210557,210557,210560,0,3,0
60148,1,2,210558,210560,210562,2,4,0
60149,5,3,210563,210563,210566,0,3,1
60150,6,2,210569,210569,210571,0,2,3
60151,5,1,210574,210574,210575,0,1,3
60152,2,3,210576,210576,210579,0,3,1
60153,5,2,210581,210581,210583,0,2,2
60154,4,1,210585,210585,210586,0,1,2
60155,1,2,210586,210586,210588,0,2,0
60156,3,3,210589,210589,210592,0,3,1
60157,5,3,210594,210594,210597,0,3,2
60158,3,3,210597,210597,210600,0,3,0
60159,2,3,210599,210600,210603,1,4,0
60160,5,1,210604,210604,210605,0,1,1
60161,3,2,210607,210607,210609,0,2,2
60162,3,1,210610,210610,210611,0,1,1
60163,3,1,210613,210613,210614,0,1,2
60164,4,3,210617,210617,210620,0,3,3
60165,4,2,210621,210621,210623,0,2,1
60166,3,3,210624,210624,210627,0,3,1
60167,1,1,210625,210627,210628,2,3,0
60168,3,3,210628,210628,210631,0,3,0
60169,6,2,210634,210634,210636,0,2,3
60170,2,3,210636,210636,210639,0,3,0
60171,2,1,210638,210639,210640,1,2,0
60172,2,3,210640,210640,210643,0,3,0
60173,5,1,210645,210645,210646,0,1,2
60174,3,3,210648,210648,210651,0,3,2
60175,3,1,210651,210651,210652,0,1,0
60176,4,2,210655,210655,210657,0,2,3
60177,2,1,210657,210657,210658,0,1,0
60178,3,2,210660,210660,210662,0,2,2
60179,3,2,210663,210663,210665,0,2,1
60180,2,1,210665,210665,210666,0,1,0
60181,6,2,210671,210671,210673,0,2,5
60182,3,3,210674,210674,210677,0,3,1
60183,1,2,210675,210677,210679,2,4,0
60184,2,3,210677,210679,210682,2,5,0
60185,2,2,210679,210682,210684,3,5,0
60186,2,2,210681,210684,210686,3,5,0
60187,5,1,210686,210686,210687,0,1,0
60188,1,1,210687,210687,210688,0,1,0
60189,4,2,210691,210691,210693,0,2,3
60190,5,1,210696,210696,210697,0,1,3
60191,6,1,210702,210702,210703,0,1,5
60192,5,1,210707,210707,210708,0,1,4
60193,4,1,210711,210711,210712,0,1,3
60194,6,2,210717,210717,210719,0,2,5
60195,2,1,210719,210719,210720,0,1,0
60196,6,2,210725,210725,210727,0,2,5
60197,3,3,210728,210728,210731,0,3,1
60198,3,2,210731,210731,210733,0,2,0
60199,2,2,210733,210733,210735,0,2,0
60200,6,3,210739,210739,210742,0,3,4
60201,1,1,210740,210742,210743,2,3,0
60202,2,3,210742,210743,210746,1,4,0
60203,2,1,210744,210746,210747,2,3,0
60204,2,3,210746,210747,210750,1,4,0
60205,3,3,210749,210750,210753,1,4,0
60206,5,1,210754,210754,210755,0,1,1
60207,4,3,210758,210758,210761,0,3,3
60208,5,3,210763,210763,210766,0,3,2
60209,3,3,210766,210766,210769,0,3,0
60210,5,1,210771,210771,210772,0,1,2
60211,6,3,210777,210777,210780,0,3,5
60212,4,2,210781,210781,210783,0,2,1
60213,5,1,210786,210786,210787,0,1,3
60214,4,3,210790,210790,210793,0,3,3
60215,2,3,210792,210793,210796,1,4,0
60216,6,2,210798,210798,210800,0,2,2
60217,5,1,210803,210803,210804,0,1,3
60218,1,1,210804,210804,210805,0,1,0
60219,6,3,210810,210810,210813,0,3,5
60220,6,3,210816,210816,210819,0,3,3
60221,4,1,210820,210820,210821,0,1,1
60222,4,2,210824,210824,210826,0,2,3
60223,5,1,210829,210829,210830,0,1,3
60224,5,2,210834,210834,210836,0,2,4
60225,3,2,210837,210837,210839,0,2,1
60226,3,2,210840,210840,210842,0,2,1
60227,4,3,210844,210844,210847,0,3,2
60228,5,1,210849,210849,210850,0,1,2
60229,1,2,210850,210850,210852,0,2,0
60230,5,3,210855,210855,210858,0,3,3
60231,2,3,210857,210858,210861,1,4,0
60232,6,3,210863,210863,210866,0,3,2
60233,1,3,210864,210866,210869,2,5,0
60234,1,2,210865,210869,210871,4,6,0
60235,6,3,210871,210871,210874,0,3,0
60236,1,2,210872,210874,210876,2,4,0
60237,5,1,210877,210877,210878,0,1,1
60238,6,3,210883,210883,210886,0,3,5
60239,2,2,210885,210886,210888,1,3,0
60240,3,1,210888,210888,210889,0,1,0
60241,4,1,210892,210892,210893,0,1,3
60242,1,2,210893,210893,210895,0,2,0
60243,1,2,210894,210895,210897,1,3,0
60244,2,3,210896,210897,210900,1,4,0
60245,6,2,210902,210902,210904,0,2,2
60246,6,1,210908,210908,210909,0,1,4
60247,5,2,210913,210913,210915,0,2,4
60248,4,1,210917,210917,210918,0,1,2
60249,4,3,210921,210921,210924,0,3,3
60250,2,3,210923,210924,210927,1,4,0
60251,2,3,210925,210927,210930,2,5,0
60252,2,1,210927,210930,210931,3,4,0
60253,1,1,210928,210931,210932,3,4,0
60254,4,3,210932,210932,210935,0,3,0
60255,1,1,210933,210935,210936,2,3,0
60256,4,3,210937,210937,210940,0,3,1
60257,3,2,210940,210940,210942,0,2,0
60258,6,2,210946,210946,210948,0,2,4
60259,4,2,210950,210950,210952,0,2,2
60260,3,3,210953,210953,210956,0,3,1
60261,4,3,210957,210957,210960,0,3,1
60262,5,1,210962,210962,210963,0,1,2
60263,6,1,210968,210968,210969,0,1,5
60264,1,2,210969,210969,210971,0,2,0
60265,6,3,210975,210975,210978,0,3,4
60266,4,3,210979,210979,210982,0,3,1
60267,6,2,210985,210985,210987,0,2,3
60268,4,2,210989,210989,210991,0,2,2
60269,5,3,210994,210994,210997,0,3,3
60270,3,1,210997,210997,210998,0,1,0
60271,6,1,211003,211003,211004,0,1,5
60272,3,2,211006,211006,211008,0,2,2
60273,2,3,211008,211008,211011,0,3,0
60274,2,1,211010,211011,211012,1,2,0
60275,1,3,211011,211012,211015,1,4,0
60276,5,1,211016,211016,211017,0,1,1
60277,1,2,211017,211017,211019,0,2,0
60278,2,2,211019,211019,211021,0,2,0
60279,5,3,211024,211024,211027,0,3,3
60280,5,1,211029,211029,211030,0,1,2
60281,6,1,211035,211035,211036,0,1,5
60282,2,3,211037,211037,211040,0,3,1
60283,2,3,211039,211040,211043,1,4,0
60284,4,1,211043,211043,211044,0,1,0
60285,1,3,211044,211044,211047,0,3,0
60286,3,1,211047,211047,211048,0,1,0
60287,4,1,211051,211051,211052,0,1,3
60288,6,1,211057,211057,211058,0,1,5
60289,2,1,211059,211059,211060,0,1,1
60290,6,2,211065,211065,211067,0,2,5
60291,6,2,211071,211071,211073,0,2,4
60292,6,1,211077,211077,211078,0,1,4
60293,2,3,211079,211079,211082,0,3,1
60294,1,1,211080,211082,211083,2,3,0
60295,4,1,211084,211084,211085,0,1,1
60296,3,1,211087,211087,211088,0,1,2
60297,3,2,211090,211090,211092,0,2,2
60298,6,3,211096,211096,211099,0,3,4
60299,4,2,211100,211100,211102,0,2,1
60300,3,1,211103,211103,211104,0,1,1
60301,2,2,211105,211105,211107,0,2,1
60302,2,3,211107,211107,211110,0,3,0
60303,4,2,211111,211111,211113,0,2,1
60304,5,1,211116,211116,211117,0,1,3
60305,2,1,211118,211118,211119,0,1,1
60306,4,2,211122,211122,211124,0,2,3
60307,4,2,211126,211126,211128,0,2,2
60308,2,1,211128,211128,211129,0,1,0
60309,6,2,211134,211134,211136,0,2,5
60310,5,3,211139,211139,211142,0,3,3
60311,2,1,211141,211142,211143,1,2,0
60312,5,1,211146,211146,211147,0,1,3
60313,5,3,211151,211151,211154,0,3,4
60314,4,3,211155,211155,211158,0,3,1
60315,5,3,211160,211160,211163,0,3,2
60316,5,2,211165,211165,211167,0,2,2
60317,6,1,211171,211171,211172,0,1,4
60318,3,2,211174,211174,211176,0,2,2
60319,3,1,211177,211177,211178,0,1,1
60320,6,3,211183,211183,211186,0,3,5
60321,5,1,211188,211188,211189,0,1,2
60322,1,3,211189,211189,211192,0,3,0
60323,1,3,211190,211192,211195,2,5,0
60324,5,2,211195,211195,211197,0,2,0
60325,1,1,211196,211197,211198,1,2,0
60326,4,3,211200,211200,211203,0,3,2
60327,6,2,211206,211206,211208,0,2,3
60328,6,2,211212,211212,211214,0,2,4
60329,5,2,211217,211217,211219,0,2,3
60330,5,1,211222,211222,211223,0,1,3
60331,6,1,211228,211228,211229,0,1,5
60332,6,2,211234,211234,211236,0,2,5
60333,4,1,211238,211238,211239,0,1,2
60334,6,2,211244,211244,211246,0,2,5
60335,3,3,211247,211247,211250,0,3,1
60336,4,2,211251,211251,211253,0,2,1
60337,2,3,211253,211253,211256,0,3,0
60338,1,2,211254,211256,211258,2,4,0
60339,1,3,211255,211258,211261,3,6,0
60340,3,3,211258,211261,211264,3,6,0
60341,5,1,211263,211264,211265,1,2,0
60342,1,3,211264,211265,211268,1,4,0
60343,6,3,211270,211270,211273,0,3,2
60344,6,3,211276,211276,211279,0,3,3
60345,2,3,211278,211279,211282,1,4,0
60346,3,3,211281,211282,211285,1,4,0
60347,2,3,211283,211285,211288,2,5,0
60348,5,2,211288,211288,211290,0,2,0
60349,3,1,211291,211291,211292,0,1,1
60350,6,1,211297,211297,211298,0,1,5
60351,5,2,211302,211302,211304,0,2,4
60352,5,3,211307,211307,211310,0,3,3
60353,2,3,211309,211310,211313,1,4,0
60354,4,2,211313,211313,211315,0,2,0
60355,1,3,211314,211315,211318,1,4,0
60356,6,2,211320,211320,211322,0,2,2
60357,5,2,211325,211325,211327,0,2,3
60358,6,2,211331,211331,211333,0,2,4
60359,4,3,211335,211335,211338,0,3,2
60360,2,2,211337,211338,211340,1,3,0
60361,6,2,211343,211343,211345,0,2,3
60362,4,2,211347,211347,211349,0,2,2
60363,2,3,211349,211349,211352,0,3,0
60364,5,1,211354,211354,211355,0,1,2
60365,6,3,211360,211360,211363,0,3,5
60366,3,1,211363,211363,211364,0,1,0
60367,3,3,211366,211366,211369,0,3,2
60368,3,1,211369,211369,211370,0,1,0
60369,1,2,211370,211370,211372,0,2,0
60370,5,1,211375,211375,211376,0,1,3
60371,1,3,211376,211376,211379,0,3,0
60372,5,2,211381,211381,211383,0,2,2
60373,2,1,211383,211383,211384,0,1,0
60374,4,3,211387,211387,211390,0,3,3
60375,4,2,211391,211391,211393,0,2,1
60376,3,2,211394,211394,211396,0,2,1
60377,3,1,211397,211397,211398,0,1,1
60378,1,1,211398,211398,211399,0,1,0
60379,2,3,211400,211400,211403,0,3,1
60380,5,2,211405,211405,211407,0,2,2
60381,5,1,211410,211410,211411,0,1,3
60382,3,2,211413,211413,211415,0,2,2
60383,5,2,211418,211418,211420,0,2,3
60384,4,1,211422,211422,211423,0,1,2
60385,3,1,211425,211425,211426,0,1,2
60386,5,3,211430,211430,211433,0,3,4
60387,5,3,211435,211435,211438,0,3,2
60388,4,1,211439,211439,211440,0,1,1
60389,2,2,211441,211441,211443,0,2,1
60390,1,2,211442,211443,211445,1,3,0
60391,1,2,211443,211445,211447,2,4,0
60392,3,2,211446,211447,211449,1,3,0
60393,4,1,211450,211450,211451,0,1,1
60394,4,1,211454,211454,211455,0,1,3
60395,1,3,211455,211455,211458,0,3,0
60396,5,1,211460,211460,211461,0,1,2
60397,6,2,211466,211466,211468,0,2,5
60398,1,3,211467,211468,211471,1,4,0
60399,3,2,211470,211471,211473,1,3,0
60400,3,1,211473,211473,211474,0,1,0
60401,4,3,211477,211477,211480,0,3,3
60402,4,2,211481,211481,211483,0,2,1
60403,5,1,211486,211486,211487,0,1,3
60404,6,2,211492,211492,211494,0,2,5
60405,3,1,211495,211495,211496,0,1,1
60406,1,1,211496,211496,211497,0,1,0
60407,1,1,211497,211497,211498,0,1,0
60408,3,1,211500,211500,211501,0,1,2
60409,1,1,211501,211501,211502,0,1,0
60410,5,1,211506,211506,211507,0,1,4
60411,6,2,211512,211512,211514,0,2,5
60412,4,1,211516,211516,211517,0,1,2
60413,1,2,211517,211517,211519,0,2,0
60414,6,3,211523,211523,211526,0,3,4
60415,2,1,211525,211526,211527,1,2,0
60416,5,2,211530,211530,211532,0,2,3
60417,5,1,211535,211535,211536,0,1,3
60418,3,2,211538,211538,211540,0,2,2
60419,2,2,211540,211540,211542,0,2,0
60420,6,3,211546,211546,211549,0,3,4
60421,5,3,211551,211551,211554,0,3,2
60422,4,1,211555,211555,211556,0,1,1
60423,4,2,211559,211559,211561,0,2,3
60424,5,1,211564,211564,211565,0,1,3
60425,3,3,211567,211567,211570,0,3,2
60426,2,1,211569,211570,211571,1,2,0
60427,2,2,211571,211571,211573,0,2,0
60428,2,1,211573,211573,211574,0,1,0
60429,2,1,211575,211575,211576,0,1,1
60430,3,2,211578,211578,211580,0,2,2
60431,3,3,211581,211581,211584,0,3,1
60432,3,3,211584,211584,211587,0,3,0
60433,3,3,211587,211587,211590,0,3,0
60434,2,2,211589,211590,211592,1,3,0
60435,6,2,211595,211595,211597,0,2,3
60436,5,1,211600,211600,211601,0,1,3
60437,1,3,211601,211601,211604,0,3,0
60438,2,3,211603,211604,211607,1,4,0
60439,4,3,211607,211607,211610,0,3,0
60440,2,2,211609,211610,211612,1,3,0
60441,5,1,211614,211614,211615,0,1,2
60442,5,2,211619,211619,211621,0,2,4
60443,2,3,211621,211621,211624,0,3,0
60444,2,2,211623,211624,211626,1,3,0
60445,6,2,211629,211629,211631,0,2,3
60446,4,2,211633,211633,211635,0,2,2
60447,3,1,211636,211636,211637,0,1,1
60448,1,2,211637,211637,211639,0,2,0
60449,6,2,211643,211643,211645,0,2,4
60450,5,2,211648,211648,211650,0,2,3
60451,2,1,211650,211650,211651,0,1,0
60452,3,2,211653,211653,211655,0,2,2
60453,1,1,211654,211655,211656,1,2,0
60454,2,2,211656,211656,211658,0,2,0
60455,1,1,211657,211658,211659,1,2,0
60456,1,3,211658,211659,211662,1,4,0
60457,3,3,211661,211662,211665,1,4,0
60458,6,3,211667,211667,211670,0,3,2
60459,5,2,211672,211672,211674,0,2,2
60460,2,3,211674,211674,211677,0,3,0
60461,2,3,211676,211677,211680,1,4,0
60462,6,1,211682,211682,211683,0,1,2
60463,4,1,211686,211686,211687,0,1,3
60464,4,3,211690,211690,211693,0,3,3
60465,6,2,211696,211696,211698,0,2,3
60466,1,2,211697,211698,211700,1,3,0
60467,1,1,211698,211700,211701,2,3,0
60468,2,3,211700,211701,211704,1,4,0
60469,6,2,211706,211706,211708,0,2,2
60470,6,3,211712,211712,211715,0,3,4
60471,1,2,211713,211715,211717,2,4,0
60472,5,2,211718,211718,211720,0,2,1
60473,2,1,211720,211720,211721,0,1,0
60474,2,3,211722,211722,211725,0,3,1
60475,4,1,211726,211726,211727,0,1,1
60476,4,2,211730,211730,211732,0,2,3
60477,6,2,211736,211736,211738,0,2,4
60478,1,2,211737,211738,211740,1,3,0
60479,5,1,211742,211742,211743,0,1,2
60480,2,3,211744,211744,211747,0,3,1
60481,1,1,211745,211747,211748,2,3,0
60482,2,3,211747,211748,211751,1,4,0
60483,6,2,211753,211753,211755,0,2,2
60484,2,2,211755,211755,211757,0,2,0
60485,2,2,211757,211757,211759,0,2,0
60486,6,1,211763,211763,211764,0,1,4
60487,1,2,211764,211764,211766,0,2,0
60488,2,2,211766,211766,211768,0,2,0
60489,4,3,211770,211770,211773,0,3,2
60490,1,2,211771,211773,211775,2,4,0
60491,4,1,211775,211775,211776,0,1,0
60492,2,3,211777,211777,211780,0,3,1
60493,2,3,211779,211780,211783,1,4,0
60494,2,1,211781,211783,211784,2,3,0
60495,1,3,211782,211784,211787,2,5,0
60496,2,3,211784,211787,211790,3,6,0
60497,6,2,211790,211790,211792,0,2,0
60498,3,1,211793,211793,211794,0,1,1
60499,5,3,211798,211798,211801,0,3,4
60500,3,2,211801,211801,211803,0,2,0
60501,1,2,211802,211803,211805,1,3,0
60502,6,2,211808,211808,211810,0,2,3
60503,4,1,211812,211812,211813,0,1,2
60504,1,3,211813,211813,211816,0,3,0
60505,6,1,211819,211819,211820,0,1,3
60506,4,3,211823,211823,211826,0,3,3
60507,3,3,211826,211826,211829,0,3,0
60508,3,2,211829,211829,211831,0,2,0
60509,1,2,211830,211831,211833,1,3,0
60510,4,3,211834,211834,211837,0,3,1
60511,1,2,211835,211837,211839,2,4,0
60512,2,3,211837,211839,211842,2,5,0
60513,4,1,211841,211842,211843,1,2,0
60514,2,3,211843,211843,211846,0,3,0
60515,2,1,211845,211846,211847,1,2,0
60516,6,2,211851,211851,211853,0,2,4
60517,6,3,211857,211857,211860,0,3,4
60518,5,2,211862,211862,211864,0,2,2
60519,2,2,211864,211864,211866,0,2,0
60520,4,3,211868,211868,211871,0,3,2
60521,6,1,211874,211874,211875,0,1,3
60522,1,1,211875,211875,211876,0,1,0
60523,3,2,211878,211878,211880,0,2,2
60524,1,2,211879,211880,211882,1,3,0
60525,6,2,211885,211885,211887,0,2,3
60526,3,1,211888,211888,211889,0,1,1
60527,6,2,211894,211894,211896,0,2,5
60528,4,3,211898,211898,211901,0,3,2
60529,1,2,211899,211901,211903,2,4,0
60530,4,2,211903,211903,211905,0,2,0
60531,4,1,211907,211907,211908,0,1,2
60532,3,3,211910,211910,211913,0,3,2
60533,5,1,211915,211915,211916,0,1,2
60534,3,3,211918,211918,211921,0,3,2
60535,6,3,211924,211924,211927,0,3,3
60536,4,1,211928,211928,211929,0,1,1
60537,1,3,211929,211929,211932,0,3,0
60538,6,2,211935,211935,211937,0,2,3
60539,6,1,211941,211941,211942,0,1,4
60540,4,3,211945,211945,211948,0,3,3
60541,3,2,211948,211948,211950,0,2,0
60542,5,2,211953,211953,211955,0,2,3
60543,5,3,211958,211958,211961,0,3,3
60544,4,1,211962,211962,211963,0,1,1
60545,6,2,211968,211968,211970,0,2,5
60546,1,2,211969,211970,211972,1,3,0
60547,4,3,211973,211973,211976,0,3,1
60548,2,3,211975,211976,211979,1,4,0
60549,5,3,211980,211980,211983,0,3,1
60550,4,2,211984,211984,211986,0,2,1
60551,2,2,211986,211986,211988,0,2,0
60552,6,3,211992,211992,211995,0,3,4
60553,2,2,211994,211995,211997,1,3,0
60554,3,2,211997,211997,211999,0,2,0
60555,5,3,212002,212002,212005,0,3,3
60556,2,1,212004,212005,212006,1,2,0
60557,2,3,212006,212006,212009,0,3,0
60558,5,2,212011,212011,212013,0,2,2
60559,6,3,212017,212017,212020,0,3,4
60560,4,2,212021,212021,212023,0,2,1
60561,6,3,212027,212027,212030,0,3,4
60562,3,3,212030,212030,212033,0,3,0
60563,3,3,212033,212033,212036,0,3,0
60564,6,2,212039,212039,212041,0,2,3
60565,2,1,212041,212041,212042,0,1,0
60566,5,2,212046,212046,212048,0,2,4
60567,5,1,212051,212051,212052,0,1,3
60568,3,1,212054,212054,212055,0,1,2
60569,2,2,212056,212056,212058,0,2,1
60570,2,1,212058,212058,212059,0,1,0
60571,4,1,212062,212062,212063,0,1,3
60572,2,1,212064,212064,212065,0,1,1
60573,4,3,212068,212068,212071,0,3,3
60574,5,3,212073,212073,212076,0,3,2
60575,1,3,212074,212076,212079,2,5,0
60576,4,1,212078,212079,212080,1,2,0
60577,3,3,212081,212081,212084,0,3,1
60578,3,2,212084,212084,212086,0,2,0
60579,2,1,212086,212086,212087,0,1,0
60580,5,3,212091,212091,212094,0,3,4
60581,6,3,212097,212097,212100,0,3,3
60582,4,2,212101,212101,212103,0,2,1
60583,4,1,212105,212105,212106,0,1,2
60584,2,2,212107,212107,212109,0,2,1
60585,5,3,212112,212112,212115,0,3,3
60586,3,1,212115,212115,212116,0,1,0
60587,4,2,212119,212119,212121,0,2,3
60588,3,3,212122,212122,212125,0,3,1
60589,2,2,212124,212125,212127,1,3,0
60590,3,1,212127,212127,212128,0,1,0
60591,6,2,212133,212133,212135,0,2,5
60592,6,1,212139,212139,212140,0,1,4
60593,4,1,212143,212143,212144,0,1,3
60594,6,1,212149,212149,212150,0,1,5
60595,2,1,212151,212151,212152,0,1,1
60596,5,2,212156,212156,212158,0,2,4
60597,5,3,212161,212161,212164,0,3,3
60598,2,3,212163,212164,212167,1,4,0
60599,1,1,212164,212167,212168,3,4,0
60600,2,1,212166,212168,212169,2,3,0
60601,2,2,212168,212169,212171,1,3,0
60602,6,3,212174,212174,212177,0,3,3
60603,6,3,212180,212180,212183,0,3,3
60604,5,3,212185,212185,212188,0,3,2
60605,5,1,212190,212190,212191,0,1,2
60606,6,2,212196,212196,212198,0,2,5
60607,6,1,212202,212202,212203,0,1,4
60608,5,3,212207,212207,212210,0,3,4
60609,6,1,212213,212213,212214,0,1,3
60610,4,2,212217,212217,212219,0,2,3
60611,4,3,212221,212221,212224,0,3,2
60612,2,1,212223,212224,212225,1,2,0
60613,1,1,212224,212225,212226,1,2,0
60614,4,2,212228,212228,212230,0,2,2
60615,3,1,212231,212231,212232,0,1,1
60616,6,3,212237,212237,212240,0,3,5
60617,5,2,212242,212242,212244,0,2,2
60618,2,2,212244,212244,212246,0,2,0
60619,3,1,212247,212247,212248,0,1,1
60620,3,3,212250,212250,212253,0,3,2
60621,2,2,212252,212253,212255,1,3,0
60622,5,1,212257,212257,212258,0,1,2
60623,3,2,212260,212260,212262,0,2,2
60624,3,3,212263,212263,212266,0,3,1
60625,2,3,212265,212266,212269,1,4,0
60626,4,2,212269,212269,212271,0,2,0
60627,6,1,212275,212275,212276,0,1,4
60628,2,1,212277,212277,212278,0,1,1
60629,2,2,212279,212279,212281,0,2,1
60630,4,1,212283,212283,212284,0,1,2
60631,2,2,212285,212285,212287,0,2,1
60632,4,1,212289,212289,212290,0,1,2
60633,6,1,212295,212295,212296,0,1,5
60634,3,2,212298,212298,212300,0,2,2
60635,5,3,212303,212303,212306,0,3,3
60636,5,1,212308,212308,212309,0,1,2
60637,6,1,212314,212314,212315,0,1,5
60638,1,3,212315,212315,212318,0,3,0
60639,5,2,212320,212320,212322,0,2,2
60640,4,2,212324,212324,212326,0,2,2
60641,6,1,212330,212330,212331,0,1,4
60642,6,2,212336,212336,212338,0,2,5
60643,3,3,212339,212339,212342,0,3,1
60644,5,2,212344,212344,212346,0,2,2
60645,1,3,212345,212346,212349,1,4,0
60646,3,3,212348,212349,212352,1,4,0
60647,1,2,212349,212352,212354,3,5,0
60648,1,1,212350,212354,212355,4,5,0
60649,4,3,212354,212355,212358,1,4,0
60650,4,3,212358,212358,212361,0,3,0
60651,4,1,212362,212362,212363,0,1,1
60652,1,1,212363,212363,212364,0,1,0
60653,1,3,212364,212364,212367,0,3,0
60654,1,2,212365,212367,212369,2,4,0
60655,3,3,212368,212369,212372,1,4,0
60656,5,1,212373,212373,212374,0,1,1
60657,5,2,212378,212378,212380,0,2,4
60658,1,2,212379,212380,212382,1,3,0
60659,3,1,212382,212382,212383,0,1,0
60660,1,3,212383,212383,212386,0,3,0
60661,5,1,212388,212388,212389,0,1,2
60662,3,1,212391,212391,212392,0,1,2
60663,5,2,212396,212396,212398,0,2,4
60664,2,1,212398,212398,212399,0,1,0
60665,1,2,212399,212399,212401,0,2,0
60666,1,2,212400,212401,212403,1,3,0
60667,1,3,212401,212403,212406,2,5,0
60668,1,2,212402,212406,212408,4,6,0
60669,1,1,212403,212408,212409,5,6,0
60670,4,3,212407,212409,212412,2,5,0
60671,2,3,212409,212412,212415,3,6,0
60672,2,3,212411,212415,212418,4,7,0
60673,2,1,212413,212418,212419,5,6,0
60674,4,3,212417,212419,212422,2,5,0
60675,1,1,212418,212422,212423,4,5,0
60676,3,1,212421,212423,212424,2,3,0
60677,1,1,212422,212424,212425,2,3,0
60678,5,1,212427,212427,212428,0,1,2
60679,3,2,212430,212430,212432,0,2,2
60680,5,2,212435,212435,212437,0,2,3
60681,4,3,212439,212439,212442,0,3,2
60682,1,3,212440,212442,212445,2,5,0
60683,2,3,212442,212445,212448,3,6,0
60684,6,1,212448,212448,212449,0,1,0
60685,5,3,212453,212453,212456,0,3,4
60686,2,2,212455,212456,212458,1,3,0
60687,1,3,212456,212458,212461,2,5,0
60688,4,3,212460,212461,212464,1,4,0
60689,3,1,212463,212464,212465,1,2,0
60690,2,2,212465,212465,212467,0,2,0
60691,3,1,212468,212468,212469,0,1,1
60692,4,2,212472,212472,212474,0,2,3
60693,1,1,212473,212474,212475,1,2,0
60694,4,1,212477,212477,212478,0,1,2
60695,4,2,212481,212481,212483,0,2,3
60696,3,3,212484,212484,212487,0,3,1
60697,6,2,212490,212490,212492,0,2,3
60698,5,3,212495,212495,212498,0,3,3
60699,3,1,212498,212498,212499,0,1,0
60700,4,1,212502,212502,212503,0,1,3
60701,3,3,212505,212505,212508,0,3,2
60702,2,1,212507,212508,212509,1,2,0
60703,4,2,212511,212511,212513,0,2,2
60704,6,2,212517,212517,212519,0,2,4
60705,4,3,212521,212521,212524,0,3,2
60706,6,2,212527,212527,212529,0,2,3
60707,1,3,212528,212529,212532,1,4,0
60708,4,2,212532,212532,212534,0,2,0
60709,5,1,212537,212537,212538,0,1,3
60710,5,3,212542,212542,212545,0,3,4
60711,3,2,212545,212545,212547,0,2,0
60712,1,2,212546,212547,212549,1,3,0
60713,4,2,212550,212550,212552,0,2,1
60714,1,1,212551,212552,212553,1,2,0
60715,1,1,212552,212553,212554,1,2,0
60716,3,2,212555,212555,212557,0,2,1
60717,4,3,212559,212559,212562,0,3,2
60718,5,1,212564,212564,212565,0,1,2
60719,6,3,212570,212570,212573,0,3,5
60720,6,2,212576,212576,212578,0,2,3
60721,4,3,212580,212580,212583,0,3,2
60722,6,3,212586,212586,212589,0,3,3
60723,2,1,212588,212589,212590,1,2,0
60724,4,3,212592,212592,212595,0,3,2
60725,5,1,212597,212597,212598,0,1,2
60726,2,1,212599,212599,212600,0,1,1
60727,3,1,212602,212602,212603,0,1,2
60728,2,3,212604,212604,212607,0,3,1
60729,2,3,212606,212607,212610,1,4,0
60730,3,2,212609,212610,212612,1,3,0
60731,5,3,212614,212614,212617,0,3,2
60732,6,1,212620,212620,212621,0,1,3
60733,3,1,212623,212623,212624,0,1,2
60734,4,2,212627,212627,212629,0,2,3
60735,6,2,212633,212633,212635,0,2,4
60736,6,1,212639,212639,212640,0,1,4
60737,3,2,212642,212642,212644,0,2,2
60738,2,3,212644,212644,212647,0,3,0
60739,1,3,212645,212647,212650,2,5,0
60740,4,1,212649,212650,212651,1,2,0
60741,6,3,212655,212655,212658,0,3,4
60742,2,3,212657,212658,212661,1,4,0
60743,6,3,212663,212663,212666,0,3,2
60744,5,1,212668,212668,212669,0,1,2
60745,6,2,212674,212674,212676,0,2,5
60746,4,2,212678,212678,212680,0,2,2
60747,4,1,212682,212682,212683,0,1,2
60748,6,3,212688,212688,212691,0,3,5
60749,4,1,212692,212692,212693,0,1,1
60750,3,3,212695,212695,212698,0,3,2
60751,1,2,212696,212698,212700,2,4,0
60752,4,1,212700,212700,212701,0,1,0
60753,4,1,212704,212704,212705,0,1,3
60754,4,2,212708,212708,212710,0,2,3
60755,1,3,212709,212710,212713,1,4,0
60756,1,3,212710,212713,212716,3,6,0
60757,5,3,212715,212716,212719,1,4,0
60758,1,3,212716,212719,212722,3,6,0
60759,4,2,212720,212722,212724,2,4,0
60760,2,1,212722,212724,212725,2,3,0
60761,4,2,212726,212726,212728,0,2,1
60762,2,3,212728,212728,212731,0,3,0
60763,1,3,212729,212731,212734,2,5,0
60764,4,2,212733,212734,212736,1,3,0
60765,3,1,212736,212736,212737,0,1,0
60766,3,3,212739,212739,212742,0,3,2
60767,5,2,212744,212744,212746,0,2,2
60768,1,3,212745,212746,212749,1,4,0
60769,1,1,212746,212749,212750,3,4,0
60770,3,2,212749,212750,212752,1,3,0
60771,2,3,212751,212752,212755,1,4,0
60772,1,2,212752,212755,212757,3,5,0
60773,5,2,212757,212757,212759,0,2,0
60774,5,1,212762,212762,212763,0,1,3
60775,3,2,212765,212765,212767,0,2,2
60776,1,2,212766,212767,212769,1,3,0
60777,3,1,212769,212769,212770,0,1,0
60778,2,3,212771,212771,212774,0,3,1
60779,2,3,212773,212774,212777,1,4,0
60780,3,3,212776,212777,212780,1,4,0
60781,2,2,212778,212780,212782,2,4,0
60782,2,2,212780,212782,212784,2,4,0
60783,5,3,212785,212785,212788,0,3,1
60784,3,1,212788,212788,212789,0,1,0
60785,6,2,212794,212794,212796,0,2,5
60786,6,2,212800,212800,212802,0,2,4
60787,1,2,212801,212802,212804,1,3,0
60788,5,3,212806,212806,212809,0,3,2
60789,4,3,212810,212810,212813,0,3,1
60790,6,3,212816,212816,212819,0,3,3
60791,4,1,212820,212820,212821,0,1,1
60792,2,1,212822,212822,212823,0,1,1
60793,5,2,212827,212827,212829,0,2,4
60794,5,3,212832,212832,212835,0,3,3
60795,5,1,212837,212837,212838,0,1,2
60796,5,3,212842,212842,212845,0,3,4
60797,6,2,212848,212848,212850,0,2,3
60798,3,3,212851,212851,212854,0,3,1
60799,4,3,212855,212855,212858,0,3,1
60800,1,1,212856,212858,212859,2,3,0
60801,5,2,212861,212861,212863,0,2,2
60802,2,1,212863,212863,212864,0,1,0
60803,2,3,212865,212865,212868,0,3,1
60804,5,1,212870,212870,212871,0,1,2
60805,4,2,212874,212874,212876,0,2,3
60806,6,1,212880,212880,212881,0,1,4
60807,1,2,212881,212881,212883,0,2,0
60808,5,2,212886,212886,212888,0,2,3
60809,2,1,212888,212888,212889,0,1,0
60810,6,3,212894,212894,212897,0,3,5
60811,2,1,212896,212897,212898,1,2,0
60812,5,2,212901,212901,212903,0,2,3
60813,2,1,212903,212903,212904,0,1,0
60814,4,2,212907,212907,212909,0,2,3
60815,1,2,212908,212909,212911,1,3,0
60816,3,1,212911,212911,212912,0,1,0
60817,6,1,212917,212917,212918,0,1,5
60818,1,3,212918,212918,212921,0,3,0
60819,4,2,212922,212922,212924,0,2,1
60820,3,3,212925,212925,212928,0,3,1
60821,5,3,212930,212930,212933,0,3,2
60822,6,1,212936,212936,212937,0,1,3
60823,1,1,212937,212937,212938,0,1,0
60824,4,3,212941,212941,212944,0,3,3
60825,4,3,212945,212945,212948,0,3,1
60826,1,1,212946,212948,212949,2,3,0
60827,6,1,212952,212952,212953,0,1,3
60828,2,1,212954,212954,212955,0,1,1
60829,1,2,212955,212955,212957,0,2,0
60830,2,2,212957,212957,212959,0,2,0
60831,1,1,212958,212959,212960,1,2,0
60832,6,2,212964,212964,212966,0,2,4
60833,2,1,212966,212966,212967,0,1,0
60834,6,1,212972,212972,212973,0,1,5
60835,6,2,212978,212978,212980,0,2,5
60836,5,3,212983,212983,212986,0,3,3
60837,2,2,212985,212986,212988,1,3,0
60838,1,3,212986,212988,212991,2,5,0
60839,2,2,212988,212991,212993,3,5,0
60840,6,2,212994,212994,212996,0,2,1
60841,1,2,212995,212996,212998,1,3,0
60842,4,2,212999,212999,213001,0,2,1
60843,3,1,213002,213002,213003,0,1,1
60844,2,1,213004,213004,213005,0,1,1
60845,2,2,213006,213006,213008,0,2,1
60846,3,3,213009,213009,213012,0,3,1
60847,4,1,213013,213013,213014,0,1,1
60848,5,3,213018,213018,213021,0,3,4
60849,2,3,213020,213021,213024,1,4,0
60850,1,3,213021,213024,213027,3,6,0
60851,1,3,213022,213027,213030,5,8,0
60852,5,1,213027,213030,213031,3,4,0
60853,6,3,213033,213033,213036,0,3,2
60854,1,1,213034,213036,213037,2,3,0
60855,4,3,213038,213038,213041,0,3,1
60856,5,2,213043,213043,213045,0,2,2
60857,3,2,213046,213046,213048,0,2,1
60858,1,1,213047,213048,213049,1,2,0
60859,3,1,213050,213050,213051,0,1,1
60860,1,2,213051,213051,213053,0,2,0
60861,4,1,213055,213055,213056,0,1,2
60862,1,3,213056,213056,213059,0,3,0
60863,1,2,213057,213059,213061,2,4,0
60864,6,1,213063,213063,213064,0,1,2
60865,6,2,213069,213069,213071,0,2,5
60866,6,1,213075,213075,213076,0,1,4
60867,2,1,213077,213077,213078,0,1,1
60868,2,3,213079,213079,213082,0,3,1
60869,4,3,213083,213083,213086,0,3,1
60870,2,3,213085,213086,213089,1,4,0
60871,3,3,213088,213089,213092,1,4,0
60872,2,1,213090,213092,213093,2,3,0
60873,1,2,213091,213093,213095,2,4,0
60874,3,2,213094,213095,213097,1,3,0
60875,2,3,213096,213097,213100,1,4,0
60876,4,3,213100,213100,213103,0,3,0
60877,4,1,213104,213104,213105,0,1,1
60878,6,1,213110,213110,213111,0,1,5
60879,6,2,213116,213116,213118,0,2,5
60880,6,1,213122,213122,213123,0,1,4
60881,5,2,213127,213127,213129,0,2,4
60882,3,3,213130,213130,213133,0,3,1
60883,2,1,213132,213133,213134,1,2,0
60884,3,1,213135,213135,213136,0,1,1
60885,2,1,213137,213137,213138,0,1,1
60886,6,2,213143,213143,213145,0,2,5
60887,3,1,213146,213146,213147,0,1,1
60888,4,2,213150,213150,213152,0,2,3
60889,5,3,213155,213155,213158,0,3,3
60890,3,3,213158,213158,213161,0,3,0
60891,6,3,213164,213164,213167,0,3,3
60892,4,2,213168,213168,213170,0,2,1
60893,3,2,213171,213171,213173,0,2,1
60894,4,2,213175,213175,213177,0,2,2
60895,5,1,213180,213180,213181,0,1,3
60896,6,2,213186,213186,213188,0,2,5
60897,6,1,213192,213192,213193,0,1,4
60898,5,2,213197,213197,213199,0,2,4
60899,4,2,213201,213201,213203,0,2,2
60900,4,2,213205,213205,213207,0,2,2
60901,6,3,213211,213211,213214,0,3,4
60902,6,3,213217,213217,213220,0,3,3
60903,6,2,213223,213223,213225,0,2,3
60904,5,2,213228,213228,213230,0,2,3
60905,6,2,213234,213234,213236,0,2,4
60906,6,2,213240,213240,213242,0,2,4
60907,5,1,213245,213245,213246,0,1,3
60908,6,3,213251,213251,213254,0,3,5
60909,4,1,213255,213255,213256,0,1,1
60910,2,1,213257,213257,213258,0,1,1
60911,5,3,213262,213262,213265,0,3,4
60912,1,3,213263,213265,213268,2,5,0
60913,4,1,213267,213268,213269,1,2,0
60914,2,1,213269,213269,213270,0,1,0
60915,2,2,213271,213271,213273,0,2,1
60916,5,2,213276,213276,213278,0,2,3
60917,1,3,213277,213278,213281,1,4,0
60918,3,1,213280,213281,213282,1,2,0
60919,6,3,213286,213286,213289,0,3,4
60920,6,2,213292,213292,213294,0,2,3
60921,4,2,213296,213296,213298,0,2,2
60922,4,1,213300,213300,213301,0,1,2
60923,2,3,213302,213302,213305,0,3,1
60924,5,3,213307,213307,213310,0,3,2
60925,2,2,213309,213310,213312,1,3,0
60926,1,1,213310,213312,213313,2,3,0
60927,3,2,213313,213313,213315,0,2,0
60928,4,2,213317,213317,213319,0,2,2
60929,2,2,213319,213319,213321,0,2,0
60930,4,1,213323,213323,213324,0,1,2
60931,4,1,213327,213327,213328,0,1,3
60932,2,2,213329,213329,213331,0,2,1
60933,1,3,213330,213331,213334,1,4,0
60934,2,3,213332,213334,213337,2,5,0
60935,4,1,213336,213337,213338,1,2,0
60936,3,1,213339,213339,213340,0,1,1
60937,3,2,213342,213342,213344,0,2,2
60938,3,3,213345,213345,213348,0,3,1
60939,2,1,213347,213348,213349,1,2,0
60940,1,1,213348,213349,213350,1,2,0
60941,4,3,213352,213352,213355,0,3,2
60942,2,2,213354,213355,213357,1,3,0
60943,5,2,213359,213359,213361,0,2,2
60944,2,1,213361,213361,213362,0,1,0
60945,5,1,213366,213366,213367,0,1,4
60946,4,1,213370,213370,213371,0,1,3
60947,3,3,213373,213373,213376,0,3,2
60948,4,1,213377,213377,213378,0,1,1
60949,1,1,213378,213378,213379,0,1,0
60950,1,3,213379,213379,213382,0,3,0
60951,5,1,213384,213384,213385,0,1,2
60952,4,3,213388,213388,213391,0,3,3
60953,5,2,213393,213393,213395,0,2,2
60954,5,3,213398,213398,213401,0,3,3
60955,3,1,213401,213401,213402,0,1,0
60956,5,2,213406,213406,213408,0,2,4
60957,2,3,213408,213408,213411,0,3,0
60958,6,2,213414,213414,213416,0,2,3
60959,3,2,213417,213417,213419,0,2,1
60960,2,2,213419,213419,213421,0,2,0
60961,2,1,213421,213421,213422,0,1,0
60962,2,3,213423,213423,213426,0,3,1
60963,1,1,213424,213426,213427,2,3,0
60964,6,1,213430,213430,213431,0,1,3
60965,6,1,213436,213436,213437,0,1,5
60966,2,3,213438,213438,213441,0,3,1
60967,6,1,213444,213444,213445,0,1,3
60968,2,1,213446,213446,213447,0,1,1
60969,4,1,213450,213450,213451,0,1,3
60970,1,3,213451,213451,213454,0,3,0
60971,3,3,213454,213454,213457,0,3,0
60972,4,3,213458,213458,213461,0,3,1
60973,3,3,213461,213461,213464,0,3,0
60974,1,2,213462,213464,213466,2,4,0
60975,2,3,213464,213466,213469,2,5,0
60976,2,3,213466,213469,213472,3,6,0
60977,2,1,213468,213472,213473,4,5,0
60978,5,3,213473,213473,213476,0,3,0
60979,2,1,213475,213476,213477,1,2,0
60980,1,2,213476,213477,213479,1,3,0
60981,3,3,213479,213479,213482,0,3,0
60982,1,3,213480,213482,213485,2,5,0
60983,1,2,213481,213485,213487,4,6,0
60984,6,3,213487,213487,213490,0,3,0
60985,4,3,213491,213491,213494,0,3,1
60986,5,3,213496,213496,213499,0,3,2
60987,5,1,213501,213501,213502,0,1,2
60988,1,2,213502,213502,213504,0,2,0
60989,3,2,213505,213505,213507,0,2,1
60990,3,3,213508,213508,213511,0,3,1
60991,5,1,213513,213513,213514,0,1,2
60992,2,2,213515,213515,213517,0,2,1
60993,2,1,213517,213517,213518,0,1,0
60994,4,1,213521,213521,213522,0,1,3
60995,5,2,213526,213526,213528,0,2,4
60996,3,1,213529,213529,213530,0,1,1
60997,6,3,213535,213535,213538,0,3,5
60998,6,3,213541,213541,213544,0,3,3
60999,6,2,213547,213547,213549,0,2,3
61000,2,2,213549,213549,213551,0,2,0
61001,2,2,213551,213551,213553,0,2,0
61002,3,3,213554,213554,213557,0,3,1
61003,2,3,213556,213557,213560,1,4,0
61004,1,1,213557,213560,213561,3,4,0
61005,2,1,213559,213561,213562,2,3,0
61006,6,1,213565,213565,213566,0,1,3
61007,6,3,213571,213571,213574,0,3,5
61008,2,2,213573,213574,213576,1,3,0
61009,3,2,213576,213576,213578,0,2,0
61010,3,2,213579,213579,213581,0,2,1
61011,4,2,213583,213583,213585,0,2,2
61012,3,3,213586,213586,213589,0,3,1
61013,5,2,213591,213591,213593,0,2,2
61014,3,1,213594,213594,213595,0,1,1
61015,2,1,213596,213596,213597,0,1,1
61016,2,3,213598,213598,213601,0,3,1
61017,2,3,213600,213601,213604,1,4,0
61018,6,1,213606,213606,213607,0,1,2
61019,2,3,213608,213608,213611,0,3,1
61020,3,1,213611,213611,213612,0,1,0
61021,1,3,213612,213612,213615,0,3,0
61022,3,2,213615,213615,213617,0,2,0
61023,2,1,213617,213617,213618,0,1,0
61024,5,3,213622,213622,213625,0,3,4
61025,4,2,213626,213626,213628,0,2,1
61026,2,3,213628,213628,213631,0,3,0
61027,2,2,213630,213631,213633,1,3,0
61028,3,2,213633,213633,213635,0,2,0
61029,6,2,213639,213639,213641,0,2,4
61030,2,2,213641,213641,213643,0,2,0
61031,1,2,213642,213643,213645,1,3,0
61032,6,3,213648,213648,213651,0,3,3
61033,1,2,213649,213651,213653,2,4,0
61034,3,2,213652,213653,213655,1,3,0
61035,3,3,213655,213655,213658,0,3,0
61036,5,2,213660,213660,213662,0,2,2
61037,4,3,213664,213664,213667,0,3,2
61038,1,2,213665,213667,213669,2,4,0
61039,2,2,213667,213669,213671,2,4,0
61040,4,2,213671,213671,213673,0,2,0
61041,5,3,213676,213676,213679,0,3,3
61042,6,1,213682,213682,213683,0,1,3
61043,2,3,213684,213684,213687,0,3,1
61044,3,1,213687,213687,213688,0,1,0
61045,6,1,213693,213693,213694,0,1,5
61046,1,2,213694,213694,213696,0,2,0
61047,3,1,213697,213697,213698,0,1,1
61048,5,1,213702,213702,213703,0,1,4
61049,5,2,213707,213707,213709,0,2,4
61050,4,1,213711,213711,213712,0,1,2
61051,3,1,213714,213714,213715,0,1,2
61052,6,1,213720,213720,213721,0,1,5
61053,5,3,213725,213725,213728,0,3,4
61054,1,1,213726,213728,213729,2,3,0
61055,1,2,213727,213729,213731,2,4,0
61056,4,3,213731,213731,213734,0,3,0
61057,3,1,213734,213734,213735,0,1,0
61058,1,3,213735,213735,213738,0,3,0
61059,5,1,213740,213740,213741,0,1,2
61060,2,3,213742,213742,213745,0,3,1
61061,5,2,213747,213747,213749,0,2,2
61062,3,1,213750,213750,213751,0,1,1
61063,6,3,213756,213756,213759,0,3,5
61064,3,2,213759,213759,213761,0,2,0
61065,4,1,213763,213763,213764,0,1,2
61066,3,2,213766,213766,213768,0,2,2
61067,5,3,213771,213771,213774,0,3,3
61068,5,1,213776,213776,213777,0,1,2
61069,3,2,213779,213779,213781,0,2,2
61070,1,1,213780,213781,213782,1,2,0
61071,5,2,213785,213785,213787,0,2,3
61072,5,2,213790,213790,213792,0,2,3
61073,6,1,213796,213796,213797,0,1,4
61074,6,3,213802,213802,213805,0,3,5
61075,3,3,213805,213805,213808,0,3,0
61076,1,3,213806,213808,213811,2,5,0
61077,1,1,213807,213811,213812,4,5,0
61078,2,3,213809,213812,213815,3,6,0
61079,6,2,213815,213815,213817,0,2,0
61080,1,3,213816,213817,213820,1,4,0
61081,1,1,213817,213820,213821,3,4,0
61082,1,1,213818,213821,213822,3,4,0
61083,4,2,213822,213822,213824,0,2,0
61084,5,2,213827,213827,213829,0,2,3
61085,5,1,213832,213832,213833,0,1,3
61086,1,1,213833,213833,213834,0,1,0
61087,3,1,213836,213836,213837,0,1,2
61088,3,2,213839,213839,213841,0,2,2
61089,3,2,213842,213842,213844,0,2,1
61090,4,1,213846,213846,213847,0,1,2
61091,5,1,213851,213851,213852,0,1,4
61092,6,2,213857,213857,213859,0,2,5
61093,5,2,213862,213862,213864,0,2,3
61094,2,2,213864,213864,213866,0,2,0
61095,2,3,213866,213866,213869,0,3,0
61096,6,2,213872,213872,213874,0,2,3
61097,2,3,213874,213874,213877,0,3,0
61098,6,1,213880,213880,213881,0,1,3
61099,3,1,213883,213883,213884,0,1,2
61100,2,1,213885,213885,213886,0,1,1
61101,5,3,213890,213890,213893,0,3,4
61102,2,3,213892,213893,213896,1,4,0
61103,3,2,213895,213896,213898,1,3,0
61104,2,3,213897,213898,213901,1,4,0
61105,6,3,213903,213903,213906,0,3,2
61106,4,3,213907,213907,213910,0,3,1
61107,5,2,213912,213912,213914,0,2,2
61108,3,2,213915,213915,213917,0,2,1
61109,6,1,213921,213921,213922,0,1,4
61110,5,1,213926,213926,213927,0,1,4
61111,5,3,213931,213931,213934,0,3,4
61112,2,1,213933,213934,213935,1,2,0
61113,3,3,213936,213936,213939,0,3,1
61114,6,3,213942,213942,213945,0,3,3
61115,1,3,213943,213945,213948,2,5,0
61116,6,2,213949,213949,213951,0,2,1
61117,6,3,213955,213955,213958,0,3,4
61118,1,1,213956,213958,213959,2,3,0
61119,6,3,213962,213962,213965,0,3,3
61120,1,2,213963,213965,213967,2,4,0
61121,3,3,213966,213967,213970,1,4,0
61122,2,3,213968,213970,213973,2,5,0
61123,1,1,213969,213973,213974,4,5,0
61124,6,3,213975,213975,213978,0,3,1
61125,2,3,213977,213978,213981,1,4,0
61126,2,2,213979,213981,213983,2,4,0
61127,3,1,213982,213983,213984,1,2,0
61128,3,2,213985,213985,213987,0,2,1
61129,5,1,213990,213990,213991,0,1,3
61130,1,3,213991,213991,213994,0,3,0
61131,6,3,213997,213997,214000,0,3,3
61132,3,3,214000,214000,214003,0,3,0
61133,5,1,214005,214005,214006,0,1,2
61134,6,3,214011,214011,214014,0,3,5
61135,5,2,214016,214016,214018,0,2,2
61136,5,1,214021,214021,214022,0,1,3
61137,1,2,214022,214022,214024,0,2,0
61138,1,1,214023,214024,214025,1,2,0
61139,6,3,214029,214029,214032,0,3,4
61140,6,1,214035,214035,214036,0,1,3
61141,4,3,214039,214039,214042,0,3,3
61142,1,2,214040,214042,214044,2,4,0
61143,5,1,214045,214045,214046,0,1,1
61144,6,2,214051,214051,214053,0,2,5
61145,5,1,214056,214056,214057,0,1,3
61146,2,1,214058,214058,214059,0,1,1
61147,3,2,214061,214061,214063,0,2,2
61148,5,3,214066,214066,214069,0,3,3
61149,2,1,214068,214069,214070,1,2,0
61150,4,3,214072,214072,214075,0,3,2
61151,5,3,214077,214077,214080,0,3,2
61152,5,2,214082,214082,214084,0,2,2
61153,5,3,214087,214087,214090,0,3,3
61154,4,1,214091,214091,214092,0,1,1
61155,3,2,214094,214094,214096,0,2,2
61156,5,1,214099,214099,214100,0,1,3
61157,3,2,214102,214102,214104,0,2,2
61158,5,1,214107,214107,214108,0,1,3
61159,4,2,214111,214111,214113,0,2,3
61160,3,3,214114,214114,214117,0,3,1
61161,2,1,214116,214117,214118,1,2,0
61162,5,1,214121,214121,214122,0,1,3
61163,5,3,214126,214126,214129,0,3,4
61164,6,3,214132,214132,214135,0,3,3
61165,3,2,214135,214135,214137,0,2,0
61166,3,1,214138,214138,214139,0,1,1
61167,6,2,214144,214144,214146,0,2,5
61168,5,1,214149,214149,214150,0,1,3
61169,3,1,214152,214152,214153,0,1,2
61170,2,3,214154,214154,214157,0,3,1
61171,1,2,214155,214157,214159,2,4,0
61172,3,1,214158,214159,214160,1,2,0
61173,1,3,214159,214160,214163,1,4,0
61174,1,1,214160,214163,214164,3,4,0
61175,4,2,214164,214164,214166,0,2,0
61176,5,3,214169,214169,214172,0,3,3
61177,2,1,214171,214172,214173,1,2,0
61178,5,1,214176,214176,214177,0,1,3
61179,6,1,214182,214182,214183,0,1,5
61180,4,1,214186,214186,214187,0,1,3
61181,3,2,214189,214189,214191,0,2,2
61182,5,3,214194,214194,214197,0,3,3
61183,1,2,214195,214197,214199,2,4,0
61184,4,3,214199,214199,214202,0,3,0
61185,6,2,214205,214205,214207,0,2,3
61186,2,2,214207,214207,214209,0,2,0
61187,2,2,214209,214209,214211,0,2,0
61188,5,2,214214,214214,214216,0,2,3
61189,1,2,214215,214216,214218,1,3,0
61190,1,1,214216,214218,214219,2,3,0
61191,2,3,214218,214219,214222,1,4,0
61192,1,1,214219,214222,214223,3,4,0
61193,1,1,214220,214223,214224,3,4,0
61194,1,1,214221,214224,214225,3,4,0
61195,6,1,214227,214227,214228,0,1,2
61196,5,1,214232,214232,214233,0,1,4
61197,2,2,214234,214234,214236,0,2,1
61198,4,2,214238,214238,214240,0,2,2
61199,4,1,214242,214242,214243,0,1,2
61200,4,2,214246,214246,214248,0,2,3
61201,3,3,214249,214249,214252,0,3,1
61202,2,2,214251,214252,214254,1,3,0
61203,6,1,214257,214257,214258,0,1,3
61204,4,3,214261,214261,214264,0,3,3
61205,2,1,214263,214264,214265,1,2,0
61206,4,3,214267,214267,214270,0,3,2
61207,2,1,214269,214270,214271,1,2,0
61208,6,2,214275,214275,214277,0,2,4
61209,1,1,214276,214277,214278,1,2,0
61210,1,3,214277,214278,214281,1,4,0
61211,4,2,214281,214281,214283,0,2,0
61212,2,2,214283,214283,214285,0,2,0
61213,2,1,214285,214285,214286,0,1,0
61214,2,3,214287,214287,214290,0,3,1
61215,2,2,214289,214290,214292,1,3,0
61216,5,1,214294,214294,214295,0,1,2
61217,5,3,214299,214299,214302,0,3,4
61218,4,3,214303,214303,214306,0,3,1
61219,5,2,214308,214308,214310,0,2,2
61220,3,1,214311,214311,214312,0,1,1
61221,4,3,214315,214315,214318,0,3,3
61222,1,2,214316,214318,214320,2,4,0
61223,5,3,214321,214321,214324,0,3,1
61224,5,3,214326,214326,214329,0,3,2
61225,1,1,214327,214329,214330,2,3,0
61226,5,1,214332,214332,214333,0,1,2
61227,2,3,214334,214334,214337,0,3,1
61228,5,3,214339,214339,214342,0,3,2
61229,1,2,214340,214342,214344,2,4,0
61230,3,2,214343,214344,214346,1,3,0
61231,4,3,214347,214347,214350,0,3,1
61232,2,1,214349,214350,214351,1,2,0
61233,3,2,214352,214352,214354,0,2,1
61234,5,1,214357,214357,214358,0,1,3
61235,6,3,214363,214363,214366,0,3,5
61236,5,1,214368,214368,214369,0,1,2
61237,2,2,214370,214370,214372,0,2,1
61238,1,2,214371,214372,214374,1,3,0
61239,6,1,214377,214377,214378,0,1,3
61240,2,1,214379,214379,214380,0,1,1
61241,6,3,214385,214385,214388,0,3,5
61242,4,2,214389,214389,214391,0,2,1
61243,6,2,214395,214395,214397,0,2,4
61244,6,3,214401,214401,214404,0,3,4
61245,2,2,214403,214404,214406,1,3,0
61246,4,3,214407,214407,214410,0,3,1
61247,3,3,214410,214410,214413,0,3,0
61248,1,1,214411,214413,214414,2,3,0
61249,3,3,214414,214414,214417,0,3,0
61250,5,1,214419,214419,214420,0,1,2
61251,6,3,214425,214425,214428,0,3,5
61252,2,2,214427,214428,214430,1,3,0
61253,5,3,214432,214432,214435,0,3,2
61254,5,2,214437,214437,214439,0,2,2
61255,3,2,214440,214440,214442,0,2,1
61256,5,2,214445,214445,214447,0,2,3
61257,5,1,214450,214450,214451,0,1,3
61258,2,1,214452,214452,214453,0,1,1
61259,6,2,214458,214458,214460,0,2,5
61260,3,3,214461,214461,214464,0,3,1
61261,1,3,214462,214464,214467,2,5,0
61262,6,3,214468,214468,214471,0,3,1
61263,2,1,214470,214471,214472,1,2,0
61264,4,3,214474,214474,214477,0,3,2
61265,3,3,214477,214477,214480,0,3,0
61266,2,1,214479,214480,214481,1,2,0
61267,2,2,214481,214481,214483,0,2,0
61268,1,2,214482,214483,214485,1,3,0
61269,4,3,214486,214486,214489,0,3,1
61270,2,2,214488,214489,214491,1,3,0
61271,1,1,214489,214491,214492,2,3,0
61272,6,1,214495,214495,214496,0,1,3
61273,5,3,214500,214500,214503,0,3,4
61274,5,1,214505,214505,214506,0,1,2
61275,5,1,214510,214510,214511,0,1,4
61276,4,1,214514,214514,214515,0,1,3
61277,1,2,214515,214515,214517,0,2,0
61278,4,2,214519,214519,214521,0,2,2
61279,5,1,214524,214524,214525,0,1,3
61280,4,3,214528,214528,214531,0,3,3
61281,6,3,214534,214534,214537,0,3,3
61282,2,2,214536,214537,214539,1,3,0
61283,3,1,214539,214539,214540,0,1,0
61284,2,2,214541,214541,214543,0,2,1
61285,2,2,214543,214543,214545,0,2,0
61286,1,3,214544,214545,214548,1,4,0
61287,6,1,214550,214550,214551,0,1,2
61288,6,2,214556,214556,214558,0,2,5
61289,1,3,214557,214558,214561,1,4,0
61290,2,2,214559,214561,214563,2,4,0
61291,5,1,214564,214564,214565,0,1,1
61292,1,3,214565,214565,214568,0,3,0
61293,6,2,214571,214571,214573,0,2,3
61294,5,1,214576,214576,214577,0,1,3
61295,6,3,214582,214582,214585,0,3,5
61296,3,2,214585,214585,214587,0,2,0
61297,1,1,214586,214587,214588,1,2,0
61298,4,2,214590,214590,214592,0,2,2
61299,1,2,214591,214592,214594,1,3,0
61300,3,1,214594,214594,214595,0,1,0
61301,1,3,214595,214595,214598,0,3,0
61302,3,1,214598,214598,214599,0,1,0
61303,4,1,214602,214602,214603,0,1,3
61304,3,2,214605,214605,214607,0,2,2
61305,4,3,214609,214609,214612,0,3,2
61306,4,1,214613,214613,214614,0,1,1
61307,5,2,214618,214618,214620,0,2,4
61308,3,1,214621,214621,214622,0,1,1
61309,3,3,214624,214624,214627,0,3,2
61310,4,3,214628,214628,214631,0,3,1
61311,2,3,214630,214631,214634,1,4,0
61312,2,1,214632,214634,214635,2,3,0
61313,5,1,214637,214637,214638,0,1,2
61314,1,3,214638,214638,214641,0,3,0
61315,1,3,214639,214641,214644,2,5,0
61316,2,3,214641,214644,214647,3,6,0
61317,1,2,214642,214647,214649,5,7,0
61318,6,3,214648,214649,214652,1,4,0
61319,1,2,214649,214652,214654,3,5,0
61320,2,1,214651,214654,214655,3,4,0
61321,1,1,214652,214655,214656,3,4,0
61322,4,1,214656,214656,214657,0,1,0
61323,4,1,214660,214660,214661,0,1,3
61324,4,2,214664,214664,214666,0,2,3
61325,4,1,214668,214668,214669,0,1,2
61326,6,3,214674,214674,214677,0,3,5
61327,5,3,214679,214679,214682,0,3,2
61328,3,3,214682,214682,214685,0,3,0
61329,3,1,214685,214685,214686,0,1,0
61330,2,2,214687,214687,214689,0,2,1
61331,4,3,214691,214691,214694,0,3,2
61332,5,3,214696,214696,214699,0,3,2
61333,6,2,214702,214702,214704,0,2,3
61334,4,3,214706,214706,214709,0,3,2
61335,4,1,214710,214710,214711,0,1,1
61336,5,2,214715,214715,214717,0,2,4
61337,1,1,214716,214717,214718,1,2,0
61338,2,1,214718,214718,214719,0,1,0
61339,5,3,214723,214723,214726,0,3,4
61340,2,1,214725,214726,214727,1,2,0
61341,2,1,214727,214727,214728,0,1,0
61342,3,1,214730,214730,214731,0,1,2
61343,1,1,214731,214731,214732,0,1,0
61344,3,3,214734,214734,214737,0,3,2
61345,5,3,214739,214739,214742,0,3,2
61346,2,2,214741,214742,214744,1,3,0
61347,5,3,214746,214746,214749,0,3,2
61348,5,2,214751,214751,214753,0,2,2
61349,4,2,214755,214755,214757,0,2,2
61350,1,1,214756,214757,214758,1,2,0
61351,2,3,214758,214758,214761,0,3,0
61352,6,3,214764,214764,214767,0,3,3
61353,4,3,214768,214768,214771,0,3,1
61354,5,1,214773,214773,214774,0,1,2
61355,6,1,214779,214779,214780,0,1,5
61356,2,2,214781,214781,214783,0,2,1
61357,5,1,214786,214786,214787,0,1,3
61358,1,2,214787,214787,214789,0,2,0
61359,2,3,214789,214789,214792,0,3,0
61360,2,2,214791,214792,214794,1,3,0
61361,3,1,214794,214794,214795,0,1,0
61362,6,1,214800,214800,214801,0,1,5
61363,4,2,214804,214804,214806,0,2,3
61364,6,1,214810,214810,214811,0,1,4
61365,6,2,214816,214816,214818,0,2,5
61366,1,3,214817,214818,214821,1,4,0
61367,4,2,214821,214821,214823,0,2,0
61368,3,1,214824,214824,214825,0,1,1
61369,3,2,214827,214827,214829,0,2,2
61370,5,1,214832,214832,214833,0,1,3
61371,2,3,214834,214834,214837,0,3,1
61372,6,2,214840,214840,214842,0,2,3
61373,2,1,214842,214842,214843,0,1,0
61374,2,3,214844,214844,214847,0,3,1
61375,2,2,214846,214847,214849,1,3,0
61376,6,2,214852,214852,214854,0,2,3
61377,3,3,214855,214855,214858,0,3,1
61378,6,1,214861,214861,214862,0,1,3
61379,3,3,214864,214864,214867,0,3,2
61380,5,2,214869,214869,214871,0,2,2
61381,4,3,214873,214873,214876,0,3,2
61382,3,1,214876,214876,214877,0,1,0
61383,5,2,214881,214881,214883,0,2,4
61384,5,2,214886,214886,214888,0,2,3
61385,2,1,214888,214888,214889,0,1,0
61386,6,2,214894,214894,214896,0,2,5
61387,3,1,214897,214897,214898,0,1,1
61388,6,3,214903,214903,214906,0,3,5
61389,1,1,214904,214906,214907,2,3,0
61390,3,1,214907,214907,214908,0,1,0
61391,3,3,214910,214910,214913,0,3,2
61392,6,2,214916,214916,214918,0,2,3
61393,1,1,214917,214918,214919,1,2,0
61394,5,2,214922,214922,214924,0,2,3
61395,3,2,214925,214925,214927,0,2,1
61396,5,2,214930,214930,214932,0,2,3
61397,6,1,214936,214936,214937,0,1,4
61398,6,2,214942,214942,214944,0,2,5
61399,5,3,214947,214947,214950,0,3,3
61400,4,2,214951,214951,214953,0,2,1
61401,2,2,214953,214953,214955,0,2,0
61402,3,2,214956,214956,214958,0,2,1
61403,1,1,214957,214958,214959,1,2,0
61404,5,2,214962,214962,214964,0,2,3
61405,6,3,214968,214968,214971,0,3,4
61406,6,1,214974,214974,214975,0,1,3
61407,1,2,214975,214975,214977,0,2,0
61408,3,2,214978,214978,214980,0,2,1
61409,6,2,214984,214984,214986,0,2,4
61410,3,1,214987,214987,214988,0,1,1
61411,6,2,214993,214993,214995,0,2,5
61412,1,3,214994,214995,214998,1,4,0
61413,6,1,215000,215000,215001,0,1,2
61414,3,3,215003,215003,215006,0,3,2
61415,1,3,215004,215006,215009,2,5,0
61416,5,2,215009,215009,215011,0,2,0
61417,4,2,215013,215013,215015,0,2,2
61418,1,3,215014,215015,215018,1,4,0
61419,6,2,215020,215020,215022,0,2,2
61420,5,3,215025,215025,215028,0,3,3
61421,6,2,215031,215031,215033,0,2,3
61422,1,1,215032,215033,215034,1,2,0
61423,5,2,215037,215037,215039,0,2,3
61424,3,3,215040,215040,215043,0,3,1
61425,6,3,215046,215046,215049,0,3,3
61426,1,2,215047,215049,215051,2,4,0
61427,6,2,215053,215053,215055,0,2,2
61428,1,3,215054,215055,215058,1,4,0
61429,1,2,215055,215058,215060,3,5,0
61430,5,2,215060,215060,215062,0,2,0
61431,4,3,215064,215064,215067,0,3,2
61432,1,2,215065,215067,215069,2,4,0
61433,2,3,215067,215069,215072,2,5,0
61434,6,1,215073,215073,215074,0,1,1
61435,3,1,215076,215076,215077,0,1,2
61436,1,2,215077,215077,215079,0,2,0
61437,1,1,215078,215079,215080,1,2,0
61438,1,3,215079,215080,215083,1,4,0
61439,2,1,215081,215083,215084,2,3,0
61440,3,2,215084,215084,215086,0,2,0
61441,5,1,215089,215089,215090,0,1,3
61442,3,2,215092,215092,215094,0,2,2
61443,3,1,215095,215095,215096,0,1,1
61444,4,1,215099,215099,215100,0,1,3
61445,5,2,215104,215104,215106,0,2,4
61446,2,3,215106,215106,215109,0,3,0
61447,2,2,215108,215109,215111,1,3,0
61448,5,2,215113,215113,215115,0,2,2
61449,2,3,215115,215115,215118,0,3,0
61450,5,2,215120,215120,215122,0,2,2
61451,5,1,215125,215125,215126,0,1,3
61452,3,3,215128,215128,215131,0,3,2
61453,5,3,215133,215133,215136,0,3,2
61454,2,3,215135,215136,215139,1,4,0
61455,6,3,215141,215141,215144,0,3,2
61456,4,2,215145,215145,215147,0,2,1
61457,3,2,215148,215148,215150,0,2,1
61458,1,1,215149,215150,215151,1,2,0
61459,4,1,215153,215153,215154,0,1,2
61460,4,1,215157,215157,215158,0,1,3
61461,3,1,215160,215160,215161,0,1,2
61462,2,1,215162,215162,215163,0,1,1
61463,2,2,215164,215164,215166,0,2,1
61464,5,3,215169,215169,215172,0,3,3
61465,6,2,215175,215175,215177,0,2,3
61466,2,2,215177,215177,215179,0,2,0
61467,3,2,215180,215180,215182,0,2,1
61468,5,2,215185,215185,215187,0,2,3
61469,6,2,215191,215191,215193,0,2,4
61470,4,1,215195,215195,215196,0,1,2
61471,3,3,215198,215198,215201,0,3,2
61472,2,3,215200,215201,215204,1,4,0
61473,2,1,215202,215204,215205,2,3,0
61474,2,2,215204,215205,215207,1,3,0
61475,6,1,215210,215210,215211,0,1,3
61476,3,1,215213,215213,215214,0,1,2
61477,5,3,215218,215218,215221,0,3,4
61478,5,1,215223,215223,215224,0,1,2
61479,3,1,215226,215226,215227,0,1,2
61480,5,1,215231,215231,215232,0,1,4
61481,4,3,215235,215235,215238,0,3,3
61482,1,1,215236,215238,215239,2,3,0
61483,6,3,215242,215242,215245,0,3,3
61484,3,2,215245,215245,215247,0,2,0
61485,2,3,215247,215247,215250,0,3,0
61486,6,1,215253,215253,215254,0,1,3
61487,1,3,215254,215254,215257,0,3,0
61488,2,3,215256,215257,215260,1,4,0
61489,2,2,215258,215260,215262,2,4,0
61490,6,3,215264,215264,215267,0,3,2
61491,6,3,215270,215270,215273,0,3,3
61492,5,3,215275,215275,215278,0,3,2
61493,3,3,215278,215278,215281,0,3,0
61494,6,3,215284,215284,215287,0,3,3
61495,2,3,215286,215287,215290,1,4,0
61496,1,1,215287,215290,215291,3,4,0
61497,3,1,215290,215291,215292,1,2,0
61498,2,2,215292,215292,215294,0,2,0
61499,6,2,215298,215298,215300,0,2,4
61500,2,3,215300,215300,215303,0,3,0
61501,1,2,215301,215303,215305,2,4,0
61502,4,1,215305,215305,215306,0,1,0
61503,3,3,215308,215308,215311,0,3,2
61504,5,2,215313,215313,215315,0,2,2
61505,4,3,215317,215317,215320,0,3,2
61506,5,3,215322,215322,215325,0,3,2
61507,2,1,215324,215325,215326,1,2,0
61508,5,2,215329,215329,215331,0,2,3
61509,5,1,215334,215334,215335,0,1,3
61510,3,1,215337,215337,215338,0,1,2
61511,2,3,215339,215339,215342,0,3,1
61512,6,2,215345,215345,215347,0,2,3
61513,2,3,215347,215347,215350,0,3,0
61514,3,2,215350,215350,215352,0,2,0
61515,4,2,215354,215354,215356,0,2,2
61516,6,1,215360,215360,215361,0,1,4
61517,1,2,215361,215361,215363,0,2,0
61518,6,3,215367,215367,215370,0,3,4
61519,2,2,215369,215370,215372,1,3,0
61520,4,2,215373,215373,215375,0,2,1
61521,5,1,215378,215378,215379,0,1,3
61522,6,2,215384,215384,215386,0,2,5
61523,4,2,215388,215388,215390,0,2,2
61524,2,2,215390,215390,215392,0,2,0
61525,3,2,215393,215393,215395,0,2,1
61526,2,2,215395,215395,215397,0,2,0
61527,5,3,215400,215400,215403,0,3,3
61528,5,3,215405,215405,215408,0,3,2
61529,6,2,215411,215411,215413,0,2,3
61530,6,2,215417,215417,215419,0,2,4
61531,1,3,215418,215419,215422,1,4,0
61532,2,3,215420,215422,215425,2,5,0
61533,3,2,215423,215425,215427,2,4,0
61534,5,1,215428,215428,215429,0,1,1
61535,6,1,215434,215434,215435,0,1,5
61536,6,2,215440,215440,215442,0,2,5
61537,3,2,215443,215443,215445,0,2,1
61538,5,2,215448,215448,215450,0,2,3
61539,6,2,215454,215454,215456,0,2,4
61540,3,3,215457,215457,215460,0,3,1
61541,6,2,215463,215463,215465,0,2,3
61542,3,3,215466,215466,215469,0,3,1
61543,6,2,215472,215472,215474,0,2,3
61544,2,1,215474,215474,215475,0,1,0
61545,5,1,215479,215479,215480,0,1,4
61546,6,1,215485,215485,215486,0,1,5
61547,1,3,215486,215486,215489,0,3,0
61548,5,3,215491,215491,215494,0,3,2
61549,2,1,215493,215494,215495,1,2,0
61550,2,1,215495,215495,215496,0,1,0
61551,5,1,215500,215500,215501,0,1,4
61552,5,1,215505,215505,215506,0,1,4
61553,4,3,215509,215509,215512,0,3,3
61554,5,1,215514,215514,215515,0,1,2
61555,6,1,215520,215520,215521,0,1,5
61556,3,1,215523,215523,215524,0,1,2
61557,1,2,215524,215524,215526,0,2,0
61558,3,1,215527,215527,215528,0,1,1
61559,5,2,215532,215532,215534,0,2,4
61560,5,1,215537,215537,215538,0,1,3
61561,1,2,215538,215538,215540,0,2,0
61562,5,1,215543,215543,215544,0,1,3
61563,2,1,215545,215545,215546,0,1,1
61564,4,3,215549,215549,215552,0,3,3
61565,5,3,215554,215554,215557,0,3,2
61566,4,2,215558,215558,215560,0,2,1
61567,4,2,215562,215562,215564,0,2,2
61568,3,3,215565,215565,215568,0,3,1
61569,5,2,215570,215570,215572,0,2,2
61570,3,2,215573,215573,215575,0,2,1
61571,3,2,215576,215576,215578,0,2,1
61572,2,1,215578,215578,215579,0,1,0
61573,6,2,215584,215584,215586,0,2,5
61574,1,2,215585,215586,215588,1,3,0
61575,1,3,215586,215588,215591,2,5,0
61576,6,3,215592,215592,215595,0,3,1
61577,5,3,215597,215597,215600,0,3,2
61578,2,3,215599,215600,215603,1,4,0
61579,1,1,215600,215603,215604,3,4,0
61580,4,1,215604,215604,215605,0,1,0
61581,2,1,215606,215606,215607,0,1,1
61582,5,1,215611,215611,215612,0,1,4
61583,4,2,215615,215615,215617,0,2,3
61584,3,1,215618,215618,215619,0,1,1
61585,3,3,215621,215621,215624,0,3,2
61586,2,1,215623,215624,215625,1,2,0
61587,5,3,215628,215628,215631,0,3,3
61588,1,1,215629,215631,215632,2,3,0
61589,2,3,215631,215632,215635,1,4,0
61590,3,2,215634,215635,215637,1,3,0
61591,4,2,215638,215638,215640,0,2,1
61592,4,2,215642,215642,215644,0,2,2
61593,3,3,215645,215645,215648,0,3,1
61594,5,2,215650,215650,215652,0,2,2
61595,6,2,215656,215656,215658,0,2,4
61596,4,3,215660,215660,215663,0,3,2
61597,1,2,215661,215663,215665,2,4,0
61598,2,3,215663,215665,215668,2,5,0
61599,3,1,215666,215668,215669,2,3,0
61600,6,1,215672,215672,215673,0,1,3
61601,5,2,215677,215677,215679,0,2,4
61602,2,3,215679,215679,215682,0,3,0
61603,4,2,215683,215683,215685,0,2,1
61604,2,3,215685,215685,215688,0,3,0
61605,3,2,215688,215688,215690,0,2,0
61606,5,1,215693,215693,215694,0,1,3
61607,5,3,215698,215698,215701,0,3,4
61608,3,3,215701,215701,215704,0,3,0
61609,2,2,215703,215704,215706,1,3,0
61610,1,1,215704,215706,215707,2,3,0
61611,6,2,215710,215710,215712,0,2,3
61612,3,3,215713,215713,215716,0,3,1
61613,5,1,215718,215718,215719,0,1,2
61614,1,2,215719,215719,215721,0,2,0
61615,4,3,215723,215723,215726,0,3,2
61616,1,1,215724,215726,215727,2,3,0
61617,3,1,215727,215727,215728,0,1,0
61618,6,3,215733,215733,215736,0,3,5
61619,3,3,215736,215736,215739,0,3,0
61620,5,1,215741,215741,215742,0,1,2
61621,2,3,215743,215743,215746,0,3,1
61622,1,2,215744,215746,215748,2,4,0
61623,1,3,215745,215748,215751,3,6,0
61624,6,3,215751,215751,215754,0,3,0
61625,1,3,215752,215754,215757,2,5,0
61626,3,3,215755,215757,215760,2,5,0
61627,3,2,215758,215760,215762,2,4,0
61628,2,1,215760,215762,215763,2,3,0
61629,4,3,215764,215764,215767,0,3,1
61630,6,3,215770,215770,215773,0,3,3
61631,6,2,215776,215776,215778,0,2,3
61632,5,3,215781,215781,215784,0,3,3
61633,2,1,215783,215784,215785,1,2,0
61634,4,1,215787,215787,215788,0,1,2
61635,2,2,215789,215789,215791,0,2,1
61636,2,3,215791,215791,215794,0,3,0
61637,4,3,215795,215795,215798,0,3,1
61638,4,1,215799,215799,215800,0,1,1
61639,1,2,215800,215800,215802,0,2,0
61640,2,1,215802,215802,215803,0,1,0
61641,4,3,215806,215806,215809,0,3,3
61642,2,1,215808,215809,215810,1,2,0
61643,5,1,215813,215813,215814,0,1,3
61644,4,2,215817,215817,215819,0,2,3
61645,4,2,215821,215821,215823,0,2,2
61646,4,3,215825,215825,215828,0,3,2
61647,6,3,215831,215831,215834,0,3,3
61648,6,2,215837,215837,215839,0,2,3
61649,4,1,215841,215841,215842,0,1,2
61650,2,3,215843,215843,215846,0,3,1
61651,3,1,215846,215846,215847,0,1,0
61652,4,2,215850,215850,215852,0,2,3
61653,5,1,215855,215855,215856,0,1,3
61654,6,3,215861,215861,215864,0,3,5
61655,4,1,215865,215865,215866,0,1,1
61656,1,2,215866,215866,215868,0,2,0
61657,4,2,215870,215870,215872,0,2,2
61658,3,1,215873,215873,215874,0,1,1
61659,2,1,215875,215875,215876,0,1,1
61660,5,2,215880,215880,215882,0,2,4
61661,2,3,215882,215882,215885,0,3,0
61662,5,3,215887,215887,215890,0,3,2
61663,1,3,215888,215890,215893,2,5,0
61664,5,3,215893,215893,215896,0,3,0
61665,2,2,215895,215896,215898,1,3,0
61666,2,2,215897,215898,215900,1,3,0
61667,6,1,215903,215903,215904,0,1,3
61668,3,1,215906,215906,215907,0,1,2
61669,5,3,215911,215911,215914,0,3,4
61670,4,2,215915,215915,215917,0,2,1
61671,2,1,215917,215917,215918,0,1,0
61672,4,2,215921,215921,215923,0,2,3
61673,5,1,215926,215926,215927,0,1,3
61674,3,1,215929,215929,215930,0,1,2
61675,4,1,215933,215933,215934,0,1,3
61676,5,3,215938,215938,215941,0,3,4
61677,5,3,215943,215943,215946,0,3,2
61678,2,3,215945,215946,215949,1,4,0
61679,3,3,215948,215949,215952,1,4,0
61680,6,2,215954,215954,215956,0,2,2
61681,1,3,215955,215956,215959,1,4,0
61682,3,3,215958,215959,215962,1,4,0
61683,6,3,215964,215964,215967,0,3,2
61684,4,3,215968,215968,215971,0,3,1
61685,1,1,215969,215971,215972,2,3,0
61686,1,3,215970,215972,215975,2,5,0
61687,1,3,215971,215975,215978,4,7,0
61688,3,2,215974,215978,215980,4,6,0
61689,3,2,215977,215980,215982,3,5,0
61690,6,3,215983,215983,215986,0,3,1
61691,6,2,215989,215989,215991,0,2,3
61692,4,1,215993,215993,215994,0,1,2
61693,3,2,215996,215996,215998,0,2,2
61694,1,3,215997,215998,216001,1,4,0
61695,2,2,215999,216001,216003,2,4,0
61696,4,2,216003,216003,216005,0,2,0
61697,3,1,216006,216006,216007,0,1,1
61698,3,3,216009,216009,216012,0,3,2
61699,5,1,216014,216014,216015,0,1,2
61700,4,3,216018,216018,216021,0,3,3
61701,5,1,216023,216023,216024,0,1,2
61702,6,2,216029,216029,216031,0,2,5
61703,1,1,216030,216031,216032,1,2,0
61704,2,3,216032,216032,216035,0,3,0
61705,6,3,216038,216038,216041,0,3,3
61706,1,3,216039,216041,216044,2,5,0
61707,1,1,216040,216044,216045,4,5,0
61708,2,3,216042,216045,216048,3,6,0
61709,4,2,216046,216048,216050,2,4,0
61710,4,2,216050,216050,216052,0,2,0
61711,4,1,216054,216054,216055,0,1,2
61712,1,1,216055,216055,216056,0,1,0
61713,3,3,216058,216058,216061,0,3,2
61714,6,1,216064,216064,216065,0,1,3
61715,6,3,216070,216070,216073,0,3,5
61716,6,1,216076,216076,216077,0,1,3
61717,4,1,216080,216080,216081,0,1,3
61718,6,3,216086,216086,216089,0,3,5
61719,3,3,216089,216089,216092,0,3,0
61720,5,1,216094,216094,216095,0,1,2
61721,6,3,216100,216100,216103,0,3,5
61722,5,1,216105,216105,216106,0,1,2
61723,6,1,216111,216111,216112,0,1,5
61724,1,2,216112,216112,216114,0,2,0
61725,6,2,216118,216118,216120,0,2,4
61726,5,1,216123,216123,216124,0,1,3
61727,4,2,216127,216127,216129,0,2,3
61728,2,1,216129,216129,216130,0,1,0
61729,5,3,216134,216134,216137,0,3,4
61730,5,1,216139,216139,216140,0,1,2
61731,1,1,216140,216140,216141,0,1,0
61732,6,2,216146,216146,216148,0,2,5
61733,1,1,216147,216148,216149,1,2,0
61734,2,3,216149,216149,216152,0,3,0
61735,3,2,216152,216152,216154,0,2,0
61736,4,1,216156,216156,216157,0,1,2
61737,4,2,216160,216160,216162,0,2,3
61738,4,3,216164,216164,216167,0,3,2
61739,6,2,216170,216170,216172,0,2,3
61740,4,2,216174,216174,216176,0,2,2
61741,2,3,216176,216176,216179,0,3,0
61742,1,2,216177,216179,216181,2,4,0
61743,1,3,216178,216181,216184,3,6,0
61744,6,3,216184,216184,216187,0,3,0
61745,4,2,216188,216188,216190,0,2,1
61746,6,1,216194,216194,216195,0,1,4
61747,2,1,216196,216196,216197,0,1,1
61748,4,1,216200,216200,216201,0,1,3
61749,1,3,216201,216201,216204,0,3,0
61750,4,1,216205,216205,216206,0,1,1
61751,1,1,216206,216206,216207,0,1,0
61752,4,3,216210,216210,216213,0,3,3
61753,2,1,216212,216213,216214,1,2,0
61754,6,2,216218,216218,216220,0,2,4
61755,1,1,216219,216220,216221,1,2,0
61756,5,3,216224,216224,216227,0,3,3
61757,1,1,216225,216227,216228,2,3,0
61758,4,1,216229,216229,216230,0,1,1
61759,3,1,216232,216232,216233,0,1,2
61760,2,1,216234,216234,216235,0,1,1
61761,4,1,216238,216238,216239,0,1,3
61762,2,1,216240,216240,216241,0,1,1
61763,2,1,216242,216242,216243,0,1,1
61764,3,1,216245,216245,216246,0,1,2
61765,3,2,216248,216248,216250,0,2,2
61766,1,2,216249,216250,216252,1,3,0
61767,2,3,216251,216252,216255,1,4,0
61768,3,3,216254,216255,216258,1,4,0
61769,3,2,216257,216258,216260,1,3,0
61770,2,3,216259,216260,216263,1,4,0
61771,4,3,216263,216263,216266,0,3,0
61772,3,3,216266,216266,216269,0,3,0
61773,1,3,216267,216269,216272,2,5,0
61774,1,3,216268,216272,216275,4,7,0
61775,4,3,216272,216275,216278,3,6,0
61776,5,1,216277,216278,216279,1,2,0
61777,5,3,216282,216282,216285,0,3,3
61778,1,3,216283,216285,216288,2,5,0
61779,5,1,216288,216288,216289,0,1,0
61780,4,2,216292,216292,216294,0,2,3
61781,4,2,216296,216296,216298,0,2,2
61782,1,3,216297,216298,216301,1,4,0
61783,6,1,216303,216303,216304,0,1,2
61784,3,1,216306,216306,216307,0,1,2
61785,3,1,216309,216309,216310,0,1,2
61786,2,1,216311,216311,216312,0,1,1
61787,6,3,216317,216317,216320,0,3,5
61788,4,3,216321,216321,216324,0,3,1
61789,1,2,216322,216324,216326,2,4,0
61790,5,1,216327,216327,216328,0,1,1
61791,2,3,216329,216329,216332,0,3,1
61792,4,3,216333,216333,216336,0,3,1
61793,6,2,216339,216339,216341,0,2,3
61794,5,2,216344,216344,216346,0,2,3
61795,3,2,216347,216347,216349,0,2,1
61796,6,2,216353,216353,216355,0,2,4
61797,3,1,216356,216356,216357,0,1,1
61798,1,1,216357,216357,216358,0,1,0
61799,4,2,216361,216361,216363,0,2,3
61800,1,2,216362,216363,216365,1,3,0
61801,3,2,216365,216365,216367,0,2,0
61802,5,2,216370,216370,216372,0,2,3
61803,3,2,216373,216373,216375,0,2,1
61804,3,1,216376,216376,216377,0,1,1
61805,3,2,216379,216379,216381,0,2,2
61806,6,3,216385,216385,216388,0,3,4
61807,3,2,216388,216388,216390,0,2,0
61808,1,3,216389,216390,216393,1,4,0
61809,4,3,216393,216393,216396,0,3,0
61810,2,2,216395,216396,216398,1,3,0
61811,4,3,216399,216399,216402,0,3,1
61812,3,1,216402,216402,216403,0,1,0
61813,3,1,216405,216405,216406,0,1,2
61814,2,1,216407,216407,216408,0,1,1
61815,6,3,216413,216413,216416,0,3,5
61816,1,2,216414,216416,216418,2,4,0
61817,5,1,216419,216419,216420,0,1,1
61818,5,3,216424,216424,216427,0,3,4
61819,5,1,216429,216429,216430,0,1,2
61820,5,1,216434,216434,216435,0,1,4
61821,3,1,216437,216437,216438,0,1,2
61822,4,3,216441,216441,216444,0,3,3
61823,4,1,216445,216445,216446,0,1,1
61824,1,2,216446,216446,216448,0,2,0
61825,3,2,216449,216449,216451,0,2,1
61826,6,3,216455,216455,216458,0,3,4
61827,1,2,216456,216458,216460,2,4,0
61828,5,2,216461,216461,216463,0,2,1
61829,5,2,216466,216466,216468,0,2,3
61830,5,1,216471,216471,216472,0,1,3
61831,5,1,216476,216476,216477,0,1,4
61832,6,2,216482,216482,216484,0,2,5
61833,1,3,216483,216484,216487,1,4,0
61834,2,2,216485,216487,216489,2,4,0
61835,2,2,216487,216489,216491,2,4,0
61836,5,3,216492,216492,216495,0,3,1
61837,1,2,216493,216495,216497,2,4,0
61838,6,2,216499,216499,216501,0,2,2
61839,2,1,216501,216501,216502,0,1,0
61840,4,3,216505,216505,216508,0,3,3
61841,5,2,216510,216510,216512,0,2,2
61842,5,2,216515,216515,216517,0,2,3
61843,1,3,216516,216517,216520,1,4,0
61844,5,2,216521,216521,216523,0,2,1
61845,3,3,216524,216524,216527,0,3,1
61846,4,2,216528,216528,216530,0,2,1
61847,2,1,216530,216530,216531,0,1,0
61848,4,1,216534,216534,216535,0,1,3
61849,4,3,216538,216538,216541,0,3,3
61850,6,1,216544,216544,216545,0,1,3
61851,3,1,216547,216547,216548,0,1,2
61852,4,3,216551,216551,216554,0,3,3
61853,5,3,216556,216556,216559,0,3,2
61854,4,3,216560,216560,216563,0,3,1
61855,3,2,216563,216563,216565,0,2,0
61856,6,3,216569,216569,216572,0,3,4
61857,6,1,216575,216575,216576,0,1,3
61858,1,1,216576,216576,216577,0,1,0
61859,5,3,216581,216581,216584,0,3,4
61860,4,3,216585,216585,216588,0,3,1
61861,2,1,216587,216588,216589,1,2,0
61862,5,2,216592,216592,216594,0,2,3
61863,5,2,216597,216597,216599,0,2,3
61864,2,1,216599,216599,216600,0,1,0
61865,5,3,216604,216604,216607,0,3,4
61866,6,1,216610,216610,216611,0,1,3
61867,4,2,216614,216614,216616,0,2,3
61868,1,3,216615,216616,216619,1,4,0
61869,5,3,216620,216620,216623,0,3,1
61870,4,2,216624,216624,216626,0,2,1
61871,2,1,216626,216626,216627,0,1,0
61872,2,2,216628,216628,216630,0,2,1
61873,6,1,216634,216634,216635,0,1,4
61874,4,3,216638,216638,216641,0,3,3
61875,5,3,216643,216643,216646,0,3,2
61876,1,3,216644,216646,216649,2,5,0
61877,2,2,216646,216649,216651,3,5,0
61878,3,3,216649,216651,216654,2,5,0
61879,2,3,216651,216654,216657,3,6,0
61880,4,3,216655,216657,216660,2,5,0
61881,4,3,216659,216660,216663,1,4,0
61882,3,3,216662,216663,216666,1,4,0
61883,4,2,216666,216666,216668,0,2,0
61884,1,3,216667,216668,216671,1,4,0
61885,4,1,216671,216671,216672,0,1,0
61886,3,1,216674,216674,216675,0,1,2
61887,2,2,216676,216676,216678,0,2,1
61888,1,1,216677,216678,216679,1,2,0
61889,1,1,216678,216679,216680,1,2,0
61890,2,3,216680,216680,216683,0,3,0
61891,5,2,216685,216685,216687,0,2,2
61892,6,1,216691,216691,216692,0,1,4
61893,3,2,216694,216694,216696,0,2,2
61894,2,1,216696,216696,216697,0,1,0
61895,4,3,216700,216700,216703,0,3,3
61896,5,1,216705,216705,216706,0,1,2
61897,3,3,216708,216708,216711,0,3,2
61898,1,3,216709,216711,216714,2,5,0
61899,1,3,216710,216714,216717,4,7,0
61900,6,1,216716,216717,216718,1,2,0
61901,4,2,216720,216720,216722,0,2,2
61902,2,1,216722,216722,216723,0,1,0
61903,4,1,216726,216726,216727,0,1,3
61904,6,3,216732,216732,216735,0,3,5
61905,2,2,216734,216735,216737,1,3,0
61906,4,2,216738,216738,216740,0,2,1
61907,3,1,216741,216741,216742,0,1,1
61908,2,3,216743,216743,216746,0,3,1
61909,1,3,216744,216746,216749,2,5,0
61910,5,1,216749,216749,216750,0,1,0
61911,5,3,216754,216754,216757,0,3,4
61912,5,3,216759,216759,216762,0,3,2
61913,2,2,216761,216762,216764,1,3,0
61914,4,1,216765,216765,216766,0,1,1
61915,6,3,216771,216771,216774,0,3,5
61916,2,1,216773,216774,216775,1,2,0
61917,1,3,216774,216775,216778,1,4,0
61918,1,2,216775,216778,216780,3,5,0
61919,1,3,216776,216780,216783,4,7,0
61920,2,3,216778,216783,216786,5,8,0
61921,5,1,216783,216786,216787,3,4,0
61922,5,1,216788,216788,216789,0,1,1
61923,3,2,216791,216791,216793,0,2,2
61924,2,3,216793,216793,216796,0,3,0
61925,3,1,216796,216796,216797,0,1,0
61926,4,2,216800,216800,216802,0,2,3
61927,3,2,216803,216803,216805,0,2,1
61928,1,2,216804,216805,216807,1,3,0
61929,4,3,216808,216808,216811,0,3,1
61930,1,1,216809,216811,216812,2,3,0
61931,1,2,216810,216812,216814,2,4,0
61932,2,2,216812,216814,216816,2,4,0
61933,5,2,216817,216817,216819,0,2,1
61934,2,2,216819,216819,216821,0,2,0
61935,3,3,216822,216822,216825,0,3,1
61936,2,1,216824,216825,216826,1,2,0
61937,6,2,216830,216830,216832,0,2,4
61938,5,2,216835,216835,216837,0,2,3
61939,1,3,216836,216837,216840,1,4,0
61940,3,3,216839,216840,216843,1,4,0
61941,1,1,216840,216843,216844,3,4,0
61942,4,3,216844,216844,216847,0,3,0
61943,4,2,216848,216848,216850,0,2,1
61944,5,1,216853,216853,216854,0,1,3
61945,6,2,216859,216859,216861,0,2,5
61946,6,1,216865,216865,216866,0,1,4
61947,1,2,216866,216866,216868,0,2,0
61948,6,2,216872,216872,216874,0,2,4
61949,2,2,216874,216874,216876,0,2,0
61950,2,2,216876,216876,216878,0,2,0
61951,6,1,216882,216882,216883,0,1,4
61952,4,2,216886,216886,216888,0,2,3
61953,5,1,216891,216891,216892,0,1,3
61954,5,3,216896,216896,216899,0,3,4
61955,2,2,216898,216899,216901,1,3,0
61956,1,1,216899,216901,216902,2,3,0
61957,4,3,216903,216903,216906,0,3,1
61958,4,1,216907,216907,216908,0,1,1
61959,3,3,216910,216910,216913,0,3,2
61960,5,3,216915,216915,216918,0,3,2
61961,2,2,216917,216918,216920,1,3,0
61962,6,2,216923,216923,216925,0,2,3
61963,1,3,216924,216925,216928,1,4,0
61964,3,2,216927,216928,216930,1,3,0
61965,5,2,216932,216932,216934,0,2,2
61966,6,3,216938,216938,216941,0,3,4
61967,3,2,216941,216941,216943,0,2,0
61968,2,3,216943,216943,216946,0,3,0
61969,3,2,216946,216946,216948,0,2,0
61970,5,1,216951,216951,216952,0,1,3
61971,4,1,216955,216955,216956,0,1,3
61972,3,2,216958,216958,216960,0,2,2
61973,3,1,216961,216961,216962,0,1,1
61974,3,2,216964,216964,216966,0,2,2
61975,2,1,216966,216966,216967,0,1,0
61976,6,1,216972,216972,216973,0,1,5
61977,2,1,216974,216974,216975,0,1,1
61978,5,2,216979,216979,216981,0,2,4
61979,1,2,216980,216981,216983,1,3,0
61980,4,2,216984,216984,216986,0,2,1
61981,1,3,216985,216986,216989,1,4,0
61982,3,1,216988,216989,216990,1,2,0
61983,6,3,216994,216994,216997,0,3,4
61984,2,1,216996,216997,216998,1,2,0
61985,3,1,216999,216999,217000,0,1,1
61986,6,1,217005,217005,217006,0,1,5
61987,2,1,217007,217007,217008,0,1,1
61988,3,2,217010,217010,217012,0,2,2
61989,2,3,217012,217012,217015,0,3,0
61990,3,3,217015,217015,217018,0,3,0
61991,4,1,217019,217019,217020,0,1,1
61992,1,2,217020,217020,217022,0,2,0
61993,3,1,217023,217023,217024,0,1,1
61994,3,3,217026,217026,217029,0,3,2
61995,6,2,217032,217032,217034,0,2,3
61996,3,3,217035,217035,217038,0,3,1
61997,5,1,217040,217040,217041,0,1,2
61998,5,3,217045,217045,217048,0,3,4
61999,1,1,217046,217048,217049,2,3,0
62000,1,1,217047,217049,217050,2,3,0
62001,1,3,217048,217050,217053,2,5,0
62002,5,3,217053,217053,217056,0,3,0
62003,6,1,217059,217059,217060,0,1,3
62004,4,3,217063,217063,217066,0,3,3
62005,3,1,217066,217066,217067,0,1,0
62006,6,2,217072,217072,217074,0,2,5
62007,1,3,217073,217074,217077,1,4,0
62008,3,2,217076,217077,217079,1,3,0
62009,3,3,217079,217079,217082,0,3,0
62010,3,1,217082,217082,217083,0,1,0
62011,3,3,217085,217085,217088,0,3,2
62012,5,2,217090,217090,217092,0,2,2
62013,2,3,217092,217092,217095,0,3,0
62014,5,3,217097,217097,217100,0,3,2
62015,2,1,217099,217100,217101,1,2,0
62016,2,1,217101,217101,217102,0,1,0
62017,4,2,217105,217105,217107,0,2,3
62018,3,1,217108,217108,217109,0,1,1
62019,5,3,217113,217113,217116,0,3,4
62020,6,3,217119,217119,217122,0,3,3
62021,2,3,217121,217122,217125,1,4,0
62022,2,2,217123,217125,217127,2,4,0
62023,6,2,217129,217129,217131,0,2,2
62024,2,2,217131,217131,217133,0,2,0
62025,1,1,217132,217133,217134,1,2,0
62026,5,2,217137,217137,217139,0,2,3
62027,2,1,217139,217139,217140,0,1,0
62028,6,3,217145,217145,217148,0,3,5
62029,1,2,217146,217148,217150,2,4,0
62030,4,2,217150,217150,217152,0,2,0
62031,5,3,217155,217155,217158,0,3,3
62032,4,3,217159,217159,217162,0,3,1
62033,4,3,217163,217163,217166,0,3,1
62034,6,3,217169,217169,217172,0,3,3
62035,2,3,217171,217172,217175,1,4,0
62036,1,1,217172,217175,217176,3,4,0
62037,1,3,217173,217176,217179,3,6,0
62038,1,1,217174,217179,217180,5,6,0
62039,5,1,217179,217180,217181,1,2,0
62040,6,1,217185,217185,217186,0,1,4
62041,1,1,217186,217186,217187,0,1,0
62042,3,2,217189,217189,217191,0,2,2
62043,2,3,217191,217191,217194,0,3,0
62044,3,1,217194,217194,217195,0,1,0
62045,3,1,217197,217197,217198,0,1,2
62046,2,2,217199,217199,217201,0,2,1
62047,2,3,217201,217201,217204,0,3,0
62048,2,1,217203,217204,217205,1,2,0
62049,3,3,217206,217206,217209,0,3,1
62050,6,3,217212,217212,217215,0,3,3
62051,4,3,217216,217216,217219,0,3,1
62052,2,3,217218,217219,217222,1,4,0
62053,6,1,217224,217224,217225,0,1,2
62054,5,3,217229,217229,217232,0,3,4
62055,1,3,217230,217232,217235,2,5,0
62056,4,3,217234,217235,217238,1,4,0
62057,1,3,217235,217238,217241,3,6,0
62058,2,3,217237,217241,217244,4,7,0
62059,5,2,217242,217244,217246,2,4,0
62060,2,3,217244,217246,217249,2,5,0
62061,5,1,217249,217249,217250,0,1,0
62062,4,1,217253,217253,217254,0,1,3
62063,5,3,217258,217258,217261,0,3,4
62064,5,3,217263,217263,217266,0,3,2
62065,6,2,217269,217269,217271,0,2,3
62066,6,1,217275,217275,217276,0,1,4
62067,5,1,217280,217280,217281,0,1,4
62068,6,3,217286,217286,217289,0,3,5
62069,4,1,217290,217290,217291,0,1,1
62070,3,2,217293,217293,217295,0,2,2
62071,6,3,217299,217299,217302,0,3,4
62072,2,3,217301,217302,217305,1,4,0
62073,1,2,217302,217305,217307,3,5,0
62074,2,3,217304,217307,217310,3,6,0
62075,1,1,217305,217310,217311,5,6,0
62076,4,1,217309,217311,217312,2,3,0
62077,4,3,217313,217313,217316,0,3,1
62078,1,2,217314,217316,217318,2,4,0
62079,2,1,217316,217318,217319,2,3,0
62080,1,2,217317,217319,217321,2,4,0
62081,2,2,217319,217321,217323,2,4,0
62082,5,2,217324,217324,217326,0,2,1
62083,2,1,217326,217326,217327,0,1,0
62084,1,3,217327,217327,217330,0,3,0
62085,2,1,217329,217330,217331,1,2,0
62086,2,3,217331,217331,217334,0,3,0
62087,1,1,217332,217334,217335,2,3,0
62088,3,3,217335,217335,217338,0,3,0
62089,5,1,217340,217340,217341,0,1,2
62090,2,1,217342,217342,217343,0,1,1
62091,3,3,217345,217345,217348,0,3,2
62092,1,1,217346,217348,217349,2,3,0
62093,5,3,217351,217351,217354,0,3,2
62094,5,1,217356,217356,217357,0,1,2
62095,5,1,217361,217361,217362,0,1,4
62096,5,1,217366,217366,217367,0,1,4
62097,4,2,217370,217370,217372,0,2,3
62098,2,2,217372,217372,217374,0,2,0
62099,4,3,217376,217376,217379,0,3,2
62100,3,2,217379,217379,217381,0,2,0
62101,1,1,217380,217381,217382,1,2,0
62102,1,3,217381,217382,217385,1,4,0
62103,6,3,217387,217387,217390,0,3,2
62104,5,2,217392,217392,217394,0,2,2
62105,1,1,217393,217394,217395,1,2,0
62106,4,3,217397,217397,217400,0,3,2
62107,1,1,217398,217400,217401,2,3,0
62108,3,3,217401,217401,217404,0,3,0
62109,4,3,217405,217405,217408,0,3,1
62110,2,2,217407,217408,217410,1,3,0
62111,5,2,217412,217412,217414,0,2,2
62112,1,1,217413,217414,217415,1,2,0
62113,6,1,217419,217419,217420,0,1,4
62114,2,1,217421,217421,217422,0,1,1
62115,1,2,217422,217422,217424,0,2,0
62116,6,3,217428,217428,217431,0,3,4
62117,1,1,217429,217431,217432,2,3,0
62118,3,2,217432,217432,217434,0,2,0
62119,2,3,217434,217434,217437,0,3,0
62120,6,3,217440,217440,217443,0,3,3
62121,6,2,217446,217446,217448,0,2,3
62122,4,3,217450,217450,217453,0,3,2
62123,3,2,217453,217453,217455,0,2,0
62124,4,2,217457,217457,217459,0,2,2
62125,4,1,217461,217461,217462,0,1,2
62126,5,3,217466,217466,217469,0,3,4
62127,3,3,217469,217469,217472,0,3,0
62128,3,3,217472,217472,217475,0,3,0
62129,1,1,217473,217475,217476,2,3,0
62130,6,1,217479,217479,217480,0,1,3
62131,3,1,217482,217482,217483,0,1,2
62132,1,3,217483,217483,217486,0,3,0
62133,5,3,217488,217488,217491,0,3,2
62134,5,3,217493,217493,217496,0,3,2
62135,6,2,217499,217499,217501,0,2,3
62136,5,2,217504,217504,217506,0,2,3
62137,5,2,217509,217509,217511,0,2,3
62138,4,2,217513,217513,217515,0,2,2
62139,3,3,217516,217516,217519,0,3,1
62140,2,2,217518,217519,217521,1,3,0
62141,4,2,217522,217522,217524,0,2,1
62142,1,2,217523,217524,217526,1,3,0
62143,3,3,217526,217526,217529,0,3,0
62144,1,3,217527,217529,217532,2,5,0
62145,2,1,217529,217532,217533,3,4,0
62146,1,2,217530,217533,217535,3,5,0
62147,2,1,217532,217535,217536,3,4,0
62148,1,1,217533,217536,217537,3,4,0
62149,6,2,217539,217539,217541,0,2,2
62150,3,1,217542,217542,217543,0,1,1
62151,4,2,217546,217546,217548,0,2,3
62152,5,1,217551,217551,217552,0,1,3
62153,6,1,217557,217557,217558,0,1,5
62154,3,2,217560,217560,217562,0,2,2
62155,4,2,217564,217564,217566,0,2,2
62156,3,2,217567,217567,217569,0,2,1
62157,2,2,217569,217569,217571,0,2,0
62158,6,2,217575,217575,217577,0,2,4
62159,1,2,217576,217577,217579,1,3,0
62160,5,1,217581,217581,217582,0,1,2
62161,5,2,217586,217586,217588,0,2,4
62162,3,2,217589,217589,217591,0,2,1
62163,6,2,217595,217595,217597,0,2,4
62164,2,3,217597,217597,217600,0,3,0
62165,2,1,217599,217600,217601,1,2,0
62166,1,2,217600,217601,217603,1,3,0
62167,5,3,217605,217605,217608,0,3,2
62168,6,3,217611,217611,217614,0,3,3
62169,5,2,217616,217616,217618,0,2,2
62170,4,1,217620,217620,217621,0,1,2
62171,4,2,217624,217624,217626,0,2,3
62172,2,3,217626,217626,217629,0,3,0
62173,5,2,217631,217631,217633,0,2,2
62174,2,2,217633,217633,217635,0,2,0
62175,5,3,217638,217638,217641,0,3,3
62176,1,1,217639,217641,217642,2,3,0
62177,2,2,217641,217642,217644,1,3,0
62178,1,3,217642,217644,217647,2,5,0
62179,5,3,217647,217647,217650,0,3,0
62180,5,2,217652,217652,217654,0,2,2
62181,5,3,217657,217657,217660,0,3,3
62182,3,3,217660,217660,217663,0,3,0
62183,6,1,217666,217666,217667,0,1,3
62184,5,2,217671,217671,217673,0,2,4
62185,5,1,217676,217676,217677,0,1,3
62186,3,1,217679,217679,217680,0,1,2
62187,2,1,217681,217681,217682,0,1,1
62188,4,3,217685,217685,217688,0,3,3
62189,4,2,217689,217689,217691,0,2,1
62190,6,1,217695,217695,217696,0,1,4
62191,3,2,217698,217698,217700,0,2,2
62192,1,3,217699,217700,217703,1,4,0
62193,6,3,217705,217705,217708,0,3,2
62194,5,2,217710,217710,217712,0,2,2
62195,5,2,217715,217715,217717,0,2,3
62196,1,2,217716,217717,217719,1,3,0
62197,1,2,217717,217719,217721,2,4,0
62198,4,2,217721,217721,217723,0,2,0
62199,1,3,217722,217723,217726,1,4,0
62200,3,3,217725,217726,217729,1,4,0
62201,6,2,217731,217731,217733,0,2,2
62202,1,1,217732,217733,217734,1,2,0
62203,3,3,217735,217735,217738,0,3,1
62204,2,2,217737,217738,217740,1,3,0
62205,5,2,217742,217742,217744,0,2,2
62206,3,1,217745,217745,217746,0,1,1
62207,1,1,217746,217746,217747,0,1,0
62208,6,1,217752,217752,217753,0,1,5
62209,1,1,217753,217753,217754,0,1,0
62210,6,2,217759,217759,217761,0,2,5
62211,3,2,217762,217762,217764,0,2,1
62212,4,3,217766,217766,217769,0,3,2
62213,2,3,217768,217769,217772,1,4,0
62214,5,3,217773,217773,217776,0,3,1
62215,2,3,217775,217776,217779,1,4,0
62216,3,3,217778,217779,217782,1,4,0
62217,3,2,217781,217782,217784,1,3,0
62218,4,3,217785,217785,217788,0,3,1
62219,2,1,217787,217788,217789,1,2,0
62220,2,1,217789,217789,217790,0,1,0
62221,3,2,217792,217792,217794,0,2,2
62222,3,1,217795,217795,217796,0,1,1
62223,6,2,217801,217801,217803,0,2,5
62224,4,3,217805,217805,217808,0,3,2
62225,4,2,217809,217809,217811,0,2,1
62226,2,2,217811,217811,217813,0,2,0
62227,1,3,217812,217813,217816,1,4,0
62228,1,1,217813,217816,217817,3,4,0
62229,2,3,217815,217817,217820,2,5,0
62230,1,3,217816,217820,217823,4,7,0
62231,3,1,217819,217823,217824,4,5,0
62232,1,2,217820,217824,217826,4,6,0
62233,3,3,217823,217826,217829,3,6,0
62234,1,3,217824,217829,217832,5,8,0
62235,1,2,217825,217832,217834,7,9,0
62236,5,2,217830,217834,217836,4,6,0
62237,6,1,217836,217836,217837,0,1,0
62238,2,2,217838,217838,217840,0,2,1
62239,6,1,217844,217844,217845,0,1,4
62240,2,3,217846,217846,217849,0,3,1
62241,4,2,217850,217850,217852,0,2,1
62242,2,3,217852,217852,217855,0,3,0
62243,6,1,217858,217858,217859,0,1,3
62244,3,1,217861,217861,217862,0,1,2
62245,3,2,217864,217864,217866,0,2,2
62246,5,1,217869,217869,217870,0,1,3
62247,5,1,217874,217874,217875,0,1,4
62248,2,3,217876,217876,217879,0,3,1
62249,1,3,217877,217879,217882,2,5,0
62250,2,3,217879,217882,217885,3,6,0
62251,2,3,217881,217885,217888,4,7,0
62252,6,3,217887,217888,217891,1,4,0
62253,3,1,217890,217891,217892,1,2,0
62254,1,3,217891,217892,217895,1,4,0
62255,1,3,217892,217895,217898,3,6,0
62256,3,2,217895,217898,217900,3,5,0
62257,5,3,217900,217900,217903,0,3,0
62258,6,3,217906,217906,217909,0,3,3
62259,3,3,217909,217909,217912,0,3,0
62260,2,3,217911,217912,217915,1,4,0
62261,6,1,217917,217917,217918,0,1,2
62262,4,3,217921,217921,217924,0,3,3
62263,1,3,217922,217924,217927,2,5,0
62264,6,1,217928,217928,217929,0,1,1
62265,6,3,217934,217934,217937,0,3,5
62266,3,1,217937,217937,217938,0,1,0
62267,4,3,217941,217941,217944,0,3,3
62268,6,2,217947,217947,217949,0,2,3
62269,5,2,217952,217952,217954,0,2,3
62270,1,3,217953,217954,217957,1,4,0
62271,2,1,217955,217957,217958,2,3,0
62272,2,2,217957,217958,217960,1,3,0
62273,6,1,217963,217963,217964,0,1,3
62274,6,1,217969,217969,217970,0,1,5
62275,3,2,217972,217972,217974,0,2,2
62276,5,2,217977,217977,217979,0,2,3
62277,3,3,217980,217980,217983,0,3,1
62278,3,3,217983,217983,217986,0,3,0
62279,4,2,217987,217987,217989,0,2,1
62280,2,1,217989,217989,217990,0,1,0
62281,6,1,217995,217995,217996,0,1,5
62282,1,1,217996,217996,217997,0,1,0
62283,5,1,218001,218001,218002,0,1,4
62284,4,3,218005,218005,218008,0,3,3
62285,5,2,218010,218010,218012,0,2,2
62286,6,2,218016,218016,218018,0,2,4
62287,3,1,218019,218019,218020,0,1,1
62288,6,2,218025,218025,218027,0,2,5
62289,4,3,218029,218029,218032,0,3,2
62290,4,3,218033,218033,218036,0,3,1
62291,1,1,218034,218036,218037,2,3,0
62292,1,1,218035,218037,218038,2,3,0
62293,1,2,218036,218038,218040,2,4,0
62294,6,1,218042,218042,218043,0,1,2
62295,2,3,218044,218044,218047,0,3,1
62296,1,2,218045,218047,218049,2,4,0
62297,4,2,218049,218049,218051,0,2,0
62298,3,2,218052,218052,218054,0,2,1
62299,5,2,218057,218057,218059,0,2,3
62300,5,1,218062,218062,218063,0,1,3
62301,4,3,218066,218066,218069,0,3,3
62302,5,2,218071,218071,218073,0,2,2
62303,6,2,218077,218077,218079,0,2,4
62304,3,1,218080,218080,218081,0,1,1
62305,4,3,218084,218084,218087,0,3,3
62306,1,1,218085,218087,218088,2,3,0
62307,5,3,218090,218090,218093,0,3,2
62308,2,3,218092,218093,218096,1,4,0
62309,6,3,218098,218098,218101,0,3,2
62310,4,1,218102,218102,218103,0,1,1
62311,6,1,218108,218108,218109,0,1,5
62312,1,1,218109,218109,218110,0,1,0
62313,4,1,218113,218113,218114,0,1,3
62314,6,1,218119,218119,218120,0,1,5
62315,5,2,218124,218124,218126,0,2,4
62316,2,2,218126,218126,218128,0,2,0
62317,5,1,218131,218131,218132,0,1,3
62318,6,3,218137,218137,218140,0,3,5
62319,4,1,218141,218141,218142,0,1,1
62320,1,3,218142,218142,218145,0,3,0
62321,6,2,218148,218148,218150,0,2,3
62322,2,3,218150,218150,218153,0,3,0
62323,4,2,218154,218154,218156,0,2,1
62324,3,3,218157,218157,218160,0,3,1
62325,1,3,218158,218160,218163,2,5,0
62326,2,3,218160,218163,218166,3,6,0
62327,2,2,218162,218166,218168,4,6,0
62328,1,2,218163,218168,218170,5,7,0
62329,6,1,218169,218170,218171,1,2,0
62330,5,2,218174,218174,218176,0,2,3
62331,6,3,218180,218180,218183,0,3,4
62332,5,2,218185,218185,218187,0,2,2
62333,6,1,218191,218191,218192,0,1,4
62334,4,3,218195,218195,218198,0,3,3
62335,3,1,218198,218198,218199,0,1,0
62336,4,3,218202,218202,218205,0,3,3
62337,3,2,218205,218205,218207,0,2,0
62338,6,1,218211,218211,218212,0,1,4
62339,4,1,218215,218215,218216,0,1,3
62340,1,1,218216,218216,218217,0,1,0
62341,4,1,218220,218220,218221,0,1,3
62342,2,2,218222,218222,218224,0,2,1
62343,2,1,218224,218224,218225,0,1,0
62344,3,2,218227,218227,218229,0,2,2
62345,5,3,218232,218232,218235,0,3,3
62346,4,2,218236,218236,218238,0,2,1
62347,2,1,218238,218238,218239,0,1,0
62348,3,3,218241,218241,218244,0,3,2
62349,1,3,218242,218244,218247,2,5,0
62350,3,3,218245,218247,218250,2,5,0
62351,5,2,218250,218250,218252,0,2,0
62352,2,2,218252,218252,218254,0,2,0
62353,6,1,218258,218258,218259,0,1,4
62354,5,3,218263,218263,218266,0,3,4
62355,2,1,218265,218266,218267,1,2,0
62356,3,2,218268,218268,218270,0,2,1
62357,3,3,218271,218271,218274,0,3,1
62358,2,2,218273,218274,218276,1,3,0
62359,2,1,218275,218276,218277,1,2,0
62360,1,2,218276,218277,218279,1,3,0
62361,5,2,218281,218281,218283,0,2,2
62362,6,1,218287,218287,218288,0,1,4
62363,3,2,218290,218290,218292,0,2,2
62364,6,2,218296,218296,218298,0,2,4
62365,4,1,218300,218300,218301,0,1,2
62366,1,1,218301,218301,218302,0,1,0
62367,6,2,218307,218307,218309,0,2,5
62368,6,1,218313,218313,218314,0,1,4
62369,2,2,218315,218315,218317,0,2,1
62370,2,1,218317,218317,218318,0,1,0
62371,4,2,218321,218321,218323,0,2,3
62372,3,3,218324,218324,218327,0,3,1
62373,2,3,218326,218327,218330,1,4,0
62374,5,3,218331,218331,218334,0,3,1
62375,3,2,218334,218334,218336,0,2,0
62376,5,1,218339,218339,218340,0,1,3
62377,2,3,218341,218341,218344,0,3,1
62378,1,1,218342,218344,218345,2,3,0
62379,4,3,218346,218346,218349,0,3,1
62380,1,3,218347,218349,218352,2,5,0
62381,3,2,218350,218352,218354,2,4,0
62382,2,1,218352,218354,218355,2,3,0
62383,1,1,218353,218355,218356,2,3,0
62384,4,2,218357,218357,218359,0,2,1
62385,5,2,218362,218362,218364,0,2,3
62386,3,2,218365,218365,218367,0,2,1
62387,4,1,218369,218369,218370,0,1,2
62388,2,2,218371,218371,218373,0,2,1
62389,3,1,218374,218374,218375,0,1,1
62390,2,3,218376,218376,218379,0,3,1
62391,5,1,218381,218381,218382,0,1,2
62392,5,2,218386,218386,218388,0,2,4
62393,4,2,218390,218390,218392,0,2,2
62394,6,3,218396,218396,218399,0,3,4
62395,5,3,218401,218401,218404,0,3,2
62396,3,1,218404,218404,218405,0,1,0
62397,3,2,218407,218407,218409,0,2,2
62398,6,2,218413,218413,218415,0,2,4
62399,2,1,218415,218415,218416,0,1,0
62400,1,2,218416,218416,218418,0,2,0
62401,3,3,218419,218419,218422,0,3,1
62402,3,3,218422,218422,218425,0,3,0
62403,3,2,218425,218425,218427,0,2,0
62404,1,3,218426,218427,218430,1,4,0
62405,2,2,218428,218430,218432,2,4,0
62406,6,1,218434,218434,218435,0,1,2
62407,5,3,218439,218439,218442,0,3,4
62408,1,3,218440,218442,218445,2,5,0
62409,4,3,218444,218445,218448,1,4,0
62410,1,3,218445,218448,218451,3,6,0
62411,1,3,218446,218451,218454,5,8,0
62412,6,1,218452,218454,218455,2,3,0
62413,2,1,218454,218455,218456,1,2,0
62414,3,2,218457,218457,218459,0,2,1
62415,1,2,218458,218459,218461,1,3,0
62416,4,3,218462,218462,218465,0,3,1
62417,4,1,218466,218466,218467,0,1,1
62418,4,3,218470,218470,218473,0,3,3
62419,3,2,218473,218473,218475,0,2,0
62420,6,3,218479,218479,218482,0,3,4
62421,2,1,218481,218482,218483,1,2,0
62422,1,3,218482,218483,218486,1,4,0
62423,5,1,218487,218487,218488,0,1,1
62424,6,1,218493,218493,218494,0,1,5
62425,3,1,218496,218496,218497,0,1,2
62426,2,1,218498,218498,218499,0,1,1
62427,5,2,218503,218503,218505,0,2,4
62428,6,2,218509,218509,218511,0,2,4
62429,5,1,218514,218514,218515,0,1,3
62430,4,2,218518,218518,218520,0,2,3
62431,2,3,218520,218520,218523,0,3,0
62432,6,2,218526,218526,218528,0,2,3
62433,2,3,218528,218528,218531,0,3,0
62434,5,3,218533,218533,218536,0,3,2
62435,5,1,218538,218538,218539,0,1,2
62436,1,1,218539,218539,218540,0,1,0
62437,3,1,218542,218542,218543,0,1,2
62438,1,3,218543,218543,218546,0,3,0
62439,3,2,218546,218546,218548,0,2,0
62440,1,1,218547,218548,218549,1,2,0
62441,1,1,218548,218549,218550,1,2,0
62442,1,2,218549,218550,218552,1,3,0
62443,3,2,218552,218552,218554,0,2,0
62444,6,2,218558,218558,218560,0,2,4
62445,5,2,218563,218563,218565,0,2,3
62446,4,2,218567,218567,218569,0,2,2
62447,4,3,218571,218571,218574,0,3,2
62448,5,3,218576,218576,218579,0,3,2
62449,4,2,218580,218580,218582,0,2,1
62450,3,1,218583,218583,218584,0,1,1
62451,3,3,218586,218586,218589,0,3,2
62452,6,1,218592,218592,218593,0,1,3
62453,1,2,218593,218593,218595,0,2,0
62454,1,2,218594,218595,218597,1,3,0
62455,5,2,218599,218599,218601,0,2,2
62456,4,3,218603,218603,218606,0,3,2
62457,2,2,218605,218606,218608,1,3,0
62458,3,3,218608,218608,218611,0,3,0
62459,5,3,218613,218613,218616,0,3,2
62460,5,1,218618,218618,218619,0,1,2
62461,2,1,218620,218620,218621,0,1,1
62462,6,2,218626,218626,218628,0,2,5
62463,6,2,218632,218632,218634,0,2,4
62464,3,1,218635,218635,218636,0,1,1
62465,4,1,218639,218639,218640,0,1,3
62466,4,1,218643,218643,218644,0,1,3
62467,2,1,218645,218645,218646,0,1,1
62468,1,1,218646,218646,218647,0,1,0
62469,1,2,218647,218647,218649,0,2,0
62470,4,2,218651,218651,218653,0,2,2
62471,6,2,218657,218657,218659,0,2,4
62472,4,1,218661,218661,218662,0,1,2
62473,5,2,218666,218666,218668,0,2,4
62474,5,1,218671,218671,218672,0,1,3
62475,5,1,218676,218676,218677,0,1,4
62476,3,3,218679,218679,218682,0,3,2
62477,2,3,218681,218682,218685,1,4,0
62478,5,3,218686,218686,218689,0,3,1
62479,6,3,218692,218692,218695,0,3,3
62480,3,1,218695,218695,218696,0,1,0
62481,3,2,218698,218698,218700,0,2,2
62482,3,2,218701,218701,218703,0,2,1
62483,1,2,218702,218703,218705,1,3,0
62484,1,2,218703,218705,218707,2,4,0
62485,2,3,218705,218707,218710,2,5,0
62486,5,2,218710,218710,218712,0,2,0
62487,3,2,218713,218713,218715,0,2,1
62488,1,1,218714,218715,218716,1,2,0
62489,3,1,218717,218717,218718,0,1,1
62490,5,1,218722,218722,218723,0,1,4
62491,2,1,218724,218724,218725,0,1,1
62492,1,2,218725,218725,218727,0,2,0
62493,5,2,218730,218730,218732,0,2,3
62494,5,2,218735,218735,218737,0,2,3
62495,6,1,218741,218741,218742,0,1,4
62496,1,1,218742,218742,218743,0,1,0
62497,5,2,218747,218747,218749,0,2,4
62498,1,2,218748,218749,218751,1,3,0
62499,3,2,218751,218751,218753,0,2,0
62500,6,1,218757,218757,218758,0,1,4
62501,1,1,218758,218758,218759,0,1,0
62502,5,1,218763,218763,218764,0,1,4
62503,2,2,218765,218765,218767,0,2,1
62504,3,1,218768,218768,218769,0,1,1
62505,5,3,218773,218773,218776,0,3,4
62506,3,3,218776,218776,218779,0,3,0
62507,6,3,218782,218782,218785,0,3,3
62508,3,3,218785,218785,218788,0,3,0
62509,4,2,218789,218789,218791,0,2,1
62510,3,3,218792,218792,218795,0,3,1
62511,4,3,218796,218796,218799,0,3,1
62512,3,2,218799,218799,218801,0,2,0
62513,3,2,218802,218802,218804,0,2,1
62514,3,2,218805,218805,218807,0,2,1
62515,6,1,218811,218811,218812,0,1,4
62516,5,1,218816,218816,218817,0,1,4
62517,3,3,218819,218819,218822,0,3,2
62518,6,1,218825,218825,218826,0,1,3
62519,4,1,218829,218829,218830,0,1,3
62520,2,2,218831,218831,218833,0,2,1
62521,3,3,218834,218834,218837,0,3,1
62522,6,1,218840,218840,218841,0,1,3
62523,3,2,218843,218843,218845,0,2,2
62524,2,2,218845,218845,218847,0,2,0
62525,4,3,218849,218849,218852,0,3,2
62526,5,1,218854,218854,218855,0,1,2
62527,4,1,218858,218858,218859,0,1,3
62528,5,1,218863,218863,218864,0,1,4
62529,4,1,218867,218867,218868,0,1,3
62530,4,2,218871,218871,218873,0,2,3
62531,5,1,218876,218876,218877,0,1,3
62532,3,1,218879,218879,218880,0,1,2
62533,2,2,218881,218881,218883,0,2,1
62534,6,1,218887,218887,218888,0,1,4
62535,6,1,218893,218893,218894,0,1,5
62536,5,3,218898,218898,218901,0,3,4
62537,3,3,218901,218901,218904,0,3,0
62538,5,3,218906,218906,218909,0,3,2
62539,1,3,218907,218909,218912,2,5,0
62540,6,1,218913,218913,218914,0,1,1
62541,3,2,218916,218916,218918,0,2,2
62542,3,3,218919,218919,218922,0,3,1
62543,4,1,218923,218923,218924,0,1,1
62544,5,2,218928,218928,218930,0,2,4
62545,6,2,218934,218934,218936,0,2,4
62546,1,2,218935,218936,218938,1,3,0
62547,2,3,218937,218938,218941,1,4,0
62548,2,3,218939,218941,218944,2,5,0
62549,3,1,218942,218944,218945,2,3,0
62550,6,3,218948,218948,218951,0,3,3
62551,1,1,218949,218951,218952,2,3,0
62552,6,3,218955,218955,218958,0,3,3
62553,4,1,218959,218959,218960,0,1,1
62554,5,1,218964,218964,218965,0,1,4
62555,6,3,218970,218970,218973,0,3,5
62556,2,2,218972,218973,218975,1,3,0
62557,2,2,218974,218975,218977,1,3,0
62558,2,1,218976,218977,218978,1,2,0
62559,3,1,218979,218979,218980,0,1,1
62560,6,2,218985,218985,218987,0,2,5
62561,6,1,218991,218991,218992,0,1,4
62562,5,3,218996,218996,218999,0,3,4
62563,4,2,219000,219000,219002,0,2,1
62564,1,3,219001,219002,219005,1,4,0
62565,4,1,219005,219005,219006,0,1,0
62566,1,2,219006,219006,219008,0,2,0
62567,2,1,219008,219008,219009,0,1,0
62568,2,3,219010,219010,219013,0,3,1
62569,2,2,219012,219013,219015,1,3,0
62570,2,3,219014,219015,219018,1,4,0
62571,5,1,219019,219019,219020,0,1,1
62572,3,2,219022,219022,219024,0,2,2
62573,4,1,219026,219026,219027,0,1,2
62574,2,1,219028,219028,219029,0,1,1
62575,4,3,219032,219032,219035,0,3,3
62576,5,1,219037,219037,219038,0,1,2
62577,1,3,219038,219038,219041,0,3,0
62578,6,2,219044,219044,219046,0,2,3
62579,2,3,219046,219046,219049,0,3,0
62580,1,2,219047,219049,219051,2,4,0
62581,1,1,219048,219051,219052,3,4,0
62582,2,2,219050,219052,219054,2,4,0
62583,2,2,219052,219054,219056,2,4,0
62584,1,1,219053,219056,219057,3,4,0
62585,5,3,219058,219058,219061,0,3,1
62586,6,2,219064,219064,219066,0,2,3
62587,3,3,219067,219067,219070,0,3,1
62588,1,2,219068,219070,219072,2,4,0
62589,1,3,219069,219072,219075,3,6,0
62590,4,1,219073,219075,219076,2,3,0
62591,1,1,219074,219076,219077,2,3,0
62592,1,1,219075,219077,219078,2,3,0
62593,3,2,219078,219078,219080,0,2,0
62594,3,3,219081,219081,219084,0,3,1
62595,2,1,219083,219084,219085,1,2,0
62596,2,1,219085,219085,219086,0,1,0
62597,5,2,219090,219090,219092,0,2,4
62598,1,2,219091,219092,219094,1,3,0
62599,1,3,219092,219094,219097,2,5,0
62600,1,3,219093,219097,219100,4,7,0
62601,6,1,219099,219100,219101,1,2,0
62602,4,1,219103,219103,219104,0,1,2
62603,2,2,219105,219105,219107,0,2,1
62604,5,3,219110,219110,219113,0,3,3
62605,1,2,219111,219113,219115,2,4,0
62606,6,1,219117,219117,219118,0,1,2
62607,6,1,219123,219123,219124,0,1,5
62608,3,1,219126,219126,219127,0,1,2
62609,2,2,219128,219128,219130,0,2,1
62610,1,2,219129,219130,219132,1,3,0
62611,5,1,219134,219134,219135,0,1,2
62612,4,1,219138,219138,219139,0,1,3
62613,6,3,219144,219144,219147,0,3,5
62614,1,2,219145,219147,219149,2,4,0
62615,3,2,219148,219149,219151,1,3,0
62616,2,2,219150,219151,219153,1,3,0
62617,4,2,219154,219154,219156,0,2,1
62618,2,3,219156,219156,219159,0,3,0
62619,5,3,219161,219161,219164,0,3,2
62620,6,2,219167,219167,219169,0,2,3
62621,1,2,219168,219169,219171,1,3,0
62622,3,2,219171,219171,219173,0,2,0
62623,2,3,219173,219173,219176,0,3,0
62624,6,1,219179,219179,219180,0,1,3
62625,4,2,219183,219183,219185,0,2,3
62626,6,3,219189,219189,219192,0,3,4
62627,4,3,219193,219193,219196,0,3,1
62628,4,3,219197,219197,219200,0,3,1
62629,6,2,219203,219203,219205,0,2,3
62630,6,3,219209,219209,219212,0,3,4
62631,2,1,219211,219212,219213,1,2,0
62632,5,2,219216,219216,219218,0,2,3
62633,5,1,219221,219221,219222,0,1,3
62634,5,1,219226,219226,219227,0,1,4
62635,6,1,219232,219232,219233,0,1,5
62636,5,3,219237,219237,219240,0,3,4
62637,2,2,219239,219240,219242,1,3,0
62638,3,1,219242,219242,219243,0,1,0
62639,6,1,219248,219248,219249,0,1,5
62640,5,3,219253,219253,219256,0,3,4
62641,1,3,219254,219256,219259,2,5,0
62642,3,2,219257,219259,219261,2,4,0
62643,6,2,219263,219263,219265,0,2,2
62644,4,2,219267,219267,219269,0,2,2
62645,4,1,219271,219271,219272,0,1,2
62646,4,1,219275,219275,219276,0,1,3
62647,5,3,219280,219280,219283,0,3,4
62648,2,1,219282,219283,219284,1,2,0
62649,3,3,219285,219285,219288,0,3,1
62650,6,2,219291,219291,219293,0,2,3
62651,1,1,219292,219293,219294,1,2,0
62652,2,2,219294,219294,219296,0,2,0
62653,4,3,219298,219298,219301,0,3,2
62654,6,3,219304,219304,219307,0,3,3
62655,2,1,219306,219307,219308,1,2,0
62656,1,1,219307,219308,219309,1,2,0
62657,4,1,219311,219311,219312,0,1,2
62658,2,3,219313,219313,219316,0,3,1
62659,5,3,219318,219318,219321,0,3,2
62660,3,3,219321,219321,219324,0,3,0
62661,3,3,219324,219324,219327,0,3,0
62662,3,1,219327,219327,219328,0,1,0
62663,3,2,219330,219330,219332,0,2,2
62664,3,2,219333,219333,219335,0,2,1
62665,5,1,219338,219338,219339,0,1,3
62666,4,1,219342,219342,219343,0,1,3
62667,2,3,219344,219344,219347,0,3,1
62668,5,2,219349,219349,219351,0,2,2
62669,5,3,219354,219354,219357,0,3,3
62670,1,1,219355,219357,219358,2,3,0
62671,1,1,219356,219358,219359,2,3,0
62672,3,1,219359,219359,219360,0,1,0
62673,5,2,219364,219364,219366,0,2,4
62674,2,2,219366,219366,219368,0,2,0
62675,6,2,219372,219372,219374,0,2,4
62676,2,3,219374,219374,219377,0,3,0
62677,5,1,219379,219379,219380,0,1,2
62678,3,1,219382,219382,219383,0,1,2
62679,2,1,219384,219384,219385,0,1,1
62680,5,3,219389,219389,219392,0,3,4
62681,1,3,219390,219392,219395,2,5,0
62682,5,3,219395,219395,219398,0,3,0
62683,2,2,219397,219398,219400,1,3,0
62684,5,2,219402,219402,219404,0,2,2
62685,1,3,219403,219404,219407,1,4,0
62686,3,3,219406,219407,219410,1,4,0
62687,1,2,219407,219410,219412,3,5,0
62688,3,2,219410,219412,219414,2,4,0
62689,4,1,219414,219414,219415,0,1,0
62690,3,1,219417,219417,219418,0,1,2
62691,2,3,219419,219419,219422,0,3,1
62692,4,3,219423,219423,219426,0,3,1
62693,1,1,219424,219426,219427,2,3,0
62694,5,1,219429,219429,219430,0,1,2
62695,2,1,219431,219431,219432,0,1,1
62696,4,3,219435,219435,219438,0,3,3
62697,3,2,219438,219438,219440,0,2,0
62698,3,2,219441,219441,219443,0,2,1
62699,4,1,219445,219445,219446,0,1,2
62700,3,1,219448,219448,219449,0,1,2
62701,3,1,219451,219451,219452,0,1,2
62702,4,1,219455,219455,219456,0,1,3
62703,3,3,219458,219458,219461,0,3,2
62704,6,3,219464,219464,219467,0,3,3
62705,6,2,219470,219470,219472,0,2,3
62706,2,3,219472,219472,219475,0,3,0
62707,6,2,219478,219478,219480,0,2,3
62708,3,3,219481,219481,219484,0,3,1
62709,2,3,219483,219484,219487,1,4,0
62710,3,2,219486,219487,219489,1,3,0
62711,4,3,219490,219490,219493,0,3,1
62712,1,3,219491,219493,219496,2,5,0
62713,2,3,219493,219496,219499,3,6,0
62714,1,2,219494,219499,219501,5,7,0
62715,1,1,219495,219501,219502,6,7,0
62716,6,2,219501,219502,219504,1,3,0
62717,4,3,219505,219505,219508,0,3,1
62718,6,1,219511,219511,219512,0,1,3
62719,4,2,219515,219515,219517,0,2,3
62720,1,2,219516,219517,219519,1,3,0
62721,1,3,219517,219519,219522,2,5,0
62722,4,1,219521,219522,219523,1,2,0
62723,6,2,219527,219527,219529,0,2,4
62724,3,2,219530,219530,219532,0,2,1
62725,6,2,219536,219536,219538,0,2,4
62726,5,2,219541,219541,219543,0,2,3
62727,6,1,219547,219547,219548,0,1,4
62728,3,1,219550,219550,219551,0,1,2
62729,4,3,219554,219554,219557,0,3,3
62730,1,1,219555,219557,219558,2,3,0
62731,3,3,219558,219558,219561,0,3,0
62732,2,2,219560,219561,219563,1,3,0
62733,5,1,219565,219565,219566,0,1,2
62734,3,2,219568,219568,219570,0,2,2
62735,4,1,219572,219572,219573,0,1,2
62736,6,1,219578,219578,219579,0,1,5
62737,6,3,219584,219584,219587,0,3,5
62738,2,3,219586,219587,219590,1,4,0
62739,6,2,219592,219592,219594,0,2,2
62740,4,2,219596,219596,219598,0,2,2
62741,6,1,219602,219602,219603,0,1,4
62742,5,2,219607,219607,219609,0,2,4
62743,2,3,219609,219609,219612,0,3,0
62744,2,3,219611,219612,219615,1,4,0
62745,1,2,219612,219615,219617,3,5,0
62746,3,3,219615,219617,219620,2,5,0
62747,6,2,219621,219621,219623,0,2,1
62748,1,2,219622,219623,219625,1,3,0
62749,5,2,219627,219627,219629,0,2,2
62750,4,3,219631,219631,219634,0,3,2
62751,5,1,219636,219636,219637,0,1,2
62752,5,3,219641,219641,219644,0,3,4
62753,5,3,219646,219646,219649,0,3,2
62754,3,2,219649,219649,219651,0,2,0
62755,1,1,219650,219651,219652,1,2,0
62756,5,1,219655,219655,219656,0,1,3
62757,1,2,219656,219656,219658,0,2,0
62758,1,2,219657,219658,219660,1,3,0
62759,5,2,219662,219662,219664,0,2,2
62760,4,3,219666,219666,219669,0,3,2
62761,3,2,219669,219669,219671,0,2,0
62762,1,1,219670,219671,219672,1,2,0
62763,6,3,219676,219676,219679,0,3,4
62764,6,2,219682,219682,219684,0,2,3
62765,1,2,219683,219684,219686,1,3,0
62766,1,3,219684,219686,219689,2,5,0
62767,5,2,219689,219689,219691,0,2,0
62768,4,3,219693,219693,219696,0,3,2
62769,6,1,219699,219699,219700,0,1,3
62770,1,3,219700,219700,219703,0,3,0
62771,2,3,219702,219703,219706,1,4,0
62772,4,2,219706,219706,219708,0,2,0
62773,2,2,219708,219708,219710,0,2,0
62774,3,1,219711,219711,219712,0,1,1
62775,3,3,219714,219714,219717,0,3,2
62776,3,1,219717,219717,219718,0,1,0
62777,1,2,219718,219718,219720,0,2,0
62778,3,1,219721,219721,219722,0,1,1
62779,3,3,219724,219724,219727,0,3,2
62780,4,3,219728,219728,219731,0,3,1
62781,1,1,219729,219731,219732,2,3,0
62782,2,1,219731,219732,219733,1,2,0
62783,2,1,219733,219733,219734,0,1,0
62784,5,1,219738,219738,219739,0,1,4
62785,4,2,219742,219742,219744,0,2,3
62786,2,2,219744,219744,219746,0,2,0
62787,2,3,219746,219746,219749,0,3,0
62788,2,1,219748,219749,219750,1,2,0
62789,6,3,219754,219754,219757,0,3,4
62790,4,2,219758,219758,219760,0,2,1
62791,4,1,219762,219762,219763,0,1,2
62792,5,1,219767,219767,219768,0,1,4
62793,6,3,219773,219773,219776,0,3,5
62794,1,2,219774,219776,219778,2,4,0
62795,4,3,219778,219778,219781,0,3,0
62796,6,3,219784,219784,219787,0,3,3
62797,5,2,219789,219789,219791,0,2,2
62798,3,1,219792,219792,219793,0,1,1
62799,5,3,219797,219797,219800,0,3,4
62800,1,2,219798,219800,219802,2,4,0
62801,6,2,219804,219804,219806,0,2,2
62802,3,3,219807,219807,219810,0,3,1
62803,4,3,219811,219811,219814,0,3,1
62804,5,1,219816,219816,219817,0,1,2
62805,3,3,219819,219819,219822,0,3,2
62806,2,1,219821,219822,219823,1,2,0
62807,2,3,219823,219823,219826,0,3,0
62808,2,1,219825,219826,219827,1,2,0
62809,1,2,219826,219827,219829,1,3,0
62810,4,3,219830,219830,219833,0,3,1
62811,6,1,219836,219836,219837,0,1,3
62812,3,3,219839,219839,219842,0,3,2
62813,1,3,219840,219842,219845,2,5,0
62814,3,1,219843,219845,219846,2,3,0
62815,4,2,219847,219847,219849,0,2,1
62816,4,3,219851,219851,219854,0,3,2
62817,5,2,219856,219856,219858,0,2,2
62818,4,1,219860,219860,219861,0,1,2
62819,3,3,219863,219863,219866,0,3,2
62820,4,3,219867,219867,219870,0,3,1
62821,2,3,219869,219870,219873,1,4,0
62822,4,1,219873,219873,219874,0,1,0
62823,6,1,219879,219879,219880,0,1,5
62824,6,2,219885,219885,219887,0,2,5
62825,6,3,219891,219891,219894,0,3,4
62826,4,2,219895,219895,219897,0,2,1
62827,2,3,219897,219897,219900,0,3,0
62828,2,3,219899,219900,219903,1,4,0
62829,6,1,219905,219905,219906,0,1,2
62830,2,1,219907,219907,219908,0,1,1
62831,5,3,219912,219912,219915,0,3,4
62832,6,2,219918,219918,219920,0,2,3
62833,3,1,219921,219921,219922,0,1,1
62834,1,3,219922,219922,219925,0,3,0
62835,3,2,219925,219925,219927,0,2,0
62836,3,3,219928,219928,219931,0,3,1
62837,2,1,219930,219931,219932,1,2,0
62838,1,3,219931,219932,219935,1,4,0
62839,6,2,219937,219937,219939,0,2,2
62840,2,1,219939,219939,219940,0,1,0
62841,2,3,219941,219941,219944,0,3,1
62842,2,3,219943,219944,219947,1,4,0
62843,6,2,219949,219949,219951,0,2,2
62844,2,2,219951,219951,219953,0,2,0
62845,4,3,219955,219955,219958,0,3,2
62846,1,1,219956,219958,219959,2,3,0
62847,1,2,219957,219959,219961,2,4,0
62848,4,3,219961,219961,219964,0,3,0
62849,2,1,219963,219964,219965,1,2,0
62850,5,2,219968,219968,219970,0,2,3
62851,6,1,219974,219974,219975,0,1,4
62852,1,2,219975,219975,219977,0,2,0
62853,2,1,219977,219977,219978,0,1,0
62854,6,3,219983,219983,219986,0,3,5
62855,5,3,219988,219988,219991,0,3,2
62856,4,2,219992,219992,219994,0,2,1
62857,5,3,219997,219997,220000,0,3,3
62858,2,2,219999,220000,220002,1,3,0
62859,4,2,220003,220003,220005,0,2,1
62860,2,1,220005,220005,220006,0,1,0
62861,4,2,220009,220009,220011,0,2,3
62862,1,1,220010,220011,220012,1,2,0
62863,5,1,220015,220015,220016,0,1,3
62864,4,3,220019,220019,220022,0,3,3
62865,3,3,220022,220022,220025,0,3,0
62866,4,2,220026,220026,220028,0,2,1
62867,1,1,220027,220028,220029,1,2,0
62868,1,2,220028,220029,220031,1,3,0
62869,1,1,220029,220031,220032,2,3,0
62870,2,1,220031,220032,220033,1,2,0
62871,3,2,220034,220034,220036,0,2,1
62872,5,1,220039,220039,220040,0,1,3
62873,6,3,220045,220045,220048,0,3,5
62874,6,1,220051,220051,220052,0,1,3
62875,5,1,220056,220056,220057,0,1,4
62876,6,3,220062,220062,220065,0,3,5
62877,4,2,220066,220066,220068,0,2,1
62878,6,1,220072,220072,220073,0,1,4
62879,4,3,220076,220076,220079,0,3,3
62880,1,3,220077,220079,220082,2,5,0
62881,2,3,220079,220082,220085,3,6,0
62882,2,1,220081,220085,220086,4,5,0
62883,2,2,220083,220086,220088,3,5,0
62884,4,3,220087,220088,220091,1,4,0
62885,2,1,220089,220091,220092,2,3,0
62886,3,3,220092,220092,220095,0,3,0
62887,6,2,220098,220098,220100,0,2,3
62888,6,2,220104,220104,220106,0,2,4
62889,2,2,220106,220106,220108,0,2,0
62890,3,1,220109,220109,220110,0,1,1
62891,5,3,220114,220114,220117,0,3,4
62892,3,2,220117,220117,220119,0,2,0
62893,5,2,220122,220122,220124,0,2,3
62894,2,1,220124,220124,220125,0,1,0
62895,3,2,220127,220127,220129,0,2,2
62896,1,1,220128,220129,220130,1,2,0
62897,4,3,220132,220132,220135,0,3,2
62898,4,1,220136,220136,220137,0,1,1
62899,2,3,220138,220138,220141,0,3,1
62900,2,2,220140,220141,220143,1,3,0
62901,2,2,220142,220143,220145,1,3,0
62902,5,2,220147,220147,220149,0,2,2
62903,2,2,220149,220149,220151,0,2,0
62904,4,3,220153,220153,220156,0,3,2
62905,4,2,220157,220157,220159,0,2,1
62906,3,2,220160,220160,220162,0,2,1
62907,5,3,220165,220165,220168,0,3,3
62908,3,2,220168,220168,220170,0,2,0
62909,1,3,220169,220170,220173,1,4,0
62910,6,3,220175,220175,220178,0,3,2
62911,1,3,220176,220178,220181,2,5,0
62912,5,1,220181,220181,220182,0,1,0
62913,4,1,220185,220185,220186,0,1,3
62914,2,1,220187,220187,220188,0,1,1
62915,2,3,220189,220189,220192,0,3,1
62916,4,3,220193,220193,220196,0,3,1
62917,6,2,220199,220199,220201,0,2,3
62918,6,1,220205,220205,220206,0,1,4
62919,5,1,220210,220210,220211,0,1,4
62920,3,2,220213,220213,220215,0,2,2
62921,4,3,220217,220217,220220,0,3,2
62922,5,2,220222,220222,220224,0,2,2
62923,1,3,220223,220224,220227,1,4,0
62924,5,1,220228,220228,220229,0,1,1
62925,4,1,220232,220232,220233,0,1,3
62926,6,1,220238,220238,220239,0,1,5
62927,5,2,220243,220243,220245,0,2,4
62928,2,2,220245,220245,220247,0,2,0
62929,5,1,220250,220250,220251,0,1,3
62930,2,2,220252,220252,220254,0,2,1
62931,1,1,220253,220254,220255,1,2,0
62932,3,1,220256,220256,220257,0,1,1
62933,4,1,220260,220260,220261,0,1,3
62934,4,1,220264,220264,220265,0,1,3
62935,1,2,220265,220265,220267,0,2,0
62936,6,3,220271,220271,220274,0,3,4
62937,3,3,220274,220274,220277,0,3,0
62938,3,2,220277,220277,220279,0,2,0
62939,5,1,220282,220282,220283,0,1,3
62940,3,1,220285,220285,220286,0,1,2
62941,3,2,220288,220288,220290,0,2,2
62942,3,1,220291,220291,220292,0,1,1
62943,2,3,220293,220293,220296,0,3,1
62944,1,3,220294,220296,220299,2,5,0
62945,5,1,220299,220299,220300,0,1,0
62946,1,3,220300,220300,220303,0,3,0
62947,1,3,220301,220303,220306,2,5,0
62948,6,2,220307,220307,220309,0,2,1
62949,3,1,220310,220310,220311,0,1,1
62950,1,1,220311,220311,220312,0,1,0
62951,1,2,220312,220312,220314,0,2,0
62952,1,3,220313,220314,220317,1,4,0
62953,4,1,220317,220317,220318,0,1,0
62954,1,3,220318,220318,220321,0,3,0
62955,4,2,220322,220322,220324,0,2,1
62956,1,2,220323,220324,220326,1,3,0
62957,5,2,220328,220328,220330,0,2,2
62958,6,2,220334,220334,220336,0,2,4
62959,2,2,220336,220336,220338,0,2,0
62960,4,3,220340,220340,220343,0,3,2
62961,3,2,220343,220343,220345,0,2,0
62962,4,3,220347,220347,220350,0,3,2
62963,1,2,220348,220350,220352,2,4,0
62964,5,3,220353,220353,220356,0,3,1
62965,4,1,220357,220357,220358,0,1,1
62966,6,1,220363,220363,220364,0,1,5
62967,3,2,220366,220366,220368,0,2,2
62968,1,2,220367,220368,220370,1,3,0
62969,6,1,220373,220373,220374,0,1,3
62970,5,2,220378,220378,220380,0,2,4
62971,2,2,220380,220380,220382,0,2,0
62972,5,3,220385,220385,220388,0,3,3
62973,1,1,220386,220388,220389,2,3,0
62974,5,1,220391,220391,220392,0,1,2
62975,5,3,220396,220396,220399,0,3,4
62976,4,2,220400,220400,220402,0,2,1
62977,6,2,220406,220406,220408,0,2,4
62978,4,2,220410,220410,220412,0,2,2
62979,5,1,220415,220415,220416,0,1,3
62980,1,2,220416,220416,220418,0,2,0
62981,3,3,220419,220419,220422,0,3,1
62982,2,1,220421,220422,220423,1,2,0
62983,3,1,220424,220424,220425,0,1,1
62984,5,2,220429,220429,220431,0,2,4
62985,6,1,220435,220435,220436,0,1,4
62986,6,2,220441,220441,220443,0,2,5
62987,1,2,220442,220443,220445,1,3,0
62988,3,3,220445,220445,220448,0,3,0
62989,3,1,220448,220448,220449,0,1,0
62990,6,3,220454,220454,220457,0,3,5
62991,1,2,220455,220457,220459,2,4,0
62992,1,1,220456,220459,220460,3,4,0
62993,6,3,220462,220462,220465,0,3,2
62994,5,2,220467,220467,220469,0,2,2
62995,5,3,220472,220472,220475,0,3,3
62996,1,3,220473,220475,220478,2,5,0
62997,5,2,220478,220478,220480,0,2,0
62998,3,1,220481,220481,220482,0,1,1
62999,6,3,220487,220487,220490,0,3,5
63000,2,3,220489,220490,220493,1,4,0
63001,5,1,220494,220494,220495,0,1,1
63002,5,2,220499,220499,220501,0,2,4
63003,2,2,220501,220501,220503,0,2,0
63004,5,2,220506,220506,220508,0,2,3
63005,2,3,220508,220508,220511,0,3,0
63006,1,3,220509,220511,220514,2,5,0
63007,2,3,220511,220514,220517,3,6,0
63008,2,2,220513,220517,220519,4,6,0
63009,5,2,220518,220519,220521,1,3,0
63010,3,2,220521,220521,220523,0,2,0
63011,2,3,220523,220523,220526,0,3,0
63012,4,3,220527,220527,220530,0,3,1
63013,5,1,220532,220532,220533,0,1,2
63014,4,1,220536,220536,220537,0,1,3
63015,3,1,220539,220539,220540,0,1,2
63016,6,3,220545,220545,220548,0,3,5
63017,1,1,220546,220548,220549,2,3,0
63018,6,2,220552,220552,220554,0,2,3
63019,6,3,220558,220558,220561,0,3,4
63020,4,2,220562,220562,220564,0,2,1
63021,2,1,220564,220564,220565,0,1,0
63022,2,2,220566,220566,220568,0,2,1
63023,1,3,220567,220568,220571,1,4,0
63024,3,3,220570,220571,220574,1,4,0
63025,6,2,220576,220576,220578,0,2,2
63026,1,3,220577,220578,220581,1,4,0
63027,5,2,220582,220582,220584,0,2,1
63028,1,1,220583,220584,220585,1,2,0
63029,6,3,220589,220589,220592,0,3,4
63030,4,1,220593,220593,220594,0,1,1
63031,5,3,220598,220598,220601,0,3,4
63032,3,1,220601,220601,220602,0,1,0
63033,4,1,220605,220605,220606,0,1,3
63034,3,1,220608,220608,220609,0,1,2
63035,4,1,220612,220612,220613,0,1,3
63036,1,3,220613,220613,220616,0,3,0
63037,6,3,220619,220619,220622,0,3,3
63038,4,1,220623,220623,220624,0,1,1
63039,6,2,220629,220629,220631,0,2,5
63040,3,2,220632,220632,220634,0,2,1
63041,1,1,220633,220634,220635,1,2,0
63042,4,3,220637,220637,220640,0,3,2
63043,3,2,220640,220640,220642,0,2,0
63044,1,2,220641,220642,220644,1,3,0
63045,2,2,220643,220644,220646,1,3,0
63046,4,3,220647,220647,220650,0,3,1
63047,5,1,220652,220652,220653,0,1,2
63048,5,3,220657,220657,220660,0,3,4
63049,6,3,220663,220663,220666,0,3,3
63050,6,3,220669,220669,220672,0,3,3
63051,3,3,220672,220672,220675,0,3,0
63052,2,1,220674,220675,220676,1,2,0
63053,1,3,220675,220676,220679,1,4,0
63054,4,2,220679,220679,220681,0,2,0
63055,6,2,220685,220685,220687,0,2,4
63056,3,1,220688,220688,220689,0,1,1
63057,4,1,220692,220692,220693,0,1,3
63058,1,1,220693,220693,220694,0,1,0
63059,3,1,220696,220696,220697,0,1,2
63060,5,2,220701,220701,220703,0,2,4
63061,1,1,220702,220703,220704,1,2,0
63062,5,1,220707,220707,220708,0,1,3
63063,4,1,220711,220711,220712,0,1,3
63064,1,3,220712,220712,220715,0,3,0
63065,6,3,220718,220718,220721,0,3,3
63066,5,1,220723,220723,220724,0,1,2
63067,1,1,220724,220724,220725,0,1,0
63068,5,1,220729,220729,220730,0,1,4
63069,4,2,220733,220733,220735,0,2,3
63070,5,3,220738,220738,220741,0,3,3
63071,5,1,220743,220743,220744,0,1,2
63072,1,2,220744,220744,220746,0,2,0
63073,5,1,220749,220749,220750,0,1,3
63074,4,2,220753,220753,220755,0,2,3
63075,4,3,220757,220757,220760,0,3,2
63076,1,1,220758,220760,220761,2,3,0
63077,2,3,220760,220761,220764,1,4,0
63078,2,3,220762,220764,220767,2,5,0
63079,4,3,220766,220767,220770,1,4,0
63080,5,1,220771,220771,220772,0,1,1
63081,3,2,220774,220774,220776,0,2,2
63082,2,2,220776,220776,220778,0,2,0
63083,1,2,220777,220778,220780,1,3,0
63084,4,1,220781,220781,220782,0,1,1
63085,5,1,220786,220786,220787,0,1,4
63086,5,1,220791,220791,220792,0,1,4
63087,4,3,220795,220795,220798,0,3,3
63088,1,2,220796,220798,220800,2,4,0
63089,3,3,220799,220800,220803,1,4,0
63090,2,2,220801,220803,220805,2,4,0
63091,2,1,220803,220805,220806,2,3,0
63092,2,1,220805,220806,220807,1,2,0
63093,6,2,220811,220811,220813,0,2,4
63094,2,1,220813,220813,220814,0,1,0
63095,2,3,220815,220815,220818,0,3,1
63096,6,3,220821,220821,220824,0,3,3
63097,4,3,220825,220825,220828,0,3,1
63098,6,1,220831,220831,220832,0,1,3
63099,5,1,220836,220836,220837,0,1,4
63100,2,3,220838,220838,220841,0,3,1
63101,1,3,220839,220841,220844,2,5,0
63102,4,1,220843,220844,220845,1,2,0
63103,5,3,220848,220848,220851,0,3,3
63104,5,2,220853,220853,220855,0,2,2
63105,3,1,220856,220856,220857,0,1,1
63106,3,1,220859,220859,220860,0,1,2
63107,3,3,220862,220862,220865,0,3,2
63108,6,3,220868,220868,220871,0,3,3
63109,3,2,220871,220871,220873,0,2,0
63110,2,2,220873,220873,220875,0,2,0
63111,2,1,220875,220875,220876,0,1,0
63112,6,1,220881,220881,220882,0,1,5
63113,4,2,220885,220885,220887,0,2,3
63114,1,1,220886,220887,220888,1,2,0
63115,1,2,220887,220888,220890,1,3,0
63116,6,1,220893,220893,220894,0,1,3
63117,3,1,220896,220896,220897,0,1,2
63118,3,1,220899,220899,220900,0,1,2
63119,2,1,220901,220901,220902,0,1,1
63120,2,3,220903,220903,220906,0,3,1
63121,4,2,220907,220907,220909,0,2,1
63122,1,1,220908,220909,220910,1,2,0
63123,4,1,220912,220912,220913,0,1,2
63124,4,3,220916,220916,220919,0,3,3
63125,6,2,220922,220922,220924,0,2,3
63126,6,1,220928,220928,220929,0,1,4
63127,3,2,220931,220931,220933,0,2,2
63128,2,3,220933,220933,220936,0,3,0
63129,2,3,220935,220936,220939,1,4,0
63130,2,3,220937,220939,220942,2,5,0
63131,1,3,220938,220942,220945,4,7,0
63132,5,1,220943,220945,220946,2,3,0
63133,6,1,220949,220949,220950,0,1,3
63134,3,3,220952,220952,220955,0,3,2
63135,2,2,220954,220955,220957,1,3,0
63136,6,1,220960,220960,220961,0,1,3
63137,1,2,220961,220961,220963,0,2,0
63138,5,2,220966,220966,220968,0,2,3
63139,2,3,220968,220968,220971,0,3,0
63140,2,1,220970,220971,220972,1,2,0
63141,2,1,220972,220972,220973,0,1,0
63142,1,3,220973,220973,220976,0,3,0
63143,3,3,220976,220976,220979,0,3,0
63144,1,2,220977,220979,220981,2,4,0
63145,4,1,220981,220981,220982,0,1,0
63146,4,3,220985,220985,220988,0,3,3
63147,2,1,220987,220988,220989,1,2,0
63148,4,2,220991,220991,220993,0,2,2
63149,2,2,220993,220993,220995,0,2,0
63150,6,1,220999,220999,221000,0,1,4
63151,4,3,221003,221003,221006,0,3,3
63152,2,3,221005,221006,221009,1,4,0
63153,1,2,221006,221009,221011,3,5,0
63154,4,2,221010,221011,221013,1,3,0
63155,2,2,221012,221013,221015,1,3,0
63156,6,3,221018,221018,221021,0,3,3
63157,5,2,221023,221023,221025,0,2,2
63158,4,2,221027,221027,221029,0,2,2
63159,5,1,221032,221032,221033,0,1,3
63160,2,3,221034,221034,221037,0,3,1
63161,4,2,221038,221038,221040,0,2,1
63162,4,2,221042,221042,221044,0,2,2
63163,2,2,221044,221044,221046,0,2,0
63164,4,1,221048,221048,221049,0,1,2
63165,1,3,221049,221049,221052,0,3,0
63166,5,3,221054,221054,221057,0,3,2
63167,6,1,221060,221060,221061,0,1,3
63168,2,2,221062,221062,221064,0,2,1
63169,1,2,221063,221064,221066,1,3,0
63170,3,3,221066,221066,221069,0,3,0
63171,1,1,221067,221069,221070,2,3,0
63172,3,1,221070,221070,221071,0,1,0
63173,2,1,221072,221072,221073,0,1,1
63174,6,3,221078,221078,221081,0,3,5
63175,6,3,221084,221084,221087,0,3,3
63176,1,2,221085,221087,221089,2,4,0
63177,6,1,221091,221091,221092,0,1,2
63178,6,1,221097,221097,221098,0,1,5
63179,2,2,221099,221099,221101,0,2,1
63180,2,1,221101,221101,221102,0,1,0
63181,6,1,221107,221107,221108,0,1,5
63182,1,1,221108,221108,221109,0,1,0
63183,1,1,221109,221109,221110,0,1,0
63184,4,2,221113,221113,221115,0,2,3
63185,3,2,221116,221116,221118,0,2,1
63186,5,1,221121,221121,221122,0,1,3
63187,2,2,221123,221123,221125,0,2,1
63188,4,1,221127,221127,221128,0,1,2
63189,4,1,221131,221131,221132,0,1,3
63190,5,1,221136,221136,221137,0,1,4
63191,3,1,221139,221139,221140,0,1,2
63192,1,2,221140,221140,221142,0,2,0
63193,3,3,221143,221143,221146,0,3,1
63194,5,2,221148,221148,221150,0,2,2
63195,6,3,221154,221154,221157,0,3,4
63196,5,1,221159,221159,221160,0,1,2
63197,6,2,221165,221165,221167,0,2,5
63198,1,2,221166,221167,221169,1,3,0
63199,1,3,221167,221169,221172,2,5,0
63200,5,1,221172,221172,221173,0,1,0
63201,4,2,221176,221176,221178,0,2,3
63202,6,1,221182,221182,221183,0,1,4
63203,4,1,221186,221186,221187,0,1,3
63204,1,2,221187,221187,221189,0,2,0
63205,2,1,221189,221189,221190,0,1,0
63206,5,2,221194,221194,221196,0,2,4
63207,2,3,221196,221196,221199,0,3,0
63208,3,3,221199,221199,221202,0,3,0
63209,2,1,221201,221202,221203,1,2,0
63210,2,2,221203,221203,221205,0,2,0
63211,6,3,221209,221209,221212,0,3,4
63212,2,2,221211,221212,221214,1,3,0
63213,1,2,221212,221214,221216,2,4,0
63214,4,2,221216,221216,221218,0,2,0
63215,4,3,221220,221220,221223,0,3,2
63216,2,2,221222,221223,221225,1,3,0
63217,6,3,221228,221228,221231,0,3,3
63218,3,3,221231,221231,221234,0,3,0
63219,5,3,221236,221236,221239,0,3,2
63220,4,3,221240,221240,221243,0,3,1
63221,5,1,221245,221245,221246,0,1,2
63222,2,3,221247,221247,221250,0,3,1
63223,4,1,221251,221251,221252,0,1,1
63224,6,1,221257,221257,221258,0,1,5
63225,1,2,221258,221258,221260,0,2,0
63226,5,1,221263,221263,221264,0,1,3
63227,6,2,221269,221269,221271,0,2,5
63228,6,2,221275,221275,221277,0,2,4
63229,2,1,221277,221277,221278,0,1,0
63230,6,2,221283,221283,221285,0,2,5
63231,4,3,221287,221287,221290,0,3,2
63232,2,2,221289,221290,221292,1,3,0
63233,4,3,221293,221293,221296,0,3,1
63234,6,2,221299,221299,221301,0,2,3
63235,3,2,221302,221302,221304,0,2,1
63236,4,3,221306,221306,221309,0,3,2
63237,3,3,221309,221309,221312,0,3,0
63238,5,3,221314,221314,221317,0,3,2
63239,6,1,221320,221320,221321,0,1,3
63240,1,2,221321,221321,221323,0,2,0
63241,5,2,221326,221326,221328,0,2,3
63242,1,1,221327,221328,221329,1,2,0
63243,6,2,221333,221333,221335,0,2,4
63244,6,3,221339,221339,221342,0,3,4
63245,4,1,221343,221343,221344,0,1,1
63246,4,3,221347,221347,221350,0,3,3
63247,4,3,221351,221351,221354,0,3,1
63248,5,3,221356,221356,221359,0,3,2
63249,2,1,221358,221359,221360,1,2,0
63250,6,2,221364,221364,221366,0,2,4
63251,5,3,221369,221369,221372,0,3,3
63252,1,3,221370,221372,221375,2,5,0
63253,1,3,221371,221375,221378,4,7,0
63254,1,1,221372,221378,221379,6,7,0
63255,5,3,221377,221379,221382,2,5,0
63256,6,2,221383,221383,221385,0,2,1
63257,1,1,221384,221385,221386,1,2,0
63258,4,2,221388,221388,221390,0,2,2
63259,5,3,221393,221393,221396,0,3,3
63260,4,3,221397,221397,221400,0,3,1
63261,1,3,221398,221400,221403,2,5,0
63262,3,1,221401,221403,221404,2,3,0
63263,3,2,221404,221404,221406,0,2,0
63264,2,1,221406,221406,221407,0,1,0
63265,2,3,221408,221408,221411,0,3,1
63266,5,2,221413,221413,221415,0,2,2
63267,5,3,221418,221418,221421,0,3,3
63268,2,2,221420,221421,221423,1,3,0
63269,4,1,221424,221424,221425,0,1,1
63270,3,1,221427,221427,221428,0,1,2
63271,6,1,221433,221433,221434,0,1,5
63272,1,2,221434,221434,221436,0,2,0
63273,1,2,221435,221436,221438,1,3,0
63274,1,1,221436,221438,221439,2,3,0
63275,6,1,221442,221442,221443,0,1,3
63276,5,1,221447,221447,221448,0,1,4
63277,6,1,221453,221453,221454,0,1,5
63278,1,1,221454,221454,221455,0,1,0
63279,5,3,221459,221459,221462,0,3,4
63280,5,2,221464,221464,221466,0,2,2
63281,5,2,221469,221469,221471,0,2,3
63282,4,2,221473,221473,221475,0,2,2
63283,1,2,221474,221475,221477,1,3,0
63284,4,3,221478,221478,221481,0,3,1
63285,2,2,221480,221481,221483,1,3,0
63286,3,3,221483,221483,221486,0,3,0
63287,6,2,221489,221489,221491,0,2,3
63288,6,1,221495,221495,221496,0,1,4
63289,3,1,221498,221498,221499,0,1,2
63290,6,1,221504,221504,221505,0,1,5
63291,5,2,221509,221509,221511,0,2,4
63292,5,3,221514,221514,221517,0,3,3
63293,5,2,221519,221519,221521,0,2,2
63294,6,3,221525,221525,221528,0,3,4
63295,1,3,221526,221528,221531,2,5,0
63296,1,3,221527,221531,221534,4,7,0
63297,2,2,221529,221534,221536,5,7,0
63298,4,1,221533,221536,221537,3,4,0
63299,4,3,221537,221537,221540,0,3,0
63300,6,2,221543,221543,221545,0,2,3
63301,5,1,221548,221548,221549,0,1,3
63302,3,2,221551,221551,221553,0,2,2
63303,5,3,221556,221556,221559,0,3,3
63304,5,2,221561,221561,221563,0,2,2
63305,4,1,221565,221565,221566,0,1,2
63306,2,3,221567,221567,221570,0,3,1
63307,3,3,221570,221570,221573,0,3,0
63308,5,2,221575,221575,221577,0,2,2
63309,5,1,221580,221580,221581,0,1,3
63310,6,1,221586,221586,221587,0,1,5
63311,5,2,221591,221591,221593,0,2,4
63312,4,2,221595,221595,221597,0,2,2
63313,6,2,221601,221601,221603,0,2,4
63314,6,1,221607,221607,221608,0,1,4
63315,3,2,221610,221610,221612,0,2,2
63316,1,2,221611,221612,221614,1,3,0
63317,5,2,221616,221616,221618,0,2,2
63318,3,3,221619,221619,221622,0,3,1
63319,4,3,221623,221623,221626,0,3,1
63320,1,1,221624,221626,221627,2,3,0
63321,3,2,221627,221627,221629,0,2,0
63322,2,1,221629,221629,221630,0,1,0
63323,4,2,221633,221633,221635,0,2,3
63324,4,2,221637,221637,221639,0,2,2
63325,2,1,221639,221639,221640,0,1,0
63326,5,1,221644,221644,221645,0,1,4
63327,4,3,221648,221648,221651,0,3,3
63328,3,2,221651,221651,221653,0,2,0
63329,1,3,221652,221653,221656,1,4,0
63330,2,1,221654,221656,221657,2,3,0
63331,4,1,221658,221658,221659,0,1,1
63332,6,1,221664,221664,221665,0,1,5
63333,5,1,221669,221669,221670,0,1,4
63334,6,3,221675,221675,221678,0,3,5
63335,2,3,221677,221678,221681,1,4,0
63336,2,3,221679,221681,221684,2,5,0
63337,1,3,221680,221684,221687,4,7,0
63338,6,3,221686,221687,221690,1,4,0
63339,6,1,221692,221692,221693,0,1,2
63340,6,2,221698,221698,221700,0,2,5
63341,5,2,221703,221703,221705,0,2,3
63342,1,3,221704,221705,221708,1,4,0
63343,3,1,221707,221708,221709,1,2,0
63344,3,2,221710,221710,221712,0,2,1
63345,6,1,221716,221716,221717,0,1,4
63346,2,2,221718,221718,221720,0,2,1
63347,4,1,221722,221722,221723,0,1,2
63348,3,2,221725,221725,221727,0,2,2
63349,1,2,221726,221727,221729,1,3,0
63350,4,2,221730,221730,221732,0,2,1
63351,6,2,221736,221736,221738,0,2,4
63352,1,2,221737,221738,221740,1,3,0
63353,2,1,221739,221740,221741,1,2,0
63354,3,1,221742,221742,221743,0,1,1
63355,3,3,221745,221745,221748,0,3,2
63356,1,2,221746,221748,221750,2,4,0
63357,2,3,221748,221750,221753,2,5,0
63358,5,2,221753,221753,221755,0,2,0
63359,1,3,221754,221755,221758,1,4,0
63360,6,3,221760,221760,221763,0,3,2
63361,5,3,221765,221765,221768,0,3,2
63362,3,1,221768,221768,221769,0,1,0
63363,5,2,221773,221773,221775,0,2,4
63364,4,2,221777,221777,221779,0,2,2
63365,6,2,221783,221783,221785,0,2,4
63366,2,1,221785,221785,221786,0,1,0
63367,6,3,221791,221791,221794,0,3,5
63368,2,1,221793,221794,221795,1,2,0
63369,2,2,221795,221795,221797,0,2,0
63370,3,2,221798,221798,221800,0,2,1
63371,2,3,221800,221800,221803,0,3,0
63372,1,1,221801,221803,221804,2,3,0
63373,4,1,221805,221805,221806,0,1,1
63374,4,3,221809,221809,221812,0,3,3
63375,5,3,221814,221814,221817,0,3,2
63376,4,3,221818,221818,221821,0,3,1
63377,5,1,221823,221823,221824,0,1,2
63378,5,1,221828,221828,221829,0,1,4
63379,4,1,221832,221832,221833,0,1,3
63380,2,3,221834,221834,221837,0,3,1
63381,5,1,221839,221839,221840,0,1,2
63382,3,1,221842,221842,221843,0,1,2
63383,3,1,221845,221845,221846,0,1,2
63384,6,3,221851,221851,221854,0,3,5
63385,6,1,221857,221857,221858,0,1,3
63386,2,1,221859,221859,221860,0,1,1
63387,4,1,221863,221863,221864,0,1,3
63388,3,3,221866,221866,221869,0,3,2
63389,1,2,221867,221869,221871,2,4,0
63390,5,1,221872,221872,221873,0,1,1
63391,1,3,221873,221873,221876,0,3,0
63392,1,3,221874,221876,221879,2,5,0
63393,5,1,221879,221879,221880,0,1,0
63394,5,1,221884,221884,221885,0,1,4
63395,5,1,221889,221889,221890,0,1,4
63396,4,1,221893,221893,221894,0,1,3
63397,2,2,221895,221895,221897,0,2,1
63398,4,3,221899,221899,221902,0,3,2
63399,5,2,221904,221904,221906,0,2,2
63400,4,1,221908,221908,221909,0,1,2
63401,3,1,221911,221911,221912,0,1,2
63402,2,3,221913,221913,221916,0,3,1
63403,4,1,221917,221917,221918,0,1,1
63404,6,3,221923,221923,221926,0,3,5
63405,2,2,221925,221926,221928,1,3,0
63406,2,2,221927,221928,221930,1,3,0
63407,3,2,221930,221930,221932,0,2,0
63408,3,2,221933,221933,221935,0,2,1
63409,5,3,221938,221938,221941,0,3,3
63410,5,1,221943,221943,221944,0,1,2
63411,2,3,221945,221945,221948,0,3,1
63412,6,3,221951,221951,221954,0,3,3
63413,1,3,221952,221954,221957,2,5,0
63414,4,1,221956,221957,221958,1,2,0
63415,5,2,221961,221961,221963,0,2,3
63416,6,1,221967,221967,221968,0,1,4
63417,1,3,221968,221968,221971,0,3,0
63418,2,2,221970,221971,221973,1,3,0
63419,2,3,221972,221973,221976,1,4,0
63420,4,3,221976,221976,221979,0,3,0
63421,6,1,221982,221982,221983,0,1,3
63422,3,3,221985,221985,221988,0,3,2
63423,6,2,221991,221991,221993,0,2,3
63424,5,2,221996,221996,221998,0,2,3
63425,6,1,222002,222002,222003,0,1,4
63426,2,2,222004,222004,222006,0,2,1
63427,2,2,222006,222006,222008,0,2,0
63428,2,1,222008,222008,222009,0,1,0
63429,3,3,222011,222011,222014,0,3,2
63430,4,2,222015,222015,222017,0,2,1
63431,3,1,222018,222018,222019,0,1,1
63432,3,2,222021,222021,222023,0,2,2
63433,4,3,222025,222025,222028,0,3,2
63434,4,2,222029,222029,222031,0,2,1
63435,1,1,222030,222031,222032,1,2,0
63436,2,1,222032,222032,222033,0,1,0
63437,3,1,222035,222035,222036,0,1,2
63438,3,2,222038,222038,222040,0,2,2
63439,6,1,222044,222044,222045,0,1,4
63440,2,3,222046,222046,222049,0,3,1
63441,1,2,222047,222049,222051,2,4,0
63442,2,1,222049,222051,222052,2,3,0
63443,4,3,222053,222053,222056,0,3,1
63444,2,2,222055,222056,222058,1,3,0
63445,2,3,222057,222058,222061,1,4,0
63446,1,2,222058,222061,222063,3,5,0
63447,2,3,222060,222063,222066,3,6,0
63448,5,1,222065,222066,222067,1,2,0
63449,4,3,222069,222069,222072,0,3,2
63450,1,2,222070,222072,222074,2,4,0
63451,2,1,222072,222074,222075,2,3,0
63452,6,1,222078,222078,222079,0,1,3
63453,3,1,222081,222081,222082,0,1,2
63454,2,1,222083,222083,222084,0,1,1
63455,3,2,222086,222086,222088,0,2,2
63456,5,2,222091,222091,222093,0,2,3
63457,2,1,222093,222093,222094,0,1,0
63458,4,1,222097,222097,222098,0,1,3
63459,5,1,222102,222102,222103,0,1,4
63460,1,2,222103,222103,222105,0,2,0
63461,1,3,222104,222105,222108,1,4,0
63462,3,1,222107,222108,222109,1,2,0
63463,5,1,222112,222112,222113,0,1,3
63464,4,1,222116,222116,222117,0,1,3
63465,1,1,222117,222117,222118,0,1,0
63466,3,3,222120,222120,222123,0,3,2
63467,5,3,222125,222125,222128,0,3,2
63468,2,2,222127,222128,222130,1,3,0
63469,4,2,222131,222131,222133,0,2,1
63470,2,3,222133,222133,222136,0,3,0
63471,6,2,222139,222139,222141,0,2,3
63472,3,3,222142,222142,222145,0,3,1
63473,3,1,222145,222145,222146,0,1,0
63474,1,1,222146,222146,222147,0,1,0
63475,3,2,222149,222149,222151,0,2,2
63476,6,3,222155,222155,222158,0,3,4
63477,4,2,222159,222159,222161,0,2,1
63478,1,1,222160,222161,222162,1,2,0
63479,2,1,222162,222162,222163,0,1,0
63480,2,1,222164,222164,222165,0,1,1
63481,3,3,222167,222167,222170,0,3,2
63482,5,3,222172,222172,222175,0,3,2
63483,1,3,222173,222175,222178,2,5,0
63484,2,3,222175,222178,222181,3,6,0
63485,2,2,222177,222181,222183,4,6,0
63486,1,1,222178,222183,222184,5,6,0
63487,4,1,222182,222184,222185,2,3,0
63488,1,1,222183,222185,222186,2,3,0
63489,6,3,222189,222189,222192,0,3,3
63490,2,1,222191,222192,222193,1,2,0
63491,1,2,222192,222193,222195,1,3,0
63492,1,1,222193,222195,222196,2,3,0
63493,1,2,222194,222196,222198,2,4,0
63494,6,1,222200,222200,222201,0,1,2
63495,5,3,222205,222205,222208,0,3,4
63496,1,2,222206,222208,222210,2,4,0
63497,3,1,222209,222210,222211,1,2,0
63498,1,3,222210,222211,222214,1,4,0
63499,6,3,222216,222216,222219,0,3,2
63500,4,1,222220,222220,222221,0,1,1
63501,1,2,222221,222221,222223,0,2,0
63502,6,1,222227,222227,222228,0,1,4
63503,2,2,222229,222229,222231,0,2,1
63504,5,2,222234,222234,222236,0,2,3
63505,4,1,222238,222238,222239,0,1,2
63506,1,3,222239,222239,222242,0,3,0
63507,6,1,222245,222245,222246,0,1,3
63508,3,3,222248,222248,222251,0,3,2
63509,5,3,222253,222253,222256,0,3,2
63510,5,3,222258,222258,222261,0,3,2
63511,6,1,222264,222264,222265,0,1,3
63512,5,3,222269,222269,222272,0,3,4
63513,2,1,222271,222272,222273,1,2,0
63514,1,2,222272,222273,222275,1,3,0
63515,4,2,222276,222276,222278,0,2,1
63516,2,1,222278,222278,222279,0,1,0
63517,5,2,222283,222283,222285,0,2,4
63518,4,1,222287,222287,222288,0,1,2
63519,6,1,222293,222293,222294,0,1,5
63520,3,1,222296,222296,222297,0,1,2
63521,6,3,222302,222302,222305,0,3,5
63522,4,1,222306,222306,222307,0,1,1
63523,1,3,222307,222307,222310,0,3,0
63524,3,1,222310,222310,222311,0,1,0
63525,2,1,222312,222312,222313,0,1,1
63526,3,1,222315,222315,222316,0,1,2
63527,5,3,222320,222320,222323,0,3,4
63528,2,2,222322,222323,222325,1,3,0
63529,4,1,222326,222326,222327,0,1,1
63530,6,3,222332,222332,222335,0,3,5
63531,3,2,222335,222335,222337,0,2,0
63532,4,1,222339,222339,222340,0,1,2
63533,3,1,222342,222342,222343,0,1,2
63534,4,3,222346,222346,222349,0,3,3
63535,1,3,222347,222349,222352,2,5,0
63536,1,1,222348,222352,222353,4,5,0
63537,4,1,222352,222353,222354,1,2,0
63538,3,1,222355,222355,222356,0,1,1
63539,6,2,222361,222361,222363,0,2,5
63540,5,3,222366,222366,222369,0,3,3
63541,5,1,222371,222371,222372,0,1,2
63542,6,2,222377,222377,222379,0,2,5
63543,4,3,222381,222381,222384,0,3,2
63544,4,2,222385,222385,222387,0,2,1
63545,4,3,222389,222389,222392,0,3,2
63546,1,1,222390,222392,222393,2,3,0
63547,2,3,222392,222393,222396,1,4,0
63548,4,2,222396,222396,222398,0,2,0
63549,2,1,222398,222398,222399,0,1,0
63550,1,1,222399,222399,222400,0,1,0
63551,6,1,222405,222405,222406,0,1,5
63552,3,2,222408,222408,222410,0,2,2
63553,1,2,222409,222410,222412,1,3,0
63554,2,2,222411,222412,222414,1,3,0
63555,4,3,222415,222415,222418,0,3,1
63556,6,1,222421,222421,222422,0,1,3
63557,3,2,222424,222424,222426,0,2,2
63558,6,1,222430,222430,222431,0,1,4
63559,2,1,222432,222432,222433,0,1,1
63560,5,2,222437,222437,222439,0,2,4
63561,4,1,222441,222441,222442,0,1,2
63562,4,3,222445,222445,222448,0,3,3
63563,2,1,222447,222448,222449,1,2,0
63564,3,1,222450,222450,222451,0,1,1
63565,1,2,222451,222451,222453,0,2,0
63566,4,1,222455,222455,222456,0,1,2
63567,2,2,222457,222457,222459,0,2,1
63568,3,1,222460,222460,222461,0,1,1
63569,1,1,222461,222461,222462,0,1,0
63570,4,2,222465,222465,222467,0,2,3
63571,1,3,222466,222467,222470,1,4,0
63572,4,3,222470,222470,222473,0,3,0
63573,4,2,222474,222474,222476,0,2,1
63574,5,2,222479,222479,222481,0,2,3
63575,3,3,222482,222482,222485,0,3,1
63576,1,1,222483,222485,222486,2,3,0
63577,5,3,222488,222488,222491,0,3,2
63578,5,1,222493,222493,222494,0,1,2
63579,2,1,222495,222495,222496,0,1,1
63580,2,3,222497,222497,222500,0,3,1
63581,6,1,222503,222503,222504,0,1,3
63582,5,2,222508,222508,222510,0,2,4
63583,2,2,222510,222510,222512,0,2,0
63584,1,1,222511,222512,222513,1,2,0
63585,2,1,222513,222513,222514,0,1,0
63586,5,3,222518,222518,222521,0,3,4
63587,1,3,222519,222521,222524,2,5,0
63588,6,3,222525,222525,222528,0,3,1
63589,4,2,222529,222529,222531,0,2,1
63590,4,3,222533,222533,222536,0,3,2
63591,5,2,222538,222538,222540,0,2,2
63592,5,3,222543,222543,222546,0,3,3
63593,3,2,222546,222546,222548,0,2,0
63594,2,3,222548,222548,222551,0,3,0
63595,3,1,222551,222551,222552,0,1,0
63596,1,3,222552,222552,222555,0,3,0
63597,6,1,222558,222558,222559,0,1,3
63598,4,1,222562,222562,222563,0,1,3
63599,6,1,222568,222568,222569,0,1,5
63600,1,2,222569,222569,222571,0,2,0
63601,6,1,222575,222575,222576,0,1,4
63602,4,3,222579,222579,222582,0,3,3
63603,3,1,222582,222582,222583,0,1,0
63604,4,3,222586,222586,222589,0,3,3
63605,4,3,222590,222590,222593,0,3,1
63606,1,2,222591,222593,222595,2,4,0
63607,6,2,222597,222597,222599,0,2,2
63608,5,2,222602,222602,222604,0,2,3
63609,2,3,222604,222604,222607,0,3,0
63610,1,1,222605,222607,222608,2,3,0
63611,2,1,222607,222608,222609,1,2,0
63612,5,3,222612,222612,222615,0,3,3
63613,6,1,222618,222618,222619,0,1,3
63614,6,1,222624,222624,222625,0,1,5
63615,2,2,222626,222626,222628,0,2,1
63616,5,1,222631,222631,222632,0,1,3
63617,6,3,222637,222637,222640,0,3,5
63618,3,2,222640,222640,222642,0,2,0
63619,4,2,222644,222644,222646,0,2,2
63620,5,2,222649,222649,222651,0,2,3
63621,5,1,222654,222654,222655,0,1,3
63622,5,2,222659,222659,222661,0,2,4
63623,5,1,222664,222664,222665,0,1,3
63624,2,1,222666,222666,222667,0,1,1
63625,5,2,222671,222671,222673,0,2,4
63626,1,1,222672,222673,222674,1,2,0
63627,4,3,222676,222676,222679,0,3,2
63628,5,3,222681,222681,222684,0,3,2
63629,1,3,222682,222684,222687,2,5,0
63630,5,2,222687,222687,222689,0,2,0
63631,3,3,222690,222690,222693,0,3,1
63632,5,3,222695,222695,222698,0,3,2
63633,5,1,222700,222700,222701,0,1,2
63634,5,2,222705,222705,222707,0,2,4
63635,6,2,222711,222711,222713,0,2,4
63636,2,2,222713,222713,222715,0,2,0
63637,5,2,222718,222718,222720,0,2,3
63638,4,1,222722,222722,222723,0,1,2
63639,5,1,222727,222727,222728,0,1,4
63640,5,1,222732,222732,222733,0,1,4
63641,3,3,222735,222735,222738,0,3,2
63642,2,1,222737,222738,222739,1,2,0
63643,4,1,222741,222741,222742,0,1,2
63644,3,1,222744,222744,222745,0,1,2
63645,2,2,222746,222746,222748,0,2,1
63646,5,1,222751,222751,222752,0,1,3
63647,3,2,222754,222754,222756,0,2,2
63648,1,2,222755,222756,222758,1,3,0
63649,2,1,222757,222758,222759,1,2,0
63650,5,3,222762,222762,222765,0,3,3
63651,2,1,222764,222765,222766,1,2,0
63652,5,2,222769,222769,222771,0,2,3
63653,5,1,222774,222774,222775,0,1,3
63654,4,1,222778,222778,222779,0,1,3
63655,6,2,222784,222784,222786,0,2,5
63656,1,2,222785,222786,222788,1,3,0
63657,6,2,222791,222791,222793,0,2,3
63658,2,3,222793,222793,222796,0,3,0
63659,6,1,222799,222799,222800,0,1,3
63660,3,1,222802,222802,222803,0,1,2
63661,4,3,222806,222806,222809,0,3,3
63662,2,3,222808,222809,222812,1,4,0
63663,6,2,222814,222814,222816,0,2,2
63664,5,2,222819,222819,222821,0,2,3
63665,6,3,222825,222825,222828,0,3,4
63666,4,2,222829,222829,222831,0,2,1
63667,4,2,222833,222833,222835,0,2,2
63668,3,2,222836,222836,222838,0,2,1
63669,3,1,222839,222839,222840,0,1,1
63670,4,1,222843,222843,222844,0,1,3
63671,5,2,222848,222848,222850,0,2,4
63672,1,3,222849,222850,222853,1,4,0
63673,5,2,222854,222854,222856,0,2,1
63674,5,2,222859,222859,222861,0,2,3
63675,1,1,222860,222861,222862,1,2,0
63676,5,3,222865,222865,222868,0,3,3
63677,2,2,222867,222868,222870,1,3,0
63678,1,2,222868,222870,222872,2,4,0
63679,2,2,222870,222872,222874,2,4,0
63680,2,1,222872,222874,222875,2,3,0
63681,1,1,222873,222875,222876,2,3,0
63682,5,3,222878,222878,222881,0,3,2
63683,6,2,222884,222884,222886,0,2,3
63684,2,1,222886,222886,222887,0,1,0
63685,6,3,222892,222892,222895,0,3,5
63686,2,2,222894,222895,222897,1,3,0
63687,1,1,222895,222897,222898,2,3,0
63688,3,3,222898,222898,222901,0,3,0
63689,6,3,222904,222904,222907,0,3,3
63690,3,1,222907,222907,222908,0,1,0
63691,4,3,222911,222911,222914,0,3,3
63692,1,2,222912,222914,222916,2,4,0
63693,2,3,222914,222916,222919,2,5,0
63694,2,1,222916,222919,222920,3,4,0
63695,2,1,222918,222920,222921,2,3,0
63696,3,3,222921,222921,222924,0,3,0
63697,5,2,222926,222926,222928,0,2,2
63698,6,1,222932,222932,222933,0,1,4
63699,3,3,222935,222935,222938,0,3,2
63700,2,2,222937,222938,222940,1,3,0
63701,3,1,222940,222940,222941,0,1,0
63702,6,3,222946,222946,222949,0,3,5
63703,5,3,222951,222951,222954,0,3,2
63704,5,3,222956,222956,222959,0,3,2
63705,4,2,222960,222960,222962,0,2,1
63706,4,1,222964,222964,222965,0,1,2
63707,6,1,222970,222970,222971,0,1,5
63708,3,2,222973,222973,222975,0,2,2
63709,4,3,222977,222977,222980,0,3,2
63710,1,3,222978,222980,222983,2,5,0
63711,1,1,222979,222983,222984,4,5,0
63712,6,1,222985,222985,222986,0,1,1
63713,6,2,222991,222991,222993,0,2,5
63714,5,3,222996,222996,222999,0,3,3
63715,4,1,223000,223000,223001,0,1,1
63716,1,3,223001,223001,223004,0,3,0
63717,1,2,223002,223004,223006,2,4,0
63718,5,2,223007,223007,223009,0,2,1
63719,1,3,223008,223009,223012,1,4,0
63720,1,1,223009,223012,223013,3,4,0
63721,5,1,223014,223014,223015,0,1,1
63722,1,3,223015,223015,223018,0,3,0
63723,2,1,223017,223018,223019,1,2,0
63724,4,1,223021,223021,223022,0,1,2
63725,1,3,223022,223022,223025,0,3,0
63726,4,2,223026,223026,223028,0,2,1
63727,6,2,223032,223032,223034,0,2,4
63728,5,3,223037,223037,223040,0,3,3
63729,1,1,223038,223040,223041,2,3,0
63730,3,2,223041,223041,223043,0,2,0
63731,2,2,223043,223043,223045,0,2,0
63732,3,2,223046,223046,223048,0,2,1
63733,2,3,223048,223048,223051,0,3,0
63734,1,2,223049,223051,223053,2,4,0
63735,6,2,223055,223055,223057,0,2,2
63736,2,2,223057,223057,223059,0,2,0
63737,4,1,223061,223061,223062,0,1,2
63738,2,1,223063,223063,223064,0,1,1
63739,1,2,223064,223064,223066,0,2,0
63740,3,1,223067,223067,223068,0,1,1
63741,1,1,223068,223068,223069,0,1,0
63742,2,2,223070,223070,223072,0,2,1
63743,2,3,223072,223072,223075,0,3,0
63744,5,3,223077,223077,223080,0,3,2
63745,4,2,223081,223081,223083,0,2,1
63746,3,3,223084,223084,223087,0,3,1
63747,6,1,223090,223090,223091,0,1,3
63748,4,2,223094,223094,223096,0,2,3
63749,1,3,223095,223096,223099,1,4,0
63750,5,1,223100,223100,223101,0,1,1
63751,5,2,223105,223105,223107,0,2,4
63752,5,1,223110,223110,223111,0,1,3
63753,2,1,223112,223112,223113,0,1,1
63754,6,3,223118,223118,223121,0,3,5
63755,4,1,223122,223122,223123,0,1,1
63756,4,2,223126,223126,223128,0,2,3
63757,2,2,223128,223128,223130,0,2,0
63758,3,2,223131,223131,223133,0,2,1
63759,5,2,223136,223136,223138,0,2,3
63760,5,1,223141,223141,223142,0,1,3
63761,4,1,223145,223145,223146,0,1,3
63762,2,3,223147,223147,223150,0,3,1
63763,6,1,223153,223153,223154,0,1,3
63764,3,2,223156,223156,223158,0,2,2
63765,6,2,223162,223162,223164,0,2,4
63766,5,1,223167,223167,223168,0,1,3
63767,2,1,223169,223169,223170,0,1,1
63768,4,3,223173,223173,223176,0,3,3
63769,2,1,223175,223176,223177,1,2,0
63770,1,3,223176,223177,223180,1,4,0
63771,5,2,223181,223181,223183,0,2,1
63772,1,2,223182,223183,223185,1,3,0
63773,1,1,223183,223185,223186,2,3,0
63774,5,1,223188,223188,223189,0,1,2
63775,5,1,223193,223193,223194,0,1,4
63776,1,2,223194,223194,223196,0,2,0
63777,2,1,223196,223196,223197,0,1,0
63778,5,3,223201,223201,223204,0,3,4
63779,5,1,223206,223206,223207,0,1,2
63780,3,3,223209,223209,223212,0,3,2
63781,6,3,223215,223215,223218,0,3,3
63782,5,1,223220,223220,223221,0,1,2
63783,6,3,223226,223226,223229,0,3,5
63784,6,2,223232,223232,223234,0,2,3
63785,5,1,223237,223237,223238,0,1,3
63786,4,2,223241,223241,223243,0,2,3
63787,3,2,223244,223244,223246,0,2,1
63788,5,3,223249,223249,223252,0,3,3
63789,5,3,223254,223254,223257,0,3,2
63790,2,3,223256,223257,223260,1,4,0
63791,2,3,223258,223260,223263,2,5,0
63792,5,1,223263,223263,223264,0,1,0
63793,6,2,223269,223269,223271,0,2,5
63794,5,3,223274,223274,223277,0,3,3
63795,3,2,223277,223277,223279,0,2,0
63796,1,3,223278,223279,223282,1,4,0
63797,6,2,223284,223284,223286,0,2,2
63798,4,3,223288,223288,223291,0,3,2
63799,5,2,223293,223293,223295,0,2,2
63800,3,1,223296,223296,223297,0,1,1
63801,3,3,223299,223299,223302,0,3,2
63802,1,2,223300,223302,223304,2,4,0
63803,2,2,223302,223304,223306,2,4,0
63804,3,2,223305,223306,223308,1,3,0
63805,4,1,223309,223309,223310,0,1,1
63806,3,3,223312,223312,223315,0,3,2
63807,5,2,223317,223317,223319,0,2,2
63808,1,1,223318,223319,223320,1,2,0
63809,3,2,223321,223321,223323,0,2,1
63810,4,2,223325,223325,223327,0,2,2
63811,4,2,223329,223329,223331,0,2,2
63812,5,2,223334,223334,223336,0,2,3
63813,6,1,223340,223340,223341,0,1,4
63814,6,1,223346,223346,223347,0,1,5
63815,2,3,223348,223348,223351,0,3,1
63816,2,1,223350,223351,223352,1,2,0
63817,1,1,223351,223352,223353,1,2,0
63818,4,3,223355,223355,223358,0,3,2
63819,1,3,223356,223358,223361,2,5,0
63820,5,2,223361,223361,223363,0,2,0
63821,2,3,223363,223363,223366,0,3,0
63822,6,1,223369,223369,223370,0,1,3
63823,4,2,223373,223373,223375,0,2,3
63824,6,1,223379,223379,223380,0,1,4
63825,5,2,223384,223384,223386,0,2,4
63826,4,3,223388,223388,223391,0,3,2
63827,4,2,223392,223392,223394,0,2,1
63828,2,1,223394,223394,223395,0,1,0
63829,2,3,223396,223396,223399,0,3,1
63830,5,3,223401,223401,223404,0,3,2
63831,3,3,223404,223404,223407,0,3,0
63832,4,3,223408,223408,223411,0,3,1
63833,1,2,223409,223411,223413,2,4,0
63834,4,2,223413,223413,223415,0,2,0
63835,6,1,223419,223419,223420,0,1,4
63836,3,2,223422,223422,223424,0,2,2
63837,3,3,223425,223425,223428,0,3,1
63838,6,3,223431,223431,223434,0,3,3
63839,5,2,223436,223436,223438,0,2,2
63840,1,1,223437,223438,223439,1,2,0
63841,1,1,223438,223439,223440,1,2,0
63842,4,3,223442,223442,223445,0,3,2
63843,6,2,223448,223448,223450,0,2,3
63844,1,1,223449,223450,223451,1,2,0
63845,5,2,223454,223454,223456,0,2,3
63846,1,1,223455,223456,223457,1,2,0
63847,4,2,223459,223459,223461,0,2,2
63848,2,2,223461,223461,223463,0,2,0
63849,6,2,223467,223467,223469,0,2,4
63850,2,3,223469,223469,223472,0,3,0
63851,2,1,223471,223472,223473,1,2,0
63852,6,1,223477,223477,223478,0,1,4
63853,6,3,223483,223483,223486,0,3,5
63854,3,1,223486,223486,223487,0,1,0
63855,5,2,223491,223491,223493,0,2,4
63856,6,2,223497,223497,223499,0,2,4
63857,4,1,223501,223501,223502,0,1,2
63858,4,1,223505,223505,223506,0,1,3
63859,4,3,223509,223509,223512,0,3,3
63860,4,1,223513,223513,223514,0,1,1
63861,5,3,223518,223518,223521,0,3,4
63862,4,3,223522,223522,223525,0,3,1
63863,1,2,223523,223525,223527,2,4,0
63864,2,2,223525,223527,223529,2,4,0
63865,3,3,223528,223529,223532,1,4,0
63866,4,1,223532,223532,223533,0,1,0
63867,6,3,223538,223538,223541,0,3,5
63868,4,2,223542,223542,223544,0,2,1
63869,4,2,223546,223546,223548,0,2,2
63870,2,3,223548,223548,223551,0,3,0
63871,1,3,223549,223551,223554,2,5,0
63872,1,1,223550,223554,223555,4,5,0
63873,1,2,223551,223555,223557,4,6,0
63874,5,2,223556,223557,223559,1,3,0
63875,6,3,223562,223562,223565,0,3,3
63876,6,2,223568,223568,223570,0,2,3
63877,4,3,223572,223572,223575,0,3,2
63878,6,3,223578,223578,223581,0,3,3
63879,3,1,223581,223581,223582,0,1,0
63880,6,1,223587,223587,223588,0,1,5
63881,1,3,223588,223588,223591,0,3,0
63882,4,1,223592,223592,223593,0,1,1
63883,2,2,223594,223594,223596,0,2,1
63884,2,2,223596,223596,223598,0,2,0
63885,5,1,223601,223601,223602,0,1,3
63886,6,1,223607,223607,223608,0,1,5
63887,5,1,223612,223612,223613,0,1,4
63888,4,2,223616,223616,223618,0,2,3
63889,3,2,223619,223619,223621,0,2,1
63890,5,2,223624,223624,223626,0,2,3
63891,1,2,223625,223626,223628,1,3,0
63892,4,2,223629,223629,223631,0,2,1
63893,5,1,223634,223634,223635,0,1,3
63894,4,1,223638,223638,223639,0,1,3
63895,5,1,223643,223643,223644,0,1,4
63896,2,3,223645,223645,223648,0,3,1
63897,1,2,223646,223648,223650,2,4,0
63898,1,3,223647,223650,223653,3,6,0
63899,4,2,223651,223653,223655,2,4,0
63900,4,2,223655,223655,223657,0,2,0
63901,4,3,223659,223659,223662,0,3,2
63902,1,3,223660,223662,223665,2,5,0
63903,4,2,223664,223665,223667,1,3,0
63904,3,3,223667,223667,223670,0,3,0
63905,4,3,223671,223671,223674,0,3,1
63906,4,3,223675,223675,223678,0,3,1
63907,5,2,223680,223680,223682,0,2,2
63908,4,1,223684,223684,223685,0,1,2
63909,3,2,223687,223687,223689,0,2,2
63910,6,1,223693,223693,223694,0,1,4
63911,1,2,223694,223694,223696,0,2,0
63912,1,2,223695,223696,223698,1,3,0
63913,4,3,223699,223699,223702,0,3,1
63914,6,1,223705,223705,223706,0,1,3
63915,4,2,223709,223709,223711,0,2,3
63916,3,3,223712,223712,223715,0,3,1
63917,3,2,223715,223715,223717,0,2,0
63918,4,2,223719,223719,223721,0,2,2
63919,1,2,223720,223721,223723,1,3,0
63920,2,2,223722,223723,223725,1,3,0
63921,4,2,223726,223726,223728,0,2,1
63922,6,1,223732,223732,223733,0,1,4
63923,4,1,223736,223736,223737,0,1,3
63924,1,2,223737,223737,223739,0,2,0
63925,4,1,223741,223741,223742,0,1,2
63926,4,2,223745,223745,223747,0,2,3
63927,6,3,223751,223751,223754,0,3,4
63928,1,1,223752,223754,223755,2,3,0
63929,5,1,223757,223757,223758,0,1,2
63930,1,2,223758,223758,223760,0,2,0
63931,2,3,223760,223760,223763,0,3,0
63932,3,2,223763,223763,223765,0,2,0
63933,4,1,223767,223767,223768,0,1,2
63934,6,3,223773,223773,223776,0,3,5
63935,6,3,223779,223779,223782,0,3,3
63936,4,1,223783,223783,223784,0,1,1
63937,1,2,223784,223784,223786,0,2,0
63938,1,3,223785,223786,223789,1,4,0
63939,4,1,223789,223789,223790,0,1,0
63940,5,1,223794,223794,223795,0,1,4
63941,2,1,223796,223796,223797,0,1,1
63942,6,2,223802,223802,223804,0,2,5
63943,1,2,223803,223804,223806,1,3,0
63944,2,2,223805,223806,223808,1,3,0
63945,1,3,223806,223808,223811,2,5,0
63946,4,2,223810,223811,223813,1,3,0
63947,5,2,223815,223815,223817,0,2,2
63948,4,3,223819,223819,223822,0,3,2
63949,3,3,223822,223822,223825,0,3,0
63950,3,3,223825,223825,223828,0,3,0
63951,3,1,223828,223828,223829,0,1,0
63952,6,3,223834,223834,223837,0,3,5
63953,3,1,223837,223837,223838,0,1,0
63954,2,3,223839,223839,223842,0,3,1
63955,3,2,223842,223842,223844,0,2,0
63956,3,1,223845,223845,223846,0,1,1
63957,4,1,223849,223849,223850,0,1,3
63958,1,2,223850,223850,223852,0,2,0
63959,3,1,223853,223853,223854,0,1,1
63960,5,3,223858,223858,223861,0,3,4
63961,3,3,223861,223861,223864,0,3,0
63962,4,3,223865,223865,223868,0,3,1
63963,1,3,223866,223868,223871,2,5,0
63964,1,3,223867,223871,223874,4,7,0
63965,6,2,223873,223874,223876,1,3,0
63966,4,3,223877,223877,223880,0,3,1
63967,4,3,223881,223881,223884,0,3,1
63968,5,1,223886,223886,223887,0,1,2
63969,3,2,223889,223889,223891,0,2,2
63970,1,3,223890,223891,223894,1,4,0
63971,6,2,223896,223896,223898,0,2,2
63972,3,2,223899,223899,223901,0,2,1
63973,6,1,223905,223905,223906,0,1,4
63974,4,3,223909,223909,223912,0,3,3
63975,2,2,223911,223912,223914,1,3,0
63976,4,2,223915,223915,223917,0,2,1
63977,4,2,223919,223919,223921,0,2,2
63978,6,1,223925,223925,223926,0,1,4
63979,2,3,223927,223927,223930,0,3,1
63980,3,1,223930,223930,223931,0,1,0
63981,5,2,223935,223935,223937,0,2,4
63982,3,1,223938,223938,223939,0,1,1
63983,4,1,223942,223942,223943,0,1,3
63984,3,1,223945,223945,223946,0,1,2
63985,4,2,223949,223949,223951,0,2,3
63986,4,2,223953,223953,223955,0,2,2
63987,6,1,223959,223959,223960,0,1,4
63988,5,3,223964,223964,223967,0,3,4
63989,6,3,223970,223970,223973,0,3,3
63990,1,2,223971,223973,223975,2,4,0
63991,6,1,223977,223977,223978,0,1,2
63992,4,2,223981,223981,223983,0,2,3
63993,6,1,223987,223987,223988,0,1,4
63994,1,2,223988,223988,223990,0,2,0
63995,1,1,223989,223990,223991,1,2,0
63996,5,1,223994,223994,223995,0,1,3
63997,4,3,223998,223998,224001,0,3,3
63998,2,3,224000,224001,224004,1,4,0
63999,5,1,224005,224005,224006,0,1,1
64000,4,3,224009,224009,224012,0,3,3
64001,1,3,224010,224012,224015,2,5,0
64002,5,3,224015,224015,224018,0,3,0
64003,4,3,224019,224019,224022,0,3,1
64004,3,3,224022,224022,224025,0,3,0
64005,2,3,224024,224025,224028,1,4,0
64006,4,3,224028,224028,224031,0,3,0
64007,2,2,224030,224031,224033,1,3,0
64008,1,1,224031,224033,224034,2,3,0
64009,5,3,224036,224036,224039,0,3,2
64010,2,1,224038,224039,224040,1,2,0
64011,2,1,224040,224040,224041,0,1,0
64012,3,3,224043,224043,224046,0,3,2
64013,3,3,224046,224046,224049,0,3,0
64014,5,1,224051,224051,224052,0,1,2
64015,6,2,224057,224057,224059,0,2,5
64016,4,3,224061,224061,224064,0,3,2
64017,3,2,224064,224064,224066,0,2,0
64018,1,1,224065,224066,224067,1,2,0
64019,6,3,224071,224071,224074,0,3,4
64020,6,1,224077,224077,224078,0,1,3
64021,3,1,224080,224080,224081,0,1,2
64022,3,3,224083,224083,224086,0,3,2
64023,6,3,224089,224089,224092,0,3,3
64024,4,2,224093,224093,224095,0,2,1
64025,1,2,224094,224095,224097,1,3,0
64026,3,2,224097,224097,224099,0,2,0
64027,1,3,224098,224099,224102,1,4,0
64028,4,3,224102,224102,224105,0,3,0
64029,4,1,224106,224106,224107,0,1,1
64030,6,1,224112,224112,224113,0,1,5
64031,1,1,224113,224113,224114,0,1,0
64032,3,1,224116,224116,224117,0,1,2
64033,2,2,224118,224118,224120,0,2,1
64034,6,2,224124,224124,224126,0,2,4
64035,2,2,224126,224126,224128,0,2,0
64036,4,3,224130,224130,224133,0,3,2
64037,1,2,224131,224133,224135,2,4,0
64038,3,2,224134,224135,224137,1,3,0
64039,5,1,224139,224139,224140,0,1,2
64040,5,2,224144,224144,224146,0,2,4
64041,1,1,224145,224146,224147,1,2,0
64042,3,1,224148,224148,224149,0,1,1
64043,5,1,224153,224153,224154,0,1,4
64044,6,2,224159,224159,224161,0,2,5
64045,4,1,224163,224163,224164,0,1,2
64046,2,2,224165,224165,224167,0,2,1
64047,4,3,224169,224169,224172,0,3,2
64048,5,2,224174,224174,224176,0,2,2
64049,3,1,224177,224177,224178,0,1,1
64050,6,3,224183,224183,224186,0,3,5
64051,3,1,224186,224186,224187,0,1,0
64052,1,3,224187,224187,224190,0,3,0
64053,5,2,224192,224192,224194,0,2,2
64054,5,1,224197,224197,224198,0,1,3
64055,1,3,224198,224198,224201,0,3,0
64056,4,2,224202,224202,224204,0,2,1
64057,5,2,224207,224207,224209,0,2,3
64058,4,3,224211,224211,224214,0,3,2
64059,2,2,224213,224214,224216,1,3,0
64060,2,1,224215,224216,224217,1,2,0
64061,1,3,224216,224217,224220,1,4,0
64062,3,3,224219,224220,224223,1,4,0
64063,5,3,224224,224224,224227,0,3,1
64064,3,3,224227,224227,224230,0,3,0
64065,2,2,224229,224230,224232,1,3,0
64066,2,2,224231,224232,224234,1,3,0
64067,4,2,224235,224235,224237,0,2,1
64068,3,1,224238,224238,224239,0,1,1
64069,1,3,224239,224239,224242,0,3,0
64070,4,2,224243,224243,224245,0,2,1
64071,1,2,224244,224245,224247,1,3,0
64072,3,1,224247,224247,224248,0,1,0
64073,4,1,224251,224251,224252,0,1,3
64074,5,2,224256,224256,224258,0,2,4
64075,6,3,224262,224262,224265,0,3,4
64076,3,2,224265,224265,224267,0,2,0
64077,4,1,224269,224269,224270,0,1,2
64078,4,3,224273,224273,224276,0,3,3
64079,2,2,224275,224276,224278,1,3,0
64080,3,2,224278,224278,224280,0,2,0
64081,2,2,224280,224280,224282,0,2,0
64082,3,2,224283,224283,224285,0,2,1
64083,6,1,224289,224289,224290,0,1,4
64084,1,2,224290,224290,224292,0,2,0
64085,6,3,224296,224296,224299,0,3,4
64086,2,3,224298,224299,224302,1,4,0
64087,2,3,224300,224302,224305,2,5,0
64088,6,2,224306,224306,224308,0,2,1
64089,6,1,224312,224312,224313,0,1,4
64090,4,3,224316,224316,224319,0,3,3
64091,2,2,224318,224319,224321,1,3,0
64092,5,1,224323,224323,224324,0,1,2
64093,1,1,224324,224324,224325,0,1,0
64094,2,3,224326,224326,224329,0,3,1
64095,4,2,224330,224330,224332,0,2,1
64096,3,1,224333,224333,224334,0,1,1
64097,4,3,224337,224337,224340,0,3,3
64098,5,1,224342,224342,224343,0,1,2
64099,5,1,224347,224347,224348,0,1,4
64100,6,2,224353,224353,224355,0,2,5
64101,3,1,224356,224356,224357,0,1,1
64102,3,2,224359,224359,224361,0,2,2
64103,2,3,224361,224361,224364,0,3,0
64104,6,3,224367,224367,224370,0,3,3
64105,6,2,224373,224373,224375,0,2,3
64106,4,2,224377,224377,224379,0,2,2
64107,2,1,224379,224379,224380,0,1,0
64108,4,2,224383,224383,224385,0,2,3
64109,1,2,224384,224385,224387,1,3,0
64110,3,3,224387,224387,224390,0,3,0
64111,5,3,224392,224392,224395,0,3,2
64112,4,3,224396,224396,224399,0,3,1
64113,3,1,224399,224399,224400,0,1,0
64114,2,3,224401,224401,224404,0,3,1
64115,5,2,224406,224406,224408,0,2,2
64116,6,1,224412,224412,224413,0,1,4
64117,5,3,224417,224417,224420,0,3,4
64118,5,1,224422,224422,224423,0,1,2
64119,1,2,224423,224423,224425,0,2,0
64120,3,3,224426,224426,224429,0,3,1
64121,5,2,224431,224431,224433,0,2,2
64122,6,3,224437,224437,224440,0,3,4
64123,6,2,224443,224443,224445,0,2,3
64124,1,1,224444,224445,224446,1,2,0
64125,6,2,224450,224450,224452,0,2,4
64126,1,2,224451,224452,224454,1,3,0
64127,4,2,224455,224455,224457,0,2,1
64128,6,1,224461,224461,224462,0,1,4
64129,6,3,224467,224467,224470,0,3,5
64130,5,1,224472,224472,224473,0,1,2
64131,3,3,224475,224475,224478,0,3,2
64132,3,3,224478,224478,224481,0,3,0
64133,6,2,224484,224484,224486,0,2,3
64134,6,2,224490,224490,224492,0,2,4
64135,5,3,224495,224495,224498,0,3,3
64136,5,2,224500,224500,224502,0,2,2
64137,4,2,224504,224504,224506,0,2,2
64138,6,3,224510,224510,224513,0,3,4
64139,6,2,224516,224516,224518,0,2,3
64140,3,3,224519,224519,224522,0,3,1
64141,4,2,224523,224523,224525,0,2,1
64142,1,2,224524,224525,224527,1,3,0
64143,5,2,224529,224529,224531,0,2,2
64144,5,3,224534,224534,224537,0,3,3
64145,1,1,224535,224537,224538,2,3,0
64146,6,3,224541,224541,224544,0,3,3
64147,1,1,224542,224544,224545,2,3,0
64148,4,1,224546,224546,224547,0,1,1
64149,2,3,224548,224548,224551,0,3,1
64150,1,3,224549,224551,224554,2,5,0
64151,3,2,224552,224554,224556,2,4,0
64152,6,2,224558,224558,224560,0,2,2
64153,4,1,224562,224562,224563,0,1,2
64154,2,1,224564,224564,224565,0,1,1
64155,4,1,224568,224568,224569,0,1,3
64156,1,1,224569,224569,224570,0,1,0
64157,1,2,224570,224570,224572,0,2,0
64158,3,3,224573,224573,224576,0,3,1
64159,3,1,224576,224576,224577,0,1,0
64160,4,2,224580,224580,224582,0,2,3
64161,1,2,224581,224582,224584,1,3,0
64162,3,1,224584,224584,224585,0,1,0
64163,5,1,224589,224589,224590,0,1,4
64164,1,3,224590,224590,224593,0,3,0
64165,5,3,224595,224595,224598,0,3,2
64166,5,1,224600,224600,224601,0,1,2
64167,1,3,224601,224601,224604,0,3,0
64168,4,3,224605,224605,224608,0,3,1
64169,6,3,224611,224611,224614,0,3,3
64170,4,2,224615,224615,224617,0,2,1
64171,1,3,224616,224617,224620,1,4,0
64172,3,3,224619,224620,224623,1,4,0
64173,1,1,224620,224623,224624,3,4,0
64174,1,3,224621,224624,224627,3,6,0
64175,3,3,224624,224627,224630,3,6,0
64176,1,2,224625,224630,224632,5,7,0
64177,2,1,224627,224632,224633,5,6,0
64178,2,1,224629,224633,224634,4,5,0
64179,4,3,224633,224634,224637,1,4,0
64180,3,3,224636,224637,224640,1,4,0
64181,3,2,224639,224640,224642,1,3,0
64182,3,1,224642,224642,224643,0,1,0
64183,5,1,224647,224647,224648,0,1,4
64184,4,3,224651,224651,224654,0,3,3
64185,3,2,224654,224654,224656,0,2,0
64186,6,2,224660,224660,224662,0,2,4
64187,2,3,224662,224662,224665,0,3,0
64188,4,3,224666,224666,224669,0,3,1
64189,6,3,224672,224672,224675,0,3,3
64190,2,2,224674,224675,224677,1,3,0
64191,6,1,224680,224680,224681,0,1,3
64192,6,3,224686,224686,224689,0,3,5
64193,3,2,224689,224689,224691,0,2,0
64194,3,1,224692,224692,224693,0,1,1
64195,3,1,224695,224695,224696,0,1,2
64196,1,1,224696,224696,224697,0,1,0
64197,2,2,224698,224698,224700,0,2,1
64198,5,3,224703,224703,224706,0,3,3
64199,4,2,224707,224707,224709,0,2,1
64200,4,3,224711,224711,224714,0,3,2
64201,4,1,224715,224715,224716,0,1,1
64202,6,3,224721,224721,224724,0,3,5
64203,5,1,224726,224726,224727,0,1,2
64204,6,2,224732,224732,224734,0,2,5
64205,3,3,224735,224735,224738,0,3,1
64206,5,1,224740,224740,224741,0,1,2
64207,5,1,224745,224745,224746,0,1,4
64208,4,1,224749,224749,224750,0,1,3
64209,3,1,224752,224752,224753,0,1,2
64210,4,2,224756,224756,224758,0,2,3
64211,4,3,224760,224760,224763,0,3,2
64212,3,1,224763,224763,224764,0,1,0
64213,3,1,224766,224766,224767,0,1,2
64214,6,2,224772,224772,224774,0,2,5
64215,4,1,224776,224776,224777,0,1,2
64216,5,1,224781,224781,224782,0,1,4
64217,2,1,224783,224783,224784,0,1,1
64218,6,3,224789,224789,224792,0,3,5
64219,1,2,224790,224792,224794,2,4,0
64220,6,1,224796,224796,224797,0,1,2
64221,1,1,224797,224797,224798,0,1,0
64222,5,3,224802,224802,224805,0,3,4
64223,3,2,224805,224805,224807,0,2,0
64224,4,1,224809,224809,224810,0,1,2
64225,4,1,224813,224813,224814,0,1,3
64226,2,3,224815,224815,224818,0,3,1
64227,2,2,224817,224818,224820,1,3,0
64228,6,3,224823,224823,224826,0,3,3
64229,4,2,224827,224827,224829,0,2,1
64230,1,2,224828,224829,224831,1,3,0
64231,5,3,224833,224833,224836,0,3,2
64232,6,1,224839,224839,224840,0,1,3
64233,3,1,224842,224842,224843,0,1,2
64234,2,2,224844,224844,224846,0,2,1
64235,5,3,224849,224849,224852,0,3,3
64236,5,1,224854,224854,224855,0,1,2
64237,6,3,224860,224860,224863,0,3,5
64238,1,1,224861,224863,224864,2,3,0
64239,1,3,224862,224864,224867,2,5,0
64240,3,1,224865,224867,224868,2,3,0
64241,4,2,224869,224869,224871,0,2,1
64242,1,1,224870,224871,224872,1,2,0
64243,5,3,224875,224875,224878,0,3,3
64244,6,2,224881,224881,224883,0,2,3
64245,5,2,224886,224886,224888,0,2,3
64246,6,1,224892,224892,224893,0,1,4
64247,2,1,224894,224894,224895,0,1,1
64248,6,2,224900,224900,224902,0,2,5
64249,6,2,224906,224906,224908,0,2,4
64250,1,1,224907,224908,224909,1,2,0
64251,2,2,224909,224909,224911,0,2,0
64252,1,3,224910,224911,224914,1,4,0
64253,3,2,224913,224914,224916,1,3,0
64254,1,3,224914,224916,224919,2,5,0
64255,5,3,224919,224919,224922,0,3,0
64256,6,1,224925,224925,224926,0,1,3
64257,6,2,224931,224931,224933,0,2,5
64258,3,2,224934,224934,224936,0,2,1
64259,1,1,224935,224936,224937,1,2,0
64260,6,2,224941,224941,224943,0,2,4
64261,4,3,224945,224945,224948,0,3,2
64262,2,2,224947,224948,224950,1,3,0
64263,2,1,224949,224950,224951,1,2,0
64264,2,3,224951,224951,224954,0,3,0
64265,3,2,224954,224954,224956,0,2,0
64266,3,3,224957,224957,224960,0,3,1
64267,3,2,224960,224960,224962,0,2,0
64268,3,2,224963,224963,224965,0,2,1
64269,1,3,224964,224965,224968,1,4,0
64270,4,1,224968,224968,224969,0,1,0
64271,5,3,224973,224973,224976,0,3,4
64272,6,3,224979,224979,224982,0,3,3
64273,1,1,224980,224982,224983,2,3,0
64274,3,2,224983,224983,224985,0,2,0
64275,1,2,224984,224985,224987,1,3,0
64276,6,1,224990,224990,224991,0,1,3
64277,1,2,224991,224991,224993,0,2,0
64278,2,3,224993,224993,224996,0,3,0
64279,1,2,224994,224996,224998,2,4,0
64280,2,2,224996,224998,225000,2,4,0
64281,2,1,224998,225000,225001,2,3,0
64282,5,2,225003,225003,225005,0,2,2
64283,3,1,225006,225006,225007,0,1,1
64284,4,1,225010,225010,225011,0,1,3
64285,1,3,225011,225011,225014,0,3,0
64286,5,3,225016,225016,225019,0,3,2
64287,2,3,225018,225019,225022,1,4,0
64288,4,3,225022,225022,225025,0,3,0
64289,6,1,225028,225028,225029,0,1,3
64290,4,3,225032,225032,225035,0,3,3
64291,4,1,225036,225036,225037,0,1,1
64292,1,1,225037,225037,225038,0,1,0
64293,5,2,225042,225042,225044,0,2,4
64294,4,1,225046,225046,225047,0,1,2
64295,1,3,225047,225047,225050,0,3,0
64296,4,1,225051,225051,225052,0,1,1
64297,4,3,225055,225055,225058,0,3,3
64298,3,3,225058,225058,225061,0,3,0
64299,6,1,225064,225064,225065,0,1,3
64300,6,3,225070,225070,225073,0,3,5
64301,6,1,225076,225076,225077,0,1,3
64302,3,3,225079,225079,225082,0,3,2
64303,2,1,225081,225082,225083,1,2,0
64304,2,3,225083,225083,225086,0,3,0
64305,4,2,225087,225087,225089,0,2,1
64306,2,3,225089,225089,225092,0,3,0
64307,3,1,225092,225092,225093,0,1,0
64308,4,1,225096,225096,225097,0,1,3
64309,6,3,225102,225102,225105,0,3,5
64310,4,1,225106,225106,225107,0,1,1
64311,1,2,225107,225107,225109,0,2,0
64312,6,3,225113,225113,225116,0,3,4
64313,3,3,225116,225116,225119,0,3,0
64314,5,2,225121,225121,225123,0,2,2
64315,1,1,225122,225123,225124,1,2,0
64316,1,3,225123,225124,225127,1,4,0
64317,2,3,225125,225127,225130,2,5,0
64318,1,3,225126,225130,225133,4,7,0
64319,5,3,225131,225133,225136,2,5,0
64320,3,3,225134,225136,225139,2,5,0
64321,1,3,225135,225139,225142,4,7,0
64322,5,1,225140,225142,225143,2,3,0
64323,4,3,225144,225144,225147,0,3,1
64324,2,2,225146,225147,225149,1,3,0
64325,1,1,225147,225149,225150,2,3,0
64326,4,3,225151,225151,225154,0,3,1
64327,3,1,225154,225154,225155,0,1,0
64328,1,2,225155,225155,225157,0,2,0
64329,5,1,225160,225160,225161,0,1,3
64330,3,2,225163,225163,225165,0,2,2
64331,2,3,225165,225165,225168,0,3,0
64332,2,2,225167,225168,225170,1,3,0
64333,6,3,225173,225173,225176,0,3,3
64334,6,3,225179,225179,225182,0,3,3
64335,6,2,225185,225185,225187,0,2,3
64336,1,2,225186,225187,225189,1,3,0
64337,4,2,225190,225190,225192,0,2,1
64338,4,3,225194,225194,225197,0,3,2
64339,1,3,225195,225197,225200,2,5,0
64340,5,3,225200,225200,225203,0,3,0
64341,2,1,225202,225203,225204,1,2,0
64342,6,2,225208,225208,225210,0,2,4
64343,3,3,225211,225211,225214,0,3,1
64344,4,2,225215,225215,225217,0,2,1
64345,2,2,225217,225217,225219,0,2,0
64346,3,2,225220,225220,225222,0,2,1
64347,5,3,225225,225225,225228,0,3,3
64348,4,2,225229,225229,225231,0,2,1
64349,3,3,225232,225232,225235,0,3,1
64350,2,2,225234,225235,225237,1,3,0
64351,6,1,225240,225240,225241,0,1,3
64352,3,1,225243,225243,225244,0,1,2
64353,6,1,225249,225249,225250,0,1,5
64354,6,3,225255,225255,225258,0,3,5
64355,5,1,225260,225260,225261,0,1,2
64356,1,3,225261,225261,225264,0,3,0
64357,6,2,225267,225267,225269,0,2,3
64358,1,1,225268,225269,225270,1,2,0
64359,5,3,225273,225273,225276,0,3,3
64360,2,2,225275,225276,225278,1,3,0
64361,1,3,225276,225278,225281,2,5,0
64362,5,1,225281,225281,225282,0,1,0
64363,4,1,225285,225285,225286,0,1,3
64364,1,3,225286,225286,225289,0,3,0
64365,4,2,225290,225290,225292,0,2,1
64366,2,3,225292,225292,225295,0,3,0
64367,4,2,225296,225296,225298,0,2,1
64368,4,3,225300,225300,225303,0,3,2
64369,2,3,225302,225303,225306,1,4,0
64370,4,1,225306,225306,225307,0,1,0
64371,2,1,225308,225308,225309,0,1,1
64372,2,1,225310,225310,225311,0,1,1
64373,5,1,225315,225315,225316,0,1,4
64374,3,3,225318,225318,225321,0,3,2
64375,2,1,225320,225321,225322,1,2,0
64376,1,2,225321,225322,225324,1,3,0
64377,2,1,225323,225324,225325,1,2,0
64378,3,3,225326,225326,225329,0,3,1
64379,6,2,225332,225332,225334,0,2,3
64380,5,3,225337,225337,225340,0,3,3
64381,3,2,225340,225340,225342,0,2,0
64382,3,1,225343,225343,225344,0,1,1
64383,5,3,225348,225348,225351,0,3,4
64384,3,3,225351,225351,225354,0,3,0
64385,5,2,225356,225356,225358,0,2,2
64386,5,1,225361,225361,225362,0,1,3
64387,4,1,225365,225365,225366,0,1,3
64388,4,2,225369,225369,225371,0,2,3
64389,2,3,225371,225371,225374,0,3,0
64390,2,1,225373,225374,225375,1,2,0
64391,2,2,225375,225375,225377,0,2,0
64392,2,2,225377,225377,225379,0,2,0
64393,5,1,225382,225382,225383,0,1,3
64394,1,2,225383,225383,225385,0,2,0
64395,2,2,225385,225385,225387,0,2,0
64396,6,3,225391,225391,225394,0,3,4
64397,6,3,225397,225397,225400,0,3,3
64398,4,3,225401,225401,225404,0,3,1
64399,4,1,225405,225405,225406,0,1,1
64400,3,1,225408,225408,225409,0,1,2
64401,2,2,225410,225410,225412,0,2,1
64402,6,1,225416,225416,225417,0,1,4
64403,6,3,225422,225422,225425,0,3,5
64404,6,1,225428,225428,225429,0,1,3
64405,6,2,225434,225434,225436,0,2,5
64406,5,3,225439,225439,225442,0,3,3
64407,6,1,225445,225445,225446,0,1,3
64408,1,1,225446,225446,225447,0,1,0
64409,2,2,225448,225448,225450,0,2,1
64410,3,1,225451,225451,225452,0,1,1
64411,3,1,225454,225454,225455,0,1,2
64412,5,2,225459,225459,225461,0,2,4
64413,2,1,225461,225461,225462,0,1,0
64414,5,3,225466,225466,225469,0,3,4
64415,2,3,225468,225469,225472,1,4,0
64416,1,3,225469,225472,225475,3,6,0
64417,3,3,225472,225475,225478,3,6,0
64418,2,1,225474,225478,225479,4,5,0
64419,2,3,225476,225479,225482,3,6,0
64420,2,3,225478,225482,225485,4,7,0
64421,1,3,225479,225485,225488,6,9,0
64422,1,3,225480,225488,225491,8,11,0
64423,5,3,225485,225491,225494,6,9,0
64424,4,2,225489,225494,225496,5,7,0
64425,3,2,225492,225496,225498,4,6,0
64426,5,1,225497,225498,225499,1,2,0
64427,6,1,225503,225503,225504,0,1,4
64428,4,2,225507,225507,225509,0,2,3
64429,1,3,225508,225509,225512,1,4,0
64430,4,1,225512,225512,225513,0,1,0
64431,5,1,225517,225517,225518,0,1,4
64432,6,3,225523,225523,225526,0,3,5
64433,2,2,225525,225526,225528,1,3,0
64434,5,1,225530,225530,225531,0,1,2
64435,4,3,225534,225534,225537,0,3,3
64436,4,2,225538,225538,225540,0,2,1
64437,5,1,225543,225543,225544,0,1,3
64438,4,1,225547,225547,225548,0,1,3
64439,3,3,225550,225550,225553,0,3,2
64440,6,1,225556,225556,225557,0,1,3
64441,6,1,225562,225562,225563,0,1,5
64442,6,2,225568,225568,225570,0,2,5
64443,1,1,225569,225570,225571,1,2,0
64444,3,3,225572,225572,225575,0,3,1
64445,2,3,225574,225575,225578,1,4,0
64446,2,3,225576,225578,225581,2,5,0
64447,4,3,225580,225581,225584,1,4,0
64448,1,2,225581,225584,225586,3,5,0
64449,5,3,225586,225586,225589,0,3,0
64450,2,2,225588,225589,225591,1,3,0
64451,5,3,225593,225593,225596,0,3,2
64452,6,3,225599,225599,225602,0,3,3
64453,4,2,225603,225603,225605,0,2,1
64454,6,1,225609,225609,225610,0,1,4
64455,4,3,225613,225613,225616,0,3,3
64456,2,3,225615,225616,225619,1,4,0
64457,2,1,225617,225619,225620,2,3,0
64458,4,2,225621,225621,225623,0,2,1
64459,5,3,225626,225626,225629,0,3,3
64460,5,3,225631,225631,225634,0,3,2
64461,5,3,225636,225636,225639,0,3,2
64462,5,2,225641,225641,225643,0,2,2
64463,4,3,225645,225645,225648,0,3,2
64464,6,2,225651,225651,225653,0,2,3
64465,2,1,225653,225653,225654,0,1,0
64466,5,3,225658,225658,225661,0,3,4
64467,4,1,225662,225662,225663,0,1,1
64468,6,2,225668,225668,225670,0,2,5
64469,1,3,225669,225670,225673,1,4,0
64470,3,1,225672,225673,225674,1,2,0
64471,2,1,225674,225674,225675,0,1,0
64472,5,2,225679,225679,225681,0,2,4
64473,2,2,225681,225681,225683,0,2,0
64474,4,1,225685,225685,225686,0,1,2
64475,2,1,225687,225687,225688,0,1,1
64476,1,1,225688,225688,225689,0,1,0
64477,3,1,225691,225691,225692,0,1,2
64478,6,1,225697,225697,225698,0,1,5
64479,4,2,225701,225701,225703,0,2,3
64480,4,1,225705,225705,225706,0,1,2
64481,4,1,225709,225709,225710,0,1,3
64482,2,3,225711,225711,225714,0,3,1
64483,2,3,225713,225714,225717,1,4,0
64484,6,3,225719,225719,225722,0,3,2
64485,1,2,225720,225722,225724,2,4,0
64486,2,3,225722,225724,225727,2,5,0
64487,2,3,225724,225727,225730,3,6,0
64488,4,1,225728,225730,225731,2,3,0
64489,3,1,225731,225731,225732,0,1,0
64490,5,2,225736,225736,225738,0,2,4
64491,2,2,225738,225738,225740,0,2,0
64492,6,1,225744,225744,225745,0,1,4
64493,2,1,225746,225746,225747,0,1,1
64494,6,1,225752,225752,225753,0,1,5
64495,1,3,225753,225753,225756,0,3,0
64496,2,1,225755,225756,225757,1,2,0
64497,4,2,225759,225759,225761,0,2,2
64498,5,1,225764,225764,225765,0,1,3
64499,2,3,225766,225766,225769,0,3,1
64500,4,2,225770,225770,225772,0,2,1
64501,1,3,225771,225772,225775,1,4,0
64502,2,1,225773,225775,225776,2,3,0
64503,3,2,225776,225776,225778,0,2,0
64504,3,1,225779,225779,225780,0,1,1
64505,2,1,225781,225781,225782,0,1,1
64506,5,3,225786,225786,225789,0,3,4
64507,2,1,225788,225789,225790,1,2,0
64508,4,2,225792,225792,225794,0,2,2
64509,3,2,225795,225795,225797,0,2,1
64510,1,3,225796,225797,225800,1,4,0
64511,1,1,225797,225800,225801,3,4,0
64512,5,3,225802,225802,225805,0,3,1
64513,3,2,225805,225805,225807,0,2,0
64514,6,2,225811,225811,225813,0,2,4
64515,6,2,225817,225817,225819,0,2,4
64516,1,2,225818,225819,225821,1,3,0
64517,6,2,225824,225824,225826,0,2,3
64518,1,3,225825,225826,225829,1,4,0
64519,1,2,225826,225829,225831,3,5,0
64520,6,2,225832,225832,225834,0,2,1
64521,5,3,225837,225837,225840,0,3,3
64522,4,2,225841,225841,225843,0,2,1
64523,6,3,225847,225847,225850,0,3,4
64524,5,1,225852,225852,225853,0,1,2
64525,3,3,225855,225855,225858,0,3,2
64526,4,2,225859,225859,225861,0,2,1
64527,6,1,225865,225865,225866,0,1,4
64528,4,2,225869,225869,225871,0,2,3
64529,6,1,225875,225875,225876,0,1,4
64530,4,2,225879,225879,225881,0,2,3
64531,5,1,225884,225884,225885,0,1,3
64532,4,2,225888,225888,225890,0,2,3
64533,1,3,225889,225890,225893,1,4,0
64534,5,1,225894,225894,225895,0,1,1
64535,5,2,225899,225899,225901,0,2,4
64536,5,2,225904,225904,225906,0,2,3
64537,6,2,225910,225910,225912,0,2,4
64538,6,2,225916,225916,225918,0,2,4
64539,4,1,225920,225920,225921,0,1,2
64540,2,2,225922,225922,225924,0,2,1
64541,3,1,225925,225925,225926,0,1,1
64542,3,1,225928,225928,225929,0,1,2
64543,2,1,225930,225930,225931,0,1,1
64544,4,1,225934,225934,225935,0,1,3
64545,2,1,225936,225936,225937,0,1,1
64546,5,3,225941,225941,225944,0,3,4
64547,6,1,225947,225947,225948,0,1,3
64548,5,3,225952,225952,225955,0,3,4
64549,3,1,225955,225955,225956,0,1,0
64550,5,3,225960,225960,225963,0,3,4
64551,1,1,225961,225963,225964,2,3,0
64552,5,1,225966,225966,225967,0,1,2
64553,3,1,225969,225969,225970,0,1,2
64554,4,2,225973,225973,225975,0,2,3
64555,4,1,225977,225977,225978,0,1,2
64556,6,2,225983,225983,225985,0,2,5
64557,3,1,225986,225986,225987,0,1,1
64558,2,2,225988,225988,225990,0,2,1
64559,1,2,225989,225990,225992,1,3,0
64560,4,3,225993,225993,225996,0,3,1
64561,2,3,225995,225996,225999,1,4,0
64562,6,2,226001,226001,226003,0,2,2
64563,6,2,226007,226007,226009,0,2,4
64564,6,2,226013,226013,226015,0,2,4
64565,3,2,226016,226016,226018,0,2,1
64566,5,3,226021,226021,226024,0,3,3
64567,5,1,226026,226026,226027,0,1,2
64568,5,2,226031,226031,226033,0,2,4
64569,2,1,226033,226033,226034,0,1,0
64570,2,2,226035,226035,226037,0,2,1
64571,5,1,226040,226040,226041,0,1,3
64572,4,1,226044,226044,226045,0,1,3
64573,5,3,226049,226049,226052,0,3,4
64574,6,3,226055,226055,226058,0,3,3
64575,6,2,226061,226061,226063,0,2,3
64576,4,1,226065,226065,226066,0,1,2
64577,6,2,226071,226071,226073,0,2,5
64578,2,3,226073,226073,226076,0,3,0
64579,4,3,226077,226077,226080,0,3,1
64580,5,1,226082,226082,226083,0,1,2
64581,6,3,226088,226088,226091,0,3,5
64582,5,1,226093,226093,226094,0,1,2
64583,2,1,226095,226095,226096,0,1,1
64584,6,1,226101,226101,226102,0,1,5
64585,3,1,226104,226104,226105,0,1,2
64586,4,2,226108,226108,226110,0,2,3
64587,5,1,226113,226113,226114,0,1,3
64588,2,2,226115,226115,226117,0,2,1
64589,3,2,226118,226118,226120,0,2,1
64590,1,2,226119,226120,226122,1,3,0
64591,3,2,226122,226122,226124,0,2,0
64592,3,1,226125,226125,226126,0,1,1
64593,3,1,226128,226128,226129,0,1,2
64594,1,3,226129,226129,226132,0,3,0
64595,5,2,226134,226134,226136,0,2,2
64596,4,1,226138,226138,226139,0,1,2
64597,3,3,226141,226141,226144,0,3,2
64598,2,2,226143,226144,226146,1,3,0
64599,6,3,226149,226149,226152,0,3,3
64600,4,1,226153,226153,226154,0,1,1
64601,1,3,226154,226154,226157,0,3,0
64602,6,1,226160,226160,226161,0,1,3
64603,2,3,226162,226162,226165,0,3,1
64604,1,2,226163,226165,226167,2,4,0
64605,3,3,226166,226167,226170,1,4,0
64606,5,1,226171,226171,226172,0,1,1
64607,2,2,226173,226173,226175,0,2,1
64608,2,2,226175,226175,226177,0,2,0
64609,5,1,226180,226180,226181,0,1,3
64610,4,2,226184,226184,226186,0,2,3
64611,2,1,226186,226186,226187,0,1,0
64612,4,2,226190,226190,226192,0,2,3
64613,6,3,226196,226196,226199,0,3,4
64614,6,3,226202,226202,226205,0,3,3
64615,1,3,226203,226205,226208,2,5,0
64616,1,3,226204,226208,226211,4,7,0
64617,4,2,226208,226211,226213,3,5,0
64618,1,3,226209,226213,226216,4,7,0
64619,5,1,226214,226216,226217,2,3,0
64620,1,3,226215,226217,226220,2,5,0
64621,6,2,226221,226221,226223,0,2,1
64622,1,3,226222,226223,226226,1,4,0
64623,2,2,226224,226226,226228,2,4,0
64624,1,3,226225,226228,226231,3,6,0
64625,4,2,226229,226231,226233,2,4,0
64626,2,2,226231,226233,226235,2,4,0
64627,4,2,226235,226235,226237,0,2,0
64628,5,3,226240,226240,226243,0,3,3
64629,6,3,226246,226246,226249,0,3,3
64630,4,2,226250,226250,226252,0,2,1
64631,6,2,226256,226256,226258,0,2,4
64632,5,3,226261,226261,226264,0,3,3
64633,5,1,226266,226266,226267,0,1,2
64634,3,1,226269,226269,226270,0,1,2
64635,1,1,226270,226270,226271,0,1,0
64636,3,3,226273,226273,226276,0,3,2
64637,3,1,226276,226276,226277,0,1,0
64638,1,3,226277,226277,226280,0,3,0
64639,5,1,226282,226282,226283,0,1,2
64640,2,3,226284,226284,226287,0,3,1
64641,4,2,226288,226288,226290,0,2,1
64642,3,3,226291,226291,226294,0,3,1
64643,3,1,226294,226294,226295,0,1,0
64644,3,3,226297,226297,226300,0,3,2
64645,3,2,226300,226300,226302,0,2,0
64646,4,3,226304,226304,226307,0,3,2
64647,6,3,226310,226310,226313,0,3,3
64648,4,3,226314,226314,226317,0,3,1
64649,3,1,226317,226317,226318,0,1,0
64650,5,3,226322,226322,226325,0,3,4
64651,6,1,226328,226328,226329,0,1,3
64652,3,2,226331,226331,226333,0,2,2
64653,5,1,226336,226336,226337,0,1,3
64654,2,1,226338,226338,226339,0,1,1
64655,2,1,226340,226340,226341,0,1,1
64656,5,1,226345,226345,226346,0,1,4
64657,1,3,226346,226346,226349,0,3,0
64658,4,3,226350,226350,226353,0,3,1
64659,3,1,226353,226353,226354,0,1,0
64660,3,2,226356,226356,226358,0,2,2
64661,2,2,226358,226358,226360,0,2,0
64662,2,2,226360,226360,226362,0,2,0
64663,3,2,226363,226363,226365,0,2,1
64664,3,3,226366,226366,226369,0,3,1
64665,5,1,226371,226371,226372,0,1,2
64666,3,1,226374,226374,226375,0,1,2
64667,3,2,226377,226377,226379,0,2,2
64668,4,3,226381,226381,226384,0,3,2
64669,6,2,226387,226387,226389,0,2,3
64670,4,2,226391,226391,226393,0,2,2
64671,2,3,226393,226393,226396,0,3,0
64672,2,1,226395,226396,226397,1,2,0
64673,4,1,226399,226399,226400,0,1,2
64674,4,2,226403,226403,226405,0,2,3
64675,5,3,226408,226408,226411,0,3,3
64676,4,3,226412,226412,226415,0,3,1
64677,4,3,226416,226416,226419,0,3,1
64678,5,1,226421,226421,226422,0,1,2
64679,1,3,226422,226422,226425,0,3,0
64680,4,2,226426,226426,226428,0,2,1
64681,5,3,226431,226431,226434,0,3,3
64682,4,2,226435,226435,226437,0,2,1
64683,6,2,226441,226441,226443,0,2,4
64684,4,3,226445,226445,226448,0,3,2
64685,4,3,226449,226449,226452,0,3,1
64686,3,1,226452,226452,226453,0,1,0
64687,2,2,226454,226454,226456,0,2,1
64688,5,1,226459,226459,226460,0,1,3
64689,6,2,226465,226465,226467,0,2,5
64690,4,2,226469,226469,226471,0,2,2
64691,4,2,226473,226473,226475,0,2,2
64692,6,1,226479,226479,226480,0,1,4
64693,3,3,226482,226482,226485,0,3,2
64694,3,3,226485,226485,226488,0,3,0
64695,5,1,226490,226490,226491,0,1,2
64696,6,2,226496,226496,226498,0,2,5
64697,4,3,226500,226500,226503,0,3,2
64698,2,3,226502,226503,226506,1,4,0
64699,3,1,226505,226506,226507,1,2,0
64700,6,2,226511,226511,226513,0,2,4
64701,5,2,226516,226516,226518,0,2,3
64702,1,2,226517,226518,226520,1,3,0
64703,5,3,226522,226522,226525,0,3,2
64704,6,1,226528,226528,226529,0,1,3
64705,2,3,226530,226530,226533,0,3,1
64706,2,1,226532,226533,226534,1,2,0
64707,4,2,226536,226536,226538,0,2,2
64708,3,2,226539,226539,226541,0,2,1
64709,3,3,226542,226542,226545,0,3,1
64710,6,3,226548,226548,226551,0,3,3
64711,2,3,226550,226551,226554,1,4,0
64712,4,3,226554,226554,226557,0,3,0
64713,6,3,226560,226560,226563,0,3,3
64714,5,1,226565,226565,226566,0,1,2
64715,1,3,226566,226566,226569,0,3,0
64716,3,1,226569,226569,226570,0,1,0
64717,6,1,226575,226575,226576,0,1,5
64718,4,1,226579,226579,226580,0,1,3
64719,1,1,226580,226580,226581,0,1,0
64720,1,2,226581,226581,226583,0,2,0
64721,3,3,226584,226584,226587,0,3,1
64722,5,1,226589,226589,226590,0,1,2
64723,6,2,226595,226595,226597,0,2,5
64724,6,1,226601,226601,226602,0,1,4
64725,2,1,226603,226603,226604,0,1,1
64726,3,1,226606,226606,226607,0,1,2
64727,5,1,226611,226611,226612,0,1,4
64728,6,2,226617,226617,226619,0,2,5
64729,5,3,226622,226622,226625,0,3,3
64730,5,2,226627,226627,226629,0,2,2
64731,1,2,226628,226629,226631,1,3,0
64732,3,3,226631,226631,226634,0,3,0
64733,3,3,226634,226634,226637,0,3,0
64734,3,1,226637,226637,226638,0,1,0
64735,1,2,226638,226638,226640,0,2,0
64736,6,1,226644,226644,226645,0,1,4
64737,3,3,226647,226647,226650,0,3,2
64738,3,3,226650,226650,226653,0,3,0
64739,6,1,226656,226656,226657,0,1,3
64740,6,2,226662,226662,226664,0,2,5
64741,4,3,226666,226666,226669,0,3,2
64742,6,1,226672,226672,226673,0,1,3
64743,2,1,226674,226674,226675,0,1,1
64744,4,1,226678,226678,226679,0,1,3
64745,6,3,226684,226684,226687,0,3,5
64746,4,3,226688,226688,226691,0,3,1
64747,1,3,226689,226691,226694,2,5,0
64748,2,2,226691,226694,226696,3,5,0
64749,3,2,226694,226696,226698,2,4,0
64750,3,1,226697,226698,226699,1,2,0
64751,4,1,226701,226701,226702,0,1,2
64752,2,2,226703,226703,226705,0,2,1
64753,3,3,226706,226706,226709,0,3,1
64754,2,3,226708,226709,226712,1,4,0
64755,6,3,226714,226714,226717,0,3,2
64756,4,3,226718,226718,226721,0,3,1
64757,5,2,226723,226723,226725,0,2,2
64758,2,3,226725,226725,226728,0,3,0
64759,5,1,226730,226730,226731,0,1,2
64760,4,1,226734,226734,226735,0,1,3
64761,1,1,226735,226735,226736,0,1,0
64762,3,1,226738,226738,226739,0,1,2
64763,3,3,226741,226741,226744,0,3,2
64764,5,1,226746,226746,226747,0,1,2
64765,1,2,226747,226747,226749,0,2,0
64766,3,3,226750,226750,226753,0,3,1
64767,4,1,226754,226754,226755,0,1,1
64768,6,1,226760,226760,226761,0,1,5
64769,5,1,226765,226765,226766,0,1,4
64770,2,2,226767,226767,226769,0,2,1
64771,1,2,226768,226769,226771,1,3,0
64772,6,1,226774,226774,226775,0,1,3
64773,2,2,226776,226776,226778,0,2,1
64774,1,1,226777,226778,226779,1,2,0
64775,1,1,226778,226779,226780,1,2,0
64776,5,1,226783,226783,226784,0,1,3
64777,5,2,226788,226788,226790,0,2,4
64778,3,2,226791,226791,226793,0,2,1
64779,1,2,226792,226793,226795,1,3,0
64780,4,3,226796,226796,226799,0,3,1
64781,6,2,226802,226802,226804,0,2,3
64782,3,2,226805,226805,226807,0,2,1
64783,3,3,226808,226808,226811,0,3,1
64784,4,3,226812,226812,226815,0,3,1
64785,4,2,226816,226816,226818,0,2,1
64786,2,2,226818,226818,226820,0,2,0
64787,5,2,226823,226823,226825,0,2,3
64788,6,1,226829,226829,226830,0,1,4
64789,5,2,226834,226834,226836,0,2,4
64790,1,1,226835,226836,226837,1,2,0
64791,6,2,226841,226841,226843,0,2,4
64792,2,1,226843,226843,226844,0,1,0
64793,5,1,226848,226848,226849,0,1,4
64794,6,3,226854,226854,226857,0,3,5
64795,5,3,226859,226859,226862,0,3,2
64796,5,2,226864,226864,226866,0,2,2
64797,3,1,226867,226867,226868,0,1,1
64798,2,1,226869,226869,226870,0,1,1
64799,4,3,226873,226873,226876,0,3,3
64800,5,2,226878,226878,226880,0,2,2
64801,6,1,226884,226884,226885,0,1,4
64802,5,1,226889,226889,226890,0,1,4
64803,4,1,226893,226893,226894,0,1,3
64804,5,3,226898,226898,226901,0,3,4
64805,4,2,226902,226902,226904,0,2,1
64806,2,2,226904,226904,226906,0,2,0
64807,6,1,226910,226910,226911,0,1,4
64808,3,3,226913,226913,226916,0,3,2
64809,6,3,226919,226919,226922,0,3,3
64810,2,2,226921,226922,226924,1,3,0
64811,3,1,226924,226924,226925,0,1,0
64812,4,1,226928,226928,226929,0,1,3
64813,5,3,226933,226933,226936,0,3,4
64814,5,2,226938,226938,226940,0,2,2
64815,4,3,226942,226942,226945,0,3,2
64816,6,2,226948,226948,226950,0,2,3
64817,1,2,226949,226950,226952,1,3,0
64818,2,1,226951,226952,226953,1,2,0
64819,2,1,226953,226953,226954,0,1,0
64820,2,2,226955,226955,226957,0,2,1
64821,3,2,226958,226958,226960,0,2,1
64822,4,1,226962,226962,226963,0,1,2
64823,5,3,226967,226967,226970,0,3,4
64824,2,2,226969,226970,226972,1,3,0
64825,3,2,226972,226972,226974,0,2,0
64826,1,3,226973,226974,226977,1,4,0
64827,2,1,226975,226977,226978,2,3,0
64828,4,3,226979,226979,226982,0,3,1
64829,4,2,226983,226983,226985,0,2,1
64830,2,2,226985,226985,226987,0,2,0
64831,2,3,226987,226987,226990,0,3,0
64832,1,3,226988,226990,226993,2,5,0
64833,1,2,226989,226993,226995,4,6,0
64834,6,2,226995,226995,226997,0,2,0
64835,1,1,226996,226997,226998,1,2,0
64836,2,3,226998,226998,227001,0,3,0
64837,2,1,227000,227001,227002,1,2,0
64838,2,3,227002,227002,227005,0,3,0
64839,5,2,227007,227007,227009,0,2,2
64840,5,1,227012,227012,227013,0,1,3
64841,5,1,227017,227017,227018,0,1,4
64842,1,3,227018,227018,227021,0,3,0
64843,4,3,227022,227022,227025,0,3,1
64844,3,2,227025,227025,227027,0,2,0
64845,1,3,227026,227027,227030,1,4,0
64846,6,3,227032,227032,227035,0,3,2
64847,2,3,227034,227035,227038,1,4,0
64848,1,2,227035,227038,227040,3,5,0
64849,6,1,227041,227041,227042,0,1,1
64850,6,1,227047,227047,227048,0,1,5
64851,5,1,227052,227052,227053,0,1,4
64852,6,3,227058,227058,227061,0,3,5
64853,2,2,227060,227061,227063,1,3,0
64854,6,2,227066,227066,227068,0,2,3
64855,6,2,227072,227072,227074,0,2,4
64856,1,2,227073,227074,227076,1,3,0
64857,5,3,227078,227078,227081,0,3,2
64858,1,3,227079,227081,227084,2,5,0
64859,5,3,227084,227084,227087,0,3,0
64860,6,3,227090,227090,227093,0,3,3
64861,5,2,227095,227095,227097,0,2,2
64862,4,1,227099,227099,227100,0,1,2
64863,2,1,227101,227101,227102,0,1,1
64864,4,1,227105,227105,227106,0,1,3
64865,2,3,227107,227107,227110,0,3,1
64866,1,2,227108,227110,227112,2,4,0
64867,2,1,227110,227112,227113,2,3,0
64868,6,1,227116,227116,227117,0,1,3
64869,6,1,227122,227122,227123,0,1,5
64870,6,1,227128,227128,227129,0,1,5
64871,5,3,227133,227133,227136,0,3,4
64872,4,3,227137,227137,227140,0,3,1
64873,5,2,227142,227142,227144,0,2,2
64874,3,3,227145,227145,227148,0,3,1
64875,6,2,227151,227151,227153,0,2,3
64876,5,2,227156,227156,227158,0,2,3
64877,3,3,227159,227159,227162,0,3,1
64878,3,3,227162,227162,227165,0,3,0
64879,5,3,227167,227167,227170,0,3,2
64880,4,1,227171,227171,227172,0,1,1
64881,1,1,227172,227172,227173,0,1,0
64882,5,2,227177,227177,227179,0,2,4
64883,3,2,227180,227180,227182,0,2,1
64884,1,1,227181,227182,227183,1,2,0
64885,2,3,227183,227183,227186,0,3,0
64886,5,1,227188,227188,227189,0,1,2
64887,5,3,227193,227193,227196,0,3,4
64888,1,2,227194,227196,227198,2,4,0
64889,4,3,227198,227198,227201,0,3,0
64890,1,2,227199,227201,227203,2,4,0
64891,3,2,227202,227203,227205,1,3,0
64892,6,3,227208,227208,227211,0,3,3
64893,3,2,227211,227211,227213,0,2,0
64894,1,2,227212,227213,227215,1,3,0
64895,4,2,227216,227216,227218,0,2,1
64896,2,3,227218,227218,227221,0,3,0
64897,5,2,227223,227223,227225,0,2,2
64898,5,3,227228,227228,227231,0,3,3
64899,1,1,227229,227231,227232,2,3,0
64900,2,3,227231,227232,227235,1,4,0
64901,3,2,227234,227235,227237,1,3,0
64902,2,3,227236,227237,227240,1,4,0
64903,5,1,227241,227241,227242,0,1,1
64904,4,3,227245,227245,227248,0,3,3
64905,6,2,227251,227251,227253,0,2,3
64906,4,3,227255,227255,227258,0,3,2
64907,2,2,227257,227258,227260,1,3,0
64908,4,1,227261,227261,227262,0,1,1
64909,3,2,227264,227264,227266,0,2,2
64910,4,2,227268,227268,227270,0,2,2
64911,5,3,227273,227273,227276,0,3,3
64912,3,2,227276,227276,227278,0,2,0
64913,6,2,227282,227282,227284,0,2,4
64914,5,1,227287,227287,227288,0,1,3
64915,3,3,227290,227290,227293,0,3,2
64916,3,3,227293,227293,227296,0,3,0
64917,1,3,227294,227296,227299,2,5,0
64918,1,1,227295,227299,227300,4,5,0
64919,4,2,227299,227300,227302,1,3,0
64920,4,2,227303,227303,227305,0,2,1
64921,4,1,227307,227307,227308,0,1,2
64922,5,1,227312,227312,227313,0,1,4
64923,6,3,227318,227318,227321,0,3,5
64924,1,1,227319,227321,227322,2,3,0
64925,2,3,227321,227322,227325,1,4,0
64926,5,1,227326,227326,227327,0,1,1
64927,5,2,227331,227331,227333,0,2,4
64928,1,2,227332,227333,227335,1,3,0
64929,6,2,227338,227338,227340,0,2,3
64930,5,2,227343,227343,227345,0,2,3
64931,5,2,227348,227348,227350,0,2,3
64932,3,3,227351,227351,227354,0,3,1
64933,2,1,227353,227354,227355,1,2,0
64934,5,1,227358,227358,227359,0,1,3
64935,5,1,227363,227363,227364,0,1,4
64936,6,3,227369,227369,227372,0,3,5
64937,6,3,227375,227375,227378,0,3,3
64938,3,2,227378,227378,227380,0,2,0
64939,6,2,227384,227384,227386,0,2,4
64940,5,1,227389,227389,227390,0,1,3
64941,5,1,227394,227394,227395,0,1,4
64942,5,2,227399,227399,227401,0,2,4
64943,1,1,227400,227401,227402,1,2,0
64944,1,1,227401,227402,227403,1,2,0
64945,2,2,227403,227403,227405,0,2,0
64946,2,3,227405,227405,227408,0,3,0
64947,2,1,227407,227408,227409,1,2,0
64948,5,1,227412,227412,227413,0,1,3
64949,2,2,227414,227414,227416,0,2,1
64950,6,1,227420,227420,227421,0,1,4
64951,3,3,227423,227423,227426,0,3,2
64952,3,2,227426,227426,227428,0,2,0
64953,1,3,227427,227428,227431,1,4,0
64954,6,1,227433,227433,227434,0,1,2
64955,1,3,227434,227434,227437,0,3,0
64956,1,1,227435,227437,227438,2,3,0
64957,5,1,227440,227440,227441,0,1,2
64958,5,1,227445,227445,227446,0,1,4
64959,3,3,227448,227448,227451,0,3,2
64960,2,2,227450,227451,227453,1,3,0
64961,1,2,227451,227453,227455,2,4,0
64962,1,3,227452,227455,227458,3,6,0
64963,2,2,227454,227458,227460,4,6,0
64964,1,2,227455,227460,227462,5,7,0
64965,6,2,227461,227462,227464,1,3,0
64966,1,2,227462,227464,227466,2,4,0
64967,3,3,227465,227466,227469,1,4,0
64968,2,2,227467,227469,227471,2,4,0
64969,1,1,227468,227471,227472,3,4,0
64970,5,2,227473,227473,227475,0,2,1
64971,1,2,227474,227475,227477,1,3,0
64972,3,3,227477,227477,227480,0,3,0
64973,2,3,227479,227480,227483,1,4,0
64974,1,3,227480,227483,227486,3,6,0
64975,5,3,227485,227486,227489,1,4,0
64976,2,3,227487,227489,227492,2,5,0
64977,5,3,227492,227492,227495,0,3,0
64978,2,1,227494,227495,227496,1,2,0
64979,5,1,227499,227499,227500,0,1,3
64980,2,2,227501,227501,227503,0,2,1
64981,6,3,227507,227507,227510,0,3,4
64982,3,3,227510,227510,227513,0,3,0
64983,2,3,227512,227513,227516,1,4,0
64984,6,2,227518,227518,227520,0,2,2
64985,3,1,227521,227521,227522,0,1,1
64986,3,2,227524,227524,227526,0,2,2
64987,4,1,227528,227528,227529,0,1,2
64988,5,3,227533,227533,227536,0,3,4
64989,4,3,227537,227537,227540,0,3,1
64990,6,2,227543,227543,227545,0,2,3
64991,5,1,227548,227548,227549,0,1,3
64992,3,3,227551,227551,227554,0,3,2
64993,5,1,227556,227556,227557,0,1,2
64994,3,3,227559,227559,227562,0,3,2
64995,6,3,227565,227565,227568,0,3,3
64996,1,1,227566,227568,227569,2,3,0
64997,4,3,227570,227570,227573,0,3,1
64998,5,1,227575,227575,227576,0,1,2
64999,4,3,227579,227579,227582,0,3,3
65000,2,2,227581,227582,227584,1,3,0
65001,3,1,227584,227584,227585,0,1,0
65002,5,2,227589,227589,227591,0,2,4
65003,1,1,227590,227591,227592,1,2,0
65004,1,3,227591,227592,227595,1,4,0
65005,2,2,227593,227595,227597,2,4,0
65006,2,2,227595,227597,227599,2,4,0
65007,4,1,227599,227599,227600,0,1,0
65008,1,1,227600,227600,227601,0,1,0
65009,3,3,227603,227603,227606,0,3,2
65010,6,2,227609,227609,227611,0,2,3
65011,1,1,227610,227611,227612,1,2,0
65012,6,3,227616,227616,227619,0,3,4
65013,2,3,227618,227619,227622,1,4,0
65014,3,1,227621,227622,227623,1,2,0
65015,3,3,227624,227624,227627,0,3,1
65016,5,1,227629,227629,227630,0,1,2
65017,5,3,227634,227634,227637,0,3,4
65018,6,3,227640,227640,227643,0,3,3
65019,4,3,227644,227644,227647,0,3,1
65020,2,3,227646,227647,227650,1,4,0
65021,4,3,227650,227650,227653,0,3,0
65022,6,3,227656,227656,227659,0,3,3
65023,2,1,227658,227659,227660,1,2,0
65024,4,3,227662,227662,227665,0,3,2
65025,2,3,227664,227665,227668,1,4,0
65026,6,1,227670,227670,227671,0,1,2
65027,4,1,227674,227674,227675,0,1,3
65028,3,3,227677,227677,227680,0,3,2
65029,4,3,227681,227681,227684,0,3,1
65030,5,2,227686,227686,227688,0,2,2
65031,1,2,227687,227688,227690,1,3,0
65032,3,2,227690,227690,227692,0,2,0
65033,4,2,227694,227694,227696,0,2,2
65034,4,3,227698,227698,227701,0,3,2
65035,4,2,227702,227702,227704,0,2,1
65036,1,1,227703,227704,227705,1,2,0
65037,4,2,227707,227707,227709,0,2,2
65038,1,1,227708,227709,227710,1,2,0
65039,1,2,227709,227710,227712,1,3,0
65040,2,2,227711,227712,227714,1,3,0
65041,2,2,227713,227714,227716,1,3,0
65042,4,3,227717,227717,227720,0,3,1
65043,3,1,227720,227720,227721,0,1,0
65044,4,3,227724,227724,227727,0,3,3
65045,2,1,227726,227727,227728,1,2,0
65046,3,1,227729,227729,227730,0,1,1
65047,6,2,227735,227735,227737,0,2,5
65048,3,3,227738,227738,227741,0,3,1
65049,6,2,227744,227744,227746,0,2,3
65050,5,2,227749,227749,227751,0,2,3
65051,6,2,227755,227755,227757,0,2,4
65052,5,3,227760,227760,227763,0,3,3
65053,4,2,227764,227764,227766,0,2,1
65054,6,2,227770,227770,227772,0,2,4
65055,6,3,227776,227776,227779,0,3,4
65056,2,1,227778,227779,227780,1,2,0
65057,2,2,227780,227780,227782,0,2,0
65058,1,3,227781,227782,227785,1,4,0
65059,6,1,227787,227787,227788,0,1,2
65060,2,1,227789,227789,227790,0,1,1
65061,6,2,227795,227795,227797,0,2,5
65062,5,2,227800,227800,227802,0,2,3
65063,5,3,227805,227805,227808,0,3,3
65064,2,3,227807,227808,227811,1,4,0
65065,6,1,227813,227813,227814,0,1,2
65066,1,2,227814,227814,227816,0,2,0
65067,3,3,227817,227817,227820,0,3,1
65068,1,1,227818,227820,227821,2,3,0
65069,6,3,227824,227824,227827,0,3,3
65070,2,2,227826,227827,227829,1,3,0
65071,5,1,227831,227831,227832,0,1,2
65072,4,1,227835,227835,227836,0,1,3
65073,5,2,227840,227840,227842,0,2,4
65074,2,1,227842,227842,227843,0,1,0
65075,1,2,227843,227843,227845,0,2,0
65076,6,2,227849,227849,227851,0,2,4
65077,5,3,227854,227854,227857,0,3,3
65078,2,3,227856,227857,227860,1,4,0
65079,6,3,227862,227862,227865,0,3,2
65080,4,1,227866,227866,227867,0,1,1
65081,2,2,227868,227868,227870,0,2,1
65082,3,3,227871,227871,227874,0,3,1
65083,2,1,227873,227874,227875,1,2,0
65084,1,3,227874,227875,227878,1,4,0
65085,6,2,227880,227880,227882,0,2,2
65086,4,2,227884,227884,227886,0,2,2
65087,2,2,227886,227886,227888,0,2,0
65088,2,3,227888,227888,227891,0,3,0
65089,1,2,227889,227891,227893,2,4,0
65090,1,3,227890,227893,227896,3,6,0
65091,5,1,227895,227896,227897,1,2,0
65092,5,2,227900,227900,227902,0,2,3
65093,3,1,227903,227903,227904,0,1,1
65094,4,1,227907,227907,227908,0,1,3
65095,3,2,227910,227910,227912,0,2,2
65096,5,2,227915,227915,227917,0,2,3
65097,4,2,227919,227919,227921,0,2,2
65098,4,1,227923,227923,227924,0,1,2
65099,4,3,227927,227927,227930,0,3,3
65100,2,2,227929,227930,227932,1,3,0
65101,3,3,227932,227932,227935,0,3,0
65102,6,1,227938,227938,227939,0,1,3
65103,2,3,227940,227940,227943,0,3,1
65104,3,1,227943,227943,227944,0,1,0
65105,2,3,227945,227945,227948,0,3,1
65106,6,1,227951,227951,227952,0,1,3
65107,3,2,227954,227954,227956,0,2,2
65108,2,3,227956,227956,227959,0,3,0
65109,3,2,227959,227959,227961,0,2,0
65110,3,3,227962,227962,227965,0,3,1
65111,1,1,227963,227965,227966,2,3,0
65112,3,1,227966,227966,227967,0,1,0
65113,3,3,227969,227969,227972,0,3,2
65114,5,2,227974,227974,227976,0,2,2
65115,3,2,227977,227977,227979,0,2,1
65116,5,1,227982,227982,227983,0,1,3
65117,2,2,227984,227984,227986,0,2,1
65118,6,3,227990,227990,227993,0,3,4
65119,3,3,227993,227993,227996,0,3,0
65120,3,1,227996,227996,227997,0,1,0
65121,1,3,227997,227997,228000,0,3,0
65122,4,3,228001,228001,228004,0,3,1
65123,5,3,228006,228006,228009,0,3,2
65124,5,3,228011,228011,228014,0,3,2
65125,2,1,228013,228014,228015,1,2,0
65126,6,1,228019,228019,228020,0,1,4
65127,5,3,228024,228024,228027,0,3,4
65128,5,3,228029,228029,228032,0,3,2
65129,2,2,228031,228032,228034,1,3,0
65130,2,1,228033,228034,228035,1,2,0
65131,2,2,228035,228035,228037,0,2,0
65132,2,3,228037,228037,228040,0,3,0
65133,1,2,228038,228040,228042,2,4,0
65134,2,2,228040,228042,228044,2,4,0
65135,2,3,228042,228044,228047,2,5,0
65136,2,1,228044,228047,228048,3,4,0
65137,2,2,228046,228048,228050,2,4,0
65138,2,2,228048,228050,228052,2,4,0
65139,5,1,228053,228053,228054,0,1,1
65140,4,2,228057,228057,228059,0,2,3
65141,5,3,228062,228062,228065,0,3,3
65142,4,2,228066,228066,228068,0,2,1
65143,6,2,228072,228072,228074,0,2,4
65144,2,2,228074,228074,228076,0,2,0
65145,4,2,228078,228078,228080,0,2,2
65146,5,2,228083,228083,228085,0,2,3
65147,3,3,228086,228086,228089,0,3,1
65148,3,2,228089,228089,228091,0,2,0
65149,2,2,228091,228091,228093,0,2,0
65150,1,3,228092,228093,228096,1,4,0
65151,5,2,228097,228097,228099,0,2,1
65152,2,2,228099,228099,228101,0,2,0
65153,1,1,228100,228101,228102,1,2,0
65154,2,3,228102,228102,228105,0,3,0
65155,2,1,228104,228105,228106,1,2,0
65156,1,1,228105,228106,228107,1,2,0
65157,5,1,228110,228110,228111,0,1,3
65158,4,3,228114,228114,228117,0,3,3
65159,5,2,228119,228119,228121,0,2,2
65160,2,2,228121,228121,228123,0,2,0
65161,3,1,228124,228124,228125,0,1,1
65162,3,1,228127,228127,228128,0,1,2
65163,5,2,228132,228132,228134,0,2,4
65164,6,2,228138,228138,228140,0,2,4
65165,3,3,228141,228141,228144,0,3,1
65166,3,2,228144,228144,228146,0,2,0
65167,2,1,228146,228146,228147,0,1,0
65168,4,2,228150,228150,228152,0,2,3
65169,1,2,228151,228152,228154,1,3,0
65170,3,2,228154,228154,228156,0,2,0
65171,5,1,228159,228159,228160,0,1,3
65172,6,2,228165,228165,228167,0,2,5
65173,2,1,228167,228167,228168,0,1,0
65174,5,1,228172,228172,228173,0,1,4
65175,4,2,228176,228176,228178,0,2,3
65176,2,3,228178,228178,228181,0,3,0
65177,5,3,228183,228183,228186,0,3,2
65178,2,2,228185,228186,228188,1,3,0
65179,2,1,228187,228188,228189,1,2,0
65180,2,2,228189,228189,228191,0,2,0
65181,2,2,228191,228191,228193,0,2,0
65182,6,3,228197,228197,228200,0,3,4
65183,4,3,228201,228201,228204,0,3,1
65184,1,3,228202,228204,228207,2,5,0
65185,4,2,228206,228207,228209,1,3,0
65186,2,1,228208,228209,228210,1,2,0
65187,5,1,228213,228213,228214,0,1,3
65188,6,3,228219,228219,228222,0,3,5
65189,5,2,228224,228224,228226,0,2,2
65190,4,1,228228,228228,228229,0,1,2
65191,2,1,228230,228230,228231,0,1,1
65192,5,2,228235,228235,228237,0,2,4
65193,6,2,228241,228241,228243,0,2,4
65194,5,1,228246,228246,228247,0,1,3
65195,5,2,228251,228251,228253,0,2,4
65196,1,1,228252,228253,228254,1,2,0
65197,4,3,228256,228256,228259,0,3,2
65198,1,3,228257,228259,228262,2,5,0
65199,3,2,228260,228262,228264,2,4,0
65200,1,1,228261,228264,228265,3,4,0
65201,3,3,228264,228265,228268,1,4,0
65202,3,1,228267,228268,228269,1,2,0
65203,3,3,228270,228270,228273,0,3,1
65204,4,3,228274,228274,228277,0,3,1
65205,1,2,228275,228277,228279,2,4,0
65206,5,1,228280,228280,228281,0,1,1
65207,2,3,228282,228282,228285,0,3,1
65208,2,3,228284,228285,228288,1,4,0
65209,3,2,228287,228288,228290,1,3,0
65210,1,3,228288,228290,228293,2,5,0
65211,1,1,228289,228293,228294,4,5,0
65212,5,3,228294,228294,228297,0,3,0
65213,3,2,228297,228297,228299,0,2,0
65214,4,2,228301,228301,228303,0,2,2
65215,6,2,228307,228307,228309,0,2,4
65216,5,3,228312,228312,228315,0,3,3
65217,3,1,228315,228315,228316,0,1,0
65218,2,2,228317,228317,228319,0,2,1
65219,2,1,228319,228319,228320,0,1,0
65220,3,2,228322,228322,228324,0,2,2
65221,3,3,228325,228325,228328,0,3,1
65222,3,3,228328,228328,228331,0,3,0
65223,1,3,228329,228331,228334,2,5,0
65224,1,2,228330,228334,228336,4,6,0
65225,6,2,228336,228336,228338,0,2,0
65226,1,2,228337,228338,228340,1,3,0
65227,3,1,228340,228340,228341,0,1,0
65228,5,2,228345,228345,228347,0,2,4
65229,4,2,228349,228349,228351,0,2,2
65230,1,3,228350,228351,228354,1,4,0
65231,4,1,228354,228354,228355,0,1,0
65232,6,3,228360,228360,228363,0,3,5
65233,1,2,228361,228363,228365,2,4,0
65234,1,3,228362,228365,228368,3,6,0
65235,2,1,228364,228368,228369,4,5,0
65236,5,3,228369,228369,228372,0,3,0
65237,6,1,228375,228375,228376,0,1,3
65238,1,2,228376,228376,228378,0,2,0
65239,6,3,228382,228382,228385,0,3,4
65240,2,1,228384,228385,228386,1,2,0
65241,3,1,228387,228387,228388,0,1,1
65242,2,1,228389,228389,228390,0,1,1
65243,3,1,228392,228392,228393,0,1,2
65244,5,2,228397,228397,228399,0,2,4
65245,2,3,228399,228399,228402,0,3,0
65246,3,2,228402,228402,228404,0,2,0
65247,1,3,228403,228404,228407,1,4,0
65248,4,3,228407,228407,228410,0,3,0
65249,3,3,228410,228410,228413,0,3,0
65250,3,2,228413,228413,228415,0,2,0
65251,2,3,228415,228415,228418,0,3,0
65252,1,2,228416,228418,228420,2,4,0
65253,4,1,228420,228420,228421,0,1,0
65254,5,1,228425,228425,228426,0,1,4
65255,4,2,228429,228429,228431,0,2,3
65256,5,2,228434,228434,228436,0,2,3
65257,1,1,228435,228436,228437,1,2,0
65258,5,1,228440,228440,228441,0,1,3
65259,6,2,228446,228446,228448,0,2,5
65260,2,3,228448,228448,228451,0,3,0
65261,3,1,228451,228451,228452,0,1,0
65262,6,2,228457,228457,228459,0,2,5
65263,1,3,228458,228459,228462,1,4,0
65264,4,1,228462,228462,228463,0,1,0
65265,1,2,228463,228463,228465,0,2,0
65266,3,3,228466,228466,228469,0,3,1
65267,1,1,228467,228469,228470,2,3,0
65268,6,2,228473,228473,228475,0,2,3
65269,4,2,228477,228477,228479,0,2,2
65270,1,2,228478,228479,228481,1,3,0
65271,5,3,228483,228483,228486,0,3,2
65272,2,1,228485,228486,228487,1,2,0
65273,1,3,228486,228487,228490,1,4,0
65274,4,1,228490,228490,228491,0,1,0
65275,3,2,228493,228493,228495,0,2,2
65276,2,3,228495,228495,228498,0,3,0
65277,5,2,228500,228500,228502,0,2,2
65278,4,1,228504,228504,228505,0,1,2
65279,2,2,228506,228506,228508,0,2,1
65280,2,3,228508,228508,228511,0,3,0
65281,1,2,228509,228511,228513,2,4,0
65282,5,1,228514,228514,228515,0,1,1
65283,5,3,228519,228519,228522,0,3,4
65284,3,3,228522,228522,228525,0,3,0
65285,5,3,228527,228527,228530,0,3,2
65286,4,1,228531,228531,228532,0,1,1
65287,4,2,228535,228535,228537,0,2,3
65288,5,3,228540,228540,228543,0,3,3
65289,3,3,228543,228543,228546,0,3,0
65290,2,3,228545,228546,228549,1,4,0
65291,3,3,228548,228549,228552,1,4,0
65292,4,3,228552,228552,228555,0,3,0
65293,3,1,228555,228555,228556,0,1,0
65294,3,2,228558,228558,228560,0,2,2
65295,4,2,228562,228562,228564,0,2,2
65296,2,1,228564,228564,228565,0,1,0
65297,4,1,228568,228568,228569,0,1,3
65298,4,2,228572,228572,228574,0,2,3
65299,4,2,228576,228576,228578,0,2,2
65300,6,2,228582,228582,228584,0,2,4
65301,2,2,228584,228584,228586,0,2,0
65302,6,3,228590,228590,228593,0,3,4
65303,4,3,228594,228594,228597,0,3,1
65304,5,3,228599,228599,228602,0,3,2
65305,6,3,228605,228605,228608,0,3,3
65306,1,2,228606,228608,228610,2,4,0
65307,3,2,228609,228610,228612,1,3,0
65308,5,2,228614,228614,228616,0,2,2
65309,4,1,228618,228618,228619,0,1,2
65310,6,2,228624,228624,228626,0,2,5
65311,5,3,228629,228629,228632,0,3,3
65312,5,2,228634,228634,228636,0,2,2
65313,1,2,228635,228636,228638,1,3,0
65314,4,2,228639,228639,228641,0,2,1
65315,3,3,228642,228642,228645,0,3,1
65316,2,3,228644,228645,228648,1,4,0
65317,4,2,228648,228648,228650,0,2,0
65318,4,2,228652,228652,228654,0,2,2
65319,4,2,228656,228656,228658,0,2,2
65320,6,2,228662,228662,228664,0,2,4
65321,2,1,228664,228664,228665,0,1,0
65322,6,2,228670,228670,228672,0,2,5
65323,4,1,228674,228674,228675,0,1,2
65324,2,3,228676,228676,228679,0,3,1
65325,3,3,228679,228679,228682,0,3,0
65326,5,3,228684,228684,228687,0,3,2
65327,2,2,228686,228687,228689,1,3,0
65328,6,3,228692,228692,228695,0,3,3
65329,1,3,228693,228695,228698,2,5,0
65330,6,1,228699,228699,228700,0,1,1
65331,1,3,228700,228700,228703,0,3,0
65332,5,1,228705,228705,228706,0,1,2
65333,6,3,228711,228711,228714,0,3,5
65334,4,1,228715,228715,228716,0,1,1
65335,4,3,228719,228719,228722,0,3,3
65336,2,1,228721,228722,228723,1,2,0
65337,2,2,228723,228723,228725,0,2,0
65338,5,3,228728,228728,228731,0,3,3
65339,6,2,228734,228734,228736,0,2,3
65340,6,1,228740,228740,228741,0,1,4
65341,2,1,228742,228742,228743,0,1,1
65342,2,1,228744,228744,228745,0,1,1
65343,1,1,228745,228745,228746,0,1,0
65344,6,1,228751,228751,228752,0,1,5
65345,5,1,228756,228756,228757,0,1,4
65346,1,2,228757,228757,228759,0,2,0
65347,1,2,228758,228759,228761,1,3,0
65348,1,1,228759,228761,228762,2,3,0
65349,5,1,228764,228764,228765,0,1,2
65350,5,1,228769,228769,228770,0,1,4
65351,5,1,228774,228774,228775,0,1,4
65352,2,3,228776,228776,228779,0,3,1
65353,3,1,228779,228779,228780,0,1,0
65354,6,1,228785,228785,228786,0,1,5
65355,1,3,228786,228786,228789,0,3,0
65356,5,3,228791,228791,228794,0,3,2
65357,1,1,228792,228794,228795,2,3,0
65358,3,2,228795,228795,228797,0,2,0
65359,1,1,228796,228797,228798,1,2,0
65360,1,1,228797,228798,228799,1,2,0
65361,2,3,228799,228799,228802,0,3,0
65362,2,2,228801,228802,228804,1,3,0
65363,1,1,228802,228804,228805,2,3,0
65364,5,3,228807,228807,228810,0,3,2
65365,6,1,228813,228813,228814,0,1,3
65366,6,2,228819,228819,228821,0,2,5
65367,6,2,228825,228825,228827,0,2,4
65368,5,1,228830,228830,228831,0,1,3
65369,4,3,228834,228834,228837,0,3,3
65370,4,2,228838,228838,228840,0,2,1
65371,2,1,228840,228840,228841,0,1,0
65372,6,2,228846,228846,228848,0,2,5
65373,3,2,228849,228849,228851,0,2,1
65374,1,3,228850,228851,228854,1,4,0
65375,5,1,228855,228855,228856,0,1,1
65376,1,2,228856,228856,228858,0,2,0
65377,6,2,228862,228862,228864,0,2,4
65378,1,2,228863,228864,228866,1,3,0
65379,6,1,228869,228869,228870,0,1,3
65380,1,3,228870,228870,228873,0,3,0
65381,4,2,228874,228874,228876,0,2,1
65382,3,3,228877,228877,228880,0,3,1
65383,3,3,228880,228880,228883,0,3,0
65384,1,3,228881,228883,228886,2,5,0
65385,1,1,228882,228886,228887,4,5,0
65386,3,3,228885,228887,228890,2,5,0
65387,6,1,228891,228891,228892,0,1,1
65388,6,1,228897,228897,228898,0,1,5
65389,1,3,228898,228898,228901,0,3,0
65390,6,1,228904,228904,228905,0,1,3
65391,3,1,228907,228907,228908,0,1,2
65392,6,1,228913,228913,228914,0,1,5
65393,4,1,228917,228917,228918,0,1,3
65394,1,3,228918,228918,228921,0,3,0
65395,2,1,228920,228921,228922,1,2,0
65396,2,1,228922,228922,228923,0,1,0
65397,1,1,228923,228923,228924,0,1,0
65398,1,2,228924,228924,228926,0,2,0
65399,4,2,228928,228928,228930,0,2,2
65400,4,3,228932,228932,228935,0,3,2
65401,1,3,228933,228935,228938,2,5,0
65402,1,1,228934,228938,228939,4,5,0
65403,1,2,228935,228939,228941,4,6,0
65404,4,3,228939,228941,228944,2,5,0
65405,3,2,228942,228944,228946,2,4,0
65406,4,3,228946,228946,228949,0,3,0
65407,1,3,228947,228949,228952,2,5,0
65408,3,2,228950,228952,228954,2,4,0
65409,3,1,228953,228954,228955,1,2,0
65410,2,3,228955,228955,228958,0,3,0
65411,6,3,228961,228961,228964,0,3,3
65412,5,2,228966,228966,228968,0,2,2
65413,5,2,228971,228971,228973,0,2,3
65414,5,1,228976,228976,228977,0,1,3
65415,6,3,228982,228982,228985,0,3,5
65416,4,3,228986,228986,228989,0,3,1
65417,1,1,228987,228989,228990,2,3,0
65418,4,2,228991,228991,228993,0,2,1
65419,5,2,228996,228996,228998,0,2,3
65420,3,2,228999,228999,229001,0,2,1
65421,5,2,229004,229004,229006,0,2,3
65422,4,2,229008,229008,229010,0,2,2
65423,3,2,229011,229011,229013,0,2,1
65424,5,3,229016,229016,229019,0,3,3
65425,4,3,229020,229020,229023,0,3,1
65426,6,2,229026,229026,229028,0,2,3
65427,3,3,229029,229029,229032,0,3,1
65428,5,3,229034,229034,229037,0,3,2
65429,6,3,229040,229040,229043,0,3,3
65430,1,3,229041,229043,229046,2,5,0
65431,1,3,229042,229046,229049,4,7,0
65432,5,2,229047,229049,229051,2,4,0
65433,2,1,229049,229051,229052,2,3,0
65434,6,2,229055,229055,229057,0,2,3
65435,6,1,229061,229061,229062,0,1,4
65436,6,1,229067,229067,229068,0,1,5
65437,1,3,229068,229068,229071,0,3,0
65438,6,1,229074,229074,229075,0,1,3
65439,3,2,229077,229077,229079,0,2,2
65440,3,1,229080,229080,229081,0,1,1
65441,1,1,229081,229081,229082,0,1,0
65442,2,1,229083,229083,229084,0,1,1
65443,2,1,229085,229085,229086,0,1,1
65444,6,2,229091,229091,229093,0,2,5
65445,5,3,229096,229096,229099,0,3,3
65446,5,3,229101,229101,229104,0,3,2
65447,2,3,229103,229104,229107,1,4,0
65448,5,1,229108,229108,229109,0,1,1
65449,4,2,229112,229112,229114,0,2,3
65450,1,1,229113,229114,229115,1,2,0
65451,6,3,229119,229119,229122,0,3,4
65452,4,2,229123,229123,229125,0,2,1
65453,1,3,229124,229125,229128,1,4,0
65454,3,1,229127,229128,229129,1,2,0
65455,3,3,229130,229130,229133,0,3,1
65456,2,2,229132,229133,229135,1,3,0
65457,3,2,229135,229135,229137,0,2,0
65458,4,3,229139,229139,229142,0,3,2
65459,5,1,229144,229144,229145,0,1,2
65460,4,3,229148,229148,229151,0,3,3
65461,4,2,229152,229152,229154,0,2,1
65462,5,1,229157,229157,229158,0,1,3
65463,6,2,229163,229163,229165,0,2,5
65464,1,3,229164,229165,229168,1,4,0
65465,5,1,229169,229169,229170,0,1,1
65466,1,3,229170,229170,229173,0,3,0
65467,1,3,229171,229173,229176,2,5,0
65468,6,2,229177,229177,229179,0,2,1
65469,1,3,229178,229179,229182,1,4,0
65470,2,2,229180,229182,229184,2,4,0
65471,5,3,229185,229185,229188,0,3,1
65472,5,1,229190,229190,229191,0,1,2
65473,5,1,229195,229195,229196,0,1,4
65474,4,1,229199,229199,229200,0,1,3
65475,6,3,229205,229205,229208,0,3,5
65476,5,3,229210,229210,229213,0,3,2
65477,2,3,229212,229213,229216,1,4,0
65478,1,3,229213,229216,229219,3,6,0
65479,4,3,229217,229219,229222,2,5,0
65480,5,3,229222,229222,229225,0,3,0
65481,3,1,229225,229225,229226,0,1,0
65482,2,2,229227,229227,229229,0,2,1
65483,4,2,229231,229231,229233,0,2,2
65484,5,3,229236,229236,229239,0,3,3
65485,2,1,229238,229239,229240,1,2,0
65486,2,1,229240,229240,229241,0,1,0
65487,1,1,229241,229241,229242,0,1,0
65488,5,3,229246,229246,229249,0,3,4
65489,6,3,229252,229252,229255,0,3,3
65490,5,2,229257,229257,229259,0,2,2
65491,3,3,229260,229260,229263,0,3,1
65492,4,3,229264,229264,229267,0,3,1
65493,2,2,229266,229267,229269,1,3,0
65494,1,3,229267,229269,229272,2,5,0
65495,2,3,229269,229272,229275,3,6,0
65496,2,3,229271,229275,229278,4,7,0
65497,2,2,229273,229278,229280,5,7,0
65498,3,2,229276,229280,229282,4,6,0
65499,5,2,229281,229282,229284,1,3,0
65500,2,1,229283,229284,229285,1,2,0
65501,2,3,229285,229285,229288,0,3,0
65502,1,2,229286,229288,229290,2,4,0
65503,3,1,229289,229290,229291,1,2,0
65504,5,2,229294,229294,229296,0,2,3
65505,5,3,229299,229299,229302,0,3,3
65506,6,1,229305,229305,229306,0,1,3
65507,4,3,229309,229309,229312,0,3,3
65508,2,2,229311,229312,229314,1,3,0
65509,2,3,229313,229314,229317,1,4,0
65510,6,1,229319,229319,229320,0,1,2
65511,4,3,229323,229323,229326,0,3,3
65512,5,3,229328,229328,229331,0,3,2
65513,3,1,229331,229331,229332,0,1,0
65514,3,2,229334,229334,229336,0,2,2
65515,5,1,229339,229339,229340,0,1,3
65516,5,2,229344,229344,229346,0,2,4
65517,5,2,229349,229349,229351,0,2,3
65518,1,2,229350,229351,229353,1,3,0
65519,3,3,229353,229353,229356,0,3,0
65520,1,2,229354,229356,229358,2,4,0
65521,4,3,229358,229358,229361,0,3,0
65522,6,2,229364,229364,229366,0,2,3
65523,4,1,229368,229368,229369,0,1,2
65524,1,1,229369,229369,229370,0,1,0
65525,4,3,229373,229373,229376,0,3,3
65526,1,1,229374,229376,229377,2,3,0
65527,2,2,229376,229377,229379,1,3,0
65528,1,2,229377,229379,229381,2,4,0
65529,4,2,229381,229381,229383,0,2,0
65530,2,1,229383,229383,229384,0,1,0
65531,4,3,229387,229387,229390,0,3,3
65532,2,2,229389,229390,229392,1,3,0
65533,6,1,229395,229395,229396,0,1,3
65534,4,1,229399,229399,229400,0,1,3
65535,3,3,229402,229402,229405,0,3,2
65536,3,2,229405,229405,229407,0,2,0
65537,5,1,229410,229410,229411,0,1,3
65538,4,1,229414,229414,229415,0,1,3
65539,4,1,229418,229418,229419,0,1,3
65540,5,1,229423,229423,229424,0,1,4
65541,1,1,229424,229424,229425,0,1,0
65542,3,3,229427,229427,229430,0,3,2
65543,3,2,229430,229430,229432,0,2,0
65544,2,2,229432,229432,229434,0,2,0
65545,2,1,229434,229434,229435,0,1,0
65546,2,1,229436,229436,229437,0,1,1
65547,4,3,229440,229440,229443,0,3,3
65548,3,2,229443,229443,229445,0,2,0
65549,2,1,229445,229445,229446,0,1,0
65550,2,3,229447,229447,229450,0,3,1
65551,4,3,229451,229451,229454,0,3,1
65552,4,3,229455,229455,229458,0,3,1
65553,3,1,229458,229458,229459,0,1,0
65554,3,2,229461,229461,229463,0,2,2
65555,2,3,229463,229463,229466,0,3,0
65556,2,1,229465,229466,229467,1,2,0
65557,3,2,229468,229468,229470,0,2,1
65558,2,1,229470,229470,229471,0,1,0
65559,1,1,229471,229471,229472,0,1,0
65560,1,1,229472,229472,229473,0,1,0
65561,5,1,229477,229477,229478,0,1,4
65562,3,3,229480,229480,229483,0,3,2
65563,2,2,229482,229483,229485,1,3,0
65564,1,2,229483,229485,229487,2,4,0
65565,1,3,229484,229487,229490,3,6,0
65566,3,3,229487,229490,229493,3,6,0
65567,2,1,229489,229493,229494,4,5,0
65568,5,1,229494,229494,229495,0,1,0
65569,1,1,229495,229495,229496,0,1,0
65570,4,1,229499,229499,229500,0,1,3
65571,1,2,229500,229500,229502,0,2,0
65572,3,2,229503,229503,229505,0,2,1
65573,1,1,229504,229505,229506,1,2,0
65574,2,3,229506,229506,229509,0,3,0
65575,2,2,229508,229509,229511,1,3,0
65576,2,1,229510,229511,229512,1,2,0
65577,4,2,229514,229514,229516,0,2,2
65578,4,1,229518,229518,229519,0,1,2
65579,4,3,229522,229522,229525,0,3,3
65580,1,3,229523,229525,229528,2,5,0
65581,4,3,229527,229528,229531,1,4,0
65582,5,1,229532,229532,229533,0,1,1
65583,6,2,229538,229538,229540,0,2,5
65584,6,2,229544,229544,229546,0,2,4
65585,5,3,229549,229549,229552,0,3,3
65586,6,3,229555,229555,229558,0,3,3
65587,5,2,229560,229560,229562,0,2,2
65588,3,1,229563,229563,229564,0,1,1
65589,6,1,229569,229569,229570,0,1,5
65590,4,1,229573,229573,229574,0,1,3
65591,5,1,229578,229578,229579,0,1,4
65592,2,2,229580,229580,229582,0,2,1
65593,6,1,229586,229586,229587,0,1,4
65594,2,3,229588,229588,229591,0,3,1
65595,3,1,229591,229591,229592,0,1,0
65596,4,3,229595,229595,229598,0,3,3
65597,6,1,229601,229601,229602,0,1,3
65598,2,1,229603,229603,229604,0,1,1
65599,1,2,229604,229604,229606,0,2,0
65600,1,1,229605,229606,229607,1,2,0
65601,1,3,229606,229607,229610,1,4,0
65602,1,1,229607,229610,229611,3,4,0
65603,1,3,229608,229611,229614,3,6,0
65604,4,2,229612,229614,229616,2,4,0
65605,6,2,229618,229618,229620,0,2,2
65606,4,2,229622,229622,229624,0,2,2
65607,4,2,229626,229626,229628,0,2,2
65608,6,2,229632,229632,229634,0,2,4
65609,1,3,229633,229634,229637,1,4,0
65610,6,3,229639,229639,229642,0,3,2
65611,2,2,229641,229642,229644,1,3,0
65612,2,2,229643,229644,229646,1,3,0
65613,4,1,229647,229647,229648,0,1,1
65614,1,1,229648,229648,229649,0,1,0
65615,1,3,229649,229649,229652,0,3,0
65616,5,2,229654,229654,229656,0,2,2
65617,3,1,229657,229657,229658,0,1,1
65618,6,1,229663,229663,229664,0,1,5
65619,3,3,229666,229666,229669,0,3,2
65620,5,3,229671,229671,229674,0,3,2
65621,2,1,229673,229674,229675,1,2,0
65622,4,3,229677,229677,229680,0,3,2
65623,2,1,229679,229680,229681,1,2,0
65624,6,3,229685,229685,229688,0,3,4
65625,6,3,229691,229691,229694,0,3,3
65626,3,1,229694,229694,229695,0,1,0
65627,2,2,229696,229696,229698,0,2,1
65628,2,2,229698,229698,229700,0,2,0
65629,3,3,229701,229701,229704,0,3,1
65630,1,3,229702,229704,229707,2,5,0
65631,6,1,229708,229708,229709,0,1,1
65632,6,1,229714,229714,229715,0,1,5
65633,2,3,229716,229716,229719,0,3,1
65634,1,3,229717,229719,229722,2,5,0
65635,6,1,229723,229723,229724,0,1,1
65636,3,1,229726,229726,229727,0,1,2
65637,6,2,229732,229732,229734,0,2,5
65638,6,2,229738,229738,229740,0,2,4
65639,2,3,229740,229740,229743,0,3,0
65640,4,3,229744,229744,229747,0,3,1
65641,1,3,229745,229747,229750,2,5,0
65642,3,1,229748,229750,229751,2,3,0
65643,5,2,229753,229753,229755,0,2,2
65644,3,1,229756,229756,229757,0,1,1
65645,3,3,229759,229759,229762,0,3,2
65646,2,2,229761,229762,229764,1,3,0
65647,5,3,229766,229766,229769,0,3,2
65648,5,1,229771,229771,229772,0,1,2
65649,3,3,229774,229774,229777,0,3,2
65650,6,2,229780,229780,229782,0,2,3
65651,1,3,229781,229782,229785,1,4,0
65652,2,2,229783,229785,229787,2,4,0
65653,5,3,229788,229788,229791,0,3,1
65654,1,3,229789,229791,229794,2,5,0
65655,3,3,229792,229794,229797,2,5,0
65656,3,2,229795,229797,229799,2,4,0
65657,3,2,229798,229799,229801,1,3,0
65658,5,2,229803,229803,229805,0,2,2
65659,4,1,229807,229807,229808,0,1,2
65660,4,2,229811,229811,229813,0,2,3
65661,5,2,229816,229816,229818,0,2,3
65662,6,3,229822,229822,229825,0,3,4
65663,4,2,229826,229826,229828,0,2,1
65664,2,2,229828,229828,229830,0,2,0
65665,2,2,229830,229830,229832,0,2,0
65666,1,3,229831,229832,229835,1,4,0
65667,3,2,229834,229835,229837,1,3,0
65668,6,1,229840,229840,229841,0,1,3
65669,6,1,229846,229846,229847,0,1,5
65670,4,1,229850,229850,229851,0,1,3
65671,6,2,229856,229856,229858,0,2,5
65672,4,1,229860,229860,229861,0,1,2
65673,3,1,229863,229863,229864,0,1,2
65674,6,3,229869,229869,229872,0,3,5
65675,5,1,229874,229874,229875,0,1,2
65676,2,2,229876,229876,229878,0,2,1
65677,5,2,229881,229881,229883,0,2,3
65678,1,3,229882,229883,229886,1,4,0
65679,6,1,229888,229888,229889,0,1,2
65680,4,3,229892,229892,229895,0,3,3
65681,2,3,229894,229895,229898,1,4,0
65682,4,2,229898,229898,229900,0,2,0
65683,1,2,229899,229900,229902,1,3,0
65684,4,1,229903,229903,229904,0,1,1
65685,5,2,229908,229908,229910,0,2,4
65686,2,3,229910,229910,229913,0,3,0
65687,1,2,229911,229913,229915,2,4,0
65688,2,3,229913,229915,229918,2,5,0
65689,5,2,229918,229918,229920,0,2,0
65690,6,3,229924,229924,229927,0,3,4
65691,4,3,229928,229928,229931,0,3,1
65692,1,1,229929,229931,229932,2,3,0
65693,5,3,229934,229934,229937,0,3,2
65694,3,3,229937,229937,229940,0,3,0
65695,3,3,229940,229940,229943,0,3,0
65696,4,2,229944,229944,229946,0,2,1
65697,5,1,229949,229949,229950,0,1,3
65698,2,1,229951,229951,229952,0,1,1
65699,6,2,229957,229957,229959,0,2,5
65700,4,3,229961,229961,229964,0,3,2
65701,6,2,229967,229967,229969,0,2,3
65702,6,1,229973,229973,229974,0,1,4
65703,6,3,229979,229979,229982,0,3,5
65704,2,3,229981,229982,229985,1,4,0
65705,6,2,229987,229987,229989,0,2,2
65706,1,1,229988,229989,229990,1,2,0
65707,6,3,229994,229994,229997,0,3,4
65708,4,3,229998,229998,230001,0,3,1
65709,6,3,230004,230004,230007,0,3,3
65710,4,1,230008,230008,230009,0,1,1
65711,3,3,230011,230011,230014,0,3,2
65712,4,2,230015,230015,230017,0,2,1
65713,2,3,230017,230017,230020,0,3,0
65714,2,3,230019,230020,230023,1,4,0
65715,5,1,230024,230024,230025,0,1,1
65716,4,2,230028,230028,230030,0,2,3
65717,4,2,230032,230032,230034,0,2,2
65718,4,2,230036,230036,230038,0,2,2
65719,6,1,230042,230042,230043,0,1,4
65720,4,1,230046,230046,230047,0,1,3
65721,1,2,230047,230047,230049,0,2,0
65722,6,3,230053,230053,230056,0,3,4
65723,1,2,230054,230056,230058,2,4,0
65724,4,2,230058,230058,230060,0,2,0
65725,6,1,230064,230064,230065,0,1,4
65726,3,3,230067,230067,230070,0,3,2
65727,6,2,230073,230073,230075,0,2,3
65728,1,2,230074,230075,230077,1,3,0
65729,5,3,230079,230079,230082,0,3,2
65730,3,3,230082,230082,230085,0,3,0
65731,2,3,230084,230085,230088,1,4,0
65732,2,2,230086,230088,230090,2,4,0
65733,6,3,230092,230092,230095,0,3,2
65734,4,3,230096,230096,230099,0,3,1
65735,5,3,230101,230101,230104,0,3,2
65736,6,2,230107,230107,230109,0,2,3
65737,6,1,230113,230113,230114,0,1,4
65738,2,2,230115,230115,230117,0,2,1
65739,1,3,230116,230117,230120,1,4,0
65740,5,2,230121,230121,230123,0,2,1
65741,3,3,230124,230124,230127,0,3,1
65742,5,3,230129,230129,230132,0,3,2
65743,6,3,230135,230135,230138,0,3,3
65744,4,1,230139,230139,230140,0,1,1
65745,5,1,230144,230144,230145,0,1,4
65746,1,3,230145,230145,230148,0,3,0
65747,1,3,230146,230148,230151,2,5,0
65748,6,3,230152,230152,230155,0,3,1
65749,2,1,230154,230155,230156,1,2,0
65750,5,1,230159,230159,230160,0,1,3
65751,2,3,230161,230161,230164,0,3,1
65752,4,1,230165,230165,230166,0,1,1
65753,4,2,230169,230169,230171,0,2,3
65754,6,1,230175,230175,230176,0,1,4
65755,6,3,230181,230181,230184,0,3,5
65756,5,2,230186,230186,230188,0,2,2
65757,5,2,230191,230191,230193,0,2,3
65758,1,1,230192,230193,230194,1,2,0
65759,5,1,230197,230197,230198,0,1,3
65760,1,1,230198,230198,230199,0,1,0
65761,3,1,230201,230201,230202,0,1,2
65762,6,3,230207,230207,230210,0,3,5
65763,1,3,230208,230210,230213,2,5,0
65764,1,2,230209,230213,230215,4,6,0
65765,3,3,230212,230215,230218,3,6,0
65766,6,2,230218,230218,230220,0,2,0
65767,3,2,230221,230221,230223,0,2,1
65768,6,2,230227,230227,230229,0,2,4
65769,2,2,230229,230229,230231,0,2,0
65770,5,1,230234,230234,230235,0,1,3
65771,6,1,230240,230240,230241,0,1,5
65772,5,2,230245,230245,230247,0,2,4
65773,3,2,230248,230248,230250,0,2,1
65774,4,3,230252,230252,230255,0,3,2
65775,3,3,230255,230255,230258,0,3,0
65776,6,1,230261,230261,230262,0,1,3
65777,2,1,230263,230263,230264,0,1,1
65778,5,3,230268,230268,230271,0,3,4
65779,2,1,230270,230271,230272,1,2,0
65780,3,1,230273,230273,230274,0,1,1
65781,3,2,230276,230276,230278,0,2,2
65782,1,1,230277,230278,230279,1,2,0
65783,6,1,230283,230283,230284,0,1,4
65784,4,1,230287,230287,230288,0,1,3
65785,1,1,230288,230288,230289,0,1,0
65786,4,1,230292,230292,230293,0,1,3
65787,3,1,230295,230295,230296,0,1,2
65788,6,1,230301,230301,230302,0,1,5
65789,6,2,230307,230307,230309,0,2,5
65790,2,3,230309,230309,230312,0,3,0
65791,3,1,230312,230312,230313,0,1,0
65792,4,3,230316,230316,230319,0,3,3
65793,2,2,230318,230319,230321,1,3,0
65794,4,1,230322,230322,230323,0,1,1
65795,1,3,230323,230323,230326,0,3,0
65796,1,3,230324,230326,230329,2,5,0
65797,3,3,230327,230329,230332,2,5,0
65798,1,2,230328,230332,230334,4,6,0
65799,1,1,230329,230334,230335,5,6,0
65800,6,3,230335,230335,230338,0,3,0
65801,1,3,230336,230338,230341,2,5,0
65802,1,1,230337,230341,230342,4,5,0
65803,5,3,230342,230342,230345,0,3,0
65804,4,2,230346,230346,230348,0,2,1
65805,5,3,230351,230351,230354,0,3,3
65806,5,1,230356,230356,230357,0,1,2
65807,1,1,230357,230357,230358,0,1,0
65808,1,3,230358,230358,230361,0,3,0
65809,1,1,230359,230361,230362,2,3,0
65810,3,2,230362,230362,230364,0,2,0
65811,2,3,230364,230364,230367,0,3,0
65812,3,3,230367,230367,230370,0,3,0
65813,2,2,230369,230370,230372,1,3,0
65814,4,2,230373,230373,230375,0,2,1
65815,6,2,230379,230379,230381,0,2,4
65816,6,1,230385,230385,230386,0,1,4
65817,4,1,230389,230389,230390,0,1,3
65818,1,3,230390,230390,230393,0,3,0
65819,4,3,230394,230394,230397,0,3,1
65820,5,3,230399,230399,230402,0,3,2
65821,5,3,230404,230404,230407,0,3,2
65822,4,2,230408,230408,230410,0,2,1
65823,4,3,230412,230412,230415,0,3,2
65824,4,2,230416,230416,230418,0,2,1
65825,6,3,230422,230422,230425,0,3,4
65826,4,2,230426,230426,230428,0,2,1
65827,1,1,230427,230428,230429,1,2,0
65828,4,1,230431,230431,230432,0,1,2
65829,6,3,230437,230437,230440,0,3,5
65830,5,1,230442,230442,230443,0,1,2
65831,1,1,230443,230443,230444,0,1,0
65832,4,1,230447,230447,230448,0,1,3
65833,3,3,230450,230450,230453,0,3,2
65834,5,1,230455,230455,230456,0,1,2
65835,3,1,230458,230458,230459,0,1,2
65836,3,2,230461,230461,230463,0,2,2
65837,5,3,230466,230466,230469,0,3,3
65838,3,1,230469,230469,230470,0,1,0
65839,4,3,230473,230473,230476,0,3,3
65840,4,1,230477,230477,230478,0,1,1
65841,1,2,230478,230478,230480,0,2,0
65842,5,1,230483,230483,230484,0,1,3
65843,3,1,230486,230486,230487,0,1,2
65844,2,3,230488,230488,230491,0,3,1
65845,5,2,230493,230493,230495,0,2,2
65846,5,3,230498,230498,230501,0,3,3
65847,6,1,230504,230504,230505,0,1,3
65848,6,2,230510,230510,230512,0,2,5
65849,6,2,230516,230516,230518,0,2,4
65850,3,1,230519,230519,230520,0,1,1
65851,6,3,230525,230525,230528,0,3,5
65852,1,2,230526,230528,230530,2,4,0
65853,1,3,230527,230530,230533,3,6,0
65854,4,2,230531,230533,230535,2,4,0
65855,1,1,230532,230535,230536,3,4,0
65856,5,2,230537,230537,230539,0,2,1
65857,2,3,230539,230539,230542,0,3,0
65858,3,3,230542,230542,230545,0,3,0
65859,5,1,230547,230547,230548,0,1,2
65860,1,2,230548,230548,230550,0,2,0
65861,6,3,230554,230554,230557,0,3,4
65862,6,3,230560,230560,230563,0,3,3
65863,4,1,230564,230564,230565,0,1,1
65864,5,3,230569,230569,230572,0,3,4
65865,1,3,230570,230572,230575,2,5,0
65866,1,2,230571,230575,230577,4,6,0
65867,1,3,230572,230577,230580,5,8,0
65868,6,1,230578,230580,230581,2,3,0
65869,2,2,230580,230581,230583,1,3,0
65870,3,1,230583,230583,230584,0,1,0
65871,2,1,230585,230585,230586,0,1,1
65872,6,3,230591,230591,230594,0,3,5
65873,4,2,230595,230595,230597,0,2,1
65874,1,2,230596,230597,230599,1,3,0
65875,5,1,230601,230601,230602,0,1,2
65876,6,2,230607,230607,230609,0,2,5
65877,1,2,230608,230609,230611,1,3,0
65878,6,2,230614,230614,230616,0,2,3
65879,6,2,230620,230620,230622,0,2,4
65880,2,1,230622,230622,230623,0,1,0
65881,4,3,230626,230626,230629,0,3,3
65882,3,3,230629,230629,230632,0,3,0
65883,6,2,230635,230635,230637,0,2,3
65884,1,1,230636,230637,230638,1,2,0
65885,5,1,230641,230641,230642,0,1,3
65886,6,2,230647,230647,230649,0,2,5
65887,3,1,230650,230650,230651,0,1,1
65888,4,2,230654,230654,230656,0,2,3
65889,1,2,230655,230656,230658,1,3,0
65890,4,1,230659,230659,230660,0,1,1
65891,1,2,230660,230660,230662,0,2,0
65892,4,2,230664,230664,230666,0,2,2
65893,6,3,230670,230670,230673,0,3,4
65894,6,2,230676,230676,230678,0,2,3
65895,5,2,230681,230681,230683,0,2,3
65896,5,3,230686,230686,230689,0,3,3
65897,6,3,230692,230692,230695,0,3,3
65898,4,3,230696,230696,230699,0,3,1
65899,1,3,230697,230699,230702,2,5,0
65900,2,1,230699,230702,230703,3,4,0
65901,6,1,230705,230705,230706,0,1,2
65902,2,1,230707,230707,230708,0,1,1
65903,2,2,230709,230709,230711,0,2,1
65904,3,3,230712,230712,230715,0,3,1
65905,3,2,230715,230715,230717,0,2,0
65906,4,3,230719,230719,230722,0,3,2
65907,4,3,230723,230723,230726,0,3,1
65908,3,3,230726,230726,230729,0,3,0
65909,4,3,230730,230730,230733,0,3,1
65910,5,3,230735,230735,230738,0,3,2
65911,4,1,230739,230739,230740,0,1,1
65912,1,3,230740,230740,230743,0,3,0
65913,2,1,230742,230743,230744,1,2,0
65914,4,1,230746,230746,230747,0,1,2
65915,2,3,230748,230748,230751,0,3,1
65916,2,1,230750,230751,230752,1,2,0
65917,4,2,230754,230754,230756,0,2,2
65918,3,3,230757,230757,230760,0,3,1
65919,6,2,230763,230763,230765,0,2,3
65920,6,2,230769,230769,230771,0,2,4
65921,1,2,230770,230771,230773,1,3,0
65922,2,2,230772,230773,230775,1,3,0
65923,2,3,230774,230775,230778,1,4,0
65924,3,1,230777,230778,230779,1,2,0
65925,2,3,230779,230779,230782,0,3,0
65926,2,3,230781,230782,230785,1,4,0
65927,2,3,230783,230785,230788,2,5,0
65928,3,2,230786,230788,230790,2,4,0
65929,4,1,230790,230790,230791,0,1,0
65930,3,2,230793,230793,230795,0,2,2
65931,4,1,230797,230797,230798,0,1,2
65932,2,2,230799,230799,230801,0,2,1
65933,3,3,230802,230802,230805,0,3,1
65934,2,1,230804,230805,230806,1,2,0
65935,3,2,230807,230807,230809,0,2,1
65936,2,2,230809,230809,230811,0,2,0
65937,2,1,230811,230811,230812,0,1,0
65938,5,1,230816,230816,230817,0,1,4
65939,3,1,230819,230819,230820,0,1,2
65940,3,1,230822,230822,230823,0,1,2
65941,2,3,230824,230824,230827,0,3,1
65942,1,3,230825,230827,230830,2,5,0
65943,4,2,230829,230830,230832,1,3,0
65944,6,2,230835,230835,230837,0,2,3
65945,1,3,230836,230837,230840,1,4,0
65946,3,2,230839,230840,230842,1,3,0
65947,1,3,230840,230842,230845,2,5,0
65948,5,3,230845,230845,230848,0,3,0
65949,5,2,230850,230850,230852,0,2,2
65950,1,1,230851,230852,230853,1,2,0
65951,5,2,230856,230856,230858,0,2,3
65952,2,1,230858,230858,230859,0,1,0
65953,1,1,230859,230859,230860,0,1,0
65954,5,1,230864,230864,230865,0,1,4
65955,5,1,230869,230869,230870,0,1,4
65956,2,3,230871,230871,230874,0,3,1
65957,2,1,230873,230874,230875,1,2,0
65958,1,3,230874,230875,230878,1,4,0
65959,6,1,230880,230880,230881,0,1,2
65960,3,3,230883,230883,230886,0,3,2
65961,2,2,230885,230886,230888,1,3,0
65962,2,1,230887,230888,230889,1,2,0
65963,1,3,230888,230889,230892,1,4,0
65964,5,1,230893,230893,230894,0,1,1
65965,5,1,230898,230898,230899,0,1,4
65966,6,1,230904,230904,230905,0,1,5
65967,3,1,230907,230907,230908,0,1,2
65968,6,1,230913,230913,230914,0,1,5
65969,4,1,230917,230917,230918,0,1,3
65970,6,2,230923,230923,230925,0,2,5
65971,4,1,230927,230927,230928,0,1,2
65972,3,2,230930,230930,230932,0,2,2
65973,1,1,230931,230932,230933,1,2,0
65974,2,1,230933,230933,230934,0,1,0
65975,6,3,230939,230939,230942,0,3,5
65976,6,1,230945,230945,230946,0,1,3
65977,5,2,230950,230950,230952,0,2,4
65978,6,3,230956,230956,230959,0,3,4
65979,2,1,230958,230959,230960,1,2,0
65980,4,2,230962,230962,230964,0,2,2
65981,6,2,230968,230968,230970,0,2,4
65982,6,2,230974,230974,230976,0,2,4
65983,5,2,230979,230979,230981,0,2,3
65984,6,2,230985,230985,230987,0,2,4
65985,2,1,230987,230987,230988,0,1,0
65986,3,2,230990,230990,230992,0,2,2
65987,2,1,230992,230992,230993,0,1,0
65988,1,3,230993,230993,230996,0,3,0
65989,5,2,230998,230998,231000,0,2,2
65990,5,2,231003,231003,231005,0,2,3
65991,1,1,231004,231005,231006,1,2,0
65992,3,1,231007,231007,231008,0,1,1
65993,2,1,231009,231009,231010,0,1,1
65994,5,3,231014,231014,231017,0,3,4
65995,6,2,231020,231020,231022,0,2,3
65996,6,3,231026,231026,231029,0,3,4
65997,2,3,231028,231029,231032,1,4,0
65998,2,3,231030,231032,231035,2,5,0
65999,6,1,231036,231036,231037,0,1,1
66000,5,2,231041,231041,231043,0,2,4
66001,5,1,231046,231046,231047,0,1,3
66002,2,3,231048,231048,231051,0,3,1
66003,2,2,231050,231051,231053,1,3,0
66004,2,2,231052,231053,231055,1,3,0
66005,3,1,231055,231055,231056,0,1,0
66006,3,3,231058,231058,231061,0,3,2
66007,6,1,231064,231064,231065,0,1,3
66008,5,3,231069,231069,231072,0,3,4
66009,3,1,231072,231072,231073,0,1,0
66010,2,3,231074,231074,231077,0,3,1
66011,5,1,231079,231079,231080,0,1,2
66012,1,2,231080,231080,231082,0,2,0
66013,4,2,231084,231084,231086,0,2,2
66014,5,2,231089,231089,231091,0,2,3
66015,4,1,231093,231093,231094,0,1,2
66016,3,2,231096,231096,231098,0,2,2
66017,3,3,231099,231099,231102,0,3,1
66018,3,3,231102,231102,231105,0,3,0
66019,5,3,231107,231107,231110,0,3,2
66020,4,1,231111,231111,231112,0,1,1
66021,3,1,231114,231114,231115,0,1,2
66022,2,1,231116,231116,231117,0,1,1
66023,4,1,231120,231120,231121,0,1,3
66024,5,3,231125,231125,231128,0,3,4
66025,3,2,231128,231128,231130,0,2,0
66026,3,2,231131,231131,231133,0,2,1
66027,4,3,231135,231135,231138,0,3,2
66028,6,1,231141,231141,231142,0,1,3
66029,3,2,231144,231144,231146,0,2,2
66030,6,2,231150,231150,231152,0,2,4
66031,3,3,231153,231153,231156,0,3,1
66032,6,3,231159,231159,231162,0,3,3
66033,1,1,231160,231162,231163,2,3,0
66034,3,2,231163,231163,231165,0,2,0
66035,4,1,231167,231167,231168,0,1,2
66036,6,3,231173,231173,231176,0,3,5
66037,6,3,231179,231179,231182,0,3,3
66038,4,2,231183,231183,231185,0,2,1
66039,3,3,231186,231186,231189,0,3,1
66040,2,2,231188,231189,231191,1,3,0
66041,5,3,231193,231193,231196,0,3,2
66042,1,1,231194,231196,231197,2,3,0
66043,2,1,231196,231197,231198,1,2,0
66044,5,1,231201,231201,231202,0,1,3
66045,3,1,231204,231204,231205,0,1,2
66046,2,3,231206,231206,231209,0,3,1
66047,5,3,231211,231211,231214,0,3,2
66048,5,2,231216,231216,231218,0,2,2
66049,2,1,231218,231218,231219,0,1,0
66050,3,2,231221,231221,231223,0,2,2
66051,4,2,231225,231225,231227,0,2,2
66052,2,1,231227,231227,231228,0,1,0
66053,5,1,231232,231232,231233,0,1,4
66054,2,3,231234,231234,231237,0,3,1
66055,1,2,231235,231237,231239,2,4,0
66056,5,1,231240,231240,231241,0,1,1
66057,2,2,231242,231242,231244,0,2,1
66058,3,1,231245,231245,231246,0,1,1
66059,1,3,231246,231246,231249,0,3,0
66060,3,3,231249,231249,231252,0,3,0
66061,4,2,231253,231253,231255,0,2,1
66062,4,1,231257,231257,231258,0,1,2
66063,1,2,231258,231258,231260,0,2,0
66064,1,3,231259,231260,231263,1,4,0
66065,4,2,231263,231263,231265,0,2,0
66066,2,2,231265,231265,231267,0,2,0
66067,6,1,231271,231271,231272,0,1,4
66068,6,2,231277,231277,231279,0,2,5
66069,3,2,231280,231280,231282,0,2,1
66070,1,3,231281,231282,231285,1,4,0
66071,4,3,231285,231285,231288,0,3,0
66072,1,2,231286,231288,231290,2,4,0
66073,2,3,231288,231290,231293,2,5,0
66074,1,3,231289,231293,231296,4,7,0
66075,6,1,231295,231296,231297,1,2,0
66076,1,3,231296,231297,231300,1,4,0
66077,5,1,231301,231301,231302,0,1,1
66078,1,1,231302,231302,231303,0,1,0
66079,5,3,231307,231307,231310,0,3,4
66080,6,1,231313,231313,231314,0,1,3
66081,5,2,231318,231318,231320,0,2,4
66082,2,2,231320,231320,231322,0,2,0
66083,5,2,231325,231325,231327,0,2,3
66084,2,1,231327,231327,231328,0,1,0
66085,6,1,231333,231333,231334,0,1,5
66086,4,1,231337,231337,231338,0,1,3
66087,1,3,231338,231338,231341,0,3,0
66088,3,1,231341,231341,231342,0,1,0
66089,5,3,231346,231346,231349,0,3,4
66090,1,1,231347,231349,231350,2,3,0
66091,2,2,231349,231350,231352,1,3,0
66092,1,2,231350,231352,231354,2,4,0
66093,1,2,231351,231354,231356,3,5,0
66094,3,2,231354,231356,231358,2,4,0
66095,2,1,231356,231358,231359,2,3,0
66096,4,1,231360,231360,231361,0,1,1
66097,4,1,231364,231364,231365,0,1,3
66098,4,2,231368,231368,231370,0,2,3
66099,4,3,231372,231372,231375,0,3,2
66100,4,2,231376,231376,231378,0,2,1
66101,3,2,231379,231379,231381,0,2,1
66102,5,3,231384,231384,231387,0,3,3
66103,4,3,231388,231388,231391,0,3,1
66104,3,3,231391,231391,231394,0,3,0
66105,1,2,231392,231394,231396,2,4,0
66106,6,3,231398,231398,231401,0,3,2
66107,6,1,231404,231404,231405,0,1,3
66108,5,2,231409,231409,231411,0,2,4
66109,3,1,231412,231412,231413,0,1,1
66110,5,2,231417,231417,231419,0,2,4
66111,5,3,231422,231422,231425,0,3,3
66112,5,2,231427,231427,231429,0,2,2
66113,2,3,231429,231429,231432,0,3,0
66114,3,2,231432,231432,231434,0,2,0
66115,2,1,231434,231434,231435,0,1,0
66116,2,1,231436,231436,231437,0,1,1
66117,4,1,231440,231440,231441,0,1,3
66118,2,1,231442,231442,231443,0,1,1
66119,5,3,231447,231447,231450,0,3,4
66120,2,3,231449,231450,231453,1,4,0
66121,1,3,231450,231453,231456,3,6,0
66122,5,1,231455,231456,231457,1,2,0
66123,2,1,231457,231457,231458,0,1,0
66124,4,2,231461,231461,231463,0,2,3
66125,3,2,231464,231464,231466,0,2,1
66126,5,1,231469,231469,231470,0,1,3
66127,6,2,231475,231475,231477,0,2,5
66128,5,2,231480,231480,231482,0,2,3
66129,5,3,231485,231485,231488,0,3,3
66130,4,3,231489,231489,231492,0,3,1
66131,5,2,231494,231494,231496,0,2,2
66132,3,2,231497,231497,231499,0,2,1
66133,2,2,231499,231499,231501,0,2,0
66134,6,3,231505,231505,231508,0,3,4
66135,5,2,231510,231510,231512,0,2,2
66136,6,1,231516,231516,231517,0,1,4
66137,2,2,231518,231518,231520,0,2,1
66138,2,2,231520,231520,231522,0,2,0
66139,3,2,231523,231523,231525,0,2,1
66140,5,1,231528,231528,231529,0,1,3
66141,4,3,231532,231532,231535,0,3,3
66142,1,3,231533,231535,231538,2,5,0
66143,2,1,231535,231538,231539,3,4,0
66144,6,2,231541,231541,231543,0,2,2
66145,4,3,231545,231545,231548,0,3,2
66146,3,2,231548,231548,231550,0,2,0
66147,1,2,231549,231550,231552,1,3,0
66148,1,3,231550,231552,231555,2,5,0
66149,5,3,231555,231555,231558,0,3,0
66150,3,3,231558,231558,231561,0,3,0
66151,1,2,231559,231561,231563,2,4,0
66152,6,2,231565,231565,231567,0,2,2
66153,5,3,231570,231570,231573,0,3,3
66154,2,3,231572,231573,231576,1,4,0
66155,3,2,231575,231576,231578,1,3,0
66156,2,3,231577,231578,231581,1,4,0
66157,2,2,231579,231581,231583,2,4,0
66158,6,2,231585,231585,231587,0,2,2
66159,1,2,231586,231587,231589,1,3,0
66160,3,1,231589,231589,231590,0,1,0
66161,3,3,231592,231592,231595,0,3,2
66162,6,2,231598,231598,231600,0,2,3
66163,5,3,231603,231603,231606,0,3,3
66164,5,3,231608,231608,231611,0,3,2
66165,6,2,231614,231614,231616,0,2,3
66166,3,1,231617,231617,231618,0,1,1
66167,1,1,231618,231618,231619,0,1,0
66168,1,1,231619,231619,231620,0,1,0
66169,1,1,231620,231620,231621,0,1,0
66170,4,3,231624,231624,231627,0,3,3
66171,5,3,231629,231629,231632,0,3,2
66172,2,2,231631,231632,231634,1,3,0
66173,1,1,231632,231634,231635,2,3,0
66174,3,2,231635,231635,231637,0,2,0
66175,6,2,231641,231641,231643,0,2,4
66176,1,2,231642,231643,231645,1,3,0
66177,5,3,231647,231647,231650,0,3,2
66178,3,1,231650,231650,231651,0,1,0
66179,2,2,231652,231652,231654,0,2,1
66180,6,3,231658,231658,231661,0,3,4
66181,5,2,231663,231663,231665,0,2,2
66182,4,2,231667,231667,231669,0,2,2
66183,5,1,231672,231672,231673,0,1,3
66184,6,2,231678,231678,231680,0,2,5
66185,3,2,231681,231681,231683,0,2,1
66186,4,1,231685,231685,231686,0,1,2
66187,5,2,231690,231690,231692,0,2,4
66188,1,3,231691,231692,231695,1,4,0
66189,3,1,231694,231695,231696,1,2,0
66190,6,2,231700,231700,231702,0,2,4
66191,3,3,231703,231703,231706,0,3,1
66192,1,3,231704,231706,231709,2,5,0
66193,2,2,231706,231709,231711,3,5,0
66194,3,3,231709,231711,231714,2,5,0
66195,1,1,231710,231714,231715,4,5,0
66196,4,2,231714,231715,231717,1,3,0
66197,1,2,231715,231717,231719,2,4,0
66198,6,1,231721,231721,231722,0,1,2
66199,5,3,231726,231726,231729,0,3,4
66200,3,3,231729,231729,231732,0,3,0
66201,5,3,231734,231734,231737,0,3,2
66202,6,3,231740,231740,231743,0,3,3
66203,4,2,231744,231744,231746,0,2,1
66204,5,3,231749,231749,231752,0,3,3
66205,4,1,231753,231753,231754,0,1,1
66206,3,2,231756,231756,231758,0,2,2
66207,2,3,231758,231758,231761,0,3,0
66208,5,1,231763,231763,231764,0,1,2
66209,5,3,231768,231768,231771,0,3,4
66210,2,2,231770,231771,231773,1,3,0
66211,2,1,231772,231773,231774,1,2,0
66212,1,2,231773,231774,231776,1,3,0
66213,1,3,231774,231776,231779,2,5,0
66214,4,2,231778,231779,231781,1,3,0
66215,5,3,231783,231783,231786,0,3,2
66216,4,1,231787,231787,231788,0,1,1
66217,1,1,231788,231788,231789,0,1,0
66218,2,3,231790,231790,231793,0,3,1
66219,3,1,231793,231793,231794,0,1,0
66220,6,3,231799,231799,231802,0,3,5
66221,1,1,231800,231802,231803,2,3,0
66222,5,1,231805,231805,231806,0,1,2
66223,5,3,231810,231810,231813,0,3,4
66224,1,1,231811,231813,231814,2,3,0
66225,3,1,231814,231814,231815,0,1,0
66226,1,3,231815,231815,231818,0,3,0
66227,3,3,231818,231818,231821,0,3,0
66228,6,3,231824,231824,231827,0,3,3
66229,5,1,231829,231829,231830,0,1,2
66230,6,2,231835,231835,231837,0,2,5
66231,2,1,231837,231837,231838,0,1,0
66232,4,2,231841,231841,231843,0,2,3
66233,4,2,231845,231845,231847,0,2,2
66234,4,3,231849,231849,231852,0,3,2
66235,5,3,231854,231854,231857,0,3,2
66236,4,3,231858,231858,231861,0,3,1
66237,6,3,231864,231864,231867,0,3,3
66238,4,3,231868,231868,231871,0,3,1
66239,1,3,231869,231871,231874,2,5,0
66240,4,3,231873,231874,231877,1,4,0
66241,5,2,231878,231878,231880,0,2,1
66242,3,2,231881,231881,231883,0,2,1
66243,3,1,231884,231884,231885,0,1,1
66244,4,1,231888,231888,231889,0,1,3
66245,2,3,231890,231890,231893,0,3,1
66246,5,1,231895,231895,231896,0,1,2
66247,1,3,231896,231896,231899,0,3,0
66248,5,1,231901,231901,231902,0,1,2
66249,1,1,231902,231902,231903,0,1,0
66250,1,2,231903,231903,231905,0,2,0
66251,3,1,231906,231906,231907,0,1,1
66252,3,3,231909,231909,231912,0,3,2
66253,4,3,231913,231913,231916,0,3,1
66254,2,3,231915,231916,231919,1,4,0
66255,3,2,231918,231919,231921,1,3,0
66256,1,1,231919,231921,231922,2,3,0
66257,1,1,231920,231922,231923,2,3,0
66258,3,1,231923,231923,231924,0,1,0
66259,3,3,231926,231926,231929,0,3,2
66260,6,3,231932,231932,231935,0,3,3
66261,5,1,231937,231937,231938,0,1,2
66262,1,2,231938,231938,231940,0,2,0
66263,6,1,231944,231944,231945,0,1,4
66264,5,2,231949,231949,231951,0,2,4
66265,3,3,231952,231952,231955,0,3,1
66266,5,2,231957,231957,231959,0,2,2
66267,6,1,231963,231963,231964,0,1,4
66268,6,2,231969,231969,231971,0,2,5
66269,6,2,231975,231975,231977,0,2,4
66270,6,1,231981,231981,231982,0,1,4
66271,2,2,231983,231983,231985,0,2,1
66272,5,2,231988,231988,231990,0,2,3
66273,6,1,231994,231994,231995,0,1,4
66274,6,2,232000,232000,232002,0,2,5
66275,4,1,232004,232004,232005,0,1,2
66276,6,1,232010,232010,232011,0,1,5
66277,1,2,232011,232011,232013,0,2,0
66278,6,3,232017,232017,232020,0,3,4
66279,2,3,232019,232020,232023,1,4,0
66280,4,2,232023,232023,232025,0,2,0
66281,4,2,232027,232027,232029,0,2,2
66282,1,2,232028,232029,232031,1,3,0
66283,4,2,232032,232032,232034,0,2,1
66284,5,1,232037,232037,232038,0,1,3
66285,4,2,232041,232041,232043,0,2,3
66286,4,1,232045,232045,232046,0,1,2
66287,6,3,232051,232051,232054,0,3,5
66288,4,2,232055,232055,232057,0,2,1
66289,6,3,232061,232061,232064,0,3,4
66290,4,1,232065,232065,232066,0,1,1
66291,2,2,232067,232067,232069,0,2,1
66292,4,3,232071,232071,232074,0,3,2
66293,4,1,232075,232075,232076,0,1,1
66294,3,1,232078,232078,232079,0,1,2
66295,2,2,232080,232080,232082,0,2,1
66296,6,2,232086,232086,232088,0,2,4
66297,4,1,232090,232090,232091,0,1,2
66298,4,2,232094,232094,232096,0,2,3
66299,3,2,232097,232097,232099,0,2,1
66300,3,3,232100,232100,232103,0,3,1
66301,4,1,232104,232104,232105,0,1,1
66302,5,3,232109,232109,232112,0,3,4
66303,1,1,232110,232112,232113,2,3,0
66304,6,3,232116,232116,232119,0,3,3
66305,6,1,232122,232122,232123,0,1,3
66306,3,2,232125,232125,232127,0,2,2
66307,4,2,232129,232129,232131,0,2,2
66308,3,2,232132,232132,232134,0,2,1
66309,1,3,232133,232134,232137,1,4,0
66310,4,3,232137,232137,232140,0,3,0
66311,6,3,232143,232143,232146,0,3,3
66312,5,3,232148,232148,232151,0,3,2
66313,2,2,232150,232151,232153,1,3,0
66314,2,2,232152,232153,232155,1,3,0
66315,2,3,232154,232155,232158,1,4,0
66316,5,2,232159,232159,232161,0,2,1
66317,1,1,232160,232161,232162,1,2,0
66318,4,3,232164,232164,232167,0,3,2
66319,3,3,232167,232167,232170,0,3,0
66320,1,2,232168,232170,232172,2,4,0
66321,6,2,232174,232174,232176,0,2,2
66322,3,1,232177,232177,232178,0,1,1
66323,3,3,232180,232180,232183,0,3,2
66324,2,1,232182,232183,232184,1,2,0
66325,5,1,232187,232187,232188,0,1,3
66326,5,3,232192,232192,232195,0,3,4
66327,6,2,232198,232198,232200,0,2,3
66328,5,3,232203,232203,232206,0,3,3
66329,3,3,232206,232206,232209,0,3,0
66330,3,3,232209,232209,232212,0,3,0
66331,2,2,232211,232212,232214,1,3,0
66332,1,2,232212,232214,232216,2,4,0
66333,2,2,232214,232216,232218,2,4,0
66334,4,3,232218,232218,232221,0,3,0
66335,6,3,232224,232224,232227,0,3,3
66336,1,3,232225,232227,232230,2,5,0
66337,1,3,232226,232230,232233,4,7,0
66338,3,1,232229,232233,232234,4,5,0
66339,6,3,232235,232235,232238,0,3,1
66340,5,3,232240,232240,232243,0,3,2
66341,2,1,232242,232243,232244,1,2,0
66342,5,3,232247,232247,232250,0,3,3
66343,3,3,232250,232250,232253,0,3,0
66344,4,2,232254,232254,232256,0,2,1
66345,2,1,232256,232256,232257,0,1,0
66346,1,3,232257,232257,232260,0,3,0
66347,2,2,232259,232260,232262,1,3,0
66348,1,3,232260,232262,232265,2,5,0
66349,6,1,232266,232266,232267,0,1,1
66350,1,3,232267,232267,232270,0,3,0
66351,2,2,232269,232270,232272,1,3,0
66352,2,2,232271,232272,232274,1,3,0
66353,1,2,232272,232274,232276,2,4,0
66354,2,1,232274,232276,232277,2,3,0
66355,2,1,232276,232277,232278,1,2,0
66356,1,2,232277,232278,232280,1,3,0
66357,2,1,232279,232280,232281,1,2,0
66358,3,1,232282,232282,232283,0,1,1
66359,5,2,232287,232287,232289,0,2,4
66360,3,1,232290,232290,232291,0,1,1
66361,5,2,232295,232295,232297,0,2,4
66362,6,3,232301,232301,232304,0,3,4
66363,4,3,232305,232305,232308,0,3,1
66364,1,2,232306,232308,232310,2,4,0
66365,2,1,232308,232310,232311,2,3,0
66366,5,3,232313,232313,232316,0,3,2
66367,4,1,232317,232317,232318,0,1,1
66368,2,1,232319,232319,232320,0,1,1
66369,3,2,232322,232322,232324,0,2,2
66370,6,2,232328,232328,232330,0,2,4
66371,3,1,232331,232331,232332,0,1,1
66372,6,1,232337,232337,232338,0,1,5
66373,6,1,232343,232343,232344,0,1,5
66374,4,3,232347,232347,232350,0,3,3
66375,1,1,232348,232350,232351,2,3,0
66376,2,3,232350,232351,232354,1,4,0
66377,2,3,232352,232354,232357,2,5,0
66378,2,3,232354,232357,232360,3,6,0
66379,6,1,232360,232360,232361,0,1,0
66380,5,2,232365,232365,232367,0,2,4
66381,4,3,232369,232369,232372,0,3,2
66382,5,1,232374,232374,232375,0,1,2
66383,5,1,232379,232379,232380,0,1,4
66384,3,1,232382,232382,232383,0,1,2
66385,5,1,232387,232387,232388,0,1,4
66386,6,2,232393,232393,232395,0,2,5
66387,5,1,232398,232398,232399,0,1,3
66388,5,2,232403,232403,232405,0,2,4
66389,3,3,232406,232406,232409,0,3,1
66390,4,2,232410,232410,232412,0,2,1
66391,5,1,232415,232415,232416,0,1,3
66392,5,2,232420,232420,232422,0,2,4
66393,2,3,232422,232422,232425,0,3,0
66394,2,2,232424,232425,232427,1,3,0
66395,6,1,232430,232430,232431,0,1,3
66396,2,3,232432,232432,232435,0,3,1
66397,6,3,232438,232438,232441,0,3,3
66398,2,3,232440,232441,232444,1,4,0
66399,6,3,232446,232446,232449,0,3,2
66400,1,3,232447,232449,232452,2,5,0
66401,1,1,232448,232452,232453,4,5,0
66402,2,2,232450,232453,232455,3,5,0
66403,4,1,232454,232455,232456,1,2,0
66404,3,3,232457,232457,232460,0,3,1
66405,6,3,232463,232463,232466,0,3,3
66406,5,2,232468,232468,232470,0,2,2
66407,3,1,232471,232471,232472,0,1,1
66408,5,1,232476,232476,232477,0,1,4
66409,4,3,232480,232480,232483,0,3,3
66410,6,3,232486,232486,232489,0,3,3
66411,6,2,232492,232492,232494,0,2,3
66412,6,3,232498,232498,232501,0,3,4
66413,2,2,232500,232501,232503,1,3,0
66414,5,1,232505,232505,232506,0,1,2
66415,4,3,232509,232509,232512,0,3,3
66416,3,1,232512,232512,232513,0,1,0
66417,1,1,232513,232513,232514,0,1,0
66418,5,3,232518,232518,232521,0,3,4
66419,1,1,232519,232521,232522,2,3,0
66420,5,1,232524,232524,232525,0,1,2
66421,3,1,232527,232527,232528,0,1,2
66422,5,2,232532,232532,232534,0,2,4
66423,6,2,232538,232538,232540,0,2,4
66424,1,3,232539,232540,232543,1,4,0
66425,3,2,232542,232543,232545,1,3,0
66426,5,3,232547,232547,232550,0,3,2
66427,5,2,232552,232552,232554,0,2,2
66428,6,3,232558,232558,232561,0,3,4
66429,2,1,232560,232561,232562,1,2,0
66430,5,1,232565,232565,232566,0,1,3
66431,1,1,232566,232566,232567,0,1,0
66432,4,1,232570,232570,232571,0,1,3
66433,3,3,232573,232573,232576,0,3,2
66434,4,2,232577,232577,232579,0,2,1
66435,6,2,232583,232583,232585,0,2,4
66436,6,1,232589,232589,232590,0,1,4
66437,2,1,232591,232591,232592,0,1,1
66438,6,1,232597,232597,232598,0,1,5
66439,3,1,232600,232600,232601,0,1,2
66440,2,2,232602,232602,232604,0,2,1
66441,1,1,232603,232604,232605,1,2,0
66442,1,1,232604,232605,232606,1,2,0
66443,2,2,232606,232606,232608,0,2,0
66444,5,3,232611,232611,232614,0,3,3
66445,5,2,232616,232616,232618,0,2,2
66446,3,1,232619,232619,232620,0,1,1
66447,3,2,232622,232622,232624,0,2,2
66448,1,3,232623,232624,232627,1,4,0
66449,3,1,232626,232627,232628,1,2,0
66450,2,2,232628,232628,232630,0,2,0
66451,6,1,232634,232634,232635,0,1,4
66452,6,1,232640,232640,232641,0,1,5
66453,2,3,232642,232642,232645,0,3,1
66454,2,2,232644,232645,232647,1,3,0
66455,4,3,232648,232648,232651,0,3,1
66456,2,3,232650,232651,232654,1,4,0
66457,6,2,232656,232656,232658,0,2,2
66458,4,1,232660,232660,232661,0,1,2
66459,2,1,232662,232662,232663,0,1,1
66460,3,3,232665,232665,232668,0,3,2
66461,4,2,232669,232669,232671,0,2,1
66462,1,3,232670,232671,232674,1,4,0
66463,4,3,232674,232674,232677,0,3,0
66464,2,2,232676,232677,232679,1,3,0
66465,2,1,232678,232679,232680,1,2,0
66466,2,3,232680,232680,232683,0,3,0
66467,2,1,232682,232683,232684,1,2,0
66468,5,1,232687,232687,232688,0,1,3
66469,1,1,232688,232688,232689,0,1,0
66470,6,2,232694,232694,232696,0,2,5
66471,2,1,232696,232696,232697,0,1,0
66472,3,2,232699,232699,232701,0,2,2
66473,6,1,232705,232705,232706,0,1,4
66474,4,3,232709,232709,232712,0,3,3
66475,6,2,232715,232715,232717,0,2,3
66476,2,3,232717,232717,232720,0,3,0
66477,2,1,232719,232720,232721,1,2,0
66478,4,1,232723,232723,232724,0,1,2
66479,6,2,232729,232729,232731,0,2,5
66480,4,3,232733,232733,232736,0,3,2
66481,5,1,232738,232738,232739,0,1,2
66482,2,1,232740,232740,232741,0,1,1
66483,6,1,232746,232746,232747,0,1,5
66484,3,1,232749,232749,232750,0,1,2
66485,2,2,232751,232751,232753,0,2,1
66486,3,3,232754,232754,232757,0,3,1
66487,2,1,232756,232757,232758,1,2,0
66488,1,2,232757,232758,232760,1,3,0
66489,6,1,232763,232763,232764,0,1,3
66490,1,1,232764,232764,232765,0,1,0
66491,3,3,232767,232767,232770,0,3,2
66492,5,1,232772,232772,232773,0,1,2
66493,5,1,232777,232777,232778,0,1,4
66494,4,1,232781,232781,232782,0,1,3
66495,5,1,232786,232786,232787,0,1,4
66496,2,2,232788,232788,232790,0,2,1
66497,6,2,232794,232794,232796,0,2,4
66498,5,1,232799,232799,232800,0,1,3
66499,3,1,232802,232802,232803,0,1,2
66500,3,3,232805,232805,232808,0,3,2
66501,1,2,232806,232808,232810,2,4,0
66502,2,3,232808,232810,232813,2,5,0
66503,5,1,232813,232813,232814,0,1,0
66504,5,2,232818,232818,232820,0,2,4
66505,5,3,232823,232823,232826,0,3,3
66506,6,3,232829,232829,232832,0,3,3
66507,5,3,232834,232834,232837,0,3,2
66508,6,3,232840,232840,232843,0,3,3
66509,6,2,232846,232846,232848,0,2,3
66510,3,3,232849,232849,232852,0,3,1
66511,6,3,232855,232855,232858,0,3,3
66512,5,3,232860,232860,232863,0,3,2
66513,5,2,232865,232865,232867,0,2,2
66514,5,1,232870,232870,232871,0,1,3
66515,3,3,232873,232873,232876,0,3,2
66516,5,1,232878,232878,232879,0,1,2
66517,6,1,232884,232884,232885,0,1,5
66518,1,2,232885,232885,232887,0,2,0
66519,1,2,232886,232887,232889,1,3,0
66520,2,3,232888,232889,232892,1,4,0
66521,3,1,232891,232892,232893,1,2,0
66522,2,3,232893,232893,232896,0,3,0
66523,4,1,232897,232897,232898,0,1,1
66524,3,2,232900,232900,232902,0,2,2
66525,6,3,232906,232906,232909,0,3,4
66526,3,1,232909,232909,232910,0,1,0
66527,4,3,232913,232913,232916,0,3,3
66528,1,3,232914,232916,232919,2,5,0
66529,3,1,232917,232919,232920,2,3,0
66530,5,2,232922,232922,232924,0,2,2
66531,3,3,232925,232925,232928,0,3,1
66532,5,2,232930,232930,232932,0,2,2
66533,1,1,232931,232932,232933,1,2,0
66534,3,2,232934,232934,232936,0,2,1
66535,2,1,232936,232936,232937,0,1,0
66536,6,2,232942,232942,232944,0,2,5
66537,5,1,232947,232947,232948,0,1,3
66538,3,2,232950,232950,232952,0,2,2
66539,4,1,232954,232954,232955,0,1,2
66540,6,2,232960,232960,232962,0,2,5
66541,6,3,232966,232966,232969,0,3,4
66542,4,3,232970,232970,232973,0,3,1
66543,5,3,232975,232975,232978,0,3,2
66544,6,1,232981,232981,232982,0,1,3
66545,1,2,232982,232982,232984,0,2,0
66546,1,1,232983,232984,232985,1,2,0
66547,3,1,232986,232986,232987,0,1,1
66548,2,2,232988,232988,232990,0,2,1
66549,2,2,232990,232990,232992,0,2,0
66550,6,2,232996,232996,232998,0,2,4
66551,5,3,233001,233001,233004,0,3,3
66552,3,2,233004,233004,233006,0,2,0
66553,2,1,233006,233006,233007,0,1,0
66554,1,1,233007,233007,233008,0,1,0
66555,2,2,233009,233009,233011,0,2,1
66556,4,2,233013,233013,233015,0,2,2
66557,5,1,233018,233018,233019,0,1,3
66558,4,3,233022,233022,233025,0,3,3
66559,2,2,233024,233025,233027,1,3,0
66560,4,2,233028,233028,233030,0,2,1
66561,6,2,233034,233034,233036,0,2,4
66562,3,3,233037,233037,233040,0,3,1
66563,4,3,233041,233041,233044,0,3,1
66564,6,1,233047,233047,233048,0,1,3
66565,1,2,233048,233048,233050,0,2,0
66566,2,1,233050,233050,233051,0,1,0
66567,4,2,233054,233054,233056,0,2,3
66568,2,3,233056,233056,233059,0,3,0
66569,4,3,233060,233060,233063,0,3,1
66570,1,3,233061,233063,233066,2,5,0
66571,1,3,233062,233066,233069,4,7,0
66572,1,1,233063,233069,233070,6,7,0
66573,1,2,233064,233070,233072,6,8,0
66574,3,1,233067,233072,233073,5,6,0
66575,1,3,233068,233073,233076,5,8,0
66576,4,3,233072,233076,233079,4,7,0
66577,1,3,233073,233079,233082,6,9,0
66578,2,1,233075,233082,233083,7,8,0
66579,6,1,233081,233083,233084,2,3,0
66580,6,1,233087,233087,233088,0,1,3
66581,2,3,233089,233089,233092,0,3,1
66582,4,1,233093,233093,233094,0,1,1
66583,3,3,233096,233096,233099,0,3,2
66584,6,3,233102,233102,233105,0,3,3
66585,5,1,233107,233107,233108,0,1,2
66586,5,2,233112,233112,233114,0,2,4
66587,4,1,233116,233116,233117,0,1,2
66588,2,2,233118,233118,233120,0,2,1
66589,3,1,233121,233121,233122,0,1,1
66590,6,3,233127,233127,233130,0,3,5
66591,5,3,233132,233132,233135,0,3,2
66592,2,3,233134,233135,233138,1,4,0
66593,2,2,233136,233138,233140,2,4,0
66594,6,3,233142,233142,233145,0,3,2
66595,2,1,233144,233145,233146,1,2,0
66596,2,1,233146,233146,233147,0,1,0
66597,2,2,233148,233148,233150,0,2,1
66598,4,1,233152,233152,233153,0,1,2
66599,1,3,233153,233153,233156,0,3,0
66600,2,1,233155,233156,233157,1,2,0
66601,1,3,233156,233157,233160,1,4,0
66602,4,1,233160,233160,233161,0,1,0
66603,2,3,233162,233162,233165,0,3,1
66604,1,3,233163,233165,233168,2,5,0
66605,5,2,233168,233168,233170,0,2,0
66606,2,3,233170,233170,233173,0,3,0
66607,2,2,233172,233173,233175,1,3,0
66608,2,1,233174,233175,233176,1,2,0
66609,4,2,233178,233178,233180,0,2,2
66610,5,3,233183,233183,233186,0,3,3
66611,4,2,233187,233187,233189,0,2,1
66612,1,1,233188,233189,233190,1,2,0
66613,3,1,233191,233191,233192,0,1,1
66614,5,2,233196,233196,233198,0,2,4
66615,4,1,233200,233200,233201,0,1,2
66616,3,2,233203,233203,233205,0,2,2
66617,1,3,233204,233205,233208,1,4,0
66618,1,2,233205,233208,233210,3,5,0
66619,2,1,233207,233210,233211,3,4,0
66620,5,1,233212,233212,233213,0,1,1
66621,2,3,233214,233214,233217,0,3,1
66622,5,3,233219,233219,233222,0,3,2
66623,5,3,233224,233224,233227,0,3,2
66624,5,2,233229,233229,233231,0,2,2
66625,5,3,233234,233234,233237,0,3,3
66626,5,1,233239,233239,233240,0,1,2
66627,6,3,233245,233245,233248,0,3,5
66628,4,3,233249,233249,233252,0,3,1
66629,5,2,233254,233254,233256,0,2,2
66630,3,2,233257,233257,233259,0,2,1
66631,2,1,233259,233259,233260,0,1,0
66632,4,1,233263,233263,233264,0,1,3
66633,6,1,233269,233269,233270,0,1,5
66634,3,1,233272,233272,233273,0,1,2
66635,6,1,233278,233278,233279,0,1,5
66636,3,2,233281,233281,233283,0,2,2
66637,6,1,233287,233287,233288,0,1,4
66638,6,2,233293,233293,233295,0,2,5
66639,4,3,233297,233297,233300,0,3,2
66640,2,1,233299,233300,233301,1,2,0
66641,1,2,233300,233301,233303,1,3,0
66642,4,1,233304,233304,233305,0,1,1
66643,3,1,233307,233307,233308,0,1,2
66644,6,3,233313,233313,233316,0,3,5
66645,5,2,233318,233318,233320,0,2,2
66646,6,1,233324,233324,233325,0,1,4
66647,5,3,233329,233329,233332,0,3,4
66648,4,1,233333,233333,233334,0,1,1
66649,4,3,233337,233337,233340,0,3,3
66650,1,2,233338,233340,233342,2,4,0
66651,6,1,233344,233344,233345,0,1,2
66652,6,2,233350,233350,233352,0,2,5
66653,5,3,233355,233355,233358,0,3,3
66654,5,1,233360,233360,233361,0,1,2
66655,3,1,233363,233363,233364,0,1,2
66656,3,1,233366,233366,233367,0,1,2
66657,6,3,233372,233372,233375,0,3,5
66658,2,2,233374,233375,233377,1,3,0
66659,5,1,233379,233379,233380,0,1,2
66660,1,3,233380,233380,233383,0,3,0
66661,4,3,233384,233384,233387,0,3,1
66662,2,3,233386,233387,233390,1,4,0
66663,4,3,233390,233390,233393,0,3,0
66664,5,1,233395,233395,233396,0,1,2
66665,2,3,233397,233397,233400,0,3,1
66666,3,3,233400,233400,233403,0,3,0
66667,4,1,233404,233404,233405,0,1,1
66668,1,2,233405,233405,233407,0,2,0
66669,6,2,233411,233411,233413,0,2,4
66670,5,2,233416,233416,233418,0,2,3
66671,1,3,233417,233418,233421,1,4,0
66672,6,1,233423,233423,233424,0,1,2
66673,4,1,233427,233427,233428,0,1,3
66674,6,3,233433,233433,233436,0,3,5
66675,5,1,233438,233438,233439,0,1,2
66676,3,2,233441,233441,233443,0,2,2
66677,4,1,233445,233445,233446,0,1,2
66678,1,2,233446,233446,233448,0,2,0
66679,5,3,233451,233451,233454,0,3,3
66680,1,2,233452,233454,233456,2,4,0
66681,2,1,233454,233456,233457,2,3,0
66682,4,3,233458,233458,233461,0,3,1
66683,2,2,233460,233461,233463,1,3,0
66684,6,3,233466,233466,233469,0,3,3
66685,4,3,233470,233470,233473,0,3,1
66686,6,2,233476,233476,233478,0,2,3
66687,4,2,233480,233480,233482,0,2,2
66688,5,3,233485,233485,233488,0,3,3
66689,2,3,233487,233488,233491,1,4,0
66690,2,2,233489,233491,233493,2,4,0
66691,4,1,233493,233493,233494,0,1,0
66692,5,1,233498,233498,233499,0,1,4
66693,5,3,233503,233503,233506,0,3,4
66694,5,3,233508,233508,233511,0,3,2
66695,4,2,233512,233512,233514,0,2,1
66696,3,3,233515,233515,233518,0,3,1
66697,2,1,233517,233518,233519,1,2,0
66698,4,1,233521,233521,233522,0,1,2
66699,4,1,233525,233525,233526,0,1,3
66700,4,1,233529,233529,233530,0,1,3
66701,2,3,233531,233531,233534,0,3,1
66702,1,1,233532,233534,233535,2,3,0
66703,4,3,233536,233536,233539,0,3,1
66704,2,1,233538,233539,233540,1,2,0
66705,5,1,233543,233543,233544,0,1,3
66706,5,1,233548,233548,233549,0,1,4
66707,4,3,233552,233552,233555,0,3,3
66708,2,3,233554,233555,233558,1,4,0
66709,6,3,233560,233560,233563,0,3,2
66710,6,3,233566,233566,233569,0,3,3
66711,6,2,233572,233572,233574,0,2,3
66712,5,1,233577,233577,233578,0,1,3
66713,2,1,233579,233579,233580,0,1,1
66714,4,2,233583,233583,233585,0,2,3
66715,6,2,233589,233589,233591,0,2,4
66716,1,3,233590,233591,233594,1,4,0
66717,4,2,233594,233594,233596,0,2,0
66718,5,3,233599,233599,233602,0,3,3
66719,3,1,233602,233602,233603,0,1,0
66720,3,1,233605,233605,233606,0,1,2
66721,6,1,233611,233611,233612,0,1,5
66722,4,1,233615,233615,233616,0,1,3
66723,4,3,233619,233619,233622,0,3,3
66724,2,1,233621,233622,233623,1,2,0
66725,1,1,233622,233623,233624,1,2,0
66726,5,3,233627,233627,233630,0,3,3
66727,6,3,233633,233633,233636,0,3,3
66728,2,1,233635,233636,233637,1,2,0
66729,5,2,233640,233640,233642,0,2,3
66730,2,2,233642,233642,233644,0,2,0
66731,6,2,233648,233648,233650,0,2,4
66732,3,3,233651,233651,233654,0,3,1
66733,4,3,233655,233655,233658,0,3,1
66734,1,2,233656,233658,233660,2,4,0
66735,1,1,233657,233660,233661,3,4,0
66736,4,1,233661,233661,233662,0,1,0
66737,6,3,233667,233667,233670,0,3,5
66738,5,3,233672,233672,233675,0,3,2
66739,6,1,233678,233678,233679,0,1,3
66740,4,2,233682,233682,233684,0,2,3
66741,3,1,233685,233685,233686,0,1,1
66742,2,1,233687,233687,233688,0,1,1
66743,6,3,233693,233693,233696,0,3,5
66744,1,3,233694,233696,233699,2,5,0
66745,4,1,233698,233699,233700,1,2,0
66746,5,3,233703,233703,233706,0,3,3
66747,3,1,233706,233706,233707,0,1,0
66748,1,3,233707,233707,233710,0,3,0
66749,1,3,233708,233710,233713,2,5,0
66750,4,3,233712,233713,233716,1,4,0
66751,5,3,233717,233717,233720,0,3,1
66752,6,3,233723,233723,233726,0,3,3
66753,1,2,233724,233726,233728,2,4,0
66754,2,2,233726,233728,233730,2,4,0
66755,5,2,233731,233731,233733,0,2,1
66756,3,1,233734,233734,233735,0,1,1
66757,6,1,233740,233740,233741,0,1,5
66758,6,1,233746,233746,233747,0,1,5
66759,4,3,233750,233750,233753,0,3,3
66760,2,3,233752,233753,233756,1,4,0
66761,3,2,233755,233756,233758,1,3,0
66762,2,2,233757,233758,233760,1,3,0
66763,5,2,233762,233762,233764,0,2,2
66764,2,2,233764,233764,233766,0,2,0
66765,1,1,233765,233766,233767,1,2,0
66766,6,2,233771,233771,233773,0,2,4
66767,4,1,233775,233775,233776,0,1,2
66768,1,2,233776,233776,233778,0,2,0
66769,6,3,233782,233782,233785,0,3,4
66770,6,3,233788,233788,233791,0,3,3
66771,5,3,233793,233793,233796,0,3,2
66772,2,1,233795,233796,233797,1,2,0
66773,3,2,233798,233798,233800,0,2,1
66774,4,2,233802,233802,233804,0,2,2
66775,4,2,233806,233806,233808,0,2,2
66776,4,3,233810,233810,233813,0,3,2
66777,3,2,233813,233813,233815,0,2,0
66778,5,3,233818,233818,233821,0,3,3
66779,4,1,233822,233822,233823,0,1,1
66780,3,2,233825,233825,233827,0,2,2
66781,2,2,233827,233827,233829,0,2,0
66782,5,1,233832,233832,233833,0,1,3
66783,1,3,233833,233833,233836,0,3,0
66784,6,1,233839,233839,233840,0,1,3
66785,6,3,233845,233845,233848,0,3,5
66786,2,3,233847,233848,233851,1,4,0
66787,2,2,233849,233851,233853,2,4,0
66788,4,1,233853,233853,233854,0,1,0
66789,5,3,233858,233858,233861,0,3,4
66790,4,1,233862,233862,233863,0,1,1
66791,6,3,233868,233868,233871,0,3,5
66792,5,3,233873,233873,233876,0,3,2
66793,2,1,233875,233876,233877,1,2,0
66794,4,2,233879,233879,233881,0,2,2
66795,6,3,233885,233885,233888,0,3,4
66796,4,3,233889,233889,233892,0,3,1
66797,6,3,233895,233895,233898,0,3,3
66798,3,3,233898,233898,233901,0,3,0
66799,2,3,233900,233901,233904,1,4,0
66800,4,2,233904,233904,233906,0,2,0
66801,6,1,233910,233910,233911,0,1,4
66802,3,2,233913,233913,233915,0,2,2
66803,1,1,233914,233915,233916,1,2,0
66804,6,3,233920,233920,233923,0,3,4
66805,1,3,233921,233923,233926,2,5,0
66806,3,3,233924,233926,233929,2,5,0
66807,5,2,233929,233929,233931,0,2,0
66808,4,3,233933,233933,233936,0,3,2
66809,6,1,233939,233939,233940,0,1,3
66810,1,2,233940,233940,233942,0,2,0
66811,5,3,233945,233945,233948,0,3,3
66812,1,2,233946,233948,233950,2,4,0
66813,6,2,233952,233952,233954,0,2,2
66814,2,2,233954,233954,233956,0,2,0
66815,2,1,233956,233956,233957,0,1,0
66816,2,2,233958,233958,233960,0,2,1
66817,6,2,233964,233964,233966,0,2,4
66818,6,3,233970,233970,233973,0,3,4
66819,6,1,233976,233976,233977,0,1,3
66820,1,3,233977,233977,233980,0,3,0
66821,6,3,233983,233983,233986,0,3,3
66822,2,2,233985,233986,233988,1,3,0
66823,6,2,233991,233991,233993,0,2,3
66824,1,2,233992,233993,233995,1,3,0
66825,6,1,233998,233998,233999,0,1,3
66826,6,2,234004,234004,234006,0,2,5
66827,2,2,234006,234006,234008,0,2,0
66828,6,2,234012,234012,234014,0,2,4
66829,4,1,234016,234016,234017,0,1,2
66830,3,2,234019,234019,234021,0,2,2
66831,6,3,234025,234025,234028,0,3,4
66832,5,1,234030,234030,234031,0,1,2
66833,4,2,234034,234034,234036,0,2,3
66834,2,2,234036,234036,234038,0,2,0
66835,1,1,234037,234038,234039,1,2,0
66836,6,1,234043,234043,234044,0,1,4
66837,2,1,234045,234045,234046,0,1,1
66838,1,1,234046,234046,234047,0,1,0
66839,5,3,234051,234051,234054,0,3,4
66840,4,2,234055,234055,234057,0,2,1
66841,3,2,234058,234058,234060,0,2,1
66842,2,1,234060,234060,234061,0,1,0
66843,2,1,234062,234062,234063,0,1,1
66844,2,2,234064,234064,234066,0,2,1
66845,5,2,234069,234069,234071,0,2,3
66846,2,3,234071,234071,234074,0,3,0
66847,4,3,234075,234075,234078,0,3,1
66848,2,3,234077,234078,234081,1,4,0
66849,1,3,234078,234081,234084,3,6,0
66850,1,2,234079,234084,234086,5,7,0
66851,4,3,234083,234086,234089,3,6,0
66852,4,3,234087,234089,234092,2,5,0
66853,1,3,234088,234092,234095,4,7,0
66854,6,3,234094,234095,234098,1,4,0
66855,5,1,234099,234099,234100,0,1,1
66856,5,2,234104,234104,234106,0,2,4
66857,1,3,234105,234106,234109,1,4,0
66858,3,3,234108,234109,234112,1,4,0
66859,2,3,234110,234112,234115,2,5,0
66860,2,1,234112,234115,234116,3,4,0
66861,5,1,234117,234117,234118,0,1,1
66862,1,2,234118,234118,234120,0,2,0
66863,4,1,234122,234122,234123,0,1,2
66864,5,3,234127,234127,234130,0,3,4
66865,6,3,234133,234133,234136,0,3,3
66866,4,2,234137,234137,234139,0,2,1
66867,6,1,234143,234143,234144,0,1,4
66868,5,2,234148,234148,234150,0,2,4
66869,6,3,234154,234154,234157,0,3,4
66870,5,2,234159,234159,234161,0,2,2
66871,4,1,234163,234163,234164,0,1,2
66872,3,1,234166,234166,234167,0,1,2
66873,6,3,234172,234172,234175,0,3,5
66874,2,1,234174,234175,234176,1,2,0
66875,2,3,234176,234176,234179,0,3,0
66876,3,2,234179,234179,234181,0,2,0
66877,6,1,234185,234185,234186,0,1,4
66878,6,2,234191,234191,234193,0,2,5
66879,5,1,234196,234196,234197,0,1,3
66880,5,1,234201,234201,234202,0,1,4
66881,3,1,234204,234204,234205,0,1,2
66882,2,2,234206,234206,234208,0,2,1
66883,1,1,234207,234208,234209,1,2,0
66884,3,1,234210,234210,234211,0,1,1
66885,3,1,234213,234213,234214,0,1,2
66886,4,1,234217,234217,234218,0,1,3
66887,2,3,234219,234219,234222,0,3,1
66888,1,1,234220,234222,234223,2,3,0
66889,5,3,234225,234225,234228,0,3,2
66890,4,1,234229,234229,234230,0,1,1
66891,3,1,234232,234232,234233,0,1,2
66892,3,3,234235,234235,234238,0,3,2
66893,2,2,234237,234238,234240,1,3,0
66894,1,2,234238,234240,234242,2,4,0
66895,6,2,234244,234244,234246,0,2,2
66896,5,1,234249,234249,234250,0,1,3
66897,3,2,234252,234252,234254,0,2,2
66898,6,2,234258,234258,234260,0,2,4
66899,5,3,234263,234263,234266,0,3,3
66900,1,1,234264,234266,234267,2,3,0
66901,5,3,234269,234269,234272,0,3,2
66902,4,1,234273,234273,234274,0,1,1
66903,6,2,234279,234279,234281,0,2,5
66904,2,3,234281,234281,234284,0,3,0
66905,6,1,234287,234287,234288,0,1,3
66906,4,3,234291,234291,234294,0,3,3
66907,6,2,234297,234297,234299,0,2,3
66908,4,1,234301,234301,234302,0,1,2
66909,5,2,234306,234306,234308,0,2,4
66910,3,3,234309,234309,234312,0,3,1
66911,5,1,234314,234314,234315,0,1,2
66912,2,3,234316,234316,234319,0,3,1
66913,5,3,234321,234321,234324,0,3,2
66914,6,1,234327,234327,234328,0,1,3
66915,1,2,234328,234328,234330,0,2,0
66916,2,3,234330,234330,234333,0,3,0
66917,5,3,234335,234335,234338,0,3,2
66918,4,1,234339,234339,234340,0,1,1
66919,6,3,234345,234345,234348,0,3,5
66920,3,2,234348,234348,234350,0,2,0
66921,5,1,234353,234353,234354,0,1,3
66922,4,3,234357,234357,234360,0,3,3
66923,4,3,234361,234361,234364,0,3,1
66924,5,3,234366,234366,234369,0,3,2
66925,3,2,234369,234369,234371,0,2,0
66926,2,3,234371,234371,234374,0,3,0
66927,5,2,234376,234376,234378,0,2,2
66928,1,2,234377,234378,234380,1,3,0
66929,1,2,234378,234380,234382,2,4,0
66930,5,1,234383,234383,234384,0,1,1
66931,2,1,234385,234385,234386,0,1,1
66932,2,2,234387,234387,234389,0,2,1
66933,5,2,234392,234392,234394,0,2,3
66934,2,3,234394,234394,234397,0,3,0
66935,5,1,234399,234399,234400,0,1,2
66936,3,2,234402,234402,234404,0,2,2
66937,6,3,234408,234408,234411,0,3,4
66938,3,1,234411,234411,234412,0,1,0
66939,4,1,234415,234415,234416,0,1,3
66940,3,1,234418,234418,234419,0,1,2
66941,3,2,234421,234421,234423,0,2,2
66942,5,3,234426,234426,234429,0,3,3
66943,2,3,234428,234429,234432,1,4,0
66944,2,1,234430,234432,234433,2,3,0
66945,3,1,234433,234433,234434,0,1,0
66946,1,2,234434,234434,234436,0,2,0
66947,1,2,234435,234436,234438,1,3,0
66948,6,3,234441,234441,234444,0,3,3
66949,4,2,234445,234445,234447,0,2,1
66950,4,3,234449,234449,234452,0,3,2
66951,6,3,234455,234455,234458,0,3,3
66952,3,1,234458,234458,234459,0,1,0
66953,5,3,234463,234463,234466,0,3,4
66954,3,2,234466,234466,234468,0,2,0
66955,3,1,234469,234469,234470,0,1,1
66956,2,1,234471,234471,234472,0,1,1
66957,6,2,234477,234477,234479,0,2,5
66958,4,3,234481,234481,234484,0,3,2
66959,2,1,234483,234484,234485,1,2,0
66960,3,2,234486,234486,234488,0,2,1
66961,5,3,234491,234491,234494,0,3,3
66962,4,2,234495,234495,234497,0,2,1
66963,2,3,234497,234497,234500,0,3,0
66964,2,2,234499,234500,234502,1,3,0
66965,5,2,234504,234504,234506,0,2,2
66966,3,2,234507,234507,234509,0,2,1
66967,1,2,234508,234509,234511,1,3,0
66968,2,3,234510,234511,234514,1,4,0
66969,1,3,234511,234514,234517,3,6,0
66970,6,2,234517,234517,234519,0,2,0
66971,6,2,234523,234523,234525,0,2,4
66972,6,2,234529,234529,234531,0,2,4
66973,4,2,234533,234533,234535,0,2,2
66974,5,1,234538,234538,234539,0,1,3
66975,2,2,234540,234540,234542,0,2,1
66976,6,1,234546,234546,234547,0,1,4
66977,5,2,234551,234551,234553,0,2,4
66978,4,3,234555,234555,234558,0,3,2
66979,5,2,234560,234560,234562,0,2,2
66980,1,1,234561,234562,234563,1,2,0
66981,2,2,234563,234563,234565,0,2,0
66982,1,1,234564,234565,234566,1,2,0
66983,5,3,234569,234569,234572,0,3,3
66984,5,1,234574,234574,234575,0,1,2
66985,3,1,234577,234577,234578,0,1,2
66986,6,2,234583,234583,234585,0,2,5
66987,6,3,234589,234589,234592,0,3,4
66988,1,1,234590,234592,234593,2,3,0
66989,1,2,234591,234593,234595,2,4,0
66990,3,1,234594,234595,234596,1,2,0
66991,6,1,234600,234600,234601,0,1,4
66992,2,3,234602,234602,234605,0,3,1
66993,4,2,234606,234606,234608,0,2,1
66994,3,2,234609,234609,234611,0,2,1
66995,3,2,234612,234612,234614,0,2,1
66996,3,2,234615,234615,234617,0,2,1
66997,1,2,234616,234617,234619,1,3,0
66998,6,2,234622,234622,234624,0,2,3
66999,4,3,234626,234626,234629,0,3,2
67000,2,3,234628,234629,234632,1,4,0
67001,1,3,234629,234632,234635,3,6,0
67002,5,1,234634,234635,234636,1,2,0
67003,5,2,234639,234639,234641,0,2,3
67004,4,1,234643,234643,234644,0,1,2
67005,1,2,234644,234644,234646,0,2,0
67006,5,2,234649,234649,234651,0,2,3
67007,4,3,234653,234653,234656,0,3,2
67008,3,2,234656,234656,234658,0,2,0
67009,6,1,234662,234662,234663,0,1,4
67010,3,3,234665,234665,234668,0,3,2
67011,1,2,234666,234668,234670,2,4,0
67012,4,2,234670,234670,234672,0,2,0
67013,2,2,234672,234672,234674,0,2,0
67014,2,1,234674,234674,234675,0,1,0
67015,2,3,234676,234676,234679,0,3,1
67016,5,2,234681,234681,234683,0,2,2
67017,2,1,234683,234683,234684,0,1,0
67018,1,3,234684,234684,234687,0,3,0
67019,2,2,234686,234687,234689,1,3,0
67020,6,1,234692,234692,234693,0,1,3
67021,6,2,234698,234698,234700,0,2,5
67022,1,3,234699,234700,234703,1,4,0
67023,4,2,234703,234703,234705,0,2,0
67024,5,2,234708,234708,234710,0,2,3
67025,5,1,234713,234713,234714,0,1,3
67026,5,2,234718,234718,234720,0,2,4
67027,2,1,234720,234720,234721,0,1,0
67028,3,2,234723,234723,234725,0,2,2
67029,3,2,234726,234726,234728,0,2,1
67030,3,1,234729,234729,234730,0,1,1
67031,3,3,234732,234732,234735,0,3,2
67032,3,1,234735,234735,234736,0,1,0
67033,5,2,234740,234740,234742,0,2,4
67034,1,2,234741,234742,234744,1,3,0
67035,4,3,234745,234745,234748,0,3,1
67036,3,3,234748,234748,234751,0,3,0
67037,2,3,234750,234751,234754,1,4,0
67038,3,2,234753,234754,234756,1,3,0
67039,2,1,234755,234756,234757,1,2,0
67040,6,3,234761,234761,234764,0,3,4
67041,3,2,234764,234764,234766,0,2,0
67042,1,2,234765,234766,234768,1,3,0
67043,4,3,234769,234769,234772,0,3,1
67044,5,3,234774,234774,234777,0,3,2
67045,5,3,234779,234779,234782,0,3,2
67046,1,3,234780,234782,234785,2,5,0
67047,2,1,234782,234785,234786,3,4,0
67048,2,3,234784,234786,234789,2,5,0
67049,2,1,234786,234789,234790,3,4,0
67050,3,2,234789,234790,234792,1,3,0
67051,5,3,234794,234794,234797,0,3,2
67052,4,1,234798,234798,234799,0,1,1
67053,4,1,234802,234802,234803,0,1,3
67054,1,3,234803,234803,234806,0,3,0
67055,2,3,234805,234806,234809,1,4,0
67056,1,3,234806,234809,234812,3,6,0
67057,1,1,234807,234812,234813,5,6,0
67058,1,2,234808,234813,234815,5,7,0
67059,5,2,234813,234815,234817,2,4,0
67060,6,2,234819,234819,234821,0,2,2
67061,1,2,234820,234821,234823,1,3,0
67062,1,2,234821,234823,234825,2,4,0
67063,2,1,234823,234825,234826,2,3,0
67064,1,1,234824,234826,234827,2,3,0
67065,1,2,234825,234827,234829,2,4,0
67066,6,3,234831,234831,234834,0,3,2
67067,2,1,234833,234834,234835,1,2,0
67068,6,1,234839,234839,234840,0,1,4
67069,2,3,234841,234841,234844,0,3,1
67070,3,1,234844,234844,234845,0,1,0
67071,2,2,234846,234846,234848,0,2,1
67072,6,1,234852,234852,234853,0,1,4
67073,5,3,234857,234857,234860,0,3,4
67074,6,3,234863,234863,234866,0,3,3
67075,2,2,234865,234866,234868,1,3,0
67076,1,3,234866,234868,234871,2,5,0
67077,3,2,234869,234871,234873,2,4,0
67078,2,1,234871,234873,234874,2,3,0
67079,4,3,234875,234875,234878,0,3,1
67080,6,2,234881,234881,234883,0,2,3
67081,1,1,234882,234883,234884,1,2,0
67082,5,3,234887,234887,234890,0,3,3
67083,1,1,234888,234890,234891,2,3,0
67084,6,2,234894,234894,234896,0,2,3
67085,2,2,234896,234896,234898,0,2,0
67086,5,3,234901,234901,234904,0,3,3
67087,3,1,234904,234904,234905,0,1,0
67088,3,3,234907,234907,234910,0,3,2
67089,1,1,234908,234910,234911,2,3,0
67090,3,3,234911,234911,234914,0,3,0
67091,4,1,234915,234915,234916,0,1,1
67092,5,3,234920,234920,234923,0,3,4
67093,6,3,234926,234926,234929,0,3,3
67094,2,3,234928,234929,234932,1,4,0
67095,5,2,234933,234933,234935,0,2,1
67096,2,3,234935,234935,234938,0,3,0
67097,6,3,234941,234941,234944,0,3,3
67098,5,2,234946,234946,234948,0,2,2
67099,5,3,234951,234951,234954,0,3,3
67100,1,3,234952,234954,234957,2,5,0
67101,1,3,234953,234957,234960,4,7,0
67102,3,1,234956,234960,234961,4,5,0
67103,6,1,234962,234962,234963,0,1,1
67104,2,1,234964,234964,234965,0,1,1
67105,5,3,234969,234969,234972,0,3,4
67106,2,1,234971,234972,234973,1,2,0
67107,6,3,234977,234977,234980,0,3,4
67108,6,3,234983,234983,234986,0,3,3
67109,4,1,234987,234987,234988,0,1,1
67110,4,1,234991,234991,234992,0,1,3
67111,2,3,234993,234993,234996,0,3,1
67112,2,3,234995,234996,234999,1,4,0
67113,3,3,234998,234999,235002,1,4,0
67114,2,3,235000,235002,235005,2,5,0
67115,6,2,235006,235006,235008,0,2,1
67116,5,2,235011,235011,235013,0,2,3
67117,1,2,235012,235013,235015,1,3,0
67118,2,2,235014,235015,235017,1,3,0
67119,6,2,235020,235020,235022,0,2,3
67120,4,1,235024,235024,235025,0,1,2
67121,4,2,235028,235028,235030,0,2,3
67122,6,3,235034,235034,235037,0,3,4
67123,5,3,235039,235039,235042,0,3,2
67124,6,3,235045,235045,235048,0,3,3
67125,4,1,235049,235049,235050,0,1,1
67126,4,1,235053,235053,235054,0,1,3
67127,3,2,235056,235056,235058,0,2,2
67128,3,2,235059,235059,235061,0,2,1
67129,1,3,235060,235061,235064,1,4,0
67130,2,2,235062,235064,235066,2,4,0
67131,6,3,235068,235068,235071,0,3,2
67132,4,3,235072,235072,235075,0,3,1
67133,5,1,235077,235077,235078,0,1,2
67134,1,1,235078,235078,235079,0,1,0
67135,2,3,235080,235080,235083,0,3,1
67136,2,3,235082,235083,235086,1,4,0
67137,6,1,235088,235088,235089,0,1,2
67138,1,1,235089,235089,235090,0,1,0
67139,4,3,235093,235093,235096,0,3,3
67140,1,3,235094,235096,235099,2,5,0
67141,2,3,235096,235099,235102,3,6,0
67142,3,3,235099,235102,235105,3,6,0
67143,2,1,235101,235105,235106,4,5,0
67144,1,3,235102,235106,235109,4,7,0
67145,2,2,235104,235109,235111,5,7,0
67146,2,3,235106,235111,235114,5,8,0
67147,2,1,235108,235114,235115,6,7,0
67148,4,3,235112,235115,235118,3,6,0
67149,1,1,235113,235118,235119,5,6,0
67150,5,3,235118,235119,235122,1,4,0
67151,4,1,235122,235122,235123,0,1,0
67152,4,2,235126,235126,235128,0,2,3
67153,6,1,235132,235132,235133,0,1,4
67154,2,1,235134,235134,235135,0,1,1
67155,3,3,235137,235137,235140,0,3,2
67156,6,2,235143,235143,235145,0,2,3
67157,2,3,235145,235145,235148,0,3,0
67158,1,3,235146,235148,235151,2,5,0
67159,6,1,235152,235152,235153,0,1,1
67160,6,1,235158,235158,235159,0,1,5
67161,3,3,235161,235161,235164,0,3,2
67162,2,1,235163,235164,235165,1,2,0
67163,5,3,235168,235168,235171,0,3,3
67164,2,3,235170,235171,235174,1,4,0
67165,4,2,235174,235174,235176,0,2,0
67166,5,2,235179,235179,235181,0,2,3
67167,6,1,235185,235185,235186,0,1,4
67168,6,3,235191,235191,235194,0,3,5
67169,6,3,235197,235197,235200,0,3,3
67170,5,3,235202,235202,235205,0,3,2
67171,4,3,235206,235206,235209,0,3,1
67172,3,1,235209,235209,235210,0,1,0
67173,3,2,235212,235212,235214,0,2,2
67174,4,2,235216,235216,235218,0,2,2
67175,2,2,235218,235218,235220,0,2,0
67176,3,1,235221,235221,235222,0,1,1
67177,1,1,235222,235222,235223,0,1,0
67178,1,2,235223,235223,235225,0,2,0
67179,2,1,235225,235225,235226,0,1,0
67180,6,2,235231,235231,235233,0,2,5
67181,1,3,235232,235233,235236,1,4,0
67182,3,2,235235,235236,235238,1,3,0
67183,1,2,235236,235238,235240,2,4,0
67184,5,3,235241,235241,235244,0,3,1
67185,4,1,235245,235245,235246,0,1,1
67186,6,3,235251,235251,235254,0,3,5
67187,1,3,235252,235254,235257,2,5,0
67188,5,1,235257,235257,235258,0,1,0
67189,5,2,235262,235262,235264,0,2,4
67190,3,2,235265,235265,235267,0,2,1
67191,1,1,235266,235267,235268,1,2,0
67192,4,3,235270,235270,235273,0,3,2
67193,6,1,235276,235276,235277,0,1,3
67194,2,3,235278,235278,235281,0,3,1
67195,5,2,235283,235283,235285,0,2,2
67196,5,1,235288,235288,235289,0,1,3
67197,1,2,235289,235289,235291,0,2,0
67198,4,1,235293,235293,235294,0,1,2
67199,2,3,235295,235295,235298,0,3,1
67200,1,1,235296,235298,235299,2,3,0
67201,5,2,235301,235301,235303,0,2,2
67202,4,3,235305,235305,235308,0,3,2
67203,2,3,235307,235308,235311,1,4,0
67204,2,1,235309,235311,235312,2,3,0
67205,4,1,235313,235313,235314,0,1,1
67206,4,1,235317,235317,235318,0,1,3
67207,2,2,235319,235319,235321,0,2,1
67208,1,2,235320,235321,235323,1,3,0
67209,3,1,235323,235323,235324,0,1,0
67210,4,1,235327,235327,235328,0,1,3
67211,3,3,235330,235330,235333,0,3,2
67212,3,2,235333,235333,235335,0,2,0
67213,6,2,235339,235339,235341,0,2,4
67214,2,1,235341,235341,235342,0,1,0
67215,3,1,235344,235344,235345,0,1,2
67216,2,3,235346,235346,235349,0,3,1
67217,5,3,235351,235351,235354,0,3,2
67218,5,3,235356,235356,235359,0,3,2
67219,2,2,235358,235359,235361,1,3,0
67220,1,2,235359,235361,235363,2,4,0
67221,4,3,235363,235363,235366,0,3,0
67222,2,2,235365,235366,235368,1,3,0
67223,6,1,235371,235371,235372,0,1,3
67224,1,2,235372,235372,235374,0,2,0
67225,5,1,235377,235377,235378,0,1,3
67226,6,3,235383,235383,235386,0,3,5
67227,5,1,235388,235388,235389,0,1,2
67228,5,3,235393,235393,235396,0,3,4
67229,6,1,235399,235399,235400,0,1,3
67230,6,3,235405,235405,235408,0,3,5
67231,1,1,235406,235408,235409,2,3,0
67232,2,3,235408,235409,235412,1,4,0
67233,1,2,235409,235412,235414,3,5,0
67234,6,2,235415,235415,235417,0,2,1
67235,4,2,235419,235419,235421,0,2,2
67236,5,2,235424,235424,235426,0,2,3
67237,5,1,235429,235429,235430,0,1,3
67238,3,1,235432,235432,235433,0,1,2
67239,2,1,235434,235434,235435,0,1,1
67240,3,1,235437,235437,235438,0,1,2
67241,1,2,235438,235438,235440,0,2,0
67242,5,3,235443,235443,235446,0,3,3
67243,2,3,235445,235446,235449,1,4,0
67244,3,3,235448,235449,235452,1,4,0
67245,5,3,235453,235453,235456,0,3,1
67246,5,2,235458,235458,235460,0,2,2
67247,2,3,235460,235460,235463,0,3,0
67248,5,2,235465,235465,235467,0,2,2
67249,2,3,235467,235467,235470,0,3,0
67250,3,1,235470,235470,235471,0,1,0
67251,4,3,235474,235474,235477,0,3,3
67252,4,2,235478,235478,235480,0,2,1
67253,6,2,235484,235484,235486,0,2,4
67254,6,3,235490,235490,235493,0,3,4
67255,3,1,235493,235493,235494,0,1,0
67256,5,2,235498,235498,235500,0,2,4
67257,2,2,235500,235500,235502,0,2,0
67258,4,1,235504,235504,235505,0,1,2
67259,6,1,235510,235510,235511,0,1,5
67260,2,1,235512,235512,235513,0,1,1
67261,4,3,235516,235516,235519,0,3,3
67262,1,2,235517,235519,235521,2,4,0
67263,1,2,235518,235521,235523,3,5,0
67264,6,3,235524,235524,235527,0,3,1
67265,6,2,235530,235530,235532,0,2,3
67266,3,2,235533,235533,235535,0,2,1
67267,6,1,235539,235539,235540,0,1,4
67268,4,2,235543,235543,235545,0,2,3
67269,2,3,235545,235545,235548,0,3,0
67270,1,3,235546,235548,235551,2,5,0
67271,4,1,235550,235551,235552,1,2,0
67272,3,2,235553,235553,235555,0,2,1
67273,6,2,235559,235559,235561,0,2,4
67274,4,1,235563,235563,235564,0,1,2
67275,3,2,235566,235566,235568,0,2,2
67276,4,2,235570,235570,235572,0,2,2
67277,5,2,235575,235575,235577,0,2,3
67278,6,3,235581,235581,235584,0,3,4
67279,2,2,235583,235584,235586,1,3,0
67280,6,1,235589,235589,235590,0,1,3
67281,1,1,235590,235590,235591,0,1,0
67282,1,1,235591,235591,235592,0,1,0
67283,4,3,235595,235595,235598,0,3,3
67284,5,2,235600,235600,235602,0,2,2
67285,5,2,235605,235605,235607,0,2,3
67286,1,2,235606,235607,235609,1,3,0
67287,5,1,235611,235611,235612,0,1,2
67288,6,3,235617,235617,235620,0,3,5
67289,5,1,235622,235622,235623,0,1,2
67290,1,3,235623,235623,235626,0,3,0
67291,2,2,235625,235626,235628,1,3,0
67292,4,1,235629,235629,235630,0,1,1
67293,1,2,235630,235630,235632,0,2,0
67294,3,2,235633,235633,235635,0,2,1
67295,4,2,235637,235637,235639,0,2,2
67296,5,2,235642,235642,235644,0,2,3
67297,5,3,235647,235647,235650,0,3,3
67298,5,2,235652,235652,235654,0,2,2
67299,6,2,235658,235658,235660,0,2,4
67300,1,2,235659,235660,235662,1,3,0
67301,2,3,235661,235662,235665,1,4,0
67302,5,1,235666,235666,235667,0,1,1
67303,6,1,235672,235672,235673,0,1,5
67304,4,1,235676,235676,235677,0,1,3
67305,5,2,235681,235681,235683,0,2,4
67306,6,2,235687,235687,235689,0,2,4
67307,1,2,235688,235689,235691,1,3,0
67308,5,1,235693,235693,235694,0,1,2
67309,3,1,235696,235696,235697,0,1,2
67310,1,1,235697,235697,235698,0,1,0
67311,1,3,235698,235698,235701,0,3,0
67312,6,2,235704,235704,235706,0,2,3
67313,2,1,235706,235706,235707,0,1,0
67314,6,1,235712,235712,235713,0,1,5
67315,6,1,235718,235718,235719,0,1,5
67316,1,3,235719,235719,235722,0,3,0
67317,1,3,235720,235722,235725,2,5,0
67318,1,2,235721,235725,235727,4,6,0
67319,4,1,235725,235727,235728,2,3,0
67320,4,3,235729,235729,235732,0,3,1
67321,6,1,235735,235735,235736,0,1,3
67322,3,2,235738,235738,235740,0,2,2
67323,1,2,235739,235740,235742,1,3,0
67324,6,2,235745,235745,235747,0,2,3
67325,4,2,235749,235749,235751,0,2,2
67326,2,2,235751,235751,235753,0,2,0
67327,4,2,235755,235755,235757,0,2,2
67328,4,3,235759,235759,235762,0,3,2
67329,1,3,235760,235762,235765,2,5,0
67330,1,3,235761,235765,235768,4,7,0
67331,4,1,235765,235768,235769,3,4,0
67332,4,3,235769,235769,235772,0,3,0
67333,1,3,235770,235772,235775,2,5,0
67334,3,3,235773,235775,235778,2,5,0
67335,1,3,235774,235778,235781,4,7,0
67336,4,3,235778,235781,235784,3,6,0
67337,4,3,235782,235784,235787,2,5,0
67338,3,1,235785,235787,235788,2,3,0
67339,1,2,235786,235788,235790,2,4,0
67340,3,1,235789,235790,235791,1,2,0
67341,4,2,235793,235793,235795,0,2,2
67342,3,3,235796,235796,235799,0,3,1
67343,4,1,235800,235800,235801,0,1,1
67344,2,1,235802,235802,235803,0,1,1
67345,5,1,235807,235807,235808,0,1,4
67346,2,1,235809,235809,235810,0,1,1
67347,5,1,235814,235814,235815,0,1,4
67348,3,2,235817,235817,235819,0,2,2
67349,5,2,235822,235822,235824,0,2,3
67350,5,1,235827,235827,235828,0,1,3
67351,2,1,235829,235829,235830,0,1,1
67352,4,1,235833,235833,235834,0,1,3
67353,4,3,235837,235837,235840,0,3,3
67354,2,2,235839,235840,235842,1,3,0
67355,1,1,235840,235842,235843,2,3,0
67356,2,2,235842,235843,235845,1,3,0
67357,1,1,235843,235845,235846,2,3,0
67358,4,2,235847,235847,235849,0,2,1
67359,3,2,235850,235850,235852,0,2,1
67360,4,1,235854,235854,235855,0,1,2
67361,6,1,235860,235860,235861,0,1,5
67362,5,1,235865,235865,235866,0,1,4
67363,1,2,235866,235866,235868,0,2,0
67364,2,2,235868,235868,235870,0,2,0
67365,4,3,235872,235872,235875,0,3,2
67366,3,3,235875,235875,235878,0,3,0
67367,4,3,235879,235879,235882,0,3,1
67368,3,3,235882,235882,235885,0,3,0
67369,3,3,235885,235885,235888,0,3,0
67370,1,1,235886,235888,235889,2,3,0
67371,3,1,235889,235889,235890,0,1,0
67372,1,3,235890,235890,235893,0,3,0
67373,6,2,235896,235896,235898,0,2,3
67374,2,1,235898,235898,235899,0,1,0
67375,2,2,235900,235900,235902,0,2,1
67376,1,3,235901,235902,235905,1,4,0
67377,3,3,235904,235905,235908,1,4,0
67378,5,3,235909,235909,235912,0,3,1
67379,1,1,235910,235912,235913,2,3,0
67380,1,3,235911,235913,235916,2,5,0
67381,5,3,235916,235916,235919,0,3,0
67382,4,2,235920,235920,235922,0,2,1
67383,5,2,235925,235925,235927,0,2,3
67384,1,3,235926,235927,235930,1,4,0
67385,5,2,235931,235931,235933,0,2,1
67386,6,1,235937,235937,235938,0,1,4
67387,3,1,235940,235940,235941,0,1,2
67388,4,1,235944,235944,235945,0,1,3
67389,1,1,235945,235945,235946,0,1,0
67390,6,1,235951,235951,235952,0,1,5
67391,5,3,235956,235956,235959,0,3,4
67392,3,1,235959,235959,235960,0,1,0
67393,3,2,235962,235962,235964,0,2,2
67394,3,2,235965,235965,235967,0,2,1
67395,4,1,235969,235969,235970,0,1,2
67396,2,2,235971,235971,235973,0,2,1
67397,5,3,235976,235976,235979,0,3,3
67398,3,2,235979,235979,235981,0,2,0
67399,6,2,235985,235985,235987,0,2,4
67400,2,3,235987,235987,235990,0,3,0
67401,5,1,235992,235992,235993,0,1,2
67402,2,3,235994,235994,235997,0,3,1
67403,1,2,235995,235997,235999,2,4,0
67404,5,1,236000,236000,236001,0,1,1
67405,4,2,236004,236004,236006,0,2,3
67406,6,1,236010,236010,236011,0,1,4
67407,5,3,236015,236015,236018,0,3,4
67408,6,2,236021,236021,236023,0,2,3
67409,4,1,236025,236025,236026,0,1,2
67410,4,3,236029,236029,236032,0,3,3
67411,2,1,236031,236032,236033,1,2,0
67412,2,3,236033,236033,236036,0,3,0
67413,5,2,236038,236038,236040,0,2,2
67414,2,2,236040,236040,236042,0,2,0
67415,5,1,236045,236045,236046,0,1,3
67416,2,2,236047,236047,236049,0,2,1
67417,3,2,236050,236050,236052,0,2,1
67418,6,3,236056,236056,236059,0,3,4
67419,3,2,236059,236059,236061,0,2,0
67420,3,3,236062,236062,236065,0,3,1
67421,1,2,236063,236065,236067,2,4,0
67422,3,2,236066,236067,236069,1,3,0
67423,6,3,236072,236072,236075,0,3,3
67424,5,1,236077,236077,236078,0,1,2
67425,6,3,236083,236083,236086,0,3,5
67426,3,2,236086,236086,236088,0,2,0
67427,5,1,236091,236091,236092,0,1,3
67428,5,3,236096,236096,236099,0,3,4
67429,3,2,236099,236099,236101,0,2,0
67430,1,1,236100,236101,236102,1,2,0
67431,1,2,236101,236102,236104,1,3,0
67432,3,1,236104,236104,236105,0,1,0
67433,4,1,236108,236108,236109,0,1,3
67434,3,1,236111,236111,236112,0,1,2
67435,4,3,236115,236115,236118,0,3,3
67436,5,3,236120,236120,236123,0,3,2
67437,1,3,236121,236123,236126,2,5,0
67438,4,2,236125,236126,236128,1,3,0
67439,4,3,236129,236129,236132,0,3,1
67440,6,3,236135,236135,236138,0,3,3
67441,2,2,236137,236138,236140,1,3,0
67442,5,3,236142,236142,236145,0,3,2
67443,5,1,236147,236147,236148,0,1,2
67444,5,1,236152,236152,236153,0,1,4
67445,2,3,236154,236154,236157,0,3,1
67446,6,1,236160,236160,236161,0,1,3
67447,5,1,236165,236165,236166,0,1,4
67448,6,3,236171,236171,236174,0,3,5
67449,4,2,236175,236175,236177,0,2,1
67450,3,2,236178,236178,236180,0,2,1
67451,3,1,236181,236181,236182,0,1,1
67452,3,1,236184,236184,236185,0,1,2
67453,3,3,236187,236187,236190,0,3,2
67454,2,2,236189,236190,236192,1,3,0
67455,6,1,236195,236195,236196,0,1,3
67456,4,2,236199,236199,236201,0,2,3
67457,2,2,236201,236201,236203,0,2,0
67458,6,3,236207,236207,236210,0,3,4
67459,4,1,236211,236211,236212,0,1,1
67460,6,2,236217,236217,236219,0,2,5
67461,4,3,236221,236221,236224,0,3,2
67462,4,2,236225,236225,236227,0,2,1
67463,5,3,236230,236230,236233,0,3,3
67464,4,1,236234,236234,236235,0,1,1
67465,2,3,236236,236236,236239,0,3,1
67466,5,3,236241,236241,236244,0,3,2
67467,6,2,236247,236247,236249,0,2,3
67468,6,2,236253,236253,236255,0,2,4
67469,6,3,236259,236259,236262,0,3,4
67470,1,1,236260,236262,236263,2,3,0
67471,5,2,236265,236265,236267,0,2,2
67472,5,2,236270,236270,236272,0,2,3
67473,5,2,236275,236275,236277,0,2,3
67474,1,2,236276,236277,236279,1,3,0
67475,5,1,236281,236281,236282,0,1,2
67476,3,1,236284,236284,236285,0,1,2
67477,1,2,236285,236285,236287,0,2,0
67478,2,1,236287,236287,236288,0,1,0
67479,4,2,236291,236291,236293,0,2,3
67480,1,1,236292,236293,236294,1,2,0
67481,5,1,236297,236297,236298,0,1,3
67482,3,2,236300,236300,236302,0,2,2
67483,1,3,236301,236302,236305,1,4,0
67484,4,1,236305,236305,236306,0,1,0
67485,5,2,236310,236310,236312,0,2,4
67486,4,3,236314,236314,236317,0,3,2
67487,6,2,236320,236320,236322,0,2,3
67488,2,1,236322,236322,236323,0,1,0
67489,4,1,236326,236326,236327,0,1,3
67490,4,1,236330,236330,236331,0,1,3
67491,6,2,236336,236336,236338,0,2,5
67492,1,3,236337,236338,236341,1,4,0
67493,1,1,236338,236341,236342,3,4,0
67494,2,3,236340,236342,236345,2,5,0
67495,2,1,236342,236345,236346,3,4,0
67496,5,3,236347,236347,236350,0,3,1
67497,2,1,236349,236350,236351,1,2,0
67498,4,1,236353,236353,236354,0,1,2
67499,2,3,236355,236355,236358,0,3,1
67500,5,1,236360,236360,236361,0,1,2
67501,6,2,236366,236366,236368,0,2,5
67502,2,2,236368,236368,236370,0,2,0
67503,5,1,236373,236373,236374,0,1,3
67504,2,2,236375,236375,236377,0,2,1
67505,3,1,236378,236378,236379,0,1,1
67506,1,3,236379,236379,236382,0,3,0
67507,6,1,236385,236385,236386,0,1,3
67508,2,2,236387,236387,236389,0,2,1
67509,2,2,236389,236389,236391,0,2,0
67510,3,3,236392,236392,236395,0,3,1
67511,3,2,236395,236395,236397,0,2,0
67512,4,1,236399,236399,236400,0,1,2
67513,1,1,236400,236400,236401,0,1,0
67514,1,2,236401,236401,236403,0,2,0
67515,2,3,236403,236403,236406,0,3,0
67516,1,1,236404,236406,236407,2,3,0
67517,4,2,236408,236408,236410,0,2,1
67518,1,2,236409,236410,236412,1,3,0
67519,2,1,236411,236412,236413,1,2,0
67520,6,2,236417,236417,236419,0,2,4
67521,5,3,236422,236422,236425,0,3,3
67522,3,1,236425,236425,236426,0,1,0
67523,5,1,236430,236430,236431,0,1,4
67524,3,3,236433,236433,236436,0,3,2
67525,3,1,236436,236436,236437,0,1,0
67526,5,3,236441,236441,236444,0,3,4
67527,3,2,236444,236444,236446,0,2,0
67528,1,2,236445,236446,236448,1,3,0
67529,2,3,236447,236448,236451,1,4,0
67530,2,2,236449,236451,236453,2,4,0
67531,3,2,236452,236453,236455,1,3,0
67532,2,3,236454,236455,236458,1,4,0
67533,1,2,236455,236458,236460,3,5,0
67534,5,2,236460,236460,236462,0,2,0
67535,6,1,236466,236466,236467,0,1,4
67536,6,3,236472,236472,236475,0,3,5
67537,6,2,236478,236478,236480,0,2,3
67538,4,2,236482,236482,236484,0,2,2
67539,5,2,236487,236487,236489,0,2,3
67540,6,2,236493,236493,236495,0,2,4
67541,6,3,236499,236499,236502,0,3,4
67542,3,1,236502,236502,236503,0,1,0
67543,1,3,236503,236503,236506,0,3,0
67544,1,3,236504,236506,236509,2,5,0
67545,5,1,236509,236509,236510,0,1,0
67546,4,2,236513,236513,236515,0,2,3
67547,1,2,236514,236515,236517,1,3,0
67548,5,1,236519,236519,236520,0,1,2
67549,4,1,236523,236523,236524,0,1,3
67550,4,3,236527,236527,236530,0,3,3
67551,5,2,236532,236532,236534,0,2,2
67552,4,3,236536,236536,236539,0,3,2
67553,6,2,236542,236542,236544,0,2,3
67554,1,3,236543,236544,236547,1,4,0
67555,6,3,236549,236549,236552,0,3,2
67556,4,3,236553,236553,236556,0,3,1
67557,2,3,236555,236556,236559,1,4,0
67558,6,3,236561,236561,236564,0,3,2
67559,2,3,236563,236564,236567,1,4,0
67560,6,2,236569,236569,236571,0,2,2
67561,1,2,236570,236571,236573,1,3,0
67562,3,2,236573,236573,236575,0,2,0
67563,4,2,236577,236577,236579,0,2,2
67564,2,3,236579,236579,236582,0,3,0
67565,6,1,236585,236585,236586,0,1,3
67566,4,1,236589,236589,236590,0,1,3
67567,3,1,236592,236592,236593,0,1,2
67568,4,2,236596,236596,236598,0,2,3
67569,3,3,236599,236599,236602,0,3,1
67570,5,2,236604,236604,236606,0,2,2
67571,4,1,236608,236608,236609,0,1,2
67572,5,2,236613,236613,236615,0,2,4
67573,1,2,236614,236615,236617,1,3,0
67574,3,1,236617,236617,236618,0,1,0
67575,3,1,236620,236620,236621,0,1,2
67576,6,2,236626,236626,236628,0,2,5
67577,5,2,236631,236631,236633,0,2,3
67578,3,1,236634,236634,236635,0,1,1
67579,2,3,236636,236636,236639,0,3,1
67580,3,3,236639,236639,236642,0,3,0
67581,5,2,236644,236644,236646,0,2,2
67582,1,2,236645,236646,236648,1,3,0
67583,4,3,236649,236649,236652,0,3,1
67584,4,1,236653,236653,236654,0,1,1
67585,3,2,236656,236656,236658,0,2,2
67586,2,1,236658,236658,236659,0,1,0
67587,6,3,236664,236664,236667,0,3,5
67588,5,3,236669,236669,236672,0,3,2
67589,6,2,236675,236675,236677,0,2,3
67590,4,2,236679,236679,236681,0,2,2
67591,4,1,236683,236683,236684,0,1,2
67592,2,2,236685,236685,236687,0,2,1
67593,3,1,236688,236688,236689,0,1,1
67594,2,2,236690,236690,236692,0,2,1
67595,5,2,236695,236695,236697,0,2,3
67596,6,1,236701,236701,236702,0,1,4
67597,4,2,236705,236705,236707,0,2,3
67598,5,3,236710,236710,236713,0,3,3
67599,3,1,236713,236713,236714,0,1,0
67600,2,2,236715,236715,236717,0,2,1
67601,2,3,236717,236717,236720,0,3,0
67602,4,3,236721,236721,236724,0,3,1
67603,5,1,236726,236726,236727,0,1,2
67604,1,3,236727,236727,236730,0,3,0
67605,1,2,236728,236730,236732,2,4,0
67606,4,3,236732,236732,236735,0,3,0
67607,6,1,236738,236738,236739,0,1,3
67608,3,3,236741,236741,236744,0,3,2
67609,4,2,236745,236745,236747,0,2,1
67610,2,3,236747,236747,236750,0,3,0
67611,6,2,236753,236753,236755,0,2,3
67612,5,3,236758,236758,236761,0,3,3
67613,4,3,236762,236762,236765,0,3,1
67614,6,2,236768,236768,236770,0,2,3
67615,2,2,236770,236770,236772,0,2,0
67616,3,2,236773,236773,236775,0,2,1
67617,4,2,236777,236777,236779,0,2,2
67618,2,1,236779,236779,236780,0,1,0
67619,2,1,236781,236781,236782,0,1,1
67620,3,3,236784,236784,236787,0,3,2
67621,5,2,236789,236789,236791,0,2,2
67622,6,2,236795,236795,236797,0,2,4
67623,2,3,236797,236797,236800,0,3,0
67624,6,1,236803,236803,236804,0,1,3
67625,2,2,236805,236805,236807,0,2,1
67626,2,2,236807,236807,236809,0,2,0
67627,4,1,236811,236811,236812,0,1,2
67628,6,2,236817,236817,236819,0,2,5
67629,5,2,236822,236822,236824,0,2,3
67630,2,1,236824,236824,236825,0,1,0
67631,1,3,236825,236825,236828,0,3,0
67632,5,3,236830,236830,236833,0,3,2
67633,3,3,236833,236833,236836,0,3,0
67634,1,3,236834,236836,236839,2,5,0
67635,5,1,236839,236839,236840,0,1,0
67636,3,3,236842,236842,236845,0,3,2
67637,6,2,236848,236848,236850,0,2,3
67638,3,3,236851,236851,236854,0,3,1
67639,3,3,236854,236854,236857,0,3,0
67640,6,1,236860,236860,236861,0,1,3
67641,3,1,236863,236863,236864,0,1,2
67642,3,1,236866,236866,236867,0,1,2
67643,6,3,236872,236872,236875,0,3,5
67644,3,2,236875,236875,236877,0,2,0
67645,5,3,236880,236880,236883,0,3,3
67646,2,2,236882,236883,236885,1,3,0
67647,2,1,236884,236885,236886,1,2,0
67648,4,2,236888,236888,236890,0,2,2
67649,5,3,236893,236893,236896,0,3,3
67650,3,1,236896,236896,236897,0,1,0
67651,5,1,236901,236901,236902,0,1,4
67652,2,2,236903,236903,236905,0,2,1
67653,4,1,236907,236907,236908,0,1,2
67654,5,1,236912,236912,236913,0,1,4
67655,4,1,236916,236916,236917,0,1,3
67656,2,1,236918,236918,236919,0,1,1
67657,4,2,236922,236922,236924,0,2,3
67658,5,3,236927,236927,236930,0,3,3
67659,4,3,236931,236931,236934,0,3,1
67660,6,2,236937,236937,236939,0,2,3
67661,3,3,236940,236940,236943,0,3,1
67662,2,2,236942,236943,236945,1,3,0
67663,4,3,236946,236946,236949,0,3,1
67664,6,1,236952,236952,236953,0,1,3
67665,1,2,236953,236953,236955,0,2,0
67666,4,2,236957,236957,236959,0,2,2
67667,2,2,236959,236959,236961,0,2,0
67668,3,2,236962,236962,236964,0,2,1
67669,4,3,236966,236966,236969,0,3,2
67670,1,2,236967,236969,236971,2,4,0
67671,5,1,236972,236972,236973,0,1,1
67672,2,1,236974,236974,236975,0,1,1
67673,1,3,236975,236975,236978,0,3,0
67674,2,3,236977,236978,236981,1,4,0
67675,5,1,236982,236982,236983,0,1,1
67676,5,2,236987,236987,236989,0,2,4
67677,3,1,236990,236990,236991,0,1,1
67678,4,1,236994,236994,236995,0,1,3
67679,1,2,236995,236995,236997,0,2,0
67680,2,1,236997,236997,236998,0,1,0
67681,2,1,236999,236999,237000,0,1,1
67682,4,3,237003,237003,237006,0,3,3
67683,4,2,237007,237007,237009,0,2,1
67684,3,3,237010,237010,237013,0,3,1
67685,5,1,237015,237015,237016,0,1,2
67686,2,1,237017,237017,237018,0,1,1
67687,2,2,237019,237019,237021,0,2,1
67688,5,2,237024,237024,237026,0,2,3
67689,1,3,237025,237026,237029,1,4,0
67690,4,1,237029,237029,237030,0,1,0
67691,4,2,237033,237033,237035,0,2,3
67692,4,1,237037,237037,237038,0,1,2
67693,4,2,237041,237041,237043,0,2,3
67694,1,3,237042,237043,237046,1,4,0
67695,3,3,237045,237046,237049,1,4,0
67696,1,1,237046,237049,237050,3,4,0
67697,1,2,237047,237050,237052,3,5,0
67698,1,2,237048,237052,237054,4,6,0
67699,5,2,237053,237054,237056,1,3,0
67700,3,3,237056,237056,237059,0,3,0
67701,4,1,237060,237060,237061,0,1,1
67702,5,1,237065,237065,237066,0,1,4
67703,1,3,237066,237066,237069,0,3,0
67704,1,2,237067,237069,237071,2,4,0
67705,3,3,237070,237071,237074,1,4,0
67706,2,2,237072,237074,237076,2,4,0
67707,4,3,237076,237076,237079,0,3,0
67708,4,1,237080,237080,237081,0,1,1
67709,4,1,237084,237084,237085,0,1,3
67710,4,2,237088,237088,237090,0,2,3
67711,6,3,237094,237094,237097,0,3,4
67712,4,1,237098,237098,237099,0,1,1
67713,6,3,237104,237104,237107,0,3,5
67714,3,3,237107,237107,237110,0,3,0
67715,2,2,237109,237110,237112,1,3,0
67716,4,3,237113,237113,237116,0,3,1
67717,4,2,237117,237117,237119,0,2,1
67718,2,1,237119,237119,237120,0,1,0
67719,3,3,237122,237122,237125,0,3,2
67720,5,3,237127,237127,237130,0,3,2
67721,5,3,237132,237132,237135,0,3,2
67722,5,3,237137,237137,237140,0,3,2
67723,2,3,237139,237140,237143,1,4,0
67724,6,2,237145,237145,237147,0,2,2
67725,2,1,237147,237147,237148,0,1,0
67726,2,3,237149,237149,237152,0,3,1
67727,6,1,237155,237155,237156,0,1,3
67728,3,2,237158,237158,237160,0,2,2
67729,5,3,237163,237163,237166,0,3,3
67730,6,3,237169,237169,237172,0,3,3
67731,5,2,237174,237174,237176,0,2,2
67732,3,2,237177,237177,237179,0,2,1
67733,3,2,237180,237180,237182,0,2,1
67734,6,2,237186,237186,237188,0,2,4
67735,1,2,237187,237188,237190,1,3,0
67736,2,2,237189,237190,237192,1,3,0
67737,1,3,237190,237192,237195,2,5,0
67738,2,2,237192,237195,237197,3,5,0
67739,5,3,237197,237197,237200,0,3,0
67740,2,1,237199,237200,237201,1,2,0
67741,1,3,237200,237201,237204,1,4,0
67742,5,2,237205,237205,237207,0,2,1
67743,6,1,237211,237211,237212,0,1,4
67744,1,2,237212,237212,237214,0,2,0
67745,3,3,237215,237215,237218,0,3,1
67746,6,3,237221,237221,237224,0,3,3
67747,1,1,237222,237224,237225,2,3,0
67748,1,3,237223,237225,237228,2,5,0
67749,2,2,237225,237228,237230,3,5,0
67750,5,2,237230,237230,237232,0,2,0
67751,3,2,237233,237233,237235,0,2,1
67752,5,3,237238,237238,237241,0,3,3
67753,3,2,237241,237241,237243,0,2,0
67754,6,3,237247,237247,237250,0,3,4
67755,6,3,237253,237253,237256,0,3,3
67756,2,2,237255,237256,237258,1,3,0
67757,5,2,237260,237260,237262,0,2,2
67758,4,2,237264,237264,237266,0,2,2
67759,5,3,237269,237269,237272,0,3,3
67760,5,3,237274,237274,237277,0,3,2
67761,2,3,237276,237277,237280,1,4,0
67762,4,2,237280,237280,237282,0,2,0
67763,5,2,237285,237285,237287,0,2,3
67764,6,1,237291,237291,237292,0,1,4
67765,6,3,237297,237297,237300,0,3,5
67766,1,2,237298,237300,237302,2,4,0
67767,6,3,237304,237304,237307,0,3,2
67768,1,3,237305,237307,237310,2,5,0
67769,6,3,237311,237311,237314,0,3,1
67770,2,2,237313,237314,237316,1,3,0
67771,2,1,237315,237316,237317,1,2,0
67772,2,1,237317,237317,237318,0,1,0
67773,1,3,237318,237318,237321,0,3,0
67774,4,1,237322,237322,237323,0,1,1
67775,2,3,237324,237324,237327,0,3,1
67776,4,2,237328,237328,237330,0,2,1
67777,1,3,237329,237330,237333,1,4,0
67778,3,3,237332,237333,237336,1,4,0
67779,5,3,237337,237337,237340,0,3,1
67780,4,1,237341,237341,237342,0,1,1
67781,3,1,237344,237344,237345,0,1,2
67782,3,3,237347,237347,237350,0,3,2
67783,6,1,237353,237353,237354,0,1,3
67784,6,1,237359,237359,237360,0,1,5
67785,5,2,237364,237364,237366,0,2,4
67786,2,1,237366,237366,237367,0,1,0
67787,1,1,237367,237367,237368,0,1,0
67788,4,1,237371,237371,237372,0,1,3
67789,1,1,237372,237372,237373,0,1,0
67790,5,1,237377,237377,237378,0,1,4
67791,1,3,237378,237378,237381,0,3,0
67792,2,3,237380,237381,237384,1,4,0
67793,5,1,237385,237385,237386,0,1,1
67794,3,3,237388,237388,237391,0,3,2
67795,1,1,237389,237391,237392,2,3,0
67796,5,2,237394,237394,237396,0,2,2
67797,1,1,237395,237396,237397,1,2,0
67798,1,3,237396,237397,237400,1,4,0
67799,4,2,237400,237400,237402,0,2,0
67800,3,1,237403,237403,237404,0,1,1
67801,6,2,237409,237409,237411,0,2,5
67802,4,3,237413,237413,237416,0,3,2
67803,4,3,237417,237417,237420,0,3,1
67804,2,3,237419,237420,237423,1,4,0
67805,5,1,237424,237424,237425,0,1,1
67806,1,3,237425,237425,237428,0,3,0
67807,3,3,237428,237428,237431,0,3,0
67808,2,1,237430,237431,237432,1,2,0
67809,5,3,237435,237435,237438,0,3,3
67810,5,3,237440,237440,237443,0,3,2
67811,6,2,237446,237446,237448,0,2,3
67812,1,1,237447,237448,237449,1,2,0
67813,5,2,237452,237452,237454,0,2,3
67814,1,2,237453,237454,237456,1,3,0
67815,3,1,237456,237456,237457,0,1,0
67816,3,2,237459,237459,237461,0,2,2
67817,4,3,237463,237463,237466,0,3,2
67818,1,2,237464,237466,237468,2,4,0
67819,1,3,237465,237468,237471,3,6,0
67820,2,3,237467,237471,237474,4,7,0
67821,4,3,237471,237474,237477,3,6,0
67822,6,2,237477,237477,237479,0,2,0
67823,5,2,237482,237482,237484,0,2,3
67824,1,3,237483,237484,237487,1,4,0
67825,4,3,237487,237487,237490,0,3,0
67826,5,3,237492,237492,237495,0,3,2
67827,5,1,237497,237497,237498,0,1,2
67828,6,3,237503,237503,237506,0,3,5
67829,1,3,237504,237506,237509,2,5,0
67830,6,1,237510,237510,237511,0,1,1
67831,6,2,237516,237516,237518,0,2,5
67832,5,2,237521,237521,237523,0,2,3
67833,6,1,237527,237527,237528,0,1,4
67834,4,2,237531,237531,237533,0,2,3
67835,3,1,237534,237534,237535,0,1,1
67836,3,3,237537,237537,237540,0,3,2
67837,4,1,237541,237541,237542,0,1,1
67838,6,2,237547,237547,237549,0,2,5
67839,4,2,237551,237551,237553,0,2,2
67840,6,2,237557,237557,237559,0,2,4
67841,4,2,237561,237561,237563,0,2,2
67842,3,3,237564,237564,237567,0,3,1
67843,5,3,237569,237569,237572,0,3,2
67844,3,1,237572,237572,237573,0,1,0
67845,3,3,237575,237575,237578,0,3,2
67846,3,3,237578,237578,237581,0,3,0
67847,5,3,237583,237583,237586,0,3,2
67848,5,1,237588,237588,237589,0,1,2
67849,3,3,237591,237591,237594,0,3,2
67850,1,1,237592,237594,237595,2,3,0
67851,4,1,237596,237596,237597,0,1,1
67852,5,1,237601,237601,237602,0,1,4
67853,1,3,237602,237602,237605,0,3,0
67854,3,2,237605,237605,237607,0,2,0
67855,1,3,237606,237607,237610,1,4,0
67856,4,3,237610,237610,237613,0,3,0
67857,6,1,237616,237616,237617,0,1,3
67858,3,1,237619,237619,237620,0,1,2
67859,2,3,237621,237621,237624,0,3,1
67860,4,1,237625,237625,237626,0,1,1
67861,6,1,237631,237631,237632,0,1,5
67862,3,3,237634,237634,237637,0,3,2
67863,6,2,237640,237640,237642,0,2,3
67864,3,3,237643,237643,237646,0,3,1
67865,3,3,237646,237646,237649,0,3,0
67866,4,2,237650,237650,237652,0,2,1
67867,1,3,237651,237652,237655,1,4,0
67868,1,1,237652,237655,237656,3,4,0
67869,5,3,237657,237657,237660,0,3,1
67870,4,3,237661,237661,237664,0,3,1
67871,3,1,237664,237664,237665,0,1,0
67872,4,3,237668,237668,237671,0,3,3
67873,5,1,237673,237673,237674,0,1,2
67874,2,1,237675,237675,237676,0,1,1
67875,3,3,237678,237678,237681,0,3,2
67876,2,1,237680,237681,237682,1,2,0
67877,2,3,237682,237682,237685,0,3,0
67878,5,1,237687,237687,237688,0,1,2
67879,2,2,237689,237689,237691,0,2,1
67880,3,1,237692,237692,237693,0,1,1
67881,3,2,237695,237695,237697,0,2,2
67882,5,2,237700,237700,237702,0,2,3
67883,4,3,237704,237704,237707,0,3,2
67884,5,3,237709,237709,237712,0,3,2
67885,3,3,237712,237712,237715,0,3,0
67886,1,1,237713,237715,237716,2,3,0
67887,2,2,237715,237716,237718,1,3,0
67888,2,3,237717,237718,237721,1,4,0
67889,4,1,237721,237721,237722,0,1,0
67890,6,1,237727,237727,237728,0,1,5
67891,4,3,237731,237731,237734,0,3,3
67892,5,2,237736,237736,237738,0,2,2
67893,2,3,237738,237738,237741,0,3,0
67894,1,3,237739,237741,237744,2,5,0
67895,5,2,237744,237744,237746,0,2,0
67896,3,1,237747,237747,237748,0,1,1
67897,4,2,237751,237751,237753,0,2,3
67898,4,1,237755,237755,237756,0,1,2
67899,3,1,237758,237758,237759,0,1,2
67900,2,1,237760,237760,237761,0,1,1
67901,6,2,237766,237766,237768,0,2,5
67902,3,2,237769,237769,237771,0,2,1
67903,6,3,237775,237775,237778,0,3,4
67904,2,3,237777,237778,237781,1,4,0
67905,2,1,237779,237781,237782,2,3,0
67906,1,2,237780,237782,237784,2,4,0
67907,5,3,237785,237785,237788,0,3,1
67908,6,2,237791,237791,237793,0,2,3
67909,3,3,237794,237794,237797,0,3,1
67910,1,3,237795,237797,237800,2,5,0
67911,2,1,237797,237800,237801,3,4,0
67912,5,2,237802,237802,237804,0,2,1
67913,6,2,237808,237808,237810,0,2,4
67914,6,1,237814,237814,237815,0,1,4
67915,4,2,237818,237818,237820,0,2,3
67916,4,1,237822,237822,237823,0,1,2
67917,5,3,237827,237827,237830,0,3,4
67918,6,3,237833,237833,237836,0,3,3
67919,3,3,237836,237836,237839,0,3,0
67920,5,3,237841,237841,237844,0,3,2
67921,1,1,237842,237844,237845,2,3,0
67922,6,1,237848,237848,237849,0,1,3
67923,3,1,237851,237851,237852,0,1,2
67924,3,1,237854,237854,237855,0,1,2
67925,2,2,237856,237856,237858,0,2,1
67926,2,3,237858,237858,237861,0,3,0
67927,3,2,237861,237861,237863,0,2,0
67928,6,2,237867,237867,237869,0,2,4
67929,3,2,237870,237870,237872,0,2,1
67930,6,2,237876,237876,237878,0,2,4
67931,5,3,237881,237881,237884,0,3,3
67932,4,1,237885,237885,237886,0,1,1
67933,5,1,237890,237890,237891,0,1,4
67934,1,2,237891,237891,237893,0,2,0
67935,2,3,237893,237893,237896,0,3,0
67936,3,1,237896,237896,237897,0,1,0
67937,6,2,237902,237902,237904,0,2,5
67938,4,2,237906,237906,237908,0,2,2
67939,6,1,237912,237912,237913,0,1,4
67940,4,1,237916,237916,237917,0,1,3
67941,6,2,237922,237922,237924,0,2,5
67942,3,3,237925,237925,237928,0,3,1
67943,4,3,237929,237929,237932,0,3,1
67944,1,1,237930,237932,237933,2,3,0
67945,2,3,237932,237933,237936,1,4,0
67946,1,3,237933,237936,237939,3,6,0
67947,5,1,237938,237939,237940,1,2,0
67948,3,2,237941,237941,237943,0,2,1
67949,4,1,237945,237945,237946,0,1,2
67950,4,2,237949,237949,237951,0,2,3
67951,4,1,237953,237953,237954,0,1,2
67952,1,2,237954,237954,237956,0,2,0
67953,2,3,237956,237956,237959,0,3,0
67954,6,1,237962,237962,237963,0,1,3
67955,3,3,237965,237965,237968,0,3,2
67956,1,3,237966,237968,237971,2,5,0
67957,3,1,237969,237971,237972,2,3,0
67958,4,2,237973,237973,237975,0,2,1
67959,6,3,237979,237979,237982,0,3,4
67960,4,2,237983,237983,237985,0,2,1
67961,1,1,237984,237985,237986,1,2,0
67962,2,2,237986,237986,237988,0,2,0
67963,4,1,237990,237990,237991,0,1,2
67964,1,3,237991,237991,237994,0,3,0
67965,5,3,237996,237996,237999,0,3,2
67966,5,1,238001,238001,238002,0,1,2
67967,5,1,238006,238006,238007,0,1,4
67968,2,1,238008,238008,238009,0,1,1
67969,1,3,238009,238009,238012,0,3,0
67970,6,2,238015,238015,238017,0,2,3
67971,2,1,238017,238017,238018,0,1,0
67972,1,1,238018,238018,238019,0,1,0
67973,1,2,238019,238019,238021,0,2,0
67974,3,2,238022,238022,238024,0,2,1
67975,2,3,238024,238024,238027,0,3,0
67976,4,2,238028,238028,238030,0,2,1
67977,6,2,238034,238034,238036,0,2,4
67978,6,1,238040,238040,238041,0,1,4
67979,6,2,238046,238046,238048,0,2,5
67980,2,1,238048,238048,238049,0,1,0
67981,4,1,238052,238052,238053,0,1,3
67982,2,3,238054,238054,238057,0,3,1
67983,2,2,238056,238057,238059,1,3,0
67984,6,1,238062,238062,238063,0,1,3
67985,1,1,238063,238063,238064,0,1,0
67986,1,2,238064,238064,238066,0,2,0
67987,3,3,238067,238067,238070,0,3,1
67988,2,3,238069,238070,238073,1,4,0
67989,3,1,238072,238073,238074,1,2,0
67990,6,3,238078,238078,238081,0,3,4
67991,5,2,238083,238083,238085,0,2,2
67992,6,1,238089,238089,238090,0,1,4
67993,6,2,238095,238095,238097,0,2,5
67994,4,1,238099,238099,238100,0,1,2
67995,4,3,238103,238103,238106,0,3,3
67996,1,1,238104,238106,238107,2,3,0
67997,3,1,238107,238107,238108,0,1,0
67998,5,1,238112,238112,238113,0,1,4
67999,2,3,238114,238114,238117,0,3,1
68000,3,3,238117,238117,238120,0,3,0
68001,6,1,238123,238123,238124,0,1,3
68002,1,3,238124,238124,238127,0,3,0
68003,2,2,238126,238127,238129,1,3,0
68004,1,1,238127,238129,238130,2,3,0
68005,3,3,238130,238130,238133,0,3,0
68006,2,1,238132,238133,238134,1,2,0
68007,4,2,238136,238136,238138,0,2,2
68008,3,2,238139,238139,238141,0,2,1
68009,1,2,238140,238141,238143,1,3,0
68010,3,2,238143,238143,238145,0,2,0
68011,3,3,238146,238146,238149,0,3,1
68012,1,1,238147,238149,238150,2,3,0
68013,5,1,238152,238152,238153,0,1,2
68014,2,3,238154,238154,238157,0,3,1
68015,5,2,238159,238159,238161,0,2,2
68016,2,3,238161,238161,238164,0,3,0
68017,5,3,238166,238166,238169,0,3,2
68018,1,1,238167,238169,238170,2,3,0
68019,4,3,238171,238171,238174,0,3,1
68020,6,1,238177,238177,238178,0,1,3
68021,1,1,238178,238178,238179,0,1,0
68022,3,1,238181,238181,238182,0,1,2
68023,1,3,238182,238182,238185,0,3,0
68024,5,2,238187,238187,238189,0,2,2
68025,5,3,238192,238192,238195,0,3,3
68026,2,1,238194,238195,238196,1,2,0
68027,3,1,238197,238197,238198,0,1,1
68028,4,3,238201,238201,238204,0,3,3
68029,2,1,238203,238204,238205,1,2,0
68030,6,2,238209,238209,238211,0,2,4
68031,4,1,238213,238213,238214,0,1,2
68032,4,2,238217,238217,238219,0,2,3
68033,5,1,238222,238222,238223,0,1,3
68034,3,1,238225,238225,238226,0,1,2
68035,6,1,238231,238231,238232,0,1,5
68036,3,1,238234,238234,238235,0,1,2
68037,6,1,238240,238240,238241,0,1,5
68038,5,3,238245,238245,238248,0,3,4
68039,3,3,238248,238248,238251,0,3,0
68040,4,3,238252,238252,238255,0,3,1
68041,1,3,238253,238255,238258,2,5,0
68042,1,3,238254,238258,238261,4,7,0
68043,3,1,238257,238261,238262,4,5,0
68044,2,3,238259,238262,238265,3,6,0
68045,6,1,238265,238265,238266,0,1,0
68046,5,2,238270,238270,238272,0,2,4
68047,1,2,238271,238272,238274,1,3,0
68048,2,2,238273,238274,238276,1,3,0
68049,5,2,238278,238278,238280,0,2,2
68050,1,1,238279,238280,238281,1,2,0
68051,3,2,238282,238282,238284,0,2,1
68052,3,1,238285,238285,238286,0,1,1
68053,6,1,238291,238291,238292,0,1,5
68054,6,3,238297,238297,238300,0,3,5
68055,3,1,238300,238300,238301,0,1,0
68056,1,2,238301,238301,238303,0,2,0
68057,2,3,238303,238303,238306,0,3,0
68058,5,1,238308,238308,238309,0,1,2
68059,6,3,238314,238314,238317,0,3,5
68060,2,3,238316,238317,238320,1,4,0
68061,5,3,238321,238321,238324,0,3,1
68062,3,1,238324,238324,238325,0,1,0
68063,3,2,238327,238327,238329,0,2,2
68064,3,3,238330,238330,238333,0,3,1
68065,2,3,238332,238333,238336,1,4,0
68066,1,1,238333,238336,238337,3,4,0
68067,3,3,238336,238337,238340,1,4,0
68068,2,3,238338,238340,238343,2,5,0
68069,5,2,238343,238343,238345,0,2,0
68070,1,3,238344,238345,238348,1,4,0
68071,6,3,238350,238350,238353,0,3,2
68072,4,3,238354,238354,238357,0,3,1
68073,3,3,238357,238357,238360,0,3,0
68074,3,1,238360,238360,238361,0,1,0
68075,2,1,238362,238362,238363,0,1,1
68076,5,3,238367,238367,238370,0,3,4
68077,6,3,238373,238373,238376,0,3,3
68078,6,1,238379,238379,238380,0,1,3
68079,5,1,238384,238384,238385,0,1,4
68080,6,2,238390,238390,238392,0,2,5
68081,2,2,238392,238392,238394,0,2,0
68082,5,1,238397,238397,238398,0,1,3
68083,4,2,238401,238401,238403,0,2,3
68084,2,2,238403,238403,238405,0,2,0
68085,5,3,238408,238408,238411,0,3,3
68086,4,1,238412,238412,238413,0,1,1
68087,2,2,238414,238414,238416,0,2,1
68088,5,2,238419,238419,238421,0,2,3
68089,6,3,238425,238425,238428,0,3,4
68090,2,1,238427,238428,238429,1,2,0
68091,3,3,238430,238430,238433,0,3,1
68092,2,1,238432,238433,238434,1,2,0
68093,1,2,238433,238434,238436,1,3,0
68094,6,3,238439,238439,238442,0,3,3
68095,6,1,238445,238445,238446,0,1,3
68096,4,2,238449,238449,238451,0,2,3
68097,2,1,238451,238451,238452,0,1,0
68098,5,2,238456,238456,238458,0,2,4
68099,2,2,238458,238458,238460,0,2,0
68100,6,1,238464,238464,238465,0,1,4
68101,5,1,238469,238469,238470,0,1,4
68102,4,3,238473,238473,238476,0,3,3
68103,5,1,238478,238478,238479,0,1,2
68104,2,3,238480,238480,238483,0,3,1
68105,4,2,238484,238484,238486,0,2,1
68106,6,1,238490,238490,238491,0,1,4
68107,5,3,238495,238495,238498,0,3,4
68108,4,3,238499,238499,238502,0,3,1
68109,3,1,238502,238502,238503,0,1,0
68110,3,1,238505,238505,238506,0,1,2
68111,5,3,238510,238510,238513,0,3,4
68112,5,3,238515,238515,238518,0,3,2
68113,5,2,238520,238520,238522,0,2,2
68114,5,2,238525,238525,238527,0,2,3
68115,4,1,238529,238529,238530,0,1,2
68116,4,3,238533,238533,238536,0,3,3
68117,4,1,238537,238537,238538,0,1,1
68118,5,2,238542,238542,238544,0,2,4
68119,1,3,238543,238544,238547,1,4,0
68120,1,3,238544,238547,238550,3,6,0
68121,6,2,238550,238550,238552,0,2,0
68122,5,3,238555,238555,238558,0,3,3
68123,2,2,238557,238558,238560,1,3,0
68124,3,2,238560,238560,238562,0,2,0
68125,3,1,238563,238563,238564,0,1,1
68126,5,2,238568,238568,238570,0,2,4
68127,6,3,238574,238574,238577,0,3,4
68128,1,1,238575,238577,238578,2,3,0
68129,6,2,238581,238581,238583,0,2,3
68130,3,2,238584,238584,238586,0,2,1
68131,1,2,238585,238586,238588,1,3,0
68132,6,3,238591,238591,238594,0,3,3
68133,3,2,238594,238594,238596,0,2,0
68134,6,2,238600,238600,238602,0,2,4
68135,1,2,238601,238602,238604,1,3,0
68136,6,2,238607,238607,238609,0,2,3
68137,4,3,238611,238611,238614,0,3,2
68138,1,3,238612,238614,238617,2,5,0
68139,6,3,238618,238618,238621,0,3,1
68140,5,2,238623,238623,238625,0,2,2
68141,3,1,238626,238626,238627,0,1,1
68142,6,2,238632,238632,238634,0,2,5
68143,4,1,238636,238636,238637,0,1,2
68144,1,1,238637,238637,238638,0,1,0
68145,1,2,238638,238638,238640,0,2,0
68146,5,1,238643,238643,238644,0,1,3
68147,5,3,238648,238648,238651,0,3,4
68148,5,1,238653,238653,238654,0,1,2
68149,4,3,238657,238657,238660,0,3,3
68150,6,1,238663,238663,238664,0,1,3
68151,2,3,238665,238665,238668,0,3,1
68152,4,3,238669,238669,238672,0,3,1
68153,6,1,238675,238675,238676,0,1,3
68154,2,1,238677,238677,238678,0,1,1
68155,2,1,238679,238679,238680,0,1,1
68156,2,3,238681,238681,238684,0,3,1
68157,5,2,238686,238686,238688,0,2,2
68158,1,1,238687,238688,238689,1,2,0
68159,6,3,238693,238693,238696,0,3,4
68160,6,3,238699,238699,238702,0,3,3
68161,3,3,238702,238702,238705,0,3,0
68162,6,3,238708,238708,238711,0,3,3
68163,2,3,238710,238711,238714,1,4,0
68164,3,1,238713,238714,238715,1,2,0
68165,3,1,238716,238716,238717,0,1,1
68166,4,3,238720,238720,238723,0,3,3
68167,3,1,238723,238723,238724,0,1,0
68168,6,2,238729,238729,238731,0,2,5
68169,5,2,238734,238734,238736,0,2,3
68170,3,1,238737,238737,238738,0,1,1
68171,1,1,238738,238738,238739,0,1,0
68172,3,1,238741,238741,238742,0,1,2
68173,2,2,238743,238743,238745,0,2,1
68174,4,3,238747,238747,238750,0,3,2
68175,3,3,238750,238750,238753,0,3,0
68176,5,1,238755,238755,238756,0,1,2
68177,6,3,238761,238761,238764,0,3,5
68178,2,1,238763,238764,238765,1,2,0
68179,4,3,238767,238767,238770,0,3,2
68180,6,2,238773,238773,238775,0,2,3
68181,6,2,238779,238779,238781,0,2,4
68182,2,1,238781,238781,238782,0,1,0
68183,6,3,238787,238787,238790,0,3,5
68184,5,3,238792,238792,238795,0,3,2
68185,6,3,238798,238798,238801,0,3,3
68186,1,2,238799,238801,238803,2,4,0
68187,5,1,238804,238804,238805,0,1,1
68188,5,1,238809,238809,238810,0,1,4
68189,6,3,238815,238815,238818,0,3,5
68190,5,3,238820,238820,238823,0,3,2
68191,1,2,238821,238823,238825,2,4,0
68192,2,2,238823,238825,238827,2,4,0
68193,4,3,238827,238827,238830,0,3,0
68194,6,2,238833,238833,238835,0,2,3
68195,4,2,238837,238837,238839,0,2,2
68196,1,1,238838,238839,238840,1,2,0
68197,4,3,238842,238842,238845,0,3,2
68198,2,3,238844,238845,238848,1,4,0
68199,5,3,238849,238849,238852,0,3,1
68200,2,2,238851,238852,238854,1,3,0
68201,3,3,238854,238854,238857,0,3,0
68202,5,2,238859,238859,238861,0,2,2
68203,2,2,238861,238861,238863,0,2,0
68204,2,1,238863,238863,238864,0,1,0
68205,2,1,238865,238865,238866,0,1,1
68206,5,1,238870,238870,238871,0,1,4
68207,5,1,238875,238875,238876,0,1,4
68208,6,1,238881,238881,238882,0,1,5
68209,5,3,238886,238886,238889,0,3,4
68210,5,2,238891,238891,238893,0,2,2
68211,4,2,238895,238895,238897,0,2,2
68212,3,1,238898,238898,238899,0,1,1
68213,2,2,238900,238900,238902,0,2,1
68214,1,2,238901,238902,238904,1,3,0
68215,3,2,238904,238904,238906,0,2,0
68216,1,2,238905,238906,238908,1,3,0
68217,1,2,238906,238908,238910,2,4,0
68218,1,3,238907,238910,238913,3,6,0
68219,3,2,238910,238913,238915,3,5,0
68220,3,1,238913,238915,238916,2,3,0
68221,4,3,238917,238917,238920,0,3,1
68222,4,2,238921,238921,238923,0,2,1
68223,4,3,238925,238925,238928,0,3,2
68224,6,2,238931,238931,238933,0,2,3
68225,4,3,238935,238935,238938,0,3,2
68226,5,2,238940,238940,238942,0,2,2
68227,2,1,238942,238942,238943,0,1,0
68228,4,3,238946,238946,238949,0,3,3
68229,4,3,238950,238950,238953,0,3,1
68230,5,3,238955,238955,238958,0,3,2
68231,4,1,238959,238959,238960,0,1,1
68232,5,3,238964,238964,238967,0,3,4
68233,4,1,238968,238968,238969,0,1,1
68234,2,1,238970,238970,238971,0,1,1
68235,4,1,238974,238974,238975,0,1,3
68236,3,2,238977,238977,238979,0,2,2
68237,3,2,238980,238980,238982,0,2,1
68238,1,1,238981,238982,238983,1,2,0
68239,2,1,238983,238983,238984,0,1,0
68240,6,3,238989,238989,238992,0,3,5
68241,5,3,238994,238994,238997,0,3,2
68242,5,1,238999,238999,239000,0,1,2
68243,5,3,239004,239004,239007,0,3,4
68244,3,1,239007,239007,239008,0,1,0
68245,3,2,239010,239010,239012,0,2,2
68246,1,1,239011,239012,239013,1,2,0
68247,6,1,239017,239017,239018,0,1,4
68248,4,2,239021,239021,239023,0,2,3
68249,5,3,239026,239026,239029,0,3,3
68250,4,2,239030,239030,239032,0,2,1
68251,4,2,239034,239034,239036,0,2,2
68252,2,1,239036,239036,239037,0,1,0
68253,2,1,239038,239038,239039,0,1,1
68254,6,2,239044,239044,239046,0,2,5
68255,1,3,239045,239046,239049,1,4,0
68256,5,2,239050,239050,239052,0,2,1
68257,4,3,239054,239054,239057,0,3,2
68258,2,3,239056,239057,239060,1,4,0
68259,3,3,239059,239060,239063,1,4,0
68260,5,2,239064,239064,239066,0,2,1
68261,6,3,239070,239070,239073,0,3,4
68262,2,3,239072,239073,239076,1,4,0
68263,2,2,239074,239076,239078,2,4,0
68264,3,2,239077,239078,239080,1,3,0
68265,5,3,239082,239082,239085,0,3,2
68266,5,3,239087,239087,239090,0,3,2
68267,2,2,239089,239090,239092,1,3,0
68268,2,2,239091,239092,239094,1,3,0
68269,2,3,239093,239094,239097,1,4,0
68270,1,3,239094,239097,239100,3,6,0
68271,2,3,239096,239100,239103,4,7,0
68272,4,3,239100,239103,239106,3,6,0
68273,4,1,239104,239106,239107,2,3,0
68274,2,2,239106,239107,239109,1,3,0
68275,1,2,239107,239109,239111,2,4,0
68276,3,3,239110,239111,239114,1,4,0
68277,5,1,239115,239115,239116,0,1,1
68278,6,2,239121,239121,239123,0,2,5
68279,6,2,239127,239127,239129,0,2,4
68280,6,1,239133,239133,239134,0,1,4
68281,3,3,239136,239136,239139,0,3,2
68282,3,1,239139,239139,239140,0,1,0
68283,2,2,239141,239141,239143,0,2,1
68284,1,2,239142,239143,239145,1,3,0
68285,4,1,239146,239146,239147,0,1,1
68286,2,2,239148,239148,239150,0,2,1
68287,5,2,239153,239153,239155,0,2,3
68288,4,3,239157,239157,239160,0,3,2
68289,4,2,239161,239161,239163,0,2,1
68290,1,1,239162,239163,239164,1,2,0
68291,3,2,239165,239165,239167,0,2,1
68292,4,2,239169,239169,239171,0,2,2
68293,5,1,239174,239174,239175,0,1,3
68294,6,1,239180,239180,239181,0,1,5
68295,1,3,239181,239181,239184,0,3,0
68296,4,3,239185,239185,239188,0,3,1
68297,2,3,239187,239188,239191,1,4,0
68298,2,1,239189,239191,239192,2,3,0
68299,1,2,239190,239192,239194,2,4,0
68300,1,3,239191,239194,239197,3,6,0
68301,6,3,239197,239197,239200,0,3,0
68302,6,1,239203,239203,239204,0,1,3
68303,3,2,239206,239206,239208,0,2,2
68304,5,1,239211,239211,239212,0,1,3
68305,5,1,239216,239216,239217,0,1,4
68306,2,2,239218,239218,239220,0,2,1
68307,5,2,239223,239223,239225,0,2,3
68308,6,2,239229,239229,239231,0,2,4
68309,2,3,239231,239231,239234,0,3,0
68310,5,1,239236,239236,239237,0,1,2
68311,6,3,239242,239242,239245,0,3,5
68312,2,3,239244,239245,239248,1,4,0
68313,3,1,239247,239248,239249,1,2,0
68314,5,3,239252,239252,239255,0,3,3
68315,2,3,239254,239255,239258,1,4,0
68316,3,2,239257,239258,239260,1,3,0
68317,4,1,239261,239261,239262,0,1,1
68318,6,2,239267,239267,239269,0,2,5
68319,4,1,239271,239271,239272,0,1,2
68320,2,1,239273,239273,239274,0,1,1
68321,3,2,239276,239276,239278,0,2,2
68322,1,3,239277,239278,239281,1,4,0
68323,3,3,239280,239281,239284,1,4,0
68324,5,2,239285,239285,239287,0,2,1
68325,2,1,239287,239287,239288,0,1,0
68326,6,1,239293,239293,239294,0,1,5
68327,4,2,239297,239297,239299,0,2,3
68328,1,3,239298,239299,239302,1,4,0
68329,6,1,239304,239304,239305,0,1,2
68330,5,1,239309,239309,239310,0,1,4
68331,2,1,239311,239311,239312,0,1,1
68332,5,1,239316,239316,239317,0,1,4
68333,5,2,239321,239321,239323,0,2,4
68334,5,3,239326,239326,239329,0,3,3
68335,6,1,239332,239332,239333,0,1,3
68336,6,2,239338,239338,239340,0,2,5
68337,5,2,239343,239343,239345,0,2,3
68338,6,3,239349,239349,239352,0,3,4
68339,6,3,239355,239355,239358,0,3,3
68340,2,1,239357,239358,239359,1,2,0
68341,1,3,239358,239359,239362,1,4,0
68342,4,3,239362,239362,239365,0,3,0
68343,6,3,239368,239368,239371,0,3,3
68344,4,3,239372,239372,239375,0,3,1
68345,2,3,239374,239375,239378,1,4,0
68346,3,1,239377,239378,239379,1,2,0
68347,4,3,239381,239381,239384,0,3,2
68348,3,3,239384,239384,239387,0,3,0
68349,6,3,239390,239390,239393,0,3,3
68350,2,2,239392,239393,239395,1,3,0
68351,1,3,239393,239395,239398,2,5,0
68352,3,2,239396,239398,239400,2,4,0
68353,3,3,239399,239400,239403,1,4,0
68354,2,3,239401,239403,239406,2,5,0
68355,6,3,239407,239407,239410,0,3,1
68356,1,1,239408,239410,239411,2,3,0
68357,3,2,239411,239411,239413,0,2,0
68358,2,2,239413,239413,239415,0,2,0
68359,6,3,239419,239419,239422,0,3,4
68360,4,1,239423,239423,239424,0,1,1
68361,4,1,239427,239427,239428,0,1,3
68362,2,2,239429,239429,239431,0,2,1
68363,2,2,239431,239431,239433,0,2,0
68364,1,2,239432,239433,239435,1,3,0
68365,1,2,239433,239435,239437,2,4,0
68366,2,1,239435,239437,239438,2,3,0
68367,5,3,239440,239440,239443,0,3,2
68368,4,1,239444,239444,239445,0,1,1
68369,6,1,239450,239450,239451,0,1,5
68370,4,3,239454,239454,239457,0,3,3
68371,2,1,239456,239457,239458,1,2,0
68372,6,3,239462,239462,239465,0,3,4
68373,1,3,239463,239465,239468,2,5,0
68374,3,1,239466,239468,239469,2,3,0
68375,5,3,239471,239471,239474,0,3,2
68376,2,2,239473,239474,239476,1,3,0
68377,3,2,239476,239476,239478,0,2,0
68378,1,1,239477,239478,239479,1,2,0
68379,2,1,239479,239479,239480,0,1,0
68380,2,2,239481,239481,239483,0,2,1
68381,4,3,239485,239485,239488,0,3,2
68382,1,3,239486,239488,239491,2,5,0
68383,5,1,239491,239491,239492,0,1,0
68384,2,2,239493,239493,239495,0,2,1
68385,6,2,239499,239499,239501,0,2,4
68386,5,1,239504,239504,239505,0,1,3
68387,6,2,239510,239510,239512,0,2,5
68388,1,1,239511,239512,239513,1,2,0
68389,4,1,239515,239515,239516,0,1,2
68390,6,1,239521,239521,239522,0,1,5
68391,6,1,239527,239527,239528,0,1,5
68392,4,1,239531,239531,239532,0,1,3
68393,5,3,239536,239536,239539,0,3,4
68394,3,1,239539,239539,239540,0,1,0
68395,3,2,239542,239542,239544,0,2,2
68396,3,2,239545,239545,239547,0,2,1
68397,5,2,239550,239550,239552,0,2,3
68398,6,2,239556,239556,239558,0,2,4
68399,5,3,239561,239561,239564,0,3,3
68400,1,3,239562,239564,239567,2,5,0
68401,1,1,239563,239567,239568,4,5,0
68402,1,1,239564,239568,239569,4,5,0
68403,1,2,239565,239569,239571,4,6,0
68404,5,2,239570,239571,239573,1,3,0
68405,4,2,239574,239574,239576,0,2,1
68406,2,3,239576,239576,239579,0,3,0
68407,3,2,239579,239579,239581,0,2,0
68408,1,1,239580,239581,239582,1,2,0
68409,5,2,239585,239585,239587,0,2,3
68410,1,2,239586,239587,239589,1,3,0
68411,6,2,239592,239592,239594,0,2,3
68412,2,1,239594,239594,239595,0,1,0
68413,4,3,239598,239598,239601,0,3,3
68414,3,2,239601,239601,239603,0,2,0
68415,3,3,239604,239604,239607,0,3,1
68416,3,2,239607,239607,239609,0,2,0
68417,1,2,239608,239609,239611,1,3,0
68418,4,3,239612,239612,239615,0,3,1
68419,2,2,239614,239615,239617,1,3,0
68420,2,1,239616,239617,239618,1,2,0
68421,4,2,239620,239620,239622,0,2,2
68422,4,3,239624,239624,239627,0,3,2
68423,2,3,239626,239627,239630,1,4,0
68424,2,2,239628,239630,239632,2,4,0
68425,5,3,239633,239633,239636,0,3,1
68426,4,3,239637,239637,239640,0,3,1
68427,4,1,239641,239641,239642,0,1,1
68428,3,2,239644,239644,239646,0,2,2
68429,2,1,239646,239646,239647,0,1,0
68430,5,1,239651,239651,239652,0,1,4
68431,1,3,239652,239652,239655,0,3,0
68432,1,1,239653,239655,239656,2,3,0
68433,6,3,239659,239659,239662,0,3,3
68434,2,2,239661,239662,239664,1,3,0
68435,4,1,239665,239665,239666,0,1,1
68436,2,2,239667,239667,239669,0,2,1
68437,6,3,239673,239673,239676,0,3,4
68438,1,3,239674,239676,239679,2,5,0
68439,5,3,239679,239679,239682,0,3,0
68440,4,2,239683,239683,239685,0,2,1
68441,3,3,239686,239686,239689,0,3,1
68442,4,3,239690,239690,239693,0,3,1
68443,2,3,239692,239693,239696,1,4,0
68444,1,1,239693,239696,239697,3,4,0
68445,5,1,239698,239698,239699,0,1,1
68446,4,3,239702,239702,239705,0,3,3
68447,5,2,239707,239707,239709,0,2,2
68448,1,2,239708,239709,239711,1,3,0
68449,2,1,239710,239711,239712,1,2,0
68450,2,2,239712,239712,239714,0,2,0
68451,3,1,239715,239715,239716,0,1,1
68452,4,1,239719,239719,239720,0,1,3
68453,1,3,239720,239720,239723,0,3,0
68454,6,2,239726,239726,239728,0,2,3
68455,3,2,239729,239729,239731,0,2,1
68456,5,2,239734,239734,239736,0,2,3
68457,5,2,239739,239739,239741,0,2,3
68458,3,3,239742,239742,239745,0,3,1
68459,4,1,239746,239746,239747,0,1,1
68460,4,2,239750,239750,239752,0,2,3
68461,3,2,239753,239753,239755,0,2,1
68462,4,1,239757,239757,239758,0,1,2
68463,2,2,239759,239759,239761,0,2,1
68464,1,1,239760,239761,239762,1,2,0
68465,2,3,239762,239762,239765,0,3,0
68466,5,1,239767,239767,239768,0,1,2
68467,3,3,239770,239770,239773,0,3,2
68468,4,2,239774,239774,239776,0,2,1
68469,6,2,239780,239780,239782,0,2,4
68470,2,3,239782,239782,239785,0,3,0
68471,1,1,239783,239785,239786,2,3,0
68472,2,3,239785,239786,239789,1,4,0
68473,6,2,239791,239791,239793,0,2,2
68474,4,3,239795,239795,239798,0,3,2
68475,4,3,239799,239799,239802,0,3,1
68476,6,2,239805,239805,239807,0,2,3
68477,1,3,239806,239807,239810,1,4,0
68478,4,1,239810,239810,239811,0,1,0
68479,3,3,239813,239813,239816,0,3,2
68480,2,3,239815,239816,239819,1,4,0
68481,2,3,239817,239819,239822,2,5,0
68482,6,2,239823,239823,239825,0,2,1
68483,3,1,239826,239826,239827,0,1,1
68484,6,3,239832,239832,239835,0,3,5
68485,4,3,239836,239836,239839,0,3,1
68486,2,1,239838,239839,239840,1,2,0
68487,5,1,239843,239843,239844,0,1,3
68488,4,3,239847,239847,239850,0,3,3
68489,2,1,239849,239850,239851,1,2,0
68490,5,3,239854,239854,239857,0,3,3
68491,6,3,239860,239860,239863,0,3,3
68492,3,1,239863,239863,239864,0,1,0
68493,1,1,239864,239864,239865,0,1,0
68494,4,1,239868,239868,239869,0,1,3
68495,3,3,239871,239871,239874,0,3,2
68496,3,2,239874,239874,239876,0,2,0
68497,4,3,239878,239878,239881,0,3,2
68498,4,1,239882,239882,239883,0,1,1
68499,1,1,239883,239883,239884,0,1,0
68500,5,3,239888,239888,239891,0,3,4
68501,5,3,239893,239893,239896,0,3,2
68502,3,2,239896,239896,239898,0,2,0
68503,1,2,239897,239898,239900,1,3,0
68504,3,2,239900,239900,239902,0,2,0
68505,2,1,239902,239902,239903,0,1,0
68506,1,2,239903,239903,239905,0,2,0
68507,6,3,239909,239909,239912,0,3,4
68508,6,2,239915,239915,239917,0,2,3
68509,3,2,239918,239918,239920,0,2,1
68510,2,1,239920,239920,239921,0,1,0
68511,4,3,239924,239924,239927,0,3,3
68512,1,3,239925,239927,239930,2,5,0
68513,2,3,239927,239930,239933,3,6,0
68514,6,1,239933,239933,239934,0,1,0
68515,3,3,239936,239936,239939,0,3,2
68516,3,1,239939,239939,239940,0,1,0
68517,3,2,239942,239942,239944,0,2,2
68518,5,3,239947,239947,239950,0,3,3
68519,6,2,239953,239953,239955,0,2,3
68520,5,1,239958,239958,239959,0,1,3
68521,1,1,239959,239959,239960,0,1,0
68522,4,3,239963,239963,239966,0,3,3
68523,2,2,239965,239966,239968,1,3,0
68524,1,1,239966,239968,239969,2,3,0
68525,1,2,239967,239969,239971,2,4,0
68526,3,2,239970,239971,239973,1,3,0
68527,5,1,239975,239975,239976,0,1,2
68528,2,2,239977,239977,239979,0,2,1
68529,5,3,239982,239982,239985,0,3,3
68530,4,3,239986,239986,239989,0,3,1
68531,4,3,239990,239990,239993,0,3,1
68532,3,3,239993,239993,239996,0,3,0
68533,6,2,239999,239999,240001,0,2,3
68534,6,3,240005,240005,240008,0,3,4
68535,1,1,240006,240008,240009,2,3,0
68536,6,1,240012,240012,240013,0,1,3
68537,2,1,240014,240014,240015,0,1,1
68538,3,3,240017,240017,240020,0,3,2
68539,5,2,240022,240022,240024,0,2,2
68540,4,3,240026,240026,240029,0,3,2
68541,4,3,240030,240030,240033,0,3,1
68542,2,3,240032,240033,240036,1,4,0
68543,4,1,240036,240036,240037,0,1,0
68544,2,2,240038,240038,240040,0,2,1
68545,6,1,240044,240044,240045,0,1,4
68546,3,1,240047,240047,240048,0,1,2
68547,4,1,240051,240051,240052,0,1,3
68548,3,1,240054,240054,240055,0,1,2
68549,4,2,240058,240058,240060,0,2,3
68550,3,1,240061,240061,240062,0,1,1
68551,4,1,240065,240065,240066,0,1,3
68552,4,3,240069,240069,240072,0,3,3
68553,3,3,240072,240072,240075,0,3,0
68554,2,3,240074,240075,240078,1,4,0
68555,2,3,240076,240078,240081,2,5,0
68556,5,1,240081,240081,240082,0,1,0
68557,3,2,240084,240084,240086,0,2,2
68558,3,1,240087,240087,240088,0,1,1
68559,6,2,240093,240093,240095,0,2,5
68560,6,1,240099,240099,240100,0,1,4
68561,2,2,240101,240101,240103,0,2,1
68562,6,2,240107,240107,240109,0,2,4
68563,3,1,240110,240110,240111,0,1,1
68564,4,1,240114,240114,240115,0,1,3
68565,6,2,240120,240120,240122,0,2,5
68566,6,2,240126,240126,240128,0,2,4
68567,4,3,240130,240130,240133,0,3,2
68568,4,3,240134,240134,240137,0,3,1
68569,6,1,240140,240140,240141,0,1,3
68570,6,1,240146,240146,240147,0,1,5
68571,4,2,240150,240150,240152,0,2,3
68572,2,1,240152,240152,240153,0,1,0
68573,1,3,240153,240153,240156,0,3,0
68574,1,2,240154,240156,240158,2,4,0
68575,5,1,240159,240159,240160,0,1,1
68576,6,1,240165,240165,240166,0,1,5
68577,2,2,240167,240167,240169,0,2,1
68578,4,1,240171,240171,240172,0,1,2
68579,1,1,240172,240172,240173,0,1,0
68580,3,2,240175,240175,240177,0,2,2
68581,3,1,240178,240178,240179,0,1,1
68582,4,3,240182,240182,240185,0,3,3
68583,1,3,240183,240185,240188,2,5,0
68584,3,2,240186,240188,240190,2,4,0
68585,3,1,240189,240190,240191,1,2,0
68586,4,3,240193,240193,240196,0,3,2
68587,3,1,240196,240196,240197,0,1,0
68588,5,3,240201,240201,240204,0,3,4
68589,2,1,240203,240204,240205,1,2,0
68590,3,2,240206,240206,240208,0,2,1
68591,4,3,240210,240210,240213,0,3,2
68592,2,1,240212,240213,240214,1,2,0
68593,4,1,240216,240216,240217,0,1,2
68594,5,3,240221,240221,240224,0,3,4
68595,4,1,240225,240225,240226,0,1,1
68596,4,1,240229,240229,240230,0,1,3
68597,4,2,240233,240233,240235,0,2,3
68598,3,2,240236,240236,240238,0,2,1
68599,1,3,240237,240238,240241,1,4,0
68600,3,1,240240,240241,240242,1,2,0
68601,6,1,240246,240246,240247,0,1,4
68602,1,1,240247,240247,240248,0,1,0
68603,1,2,240248,240248,240250,0,2,0
68604,6,1,240254,240254,240255,0,1,4
68605,1,1,240255,240255,240256,0,1,0
68606,1,1,240256,240256,240257,0,1,0
68607,3,1,240259,240259,240260,0,1,2
68608,6,1,240265,240265,240266,0,1,5
68609,1,2,240266,240266,240268,0,2,0
68610,6,2,240272,240272,240274,0,2,4
68611,2,1,240274,240274,240275,0,1,0
68612,3,3,240277,240277,240280,0,3,2
68613,3,1,240280,240280,240281,0,1,0
68614,4,3,240284,240284,240287,0,3,3
68615,2,1,240286,240287,240288,1,2,0
68616,5,3,240291,240291,240294,0,3,3
68617,4,3,240295,240295,240298,0,3,1
68618,5,3,240300,240300,240303,0,3,2
68619,2,3,240302,240303,240306,1,4,0
68620,6,3,240308,240308,240311,0,3,2
68621,4,2,240312,240312,240314,0,2,1
68622,2,2,240314,240314,240316,0,2,0
68623,2,2,240316,240316,240318,0,2,0
68624,4,3,240320,240320,240323,0,3,2
68625,1,2,240321,240323,240325,2,4,0
68626,4,3,240325,240325,240328,0,3,0
68627,5,3,240330,240330,240333,0,3,2
68628,3,3,240333,240333,240336,0,3,0
68629,4,1,240337,240337,240338,0,1,1
68630,2,1,240339,240339,240340,0,1,1
68631,2,1,240341,240341,240342,0,1,1
68632,1,3,240342,240342,240345,0,3,0
68633,4,1,240346,240346,240347,0,1,1
68634,4,1,240350,240350,240351,0,1,3
68635,5,3,240355,240355,240358,0,3,4
68636,2,1,240357,240358,240359,1,2,0
68637,1,3,240358,240359,240362,1,4,0
68638,1,1,240359,240362,240363,3,4,0
68639,3,3,240362,240363,240366,1,4,0
68640,6,1,240368,240368,240369,0,1,2
68641,4,3,240372,240372,240375,0,3,3
68642,5,3,240377,240377,240380,0,3,2
68643,1,2,240378,240380,240382,2,4,0
68644,6,3,240384,240384,240387,0,3,2
68645,5,1,240389,240389,240390,0,1,2
68646,2,1,240391,240391,240392,0,1,1
68647,2,3,240393,240393,240396,0,3,1
68648,1,1,240394,240396,240397,2,3,0
68649,4,3,240398,240398,240401,0,3,1
68650,4,1,240402,240402,240403,0,1,1
68651,5,2,240407,240407,240409,0,2,4
68652,2,3,240409,240409,240412,0,3,0
68653,6,2,240415,240415,240417,0,2,3
68654,3,1,240418,240418,240419,0,1,1
68655,3,2,240421,240421,240423,0,2,2
68656,1,1,240422,240423,240424,1,2,0
68657,5,3,240427,240427,240430,0,3,3
68658,3,3,240430,240430,240433,0,3,0
68659,1,3,240431,240433,240436,2,5,0
68660,6,3,240437,240437,240440,0,3,1
68661,6,1,240443,240443,240444,0,1,3
68662,5,3,240448,240448,240451,0,3,4
68663,6,2,240454,240454,240456,0,2,3
68664,6,1,240460,240460,240461,0,1,4
68665,4,3,240464,240464,240467,0,3,3
68666,5,2,240469,240469,240471,0,2,2
68667,3,2,240472,240472,240474,0,2,1
68668,5,3,240477,240477,240480,0,3,3
68669,2,2,240479,240480,240482,1,3,0
68670,5,1,240484,240484,240485,0,1,2
68671,6,2,240490,240490,240492,0,2,5
68672,3,1,240493,240493,240494,0,1,1
68673,3,2,240496,240496,240498,0,2,2
68674,5,1,240501,240501,240502,0,1,3
68675,2,2,240503,240503,240505,0,2,1
68676,5,3,240508,240508,240511,0,3,3
68677,1,2,240509,240511,240513,2,4,0
68678,3,1,240512,240513,240514,1,2,0
68679,3,2,240515,240515,240517,0,2,1
68680,1,1,240516,240517,240518,1,2,0
68681,3,2,240519,240519,240521,0,2,1
68682,2,1,240521,240521,240522,0,1,0
68683,3,1,240524,240524,240525,0,1,2
68684,1,1,240525,240525,240526,0,1,0
68685,2,2,240527,240527,240529,0,2,1
68686,5,2,240532,240532,240534,0,2,3
68687,2,1,240534,240534,240535,0,1,0
68688,2,1,240536,240536,240537,0,1,1
68689,5,2,240541,240541,240543,0,2,4
68690,2,3,240543,240543,240546,0,3,0
68691,3,2,240546,240546,240548,0,2,0
68692,1,1,240547,240548,240549,1,2,0
68693,6,3,240553,240553,240556,0,3,4
68694,1,3,240554,240556,240559,2,5,0
68695,3,2,240557,240559,240561,2,4,0
68696,5,2,240562,240562,240564,0,2,1
68697,4,2,240566,240566,240568,0,2,2
68698,6,3,240572,240572,240575,0,3,4
68699,2,3,240574,240575,240578,1,4,0
68700,5,3,240579,240579,240582,0,3,1
68701,1,3,240580,240582,240585,2,5,0
68702,4,2,240584,240585,240587,1,3,0
68703,2,1,240586,240587,240588,1,2,0
68704,2,3,240588,240588,240591,0,3,0
68705,2,3,240590,240591,240594,1,4,0
68706,5,2,240595,240595,240597,0,2,1
68707,2,1,240597,240597,240598,0,1,0
68708,1,1,240598,240598,240599,0,1,0
68709,5,3,240603,240603,240606,0,3,4
68710,1,3,240604,240606,240609,2,5,0
68711,4,1,240608,240609,240610,1,2,0
68712,5,1,240613,240613,240614,0,1,3
68713,4,1,240617,240617,240618,0,1,3
68714,6,2,240623,240623,240625,0,2,5
68715,6,1,240629,240629,240630,0,1,4
68716,4,2,240633,240633,240635,0,2,3
68717,5,1,240638,240638,240639,0,1,3
68718,1,3,240639,240639,240642,0,3,0
68719,1,3,240640,240642,240645,2,5,0
68720,6,2,240646,240646,240648,0,2,1
68721,2,3,240648,240648,240651,0,3,0
68722,4,2,240652,240652,240654,0,2,1
68723,6,1,240658,240658,240659,0,1,4
68724,1,1,240659,240659,240660,0,1,0
68725,2,2,240661,240661,240663,0,2,1
68726,5,2,240666,240666,240668,0,2,3
68727,1,2,240667,240668,240670,1,3,0
68728,2,2,240669,240670,240672,1,3,0
68729,1,2,240670,240672,240674,2,4,0
68730,2,3,240672,240674,240677,2,5,0
68731,4,2,240676,240677,240679,1,3,0
68732,3,2,240679,240679,240681,0,2,0
68733,5,3,240684,240684,240687,0,3,3
68734,1,2,240685,240687,240689,2,4,0
68735,4,2,240689,240689,240691,0,2,0
68736,3,1,240692,240692,240693,0,1,1
68737,4,3,240696,240696,240699,0,3,3
68738,5,1,240701,240701,240702,0,1,2
68739,2,3,240703,240703,240706,0,3,1
68740,1,2,240704,240706,240708,2,4,0
68741,5,1,240709,240709,240710,0,1,1
68742,2,3,240711,240711,240714,0,3,1
68743,4,2,240715,240715,240717,0,2,1
68744,3,2,240718,240718,240720,0,2,1
68745,1,3,240719,240720,240723,1,4,0
68746,2,1,240721,240723,240724,2,3,0
68747,6,1,240727,240727,240728,0,1,3
68748,3,1,240730,240730,240731,0,1,2
68749,4,3,240734,240734,240737,0,3,3
68750,4,1,240738,240738,240739,0,1,1
68751,4,1,240742,240742,240743,0,1,3
68752,2,2,240744,240744,240746,0,2,1
68753,5,1,240749,240749,240750,0,1,3
68754,3,2,240752,240752,240754,0,2,2
68755,1,2,240753,240754,240756,1,3,0
68756,1,2,240754,240756,240758,2,4,0
68757,4,2,240758,240758,240760,0,2,0
68758,4,3,240762,240762,240765,0,3,2
68759,3,2,240765,240765,240767,0,2,0
68760,4,2,240769,240769,240771,0,2,2
68761,6,2,240775,240775,240777,0,2,4
68762,6,1,240781,240781,240782,0,1,4
68763,5,2,240786,240786,240788,0,2,4
68764,1,2,240787,240788,240790,1,3,0
68765,5,2,240792,240792,240794,0,2,2
68766,2,3,240794,240794,240797,0,3,0
68767,6,3,240800,240800,240803,0,3,3
68768,3,3,240803,240803,240806,0,3,0
68769,6,1,240809,240809,240810,0,1,3
68770,3,1,240812,240812,240813,0,1,2
68771,4,3,240816,240816,240819,0,3,3
68772,6,2,240822,240822,240824,0,2,3
68773,5,3,240827,240827,240830,0,3,3
68774,2,1,240829,240830,240831,1,2,0
68775,2,2,240831,240831,240833,0,2,0
68776,1,3,240832,240833,240836,1,4,0
68777,6,3,240838,240838,240841,0,3,2
68778,4,3,240842,240842,240845,0,3,1
68779,1,2,240843,240845,240847,2,4,0
68780,2,3,240845,240847,240850,2,5,0
68781,2,3,240847,240850,240853,3,6,0
68782,1,2,240848,240853,240855,5,7,0
68783,3,1,240851,240855,240856,4,5,0
68784,2,3,240853,240856,240859,3,6,0
68785,3,1,240856,240859,240860,3,4,0
68786,5,2,240861,240861,240863,0,2,1
68787,5,1,240866,240866,240867,0,1,3
68788,2,2,240868,240868,240870,0,2,1
68789,5,3,240873,240873,240876,0,3,3
68790,5,2,240878,240878,240880,0,2,2
68791,3,1,240881,240881,240882,0,1,1
68792,5,3,240886,240886,240889,0,3,4
68793,3,2,240889,240889,240891,0,2,0
68794,1,1,240890,240891,240892,1,2,0
68795,5,3,240895,240895,240898,0,3,3
68796,1,1,240896,240898,240899,2,3,0
68797,2,3,240898,240899,240902,1,4,0
68798,3,1,240901,240902,240903,1,2,0
68799,6,3,240907,240907,240910,0,3,4
68800,3,1,240910,240910,240911,0,1,0
68801,1,1,240911,240911,240912,0,1,0
68802,4,3,240915,240915,240918,0,3,3
68803,2,1,240917,240918,240919,1,2,0
68804,4,1,240921,240921,240922,0,1,2
68805,1,1,240922,240922,240923,0,1,0
68806,5,2,240927,240927,240929,0,2,4
68807,6,3,240933,240933,240936,0,3,4
68808,4,3,240937,240937,240940,0,3,1
68809,2,3,240939,240940,240943,1,4,0
68810,2,3,240941,240943,240946,2,5,0
68811,6,3,240947,240947,240950,0,3,1
68812,1,1,240948,240950,240951,2,3,0
68813,1,3,240949,240951,240954,2,5,0
68814,2,3,240951,240954,240957,3,6,0
68815,1,2,240952,240957,240959,5,7,0
68816,6,2,240958,240959,240961,1,3,0
68817,6,1,240964,240964,240965,0,1,3
68818,4,2,240968,240968,240970,0,2,3
68819,1,3,240969,240970,240973,1,4,0
68820,3,2,240972,240973,240975,1,3,0
68821,4,3,240976,240976,240979,0,3,1
68822,2,3,240978,240979,240982,1,4,0
68823,1,3,240979,240982,240985,3,6,0
68824,4,1,240983,240985,240986,2,3,0
68825,4,3,240987,240987,240990,0,3,1
68826,3,3,240990,240990,240993,0,3,0
68827,2,1,240992,240993,240994,1,2,0
68828,6,2,240998,240998,241000,0,2,4
68829,3,3,241001,241001,241004,0,3,1
68830,5,2,241006,241006,241008,0,2,2
68831,4,3,241010,241010,241013,0,3,2
68832,3,3,241013,241013,241016,0,3,0
68833,5,2,241018,241018,241020,0,2,2
68834,4,2,241022,241022,241024,0,2,2
68835,5,1,241027,241027,241028,0,1,3
68836,1,2,241028,241028,241030,0,2,0
68837,3,1,241031,241031,241032,0,1,1
68838,4,2,241035,241035,241037,0,2,3
68839,3,1,241038,241038,241039,0,1,1
68840,6,2,241044,241044,241046,0,2,5
68841,5,1,241049,241049,241050,0,1,3
68842,2,2,241051,241051,241053,0,2,1
68843,3,3,241054,241054,241057,0,3,1
68844,1,1,241055,241057,241058,2,3,0
68845,3,3,241058,241058,241061,0,3,0
68846,2,3,241060,241061,241064,1,4,0
68847,1,1,241061,241064,241065,3,4,0
68848,2,3,241063,241065,241068,2,5,0
68849,6,2,241069,241069,241071,0,2,1
68850,3,3,241072,241072,241075,0,3,1
68851,1,1,241073,241075,241076,2,3,0
68852,5,2,241078,241078,241080,0,2,2
68853,2,2,241080,241080,241082,0,2,0
68854,4,2,241084,241084,241086,0,2,2
68855,1,2,241085,241086,241088,1,3,0
68856,5,3,241090,241090,241093,0,3,2
68857,4,2,241094,241094,241096,0,2,1
68858,5,3,241099,241099,241102,0,3,3
68859,5,3,241104,241104,241107,0,3,2
68860,3,3,241107,241107,241110,0,3,0
68861,5,2,241112,241112,241114,0,2,2
68862,4,3,241116,241116,241119,0,3,2
68863,4,2,241120,241120,241122,0,2,1
68864,5,3,241125,241125,241128,0,3,3
68865,1,1,241126,241128,241129,2,3,0
68866,5,1,241131,241131,241132,0,1,2
68867,5,3,241136,241136,241139,0,3,4
68868,3,1,241139,241139,241140,0,1,0
68869,3,2,241142,241142,241144,0,2,2
68870,6,3,241148,241148,241151,0,3,4
68871,6,3,241154,241154,241157,0,3,3
68872,6,3,241160,241160,241163,0,3,3
68873,6,2,241166,241166,241168,0,2,3
68874,2,1,241168,241168,241169,0,1,0
68875,4,2,241172,241172,241174,0,2,3
68876,1,2,241173,241174,241176,1,3,0
68877,6,2,241179,241179,241181,0,2,3
68878,2,1,241181,241181,241182,0,1,0
68879,1,2,241182,241182,241184,0,2,0
68880,6,3,241188,241188,241191,0,3,4
68881,6,2,241194,241194,241196,0,2,3
68882,5,1,241199,241199,241200,0,1,3
68883,3,2,241202,241202,241204,0,2,2
68884,1,2,241203,241204,241206,1,3,0
68885,6,2,241209,241209,241211,0,2,3
68886,6,2,241215,241215,241217,0,2,4
68887,5,2,241220,241220,241222,0,2,3
68888,2,3,241222,241222,241225,0,3,0
68889,3,2,241225,241225,241227,0,2,0
68890,2,2,241227,241227,241229,0,2,0
68891,6,1,241233,241233,241234,0,1,4
68892,6,3,241239,241239,241242,0,3,5
68893,1,1,241240,241242,241243,2,3,0
68894,1,2,241241,241243,241245,2,4,0
68895,2,1,241243,241245,241246,2,3,0
68896,5,3,241248,241248,241251,0,3,2
68897,1,1,241249,241251,241252,2,3,0
68898,1,1,241250,241252,241253,2,3,0
68899,2,1,241252,241253,241254,1,2,0
68900,5,2,241257,241257,241259,0,2,3
68901,5,1,241262,241262,241263,0,1,3
68902,2,1,241264,241264,241265,0,1,1
68903,4,3,241268,241268,241271,0,3,3
68904,6,3,241274,241274,241277,0,3,3
68905,5,1,241279,241279,241280,0,1,2
68906,1,1,241280,241280,241281,0,1,0
68907,1,2,241281,241281,241283,0,2,0
68908,1,1,241282,241283,241284,1,2,0
68909,5,2,241287,241287,241289,0,2,3
68910,4,3,241291,241291,241294,0,3,2
68911,3,1,241294,241294,241295,0,1,0
68912,3,1,241297,241297,241298,0,1,2
68913,3,3,241300,241300,241303,0,3,2
68914,2,1,241302,241303,241304,1,2,0
68915,1,3,241303,241304,241307,1,4,0
68916,4,1,241307,241307,241308,0,1,0
68917,6,2,241313,241313,241315,0,2,5
68918,5,2,241318,241318,241320,0,2,3
68919,5,1,241323,241323,241324,0,1,3
68920,6,3,241329,241329,241332,0,3,5
68921,2,3,241331,241332,241335,1,4,0
68922,2,3,241333,241335,241338,2,5,0
68923,3,2,241336,241338,241340,2,4,0
68924,3,2,241339,241340,241342,1,3,0
68925,4,3,241343,241343,241346,0,3,1
68926,5,2,241348,241348,241350,0,2,2
68927,4,1,241352,241352,241353,0,1,2
68928,6,1,241358,241358,241359,0,1,5
68929,2,3,241360,241360,241363,0,3,1
68930,3,3,241363,241363,241366,0,3,0
68931,6,2,241369,241369,241371,0,2,3
68932,4,1,241373,241373,241374,0,1,2
68933,2,1,241375,241375,241376,0,1,1
68934,5,2,241380,241380,241382,0,2,4
68935,5,3,241385,241385,241388,0,3,3
68936,1,2,241386,241388,241390,2,4,0
68937,3,3,241389,241390,241393,1,4,0
68938,6,1,241395,241395,241396,0,1,2
68939,1,2,241396,241396,241398,0,2,0
68940,6,2,241402,241402,241404,0,2,4
68941,4,3,241406,241406,241409,0,3,2
68942,1,3,241407,241409,241412,2,5,0
68943,4,1,241411,241412,241413,1,2,0
68944,1,1,241412,241413,241414,1,2,0
68945,6,3,241418,241418,241421,0,3,4
68946,2,1,241420,241421,241422,1,2,0
68947,3,1,241423,241423,241424,0,1,1
68948,6,1,241429,241429,241430,0,1,5
68949,4,2,241433,241433,241435,0,2,3
68950,5,1,241438,241438,241439,0,1,3
68951,2,1,241440,241440,241441,0,1,1
68952,3,1,241443,241443,241444,0,1,2
68953,3,2,241446,241446,241448,0,2,2
68954,6,1,241452,241452,241453,0,1,4
68955,6,3,241458,241458,241461,0,3,5
68956,1,1,241459,241461,241462,2,3,0
68957,1,3,241460,241462,241465,2,5,0
68958,5,1,241465,241465,241466,0,1,0
68959,5,3,241470,241470,241473,0,3,4
68960,4,1,241474,241474,241475,0,1,1
68961,1,2,241475,241475,241477,0,2,0
68962,4,3,241479,241479,241482,0,3,2
68963,3,2,241482,241482,241484,0,2,0
68964,4,1,241486,241486,241487,0,1,2
68965,3,3,241489,241489,241492,0,3,2
68966,2,1,241491,241492,241493,1,2,0
68967,5,3,241496,241496,241499,0,3,3
68968,4,2,241500,241500,241502,0,2,1
68969,4,3,241504,241504,241507,0,3,2
68970,6,3,241510,241510,241513,0,3,3
68971,6,2,241516,241516,241518,0,2,3
68972,1,1,241517,241518,241519,1,2,0
68973,1,2,241518,241519,241521,1,3,0
68974,1,3,241519,241521,241524,2,5,0
68975,4,1,241523,241524,241525,1,2,0
68976,6,2,241529,241529,241531,0,2,4
68977,5,1,241534,241534,241535,0,1,3
68978,2,2,241536,241536,241538,0,2,1
68979,2,2,241538,241538,241540,0,2,0
68980,6,1,241544,241544,241545,0,1,4
68981,2,1,241546,241546,241547,0,1,1
68982,1,1,241547,241547,241548,0,1,0
68983,6,1,241553,241553,241554,0,1,5
68984,6,2,241559,241559,241561,0,2,5
68985,3,3,241562,241562,241565,0,3,1
68986,3,3,241565,241565,241568,0,3,0
68987,3,2,241568,241568,241570,0,2,0
68988,4,1,241572,241572,241573,0,1,2
68989,1,2,241573,241573,241575,0,2,0
68990,1,1,241574,241575,241576,1,2,0
68991,5,2,241579,241579,241581,0,2,3
68992,6,3,241585,241585,241588,0,3,4
68993,5,2,241590,241590,241592,0,2,2
68994,4,1,241594,241594,241595,0,1,2
68995,2,2,241596,241596,241598,0,2,1
68996,4,1,241600,241600,241601,0,1,2
68997,2,2,241602,241602,241604,0,2,1
68998,6,2,241608,241608,241610,0,2,4
68999,4,3,241612,241612,241615,0,3,2
69000,4,2,241616,241616,241618,0,2,1
69001,5,2,241621,241621,241623,0,2,3
69002,4,1,241625,241625,241626,0,1,2
69003,4,1,241629,241629,241630,0,1,3
69004,1,2,241630,241630,241632,0,2,0
69005,2,2,241632,241632,241634,0,2,0
69006,4,2,241636,241636,241638,0,2,2
69007,5,1,241641,241641,241642,0,1,3
69008,5,3,241646,241646,241649,0,3,4
69009,1,1,241647,241649,241650,2,3,0
69010,5,1,241652,241652,241653,0,1,2
69011,2,2,241654,241654,241656,0,2,1
69012,5,1,241659,241659,241660,0,1,3
69013,6,2,241665,241665,241667,0,2,5
69014,4,3,241669,241669,241672,0,3,2
69015,5,2,241674,241674,241676,0,2,2
69016,4,2,241678,241678,241680,0,2,2
69017,4,1,241682,241682,241683,0,1,2
69018,2,2,241684,241684,241686,0,2,1
69019,5,1,241689,241689,241690,0,1,3
69020,3,1,241692,241692,241693,0,1,2
69021,3,3,241695,241695,241698,0,3,2
69022,1,3,241696,241698,241701,2,5,0
69023,5,3,241701,241701,241704,0,3,0
69024,5,1,241706,241706,241707,0,1,2
69025,1,1,241707,241707,241708,0,1,0
69026,3,1,241710,241710,241711,0,1,2
69027,5,3,241715,241715,241718,0,3,4
69028,6,2,241721,241721,241723,0,2,3
69029,6,1,241727,241727,241728,0,1,4
69030,4,3,241731,241731,241734,0,3,3
69031,2,3,241733,241734,241737,1,4,0
69032,1,2,241734,241737,241739,3,5,0
69033,3,2,241737,241739,241741,2,4,0
69034,3,3,241740,241741,241744,1,4,0
69035,6,3,241746,241746,241749,0,3,2
69036,3,1,241749,241749,241750,0,1,0
69037,4,2,241753,241753,241755,0,2,3
69038,3,2,241756,241756,241758,0,2,1
69039,3,3,241759,241759,241762,0,3,1
69040,3,3,241762,241762,241765,0,3,0
69041,1,1,241763,241765,241766,2,3,0
69042,4,1,241767,241767,241768,0,1,1
69043,4,1,241771,241771,241772,0,1,3
69044,3,3,241774,241774,241777,0,3,2
69045,6,2,241780,241780,241782,0,2,3
69046,1,3,241781,241782,241785,1,4,0
69047,2,2,241783,241785,241787,2,4,0
69048,3,2,241786,241787,241789,1,3,0
69049,4,2,241790,241790,241792,0,2,1
69050,6,2,241796,241796,241798,0,2,4
69051,2,3,241798,241798,241801,0,3,0
69052,3,2,241801,241801,241803,0,2,0
69053,6,1,241807,241807,241808,0,1,4
69054,2,3,241809,241809,241812,0,3,1
69055,3,2,241812,241812,241814,0,2,0
69056,1,2,241813,241814,241816,1,3,0
69057,5,2,241818,241818,241820,0,2,2
69058,5,3,241823,241823,241826,0,3,3
69059,4,1,241827,241827,241828,0,1,1
69060,5,1,241832,241832,241833,0,1,4
69061,5,2,241837,241837,241839,0,2,4
69062,6,1,241843,241843,241844,0,1,4
69063,2,2,241845,241845,241847,0,2,1
69064,4,1,241849,241849,241850,0,1,2
69065,1,1,241850,241850,241851,0,1,0
69066,5,3,241855,241855,241858,0,3,4
69067,6,2,241861,241861,241863,0,2,3
69068,6,3,241867,241867,241870,0,3,4
69069,4,1,241871,241871,241872,0,1,1
69070,1,3,241872,241872,241875,0,3,0
69071,5,1,241877,241877,241878,0,1,2
69072,4,2,241881,241881,241883,0,2,3
69073,3,3,241884,241884,241887,0,3,1
69074,3,1,241887,241887,241888,0,1,0
69075,5,3,241892,241892,241895,0,3,4
69076,4,3,241896,241896,241899,0,3,1
69077,1,2,241897,241899,241901,2,4,0
69078,3,3,241900,241901,241904,1,4,0
69079,1,3,241901,241904,241907,3,6,0
69080,6,3,241907,241907,241910,0,3,0
69081,3,3,241910,241910,241913,0,3,0
69082,5,3,241915,241915,241918,0,3,2
69083,2,1,241917,241918,241919,1,2,0
69084,1,1,241918,241919,241920,1,2,0
69085,6,3,241924,241924,241927,0,3,4
69086,1,3,241925,241927,241930,2,5,0
69087,6,3,241931,241931,241934,0,3,1
69088,3,2,241934,241934,241936,0,2,0
69089,4,2,241938,241938,241940,0,2,2
69090,1,2,241939,241940,241942,1,3,0
69091,5,3,241944,241944,241947,0,3,2
69092,3,1,241947,241947,241948,0,1,0
69093,5,2,241952,241952,241954,0,2,4
69094,4,3,241956,241956,241959,0,3,2
69095,5,2,241961,241961,241963,0,2,2
69096,5,2,241966,241966,241968,0,2,3
69097,5,3,241971,241971,241974,0,3,3
69098,1,3,241972,241974,241977,2,5,0
69099,2,3,241974,241977,241980,3,6,0
69100,3,3,241977,241980,241983,3,6,0
69101,2,2,241979,241983,241985,4,6,0
69102,1,3,241980,241985,241988,5,8,0
69103,1,2,241981,241988,241990,7,9,0
69104,3,1,241984,241990,241991,6,7,0
69105,4,2,241988,241991,241993,3,5,0
69106,5,3,241993,241993,241996,0,3,0
69107,2,3,241995,241996,241999,1,4,0
69108,6,3,242001,242001,242004,0,3,2
69109,1,2,242002,242004,242006,2,4,0
69110,3,3,242005,242006,242009,1,4,0
69111,6,2,242011,242011,242013,0,2,2
69112,5,2,242016,242016,242018,0,2,3
69113,6,3,242022,242022,242025,0,3,4
69114,3,2,242025,242025,242027,0,2,0
69115,5,2,242030,242030,242032,0,2,3
69116,3,1,242033,242033,242034,0,1,1
69117,6,1,242039,242039,242040,0,1,5
69118,3,2,242042,242042,242044,0,2,2
69119,5,3,242047,242047,242050,0,3,3
69120,1,3,242048,242050,242053,2,5,0
69121,2,1,242050,242053,242054,3,4,0
69122,5,2,242055,242055,242057,0,2,1
69123,5,1,242060,242060,242061,0,1,3
69124,3,1,242063,242063,242064,0,1,2
69125,5,1,242068,242068,242069,0,1,4
69126,5,3,242073,242073,242076,0,3,4
69127,5,1,242078,242078,242079,0,1,2
69128,3,1,242081,242081,242082,0,1,2
69129,6,2,242087,242087,242089,0,2,5
69130,1,3,242088,242089,242092,1,4,0
69131,6,3,242094,242094,242097,0,3,2
69132,1,2,242095,242097,242099,2,4,0
69133,3,2,242098,242099,242101,1,3,0
69134,6,2,242104,242104,242106,0,2,3
69135,4,1,242108,242108,242109,0,1,2
69136,5,3,242113,242113,242116,0,3,4
69137,5,1,242118,242118,242119,0,1,2
69138,2,3,242120,242120,242123,0,3,1
69139,3,3,242123,242123,242126,0,3,0
69140,6,3,242129,242129,242132,0,3,3
69141,4,1,242133,242133,242134,0,1,1
69142,3,3,242136,242136,242139,0,3,2
69143,5,3,242141,242141,242144,0,3,2
69144,1,2,242142,242144,242146,2,4,0
69145,4,2,242146,242146,242148,0,2,0
69146,5,3,242151,242151,242154,0,3,3
69147,3,2,242154,242154,242156,0,2,0
69148,4,2,242158,242158,242160,0,2,2
69149,6,3,242164,242164,242167,0,3,4
69150,2,3,242166,242167,242170,1,4,0
69151,5,3,242171,242171,242174,0,3,1
69152,5,3,242176,242176,242179,0,3,2
69153,1,2,242177,242179,242181,2,4,0
69154,1,3,242178,242181,242184,3,6,0
69155,4,2,242182,242184,242186,2,4,0
69156,2,1,242184,242186,242187,2,3,0
69157,6,1,242190,242190,242191,0,1,3
69158,6,2,242196,242196,242198,0,2,5
69159,2,3,242198,242198,242201,0,3,0
69160,3,2,242201,242201,242203,0,2,0
69161,4,1,242205,242205,242206,0,1,2
69162,2,1,242207,242207,242208,0,1,1
69163,6,2,242213,242213,242215,0,2,5
69164,1,2,242214,242215,242217,1,3,0
69165,6,1,242220,242220,242221,0,1,3
69166,5,3,242225,242225,242228,0,3,4
69167,5,3,242230,242230,242233,0,3,2
69168,4,2,242234,242234,242236,0,2,1
69169,6,3,242240,242240,242243,0,3,4
69170,2,2,242242,242243,242245,1,3,0
69171,4,1,242246,242246,242247,0,1,1
69172,2,1,242248,242248,242249,0,1,1
69173,5,2,242253,242253,242255,0,2,4
69174,4,1,242257,242257,242258,0,1,2
69175,2,1,242259,242259,242260,0,1,1
69176,6,2,242265,242265,242267,0,2,5
69177,3,1,242268,242268,242269,0,1,1
69178,4,2,242272,242272,242274,0,2,3
69179,2,1,242274,242274,242275,0,1,0
69180,5,1,242279,242279,242280,0,1,4
69181,6,1,242285,242285,242286,0,1,5
69182,3,2,242288,242288,242290,0,2,2
69183,3,3,242291,242291,242294,0,3,1
69184,2,1,242293,242294,242295,1,2,0
69185,6,3,242299,242299,242302,0,3,4
69186,6,3,242305,242305,242308,0,3,3
69187,4,2,242309,242309,242311,0,2,1
69188,4,1,242313,242313,242314,0,1,2
69189,5,2,242318,242318,242320,0,2,4
69190,3,3,242321,242321,242324,0,3,1
69191,6,2,242327,242327,242329,0,2,3
69192,6,3,242333,242333,242336,0,3,4
69193,5,3,242338,242338,242341,0,3,2
69194,6,1,242344,242344,242345,0,1,3
69195,1,3,242345,242345,242348,0,3,0
69196,1,1,242346,242348,242349,2,3,0
69197,5,2,242351,242351,242353,0,2,2
69198,2,2,242353,242353,242355,0,2,0
69199,2,3,242355,242355,242358,0,3,0
69200,6,2,242361,242361,242363,0,2,3
69201,2,2,242363,242363,242365,0,2,0
69202,3,2,242366,242366,242368,0,2,1
69203,5,2,242371,242371,242373,0,2,3
69204,1,2,242372,242373,242375,1,3,0
69205,4,3,242376,242376,242379,0,3,1
69206,4,2,242380,242380,242382,0,2,1
69207,2,1,242382,242382,242383,0,1,0
69208,2,1,242384,242384,242385,0,1,1
69209,3,1,242387,242387,242388,0,1,2
69210,2,1,242389,242389,242390,0,1,1
69211,2,3,242391,242391,242394,0,3,1
69212,3,1,242394,242394,242395,0,1,0
69213,6,1,242400,242400,242401,0,1,5
69214,4,2,242404,242404,242406,0,2,3
69215,6,3,242410,242410,242413,0,3,4
69216,2,2,242412,242413,242415,1,3,0
69217,1,2,242413,242415,242417,2,4,0
69218,5,1,242418,242418,242419,0,1,1
69219,2,3,242420,242420,242423,0,3,1
69220,5,1,242425,242425,242426,0,1,2
69221,6,3,242431,242431,242434,0,3,5
69222,6,1,242437,242437,242438,0,1,3
69223,5,2,242442,242442,242444,0,2,4
69224,1,1,242443,242444,242445,1,2,0
69225,2,2,242445,242445,242447,0,2,0
69226,6,1,242451,242451,242452,0,1,4
69227,2,3,242453,242453,242456,0,3,1
69228,1,2,242454,242456,242458,2,4,0
69229,3,1,242457,242458,242459,1,2,0
69230,3,2,242460,242460,242462,0,2,1
69231,3,1,242463,242463,242464,0,1,1
69232,5,1,242468,242468,242469,0,1,4
69233,2,3,242470,242470,242473,0,3,1
69234,1,1,242471,242473,242474,2,3,0
69235,2,1,242473,242474,242475,1,2,0
69236,3,1,242476,242476,242477,0,1,1
69237,5,2,242481,242481,242483,0,2,4
69238,5,1,242486,242486,242487,0,1,3
69239,6,1,242492,242492,242493,0,1,5
69240,3,2,242495,242495,242497,0,2,2
69241,6,1,242501,242501,242502,0,1,4
69242,5,1,242506,242506,242507,0,1,4
69243,5,2,242511,242511,242513,0,2,4
69244,1,1,242512,242513,242514,1,2,0
69245,2,3,242514,242514,242517,0,3,0
69246,2,1,242516,242517,242518,1,2,0
69247,2,1,242518,242518,242519,0,1,0
69248,1,3,242519,242519,242522,0,3,0
69249,4,1,242523,242523,242524,0,1,1
69250,6,3,242529,242529,242532,0,3,5
69251,4,1,242533,242533,242534,0,1,1
69252,1,1,242534,242534,242535,0,1,0
69253,1,2,242535,242535,242537,0,2,0
69254,6,2,242541,242541,242543,0,2,4
69255,1,3,242542,242543,242546,1,4,0
69256,2,1,242544,242546,242547,2,3,0
69257,2,2,242546,242547,242549,1,3,0
69258,2,2,242548,242549,242551,1,3,0
69259,4,3,242552,242552,242555,0,3,1
69260,2,1,242554,242555,242556,1,2,0
69261,2,3,242556,242556,242559,0,3,0
69262,1,3,242557,242559,242562,2,5,0
69263,5,2,242562,242562,242564,0,2,0
69264,1,1,242563,242564,242565,1,2,0
69265,2,2,242565,242565,242567,0,2,0
69266,1,1,242566,242567,242568,1,2,0
69267,5,1,242571,242571,242572,0,1,3
69268,2,2,242573,242573,242575,0,2,1
69269,4,3,242577,242577,242580,0,3,2
69270,2,2,242579,242580,242582,1,3,0
69271,5,1,242584,242584,242585,0,1,2
69272,1,2,242585,242585,242587,0,2,0
69273,5,2,242590,242590,242592,0,2,3
69274,3,2,242593,242593,242595,0,2,1
69275,4,2,242597,242597,242599,0,2,2
69276,3,1,242600,242600,242601,0,1,1
69277,2,3,242602,242602,242605,0,3,1
69278,2,3,242604,242605,242608,1,4,0
69279,5,3,242609,242609,242612,0,3,1
69280,1,3,242610,242612,242615,2,5,0
69281,2,2,242612,242615,242617,3,5,0
69282,6,3,242618,242618,242621,0,3,1
69283,3,3,242621,242621,242624,0,3,0
69284,2,2,242623,242624,242626,1,3,0
69285,5,1,242628,242628,242629,0,1,2
69286,3,1,242631,242631,242632,0,1,2
69287,1,1,242632,242632,242633,0,1,0
69288,4,1,242636,242636,242637,0,1,3
69289,5,2,242641,242641,242643,0,2,4
69290,1,2,242642,242643,242645,1,3,0
69291,3,3,242645,242645,242648,0,3,0
69292,1,1,242646,242648,242649,2,3,0
69293,5,1,242651,242651,242652,0,1,2
69294,2,3,242653,242653,242656,0,3,1
69295,3,1,242656,242656,242657,0,1,0
69296,2,2,242658,242658,242660,0,2,1
69297,3,2,242661,242661,242663,0,2,1
69298,3,3,242664,242664,242667,0,3,1
69299,1,2,242665,242667,242669,2,4,0
69300,4,3,242669,242669,242672,0,3,0
69301,4,3,242673,242673,242676,0,3,1
69302,6,1,242679,242679,242680,0,1,3
69303,4,1,242683,242683,242684,0,1,3
69304,3,2,242686,242686,242688,0,2,2
69305,1,2,242687,242688,242690,1,3,0
69306,1,2,242688,242690,242692,2,4,0
69307,2,2,242690,242692,242694,2,4,0
69308,1,2,242691,242694,242696,3,5,0
69309,1,2,242692,242696,242698,4,6,0
69310,5,3,242697,242698,242701,1,4,0
69311,3,3,242700,242701,242704,1,4,0
69312,4,2,242704,242704,242706,0,2,0
69313,1,3,242705,242706,242709,1,4,0
69314,1,2,242706,242709,242711,3,5,0
69315,2,1,242708,242711,242712,3,4,0
69316,5,3,242713,242713,242716,0,3,1
69317,4,2,242717,242717,242719,0,2,1
69318,3,3,242720,242720,242723,0,3,1
69319,2,1,242722,242723,242724,1,2,0
69320,2,1,242724,242724,242725,0,1,0
69321,4,3,242728,242728,242731,0,3,3
69322,6,3,242734,242734,242737,0,3,3
69323,6,1,242740,242740,242741,0,1,3
69324,5,2,242745,242745,242747,0,2,4
69325,1,2,242746,242747,242749,1,3,0
69326,2,3,242748,242749,242752,1,4,0
69327,5,3,242753,242753,242756,0,3,1
69328,2,1,242755,242756,242757,1,2,0
69329,6,1,242761,242761,242762,0,1,4
69330,6,2,242767,242767,242769,0,2,5
69331,4,1,242771,242771,242772,0,1,2
69332,4,2,242775,242775,242777,0,2,3
69333,2,1,242777,242777,242778,0,1,0
69334,6,1,242783,242783,242784,0,1,5
69335,3,2,242786,242786,242788,0,2,2
69336,5,3,242791,242791,242794,0,3,3
69337,1,2,242792,242794,242796,2,4,0
69338,5,2,242797,242797,242799,0,2,1
69339,6,2,242803,242803,242805,0,2,4
69340,2,2,242805,242805,242807,0,2,0
69341,6,1,242811,242811,242812,0,1,4
69342,4,2,242815,242815,242817,0,2,3
69343,5,3,242820,242820,242823,0,3,3
69344,2,2,242822,242823,242825,1,3,0
69345,6,2,242828,242828,242830,0,2,3
69346,5,3,242833,242833,242836,0,3,3
69347,5,3,242838,242838,242841,0,3,2
69348,3,3,242841,242841,242844,0,3,0
69349,4,2,242845,242845,242847,0,2,1
69350,1,1,242846,242847,242848,1,2,0
69351,2,3,242848,242848,242851,0,3,0
69352,5,2,242853,242853,242855,0,2,2
69353,5,3,242858,242858,242861,0,3,3
69354,5,1,242863,242863,242864,0,1,2
69355,1,2,242864,242864,242866,0,2,0
69356,1,1,242865,242866,242867,1,2,0
69357,1,1,242866,242867,242868,1,2,0
69358,3,2,242869,242869,242871,0,2,1
69359,1,2,242870,242871,242873,1,3,0
69360,5,3,242875,242875,242878,0,3,2
69361,6,2,242881,242881,242883,0,2,3
69362,2,1,242883,242883,242884,0,1,0
69363,6,3,242889,242889,242892,0,3,5
69364,1,1,242890,242892,242893,2,3,0
69365,6,3,242896,242896,242899,0,3,3
69366,2,2,242898,242899,242901,1,3,0
69367,3,3,242901,242901,242904,0,3,0
69368,3,3,242904,242904,242907,0,3,0
69369,3,1,242907,242907,242908,0,1,0
69370,5,2,242912,242912,242914,0,2,4
69371,4,1,242916,242916,242917,0,1,2
69372,1,2,242917,242917,242919,0,2,0
69373,6,1,242923,242923,242924,0,1,4
69374,3,2,242926,242926,242928,0,2,2
69375,4,2,242930,242930,242932,0,2,2
69376,3,2,242933,242933,242935,0,2,1
69377,1,3,242934,242935,242938,1,4,0
69378,5,1,242939,242939,242940,0,1,1
69379,6,3,242945,242945,242948,0,3,5
69380,1,2,242946,242948,242950,2,4,0
69381,1,2,242947,242950,242952,3,5,0
69382,1,3,242948,242952,242955,4,7,0
69383,5,3,242953,242955,242958,2,5,0
69384,2,2,242955,242958,242960,3,5,0
69385,4,2,242959,242960,242962,1,3,0
69386,4,2,242963,242963,242965,0,2,1
69387,1,1,242964,242965,242966,1,2,0
69388,3,1,242967,242967,242968,0,1,1
69389,1,2,242968,242968,242970,0,2,0
69390,3,3,242971,242971,242974,0,3,1
69391,1,2,242972,242974,242976,2,4,0
69392,6,3,242978,242978,242981,0,3,2
69393,3,1,242981,242981,242982,0,1,0
69394,5,2,242986,242986,242988,0,2,4
69395,1,2,242987,242988,242990,1,3,0
69396,4,1,242991,242991,242992,0,1,1
69397,6,2,242997,242997,242999,0,2,5
69398,1,3,242998,242999,243002,1,4,0
69399,2,2,243000,243002,243004,2,4,0
69400,4,1,243004,243004,243005,0,1,0
69401,6,1,243010,243010,243011,0,1,5
69402,6,3,243016,243016,243019,0,3,5
69403,3,2,243019,243019,243021,0,2,0
69404,5,2,243024,243024,243026,0,2,3
69405,4,3,243028,243028,243031,0,3,2
69406,3,2,243031,243031,243033,0,2,0
69407,1,1,243032,243033,243034,1,2,0
69408,4,2,243036,243036,243038,0,2,2
69409,5,3,243041,243041,243044,0,3,3
69410,1,1,243042,243044,243045,2,3,0
69411,3,2,243045,243045,243047,0,2,0
69412,5,2,243050,243050,243052,0,2,3
69413,1,3,243051,243052,243055,1,4,0
69414,2,2,243053,243055,243057,2,4,0
69415,5,1,243058,243058,243059,0,1,1
69416,4,3,243062,243062,243065,0,3,3
69417,1,2,243063,243065,243067,2,4,0
69418,5,1,243068,243068,243069,0,1,1
69419,6,2,243074,243074,243076,0,2,5
69420,6,3,243080,243080,243083,0,3,4
69421,6,1,243086,243086,243087,0,1,3
69422,6,2,243092,243092,243094,0,2,5
69423,6,2,243098,243098,243100,0,2,4
69424,2,3,243100,243100,243103,0,3,0
69425,6,2,243106,243106,243108,0,2,3
69426,4,3,243110,243110,243113,0,3,2
69427,1,1,243111,243113,243114,2,3,0
69428,1,3,243112,243114,243117,2,5,0
69429,3,1,243115,243117,243118,2,3,0
69430,4,3,243119,243119,243122,0,3,1
69431,1,1,243120,243122,243123,2,3,0
69432,5,3,243125,243125,243128,0,3,2
69433,4,1,243129,243129,243130,0,1,1
69434,6,1,243135,243135,243136,0,1,5
69435,3,1,243138,243138,243139,0,1,2
69436,5,2,243143,243143,243145,0,2,4
69437,1,2,243144,243145,243147,1,3,0
69438,3,1,243147,243147,243148,0,1,0
69439,2,3,243149,243149,243152,0,3,1
69440,6,2,243155,243155,243157,0,2,3
69441,6,2,243161,243161,243163,0,2,4
69442,4,3,243165,243165,243168,0,3,2
69443,4,2,243169,243169,243171,0,2,1
69444,5,3,243174,243174,243177,0,3,3
69445,2,3,243176,243177,243180,1,4,0
69446,4,3,243180,243180,243183,0,3,0
69447,2,3,243182,243183,243186,1,4,0
69448,1,2,243183,243186,243188,3,5,0
69449,5,1,243188,243188,243189,0,1,0
69450,2,1,243190,243190,243191,0,1,1
69451,1,2,243191,243191,243193,0,2,0
69452,1,3,243192,243193,243196,1,4,0
69453,6,2,243198,243198,243200,0,2,2
69454,2,2,243200,243200,243202,0,2,0
69455,6,2,243206,243206,243208,0,2,4
69456,3,3,243209,243209,243212,0,3,1
69457,4,3,243213,243213,243216,0,3,1
69458,4,1,243217,243217,243218,0,1,1
69459,4,1,243221,243221,243222,0,1,3
69460,3,1,243224,243224,243225,0,1,2
69461,1,2,243225,243225,243227,0,2,0
69462,6,3,243231,243231,243234,0,3,4
69463,5,3,243236,243236,243239,0,3,2
69464,4,3,243240,243240,243243,0,3,1
69465,1,3,243241,243243,243246,2,5,0
69466,2,2,243243,243246,243248,3,5,0
69467,1,2,243244,243248,243250,4,6,0
69468,3,1,243247,243250,243251,3,4,0
69469,3,3,243250,243251,243254,1,4,0
69470,2,2,243252,243254,243256,2,4,0
69471,5,3,243257,243257,243260,0,3,1
69472,2,2,243259,243260,243262,1,3,0
69473,4,3,243263,243263,243266,0,3,1
69474,6,3,243269,243269,243272,0,3,3
69475,6,3,243275,243275,243278,0,3,3
69476,4,1,243279,243279,243280,0,1,1
69477,5,2,243284,243284,243286,0,2,4
69478,1,1,243285,243286,243287,1,2,0
69479,2,3,243287,243287,243290,0,3,0
69480,4,2,243291,243291,243293,0,2,1
69481,6,3,243297,243297,243300,0,3,4
69482,2,1,243299,243300,243301,1,2,0
69483,1,1,243300,243301,243302,1,2,0
69484,5,2,243305,243305,243307,0,2,3
69485,2,2,243307,243307,243309,0,2,0
69486,3,2,243310,243310,243312,0,2,1
69487,5,3,243315,243315,243318,0,3,3
69488,3,1,243318,243318,243319,0,1,0
69489,6,1,243324,243324,243325,0,1,5
69490,4,3,243328,243328,243331,0,3,3
69491,6,3,243334,243334,243337,0,3,3
69492,5,2,243339,243339,243341,0,2,2
69493,3,3,243342,243342,243345,0,3,1
69494,1,2,243343,243345,243347,2,4,0
69495,4,2,243347,243347,243349,0,2,0
69496,3,2,243350,243350,243352,0,2,1
69497,1,1,243351,243352,243353,1,2,0
69498,6,2,243357,243357,243359,0,2,4
69499,5,3,243362,243362,243365,0,3,3
69500,5,2,243367,243367,243369,0,2,2
69501,4,2,243371,243371,243373,0,2,2
69502,5,1,243376,243376,243377,0,1,3
69503,5,2,243381,243381,243383,0,2,4
69504,6,2,243387,243387,243389,0,2,4
69505,1,3,243388,243389,243392,1,4,0
69506,4,3,243392,243392,243395,0,3,0
69507,4,2,243396,243396,243398,0,2,1
69508,6,3,243402,243402,243405,0,3,4
69509,5,1,243407,243407,243408,0,1,2
69510,6,1,243413,243413,243414,0,1,5
69511,2,1,243415,243415,243416,0,1,1
69512,2,1,243417,243417,243418,0,1,1
69513,2,3,243419,243419,243422,0,3,1
69514,2,2,243421,243422,243424,1,3,0
69515,2,3,243423,243424,243427,1,4,0
69516,1,2,243424,243427,243429,3,5,0
69517,4,1,243428,243429,243430,1,2,0
69518,4,2,243432,243432,243434,0,2,2
69519,5,1,243437,243437,243438,0,1,3
69520,5,3,243442,243442,243445,0,3,4
69521,5,1,243447,243447,243448,0,1,2
69522,1,2,243448,243448,243450,0,2,0
69523,2,1,243450,243450,243451,0,1,0
69524,4,2,243454,243454,243456,0,2,3
69525,2,1,243456,243456,243457,0,1,0
69526,1,3,243457,243457,243460,0,3,0
69527,6,1,243463,243463,243464,0,1,3
69528,6,2,243469,243469,243471,0,2,5
69529,6,3,243475,243475,243478,0,3,4
69530,5,1,243480,243480,243481,0,1,2
69531,3,1,243483,243483,243484,0,1,2
69532,4,1,243487,243487,243488,0,1,3
69533,6,2,243493,243493,243495,0,2,5
69534,3,2,243496,243496,243498,0,2,1
69535,6,1,243502,243502,243503,0,1,4
69536,5,2,243507,243507,243509,0,2,4
69537,1,2,243508,243509,243511,1,3,0
69538,3,1,243511,243511,243512,0,1,0
69539,1,2,243512,243512,243514,0,2,0
69540,5,3,243517,243517,243520,0,3,3
69541,1,1,243518,243520,243521,2,3,0
69542,5,1,243523,243523,243524,0,1,2
69543,3,1,243526,243526,243527,0,1,2
69544,2,2,243528,243528,243530,0,2,1
69545,6,2,243534,243534,243536,0,2,4
69546,4,1,243538,243538,243539,0,1,2
69547,3,2,243541,243541,243543,0,2,2
69548,5,3,243546,243546,243549,0,3,3
69549,5,3,243551,243551,243554,0,3,2
69550,6,1,243557,243557,243558,0,1,3
69551,4,2,243561,243561,243563,0,2,3
69552,2,3,243563,243563,243566,0,3,0
69553,2,2,243565,243566,243568,1,3,0
69554,1,2,243566,243568,243570,2,4,0
69555,5,3,243571,243571,243574,0,3,1
69556,2,3,243573,243574,243577,1,4,0
69557,4,1,243577,243577,243578,0,1,0
69558,3,2,243580,243580,243582,0,2,2
69559,5,1,243585,243585,243586,0,1,3
69560,3,3,243588,243588,243591,0,3,2
69561,6,1,243594,243594,243595,0,1,3
69562,2,2,243596,243596,243598,0,2,1
69563,3,3,243599,243599,243602,0,3,1
69564,3,3,243602,243602,243605,0,3,0
69565,4,1,243606,243606,243607,0,1,1
69566,5,3,243611,243611,243614,0,3,4
69567,4,3,243615,243615,243618,0,3,1
69568,6,3,243621,243621,243624,0,3,3
69569,2,2,243623,243624,243626,1,3,0
69570,2,3,243625,243626,243629,1,4,0
69571,6,1,243631,243631,243632,0,1,2
69572,5,1,243636,243636,243637,0,1,4
69573,5,1,243641,243641,243642,0,1,4
69574,2,3,243643,243643,243646,0,3,1
69575,1,3,243644,243646,243649,2,5,0
69576,1,2,243645,243649,243651,4,6,0
69577,3,1,243648,243651,243652,3,4,0
69578,4,3,243652,243652,243655,0,3,0
69579,3,3,243655,243655,243658,0,3,0
69580,4,1,243659,243659,243660,0,1,1
69581,4,2,243663,243663,243665,0,2,3
69582,4,1,243667,243667,243668,0,1,2
69583,2,3,243669,243669,243672,0,3,1
69584,4,2,243673,243673,243675,0,2,1
69585,6,2,243679,243679,243681,0,2,4
69586,4,2,243683,243683,243685,0,2,2
69587,1,3,243684,243685,243688,1,4,0
69588,5,3,243689,243689,243692,0,3,1
69589,2,2,243691,243692,243694,1,3,0
69590,5,1,243696,243696,243697,0,1,2
69591,4,3,243700,243700,243703,0,3,3
69592,1,2,243701,243703,243705,2,4,0
69593,3,1,243704,243705,243706,1,2,0
69594,1,1,243705,243706,243707,1,2,0
69595,3,2,243708,243708,243710,0,2,1
69596,1,1,243709,243710,243711,1,2,0
69597,5,3,243714,243714,243717,0,3,3
69598,3,1,243717,243717,243718,0,1,0
69599,6,2,243723,243723,243725,0,2,5
69600,5,3,243728,243728,243731,0,3,3
69601,4,2,243732,243732,243734,0,2,1
69602,4,3,243736,243736,243739,0,3,2
69603,5,1,243741,243741,243742,0,1,2
69604,1,1,243742,243742,243743,0,1,0
69605,2,2,243744,243744,243746,0,2,1
69606,5,2,243749,243749,243751,0,2,3
69607,3,1,243752,243752,243753,0,1,1
69608,6,2,243758,243758,243760,0,2,5
69609,3,3,243761,243761,243764,0,3,1
69610,6,3,243767,243767,243770,0,3,3
69611,2,1,243769,243770,243771,1,2,0
69612,4,1,243773,243773,243774,0,1,2
69613,6,1,243779,243779,243780,0,1,5
69614,3,3,243782,243782,243785,0,3,2
69615,2,1,243784,243785,243786,1,2,0
69616,6,1,243790,243790,243791,0,1,4
69617,4,2,243794,243794,243796,0,2,3
69618,2,2,243796,243796,243798,0,2,0
69619,3,1,243799,243799,243800,0,1,1
69620,2,2,243801,243801,243803,0,2,1
69621,3,1,243804,243804,243805,0,1,1
69622,6,1,243810,243810,243811,0,1,5
69623,3,3,243813,243813,243816,0,3,2
69624,2,3,243815,243816,243819,1,4,0
69625,5,2,243820,243820,243822,0,2,1
69626,5,2,243825,243825,243827,0,2,3
69627,3,3,243828,243828,243831,0,3,1
69628,6,3,243834,243834,243837,0,3,3
69629,5,3,243839,243839,243842,0,3,2
69630,5,1,243844,243844,243845,0,1,2
69631,3,2,243847,243847,243849,0,2,2
69632,6,3,243853,243853,243856,0,3,4
69633,6,2,243859,243859,243861,0,2,3
69634,5,3,243864,243864,243867,0,3,3
69635,6,2,243870,243870,243872,0,2,3
69636,3,1,243873,243873,243874,0,1,1
69637,6,1,243879,243879,243880,0,1,5
69638,5,2,243884,243884,243886,0,2,4
69639,2,3,243886,243886,243889,0,3,0
69640,3,2,243889,243889,243891,0,2,0
69641,1,2,243890,243891,243893,1,3,0
69642,4,1,243894,243894,243895,0,1,1
69643,3,2,243897,243897,243899,0,2,2
69644,3,3,243900,243900,243903,0,3,1
69645,1,2,243901,243903,243905,2,4,0
69646,5,1,243906,243906,243907,0,1,1
69647,1,2,243907,243907,243909,0,2,0
69648,6,2,243913,243913,243915,0,2,4
69649,1,3,243914,243915,243918,1,4,0
69650,1,3,243915,243918,243921,3,6,0
69651,2,2,243917,243921,243923,4,6,0
69652,5,2,243922,243923,243925,1,3,0
69653,1,3,243923,243925,243928,2,5,0
69654,5,1,243928,243928,243929,0,1,0
69655,5,3,243933,243933,243936,0,3,4
69656,5,3,243938,243938,243941,0,3,2
69657,5,1,243943,243943,243944,0,1,2
69658,5,3,243948,243948,243951,0,3,4
69659,6,3,243954,243954,243957,0,3,3
69660,5,2,243959,243959,243961,0,2,2
69661,6,2,243965,243965,243967,0,2,4
69662,3,1,243968,243968,243969,0,1,1
69663,4,2,243972,243972,243974,0,2,3
69664,2,3,243974,243974,243977,0,3,0
69665,2,1,243976,243977,243978,1,2,0
69666,1,2,243977,243978,243980,1,3,0
69667,3,1,243980,243980,243981,0,1,0
69668,1,3,243981,243981,243984,0,3,0
69669,1,3,243982,243984,243987,2,5,0
69670,5,1,243987,243987,243988,0,1,0
69671,4,3,243991,243991,243994,0,3,3
69672,1,2,243992,243994,243996,2,4,0
69673,3,3,243995,243996,243999,1,4,0
69674,1,2,243996,243999,244001,3,5,0
69675,1,2,243997,244001,244003,4,6,0
69676,3,2,244000,244003,244005,3,5,0
69677,6,1,244006,244006,244007,0,1,1
69678,5,3,244011,244011,244014,0,3,4
69679,4,1,244015,244015,244016,0,1,1
69680,5,3,244020,244020,244023,0,3,4
69681,3,2,244023,244023,244025,0,2,0
69682,2,3,244025,244025,244028,0,3,0
69683,1,2,244026,244028,244030,2,4,0
69684,2,1,244028,244030,244031,2,3,0
69685,5,2,244033,244033,244035,0,2,2
69686,1,3,244034,244035,244038,1,4,0
69687,2,2,244036,244038,244040,2,4,0
69688,2,3,244038,244040,244043,2,5,0
69689,1,1,244039,244043,244044,4,5,0
69690,2,2,244041,244044,244046,3,5,0
69691,5,1,244046,244046,244047,0,1,0
69692,2,1,244048,244048,244049,0,1,1
69693,3,1,244051,244051,244052,0,1,2
69694,4,2,244055,244055,244057,0,2,3
69695,4,3,244059,244059,244062,0,3,2
69696,1,2,244060,244062,244064,2,4,0
69697,2,3,244062,244064,244067,2,5,0
69698,2,3,244064,244067,244070,3,6,0
69699,5,2,244069,244070,244072,1,3,0
69700,4,1,244073,244073,244074,0,1,1
69701,6,3,244079,244079,244082,0,3,5
69702,2,3,244081,244082,244085,1,4,0
69703,4,3,244085,244085,244088,0,3,0
69704,1,2,244086,244088,244090,2,4,0
69705,3,2,244089,244090,244092,1,3,0
69706,4,2,244093,244093,244095,0,2,1
69707,4,3,244097,244097,244100,0,3,2
69708,6,2,244103,244103,244105,0,2,3
69709,5,2,244108,244108,244110,0,2,3
69710,5,2,244113,244113,244115,0,2,3
69711,3,2,244116,244116,244118,0,2,1
69712,2,2,244118,244118,244120,0,2,0
69713,1,3,244119,244120,244123,1,4,0
69714,4,2,244123,244123,244125,0,2,0
69715,5,1,244128,244128,244129,0,1,3
69716,1,2,244129,244129,244131,0,2,0
69717,1,1,244130,244131,244132,1,2,0
69718,6,1,244136,244136,244137,0,1,4
69719,5,2,244141,244141,244143,0,2,4
69720,1,3,244142,244143,244146,1,4,0
69721,6,3,244148,244148,244151,0,3,2
69722,3,2,244151,244151,244153,0,2,0
69723,5,1,244156,244156,244157,0,1,3
69724,1,2,244157,244157,244159,0,2,0
69725,4,1,244161,244161,244162,0,1,2
69726,1,1,244162,244162,244163,0,1,0
69727,1,1,244163,244163,244164,0,1,0
69728,5,1,244168,244168,244169,0,1,4
69729,2,1,244170,244170,244171,0,1,1
69730,1,2,244171,244171,244173,0,2,0
69731,6,2,244177,244177,244179,0,2,4
69732,1,3,244178,244179,244182,1,4,0
69733,3,3,244181,244182,244185,1,4,0
69734,3,1,244184,244185,244186,1,2,0
69735,1,3,244185,244186,244189,1,4,0
69736,6,1,244191,244191,244192,0,1,2
69737,1,1,244192,244192,244193,0,1,0
69738,1,1,244193,244193,244194,0,1,0
69739,3,3,244196,244196,244199,0,3,2
69740,2,3,244198,244199,244202,1,4,0
69741,2,1,244200,244202,244203,2,3,0
69742,3,1,244203,244203,244204,0,1,0
69743,2,1,244205,244205,244206,0,1,1
69744,1,3,244206,244206,244209,0,3,0
69745,6,1,244212,244212,244213,0,1,3
69746,5,1,244217,244217,244218,0,1,4
69747,3,3,244220,244220,244223,0,3,2
69748,6,3,244226,244226,244229,0,3,3
69749,3,2,244229,244229,244231,0,2,0
69750,4,2,244233,244233,244235,0,2,2
69751,2,2,244235,244235,244237,0,2,0
69752,1,3,244236,244237,244240,1,4,0
69753,4,1,244240,244240,244241,0,1,0
69754,4,2,244244,244244,244246,0,2,3
69755,6,3,244250,244250,244253,0,3,4
69756,4,1,244254,244254,244255,0,1,1
69757,4,2,244258,244258,244260,0,2,3
69758,4,2,244262,244262,244264,0,2,2
69759,6,3,244268,244268,244271,0,3,4
69760,4,1,244272,244272,244273,0,1,1
69761,2,2,244274,244274,244276,0,2,1
69762,1,3,244275,244276,244279,1,4,0
69763,4,3,244279,244279,244282,0,3,0
69764,4,1,244283,244283,244284,0,1,1
69765,2,1,244285,244285,244286,0,1,1
69766,3,1,244288,244288,244289,0,1,2
69767,1,2,244289,244289,244291,0,2,0
69768,2,1,244291,244291,244292,0,1,0
69769,3,2,244294,244294,244296,0,2,2
69770,5,3,244299,244299,244302,0,3,3
69771,2,1,244301,244302,244303,1,2,0
69772,2,1,244303,244303,244304,0,1,0
69773,3,1,244306,244306,244307,0,1,2
69774,6,1,244312,244312,244313,0,1,5
69775,3,2,244315,244315,244317,0,2,2
69776,3,3,244318,244318,244321,0,3,1
69777,1,2,244319,244321,244323,2,4,0
69778,5,2,244324,244324,244326,0,2,1
69779,3,1,244327,244327,244328,0,1,1
69780,5,3,244332,244332,244335,0,3,4
69781,2,3,244334,244335,244338,1,4,0
69782,5,3,244339,244339,244342,0,3,1
69783,1,3,244340,244342,244345,2,5,0
69784,6,1,244346,244346,244347,0,1,1
69785,1,2,244347,244347,244349,0,2,0
69786,5,3,244352,244352,244355,0,3,3
69787,6,2,244358,244358,244360,0,2,3
69788,4,3,244362,244362,244365,0,3,2
69789,5,3,244367,244367,244370,0,3,2
69790,5,3,244372,244372,244375,0,3,2
69791,5,1,244377,244377,244378,0,1,2
69792,4,3,244381,244381,244384,0,3,3
69793,4,1,244385,244385,244386,0,1,1
69794,6,1,244391,244391,244392,0,1,5
69795,5,3,244396,244396,244399,0,3,4
69796,3,3,244399,244399,244402,0,3,0
69797,5,2,244404,244404,244406,0,2,2
69798,2,3,244406,244406,244409,0,3,0
69799,1,3,244407,244409,244412,2,5,0
69800,6,1,244413,244413,244414,0,1,1
69801,1,2,244414,244414,244416,0,2,0
69802,3,3,244417,244417,244420,0,3,1
69803,3,2,244420,244420,244422,0,2,0
69804,6,3,244426,244426,244429,0,3,4
69805,3,3,244429,244429,244432,0,3,0
69806,3,2,244432,244432,244434,0,2,0
69807,6,1,244438,244438,244439,0,1,4
69808,1,1,244439,244439,244440,0,1,0
69809,5,2,244444,244444,244446,0,2,4
69810,1,1,244445,244446,244447,1,2,0
69811,2,3,244447,244447,244450,0,3,0
69812,1,3,244448,244450,244453,2,5,0
69813,6,1,244454,244454,244455,0,1,1
69814,6,3,244460,244460,244463,0,3,5
69815,3,3,244463,244463,244466,0,3,0
69816,6,2,244469,244469,244471,0,2,3
69817,3,1,244472,244472,244473,0,1,1
69818,1,2,244473,244473,244475,0,2,0
69819,6,1,244479,244479,244480,0,1,4
69820,5,1,244484,244484,244485,0,1,4
69821,4,3,244488,244488,244491,0,3,3
69822,1,1,244489,244491,244492,2,3,0
69823,5,2,244494,244494,244496,0,2,2
69824,2,3,244496,244496,244499,0,3,0
69825,5,3,244501,244501,244504,0,3,2
69826,3,2,244504,244504,244506,0,2,0
69827,2,2,244506,244506,244508,0,2,0
69828,1,1,244507,244508,244509,1,2,0
69829,1,1,244508,244509,244510,1,2,0
69830,1,2,244509,244510,244512,1,3,0
69831,3,3,244512,244512,244515,0,3,0
69832,6,3,244518,244518,244521,0,3,3
69833,2,3,244520,244521,244524,1,4,0
69834,3,1,244523,244524,244525,1,2,0
69835,4,1,244527,244527,244528,0,1,2
69836,6,3,244533,244533,244536,0,3,5
69837,6,3,244539,244539,244542,0,3,3
69838,4,2,244543,244543,244545,0,2,1
69839,3,1,244546,244546,244547,0,1,1
69840,1,3,244547,244547,244550,0,3,0
69841,4,2,244551,244551,244553,0,2,1
69842,3,3,244554,244554,244557,0,3,1
69843,1,3,244555,244557,244560,2,5,0
69844,3,1,244558,244560,244561,2,3,0
69845,6,1,244564,244564,244565,0,1,3
69846,3,3,244567,244567,244570,0,3,2
69847,6,1,244573,244573,244574,0,1,3
69848,3,1,244576,244576,244577,0,1,2
69849,5,1,244581,244581,244582,0,1,4
69850,4,2,244585,244585,244587,0,2,3
69851,4,3,244589,244589,244592,0,3,2
69852,4,1,244593,244593,244594,0,1,1
69853,6,2,244599,244599,244601,0,2,5
69854,5,1,244604,244604,244605,0,1,3
69855,5,3,244609,244609,244612,0,3,4
69856,5,3,244614,244614,244617,0,3,2
69857,5,3,244619,244619,244622,0,3,2
69858,3,3,244622,244622,244625,0,3,0
69859,4,3,244626,244626,244629,0,3,1
69860,5,1,244631,244631,244632,0,1,2
69861,2,3,244633,244633,244636,0,3,1
69862,4,1,244637,244637,244638,0,1,1
69863,5,2,244642,244642,244644,0,2,4
69864,4,3,244646,244646,244649,0,3,2
69865,3,1,244649,244649,244650,0,1,0
69866,6,1,244655,244655,244656,0,1,5
69867,5,2,244660,244660,244662,0,2,4
69868,6,3,244666,244666,244669,0,3,4
69869,6,3,244672,244672,244675,0,3,3
69870,1,2,244673,244675,244677,2,4,0
69871,1,1,244674,244677,244678,3,4,0
69872,5,1,244679,244679,244680,0,1,1
69873,6,2,244685,244685,244687,0,2,5
69874,3,2,244688,244688,244690,0,2,1
69875,4,3,244692,244692,244695,0,3,2
69876,4,3,244696,244696,244699,0,3,1
69877,2,3,244698,244699,244702,1,4,0
69878,3,2,244701,244702,244704,1,3,0
69879,1,1,244702,244704,244705,2,3,0
69880,1,3,244703,244705,244708,2,5,0
69881,4,1,244707,244708,244709,1,2,0
69882,2,1,244709,244709,244710,0,1,0
69883,1,1,244710,244710,244711,0,1,0
69884,5,1,244715,244715,244716,0,1,4
69885,5,3,244720,244720,244723,0,3,4
69886,1,3,244721,244723,244726,2,5,0
69887,5,2,244726,244726,244728,0,2,0
69888,2,2,244728,244728,244730,0,2,0
69889,4,3,244732,244732,244735,0,3,2
69890,6,2,244738,244738,244740,0,2,3
69891,2,2,244740,244740,244742,0,2,0
69892,1,3,244741,244742,244745,1,4,0
69893,4,1,244745,244745,244746,0,1,0
69894,2,2,244747,244747,244749,0,2,1
69895,2,2,244749,244749,244751,0,2,0
69896,2,1,244751,244751,244752,0,1,0
69897,1,3,244752,244752,244755,0,3,0
69898,5,3,244757,244757,244760,0,3,2
69899,4,2,244761,244761,244763,0,2,1
69900,3,3,244764,244764,244767,0,3,1
69901,4,2,244768,244768,244770,0,2,1
69902,5,2,244773,244773,244775,0,2,3
69903,4,2,244777,244777,244779,0,2,2
69904,4,1,244781,244781,244782,0,1,2
69905,4,2,244785,244785,244787,0,2,3
69906,1,1,244786,244787,244788,1,2,0
69907,6,3,244792,244792,244795,0,3,4
69908,3,3,244795,244795,244798,0,3,0
69909,4,1,244799,244799,244800,0,1,1
69910,2,3,244801,244801,244804,0,3,1
69911,3,2,244804,244804,244806,0,2,0
69912,1,1,244805,244806,244807,1,2,0
69913,2,1,244807,244807,244808,0,1,0
69914,4,1,244811,244811,244812,0,1,3
69915,2,1,244813,244813,244814,0,1,1
69916,4,1,244817,244817,244818,0,1,3
69917,6,2,244823,244823,244825,0,2,5
69918,1,3,244824,244825,244828,1,4,0
69919,5,1,244829,244829,244830,0,1,1
69920,3,2,244832,244832,244834,0,2,2
69921,6,3,244838,244838,244841,0,3,4
69922,4,3,244842,244842,244845,0,3,1
69923,4,1,244846,244846,244847,0,1,1
69924,5,1,244851,244851,244852,0,1,4
69925,4,2,244855,244855,244857,0,2,3
69926,2,3,244857,244857,244860,0,3,0
69927,4,3,244861,244861,244864,0,3,1
69928,3,3,244864,244864,244867,0,3,0
69929,1,1,244865,244867,244868,2,3,0
69930,3,3,244868,244868,244871,0,3,0
69931,1,2,244869,244871,244873,2,4,0
69932,5,3,244874,244874,244877,0,3,1
69933,4,1,244878,244878,244879,0,1,1
69934,5,3,244883,244883,244886,0,3,4
69935,1,3,244884,244886,244889,2,5,0
69936,6,3,244890,244890,244893,0,3,1
69937,4,1,244894,244894,244895,0,1,1
69938,4,1,244898,244898,244899,0,1,3
69939,6,2,244904,244904,244906,0,2,5
69940,3,3,244907,244907,244910,0,3,1
69941,3,2,244910,244910,244912,0,2,0
69942,6,1,244916,244916,244917,0,1,4
69943,2,1,244918,244918,244919,0,1,1
69944,1,1,244919,244919,244920,0,1,0
69945,4,1,244923,244923,244924,0,1,3
69946,6,1,244929,244929,244930,0,1,5
69947,2,3,244931,244931,244934,0,3,1
69948,4,2,244935,244935,244937,0,2,1
69949,1,2,244936,244937,244939,1,3,0
69950,1,2,244937,244939,244941,2,4,0
69951,5,3,244942,244942,244945,0,3,1
69952,2,3,244944,244945,244948,1,4,0
69953,2,1,244946,244948,244949,2,3,0
69954,6,2,244952,244952,244954,0,2,3
69955,1,3,244953,244954,244957,1,4,0
69956,4,2,244957,244957,244959,0,2,0
69957,1,1,244958,244959,244960,1,2,0
69958,3,2,244961,244961,244963,0,2,1
69959,4,1,244965,244965,244966,0,1,2
69960,1,1,244966,244966,244967,0,1,0
69961,5,1,244971,244971,244972,0,1,4
69962,5,3,244976,244976,244979,0,3,4
69963,3,3,244979,244979,244982,0,3,0
69964,4,2,244983,244983,244985,0,2,1
69965,3,3,244986,244986,244989,0,3,1
69966,3,1,244989,244989,244990,0,1,0
69967,5,2,244994,244994,244996,0,2,4
69968,4,1,244998,244998,244999,0,1,2
69969,3,3,245001,245001,245004,0,3,2
69970,1,1,245002,245004,245005,2,3,0
69971,2,1,245004,245005,245006,1,2,0
69972,4,3,245008,245008,245011,0,3,2
69973,3,2,245011,245011,245013,0,2,0
69974,3,1,245014,245014,245015,0,1,1
69975,4,3,245018,245018,245021,0,3,3
69976,1,1,245019,245021,245022,2,3,0
69977,2,1,245021,245022,245023,1,2,0
69978,5,2,245026,245026,245028,0,2,3
69979,5,1,245031,245031,245032,0,1,3
69980,3,2,245034,245034,245036,0,2,2
69981,5,3,245039,245039,245042,0,3,3
69982,4,2,245043,245043,245045,0,2,1
69983,6,2,245049,245049,245051,0,2,4
69984,5,1,245054,245054,245055,0,1,3
69985,4,2,245058,245058,245060,0,2,3
69986,4,1,245062,245062,245063,0,1,2
69987,3,2,245065,245065,245067,0,2,2
69988,3,3,245068,245068,245071,0,3,1
69989,4,2,245072,245072,245074,0,2,1
69990,4,2,245076,245076,245078,0,2,2
69991,1,1,245077,245078,245079,1,2,0
69992,1,2,245078,245079,245081,1,3,0
69993,1,3,245079,245081,245084,2,5,0
69994,2,2,245081,245084,245086,3,5,0
69995,1,3,245082,245086,245089,4,7,0
69996,6,1,245088,245089,245090,1,2,0
69997,6,2,245094,245094,245096,0,2,4
69998,1,2,245095,245096,245098,1,3,0
69999,2,3,245097,245098,245101,1,4,0
70000,5,1,245102,245102,245103,0,1,1
70001,5,2,245107,245107,245109,0,2,4
70002,1,1,245108,245109,245110,1,2,0
70003,1,1,245109,245110,245111,1,2,0
70004,1,2,245110,245111,245113,1,3,0
70005,1,1,245111,245113,245114,2,3,0
70006,3,2,245114,245114,245116,0,2,0
70007,1,3,245115,245116,245119,1,4,0
70008,1,3,245116,245119,245122,3,6,0
70009,2,2,245118,245122,245124,4,6,0
70010,5,1,245123,245124,245125,1,2,0
70011,4,1,245127,245127,245128,0,1,2
70012,6,3,245133,245133,245136,0,3,5
70013,1,1,245134,245136,245137,2,3,0
70014,6,3,245140,245140,245143,0,3,3
70015,2,3,245142,245143,245146,1,4,0
70016,5,1,245147,245147,245148,0,1,1
70017,2,2,245149,245149,245151,0,2,1
70018,6,2,245155,245155,245157,0,2,4
70019,3,3,245158,245158,245161,0,3,1
70020,5,1,245163,245163,245164,0,1,2
70021,4,2,245167,245167,245169,0,2,3
70022,3,2,245170,245170,245172,0,2,1
70023,3,3,245173,245173,245176,0,3,1
70024,1,2,245174,245176,245178,2,4,0
70025,5,3,245179,245179,245182,0,3,1
70026,6,1,245185,245185,245186,0,1,3
70027,2,1,245187,245187,245188,0,1,1
70028,2,2,245189,245189,245191,0,2,1
70029,3,1,245192,245192,245193,0,1,1
70030,5,3,245197,245197,245200,0,3,4
70031,1,2,245198,245200,245202,2,4,0
70032,2,1,245200,245202,245203,2,3,0
70033,3,2,245203,245203,245205,0,2,0
70034,6,1,245209,245209,245210,0,1,4
70035,6,2,245215,245215,245217,0,2,5
70036,5,3,245220,245220,245223,0,3,3
70037,6,2,245226,245226,245228,0,2,3
70038,4,2,245230,245230,245232,0,2,2
70039,4,2,245234,245234,245236,0,2,2
70040,5,3,245239,245239,245242,0,3,3
70041,1,2,245240,245242,245244,2,4,0
70042,6,1,245246,245246,245247,0,1,2
70043,1,2,245247,245247,245249,0,2,0
70044,2,3,245249,245249,245252,0,3,0
70045,6,3,245255,245255,245258,0,3,3
70046,4,1,245259,245259,245260,0,1,1
70047,3,3,245262,245262,245265,0,3,2
70048,5,1,245267,245267,245268,0,1,2
70049,1,1,245268,245268,245269,0,1,0
70050,2,2,245270,245270,245272,0,2,1
70051,4,1,245274,245274,245275,0,1,2
70052,6,2,245280,245280,245282,0,2,5
70053,2,1,245282,245282,245283,0,1,0
70054,3,1,245285,245285,245286,0,1,2
70055,6,2,245291,245291,245293,0,2,5
70056,4,3,245295,245295,245298,0,3,2
70057,3,1,245298,245298,245299,0,1,0
70058,5,2,245303,245303,245305,0,2,4
70059,5,3,245308,245308,245311,0,3,3
70060,5,1,245313,245313,245314,0,1,2
70061,1,3,245314,245314,245317,0,3,0
70062,3,2,245317,245317,245319,0,2,0
70063,1,2,245318,245319,245321,1,3,0
70064,5,3,245323,245323,245326,0,3,2
70065,3,1,245326,245326,245327,0,1,0
70066,5,3,245331,245331,245334,0,3,4
70067,3,3,245334,245334,245337,0,3,0
70068,1,3,245335,245337,245340,2,5,0
70069,4,2,245339,245340,245342,1,3,0
70070,2,1,245341,245342,245343,1,2,0
70071,1,2,245342,245343,245345,1,3,0
70072,2,1,245344,245345,245346,1,2,0
70073,4,2,245348,245348,245350,0,2,2
70074,4,2,245352,245352,245354,0,2,2
70075,1,3,245353,245354,245357,1,4,0
70076,4,2,245357,245357,245359,0,2,0
70077,6,1,245363,245363,245364,0,1,4
70078,2,3,245365,245365,245368,0,3,1
70079,2,1,245367,245368,245369,1,2,0
70080,3,3,245370,245370,245373,0,3,1
70081,6,2,245376,245376,245378,0,2,3
70082,4,1,245380,245380,245381,0,1,2
70083,1,3,245381,245381,245384,0,3,0
70084,2,1,245383,245384,245385,1,2,0
70085,6,2,245389,245389,245391,0,2,4
70086,1,1,245390,245391,245392,1,2,0
70087,1,2,245391,245392,245394,1,3,0
70088,3,2,245394,245394,245396,0,2,0
70089,5,3,245399,245399,245402,0,3,3
70090,3,3,245402,245402,245405,0,3,0
70091,5,2,245407,245407,245409,0,2,2
70092,3,1,245410,245410,245411,0,1,1
70093,3,1,245413,245413,245414,0,1,2
70094,1,1,245414,245414,245415,0,1,0
70095,2,1,245416,245416,245417,0,1,1
70096,3,3,245419,245419,245422,0,3,2
70097,2,1,245421,245422,245423,1,2,0
70098,1,1,245422,245423,245424,1,2,0
70099,4,3,245426,245426,245429,0,3,2
70100,5,3,245431,245431,245434,0,3,2
70101,1,3,245432,245434,245437,2,5,0
70102,2,3,245434,245437,245440,3,6,0
70103,1,3,245435,245440,245443,5,8,0
70104,1,1,245436,245443,245444,7,8,0
70105,3,3,245439,245444,245447,5,8,0
70106,5,3,245444,245447,245450,3,6,0
70107,3,3,245447,245450,245453,3,6,0
70108,5,3,245452,245453,245456,1,4,0
70109,5,1,245457,245457,245458,0,1,1
70110,1,1,245458,245458,245459,0,1,0
70111,4,1,245462,245462,245463,0,1,3
70112,4,1,245466,245466,245467,0,1,3
70113,2,1,245468,245468,245469,0,1,1
70114,4,3,245472,245472,245475,0,3,3
70115,4,3,245476,245476,245479,0,3,1
70116,1,3,245477,245479,245482,2,5,0
70117,6,3,245483,245483,245486,0,3,1
70118,2,2,245485,245486,245488,1,3,0
70119,6,2,245491,245491,245493,0,2,3
70120,2,1,245493,245493,245494,0,1,0
70121,5,3,245498,245498,245501,0,3,4
70122,3,2,245501,245501,245503,0,2,0
70123,4,3,245505,245505,245508,0,3,2
70124,6,3,245511,245511,245514,0,3,3
70125,4,2,245515,245515,245517,0,2,1
70126,3,1,245518,245518,245519,0,1,1
70127,1,1,245519,245519,245520,0,1,0
70128,1,2,245520,245520,245522,0,2,0
70129,2,2,245522,245522,245524,0,2,0
70130,5,2,245527,245527,245529,0,2,3
70131,4,1,245531,245531,245532,0,1,2
70132,4,1,245535,245535,245536,0,1,3
70133,5,2,245540,245540,245542,0,2,4
70134,3,2,245543,245543,245545,0,2,1
70135,2,3,245545,245545,245548,0,3,0
70136,6,3,245551,245551,245554,0,3,3
70137,4,2,245555,245555,245557,0,2,1
70138,1,1,245556,245557,245558,1,2,0
70139,5,2,245561,245561,245563,0,2,3
70140,1,2,245562,245563,245565,1,3,0
70141,2,3,245564,245565,245568,1,4,0
70142,4,3,245568,245568,245571,0,3,0
70143,6,1,245574,245574,245575,0,1,3
70144,4,2,245578,245578,245580,0,2,3
70145,3,2,245581,245581,245583,0,2,1
70146,6,2,245587,245587,245589,0,2,4
70147,4,2,245591,245591,245593,0,2,2
70148,6,3,245597,245597,245600,0,3,4
70149,3,2,245600,245600,245602,0,2,0
70150,2,2,245602,245602,245604,0,2,0
70151,3,1,245605,245605,245606,0,1,1
70152,5,3,245610,245610,245613,0,3,4
70153,1,3,245611,245613,245616,2,5,0
70154,6,1,245617,245617,245618,0,1,1
70155,5,3,245622,245622,245625,0,3,4
70156,3,3,245625,245625,245628,0,3,0
70157,2,3,245627,245628,245631,1,4,0
70158,3,3,245630,245631,245634,1,4,0
70159,6,2,245636,245636,245638,0,2,2
70160,6,1,245642,245642,245643,0,1,4
70161,4,2,245646,245646,245648,0,2,3
70162,2,1,245648,245648,245649,0,1,0
70163,2,3,245650,245650,245653,0,3,1
70164,5,3,245655,245655,245658,0,3,2
70165,5,3,245660,245660,245663,0,3,2
70166,6,2,245666,245666,245668,0,2,3
70167,1,3,245667,245668,245671,1,4,0
70168,3,3,245670,245671,245674,1,4,0
70169,5,1,245675,245675,245676,0,1,1
70170,6,1,245681,245681,245682,0,1,5
70171,2,1,245683,245683,245684,0,1,1
70172,4,3,245687,245687,245690,0,3,3
70173,2,3,245689,245690,245693,1,4,0
70174,2,2,245691,245693,245695,2,4,0
70175,5,1,245696,245696,245697,0,1,1
70176,5,3,245701,245701,245704,0,3,4
70177,6,2,245707,245707,245709,0,2,3
70178,6,1,245713,245713,245714,0,1,4
70179,3,2,245716,245716,245718,0,2,2
70180,6,2,245722,245722,245724,0,2,4
70181,3,3,245725,245725,245728,0,3,1
70182,6,2,245731,245731,245733,0,2,3
70183,3,1,245734,245734,245735,0,1,1
70184,6,1,245740,245740,245741,0,1,5
70185,6,1,245746,245746,245747,0,1,5
70186,6,3,245752,245752,245755,0,3,5
70187,3,3,245755,245755,245758,0,3,0
70188,5,2,245760,245760,245762,0,2,2
70189,2,1,245762,245762,245763,0,1,0
70190,6,1,245768,245768,245769,0,1,5
70191,2,2,245770,245770,245772,0,2,1
70192,3,3,245773,245773,245776,0,3,1
70193,2,2,245775,245776,245778,1,3,0
70194,1,2,245776,245778,245780,2,4,0
70195,4,1,245780,245780,245781,0,1,0
70196,5,1,245785,245785,245786,0,1,4
70197,3,3,245788,245788,245791,0,3,2
70198,6,3,245794,245794,245797,0,3,3
70199,4,3,245798,245798,245801,0,3,1
70200,3,1,245801,245801,245802,0,1,0
70201,4,1,245805,245805,245806,0,1,3
70202,3,1,245808,245808,245809,0,1,2
70203,5,1,245813,245813,245814,0,1,4
70204,6,3,245819,245819,245822,0,3,5
70205,1,1,245820,245822,245823,2,3,0
70206,3,1,245823,245823,245824,0,1,0
70207,1,3,245824,245824,245827,0,3,0
70208,1,2,245825,245827,245829,2,4,0
70209,5,3,245830,245830,245833,0,3,1
70210,5,2,245835,245835,245837,0,2,2
70211,2,1,245837,245837,245838,0,1,0
70212,4,3,245841,245841,245844,0,3,3
70213,2,3,245843,245844,245847,1,4,0
70214,4,2,245847,245847,245849,0,2,0
70215,4,3,245851,245851,245854,0,3,2
70216,4,2,245855,245855,245857,0,2,1
70217,1,3,245856,245857,245860,1,4,0
70218,6,1,245862,245862,245863,0,1,2
70219,4,1,245866,245866,245867,0,1,3
70220,2,2,245868,245868,245870,0,2,1
70221,1,1,245869,245870,245871,1,2,0
70222,2,1,245871,245871,245872,0,1,0
70223,4,3,245875,245875,245878,0,3,3
70224,5,2,245880,245880,245882,0,2,2
70225,4,3,245884,245884,245887,0,3,2
70226,4,2,245888,245888,245890,0,2,1
70227,1,1,245889,245890,245891,1,2,0
70228,4,1,245893,245893,245894,0,1,2
70229,1,3,245894,245894,245897,0,3,0
70230,6,3,245900,245900,245903,0,3,3
70231,6,2,245906,245906,245908,0,2,3
70232,1,1,245907,245908,245909,1,2,0
70233,2,3,245909,245909,245912,0,3,0
70234,4,2,245913,245913,245915,0,2,1
70235,6,2,245919,245919,245921,0,2,4
70236,3,2,245922,245922,245924,0,2,1
70237,4,3,245926,245926,245929,0,3,2
70238,5,1,245931,245931,245932,0,1,2
70239,6,1,245937,245937,245938,0,1,5
70240,4,3,245941,245941,245944,0,3,3
70241,1,3,245942,245944,245947,2,5,0
70242,4,1,245946,245947,245948,1,2,0
70243,4,2,245950,245950,245952,0,2,2
70244,5,3,245955,245955,245958,0,3,3
70245,1,1,245956,245958,245959,2,3,0
70246,2,2,245958,245959,245961,1,3,0
70247,1,1,245959,245961,245962,2,3,0
70248,4,2,245963,245963,245965,0,2,1
70249,5,2,245968,245968,245970,0,2,3
70250,2,1,245970,245970,245971,0,1,0
70251,6,1,245976,245976,245977,0,1,5
70252,4,1,245980,245980,245981,0,1,3
70253,1,3,245981,245981,245984,0,3,0
70254,2,1,245983,245984,245985,1,2,0
70255,5,1,245988,245988,245989,0,1,3
70256,6,1,245994,245994,245995,0,1,5
70257,3,1,245997,245997,245998,0,1,2
70258,2,2,245999,245999,246001,0,2,1
70259,1,3,246000,246001,246004,1,4,0
70260,1,3,246001,246004,246007,3,6,0
70261,6,3,246007,246007,246010,0,3,0
70262,6,3,246013,246013,246016,0,3,3
70263,2,2,246015,246016,246018,1,3,0
70264,3,2,246018,246018,246020,0,2,0
70265,4,2,246022,246022,246024,0,2,2
70266,5,1,246027,246027,246028,0,1,3
70267,5,2,246032,246032,246034,0,2,4
70268,6,3,246038,246038,246041,0,3,4
70269,1,1,246039,246041,246042,2,3,0
70270,5,2,246044,246044,246046,0,2,2
70271,4,3,246048,246048,246051,0,3,2
70272,5,1,246053,246053,246054,0,1,2
70273,4,1,246057,246057,246058,0,1,3
70274,1,2,246058,246058,246060,0,2,0
70275,5,2,246063,246063,246065,0,2,3
70276,1,1,246064,246065,246066,1,2,0
70277,4,1,246068,246068,246069,0,1,2
70278,5,2,246073,246073,246075,0,2,4
70279,6,2,246079,246079,246081,0,2,4
70280,1,3,246080,246081,246084,1,4,0
70281,4,3,246084,246084,246087,0,3,0
70282,4,1,246088,246088,246089,0,1,1
70283,5,1,246093,246093,246094,0,1,4
70284,3,1,246096,246096,246097,0,1,2
70285,3,3,246099,246099,246102,0,3,2
70286,6,1,246105,246105,246106,0,1,3
70287,4,1,246109,246109,246110,0,1,3
70288,5,1,246114,246114,246115,0,1,4
70289,5,3,246119,246119,246122,0,3,4
70290,6,1,246125,246125,246126,0,1,3
70291,4,3,246129,246129,246132,0,3,3
70292,5,1,246134,246134,246135,0,1,2
70293,5,3,246139,246139,246142,0,3,4
70294,6,3,246145,246145,246148,0,3,3
70295,1,1,246146,246148,246149,2,3,0
70296,2,3,246148,246149,246152,1,4,0
70297,6,1,246154,246154,246155,0,1,2
70298,4,3,246158,246158,246161,0,3,3
70299,2,1,246160,246161,246162,1,2,0
70300,2,3,246162,246162,246165,0,3,0
70301,3,1,246165,246165,246166,0,1,0
70302,3,3,246168,246168,246171,0,3,2
70303,6,3,246174,246174,246177,0,3,3
70304,2,3,246176,246177,246180,1,4,0
70305,6,2,246182,246182,246184,0,2,2
70306,5,2,246187,246187,246189,0,2,3
70307,2,1,246189,246189,246190,0,1,0
70308,2,2,246191,246191,246193,0,2,1
70309,1,1,246192,246193,246194,1,2,0
70310,5,1,246197,246197,246198,0,1,3
70311,6,3,246203,246203,246206,0,3,5
70312,3,2,246206,246206,246208,0,2,0
70313,3,1,246209,246209,246210,0,1,1
70314,3,1,246212,246212,246213,0,1,2
70315,3,3,246215,246215,246218,0,3,2
70316,3,1,246218,246218,246219,0,1,0
70317,1,2,246219,246219,246221,0,2,0
70318,3,3,246222,246222,246225,0,3,1
70319,1,1,246223,246225,246226,2,3,0
70320,6,2,246229,246229,246231,0,2,3
70321,3,1,246232,246232,246233,0,1,1
70322,4,2,246236,246236,246238,0,2,3
70323,1,2,246237,246238,246240,1,3,0
70324,2,2,246239,246240,246242,1,3,0
70325,5,2,246244,246244,246246,0,2,2
70326,2,1,246246,246246,246247,0,1,0
70327,4,2,246250,246250,246252,0,2,3
70328,6,2,246256,246256,246258,0,2,4
70329,4,1,246260,246260,246261,0,1,2
70330,5,1,246265,246265,246266,0,1,4
70331,4,1,246269,246269,246270,0,1,3
70332,6,2,246275,246275,246277,0,2,5
70333,5,3,246280,246280,246283,0,3,3
70334,2,2,246282,246283,246285,1,3,0
70335,5,3,246287,246287,246290,0,3,2
70336,6,2,246293,246293,246295,0,2,3
70337,2,3,246295,246295,246298,0,3,0
70338,1,3,246296,246298,246301,2,5,0
70339,4,3,246300,246301,246304,1,4,0
70340,5,2,246305,246305,246307,0,2,1
70341,5,3,246310,246310,246313,0,3,3
70342,3,3,246313,246313,246316,0,3,0
70343,6,3,246319,246319,246322,0,3,3
70344,5,3,246324,246324,246327,0,3,2
70345,1,2,246325,246327,246329,2,4,0
70346,6,3,246331,246331,246334,0,3,2
70347,2,3,246333,246334,246337,1,4,0
70348,4,2,246337,246337,246339,0,2,0
70349,1,3,246338,246339,246342,1,4,0
70350,2,1,246340,246342,246343,2,3,0
70351,1,3,246341,246343,246346,2,5,0
70352,3,1,246344,246346,246347,2,3,0
70353,3,2,246347,246347,246349,0,2,0
70354,2,3,246349,246349,246352,0,3,0
70355,2,3,246351,246352,246355,1,4,0
70356,2,3,246353,246355,246358,2,5,0
70357,1,3,246354,246358,246361,4,7,0
70358,4,1,246358,246361,246362,3,4,0
70359,3,2,246361,246362,246364,1,3,0
70360,1,1,246362,246364,246365,2,3,0
70361,1,2,246363,246365,246367,2,4,0
70362,6,1,246369,246369,246370,0,1,2
70363,1,2,246370,246370,246372,0,2,0
70364,2,3,246372,246372,246375,0,3,0
70365,6,2,246378,246378,246380,0,2,3
70366,4,1,246382,246382,246383,0,1,2
70367,2,2,246384,246384,246386,0,2,1
70368,1,1,246385,246386,246387,1,2,0
70369,2,1,246387,246387,246388,0,1,0
70370,2,2,246389,246389,246391,0,2,1
70371,1,2,246390,246391,246393,1,3,0
70372,4,1,246394,246394,246395,0,1,1
70373,2,1,246396,246396,246397,0,1,1
70374,1,1,246397,246397,246398,0,1,0
70375,4,1,246401,246401,246402,0,1,3
70376,4,2,246405,246405,246407,0,2,3
70377,4,1,246409,246409,246410,0,1,2
70378,1,1,246410,246410,246411,0,1,0
70379,6,2,246416,246416,246418,0,2,5
70380,1,3,246417,246418,246421,1,4,0
70381,6,1,246423,246423,246424,0,1,2
70382,1,1,246424,246424,246425,0,1,0
70383,1,3,246425,246425,246428,0,3,0
70384,6,1,246431,246431,246432,0,1,3
70385,5,3,246436,246436,246439,0,3,4
70386,4,1,246440,246440,246441,0,1,1
70387,6,2,246446,246446,246448,0,2,5
70388,2,1,246448,246448,246449,0,1,0
70389,1,1,246449,246449,246450,0,1,0
70390,3,1,246452,246452,246453,0,1,2
70391,4,3,246456,246456,246459,0,3,3
70392,4,2,246460,246460,246462,0,2,1
70393,3,3,246463,246463,246466,0,3,1
70394,1,2,246464,246466,246468,2,4,0
70395,5,1,246469,246469,246470,0,1,1
70396,6,3,246475,246475,246478,0,3,5
70397,2,2,246477,246478,246480,1,3,0
70398,5,3,246482,246482,246485,0,3,2
70399,3,2,246485,246485,246487,0,2,0
70400,4,3,246489,246489,246492,0,3,2
70401,4,3,246493,246493,246496,0,3,1
70402,3,3,246496,246496,246499,0,3,0
70403,6,2,246502,246502,246504,0,2,3
70404,6,1,246508,246508,246509,0,1,4
70405,5,2,246513,246513,246515,0,2,4
70406,5,3,246518,246518,246521,0,3,3
70407,4,1,246522,246522,246523,0,1,1
70408,4,1,246526,246526,246527,0,1,3
70409,5,2,246531,246531,246533,0,2,4
70410,5,1,246536,246536,246537,0,1,3
70411,6,2,246542,246542,246544,0,2,5
70412,5,1,246547,246547,246548,0,1,3
70413,1,1,246548,246548,246549,0,1,0
70414,3,2,246551,246551,246553,0,2,2
70415,5,2,246556,246556,246558,0,2,3
70416,2,2,246558,246558,246560,0,2,0
70417,6,3,246564,246564,246567,0,3,4
70418,5,2,246569,246569,246571,0,2,2
70419,6,1,246575,246575,246576,0,1,4
70420,2,2,246577,246577,246579,0,2,1
70421,2,2,246579,246579,246581,0,2,0
70422,3,3,246582,246582,246585,0,3,1
70423,3,2,246585,246585,246587,0,2,0
70424,2,1,246587,246587,246588,0,1,0
70425,2,1,246589,246589,246590,0,1,1
70426,4,3,246593,246593,246596,0,3,3
70427,5,3,246598,246598,246601,0,3,2
70428,1,2,246599,246601,246603,2,4,0
70429,2,3,246601,246603,246606,2,5,0
70430,2,1,246603,246606,246607,3,4,0
70431,3,2,246606,246607,246609,1,3,0
70432,1,3,246607,246609,246612,2,5,0
70433,2,1,246609,246612,246613,3,4,0
70434,3,3,246612,246613,246616,1,4,0
70435,2,1,246614,246616,246617,2,3,0
70436,5,1,246619,246619,246620,0,1,2
70437,1,2,246620,246620,246622,0,2,0
70438,6,1,246626,246626,246627,0,1,4
70439,5,1,246631,246631,246632,0,1,4
70440,5,1,246636,246636,246637,0,1,4
70441,2,2,246638,246638,246640,0,2,1
70442,2,3,246640,246640,246643,0,3,0
70443,4,2,246644,246644,246646,0,2,1
70444,5,2,246649,246649,246651,0,2,3
70445,1,3,246650,246651,246654,1,4,0
70446,2,2,246652,246654,246656,2,4,0
70447,1,1,246653,246656,246657,3,4,0
70448,1,2,246654,246657,246659,3,5,0
70449,6,2,246660,246660,246662,0,2,1
70450,4,3,246664,246664,246667,0,3,2
70451,2,2,246666,246667,246669,1,3,0
70452,2,1,246668,246669,246670,1,2,0
70453,3,1,246671,246671,246672,0,1,1
70454,6,3,246677,246677,246680,0,3,5
70455,2,1,246679,246680,246681,1,2,0
70456,6,1,246685,246685,246686,0,1,4
70457,6,2,246691,246691,246693,0,2,5
70458,4,2,246695,246695,246697,0,2,2
70459,5,3,246700,246700,246703,0,3,3
70460,3,1,246703,246703,246704,0,1,0
70461,4,3,246707,246707,246710,0,3,3
70462,6,1,246713,246713,246714,0,1,3
70463,2,1,246715,246715,246716,0,1,1
70464,1,3,246716,246716,246719,0,3,0
70465,6,3,246722,246722,246725,0,3,3
70466,1,1,246723,246725,246726,2,3,0
70467,4,1,246727,246727,246728,0,1,1
70468,5,2,246732,246732,246734,0,2,4
70469,4,3,246736,246736,246739,0,3,2
70470,4,1,246740,246740,246741,0,1,1
70471,3,2,246743,246743,246745,0,2,2
70472,5,3,246748,246748,246751,0,3,3
70473,6,1,246754,246754,246755,0,1,3
70474,5,3,246759,246759,246762,0,3,4
70475,4,3,246763,246763,246766,0,3,1
70476,6,1,246769,246769,246770,0,1,3
70477,5,1,246774,246774,246775,0,1,4
70478,2,2,246776,246776,246778,0,2,1
70479,6,3,246782,246782,246785,0,3,4
70480,6,2,246788,246788,246790,0,2,3
70481,2,3,246790,246790,246793,0,3,0
70482,6,1,246796,246796,246797,0,1,3
70483,3,3,246799,246799,246802,0,3,2
70484,5,1,246804,246804,246805,0,1,2
70485,2,1,246806,246806,246807,0,1,1
70486,4,3,246810,246810,246813,0,3,3
70487,6,3,246816,246816,246819,0,3,3
70488,6,2,246822,246822,246824,0,2,3
70489,3,3,246825,246825,246828,0,3,1
70490,2,1,246827,246828,246829,1,2,0
70491,2,1,246829,246829,246830,0,1,0
70492,5,3,246834,246834,246837,0,3,4
70493,3,3,246837,246837,246840,0,3,0
70494,6,2,246843,246843,246845,0,2,3
70495,6,2,246849,246849,246851,0,2,4
70496,5,3,246854,246854,246857,0,3,3
70497,4,3,246858,246858,246861,0,3,1
70498,3,1,246861,246861,246862,0,1,0
70499,5,3,246866,246866,246869,0,3,4
70500,6,2,246872,246872,246874,0,2,3
70501,6,3,246878,246878,246881,0,3,4
70502,3,3,246881,246881,246884,0,3,0
70503,1,1,246882,246884,246885,2,3,0
70504,3,3,246885,246885,246888,0,3,0
70505,1,2,246886,246888,246890,2,4,0
70506,1,1,246887,246890,246891,3,4,0
70507,3,3,246890,246891,246894,1,4,0
70508,6,3,246896,246896,246899,0,3,2
70509,2,1,246898,246899,246900,1,2,0
70510,3,2,246901,246901,246903,0,2,1
70511,4,3,246905,246905,246908,0,3,2
70512,5,2,246910,246910,246912,0,2,2
70513,5,1,246915,246915,246916,0,1,3
70514,1,2,246916,246916,246918,0,2,0
70515,1,2,246917,246918,246920,1,3,0
70516,1,2,246918,246920,246922,2,4,0
70517,2,1,246920,246922,246923,2,3,0
70518,1,3,246921,246923,246926,2,5,0
70519,5,1,246926,246926,246927,0,1,0
70520,2,2,246928,246928,246930,0,2,1
70521,6,3,246934,246934,246937,0,3,4
70522,3,2,246937,246937,246939,0,2,0
70523,2,1,246939,246939,246940,0,1,0
70524,5,3,246944,246944,246947,0,3,4
70525,6,3,246950,246950,246953,0,3,3
70526,5,2,246955,246955,246957,0,2,2
70527,6,3,246961,246961,246964,0,3,4
70528,6,2,246967,246967,246969,0,2,3
70529,4,1,246971,246971,246972,0,1,2
70530,2,1,246973,246973,246974,0,1,1
70531,4,2,246977,246977,246979,0,2,3
70532,4,1,246981,246981,246982,0,1,2
70533,3,3,246984,246984,246987,0,3,2
70534,5,3,246989,246989,246992,0,3,2
70535,1,3,246990,246992,246995,2,5,0
70536,6,1,246996,246996,246997,0,1,1
70537,4,3,247000,247000,247003,0,3,3
70538,1,3,247001,247003,247006,2,5,0
70539,6,3,247007,247007,247010,0,3,1
70540,1,1,247008,247010,247011,2,3,0
70541,4,3,247012,247012,247015,0,3,1
70542,6,1,247018,247018,247019,0,1,3
70543,6,2,247024,247024,247026,0,2,5
70544,4,3,247028,247028,247031,0,3,2
70545,4,2,247032,247032,247034,0,2,1
70546,1,2,247033,247034,247036,1,3,0
70547,6,1,247039,247039,247040,0,1,3
70548,4,3,247043,247043,247046,0,3,3
70549,5,1,247048,247048,247049,0,1,2
70550,5,3,247053,247053,247056,0,3,4
70551,2,2,247055,247056,247058,1,3,0
70552,1,1,247056,247058,247059,2,3,0
70553,6,3,247062,247062,247065,0,3,3
70554,6,3,247068,247068,247071,0,3,3
70555,6,3,247074,247074,247077,0,3,3
70556,1,1,247075,247077,247078,2,3,0
70557,1,3,247076,247078,247081,2,5,0
70558,2,2,247078,247081,247083,3,5,0
70559,1,1,247079,247083,247084,4,5,0
70560,2,2,247081,247084,247086,3,5,0
70561,4,2,247085,247086,247088,1,3,0
70562,3,2,247088,247088,247090,0,2,0
70563,5,2,247093,247093,247095,0,2,3
70564,2,3,247095,247095,247098,0,3,0
70565,3,3,247098,247098,247101,0,3,0
70566,6,2,247104,247104,247106,0,2,3
70567,6,2,247110,247110,247112,0,2,4
70568,2,2,247112,247112,247114,0,2,0
70569,5,2,247117,247117,247119,0,2,3
70570,5,3,247122,247122,247125,0,3,3
70571,6,3,247128,247128,247131,0,3,3
70572,6,3,247134,247134,247137,0,3,3
70573,5,2,247139,247139,247141,0,2,2
70574,2,2,247141,247141,247143,0,2,0
70575,4,3,247145,247145,247148,0,3,2
70576,6,1,247151,247151,247152,0,1,3
70577,6,2,247157,247157,247159,0,2,5
70578,6,2,247163,247163,247165,0,2,4
70579,2,3,247165,247165,247168,0,3,0
70580,5,2,247170,247170,247172,0,2,2
70581,1,3,247171,247172,247175,1,4,0
70582,3,3,247174,247175,247178,1,4,0
70583,4,1,247178,247178,247179,0,1,0
70584,1,2,247179,247179,247181,0,2,0
70585,5,2,247184,247184,247186,0,2,3
70586,6,2,247190,247190,247192,0,2,4
70587,3,2,247193,247193,247195,0,2,1
70588,3,3,247196,247196,247199,0,3,1
70589,2,3,247198,247199,247202,1,4,0
70590,3,2,247201,247202,247204,1,3,0
70591,5,1,247206,247206,247207,0,1,2
70592,3,3,247209,247209,247212,0,3,2
70593,6,1,247215,247215,247216,0,1,3
70594,6,2,247221,247221,247223,0,2,5
70595,5,3,247226,247226,247229,0,3,3
70596,1,2,247227,247229,247231,2,4,0
70597,5,2,247232,247232,247234,0,2,1
70598,2,3,247234,247234,247237,0,3,0
70599,5,3,247239,247239,247242,0,3,2
70600,5,2,247244,247244,247246,0,2,2
70601,4,3,247248,247248,247251,0,3,2
70602,6,2,247254,247254,247256,0,2,3
70603,5,3,247259,247259,247262,0,3,3
70604,6,3,247265,247265,247268,0,3,3
70605,3,2,247268,247268,247270,0,2,0
70606,6,3,247274,247274,247277,0,3,4
70607,5,1,247279,247279,247280,0,1,2
70608,1,1,247280,247280,247281,0,1,0
70609,2,3,247282,247282,247285,0,3,1
70610,1,2,247283,247285,247287,2,4,0
70611,5,1,247288,247288,247289,0,1,1
70612,4,3,247292,247292,247295,0,3,3
70613,2,3,247294,247295,247298,1,4,0
70614,1,2,247295,247298,247300,3,5,0
70615,2,1,247297,247300,247301,3,4,0
70616,1,2,247298,247301,247303,3,5,0
70617,1,2,247299,247303,247305,4,6,0
70618,3,1,247302,247305,247306,3,4,0
70619,4,3,247306,247306,247309,0,3,0
70620,4,1,247310,247310,247311,0,1,1
70621,3,2,247313,247313,247315,0,2,2
70622,1,1,247314,247315,247316,1,2,0
70623,3,1,247317,247317,247318,0,1,1
70624,2,1,247319,247319,247320,0,1,1
70625,1,3,247320,247320,247323,0,3,0
70626,4,1,247324,247324,247325,0,1,1
70627,4,3,247328,247328,247331,0,3,3
70628,3,3,247331,247331,247334,0,3,0
70629,4,1,247335,247335,247336,0,1,1
70630,6,3,247341,247341,247344,0,3,5
70631,6,2,247347,247347,247349,0,2,3
70632,4,3,247351,247351,247354,0,3,2
70633,5,2,247356,247356,247358,0,2,2
70634,5,1,247361,247361,247362,0,1,3
70635,4,2,247365,247365,247367,0,2,3
70636,1,1,247366,247367,247368,1,2,0
70637,4,2,247370,247370,247372,0,2,2
70638,1,3,247371,247372,247375,1,4,0
70639,2,2,247373,247375,247377,2,4,0
70640,5,2,247378,247378,247380,0,2,1
70641,5,3,247383,247383,247386,0,3,3
70642,3,1,247386,247386,247387,0,1,0
70643,5,3,247391,247391,247394,0,3,4
70644,2,2,247393,247394,247396,1,3,0
70645,2,1,247395,247396,247397,1,2,0
70646,4,2,247399,247399,247401,0,2,2
70647,4,1,247403,247403,247404,0,1,2
70648,5,1,247408,247408,247409,0,1,4
70649,2,2,247410,247410,247412,0,2,1
70650,4,2,247414,247414,247416,0,2,2
70651,4,3,247418,247418,247421,0,3,2
70652,3,2,247421,247421,247423,0,2,0
70653,3,2,247424,247424,247426,0,2,1
70654,5,1,247429,247429,247430,0,1,3
70655,2,2,247431,247431,247433,0,2,1
70656,3,2,247434,247434,247436,0,2,1
70657,6,2,247440,247440,247442,0,2,4
70658,2,3,247442,247442,247445,0,3,0
70659,1,2,247443,247445,247447,2,4,0
70660,3,1,247446,247447,247448,1,2,0
70661,4,3,247450,247450,247453,0,3,2
70662,6,3,247456,247456,247459,0,3,3
70663,3,1,247459,247459,247460,0,1,0
70664,6,2,247465,247465,247467,0,2,5
70665,3,3,247468,247468,247471,0,3,1
70666,4,3,247472,247472,247475,0,3,1
70667,6,3,247478,247478,247481,0,3,3
70668,4,3,247482,247482,247485,0,3,1
70669,3,1,247485,247485,247486,0,1,0
70670,1,3,247486,247486,247489,0,3,0
70671,1,3,247487,247489,247492,2,5,0
70672,5,1,247492,247492,247493,0,1,0
70673,2,3,247494,247494,247497,0,3,1
70674,6,3,247500,247500,247503,0,3,3
70675,3,2,247503,247503,247505,0,2,0
70676,6,3,247509,247509,247512,0,3,4
70677,5,3,247514,247514,247517,0,3,2
70678,6,2,247520,247520,247522,0,2,3
70679,2,2,247522,247522,247524,0,2,0
70680,5,1,247527,247527,247528,0,1,3
70681,2,3,247529,247529,247532,0,3,1
70682,3,2,247532,247532,247534,0,2,0
70683,1,2,247533,247534,247536,1,3,0
70684,1,2,247534,247536,247538,2,4,0
70685,3,1,247537,247538,247539,1,2,0
70686,4,2,247541,247541,247543,0,2,2
70687,3,3,247544,247544,247547,0,3,1
70688,3,1,247547,247547,247548,0,1,0
70689,5,2,247552,247552,247554,0,2,4
70690,1,2,247553,247554,247556,1,3,0
70691,3,3,247556,247556,247559,0,3,0
70692,4,1,247560,247560,247561,0,1,1
70693,1,3,247561,247561,247564,0,3,0
70694,4,3,247565,247565,247568,0,3,1
70695,1,2,247566,247568,247570,2,4,0
70696,3,3,247569,247570,247573,1,4,0
70697,2,2,247571,247573,247575,2,4,0
70698,4,3,247575,247575,247578,0,3,0
70699,2,3,247577,247578,247581,1,4,0
70700,1,3,247578,247581,247584,3,6,0
70701,5,1,247583,247584,247585,1,2,0
70702,2,1,247585,247585,247586,0,1,0
70703,4,1,247589,247589,247590,0,1,3
70704,6,2,247595,247595,247597,0,2,5
70705,4,2,247599,247599,247601,0,2,2
70706,5,2,247604,247604,247606,0,2,3
70707,1,3,247605,247606,247609,1,4,0
70708,3,3,247608,247609,247612,1,4,0
70709,5,1,247613,247613,247614,0,1,1
70710,3,2,247616,247616,247618,0,2,2
70711,3,2,247619,247619,247621,0,2,1
70712,6,2,247625,247625,247627,0,2,4
70713,5,1,247630,247630,247631,0,1,3
70714,5,1,247635,247635,247636,0,1,4
70715,5,2,247640,247640,247642,0,2,4
70716,1,3,247641,247642,247645,1,4,0
70717,4,2,247645,247645,247647,0,2,0
70718,2,3,247647,247647,247650,0,3,0
70719,1,3,247648,247650,247653,2,5,0
70720,4,1,247652,247653,247654,1,2,0
70721,4,3,247656,247656,247659,0,3,2
70722,4,3,247660,247660,247663,0,3,1
70723,4,3,247664,247664,247667,0,3,1
70724,2,2,247666,247667,247669,1,3,0
70725,2,1,247668,247669,247670,1,2,0
70726,3,3,247671,247671,247674,0,3,1
70727,1,3,247672,247674,247677,2,5,0
70728,4,1,247676,247677,247678,1,2,0
70729,6,2,247682,247682,247684,0,2,4
70730,5,3,247687,247687,247690,0,3,3
70731,2,2,247689,247690,247692,1,3,0
70732,5,1,247694,247694,247695,0,1,2
70733,1,2,247695,247695,247697,0,2,0
70734,5,3,247700,247700,247703,0,3,3
70735,1,1,247701,247703,247704,2,3,0
70736,4,2,247705,247705,247707,0,2,1
70737,5,1,247710,247710,247711,0,1,3
70738,1,1,247711,247711,247712,0,1,0
70739,2,1,247713,247713,247714,0,1,1
70740,5,2,247718,247718,247720,0,2,4
70741,1,1,247719,247720,247721,1,2,0
70742,6,2,247725,247725,247727,0,2,4
70743,4,2,247729,247729,247731,0,2,2
70744,5,3,247734,247734,247737,0,3,3
70745,4,3,247738,247738,247741,0,3,1
70746,2,2,247740,247741,247743,1,3,0
70747,1,1,247741,247743,247744,2,3,0
70748,2,1,247743,247744,247745,1,2,0
70749,3,2,247746,247746,247748,0,2,1
70750,4,3,247750,247750,247753,0,3,2
70751,3,1,247753,247753,247754,0,1,0
70752,3,2,247756,247756,247758,0,2,2
70753,4,3,247760,247760,247763,0,3,2
70754,1,2,247761,247763,247765,2,4,0
70755,5,1,247766,247766,247767,0,1,1
70756,2,1,247768,247768,247769,0,1,1
70757,4,2,247772,247772,247774,0,2,3
70758,6,1,247778,247778,247779,0,1,4
70759,6,2,247784,247784,247786,0,2,5
70760,1,1,247785,247786,247787,1,2,0
70761,4,1,247789,247789,247790,0,1,2
70762,1,2,247790,247790,247792,0,2,0
70763,1,1,247791,247792,247793,1,2,0
70764,4,2,247795,247795,247797,0,2,2
70765,2,2,247797,247797,247799,0,2,0
70766,2,1,247799,247799,247800,0,1,0
70767,6,2,247805,247805,247807,0,2,5
70768,3,2,247808,247808,247810,0,2,1
70769,1,3,247809,247810,247813,1,4,0
70770,6,3,247815,247815,247818,0,3,2
70771,3,2,247818,247818,247820,0,2,0
70772,5,3,247823,247823,247826,0,3,3
70773,1,1,247824,247826,247827,2,3,0
70774,4,3,247828,247828,247831,0,3,1
70775,4,3,247832,247832,247835,0,3,1
70776,2,1,247834,247835,247836,1,2,0
70777,2,1,247836,247836,247837,0,1,0
70778,5,1,247841,247841,247842,0,1,4
70779,5,2,247846,247846,247848,0,2,4
70780,4,1,247850,247850,247851,0,1,2
70781,5,2,247855,247855,247857,0,2,4
70782,1,3,247856,247857,247860,1,4,0
70783,4,1,247860,247860,247861,0,1,0
70784,5,3,247865,247865,247868,0,3,4
70785,2,3,247867,247868,247871,1,4,0
70786,1,3,247868,247871,247874,3,6,0
70787,1,2,247869,247874,247876,5,7,0
70788,1,3,247870,247876,247879,6,9,0
70789,3,2,247873,247879,247881,6,8,0
70790,2,2,247875,247881,247883,6,8,0
70791,1,2,247876,247883,247885,7,9,0
70792,1,3,247877,247885,247888,8,11,0
70793,2,3,247879,247888,247891,9,12,0
70794,2,1,247881,247891,247892,10,11,0
70795,6,3,247887,247892,247895,5,8,0
70796,4,2,247891,247895,247897,4,6,0
70797,2,1,247893,247897,247898,4,5,0
70798,5,1,247898,247898,247899,0,1,0
70799,4,3,247902,247902,247905,0,3,3
70800,4,2,247906,247906,247908,0,2,1
70801,2,2,247908,247908,247910,0,2,0
70802,5,2,247913,247913,247915,0,2,3
70803,3,3,247916,247916,247919,0,3,1
70804,5,3,247921,247921,247924,0,3,2
70805,4,2,247925,247925,247927,0,2,1
70806,4,2,247929,247929,247931,0,2,2
70807,1,2,247930,247931,247933,1,3,0
70808,1,2,247931,247933,247935,2,4,0
70809,4,2,247935,247935,247937,0,2,0
70810,1,1,247936,247937,247938,1,2,0
70811,5,2,247941,247941,247943,0,2,3
70812,3,2,247944,247944,247946,0,2,1
70813,5,1,247949,247949,247950,0,1,3
70814,1,2,247950,247950,247952,0,2,0
70815,3,2,247953,247953,247955,0,2,1
70816,5,1,247958,247958,247959,0,1,3
70817,6,3,247964,247964,247967,0,3,5
70818,6,2,247970,247970,247972,0,2,3
70819,1,2,247971,247972,247974,1,3,0
70820,2,1,247973,247974,247975,1,2,0
70821,2,1,247975,247975,247976,0,1,0
70822,1,2,247976,247976,247978,0,2,0
70823,1,3,247977,247978,247981,1,4,0
70824,6,2,247983,247983,247985,0,2,2
70825,4,3,247987,247987,247990,0,3,2
70826,4,2,247991,247991,247993,0,2,1
70827,1,1,247992,247993,247994,1,2,0
70828,4,2,247996,247996,247998,0,2,2
70829,1,1,247997,247998,247999,1,2,0
70830,3,2,248000,248000,248002,0,2,1
70831,4,1,248004,248004,248005,0,1,2
70832,3,1,248007,248007,248008,0,1,2
70833,3,1,248010,248010,248011,0,1,2
70834,5,2,248015,248015,248017,0,2,4
70835,3,2,248018,248018,248020,0,2,1
70836,3,3,248021,248021,248024,0,3,1
70837,6,3,248027,248027,248030,0,3,3
70838,5,1,248032,248032,248033,0,1,2
70839,6,3,248038,248038,248041,0,3,5
70840,4,2,248042,248042,248044,0,2,1
70841,1,1,248043,248044,248045,1,2,0
70842,1,3,248044,248045,248048,1,4,0
70843,4,3,248048,248048,248051,0,3,0
70844,4,2,248052,248052,248054,0,2,1
70845,4,1,248056,248056,248057,0,1,2
70846,6,2,248062,248062,248064,0,2,5
70847,6,2,248068,248068,248070,0,2,4
70848,2,2,248070,248070,248072,0,2,0
70849,5,3,248075,248075,248078,0,3,3
70850,4,3,248079,248079,248082,0,3,1
70851,4,2,248083,248083,248085,0,2,1
70852,2,2,248085,248085,248087,0,2,0
70853,5,1,248090,248090,248091,0,1,3
70854,2,2,248092,248092,248094,0,2,1
70855,3,1,248095,248095,248096,0,1,1
70856,5,3,248100,248100,248103,0,3,4
70857,5,3,248105,248105,248108,0,3,2
70858,6,1,248111,248111,248112,0,1,3
70859,5,1,248116,248116,248117,0,1,4
70860,5,2,248121,248121,248123,0,2,4
70861,2,3,248123,248123,248126,0,3,0
70862,1,3,248124,248126,248129,2,5,0
70863,2,1,248126,248129,248130,3,4,0
70864,3,1,248129,248130,248131,1,2,0
70865,4,1,248133,248133,248134,0,1,2
70866,3,3,248136,248136,248139,0,3,2
70867,5,2,248141,248141,248143,0,2,2
70868,3,3,248144,248144,248147,0,3,1
70869,1,3,248145,248147,248150,2,5,0
70870,3,2,248148,248150,248152,2,4,0
70871,2,1,248150,248152,248153,2,3,0
70872,5,3,248155,248155,248158,0,3,2
70873,6,1,248161,248161,248162,0,1,3
70874,2,2,248163,248163,248165,0,2,1
70875,4,3,248167,248167,248170,0,3,2
70876,5,3,248172,248172,248175,0,3,2
70877,1,3,248173,248175,248178,2,5,0
70878,1,3,248174,248178,248181,4,7,0
70879,5,1,248179,248181,248182,2,3,0
70880,2,2,248181,248182,248184,1,3,0
70881,3,1,248184,248184,248185,0,1,0
70882,4,1,248188,248188,248189,0,1,3
70883,5,3,248193,248193,248196,0,3,4
70884,4,3,248197,248197,248200,0,3,1
70885,3,3,248200,248200,248203,0,3,0
70886,3,3,248203,248203,248206,0,3,0
70887,2,3,248205,248206,248209,1,4,0
70888,1,3,248206,248209,248212,3,6,0
70889,5,3,248211,248212,248215,1,4,0
70890,3,2,248214,248215,248217,1,3,0
70891,3,2,248217,248217,248219,0,2,0
70892,3,1,248220,248220,248221,0,1,1
70893,6,2,248226,248226,248228,0,2,5
70894,3,1,248229,248229,248230,0,1,1
70895,4,1,248233,248233,248234,0,1,3
70896,5,1,248238,248238,248239,0,1,4
70897,1,3,248239,248239,248242,0,3,0
70898,4,3,248243,248243,248246,0,3,1
70899,5,3,248248,248248,248251,0,3,2
70900,2,2,248250,248251,248253,1,3,0
70901,1,3,248251,248253,248256,2,5,0
70902,3,2,248254,248256,248258,2,4,0
70903,3,2,248257,248258,248260,1,3,0
70904,3,2,248260,248260,248262,0,2,0
70905,4,3,248264,248264,248267,0,3,2
70906,1,3,248265,248267,248270,2,5,0
70907,2,2,248267,248270,248272,3,5,0
70908,2,2,248269,248272,248274,3,5,0
70909,6,3,248275,248275,248278,0,3,1
70910,2,1,248277,248278,248279,1,2,0
70911,3,3,248280,248280,248283,0,3,1
70912,5,3,248285,248285,248288,0,3,2
70913,3,2,248288,248288,248290,0,2,0
70914,3,3,248291,248291,248294,0,3,1
70915,5,2,248296,248296,248298,0,2,2
70916,3,3,248299,248299,248302,0,3,1
70917,6,2,248305,248305,248307,0,2,3
70918,4,3,248309,248309,248312,0,3,2
70919,1,3,248310,248312,248315,2,5,0
70920,2,2,248312,248315,248317,3,5,0
70921,5,1,248317,248317,248318,0,1,0
70922,5,1,248322,248322,248323,0,1,4
70923,2,3,248324,248324,248327,0,3,1
70924,4,3,248328,248328,248331,0,3,1
70925,5,1,248333,248333,248334,0,1,2
70926,1,2,248334,248334,248336,0,2,0
70927,5,2,248339,248339,248341,0,2,3
70928,5,2,248344,248344,248346,0,2,3
70929,1,1,248345,248346,248347,1,2,0
70930,2,2,248347,248347,248349,0,2,0
70931,2,3,248349,248349,248352,0,3,0
70932,3,1,248352,248352,248353,0,1,0
70933,1,3,248353,248353,248356,0,3,0
70934,2,1,248355,248356,248357,1,2,0
70935,5,2,248360,248360,248362,0,2,3
70936,2,3,248362,248362,248365,0,3,0
70937,4,3,248366,248366,248369,0,3,1
70938,3,3,248369,248369,248372,0,3,0
70939,1,2,248370,248372,248374,2,4,0
70940,1,2,248371,248374,248376,3,5,0
70941,4,2,248375,248376,248378,1,3,0
70942,3,3,248378,248378,248381,0,3,0
70943,3,2,248381,248381,248383,0,2,0
70944,4,3,248385,248385,248388,0,3,2
70945,3,1,248388,248388,248389,0,1,0
70946,3,1,248391,248391,248392,0,1,2
70947,2,3,248393,248393,248396,0,3,1
70948,3,2,248396,248396,248398,0,2,0
70949,1,3,248397,248398,248401,1,4,0
70950,1,3,248398,248401,248404,3,6,0
70951,2,2,248400,248404,248406,4,6,0
70952,1,2,248401,248406,248408,5,7,0
70953,2,1,248403,248408,248409,5,6,0
70954,2,2,248405,248409,248411,4,6,0
70955,4,3,248409,248411,248414,2,5,0
70956,3,3,248412,248414,248417,2,5,0
70957,6,1,248418,248418,248419,0,1,1
70958,1,2,248419,248419,248421,0,2,0
70959,4,2,248423,248423,248425,0,2,2
70960,3,3,248426,248426,248429,0,3,1
70961,6,1,248432,248432,248433,0,1,3
70962,2,1,248434,248434,248435,0,1,1
70963,5,3,248439,248439,248442,0,3,4
70964,5,3,248444,248444,248447,0,3,2
70965,1,3,248445,248447,248450,2,5,0
70966,2,2,248447,248450,248452,3,5,0
70967,6,1,248453,248453,248454,0,1,1
70968,6,3,248459,248459,248462,0,3,5
70969,1,2,248460,248462,248464,2,4,0
70970,6,3,248466,248466,248469,0,3,2
70971,4,2,248470,248470,248472,0,2,1
70972,2,3,248472,248472,248475,0,3,0
70973,2,3,248474,248475,248478,1,4,0
70974,1,3,248475,248478,248481,3,6,0
70975,6,2,248481,248481,248483,0,2,0
70976,6,1,248487,248487,248488,0,1,4
70977,5,2,248492,248492,248494,0,2,4
70978,1,2,248493,248494,248496,1,3,0
70979,1,1,248494,248496,248497,2,3,0
70980,5,2,248499,248499,248501,0,2,2
70981,2,2,248501,248501,248503,0,2,0
70982,6,1,248507,248507,248508,0,1,4
70983,2,1,248509,248509,248510,0,1,1
70984,5,1,248514,248514,248515,0,1,4
70985,2,1,248516,248516,248517,0,1,1
70986,4,1,248520,248520,248521,0,1,3
70987,1,3,248521,248521,248524,0,3,0
70988,4,1,248525,248525,248526,0,1,1
70989,1,2,248526,248526,248528,0,2,0
70990,2,3,248528,248528,248531,0,3,0
70991,4,2,248532,248532,248534,0,2,1
70992,4,2,248536,248536,248538,0,2,2
70993,5,1,248541,248541,248542,0,1,3
70994,4,1,248545,248545,248546,0,1,3
70995,4,3,248549,248549,248552,0,3,3
70996,2,1,248551,248552,248553,1,2,0
70997,2,3,248553,248553,248556,0,3,0
70998,3,2,248556,248556,248558,0,2,0
70999,4,3,248560,248560,248563,0,3,2
71000,1,3,248561,248563,248566,2,5,0
71001,5,2,248566,248566,248568,0,2,0
71002,3,1,248569,248569,248570,0,1,1
71003,4,1,248573,248573,248574,0,1,3
71004,5,2,248578,248578,248580,0,2,4
71005,5,1,248583,248583,248584,0,1,3
71006,6,1,248589,248589,248590,0,1,5
71007,1,2,248590,248590,248592,0,2,0
71008,6,3,248596,248596,248599,0,3,4
71009,2,1,248598,248599,248600,1,2,0
71010,3,1,248601,248601,248602,0,1,1
71011,5,2,248606,248606,248608,0,2,4
71012,3,3,248609,248609,248612,0,3,1
71013,5,1,248614,248614,248615,0,1,2
71014,1,3,248615,248615,248618,0,3,0
71015,4,1,248619,248619,248620,0,1,1
71016,4,2,248623,248623,248625,0,2,3
71017,3,1,248626,248626,248627,0,1,1
71018,6,1,248632,248632,248633,0,1,5
71019,4,1,248636,248636,248637,0,1,3
71020,6,1,248642,248642,248643,0,1,5
71021,3,1,248645,248645,248646,0,1,2
71022,6,2,248651,248651,248653,0,2,5
71023,4,2,248655,248655,248657,0,2,2
71024,6,1,248661,248661,248662,0,1,4
71025,4,2,248665,248665,248667,0,2,3
71026,3,3,248668,248668,248671,0,3,1
71027,2,3,248670,248671,248674,1,4,0
71028,1,3,248671,248674,248677,3,6,0
71029,4,3,248675,248677,248680,2,5,0
71030,3,3,248678,248680,248683,2,5,0
71031,5,1,248683,248683,248684,0,1,0
71032,5,1,248688,248688,248689,0,1,4
71033,4,1,248692,248692,248693,0,1,3
71034,1,1,248693,248693,248694,0,1,0
71035,2,1,248695,248695,248696,0,1,1
71036,6,1,248701,248701,248702,0,1,5
71037,3,1,248704,248704,248705,0,1,2
71038,6,3,248710,248710,248713,0,3,5
71039,4,1,248714,248714,248715,0,1,1
71040,5,3,248719,248719,248722,0,3,4
71041,6,1,248725,248725,248726,0,1,3
71042,4,3,248729,248729,248732,0,3,3
71043,5,1,248734,248734,248735,0,1,2
71044,1,2,248735,248735,248737,0,2,0
71045,6,1,248741,248741,248742,0,1,4
71046,3,3,248744,248744,248747,0,3,2
71047,1,2,248745,248747,248749,2,4,0
71048,5,1,248750,248750,248751,0,1,1
71049,5,1,248755,248755,248756,0,1,4
71050,1,1,248756,248756,248757,0,1,0
71051,4,3,248760,248760,248763,0,3,3
71052,4,2,248764,248764,248766,0,2,1
71053,3,3,248767,248767,248770,0,3,1
71054,2,3,248769,248770,248773,1,4,0
71055,6,2,248775,248775,248777,0,2,2
71056,5,3,248780,248780,248783,0,3,3
71057,2,2,248782,248783,248785,1,3,0
71058,2,1,248784,248785,248786,1,2,0
71059,5,2,248789,248789,248791,0,2,3
71060,4,3,248793,248793,248796,0,3,2
71061,2,2,248795,248796,248798,1,3,0
71062,5,2,248800,248800,248802,0,2,2
71063,3,3,248803,248803,248806,0,3,1
71064,1,2,248804,248806,248808,2,4,0
71065,1,3,248805,248808,248811,3,6,0
71066,1,3,248806,248811,248814,5,8,0
71067,6,1,248812,248814,248815,2,3,0
71068,3,3,248815,248815,248818,0,3,0
71069,2,1,248817,248818,248819,1,2,0
71070,3,3,248820,248820,248823,0,3,1
71071,4,1,248824,248824,248825,0,1,1
71072,5,2,248829,248829,248831,0,2,4
71073,5,3,248834,248834,248837,0,3,3
71074,6,2,248840,248840,248842,0,2,3
71075,2,1,248842,248842,248843,0,1,0
71076,2,2,248844,248844,248846,0,2,1
71077,2,1,248846,248846,248847,0,1,0
71078,1,3,248847,248847,248850,0,3,0
71079,6,1,248853,248853,248854,0,1,3
71080,5,1,248858,248858,248859,0,1,4
71081,3,1,248861,248861,248862,0,1,2
71082,3,2,248864,248864,248866,0,2,2
71083,1,1,248865,248866,248867,1,2,0
71084,2,2,248867,248867,248869,0,2,0
71085,5,2,248872,248872,248874,0,2,3
71086,3,1,248875,248875,248876,0,1,1
71087,5,3,248880,248880,248883,0,3,4
71088,3,2,248883,248883,248885,0,2,0
71089,1,1,248884,248885,248886,1,2,0
71090,1,2,248885,248886,248888,1,3,0
71091,2,1,248887,248888,248889,1,2,0
71092,3,2,248890,248890,248892,0,2,1
71093,6,3,248896,248896,248899,0,3,4
71094,3,1,248899,248899,248900,0,1,0
71095,3,3,248902,248902,248905,0,3,2
71096,6,1,248908,248908,248909,0,1,3
71097,2,2,248910,248910,248912,0,2,1
71098,1,2,248911,248912,248914,1,3,0
71099,6,1,248917,248917,248918,0,1,3
71100,4,1,248921,248921,248922,0,1,3
71101,5,1,248926,248926,248927,0,1,4
71102,6,1,248932,248932,248933,0,1,5
71103,5,3,248937,248937,248940,0,3,4
71104,2,3,248939,248940,248943,1,4,0
71105,6,1,248945,248945,248946,0,1,2
71106,6,3,248951,248951,248954,0,3,5
71107,4,1,248955,248955,248956,0,1,1
71108,6,2,248961,248961,248963,0,2,5
71109,5,1,248966,248966,248967,0,1,3
71110,6,3,248972,248972,248975,0,3,5
71111,3,3,248975,248975,248978,0,3,0
71112,5,1,248980,248980,248981,0,1,2
71113,1,2,248981,248981,248983,0,2,0
71114,4,1,248985,248985,248986,0,1,2
71115,6,1,248991,248991,248992,0,1,5
71116,1,2,248992,248992,248994,0,2,0
71117,5,3,248997,248997,249000,0,3,3
71118,3,2,249000,249000,249002,0,2,0
71119,5,1,249005,249005,249006,0,1,3
71120,5,2,249010,249010,249012,0,2,4
71121,1,3,249011,249012,249015,1,4,0
71122,1,3,249012,249015,249018,3,6,0
71123,6,1,249018,249018,249019,0,1,0
71124,3,2,249021,249021,249023,0,2,2
71125,3,2,249024,249024,249026,0,2,1
71126,2,3,249026,249026,249029,0,3,0
71127,2,1,249028,249029,249030,1,2,0
71128,2,3,249030,249030,249033,0,3,0
71129,2,1,249032,249033,249034,1,2,0
71130,6,1,249038,249038,249039,0,1,4
71131,6,2,249044,249044,249046,0,2,5
71132,2,1,249046,249046,249047,0,1,0
71133,6,1,249052,249052,249053,0,1,5
71134,5,1,249057,249057,249058,0,1,4
71135,4,2,249061,249061,249063,0,2,3
71136,2,1,249063,249063,249064,0,1,0
71137,4,1,249067,249067,249068,0,1,3
71138,3,1,249070,249070,249071,0,1,2
71139,3,3,249073,249073,249076,0,3,2
71140,5,1,249078,249078,249079,0,1,2
71141,6,2,249084,249084,249086,0,2,5
71142,6,1,249090,249090,249091,0,1,4
71143,5,1,249095,249095,249096,0,1,4
71144,5,3,249100,249100,249103,0,3,4
71145,2,2,249102,249103,249105,1,3,0
71146,5,3,249107,249107,249110,0,3,2
71147,6,1,249113,249113,249114,0,1,3
71148,5,3,249118,249118,249121,0,3,4
71149,4,1,249122,249122,249123,0,1,1
71150,1,1,249123,249123,249124,0,1,0
71151,1,3,249124,249124,249127,0,3,0
71152,2,2,249126,249127,249129,1,3,0
71153,3,1,249129,249129,249130,0,1,0
71154,4,1,249133,249133,249134,0,1,3
71155,4,2,249137,249137,249139,0,2,3
71156,5,3,249142,249142,249145,0,3,3
71157,4,3,249146,249146,249149,0,3,1
71158,2,2,249148,249149,249151,1,3,0
71159,6,3,249154,249154,249157,0,3,3
71160,3,3,249157,249157,249160,0,3,0
71161,1,2,249158,249160,249162,2,4,0
71162,3,1,249161,249162,249163,1,2,0
71163,4,2,249165,249165,249167,0,2,2
71164,5,1,249170,249170,249171,0,1,3
71165,1,3,249171,249171,249174,0,3,0
71166,1,3,249172,249174,249177,2,5,0
71167,1,2,249173,249177,249179,4,6,0
71168,4,3,249177,249179,249182,2,5,0
71169,2,3,249179,249182,249185,3,6,0
71170,6,3,249185,249185,249188,0,3,0
71171,2,2,249187,249188,249190,1,3,0
71172,1,1,249188,249190,249191,2,3,0
71173,1,3,249189,249191,249194,2,5,0
71174,5,1,249194,249194,249195,0,1,0
71175,1,2,249195,249195,249197,0,2,0
71176,6,1,249201,249201,249202,0,1,4
71177,1,1,249202,249202,249203,0,1,0
71178,4,1,249206,249206,249207,0,1,3
71179,5,1,249211,249211,249212,0,1,4
71180,4,2,249215,249215,249217,0,2,3
71181,5,2,249220,249220,249222,0,2,3
71182,4,2,249224,249224,249226,0,2,2
71183,3,3,249227,249227,249230,0,3,1
71184,6,1,249233,249233,249234,0,1,3
71185,1,2,249234,249234,249236,0,2,0
71186,3,2,249237,249237,249239,0,2,1
71187,1,3,249238,249239,249242,1,4,0
71188,4,2,249242,249242,249244,0,2,0
71189,4,2,249246,249246,249248,0,2,2
71190,3,2,249249,249249,249251,0,2,1
71191,5,2,249254,249254,249256,0,2,3
71192,6,2,249260,249260,249262,0,2,4
71193,1,2,249261,249262,249264,1,3,0
71194,1,2,249262,249264,249266,2,4,0
71195,6,1,249268,249268,249269,0,1,2
71196,6,1,249274,249274,249275,0,1,5
71197,4,2,249278,249278,249280,0,2,3
71198,4,1,249282,249282,249283,0,1,2
71199,2,1,249284,249284,249285,0,1,1
71200,2,1,249286,249286,249287,0,1,1
71201,4,3,249290,249290,249293,0,3,3
71202,5,2,249295,249295,249297,0,2,2
71203,6,1,249301,249301,249302,0,1,4
71204,1,1,249302,249302,249303,0,1,0
71205,5,3,249307,249307,249310,0,3,4
71206,4,1,249311,249311,249312,0,1,1
71207,4,1,249315,249315,249316,0,1,3
71208,2,2,249317,249317,249319,0,2,1
71209,6,1,249323,249323,249324,0,1,4
71210,4,2,249327,249327,249329,0,2,3
71211,3,2,249330,249330,249332,0,2,1
71212,5,2,249335,249335,249337,0,2,3
71213,2,2,249337,249337,249339,0,2,0
71214,5,2,249342,249342,249344,0,2,3
71215,3,1,249345,249345,249346,0,1,1
71216,6,3,249351,249351,249354,0,3,5
71217,4,1,249355,249355,249356,0,1,1
71218,6,3,249361,249361,249364,0,3,5
71219,1,1,249362,249364,249365,2,3,0
71220,5,1,249367,249367,249368,0,1,2
71221,1,3,249368,249368,249371,0,3,0
71222,3,1,249371,249371,249372,0,1,0
71223,3,3,249374,249374,249377,0,3,2
71224,3,2,249377,249377,249379,0,2,0
71225,6,3,249383,249383,249386,0,3,4
71226,1,3,249384,249386,249389,2,5,0
71227,1,3,249385,249389,249392,4,7,0
71228,1,2,249386,249392,249394,6,8,0
71229,4,3,249390,249394,249397,4,7,0
71230,4,2,249394,249397,249399,3,5,0
71231,6,3,249400,249400,249403,0,3,1
71232,5,3,249405,249405,249408,0,3,2
71233,4,2,249409,249409,249411,0,2,1
71234,4,1,249413,249413,249414,0,1,2
71235,4,1,249417,249417,249418,0,1,3
71236,5,3,249422,249422,249425,0,3,4
71237,5,3,249427,249427,249430,0,3,2
71238,2,1,249429,249430,249431,1,2,0
71239,1,1,249430,249431,249432,1,2,0
71240,5,3,249435,249435,249438,0,3,3
71241,3,2,249438,249438,249440,0,2,0
71242,3,3,249441,249441,249444,0,3,1
71243,5,2,249446,249446,249448,0,2,2
71244,1,1,249447,249448,249449,1,2,0
71245,5,2,249452,249452,249454,0,2,3
71246,4,2,249456,249456,249458,0,2,2
71247,4,1,249460,249460,249461,0,1,2
71248,4,3,249464,249464,249467,0,3,3
71249,2,1,249466,249467,249468,1,2,0
71250,5,1,249471,249471,249472,0,1,3
71251,6,1,249477,249477,249478,0,1,5
71252,3,1,249480,249480,249481,0,1,2
71253,5,3,249485,249485,249488,0,3,4
71254,6,1,249491,249491,249492,0,1,3
71255,2,1,249493,249493,249494,0,1,1
71256,1,1,249494,249494,249495,0,1,0
71257,2,1,249496,249496,249497,0,1,1
71258,2,2,249498,249498,249500,0,2,1
71259,2,3,249500,249500,249503,0,3,0
71260,4,3,249504,249504,249507,0,3,1
71261,6,1,249510,249510,249511,0,1,3
71262,5,1,249515,249515,249516,0,1,4
71263,1,1,249516,249516,249517,0,1,0
71264,4,1,249520,249520,249521,0,1,3
71265,3,1,249523,249523,249524,0,1,2
71266,3,1,249526,249526,249527,0,1,2
71267,2,3,249528,249528,249531,0,3,1
71268,5,3,249533,249533,249536,0,3,2
71269,4,1,249537,249537,249538,0,1,1
71270,5,1,249542,249542,249543,0,1,4
71271,6,3,249548,249548,249551,0,3,5
71272,1,1,249549,249551,249552,2,3,0
71273,6,1,249555,249555,249556,0,1,3
71274,6,2,249561,249561,249563,0,2,5
71275,1,3,249562,249563,249566,1,4,0
71276,1,2,249563,249566,249568,3,5,0
71277,5,2,249568,249568,249570,0,2,0
71278,2,3,249570,249570,249573,0,3,0
71279,6,2,249576,249576,249578,0,2,3
71280,4,1,249580,249580,249581,0,1,2
71281,2,1,249582,249582,249583,0,1,1
71282,6,3,249588,249588,249591,0,3,5
71283,3,2,249591,249591,249593,0,2,0
71284,2,2,249593,249593,249595,0,2,0
71285,1,3,249594,249595,249598,1,4,0
71286,3,1,249597,249598,249599,1,2,0
71287,6,3,249603,249603,249606,0,3,4
71288,6,3,249609,249609,249612,0,3,3
71289,6,3,249615,249615,249618,0,3,3
71290,5,3,249620,249620,249623,0,3,2
71291,6,1,249626,249626,249627,0,1,3
71292,4,1,249630,249630,249631,0,1,3
71293,5,3,249635,249635,249638,0,3,4
71294,6,2,249641,249641,249643,0,2,3
71295,5,3,249646,249646,249649,0,3,3
71296,1,2,249647,249649,249651,2,4,0
71297,1,2,249648,249651,249653,3,5,0
71298,5,2,249653,249653,249655,0,2,0
71299,1,1,249654,249655,249656,1,2,0
71300,3,2,249657,249657,249659,0,2,1
71301,4,3,249661,249661,249664,0,3,2
71302,3,1,249664,249664,249665,0,1,0
71303,1,2,249665,249665,249667,0,2,0
71304,3,2,249668,249668,249670,0,2,1
71305,1,3,249669,249670,249673,1,4,0
71306,2,1,249671,249673,249674,2,3,0
71307,2,3,249673,249674,249677,1,4,0
71308,6,3,249679,249679,249682,0,3,2
71309,4,3,249683,249683,249686,0,3,1
71310,4,3,249687,249687,249690,0,3,1
71311,1,1,249688,249690,249691,2,3,0
71312,4,2,249692,249692,249694,0,2,1
71313,2,1,249694,249694,249695,0,1,0
71314,4,3,249698,249698,249701,0,3,3
71315,1,3,249699,249701,249704,2,5,0
71316,6,3,249705,249705,249708,0,3,1
71317,3,1,249708,249708,249709,0,1,0
71318,2,2,249710,249710,249712,0,2,1
71319,6,2,249716,249716,249718,0,2,4
71320,1,1,249717,249718,249719,1,2,0
71321,2,3,249719,249719,249722,0,3,0
71322,1,1,249720,249722,249723,2,3,0
71323,3,1,249723,249723,249724,0,1,0
71324,3,2,249726,249726,249728,0,2,2
71325,1,2,249727,249728,249730,1,3,0
71326,2,3,249729,249730,249733,1,4,0
71327,6,3,249735,249735,249738,0,3,2
71328,5,3,249740,249740,249743,0,3,2
71329,5,2,249745,249745,249747,0,2,2
71330,3,3,249748,249748,249751,0,3,1
71331,3,2,249751,249751,249753,0,2,0
71332,3,1,249754,249754,249755,0,1,1
71333,2,1,249756,249756,249757,0,1,1
71334,1,3,249757,249757,249760,0,3,0
71335,5,1,249762,249762,249763,0,1,2
71336,3,1,249765,249765,249766,0,1,2
71337,6,1,249771,249771,249772,0,1,5
71338,1,3,249772,249772,249775,0,3,0
71339,3,2,249775,249775,249777,0,2,0
71340,4,3,249779,249779,249782,0,3,2
71341,3,3,249782,249782,249785,0,3,0
71342,5,1,249787,249787,249788,0,1,2
71343,3,2,249790,249790,249792,0,2,2
71344,2,3,249792,249792,249795,0,3,0
71345,4,2,249796,249796,249798,0,2,1
71346,1,2,249797,249798,249800,1,3,0
71347,1,2,249798,249800,249802,2,4,0
71348,4,3,249802,249802,249805,0,3,0
71349,6,2,249808,249808,249810,0,2,3
71350,1,3,249809,249810,249813,1,4,0
71351,5,3,249814,249814,249817,0,3,1
71352,5,1,249819,249819,249820,0,1,2
71353,1,3,249820,249820,249823,0,3,0
71354,1,3,249821,249823,249826,2,5,0
71355,5,3,249826,249826,249829,0,3,0
71356,3,3,249829,249829,249832,0,3,0
71357,6,2,249835,249835,249837,0,2,3
71358,3,2,249838,249838,249840,0,2,1
71359,1,3,249839,249840,249843,1,4,0
71360,3,2,249842,249843,249845,1,3,0
71361,4,2,249846,249846,249848,0,2,1
71362,2,3,249848,249848,249851,0,3,0
71363,3,3,249851,249851,249854,0,3,0
71364,3,2,249854,249854,249856,0,2,0
71365,4,2,249858,249858,249860,0,2,2
71366,1,1,249859,249860,249861,1,2,0
71367,4,1,249863,249863,249864,0,1,2
71368,3,2,249866,249866,249868,0,2,2
71369,4,2,249870,249870,249872,0,2,2
71370,4,2,249874,249874,249876,0,2,2
71371,5,2,249879,249879,249881,0,2,3
71372,5,2,249884,249884,249886,0,2,3
71373,6,2,249890,249890,249892,0,2,4
71374,5,2,249895,249895,249897,0,2,3
71375,2,3,249897,249897,249900,0,3,0
71376,4,3,249901,249901,249904,0,3,1
71377,5,1,249906,249906,249907,0,1,2
71378,6,1,249912,249912,249913,0,1,5
71379,1,3,249913,249913,249916,0,3,0
71380,1,3,249914,249916,249919,2,5,0
71381,5,1,249919,249919,249920,0,1,0
71382,3,2,249922,249922,249924,0,2,2
71383,3,2,249925,249925,249927,0,2,1
71384,4,1,249929,249929,249930,0,1,2
71385,1,3,249930,249930,249933,0,3,0
71386,5,2,249935,249935,249937,0,2,2
71387,6,3,249941,249941,249944,0,3,4
71388,4,1,249945,249945,249946,0,1,1
71389,4,3,249949,249949,249952,0,3,3
71390,6,2,249955,249955,249957,0,2,3
71391,6,3,249961,249961,249964,0,3,4
71392,4,3,249965,249965,249968,0,3,1
71393,1,3,249966,249968,249971,2,5,0
71394,4,1,249970,249971,249972,1,2,0
71395,5,1,249975,249975,249976,0,1,3
71396,4,2,249979,249979,249981,0,2,3
71397,6,1,249985,249985,249986,0,1,4
71398,1,3,249986,249986,249989,0,3,0
71399,1,2,249987,249989,249991,2,4,0
71400,4,3,249991,249991,249994,0,3,0
71401,5,1,249996,249996,249997,0,1,2
71402,1,2,249997,249997,249999,0,2,0
71403,4,3,250001,250001,250004,0,3,2
71404,1,1,250002,250004,250005,2,3,0
71405,4,1,250006,250006,250007,0,1,1
71406,2,2,250008,250008,250010,0,2,1
71407,2,2,250010,250010,250012,0,2,0
71408,4,1,250014,250014,250015,0,1,2
71409,4,2,250018,250018,250020,0,2,3
71410,1,2,250019,250020,250022,1,3,0
71411,2,1,250021,250022,250023,1,2,0
71412,2,3,250023,250023,250026,0,3,0
71413,5,3,250028,250028,250031,0,3,2
71414,4,1,250032,250032,250033,0,1,1
71415,3,2,250035,250035,250037,0,2,2
71416,2,2,250037,250037,250039,0,2,0
71417,1,2,250038,250039,250041,1,3,0
71418,1,1,250039,250041,250042,2,3,0
71419,1,3,250040,250042,250045,2,5,0
71420,2,3,250042,250045,250048,3,6,0
71421,5,3,250047,250048,250051,1,4,0
71422,5,1,250052,250052,250053,0,1,1
71423,3,3,250055,250055,250058,0,3,2
71424,4,2,250059,250059,250061,0,2,1
71425,5,2,250064,250064,250066,0,2,3
71426,2,1,250066,250066,250067,0,1,0
71427,1,3,250067,250067,250070,0,3,0
71428,6,3,250073,250073,250076,0,3,3
71429,5,3,250078,250078,250081,0,3,2
71430,2,3,250080,250081,250084,1,4,0
71431,1,2,250081,250084,250086,3,5,0
71432,1,2,250082,250086,250088,4,6,0
71433,6,3,250088,250088,250091,0,3,0
71434,3,2,250091,250091,250093,0,2,0
71435,2,2,250093,250093,250095,0,2,0
71436,3,2,250096,250096,250098,0,2,1
71437,6,1,250102,250102,250103,0,1,4
71438,6,1,250108,250108,250109,0,1,5
71439,4,2,250112,250112,250114,0,2,3
71440,1,3,250113,250114,250117,1,4,0
71441,1,2,250114,250117,250119,3,5,0
71442,1,2,250115,250119,250121,4,6,0
71443,5,1,250120,250121,250122,1,2,0
71444,5,3,250125,250125,250128,0,3,3
71445,1,3,250126,250128,250131,2,5,0
71446,6,2,250132,250132,250134,0,2,1
71447,4,1,250136,250136,250137,0,1,2
71448,4,3,250140,250140,250143,0,3,3
71449,4,3,250144,250144,250147,0,3,1
71450,6,3,250150,250150,250153,0,3,3
71451,6,2,250156,250156,250158,0,2,3
71452,3,3,250159,250159,250162,0,3,1
71453,1,2,250160,250162,250164,2,4,0
71454,6,2,250166,250166,250168,0,2,2
71455,6,3,250172,250172,250175,0,3,4
71456,2,1,250174,250175,250176,1,2,0
71457,2,1,250176,250176,250177,0,1,0
71458,4,1,250180,250180,250181,0,1,3
71459,3,1,250183,250183,250184,0,1,2
71460,3,2,250186,250186,250188,0,2,2
71461,5,2,250191,250191,250193,0,2,3
71462,3,1,250194,250194,250195,0,1,1
71463,2,3,250196,250196,250199,0,3,1
71464,1,3,250197,250199,250202,2,5,0
71465,5,3,250202,250202,250205,0,3,0
71466,3,1,250205,250205,250206,0,1,0
71467,5,3,250210,250210,250213,0,3,4
71468,4,3,250214,250214,250217,0,3,1
71469,4,2,250218,250218,250220,0,2,1
71470,1,3,250219,250220,250223,1,4,0
71471,3,1,250222,250223,250224,1,2,0
71472,1,2,250223,250224,250226,1,3,0
71473,1,2,250224,250226,250228,2,4,0
71474,3,2,250227,250228,250230,1,3,0
71475,4,1,250231,250231,250232,0,1,1
71476,5,3,250236,250236,250239,0,3,4
71477,3,3,250239,250239,250242,0,3,0
71478,6,1,250245,250245,250246,0,1,3
71479,5,2,250250,250250,250252,0,2,4
71480,3,2,250253,250253,250255,0,2,1
71481,3,2,250256,250256,250258,0,2,1
71482,5,2,250261,250261,250263,0,2,3
71483,3,3,250264,250264,250267,0,3,1
71484,2,1,250266,250267,250268,1,2,0
71485,6,3,250272,250272,250275,0,3,4
71486,5,2,250277,250277,250279,0,2,2
71487,3,3,250280,250280,250283,0,3,1
71488,3,1,250283,250283,250284,0,1,0
71489,6,2,250289,250289,250291,0,2,5
71490,5,3,250294,250294,250297,0,3,3
71491,1,3,250295,250297,250300,2,5,0
71492,6,3,250301,250301,250304,0,3,1
71493,4,1,250305,250305,250306,0,1,1
71494,2,1,250307,250307,250308,0,1,1
71495,6,3,250313,250313,250316,0,3,5
71496,2,2,250315,250316,250318,1,3,0
71497,1,1,250316,250318,250319,2,3,0
71498,6,1,250322,250322,250323,0,1,3
71499,1,2,250323,250323,250325,0,2,0
71500,5,3,250328,250328,250331,0,3,3
71501,3,1,250331,250331,250332,0,1,0
71502,4,2,250335,250335,250337,0,2,3
71503,3,3,250338,250338,250341,0,3,1
71504,1,2,250339,250341,250343,2,4,0
71505,5,1,250344,250344,250345,0,1,1
71506,1,2,250345,250345,250347,0,2,0
71507,4,1,250349,250349,250350,0,1,2
71508,4,3,250353,250353,250356,0,3,3
71509,1,1,250354,250356,250357,2,3,0
71510,4,2,250358,250358,250360,0,2,1
71511,4,2,250362,250362,250364,0,2,2
71512,3,3,250365,250365,250368,0,3,1
71513,5,1,250370,250370,250371,0,1,2
71514,1,2,250371,250371,250373,0,2,0
71515,3,1,250374,250374,250375,0,1,1
71516,4,1,250378,250378,250379,0,1,3
71517,4,2,250382,250382,250384,0,2,3
71518,2,1,250384,250384,250385,0,1,0
71519,5,3,250389,250389,250392,0,3,4
71520,4,3,250393,250393,250396,0,3,1
71521,1,3,250394,250396,250399,2,5,0
71522,4,2,250398,250399,250401,1,3,0
71523,6,2,250404,250404,250406,0,2,3
71524,2,2,250406,250406,250408,0,2,0
71525,5,2,250411,250411,250413,0,2,3
71526,1,3,250412,250413,250416,1,4,0
71527,5,1,250417,250417,250418,0,1,1
71528,3,2,250420,250420,250422,0,2,2
71529,2,1,250422,250422,250423,0,1,0
71530,3,3,250425,250425,250428,0,3,2
71531,3,3,250428,250428,250431,0,3,0
71532,3,2,250431,250431,250433,0,2,0
71533,1,2,250432,250433,250435,1,3,0
71534,6,2,250438,250438,250440,0,2,3
71535,4,1,250442,250442,250443,0,1,2
71536,1,2,250443,250443,250445,0,2,0
71537,4,1,250447,250447,250448,0,1,2
71538,1,1,250448,250448,250449,0,1,0
71539,6,2,250454,250454,250456,0,2,5
71540,3,2,250457,250457,250459,0,2,1
71541,2,3,250459,250459,250462,0,3,0
71542,5,2,250464,250464,250466,0,2,2
71543,3,1,250467,250467,250468,0,1,1
71544,6,3,250473,250473,250476,0,3,5
71545,5,2,250478,250478,250480,0,2,2
71546,6,3,250484,250484,250487,0,3,4
71547,5,2,250489,250489,250491,0,2,2
71548,6,3,250495,250495,250498,0,3,4
71549,6,3,250501,250501,250504,0,3,3
71550,3,1,250504,250504,250505,0,1,0
71551,6,3,250510,250510,250513,0,3,5
71552,5,1,250515,250515,250516,0,1,2
71553,3,1,250518,250518,250519,0,1,2
71554,5,1,250523,250523,250524,0,1,4
71555,2,2,250525,250525,250527,0,2,1
71556,3,1,250528,250528,250529,0,1,1
71557,5,1,250533,250533,250534,0,1,4
71558,3,3,250536,250536,250539,0,3,2
71559,4,1,250540,250540,250541,0,1,1
71560,6,3,250546,250546,250549,0,3,5
71561,5,3,250551,250551,250554,0,3,2
71562,2,3,250553,250554,250557,1,4,0
71563,3,3,250556,250557,250560,1,4,0
71564,5,1,250561,250561,250562,0,1,1
71565,3,3,250564,250564,250567,0,3,2
71566,6,2,250570,250570,250572,0,2,3
71567,6,1,250576,250576,250577,0,1,4
71568,1,1,250577,250577,250578,0,1,0
71569,2,2,250579,250579,250581,0,2,1
71570,6,2,250585,250585,250587,0,2,4
71571,6,1,250591,250591,250592,0,1,4
71572,5,2,250596,250596,250598,0,2,4
71573,3,2,250599,250599,250601,0,2,1
71574,2,3,250601,250601,250604,0,3,0
71575,3,3,250604,250604,250607,0,3,0
71576,2,1,250606,250607,250608,1,2,0
71577,1,1,250607,250608,250609,1,2,0
71578,4,1,250611,250611,250612,0,1,2
71579,6,1,250617,250617,250618,0,1,5
71580,5,3,250622,250622,250625,0,3,4
71581,4,3,250626,250626,250629,0,3,1
71582,6,3,250632,250632,250635,0,3,3
71583,3,1,250635,250635,250636,0,1,0
71584,5,2,250640,250640,250642,0,2,4
71585,6,1,250646,250646,250647,0,1,4
71586,6,2,250652,250652,250654,0,2,5
71587,2,1,250654,250654,250655,0,1,0
71588,4,3,250658,250658,250661,0,3,3
71589,1,3,250659,250661,250664,2,5,0
71590,5,1,250664,250664,250665,0,1,0
71591,1,1,250665,250665,250666,0,1,0
71592,2,2,250667,250667,250669,0,2,1
71593,4,1,250671,250671,250672,0,1,2
71594,3,2,250674,250674,250676,0,2,2
71595,1,3,250675,250676,250679,1,4,0
71596,1,3,250676,250679,250682,3,6,0
71597,3,3,250679,250682,250685,3,6,0
71598,2,3,250681,250685,250688,4,7,0
71599,1,3,250682,250688,250691,6,9,0
71600,4,1,250686,250691,250692,5,6,0
71601,6,3,250692,250692,250695,0,3,0
71602,2,3,250694,250695,250698,1,4,0
71603,2,2,250696,250698,250700,2,4,0
71604,6,1,250702,250702,250703,0,1,2
71605,3,3,250705,250705,250708,0,3,2
71606,4,2,250709,250709,250711,0,2,1
71607,4,2,250713,250713,250715,0,2,2
71608,1,3,250714,250715,250718,1,4,0
71609,3,2,250717,250718,250720,1,3,0
71610,6,2,250723,250723,250725,0,2,3
71611,4,3,250727,250727,250730,0,3,2
71612,1,2,250728,250730,250732,2,4,0
71613,1,2,250729,250732,250734,3,5,0
71614,2,2,250731,250734,250736,3,5,0
71615,1,2,250732,250736,250738,4,6,0
71616,4,3,250736,250738,250741,2,5,0
71617,4,3,250740,250741,250744,1,4,0
71618,3,3,250743,250744,250747,1,4,0
71619,1,1,250744,250747,250748,3,4,0
71620,2,2,250746,250748,250750,2,4,0
71621,1,2,250747,250750,250752,3,5,0
71622,4,2,250751,250752,250754,1,3,0
71623,6,3,250757,250757,250760,0,3,3
71624,4,3,250761,250761,250764,0,3,1
71625,6,1,250767,250767,250768,0,1,3
71626,3,3,250770,250770,250773,0,3,2
71627,6,2,250776,250776,250778,0,2,3
71628,5,3,250781,250781,250784,0,3,3
71629,6,3,250787,250787,250790,0,3,3
71630,6,1,250793,250793,250794,0,1,3
71631,5,3,250798,250798,250801,0,3,4
71632,1,3,250799,250801,250804,2,5,0
71633,1,3,250800,250804,250807,4,7,0
71634,5,1,250805,250807,250808,2,3,0
71635,6,1,250811,250811,250812,0,1,3
71636,4,3,250815,250815,250818,0,3,3
71637,3,3,250818,250818,250821,0,3,0
71638,4,2,250822,250822,250824,0,2,1
71639,4,3,250826,250826,250829,0,3,2
71640,1,3,250827,250829,250832,2,5,0
71641,3,1,250830,250832,250833,2,3,0
71642,1,2,250831,250833,250835,2,4,0
71643,3,1,250834,250835,250836,1,2,0
71644,2,2,250836,250836,250838,0,2,0
71645,6,3,250842,250842,250845,0,3,4
71646,2,2,250844,250845,250847,1,3,0
71647,6,3,250850,250850,250853,0,3,3
71648,4,3,250854,250854,250857,0,3,1
71649,1,3,250855,250857,250860,2,5,0
71650,4,3,250859,250860,250863,1,4,0
71651,4,1,250863,250863,250864,0,1,0
71652,5,2,250868,250868,250870,0,2,4
71653,3,3,250871,250871,250874,0,3,1
71654,1,2,250872,250874,250876,2,4,0
71655,6,3,250878,250878,250881,0,3,2
71656,3,2,250881,250881,250883,0,2,0
71657,2,2,250883,250883,250885,0,2,0
71658,2,1,250885,250885,250886,0,1,0
71659,5,1,250890,250890,250891,0,1,4
71660,2,3,250892,250892,250895,0,3,1
71661,5,1,250897,250897,250898,0,1,2
71662,3,1,250900,250900,250901,0,1,2
71663,5,1,250905,250905,250906,0,1,4
71664,5,3,250910,250910,250913,0,3,4
71665,6,2,250916,250916,250918,0,2,3
71666,4,2,250920,250920,250922,0,2,2
71667,5,2,250925,250925,250927,0,2,3
71668,3,3,250928,250928,250931,0,3,1
71669,3,2,250931,250931,250933,0,2,0
71670,5,2,250936,250936,250938,0,2,3
71671,1,1,250937,250938,250939,1,2,0
71672,3,1,250940,250940,250941,0,1,1
71673,5,2,250945,250945,250947,0,2,4
71674,1,2,250946,250947,250949,1,3,0
71675,4,1,250950,250950,250951,0,1,1
71676,4,2,250954,250954,250956,0,2,3
71677,3,1,250957,250957,250958,0,1,1
71678,3,1,250960,250960,250961,0,1,2
71679,1,1,250961,250961,250962,0,1,0
71680,4,1,250965,250965,250966,0,1,3
71681,2,3,250967,250967,250970,0,3,1
71682,5,3,250972,250972,250975,0,3,2
71683,4,1,250976,250976,250977,0,1,1
71684,6,1,250982,250982,250983,0,1,5
71685,3,3,250985,250985,250988,0,3,2
71686,6,1,250991,250991,250992,0,1,3
71687,5,1,250996,250996,250997,0,1,4
71688,6,2,251002,251002,251004,0,2,5
71689,2,2,251004,251004,251006,0,2,0
71690,5,2,251009,251009,251011,0,2,3
71691,5,3,251014,251014,251017,0,3,3
71692,1,3,251015,251017,251020,2,5,0
71693,2,3,251017,251020,251023,3,6,0
71694,1,1,251018,251023,251024,5,6,0
71695,3,1,251021,251024,251025,3,4,0
71696,6,2,251027,251027,251029,0,2,2
71697,6,1,251033,251033,251034,0,1,4
71698,5,3,251038,251038,251041,0,3,4
71699,4,2,251042,251042,251044,0,2,1
71700,2,1,251044,251044,251045,0,1,0
71701,1,3,251045,251045,251048,0,3,0
71702,5,3,251050,251050,251053,0,3,2
71703,5,2,251055,251055,251057,0,2,2
71704,4,3,251059,251059,251062,0,3,2
71705,5,3,251064,251064,251067,0,3,2
71706,2,1,251066,251067,251068,1,2,0
71707,2,3,251068,251068,251071,0,3,0
71708,6,3,251074,251074,251077,0,3,3
71709,2,1,251076,251077,251078,1,2,0
71710,2,1,251078,251078,251079,0,1,0
71711,1,3,251079,251079,251082,0,3,0
71712,5,3,251084,251084,251087,0,3,2
71713,6,1,251090,251090,251091,0,1,3
71714,5,2,251095,251095,251097,0,2,4
71715,4,3,251099,251099,251102,0,3,2
71716,2,1,251101,251102,251103,1,2,0
71717,4,1,251105,251105,251106,0,1,2
71718,6,1,251111,251111,251112,0,1,5
71719,3,3,251114,251114,251117,0,3,2
71720,4,3,251118,251118,251121,0,3,1
71721,5,1,251123,251123,251124,0,1,2
71722,4,3,251127,251127,251130,0,3,3
71723,6,3,251133,251133,251136,0,3,3
71724,2,2,251135,251136,251138,1,3,0
71725,6,1,251141,251141,251142,0,1,3
71726,1,1,251142,251142,251143,0,1,0
71727,2,1,251144,251144,251145,0,1,1
71728,5,1,251149,251149,251150,0,1,4
71729,1,2,251150,251150,251152,0,2,0
71730,1,1,251151,251152,251153,1,2,0
71731,3,1,251154,251154,251155,0,1,1
71732,5,2,251159,251159,251161,0,2,4
71733,6,1,251165,251165,251166,0,1,4
71734,5,2,251170,251170,251172,0,2,4
71735,2,3,251172,251172,251175,0,3,0
71736,1,2,251173,251175,251177,2,4,0
71737,1,1,251174,251177,251178,3,4,0
71738,5,3,251179,251179,251182,0,3,1
71739,2,1,251181,251182,251183,1,2,0
71740,4,2,251185,251185,251187,0,2,2
71741,1,2,251186,251187,251189,1,3,0
71742,5,1,251191,251191,251192,0,1,2
71743,2,1,251193,251193,251194,0,1,1
71744,5,1,251198,251198,251199,0,1,4
71745,5,3,251203,251203,251206,0,3,4
71746,5,2,251208,251208,251210,0,2,2
71747,1,1,251209,251210,251211,1,2,0
71748,3,3,251212,251212,251215,0,3,1
71749,4,1,251216,251216,251217,0,1,1
71750,2,1,251218,251218,251219,0,1,1
71751,5,1,251223,251223,251224,0,1,4
71752,3,1,251226,251226,251227,0,1,2
71753,1,2,251227,251227,251229,0,2,0
71754,5,1,251232,251232,251233,0,1,3
71755,1,1,251233,251233,251234,0,1,0
71756,4,3,251237,251237,251240,0,3,3
71757,1,2,251238,251240,251242,2,4,0
71758,4,3,251242,251242,251245,0,3,0
71759,1,1,251243,251245,251246,2,3,0
71760,1,3,251244,251246,251249,2,5,0
71761,1,3,251245,251249,251252,4,7,0
71762,5,1,251250,251252,251253,2,3,0
71763,6,1,251256,251256,251257,0,1,3
71764,5,2,251261,251261,251263,0,2,4
71765,4,2,251265,251265,251267,0,2,2
71766,1,2,251266,251267,251269,1,3,0
71767,4,3,251270,251270,251273,0,3,1
71768,2,1,251272,251273,251274,1,2,0
71769,3,3,251275,251275,251278,0,3,1
71770,1,1,251276,251278,251279,2,3,0
71771,4,1,251280,251280,251281,0,1,1
71772,6,2,251286,251286,251288,0,2,5
71773,1,1,251287,251288,251289,1,2,0
71774,4,3,251291,251291,251294,0,3,2
71775,2,2,251293,251294,251296,1,3,0
71776,5,3,251298,251298,251301,0,3,2
71777,6,3,251304,251304,251307,0,3,3
71778,2,3,251306,251307,251310,1,4,0
71779,2,2,251308,251310,251312,2,4,0
71780,6,3,251314,251314,251317,0,3,2
71781,5,2,251319,251319,251321,0,2,2
71782,6,3,251325,251325,251328,0,3,4
71783,3,2,251328,251328,251330,0,2,0
71784,3,2,251331,251331,251333,0,2,1
71785,4,1,251335,251335,251336,0,1,2
71786,1,1,251336,251336,251337,0,1,0
71787,5,3,251341,251341,251344,0,3,4
71788,2,2,251343,251344,251346,1,3,0
71789,6,2,251349,251349,251351,0,2,3
71790,6,2,251355,251355,251357,0,2,4
71791,4,1,251359,251359,251360,0,1,2
71792,5,3,251364,251364,251367,0,3,4
71793,2,3,251366,251367,251370,1,4,0
71794,6,2,251372,251372,251374,0,2,2
71795,1,2,251373,251374,251376,1,3,0
71796,1,2,251374,251376,251378,2,4,0
71797,6,1,251380,251380,251381,0,1,2
71798,3,2,251383,251383,251385,0,2,2
71799,4,2,251387,251387,251389,0,2,2
71800,3,1,251390,251390,251391,0,1,1
71801,4,1,251394,251394,251395,0,1,3
71802,6,3,251400,251400,251403,0,3,5
71803,1,3,251401,251403,251406,2,5,0
71804,4,3,251405,251406,251409,1,4,0
71805,4,2,251409,251409,251411,0,2,0
71806,3,1,251412,251412,251413,0,1,1
71807,6,3,251418,251418,251421,0,3,5
71808,4,3,251422,251422,251425,0,3,1
71809,4,1,251426,251426,251427,0,1,1
71810,6,2,251432,251432,251434,0,2,5
71811,3,3,251435,251435,251438,0,3,1
71812,2,1,251437,251438,251439,1,2,0
71813,2,3,251439,251439,251442,0,3,0
71814,1,2,251440,251442,251444,2,4,0
71815,3,2,251443,251444,251446,1,3,0
71816,6,2,251449,251449,251451,0,2,3
71817,1,1,251450,251451,251452,1,2,0
71818,4,2,251454,251454,251456,0,2,2
71819,4,1,251458,251458,251459,0,1,2
71820,6,2,251464,251464,251466,0,2,5
71821,2,2,251466,251466,251468,0,2,0
71822,5,3,251471,251471,251474,0,3,3
71823,3,2,251474,251474,251476,0,2,0
71824,2,1,251476,251476,251477,0,1,0
71825,2,2,251478,251478,251480,0,2,1
71826,3,2,251481,251481,251483,0,2,1
71827,4,3,251485,251485,251488,0,3,2
71828,2,3,251487,251488,251491,1,4,0
71829,6,2,251493,251493,251495,0,2,2
71830,5,2,251498,251498,251500,0,2,3
71831,2,3,251500,251500,251503,0,3,0
71832,6,1,251506,251506,251507,0,1,3
71833,1,2,251507,251507,251509,0,2,0
71834,3,3,251510,251510,251513,0,3,1
71835,2,2,251512,251513,251515,1,3,0
71836,3,2,251515,251515,251517,0,2,0
71837,6,1,251521,251521,251522,0,1,4
71838,6,3,251527,251527,251530,0,3,5
71839,3,1,251530,251530,251531,0,1,0
71840,2,2,251532,251532,251534,0,2,1
71841,6,1,251538,251538,251539,0,1,4
71842,2,3,251540,251540,251543,0,3,1
71843,5,1,251545,251545,251546,0,1,2
71844,1,3,251546,251546,251549,0,3,0
71845,2,2,251548,251549,251551,1,3,0
71846,5,1,251553,251553,251554,0,1,2
71847,2,2,251555,251555,251557,0,2,1
71848,4,2,251559,251559,251561,0,2,2
71849,5,3,251564,251564,251567,0,3,3
71850,4,1,251568,251568,251569,0,1,1
71851,5,3,251573,251573,251576,0,3,4
71852,5,1,251578,251578,251579,0,1,2
71853,2,3,251580,251580,251583,0,3,1
71854,3,3,251583,251583,251586,0,3,0
71855,4,2,251587,251587,251589,0,2,1
71856,3,2,251590,251590,251592,0,2,1
71857,1,3,251591,251592,251595,1,4,0
71858,5,1,251596,251596,251597,0,1,1
71859,3,2,251599,251599,251601,0,2,2
71860,3,3,251602,251602,251605,0,3,1
71861,6,2,251608,251608,251610,0,2,3
71862,1,2,251609,251610,251612,1,3,0
71863,4,2,251613,251613,251615,0,2,1
71864,4,1,251617,251617,251618,0,1,2
71865,5,2,251622,251622,251624,0,2,4
71866,6,1,251628,251628,251629,0,1,4
71867,3,2,251631,251631,251633,0,2,2
71868,5,2,251636,251636,251638,0,2,3
71869,3,3,251639,251639,251642,0,3,1
71870,1,3,251640,251642,251645,2,5,0
71871,4,3,251644,251645,251648,1,4,0
71872,6,2,251650,251650,251652,0,2,2
71873,3,3,251653,251653,251656,0,3,1
71874,6,3,251659,251659,251662,0,3,3
71875,1,2,251660,251662,251664,2,4,0
71876,2,3,251662,251664,251667,2,5,0
71877,1,1,251663,251667,251668,4,5,0
71878,5,1,251668,251668,251669,0,1,0
71879,1,1,251669,251669,251670,0,1,0
71880,5,2,251674,251674,251676,0,2,4
71881,1,2,251675,251676,251678,1,3,0
71882,4,3,251679,251679,251682,0,3,1
71883,3,1,251682,251682,251683,0,1,0
71884,5,3,251687,251687,251690,0,3,4
71885,3,2,251690,251690,251692,0,2,0
71886,5,2,251695,251695,251697,0,2,3
71887,1,3,251696,251697,251700,1,4,0
71888,5,3,251701,251701,251704,0,3,1
71889,2,3,251703,251704,251707,1,4,0
71890,5,1,251708,251708,251709,0,1,1
71891,5,2,251713,251713,251715,0,2,4
71892,6,2,251719,251719,251721,0,2,4
71893,2,2,251721,251721,251723,0,2,0
71894,1,1,251722,251723,251724,1,2,0
71895,6,2,251728,251728,251730,0,2,4
71896,6,2,251734,251734,251736,0,2,4
71897,3,2,251737,251737,251739,0,2,1
71898,6,2,251743,251743,251745,0,2,4
71899,4,1,251747,251747,251748,0,1,2
71900,6,1,251753,251753,251754,0,1,5
71901,2,2,251755,251755,251757,0,2,1
71902,2,3,251757,251757,251760,0,3,0
71903,6,2,251763,251763,251765,0,2,3
71904,6,3,251769,251769,251772,0,3,4
71905,6,1,251775,251775,251776,0,1,3
71906,5,1,251780,251780,251781,0,1,4
71907,3,3,251783,251783,251786,0,3,2
71908,4,1,251787,251787,251788,0,1,1
71909,6,1,251793,251793,251794,0,1,5
71910,6,3,251799,251799,251802,0,3,5
71911,5,2,251804,251804,251806,0,2,2
71912,1,1,251805,251806,251807,1,2,0
71913,5,3,251810,251810,251813,0,3,3
71914,3,3,251813,251813,251816,0,3,0
71915,6,3,251819,251819,251822,0,3,3
71916,5,3,251824,251824,251827,0,3,2
71917,5,2,251829,251829,251831,0,2,2
71918,3,1,251832,251832,251833,0,1,1
71919,6,2,251838,251838,251840,0,2,5
71920,2,3,251840,251840,251843,0,3,0
71921,5,1,251845,251845,251846,0,1,2
71922,5,3,251850,251850,251853,0,3,4
71923,6,1,251856,251856,251857,0,1,3
71924,4,3,251860,251860,251863,0,3,3
71925,4,2,251864,251864,251866,0,2,1
71926,1,3,251865,251866,251869,1,4,0
71927,6,3,251871,251871,251874,0,3,2
71928,3,1,251874,251874,251875,0,1,0
71929,6,2,251880,251880,251882,0,2,5
71930,3,3,251883,251883,251886,0,3,1
71931,1,1,251884,251886,251887,2,3,0
71932,5,3,251889,251889,251892,0,3,2
71933,3,3,251892,251892,251895,0,3,0
71934,5,2,251897,251897,251899,0,2,2
71935,2,1,251899,251899,251900,0,1,0
71936,5,3,251904,251904,251907,0,3,4
71937,6,1,251910,251910,251911,0,1,3
71938,1,2,251911,251911,251913,0,2,0
71939,5,2,251916,251916,251918,0,2,3
71940,1,3,251917,251918,251921,1,4,0
71941,1,1,251918,251921,251922,3,4,0
71942,6,2,251924,251924,251926,0,2,2
71943,6,3,251930,251930,251933,0,3,4
71944,2,2,251932,251933,251935,1,3,0
71945,4,2,251936,251936,251938,0,2,1
71946,6,1,251942,251942,251943,0,1,4
71947,4,3,251946,251946,251949,0,3,3
71948,2,1,251948,251949,251950,1,2,0
71949,5,3,251953,251953,251956,0,3,3
71950,5,2,251958,251958,251960,0,2,2
71951,5,2,251963,251963,251965,0,2,3
71952,4,2,251967,251967,251969,0,2,2
71953,3,3,251970,251970,251973,0,3,1
71954,4,2,251974,251974,251976,0,2,1
71955,3,3,251977,251977,251980,0,3,1
71956,2,1,251979,251980,251981,1,2,0
71957,1,3,251980,251981,251984,1,4,0
71958,5,3,251985,251985,251988,0,3,1
71959,6,2,251991,251991,251993,0,2,3
71960,1,3,251992,251993,251996,1,4,0
71961,3,2,251995,251996,251998,1,3,0
71962,1,3,251996,251998,252001,2,5,0
71963,4,1,252000,252001,252002,1,2,0
71964,4,1,252004,252004,252005,0,1,2
71965,2,3,252006,252006,252009,0,3,1
71966,4,1,252010,252010,252011,0,1,1
71967,3,3,252013,252013,252016,0,3,2
71968,4,1,252017,252017,252018,0,1,1
71969,1,1,252018,252018,252019,0,1,0
71970,3,3,252021,252021,252024,0,3,2
71971,4,1,252025,252025,252026,0,1,1
71972,1,1,252026,252026,252027,0,1,0
71973,5,1,252031,252031,252032,0,1,4
71974,1,2,252032,252032,252034,0,2,0
71975,6,3,252038,252038,252041,0,3,4
71976,6,3,252044,252044,252047,0,3,3
71977,1,2,252045,252047,252049,2,4,0
71978,1,3,252046,252049,252052,3,6,0
71979,1,1,252047,252052,252053,5,6,0
71980,3,2,252050,252053,252055,3,5,0
71981,1,3,252051,252055,252058,4,7,0
71982,4,1,252055,252058,252059,3,4,0
71983,4,1,252059,252059,252060,0,1,0
71984,6,3,252065,252065,252068,0,3,5
71985,2,2,252067,252068,252070,1,3,0
71986,6,2,252073,252073,252075,0,2,3
71987,6,3,252079,252079,252082,0,3,4
71988,2,3,252081,252082,252085,1,4,0
71989,2,1,252083,252085,252086,2,3,0
71990,6,3,252089,252089,252092,0,3,3
71991,2,3,252091,252092,252095,1,4,0
71992,1,2,252092,252095,252097,3,5,0
71993,3,3,252095,252097,252100,2,5,0
71994,1,1,252096,252100,252101,4,5,0
71995,1,2,252097,252101,252103,4,6,0
71996,4,3,252101,252103,252106,2,5,0
71997,2,3,252103,252106,252109,3,6,0
71998,6,1,252109,252109,252110,0,1,0
71999,2,3,252111,252111,252114,0,3,1
72000,3,3,252114,252114,252117,0,3,0
72001,3,3,252117,252117,252120,0,3,0
72002,2,2,252119,252120,252122,1,3,0
72003,6,3,252125,252125,252128,0,3,3
72004,4,1,252129,252129,252130,0,1,1
72005,5,3,252134,252134,252137,0,3,4
72006,3,2,252137,252137,252139,0,2,0
72007,4,3,252141,252141,252144,0,3,2
72008,3,1,252144,252144,252145,0,1,0
72009,5,2,252149,252149,252151,0,2,4
72010,6,1,252155,252155,252156,0,1,4
72011,4,2,252159,252159,252161,0,2,3
72012,2,3,252161,252161,252164,0,3,0
72013,6,2,252167,252167,252169,0,2,3
72014,2,2,252169,252169,252171,0,2,0
72015,4,3,252173,252173,252176,0,3,2
72016,5,1,252178,252178,252179,0,1,2
72017,5,2,252183,252183,252185,0,2,4
72018,1,2,252184,252185,252187,1,3,0
72019,4,1,252188,252188,252189,0,1,1
72020,4,3,252192,252192,252195,0,3,3
72021,5,2,252197,252197,252199,0,2,2
72022,6,3,252203,252203,252206,0,3,4
72023,6,3,252209,252209,252212,0,3,3
72024,6,3,252215,252215,252218,0,3,3
72025,1,2,252216,252218,252220,2,4,0
72026,6,2,252222,252222,252224,0,2,2
72027,2,2,252224,252224,252226,0,2,0
72028,3,1,252227,252227,252228,0,1,1
72029,1,3,252228,252228,252231,0,3,0
72030,2,3,252230,252231,252234,1,4,0
72031,5,3,252235,252235,252238,0,3,1
72032,2,3,252237,252238,252241,1,4,0
72033,1,2,252238,252241,252243,3,5,0
72034,6,3,252244,252244,252247,0,3,1
72035,6,2,252250,252250,252252,0,2,3
72036,4,1,252254,252254,252255,0,1,2
72037,1,1,252255,252255,252256,0,1,0
72038,3,3,252258,252258,252261,0,3,2
72039,1,2,252259,252261,252263,2,4,0
72040,2,2,252261,252263,252265,2,4,0
72041,5,1,252266,252266,252267,0,1,1
72042,3,2,252269,252269,252271,0,2,2
72043,2,3,252271,252271,252274,0,3,0
72044,4,1,252275,252275,252276,0,1,1
72045,3,2,252278,252278,252280,0,2,2
72046,6,2,252284,252284,252286,0,2,4
72047,6,3,252290,252290,252293,0,3,4
72048,5,2,252295,252295,252297,0,2,2
72049,4,2,252299,252299,252301,0,2,2
72050,6,1,252305,252305,252306,0,1,4
72051,6,2,252311,252311,252313,0,2,5
72052,2,2,252313,252313,252315,0,2,0
72053,4,1,252317,252317,252318,0,1,2
72054,6,3,252323,252323,252326,0,3,5
72055,3,1,252326,252326,252327,0,1,0
72056,5,1,252331,252331,252332,0,1,4
72057,4,3,252335,252335,252338,0,3,3
72058,1,2,252336,252338,252340,2,4,0
72059,6,1,252342,252342,252343,0,1,2
72060,3,3,252345,252345,252348,0,3,2
72061,2,2,252347,252348,252350,1,3,0
72062,3,1,252350,252350,252351,0,1,0
72063,5,3,252355,252355,252358,0,3,4
72064,2,2,252357,252358,252360,1,3,0
72065,2,2,252359,252360,252362,1,3,0
72066,5,2,252364,252364,252366,0,2,2
72067,5,2,252369,252369,252371,0,2,3
72068,6,1,252375,252375,252376,0,1,4
72069,5,1,252380,252380,252381,0,1,4
72070,1,3,252381,252381,252384,0,3,0
72071,3,2,252384,252384,252386,0,2,0
72072,6,3,252390,252390,252393,0,3,4
72073,5,2,252395,252395,252397,0,2,2
72074,6,1,252401,252401,252402,0,1,4
72075,2,1,252403,252403,252404,0,1,1
72076,3,1,252406,252406,252407,0,1,2
72077,5,3,252411,252411,252414,0,3,4
72078,6,2,252417,252417,252419,0,2,3
72079,6,1,252423,252423,252424,0,1,4
72080,1,3,252424,252424,252427,0,3,0
72081,3,3,252427,252427,252430,0,3,0
72082,4,2,252431,252431,252433,0,2,1
72083,4,3,252435,252435,252438,0,3,2
72084,3,1,252438,252438,252439,0,1,0
72085,6,1,252444,252444,252445,0,1,5
72086,2,2,252446,252446,252448,0,2,1
72087,2,3,252448,252448,252451,0,3,0
72088,5,2,252453,252453,252455,0,2,2
72089,5,1,252458,252458,252459,0,1,3
72090,2,2,252460,252460,252462,0,2,1
72091,1,3,252461,252462,252465,1,4,0
72092,1,1,252462,252465,252466,3,4,0
72093,6,3,252468,252468,252471,0,3,2
72094,1,2,252469,252471,252473,2,4,0
72095,5,1,252474,252474,252475,0,1,1
72096,5,3,252479,252479,252482,0,3,4
72097,6,3,252485,252485,252488,0,3,3
72098,6,2,252491,252491,252493,0,2,3
72099,4,3,252495,252495,252498,0,3,2
72100,2,2,252497,252498,252500,1,3,0
72101,1,1,252498,252500,252501,2,3,0
72102,5,3,252503,252503,252506,0,3,2
72103,4,3,252507,252507,252510,0,3,1
72104,1,1,252508,252510,252511,2,3,0
72105,4,3,252512,252512,252515,0,3,1
72106,3,1,252515,252515,252516,0,1,0
72107,5,3,252520,252520,252523,0,3,4
72108,5,2,252525,252525,252527,0,2,2
72109,2,2,252527,252527,252529,0,2,0
72110,3,2,252530,252530,252532,0,2,1
72111,3,3,252533,252533,252536,0,3,1
72112,5,3,252538,252538,252541,0,3,2
72113,5,3,252543,252543,252546,0,3,2
72114,3,3,252546,252546,252549,0,3,0
72115,3,1,252549,252549,252550,0,1,0
72116,4,2,252553,252553,252555,0,2,3
72117,3,3,252556,252556,252559,0,3,1
72118,4,3,252560,252560,252563,0,3,1
72119,2,3,252562,252563,252566,1,4,0
72120,5,3,252567,252567,252570,0,3,1
72121,4,3,252571,252571,252574,0,3,1
72122,4,1,252575,252575,252576,0,1,1
72123,4,3,252579,252579,252582,0,3,3
72124,6,1,252585,252585,252586,0,1,3
72125,1,3,252586,252586,252589,0,3,0
72126,6,1,252592,252592,252593,0,1,3
72127,6,2,252598,252598,252600,0,2,5
72128,6,3,252604,252604,252607,0,3,4
72129,4,2,252608,252608,252610,0,2,1
72130,6,1,252614,252614,252615,0,1,4
72131,5,3,252619,252619,252622,0,3,4
72132,3,3,252622,252622,252625,0,3,0
72133,2,1,252624,252625,252626,1,2,0
72134,1,2,252625,252626,252628,1,3,0
72135,2,2,252627,252628,252630,1,3,0
72136,4,1,252631,252631,252632,0,1,1
72137,5,3,252636,252636,252639,0,3,4
72138,6,1,252642,252642,252643,0,1,3
72139,1,2,252643,252643,252645,0,2,0
72140,6,1,252649,252649,252650,0,1,4
72141,1,3,252650,252650,252653,0,3,0
72142,2,1,252652,252653,252654,1,2,0
72143,4,2,252656,252656,252658,0,2,2
72144,4,2,252660,252660,252662,0,2,2
72145,2,1,252662,252662,252663,0,1,0
72146,1,3,252663,252663,252666,0,3,0
72147,2,1,252665,252666,252667,1,2,0
72148,5,1,252670,252670,252671,0,1,3
72149,2,2,252672,252672,252674,0,2,1
72150,6,1,252678,252678,252679,0,1,4
72151,5,1,252683,252683,252684,0,1,4
72152,6,3,252689,252689,252692,0,3,5
72153,3,1,252692,252692,252693,0,1,0
72154,5,2,252697,252697,252699,0,2,4
72155,2,2,252699,252699,252701,0,2,0
72156,5,2,252704,252704,252706,0,2,3
72157,2,2,252706,252706,252708,0,2,0
72158,1,1,252707,252708,252709,1,2,0
72159,4,2,252711,252711,252713,0,2,2
72160,6,2,252717,252717,252719,0,2,4
72161,6,3,252723,252723,252726,0,3,4
72162,1,2,252724,252726,252728,2,4,0
72163,2,2,252726,252728,252730,2,4,0
72164,5,3,252731,252731,252734,0,3,1
72165,1,2,252732,252734,252736,2,4,0
72166,1,3,252733,252736,252739,3,6,0
72167,2,1,252735,252739,252740,4,5,0
72168,2,3,252737,252740,252743,3,6,0
72169,6,3,252743,252743,252746,0,3,0
72170,2,3,252745,252746,252749,1,4,0
72171,5,3,252750,252750,252753,0,3,1
72172,6,1,252756,252756,252757,0,1,3
72173,4,1,252760,252760,252761,0,1,3
72174,2,2,252762,252762,252764,0,2,1
72175,5,1,252767,252767,252768,0,1,3
72176,1,2,252768,252768,252770,0,2,0
72177,2,3,252770,252770,252773,0,3,0
72178,6,3,252776,252776,252779,0,3,3
72179,3,3,252779,252779,252782,0,3,0
72180,3,3,252782,252782,252785,0,3,0
72181,6,3,252788,252788,252791,0,3,3
72182,2,2,252790,252791,252793,1,3,0
72183,2,3,252792,252793,252796,1,4,0
72184,6,2,252798,252798,252800,0,2,2
72185,5,1,252803,252803,252804,0,1,3
72186,6,3,252809,252809,252812,0,3,5
72187,1,1,252810,252812,252813,2,3,0
72188,6,3,252816,252816,252819,0,3,3
72189,2,3,252818,252819,252822,1,4,0
72190,5,2,252823,252823,252825,0,2,1
72191,5,3,252828,252828,252831,0,3,3
72192,4,1,252832,252832,252833,0,1,1
72193,2,3,252834,252834,252837,0,3,1
72194,4,1,252838,252838,252839,0,1,1
72195,5,2,252843,252843,252845,0,2,4
72196,3,3,252846,252846,252849,0,3,1
72197,4,2,252850,252850,252852,0,2,1
72198,4,2,252854,252854,252856,0,2,2
72199,4,1,252858,252858,252859,0,1,2
72200,6,3,252864,252864,252867,0,3,5
72201,3,2,252867,252867,252869,0,2,0
72202,4,1,252871,252871,252872,0,1,2
72203,6,2,252877,252877,252879,0,2,5
72204,4,3,252881,252881,252884,0,3,2
72205,5,3,252886,252886,252889,0,3,2
72206,1,2,252887,252889,252891,2,4,0
72207,3,2,252890,252891,252893,1,3,0
72208,5,1,252895,252895,252896,0,1,2
72209,3,3,252898,252898,252901,0,3,2
72210,6,3,252904,252904,252907,0,3,3
72211,4,1,252908,252908,252909,0,1,1
72212,1,2,252909,252909,252911,0,2,0
72213,4,1,252913,252913,252914,0,1,2
72214,4,2,252917,252917,252919,0,2,3
72215,4,3,252921,252921,252924,0,3,2
72216,3,1,252924,252924,252925,0,1,0
72217,2,1,252926,252926,252927,0,1,1
72218,1,1,252927,252927,252928,0,1,0
72219,2,1,252929,252929,252930,0,1,1
72220,3,3,252932,252932,252935,0,3,2
72221,4,2,252936,252936,252938,0,2,1
72222,5,1,252941,252941,252942,0,1,3
72223,3,1,252944,252944,252945,0,1,2
72224,6,1,252950,252950,252951,0,1,5
72225,3,1,252953,252953,252954,0,1,2
72226,5,1,252958,252958,252959,0,1,4
72227,2,3,252960,252960,252963,0,3,1
72228,1,3,252961,252963,252966,2,5,0
72229,5,3,252966,252966,252969,0,3,0
72230,2,3,252968,252969,252972,1,4,0
72231,2,2,252970,252972,252974,2,4,0
72232,3,3,252973,252974,252977,1,4,0
72233,3,1,252976,252977,252978,1,2,0
72234,2,2,252978,252978,252980,0,2,0
72235,4,2,252982,252982,252984,0,2,2
72236,5,3,252987,252987,252990,0,3,3
72237,1,3,252988,252990,252993,2,5,0
72238,2,3,252990,252993,252996,3,6,0
72239,2,3,252992,252996,252999,4,7,0
72240,3,1,252995,252999,253000,4,5,0
72241,3,1,252998,253000,253001,2,3,0
72242,4,1,253002,253002,253003,0,1,1
72243,2,1,253004,253004,253005,0,1,1
72244,3,1,253007,253007,253008,0,1,2
72245,6,3,253013,253013,253016,0,3,5
72246,6,3,253019,253019,253022,0,3,3
72247,6,1,253025,253025,253026,0,1,3
72248,5,1,253030,253030,253031,0,1,4
72249,2,3,253032,253032,253035,0,3,1
72250,2,1,253034,253035,253036,1,2,0
72251,5,1,253039,253039,253040,0,1,3
72252,5,1,253044,253044,253045,0,1,4
72253,6,3,253050,253050,253053,0,3,5
72254,3,3,253053,253053,253056,0,3,0
72255,5,1,253058,253058,253059,0,1,2
72256,2,3,253060,253060,253063,0,3,1
72257,5,2,253065,253065,253067,0,2,2
72258,5,2,253070,253070,253072,0,2,3
72259,6,3,253076,253076,253079,0,3,4
72260,6,2,253082,253082,253084,0,2,3
72261,3,2,253085,253085,253087,0,2,1
72262,3,3,253088,253088,253091,0,3,1
72263,3,1,253091,253091,253092,0,1,0
72264,2,1,253093,253093,253094,0,1,1
72265,6,1,253099,253099,253100,0,1,5
72266,5,1,253104,253104,253105,0,1,4
72267,3,2,253107,253107,253109,0,2,2
72268,5,3,253112,253112,253115,0,3,3
72269,5,2,253117,253117,253119,0,2,2
72270,2,1,253119,253119,253120,0,1,0
72271,4,3,253123,253123,253126,0,3,3
72272,4,2,253127,253127,253129,0,2,1
72273,2,2,253129,253129,253131,0,2,0
72274,3,1,253132,253132,253133,0,1,1
72275,1,1,253133,253133,253134,0,1,0
72276,1,1,253134,253134,253135,0,1,0
72277,2,3,253136,253136,253139,0,3,1
72278,6,2,253142,253142,253144,0,2,3
72279,3,2,253145,253145,253147,0,2,1
72280,6,1,253151,253151,253152,0,1,4
72281,5,3,253156,253156,253159,0,3,4
72282,5,1,253161,253161,253162,0,1,2
72283,1,1,253162,253162,253163,0,1,0
72284,6,2,253168,253168,253170,0,2,5
72285,1,1,253169,253170,253171,1,2,0
72286,5,1,253174,253174,253175,0,1,3
72287,2,2,253176,253176,253178,0,2,1
72288,1,1,253177,253178,253179,1,2,0
72289,6,2,253183,253183,253185,0,2,4
72290,2,1,253185,253185,253186,0,1,0
72291,2,3,253187,253187,253190,0,3,1
72292,2,2,253189,253190,253192,1,3,0
72293,4,1,253193,253193,253194,0,1,1
72294,5,3,253198,253198,253201,0,3,4
72295,2,3,253200,253201,253204,1,4,0
72296,6,2,253206,253206,253208,0,2,2
72297,1,3,253207,253208,253211,1,4,0
72298,5,1,253212,253212,253213,0,1,1
72299,2,1,253214,253214,253215,0,1,1
72300,2,2,253216,253216,253218,0,2,1
72301,3,1,253219,253219,253220,0,1,1
72302,5,3,253224,253224,253227,0,3,4
72303,3,2,253227,253227,253229,0,2,0
72304,5,3,253232,253232,253235,0,3,3
72305,6,2,253238,253238,253240,0,2,3
72306,6,1,253244,253244,253245,0,1,4
72307,1,3,253245,253245,253248,0,3,0
72308,6,2,253251,253251,253253,0,2,3
72309,6,2,253257,253257,253259,0,2,4
72310,1,1,253258,253259,253260,1,2,0
72311,4,1,253262,253262,253263,0,1,2
72312,2,3,253264,253264,253267,0,3,1
72313,1,2,253265,253267,253269,2,4,0
72314,4,3,253269,253269,253272,0,3,0
72315,1,2,253270,253272,253274,2,4,0
72316,6,2,253276,253276,253278,0,2,2
72317,3,2,253279,253279,253281,0,2,1
72318,1,2,253280,253281,253283,1,3,0
72319,3,3,253283,253283,253286,0,3,0
72320,5,1,253288,253288,253289,0,1,2
72321,3,1,253291,253291,253292,0,1,2
72322,1,1,253292,253292,253293,0,1,0
72323,5,1,253297,253297,253298,0,1,4
72324,6,2,253303,253303,253305,0,2,5
72325,1,3,253304,253305,253308,1,4,0
72326,6,3,253310,253310,253313,0,3,2
72327,5,1,253315,253315,253316,0,1,2
72328,1,1,253316,253316,253317,0,1,0
72329,6,2,253322,253322,253324,0,2,5
72330,2,1,253324,253324,253325,0,1,0
72331,6,1,253330,253330,253331,0,1,5
72332,2,3,253332,253332,253335,0,3,1
72333,6,3,253338,253338,253341,0,3,3
72334,3,1,253341,253341,253342,0,1,0
72335,4,2,253345,253345,253347,0,2,3
72336,4,1,253349,253349,253350,0,1,2
72337,1,2,253350,253350,253352,0,2,0
72338,1,1,253351,253352,253353,1,2,0
72339,6,2,253357,253357,253359,0,2,4
72340,3,1,253360,253360,253361,0,1,1
72341,6,3,253366,253366,253369,0,3,5
72342,1,3,253367,253369,253372,2,5,0
72343,2,1,253369,253372,253373,3,4,0
72344,1,2,253370,253373,253375,3,5,0
72345,5,2,253375,253375,253377,0,2,0
72346,4,3,253379,253379,253382,0,3,2
72347,4,1,253383,253383,253384,0,1,1
72348,2,3,253385,253385,253388,0,3,1
72349,1,3,253386,253388,253391,2,5,0
72350,2,2,253388,253391,253393,3,5,0
72351,6,1,253394,253394,253395,0,1,1
72352,6,3,253400,253400,253403,0,3,5
72353,4,3,253404,253404,253407,0,3,1
72354,6,3,253410,253410,253413,0,3,3
72355,2,1,253412,253413,253414,1,2,0
72356,1,2,253413,253414,253416,1,3,0
72357,5,1,253418,253418,253419,0,1,2
72358,6,1,253424,253424,253425,0,1,5
72359,6,2,253430,253430,253432,0,2,5
72360,2,2,253432,253432,253434,0,2,0
72361,4,1,253436,253436,253437,0,1,2
72362,3,1,253439,253439,253440,0,1,2
72363,2,2,253441,253441,253443,0,2,1
72364,6,1,253447,253447,253448,0,1,4
72365,4,1,253451,253451,253452,0,1,3
72366,2,3,253453,253453,253456,0,3,1
72367,2,1,253455,253456,253457,1,2,0
72368,1,1,253456,253457,253458,1,2,0
72369,2,2,253458,253458,253460,0,2,0
72370,4,2,253462,253462,253464,0,2,2
72371,1,1,253463,253464,253465,1,2,0
72372,5,2,253468,253468,253470,0,2,3
72373,3,1,253471,253471,253472,0,1,1
72374,3,2,253474,253474,253476,0,2,2
72375,2,2,253476,253476,253478,0,2,0
72376,1,2,253477,253478,253480,1,3,0
72377,4,1,253481,253481,253482,0,1,1
72378,4,2,253485,253485,253487,0,2,3
72379,2,1,253487,253487,253488,0,1,0
72380,6,2,253493,253493,253495,0,2,5
72381,4,2,253497,253497,253499,0,2,2
72382,3,2,253500,253500,253502,0,2,1
72383,3,3,253503,253503,253506,0,3,1
72384,1,1,253504,253506,253507,2,3,0
72385,6,2,253510,253510,253512,0,2,3
72386,3,1,253513,253513,253514,0,1,1
72387,3,2,253516,253516,253518,0,2,2
72388,1,1,253517,253518,253519,1,2,0
72389,1,3,253518,253519,253522,1,4,0
72390,4,2,253522,253522,253524,0,2,0
72391,2,2,253524,253524,253526,0,2,0
72392,2,1,253526,253526,253527,0,1,0
72393,5,1,253531,253531,253532,0,1,4
72394,2,1,253533,253533,253534,0,1,1
72395,3,1,253536,253536,253537,0,1,2
72396,6,3,253542,253542,253545,0,3,5
72397,5,1,253547,253547,253548,0,1,2
72398,2,2,253549,253549,253551,0,2,1
72399,4,2,253553,253553,253555,0,2,2
72400,3,1,253556,253556,253557,0,1,1
72401,3,1,253559,253559,253560,0,1,2
72402,6,3,253565,253565,253568,0,3,5
72403,6,3,253571,253571,253574,0,3,3
72404,1,3,253572,253574,253577,2,5,0
72405,1,3,253573,253577,253580,4,7,0
72406,1,2,253574,253580,253582,6,8,0
72407,4,3,253578,253582,253585,4,7,0
72408,4,3,253582,253585,253588,3,6,0
72409,2,1,253584,253588,253589,4,5,0
72410,2,1,253586,253589,253590,3,4,0
72411,5,2,253591,253591,253593,0,2,1
72412,5,2,253596,253596,253598,0,2,3
72413,6,2,253602,253602,253604,0,2,4
72414,2,2,253604,253604,253606,0,2,0
72415,3,2,253607,253607,253609,0,2,1
72416,1,3,253608,253609,253612,1,4,0
72417,1,2,253609,253612,253614,3,5,0
72418,5,1,253614,253614,253615,0,1,0
72419,5,1,253619,253619,253620,0,1,4
72420,2,1,253621,253621,253622,0,1,1
72421,2,2,253623,253623,253625,0,2,1
72422,5,3,253628,253628,253631,0,3,3
72423,2,1,253630,253631,253632,1,2,0
72424,2,2,253632,253632,253634,0,2,0
72425,4,2,253636,253636,253638,0,2,2
72426,1,2,253637,253638,253640,1,3,0
72427,2,3,253639,253640,253643,1,4,0
72428,5,2,253644,253644,253646,0,2,1
72429,6,1,253650,253650,253651,0,1,4
72430,2,2,253652,253652,253654,0,2,1
72431,6,1,253658,253658,253659,0,1,4
72432,4,3,253662,253662,253665,0,3,3
72433,1,3,253663,253665,253668,2,5,0
72434,1,1,253664,253668,253669,4,5,0
72435,4,3,253668,253669,253672,1,4,0
72436,6,1,253674,253674,253675,0,1,2
72437,3,3,253677,253677,253680,0,3,2
72438,4,3,253681,253681,253684,0,3,1
72439,3,1,253684,253684,253685,0,1,0
72440,5,1,253689,253689,253690,0,1,4
72441,5,3,253694,253694,253697,0,3,4
72442,3,1,253697,253697,253698,0,1,0
72443,6,2,253703,253703,253705,0,2,5
72444,2,3,253705,253705,253708,0,3,0
72445,3,2,253708,253708,253710,0,2,0
72446,4,3,253712,253712,253715,0,3,2
72447,6,3,253718,253718,253721,0,3,3
72448,5,3,253723,253723,253726,0,3,2
72449,1,1,253724,253726,253727,2,3,0
72450,3,2,253727,253727,253729,0,2,0
72451,3,3,253730,253730,253733,0,3,1
72452,1,1,253731,253733,253734,2,3,0
72453,6,2,253737,253737,253739,0,2,3
72454,5,2,253742,253742,253744,0,2,3
72455,5,2,253747,253747,253749,0,2,3
72456,2,2,253749,253749,253751,0,2,0
72457,4,2,253753,253753,253755,0,2,2
72458,3,3,253756,253756,253759,0,3,1
72459,3,2,253759,253759,253761,0,2,0
72460,5,2,253764,253764,253766,0,2,3
72461,4,2,253768,253768,253770,0,2,2
72462,5,3,253773,253773,253776,0,3,3
72463,3,1,253776,253776,253777,0,1,0
72464,5,3,253781,253781,253784,0,3,4
72465,1,2,253782,253784,253786,2,4,0
72466,5,3,253787,253787,253790,0,3,1
72467,2,2,253789,253790,253792,1,3,0
72468,6,3,253795,253795,253798,0,3,3
72469,5,2,253800,253800,253802,0,2,2
72470,4,1,253804,253804,253805,0,1,2
72471,6,2,253810,253810,253812,0,2,5
72472,4,3,253814,253814,253817,0,3,2
72473,1,3,253815,253817,253820,2,5,0
72474,3,1,253818,253820,253821,2,3,0
72475,5,2,253823,253823,253825,0,2,2
72476,4,1,253827,253827,253828,0,1,2
72477,3,2,253830,253830,253832,0,2,2
72478,4,3,253834,253834,253837,0,3,2
72479,6,3,253840,253840,253843,0,3,3
72480,1,3,253841,253843,253846,2,5,0
72481,1,3,253842,253846,253849,4,7,0
72482,6,1,253848,253849,253850,1,2,0
72483,1,1,253849,253850,253851,1,2,0
72484,2,2,253851,253851,253853,0,2,0
72485,2,2,253853,253853,253855,0,2,0
72486,5,1,253858,253858,253859,0,1,3
72487,6,1,253864,253864,253865,0,1,5
72488,3,3,253867,253867,253870,0,3,2
72489,3,1,253870,253870,253871,0,1,0
72490,2,1,253872,253872,253873,0,1,1
72491,6,2,253878,253878,253880,0,2,5
72492,1,2,253879,253880,253882,1,3,0
72493,4,3,253883,253883,253886,0,3,1
72494,4,2,253887,253887,253889,0,2,1
72495,5,1,253892,253892,253893,0,1,3
72496,5,3,253897,253897,253900,0,3,4
72497,1,3,253898,253900,253903,2,5,0
72498,3,2,253901,253903,253905,2,4,0
72499,2,1,253903,253905,253906,2,3,0
72500,5,3,253908,253908,253911,0,3,2
72501,2,2,253910,253911,253913,1,3,0
72502,5,2,253915,253915,253917,0,2,2
72503,6,3,253921,253921,253924,0,3,4
72504,3,1,253924,253924,253925,0,1,0
72505,1,3,253925,253925,253928,0,3,0
72506,4,3,253929,253929,253932,0,3,1
72507,4,2,253933,253933,253935,0,2,1
72508,4,3,253937,253937,253940,0,3,2
72509,5,3,253942,253942,253945,0,3,2
72510,4,2,253946,253946,253948,0,2,1
72511,6,1,253952,253952,253953,0,1,4
72512,2,3,253954,253954,253957,0,3,1
72513,1,3,253955,253957,253960,2,5,0
72514,6,2,253961,253961,253963,0,2,1
72515,4,3,253965,253965,253968,0,3,2
72516,1,3,253966,253968,253971,2,5,0
72517,3,2,253969,253971,253973,2,4,0
72518,2,1,253971,253973,253974,2,3,0
72519,1,2,253972,253974,253976,2,4,0
72520,3,2,253975,253976,253978,1,3,0
72521,6,2,253981,253981,253983,0,2,3
72522,5,3,253986,253986,253989,0,3,3
72523,4,3,253990,253990,253993,0,3,1
72524,2,3,253992,253993,253996,1,4,0
72525,4,1,253996,253996,253997,0,1,0
72526,2,1,253998,253998,253999,0,1,1
72527,3,2,254001,254001,254003,0,2,2
72528,1,2,254002,254003,254005,1,3,0
72529,4,2,254006,254006,254008,0,2,1
72530,6,1,254012,254012,254013,0,1,4
72531,6,3,254018,254018,254021,0,3,5
72532,1,1,254019,254021,254022,2,3,0
72533,5,3,254024,254024,254027,0,3,2
72534,6,3,254030,254030,254033,0,3,3
72535,6,2,254036,254036,254038,0,2,3
72536,4,3,254040,254040,254043,0,3,2
72537,5,1,254045,254045,254046,0,1,2
72538,2,3,254047,254047,254050,0,3,1
72539,5,3,254052,254052,254055,0,3,2
72540,4,1,254056,254056,254057,0,1,1
72541,4,1,254060,254060,254061,0,1,3
72542,5,1,254065,254065,254066,0,1,4
72543,2,3,254067,254067,254070,0,3,1
72544,6,2,254073,254073,254075,0,2,3
72545,6,2,254079,254079,254081,0,2,4
72546,5,3,254084,254084,254087,0,3,3
72547,6,2,254090,254090,254092,0,2,3
72548,2,1,254092,254092,254093,0,1,0
72549,5,1,254097,254097,254098,0,1,4
72550,1,1,254098,254098,254099,0,1,0
72551,3,3,254101,254101,254104,0,3,2
72552,2,1,254103,254104,254105,1,2,0
72553,3,1,254106,254106,254107,0,1,1
72554,5,2,254111,254111,254113,0,2,4
72555,4,2,254115,254115,254117,0,2,2
72556,6,3,254121,254121,254124,0,3,4
72557,4,1,254125,254125,254126,0,1,1
72558,3,1,254128,254128,254129,0,1,2
72559,5,2,254133,254133,254135,0,2,4
72560,3,1,254136,254136,254137,0,1,1
72561,1,2,254137,254137,254139,0,2,0
72562,6,2,254143,254143,254145,0,2,4
72563,3,1,254146,254146,254147,0,1,1
72564,1,2,254147,254147,254149,0,2,0
72565,6,3,254153,254153,254156,0,3,4
72566,2,1,254155,254156,254157,1,2,0
72567,6,1,254161,254161,254162,0,1,4
72568,3,2,254164,254164,254166,0,2,2
72569,6,2,254170,254170,254172,0,2,4
72570,1,2,254171,254172,254174,1,3,0
72571,3,3,254174,254174,254177,0,3,0
72572,5,1,254179,254179,254180,0,1,2
72573,2,1,254181,254181,254182,0,1,1
72574,3,1,254184,254184,254185,0,1,2
72575,6,2,254190,254190,254192,0,2,5
72576,4,3,254194,254194,254197,0,3,2
72577,4,2,254198,254198,254200,0,2,1
72578,6,2,254204,254204,254206,0,2,4
72579,2,1,254206,254206,254207,0,1,0
72580,4,1,254210,254210,254211,0,1,3
72581,5,1,254215,254215,254216,0,1,4
72582,5,2,254220,254220,254222,0,2,4
72583,4,3,254224,254224,254227,0,3,2
72584,4,1,254228,254228,254229,0,1,1
72585,2,3,254230,254230,254233,0,3,1
72586,3,3,254233,254233,254236,0,3,0
72587,5,3,254238,254238,254241,0,3,2
72588,6,2,254244,254244,254246,0,2,3
72589,3,2,254247,254247,254249,0,2,1
72590,6,3,254253,254253,254256,0,3,4
72591,6,3,254259,254259,254262,0,3,3
72592,4,1,254263,254263,254264,0,1,1
72593,1,1,254264,254264,254265,0,1,0
72594,4,1,254268,254268,254269,0,1,3
72595,3,1,254271,254271,254272,0,1,2
72596,6,2,254277,254277,254279,0,2,5
72597,3,1,254280,254280,254281,0,1,1
72598,6,1,254286,254286,254287,0,1,5
72599,3,1,254289,254289,254290,0,1,2
72600,5,1,254294,254294,254295,0,1,4
72601,1,2,254295,254295,254297,0,2,0
72602,3,3,254298,254298,254301,0,3,1
72603,1,2,254299,254301,254303,2,4,0
72604,5,3,254304,254304,254307,0,3,1
72605,5,2,254309,254309,254311,0,2,2
72606,6,3,254315,254315,254318,0,3,4
72607,3,1,254318,254318,254319,0,1,0
72608,1,3,254319,254319,254322,0,3,0
72609,3,1,254322,254322,254323,0,1,0
72610,2,2,254324,254324,254326,0,2,1
72611,4,3,254328,254328,254331,0,3,2
72612,4,2,254332,254332,254334,0,2,1
72613,5,2,254337,254337,254339,0,2,3
72614,1,3,254338,254339,254342,1,4,0
72615,4,2,254342,254342,254344,0,2,0
72616,6,3,254348,254348,254351,0,3,4
72617,2,1,254350,254351,254352,1,2,0
72618,6,1,254356,254356,254357,0,1,4
72619,1,1,254357,254357,254358,0,1,0
72620,6,1,254363,254363,254364,0,1,5
72621,4,1,254367,254367,254368,0,1,3
72622,5,3,254372,254372,254375,0,3,4
72623,6,3,254378,254378,254381,0,3,3
72624,5,3,254383,254383,254386,0,3,2
72625,4,2,254387,254387,254389,0,2,1
72626,4,2,254391,254391,254393,0,2,2
72627,4,2,254395,254395,254397,0,2,2
72628,4,2,254399,254399,254401,0,2,2
72629,6,1,254405,254405,254406,0,1,4
72630,5,3,254410,254410,254413,0,3,4
72631,2,3,254412,254413,254416,1,4,0
72632,2,3,254414,254416,254419,2,5,0
72633,5,2,254419,254419,254421,0,2,0
72634,6,3,254425,254425,254428,0,3,4
72635,5,2,254430,254430,254432,0,2,2
72636,2,2,254432,254432,254434,0,2,0
72637,5,1,254437,254437,254438,0,1,3
72638,1,1,254438,254438,254439,0,1,0
72639,2,3,254440,254440,254443,0,3,1
72640,5,3,254445,254445,254448,0,3,2
72641,5,2,254450,254450,254452,0,2,2
72642,6,2,254456,254456,254458,0,2,4
72643,1,1,254457,254458,254459,1,2,0
72644,1,3,254458,254459,254462,1,4,0
72645,6,1,254464,254464,254465,0,1,2
72646,6,1,254470,254470,254471,0,1,5
72647,1,3,254471,254471,254474,0,3,0
72648,2,2,254473,254474,254476,1,3,0
72649,3,3,254476,254476,254479,0,3,0
72650,3,3,254479,254479,254482,0,3,0
72651,4,3,254483,254483,254486,0,3,1
72652,4,2,254487,254487,254489,0,2,1
72653,6,2,254493,254493,254495,0,2,4
72654,1,2,254494,254495,254497,1,3,0
72655,3,1,254497,254497,254498,0,1,0
72656,3,3,254500,254500,254503,0,3,2
72657,3,1,254503,254503,254504,0,1,0
72658,2,1,254505,254505,254506,0,1,1
72659,5,2,254510,254510,254512,0,2,4
72660,1,3,254511,254512,254515,1,4,0
72661,3,3,254514,254515,254518,1,4,0
72662,3,3,254517,254518,254521,1,4,0
72663,5,2,254522,254522,254524,0,2,1
72664,1,1,254523,254524,254525,1,2,0
72665,6,1,254529,254529,254530,0,1,4
72666,3,2,254532,254532,254534,0,2,2
72667,5,2,254537,254537,254539,0,2,3
72668,1,3,254538,254539,254542,1,4,0
72669,6,2,254544,254544,254546,0,2,2
72670,3,3,254547,254547,254550,0,3,1
72671,5,3,254552,254552,254555,0,3,2
72672,2,2,254554,254555,254557,1,3,0
72673,5,3,254559,254559,254562,0,3,2
72674,6,1,254565,254565,254566,0,1,3
72675,1,3,254566,254566,254569,0,3,0
72676,4,2,254570,254570,254572,0,2,1
72677,5,2,254575,254575,254577,0,2,3
72678,2,2,254577,254577,254579,0,2,0
72679,4,2,254581,254581,254583,0,2,2
72680,2,2,254583,254583,254585,0,2,0
72681,2,2,254585,254585,254587,0,2,0
72682,5,2,254590,254590,254592,0,2,3
72683,3,2,254593,254593,254595,0,2,1
72684,1,3,254594,254595,254598,1,4,0
72685,6,2,254600,254600,254602,0,2,2
72686,3,3,254603,254603,254606,0,3,1
72687,3,2,254606,254606,254608,0,2,0
72688,4,2,254610,254610,254612,0,2,2
72689,2,2,254612,254612,254614,0,2,0
72690,4,3,254616,254616,254619,0,3,2
72691,4,1,254620,254620,254621,0,1,1
72692,5,2,254625,254625,254627,0,2,4
72693,3,1,254628,254628,254629,0,1,1
72694,1,1,254629,254629,254630,0,1,0
72695,5,1,254634,254634,254635,0,1,4
72696,4,3,254638,254638,254641,0,3,3
72697,3,2,254641,254641,254643,0,2,0
72698,4,3,254645,254645,254648,0,3,2
72699,4,2,254649,254649,254651,0,2,1
72700,2,2,254651,254651,254653,0,2,0
72701,5,3,254656,254656,254659,0,3,3
72702,1,1,254657,254659,254660,2,3,0
72703,1,1,254658,254660,254661,2,3,0
72704,2,3,254660,254661,254664,1,4,0
72705,1,3,254661,254664,254667,3,6,0
72706,5,1,254666,254667,254668,1,2,0
72707,2,3,254668,254668,254671,0,3,0
72708,5,1,254673,254673,254674,0,1,2
72709,4,2,254677,254677,254679,0,2,3
72710,3,2,254680,254680,254682,0,2,1
72711,5,3,254685,254685,254688,0,3,3
72712,3,2,254688,254688,254690,0,2,0
72713,6,1,254694,254694,254695,0,1,4
72714,2,3,254696,254696,254699,0,3,1
72715,6,2,254702,254702,254704,0,2,3
72716,1,2,254703,254704,254706,1,3,0
72717,2,3,254705,254706,254709,1,4,0
72718,5,1,254710,254710,254711,0,1,1
72719,5,2,254715,254715,254717,0,2,4
72720,1,1,254716,254717,254718,1,2,0
72721,5,3,254721,254721,254724,0,3,3
72722,3,1,254724,254724,254725,0,1,0
72723,3,2,254727,254727,254729,0,2,2
72724,4,1,254731,254731,254732,0,1,2
72725,5,2,254736,254736,254738,0,2,4
72726,3,1,254739,254739,254740,0,1,1
72727,6,2,254745,254745,254747,0,2,5
72728,2,2,254747,254747,254749,0,2,0
72729,3,2,254750,254750,254752,0,2,1
72730,1,3,254751,254752,254755,1,4,0
72731,2,1,254753,254755,254756,2,3,0
72732,2,3,254755,254756,254759,1,4,0
72733,2,2,254757,254759,254761,2,4,0
72734,1,3,254758,254761,254764,3,6,0
72735,1,3,254759,254764,254767,5,8,0
72736,6,3,254765,254767,254770,2,5,0
72737,6,3,254771,254771,254774,0,3,1
72738,4,3,254775,254775,254778,0,3,1
72739,6,2,254781,254781,254783,0,2,3
72740,1,2,254782,254783,254785,1,3,0
72741,5,2,254787,254787,254789,0,2,2
72742,2,1,254789,254789,254790,0,1,0
72743,4,3,254793,254793,254796,0,3,3
72744,5,2,254798,254798,254800,0,2,2
72745,3,2,254801,254801,254803,0,2,1
72746,3,3,254804,254804,254807,0,3,1
72747,4,3,254808,254808,254811,0,3,1
72748,6,2,254814,254814,254816,0,2,3
72749,1,3,254815,254816,254819,1,4,0
72750,3,1,254818,254819,254820,1,2,0
72751,1,3,254819,254820,254823,1,4,0
72752,1,2,254820,254823,254825,3,5,0
72753,6,3,254826,254826,254829,0,3,1
72754,5,3,254831,254831,254834,0,3,2
72755,1,3,254832,254834,254837,2,5,0
72756,2,2,254834,254837,254839,3,5,0
72757,6,3,254840,254840,254843,0,3,1
72758,4,3,254844,254844,254847,0,3,1
72759,2,1,254846,254847,254848,1,2,0
72760,3,1,254849,254849,254850,0,1,1
72761,6,3,254855,254855,254858,0,3,5
72762,4,1,254859,254859,254860,0,1,1
72763,6,1,254865,254865,254866,0,1,5
72764,6,3,254871,254871,254874,0,3,5
72765,1,3,254872,254874,254877,2,5,0
72766,5,2,254877,254877,254879,0,2,0
72767,4,1,254881,254881,254882,0,1,2
72768,5,1,254886,254886,254887,0,1,4
72769,6,3,254892,254892,254895,0,3,5
72770,2,1,254894,254895,254896,1,2,0
72771,1,2,254895,254896,254898,1,3,0
72772,2,1,254897,254898,254899,1,2,0
72773,1,1,254898,254899,254900,1,2,0
72774,4,2,254902,254902,254904,0,2,2
72775,2,3,254904,254904,254907,0,3,0
72776,5,3,254909,254909,254912,0,3,2
72777,1,3,254910,254912,254915,2,5,0
72778,1,2,254911,254915,254917,4,6,0
72779,4,3,254915,254917,254920,2,5,0
72780,4,1,254919,254920,254921,1,2,0
72781,6,3,254925,254925,254928,0,3,4
72782,4,1,254929,254929,254930,0,1,1
72783,6,3,254935,254935,254938,0,3,5
72784,5,2,254940,254940,254942,0,2,2
72785,4,2,254944,254944,254946,0,2,2
72786,5,3,254949,254949,254952,0,3,3
72787,1,2,254950,254952,254954,2,4,0
72788,2,3,254952,254954,254957,2,5,0
72789,5,1,254957,254957,254958,0,1,0
72790,6,1,254963,254963,254964,0,1,5
72791,4,1,254967,254967,254968,0,1,3
72792,2,2,254969,254969,254971,0,2,1
72793,3,2,254972,254972,254974,0,2,1
72794,4,1,254976,254976,254977,0,1,2
72795,4,3,254980,254980,254983,0,3,3
72796,2,1,254982,254983,254984,1,2,0
72797,3,3,254985,254985,254988,0,3,1
72798,3,1,254988,254988,254989,0,1,0
72799,5,2,254993,254993,254995,0,2,4
72800,2,3,254995,254995,254998,0,3,0
72801,2,3,254997,254998,255001,1,4,0
72802,2,3,254999,255001,255004,2,5,0
72803,1,3,255000,255004,255007,4,7,0
72804,2,2,255002,255007,255009,5,7,0
72805,2,2,255004,255009,255011,5,7,0
72806,4,2,255008,255011,255013,3,5,0
72807,6,2,255014,255014,255016,0,2,1
72808,1,3,255015,255016,255019,1,4,0
72809,4,1,255019,255019,255020,0,1,0
72810,2,2,255021,255021,255023,0,2,1
72811,5,3,255026,255026,255029,0,3,3
72812,3,2,255029,255029,255031,0,2,0
72813,3,2,255032,255032,255034,0,2,1
72814,2,2,255034,255034,255036,0,2,0
72815,6,2,255040,255040,255042,0,2,4
72816,5,2,255045,255045,255047,0,2,3
72817,6,3,255051,255051,255054,0,3,4
72818,1,3,255052,255054,255057,2,5,0
72819,6,1,255058,255058,255059,0,1,1
72820,4,3,255062,255062,255065,0,3,3
72821,1,3,255063,255065,255068,2,5,0
72822,3,1,255066,255068,255069,2,3,0
72823,4,3,255070,255070,255073,0,3,1
72824,5,3,255075,255075,255078,0,3,2
72825,4,2,255079,255079,255081,0,2,1
72826,3,1,255082,255082,255083,0,1,1
72827,3,2,255085,255085,255087,0,2,2
72828,6,3,255091,255091,255094,0,3,4
72829,3,3,255094,255094,255097,0,3,0
72830,3,1,255097,255097,255098,0,1,0
72831,5,2,255102,255102,255104,0,2,4
72832,2,3,255104,255104,255107,0,3,0
72833,2,3,255106,255107,255110,1,4,0
72834,2,1,255108,255110,255111,2,3,0
72835,2,3,255110,255111,255114,1,4,0
72836,3,1,255113,255114,255115,1,2,0
72837,2,3,255115,255115,255118,0,3,0
72838,5,3,255120,255120,255123,0,3,2
72839,3,1,255123,255123,255124,0,1,0
72840,2,2,255125,255125,255127,0,2,1
72841,4,3,255129,255129,255132,0,3,2
72842,3,2,255132,255132,255134,0,2,0
72843,4,1,255136,255136,255137,0,1,2
72844,3,1,255139,255139,255140,0,1,2
72845,3,1,255142,255142,255143,0,1,2
72846,2,1,255144,255144,255145,0,1,1
72847,4,1,255148,255148,255149,0,1,3
72848,3,1,255151,255151,255152,0,1,2
72849,1,2,255152,255152,255154,0,2,0
72850,2,3,255154,255154,255157,0,3,0
72851,3,1,255157,255157,255158,0,1,0
72852,2,2,255159,255159,255161,0,2,1
72853,2,1,255161,255161,255162,0,1,0
72854,4,2,255165,255165,255167,0,2,3
72855,5,1,255170,255170,255171,0,1,3
72856,6,3,255176,255176,255179,0,3,5
72857,2,3,255178,255179,255182,1,4,0
72858,4,3,255182,255182,255185,0,3,0
72859,1,2,255183,255185,255187,2,4,0
72860,6,3,255189,255189,255192,0,3,2
72861,2,3,255191,255192,255195,1,4,0
72862,6,3,255197,255197,255200,0,3,2
72863,5,2,255202,255202,255204,0,2,2
72864,2,1,255204,255204,255205,0,1,0
72865,4,3,255208,255208,255211,0,3,3
72866,5,2,255213,255213,255215,0,2,2
72867,2,2,255215,255215,255217,0,2,0
72868,4,2,255219,255219,255221,0,2,2
72869,4,2,255223,255223,255225,0,2,2
72870,3,1,255226,255226,255227,0,1,1
72871,1,1,255227,255227,255228,0,1,0
72872,1,2,255228,255228,255230,0,2,0
72873,6,2,255234,255234,255236,0,2,4
72874,5,3,255239,255239,255242,0,3,3
72875,4,1,255243,255243,255244,0,1,1
72876,6,1,255249,255249,255250,0,1,5
72877,5,3,255254,255254,255257,0,3,4
72878,4,2,255258,255258,255260,0,2,1
72879,3,3,255261,255261,255264,0,3,1
72880,6,3,255267,255267,255270,0,3,3
72881,3,1,255270,255270,255271,0,1,0
72882,6,2,255276,255276,255278,0,2,5
72883,4,2,255280,255280,255282,0,2,2
72884,4,2,255284,255284,255286,0,2,2
72885,3,1,255287,255287,255288,0,1,1
72886,6,3,255293,255293,255296,0,3,5
72887,1,2,255294,255296,255298,2,4,0
72888,5,2,255299,255299,255301,0,2,1
72889,5,2,255304,255304,255306,0,2,3
72890,4,3,255308,255308,255311,0,3,2
72891,3,3,255311,255311,255314,0,3,0
72892,1,1,255312,255314,255315,2,3,0
72893,4,2,255316,255316,255318,0,2,1
72894,2,3,255318,255318,255321,0,3,0
72895,6,3,255324,255324,255327,0,3,3
72896,4,1,255328,255328,255329,0,1,1
72897,4,2,255332,255332,255334,0,2,3
72898,3,3,255335,255335,255338,0,3,1
72899,5,1,255340,255340,255341,0,1,2
72900,4,1,255344,255344,255345,0,1,3
72901,3,2,255347,255347,255349,0,2,2
72902,1,1,255348,255349,255350,1,2,0
72903,4,3,255352,255352,255355,0,3,2
72904,3,1,255355,255355,255356,0,1,0
72905,3,3,255358,255358,255361,0,3,2
72906,1,3,255359,255361,255364,2,5,0
72907,5,3,255364,255364,255367,0,3,0
72908,4,3,255368,255368,255371,0,3,1
72909,3,3,255371,255371,255374,0,3,0
72910,3,1,255374,255374,255375,0,1,0
72911,1,3,255375,255375,255378,0,3,0
72912,5,2,255380,255380,255382,0,2,2
72913,1,3,255381,255382,255385,1,4,0
72914,5,2,255386,255386,255388,0,2,1
72915,5,2,255391,255391,255393,0,2,3
72916,6,2,255397,255397,255399,0,2,4
72917,3,2,255400,255400,255402,0,2,1
72918,5,3,255405,255405,255408,0,3,3
72919,2,2,255407,255408,255410,1,3,0
72920,6,1,255413,255413,255414,0,1,3
72921,2,2,255415,255415,255417,0,2,1
72922,6,2,255421,255421,255423,0,2,4
72923,2,1,255423,255423,255424,0,1,0
72924,6,3,255429,255429,255432,0,3,5
72925,5,2,255434,255434,255436,0,2,2
72926,2,2,255436,255436,255438,0,2,0
72927,2,2,255438,255438,255440,0,2,0
72928,1,3,255439,255440,255443,1,4,0
72929,4,1,255443,255443,255444,0,1,0
72930,4,2,255447,255447,255449,0,2,3
72931,4,3,255451,255451,255454,0,3,2
72932,2,3,255453,255454,255457,1,4,0
72933,6,3,255459,255459,255462,0,3,2
72934,3,2,255462,255462,255464,0,2,0
72935,6,1,255468,255468,255469,0,1,4
72936,3,2,255471,255471,255473,0,2,2
72937,1,3,255472,255473,255476,1,4,0
72938,6,3,255478,255478,255481,0,3,2
72939,5,3,255483,255483,255486,0,3,2
72940,1,1,255484,255486,255487,2,3,0
72941,5,2,255489,255489,255491,0,2,2
72942,6,1,255495,255495,255496,0,1,4
72943,2,3,255497,255497,255500,0,3,1
72944,1,1,255498,255500,255501,2,3,0
72945,6,1,255504,255504,255505,0,1,3
72946,6,3,255510,255510,255513,0,3,5
72947,4,2,255514,255514,255516,0,2,1
72948,2,3,255516,255516,255519,0,3,0
72949,2,2,255518,255519,255521,1,3,0
72950,1,3,255519,255521,255524,2,5,0
72951,3,3,255522,255524,255527,2,5,0
72952,4,2,255526,255527,255529,1,3,0
72953,1,3,255527,255529,255532,2,5,0
72954,2,1,255529,255532,255533,3,4,0
72955,3,2,255532,255533,255535,1,3,0
72956,6,1,255538,255538,255539,0,1,3
72957,5,1,255543,255543,255544,0,1,4
72958,4,1,255547,255547,255548,0,1,3
72959,5,2,255552,255552,255554,0,2,4
72960,3,3,255555,255555,255558,0,3,1
72961,4,3,255559,255559,255562,0,3,1
72962,2,1,255561,255562,255563,1,2,0
72963,4,3,255565,255565,255568,0,3,2
72964,3,3,255568,255568,255571,0,3,0
72965,6,1,255574,255574,255575,0,1,3
72966,3,3,255577,255577,255580,0,3,2
72967,2,3,255579,255580,255583,1,4,0
72968,4,1,255583,255583,255584,0,1,0
72969,6,2,255589,255589,255591,0,2,5
72970,1,3,255590,255591,255594,1,4,0
72971,6,2,255596,255596,255598,0,2,2
72972,2,2,255598,255598,255600,0,2,0
72973,3,1,255601,255601,255602,0,1,1
72974,5,2,255606,255606,255608,0,2,4
72975,3,2,255609,255609,255611,0,2,1
72976,3,2,255612,255612,255614,0,2,1
72977,5,2,255617,255617,255619,0,2,3
72978,4,2,255621,255621,255623,0,2,2
72979,4,1,255625,255625,255626,0,1,2
72980,2,2,255627,255627,255629,0,2,1
72981,6,2,255633,255633,255635,0,2,4
72982,3,3,255636,255636,255639,0,3,1
72983,3,3,255639,255639,255642,0,3,0
72984,1,3,255640,255642,255645,2,5,0
72985,1,3,255641,255645,255648,4,7,0
72986,2,1,255643,255648,255649,5,6,0
72987,3,3,255646,255649,255652,3,6,0
72988,6,3,255652,255652,255655,0,3,0
72989,5,2,255657,255657,255659,0,2,2
72990,1,2,255658,255659,255661,1,3,0
72991,2,3,255660,255661,255664,1,4,0
72992,4,3,255664,255664,255667,0,3,0
72993,1,1,255665,255667,255668,2,3,0
72994,1,1,255666,255668,255669,2,3,0
72995,1,2,255667,255669,255671,2,4,0
72996,3,1,255670,255671,255672,1,2,0
72997,2,3,255672,255672,255675,0,3,0
72998,4,3,255676,255676,255679,0,3,1
72999,5,3,255681,255681,255684,0,3,2
73000,1,3,255682,255684,255687,2,5,0
73001,2,3,255684,255687,255690,3,6,0
73002,1,3,255685,255690,255693,5,8,0
73003,6,3,255691,255693,255696,2,5,0
73004,3,3,255694,255696,255699,2,5,0
73005,1,1,255695,255699,255700,4,5,0
73006,3,3,255698,255700,255703,2,5,0
73007,6,3,255704,255704,255707,0,3,1
73008,3,2,255707,255707,255709,0,2,0
73009,3,1,255710,255710,255711,0,1,1
73010,5,1,255715,255715,255716,0,1,4
73011,1,2,255716,255716,255718,0,2,0
73012,4,2,255720,255720,255722,0,2,2
73013,4,1,255724,255724,255725,0,1,2
73014,6,1,255730,255730,255731,0,1,5
73015,2,3,255732,255732,255735,0,3,1
73016,3,2,255735,255735,255737,0,2,0
73017,5,3,255740,255740,255743,0,3,3
73018,4,3,255744,255744,255747,0,3,1
73019,4,3,255748,255748,255751,0,3,1
73020,3,3,255751,255751,255754,0,3,0
73021,6,3,255757,255757,255760,0,3,3
73022,6,2,255763,255763,255765,0,2,3
73023,2,3,255765,255765,255768,0,3,0
73024,1,2,255766,255768,255770,2,4,0
73025,4,3,255770,255770,255773,0,3,0
73026,5,1,255775,255775,255776,0,1,2
73027,4,1,255779,255779,255780,0,1,3
73028,4,1,255783,255783,255784,0,1,3
73029,1,2,255784,255784,255786,0,2,0
73030,5,1,255789,255789,255790,0,1,3
73031,3,1,255792,255792,255793,0,1,2
73032,2,2,255794,255794,255796,0,2,1
73033,5,2,255799,255799,255801,0,2,3
73034,1,1,255800,255801,255802,1,2,0
73035,6,3,255806,255806,255809,0,3,4
73036,5,1,255811,255811,255812,0,1,2
73037,3,1,255814,255814,255815,0,1,2
73038,4,1,255818,255818,255819,0,1,3
73039,2,2,255820,255820,255822,0,2,1
73040,6,1,255826,255826,255827,0,1,4
73041,3,1,255829,255829,255830,0,1,2
73042,2,1,255831,255831,255832,0,1,1
73043,2,3,255833,255833,255836,0,3,1
73044,1,1,255834,255836,255837,2,3,0
73045,4,2,255838,255838,255840,0,2,1
73046,5,1,255843,255843,255844,0,1,3
73047,3,2,255846,255846,255848,0,2,2
73048,1,3,255847,255848,255851,1,4,0
73049,4,3,255851,255851,255854,0,3,0
73050,2,1,255853,255854,255855,1,2,0
73051,3,1,255856,255856,255857,0,1,1
73052,1,1,255857,255857,255858,0,1,0
73053,2,1,255859,255859,255860,0,1,1
73054,4,2,255863,255863,255865,0,2,3
73055,3,3,255866,255866,255869,0,3,1
73056,6,2,255872,255872,255874,0,2,3
73057,1,3,255873,255874,255877,1,4,0
73058,1,2,255874,255877,255879,3,5,0
73059,1,3,255875,255879,255882,4,7,0
73060,6,3,255881,255882,255885,1,4,0
73061,4,1,255885,255885,255886,0,1,0
73062,4,3,255889,255889,255892,0,3,3
73063,2,1,255891,255892,255893,1,2,0
73064,1,1,255892,255893,255894,1,2,0
73065,2,2,255894,255894,255896,0,2,0
73066,5,3,255899,255899,255902,0,3,3
73067,2,1,255901,255902,255903,1,2,0
73068,6,2,255907,255907,255909,0,2,4
73069,4,2,255911,255911,255913,0,2,2
73070,2,3,255913,255913,255916,0,3,0
73071,3,2,255916,255916,255918,0,2,0
73072,1,1,255917,255918,255919,1,2,0
73073,2,1,255919,255919,255920,0,1,0
73074,1,3,255920,255920,255923,0,3,0
73075,2,3,255922,255923,255926,1,4,0
73076,6,1,255928,255928,255929,0,1,2
73077,6,2,255934,255934,255936,0,2,5
73078,2,2,255936,255936,255938,0,2,0
73079,3,2,255939,255939,255941,0,2,1
73080,1,3,255940,255941,255944,1,4,0
73081,2,3,255942,255944,255947,2,5,0
73082,4,1,255946,255947,255948,1,2,0
73083,3,1,255949,255949,255950,0,1,1
73084,4,3,255953,255953,255956,0,3,3
73085,5,1,255958,255958,255959,0,1,2
73086,2,2,255960,255960,255962,0,2,1
73087,3,2,255963,255963,255965,0,2,1
73088,6,2,255969,255969,255971,0,2,4
73089,1,1,255970,255971,255972,1,2,0
73090,4,2,255974,255974,255976,0,2,2
73091,6,1,255980,255980,255981,0,1,4
73092,3,1,255983,255983,255984,0,1,2
73093,2,2,255985,255985,255987,0,2,1
73094,2,2,255987,255987,255989,0,2,0
73095,1,2,255988,255989,255991,1,3,0
73096,6,1,255994,255994,255995,0,1,3
73097,5,2,255999,255999,256001,0,2,4
73098,4,3,256003,256003,256006,0,3,2
73099,5,1,256008,256008,256009,0,1,2
73100,2,3,256010,256010,256013,0,3,1
73101,2,1,256012,256013,256014,1,2,0
73102,6,2,256018,256018,256020,0,2,4
73103,1,3,256019,256020,256023,1,4,0
73104,2,3,256021,256023,256026,2,5,0
73105,2,1,256023,256026,256027,3,4,0
73106,5,3,256028,256028,256031,0,3,1
73107,5,1,256033,256033,256034,0,1,2
73108,4,3,256037,256037,256040,0,3,3
73109,5,3,256042,256042,256045,0,3,2
73110,1,1,256043,256045,256046,2,3,0
73111,6,1,256049,256049,256050,0,1,3
73112,1,2,256050,256050,256052,0,2,0
73113,1,3,256051,256052,256055,1,4,0
73114,6,1,256057,256057,256058,0,1,2
73115,3,2,256060,256060,256062,0,2,2
73116,1,3,256061,256062,256065,1,4,0
73117,3,1,256064,256065,256066,1,2,0
73118,5,3,256069,256069,256072,0,3,3
73119,1,2,256070,256072,256074,2,4,0
73120,6,1,256076,256076,256077,0,1,2
73121,2,3,256078,256078,256081,0,3,1
73122,5,2,256083,256083,256085,0,2,2
73123,2,2,256085,256085,256087,0,2,0
73124,3,3,256088,256088,256091,0,3,1
73125,2,1,256090,256091,256092,1,2,0
73126,1,3,256091,256092,256095,1,4,0
73127,2,1,256093,256095,256096,2,3,0
73128,1,3,256094,256096,256099,2,5,0
73129,4,3,256098,256099,256102,1,4,0
73130,5,2,256103,256103,256105,0,2,1
73131,6,3,256109,256109,256112,0,3,4
73132,2,3,256111,256112,256115,1,4,0
73133,1,3,256112,256115,256118,3,6,0
73134,4,3,256116,256118,256121,2,5,0
73135,5,1,256121,256121,256122,0,1,0
73136,4,1,256125,256125,256126,0,1,3
73137,5,1,256130,256130,256131,0,1,4
73138,1,1,256131,256131,256132,0,1,0
73139,1,1,256132,256132,256133,0,1,0
73140,3,2,256135,256135,256137,0,2,2
73141,6,2,256141,256141,256143,0,2,4
73142,2,3,256143,256143,256146,0,3,0
73143,3,3,256146,256146,256149,0,3,0
73144,4,1,256150,256150,256151,0,1,1
73145,3,1,256153,256153,256154,0,1,2
73146,5,2,256158,256158,256160,0,2,4
73147,3,3,256161,256161,256164,0,3,1
73148,1,1,256162,256164,256165,2,3,0
73149,2,2,256164,256165,256167,1,3,0
73150,3,3,256167,256167,256170,0,3,0
73151,1,3,256168,256170,256173,2,5,0
73152,2,1,256170,256173,256174,3,4,0
73153,4,2,256174,256174,256176,0,2,0
73154,3,1,256177,256177,256178,0,1,1
73155,6,3,256183,256183,256186,0,3,5
73156,1,3,256184,256186,256189,2,5,0
73157,4,3,256188,256189,256192,1,4,0
73158,4,3,256192,256192,256195,0,3,0
73159,5,1,256197,256197,256198,0,1,2
73160,3,1,256200,256200,256201,0,1,2
73161,1,2,256201,256201,256203,0,2,0
73162,2,2,256203,256203,256205,0,2,0
73163,2,2,256205,256205,256207,0,2,0
73164,4,3,256209,256209,256212,0,3,2
73165,4,1,256213,256213,256214,0,1,1
73166,4,1,256217,256217,256218,0,1,3
73167,2,3,256219,256219,256222,0,3,1
73168,5,1,256224,256224,256225,0,1,2
73169,5,3,256229,256229,256232,0,3,4
73170,4,2,256233,256233,256235,0,2,1
73171,5,3,256238,256238,256241,0,3,3
73172,2,2,256240,256241,256243,1,3,0
73173,2,3,256242,256243,256246,1,4,0
73174,4,3,256246,256246,256249,0,3,0
73175,4,2,256250,256250,256252,0,2,1
73176,5,2,256255,256255,256257,0,2,3
73177,1,1,256256,256257,256258,1,2,0
73178,4,1,256260,256260,256261,0,1,2
73179,5,1,256265,256265,256266,0,1,4
73180,1,1,256266,256266,256267,0,1,0
73181,4,3,256270,256270,256273,0,3,3
73182,3,2,256273,256273,256275,0,2,0
73183,4,2,256277,256277,256279,0,2,2
73184,3,3,256280,256280,256283,0,3,1
73185,3,3,256283,256283,256286,0,3,0
73186,4,2,256287,256287,256289,0,2,1
73187,4,2,256291,256291,256293,0,2,2
73188,5,3,256296,256296,256299,0,3,3
73189,1,3,256297,256299,256302,2,5,0
73190,2,3,256299,256302,256305,3,6,0
73191,5,2,256304,256305,256307,1,3,0
73192,4,2,256308,256308,256310,0,2,1
73193,4,1,256312,256312,256313,0,1,2
73194,5,3,256317,256317,256320,0,3,4
73195,1,3,256318,256320,256323,2,5,0
73196,2,2,256320,256323,256325,3,5,0
73197,4,1,256324,256325,256326,1,2,0
73198,1,1,256325,256326,256327,1,2,0
73199,2,3,256327,256327,256330,0,3,0
73200,1,1,256328,256330,256331,2,3,0
73201,5,3,256333,256333,256336,0,3,2
73202,5,1,256338,256338,256339,0,1,2
73203,3,1,256341,256341,256342,0,1,2
73204,3,3,256344,256344,256347,0,3,2
73205,1,1,256345,256347,256348,2,3,0
73206,3,2,256348,256348,256350,0,2,0
73207,5,2,256353,256353,256355,0,2,3
73208,4,2,256357,256357,256359,0,2,2
73209,3,3,256360,256360,256363,0,3,1
73210,5,1,256365,256365,256366,0,1,2
73211,4,2,256369,256369,256371,0,2,3
73212,1,1,256370,256371,256372,1,2,0
73213,1,3,256371,256372,256375,1,4,0
73214,2,2,256373,256375,256377,2,4,0
73215,1,3,256374,256377,256380,3,6,0
73216,2,3,256376,256380,256383,4,7,0
73217,5,2,256381,256383,256385,2,4,0
73218,4,1,256385,256385,256386,0,1,0
73219,1,2,256386,256386,256388,0,2,0
73220,6,3,256392,256392,256395,0,3,4
73221,2,2,256394,256395,256397,1,3,0
73222,6,3,256400,256400,256403,0,3,3
73223,4,2,256404,256404,256406,0,2,1
73224,5,2,256409,256409,256411,0,2,3
73225,6,2,256415,256415,256417,0,2,4
73226,6,3,256421,256421,256424,0,3,4
73227,1,1,256422,256424,256425,2,3,0
73228,3,1,256425,256425,256426,0,1,0
73229,1,1,256426,256426,256427,0,1,0
73230,1,2,256427,256427,256429,0,2,0
73231,6,2,256433,256433,256435,0,2,4
73232,1,3,256434,256435,256438,1,4,0
73233,4,3,256438,256438,256441,0,3,0
73234,4,3,256442,256442,256445,0,3,1
73235,5,3,256447,256447,256450,0,3,2
73236,1,2,256448,256450,256452,2,4,0
73237,6,3,256454,256454,256457,0,3,2
73238,4,1,256458,256458,256459,0,1,1
73239,5,2,256463,256463,256465,0,2,4
73240,2,2,256465,256465,256467,0,2,0
73241,5,1,256470,256470,256471,0,1,3
73242,3,2,256473,256473,256475,0,2,2
73243,3,1,256476,256476,256477,0,1,1
73244,6,2,256482,256482,256484,0,2,5
73245,6,3,256488,256488,256491,0,3,4
73246,2,1,256490,256491,256492,1,2,0
73247,5,3,256495,256495,256498,0,3,3
73248,5,2,256500,256500,256502,0,2,2
73249,5,3,256505,256505,256508,0,3,3
73250,4,2,256509,256509,256511,0,2,1
73251,2,2,256511,256511,256513,0,2,0
73252,1,1,256512,256513,256514,1,2,0
73253,5,1,256517,256517,256518,0,1,3
73254,4,2,256521,256521,256523,0,2,3
73255,3,2,256524,256524,256526,0,2,1
73256,3,1,256527,256527,256528,0,1,1
73257,4,3,256531,256531,256534,0,3,3
73258,1,3,256532,256534,256537,2,5,0
73259,6,2,256538,256538,256540,0,2,1
73260,6,1,256544,256544,256545,0,1,4
73261,1,1,256545,256545,256546,0,1,0
73262,1,2,256546,256546,256548,0,2,0
73263,1,3,256547,256548,256551,1,4,0
73264,1,1,256548,256551,256552,3,4,0
73265,6,1,256554,256554,256555,0,1,2
73266,5,3,256559,256559,256562,0,3,4
73267,3,2,256562,256562,256564,0,2,0
73268,4,1,256566,256566,256567,0,1,2
73269,3,2,256569,256569,256571,0,2,2
73270,5,2,256574,256574,256576,0,2,3
73271,6,1,256580,256580,256581,0,1,4
73272,3,1,256583,256583,256584,0,1,2
73273,2,1,256585,256585,256586,0,1,1
73274,5,3,256590,256590,256593,0,3,4
73275,1,2,256591,256593,256595,2,4,0
73276,3,3,256594,256595,256598,1,4,0
73277,3,1,256597,256598,256599,1,2,0
73278,4,1,256601,256601,256602,0,1,2
73279,6,3,256607,256607,256610,0,3,5
73280,5,2,256612,256612,256614,0,2,2
73281,2,2,256614,256614,256616,0,2,0
73282,1,2,256615,256616,256618,1,3,0
73283,6,1,256621,256621,256622,0,1,3
73284,2,3,256623,256623,256626,0,3,1
73285,6,1,256629,256629,256630,0,1,3
73286,6,1,256635,256635,256636,0,1,5
73287,6,2,256641,256641,256643,0,2,5
73288,6,3,256647,256647,256650,0,3,4
73289,5,3,256652,256652,256655,0,3,2
73290,1,3,256653,256655,256658,2,5,0
73291,6,1,256659,256659,256660,0,1,1
73292,2,1,256661,256661,256662,0,1,1
73293,4,1,256665,256665,256666,0,1,3
73294,4,3,256669,256669,256672,0,3,3
73295,3,3,256672,256672,256675,0,3,0
73296,6,3,256678,256678,256681,0,3,3
73297,4,3,256682,256682,256685,0,3,1
73298,6,1,256688,256688,256689,0,1,3
73299,3,2,256691,256691,256693,0,2,2
73300,1,2,256692,256693,256695,1,3,0
73301,2,3,256694,256695,256698,1,4,0
73302,6,2,256700,256700,256702,0,2,2
73303,1,3,256701,256702,256705,1,4,0
73304,5,2,256706,256706,256708,0,2,1
73305,3,3,256709,256709,256712,0,3,1
73306,5,3,256714,256714,256717,0,3,2
73307,4,2,256718,256718,256720,0,2,1
73308,6,2,256724,256724,256726,0,2,4
73309,4,1,256728,256728,256729,0,1,2
73310,1,3,256729,256729,256732,0,3,0
73311,3,1,256732,256732,256733,0,1,0
73312,5,1,256737,256737,256738,0,1,4
73313,1,1,256738,256738,256739,0,1,0
73314,1,1,256739,256739,256740,0,1,0
73315,1,2,256740,256740,256742,0,2,0
73316,4,1,256744,256744,256745,0,1,2
73317,6,2,256750,256750,256752,0,2,5
73318,1,3,256751,256752,256755,1,4,0
73319,5,3,256756,256756,256759,0,3,1
73320,3,2,256759,256759,256761,0,2,0
73321,1,1,256760,256761,256762,1,2,0
73322,6,3,256766,256766,256769,0,3,4
73323,6,3,256772,256772,256775,0,3,3
73324,3,3,256775,256775,256778,0,3,0
73325,3,3,256778,256778,256781,0,3,0
73326,5,3,256783,256783,256786,0,3,2
73327,3,3,256786,256786,256789,0,3,0
73328,1,3,256787,256789,256792,2,5,0
73329,4,3,256791,256792,256795,1,4,0
73330,4,2,256795,256795,256797,0,2,0
73331,1,1,256796,256797,256798,1,2,0
73332,2,2,256798,256798,256800,0,2,0
73333,6,3,256804,256804,256807,0,3,4
73334,5,2,256809,256809,256811,0,2,2
73335,6,1,256815,256815,256816,0,1,4
73336,5,1,256820,256820,256821,0,1,4
73337,3,1,256823,256823,256824,0,1,2
73338,2,2,256825,256825,256827,0,2,1
73339,1,1,256826,256827,256828,1,2,0
73340,5,2,256831,256831,256833,0,2,3
73341,5,1,256836,256836,256837,0,1,3
73342,6,2,256842,256842,256844,0,2,5
73343,2,3,256844,256844,256847,0,3,0
73344,3,3,256847,256847,256850,0,3,0
73345,1,1,256848,256850,256851,2,3,0
73346,4,1,256852,256852,256853,0,1,1
73347,1,1,256853,256853,256854,0,1,0
73348,4,2,256857,256857,256859,0,2,3
73349,6,3,256863,256863,256866,0,3,4
73350,2,2,256865,256866,256868,1,3,0
73351,4,2,256869,256869,256871,0,2,1
73352,4,1,256873,256873,256874,0,1,2
73353,6,2,256879,256879,256881,0,2,5
73354,5,3,256884,256884,256887,0,3,3
73355,6,1,256890,256890,256891,0,1,3
73356,2,1,256892,256892,256893,0,1,1
73357,6,1,256898,256898,256899,0,1,5
73358,4,1,256902,256902,256903,0,1,3
73359,1,3,256903,256903,256906,0,3,0
73360,3,3,256906,256906,256909,0,3,0
73361,1,3,256907,256909,256912,2,5,0
73362,3,2,256910,256912,256914,2,4,0
73363,4,3,256914,256914,256917,0,3,0
73364,6,1,256920,256920,256921,0,1,3
73365,6,1,256926,256926,256927,0,1,5
73366,4,3,256930,256930,256933,0,3,3
73367,3,3,256933,256933,256936,0,3,0
73368,3,3,256936,256936,256939,0,3,0
73369,3,2,256939,256939,256941,0,2,0
73370,5,2,256944,256944,256946,0,2,3
73371,5,3,256949,256949,256952,0,3,3
73372,3,1,256952,256952,256953,0,1,0
73373,5,3,256957,256957,256960,0,3,4
73374,5,1,256962,256962,256963,0,1,2
73375,1,1,256963,256963,256964,0,1,0
73376,5,2,256968,256968,256970,0,2,4
73377,6,2,256974,256974,256976,0,2,4
73378,2,1,256976,256976,256977,0,1,0
73379,6,3,256982,256982,256985,0,3,5
73380,2,3,256984,256985,256988,1,4,0
73381,1,3,256985,256988,256991,3,6,0
73382,2,2,256987,256991,256993,4,6,0
73383,6,1,256993,256993,256994,0,1,0
73384,6,1,256999,256999,257000,0,1,5
73385,2,1,257001,257001,257002,0,1,1
73386,1,1,257002,257002,257003,0,1,0
73387,4,1,257006,257006,257007,0,1,3
73388,3,1,257009,257009,257010,0,1,2
73389,1,2,257010,257010,257012,0,2,0
73390,4,3,257014,257014,257017,0,3,2
73391,2,3,257016,257017,257020,1,4,0
73392,5,2,257021,257021,257023,0,2,1
73393,3,2,257024,257024,257026,0,2,1
73394,2,1,257026,257026,257027,0,1,0
73395,3,2,257029,257029,257031,0,2,2
73396,1,3,257030,257031,257034,1,4,0
73397,1,3,257031,257034,257037,3,6,0
73398,4,2,257035,257037,257039,2,4,0
73399,2,1,257037,257039,257040,2,3,0
73400,3,2,257040,257040,257042,0,2,0
73401,6,1,257046,257046,257047,0,1,4
73402,1,1,257047,257047,257048,0,1,0
73403,6,1,257053,257053,257054,0,1,5
73404,5,3,257058,257058,257061,0,3,4
73405,2,2,257060,257061,257063,1,3,0
73406,5,3,257065,257065,257068,0,3,2
73407,1,2,257066,257068,257070,2,4,0
73408,1,3,257067,257070,257073,3,6,0
73409,6,2,257073,257073,257075,0,2,0
73410,5,1,257078,257078,257079,0,1,3
73411,1,3,257079,257079,257082,0,3,0
73412,4,3,257083,257083,257086,0,3,1
73413,1,2,257084,257086,257088,2,4,0
73414,1,1,257085,257088,257089,3,4,0
73415,3,3,257088,257089,257092,1,4,0
73416,4,2,257092,257092,257094,0,2,0
73417,5,2,257097,257097,257099,0,2,3
73418,4,3,257101,257101,257104,0,3,2
73419,3,1,257104,257104,257105,0,1,0
73420,2,1,257106,257106,257107,0,1,1
73421,5,2,257111,257111,257113,0,2,4
73422,6,3,257117,257117,257120,0,3,4
73423,2,1,257119,257120,257121,1,2,0
73424,2,2,257121,257121,257123,0,2,0
73425,4,2,257125,257125,257127,0,2,2
73426,6,1,257131,257131,257132,0,1,4
73427,2,3,257133,257133,257136,0,3,1
73428,1,3,257134,257136,257139,2,5,0
73429,1,2,257135,257139,257141,4,6,0
73430,1,1,257136,257141,257142,5,6,0
73431,5,3,257141,257142,257145,1,4,0
73432,2,3,257143,257145,257148,2,5,0
73433,1,2,257144,257148,257150,4,6,0
73434,5,2,257149,257150,257152,1,3,0
73435,4,3,257153,257153,257156,0,3,1
73436,2,3,257155,257156,257159,1,4,0
73437,4,3,257159,257159,257162,0,3,0
73438,5,2,257164,257164,257166,0,2,2
73439,5,3,257169,257169,257172,0,3,3
73440,3,1,257172,257172,257173,0,1,0
73441,2,3,257174,257174,257177,0,3,1
73442,1,3,257175,257177,257180,2,5,0
73443,4,3,257179,257180,257183,1,4,0
73444,6,1,257185,257185,257186,0,1,2
73445,5,3,257190,257190,257193,0,3,4
73446,5,3,257195,257195,257198,0,3,2
73447,5,2,257200,257200,257202,0,2,2
73448,4,1,257204,257204,257205,0,1,2
73449,1,3,257205,257205,257208,0,3,0
73450,4,2,257209,257209,257211,0,2,1
73451,2,1,257211,257211,257212,0,1,0
73452,4,3,257215,257215,257218,0,3,3
73453,2,3,257217,257218,257221,1,4,0
73454,6,3,257223,257223,257226,0,3,2
73455,1,1,257224,257226,257227,2,3,0
73456,1,2,257225,257227,257229,2,4,0
73457,6,3,257231,257231,257234,0,3,2
73458,4,1,257235,257235,257236,0,1,1
73459,5,1,257240,257240,257241,0,1,4
73460,6,3,257246,257246,257249,0,3,5
73461,1,3,257247,257249,257252,2,5,0
73462,6,2,257253,257253,257255,0,2,1
73463,6,2,257259,257259,257261,0,2,4
73464,5,1,257264,257264,257265,0,1,3
73465,4,3,257268,257268,257271,0,3,3
73466,1,3,257269,257271,257274,2,5,0
73467,1,3,257270,257274,257277,4,7,0
73468,3,2,257273,257277,257279,4,6,0
73469,2,3,257275,257279,257282,4,7,0
73470,3,1,257278,257282,257283,4,5,0
73471,4,2,257282,257283,257285,1,3,0
73472,4,3,257286,257286,257289,0,3,1
73473,5,2,257291,257291,257293,0,2,2
73474,2,2,257293,257293,257295,0,2,0
73475,1,2,257294,257295,257297,1,3,0
73476,2,2,257296,257297,257299,1,3,0
73477,3,1,257299,257299,257300,0,1,0
73478,5,2,257304,257304,257306,0,2,4
73479,6,2,257310,257310,257312,0,2,4
73480,6,2,257316,257316,257318,0,2,4
73481,5,1,257321,257321,257322,0,1,3
73482,1,1,257322,257322,257323,0,1,0
73483,4,2,257326,257326,257328,0,2,3
73484,6,1,257332,257332,257333,0,1,4
73485,3,1,257335,257335,257336,0,1,2
73486,1,1,257336,257336,257337,0,1,0
73487,2,1,257338,257338,257339,0,1,1
73488,4,3,257342,257342,257345,0,3,3
73489,2,2,257344,257345,257347,1,3,0
73490,3,2,257347,257347,257349,0,2,0
73491,1,1,257348,257349,257350,1,2,0
73492,3,3,257351,257351,257354,0,3,1
73493,3,2,257354,257354,257356,0,2,0
73494,4,2,257358,257358,257360,0,2,2
73495,1,3,257359,257360,257363,1,4,0
73496,5,3,257364,257364,257367,0,3,1
73497,6,1,257370,257370,257371,0,1,3
73498,3,3,257373,257373,257376,0,3,2
73499,1,2,257374,257376,257378,2,4,0
73500,6,3,257380,257380,257383,0,3,2
73501,5,2,257385,257385,257387,0,2,2
73502,2,1,257387,257387,257388,0,1,0
73503,2,2,257389,257389,257391,0,2,1
73504,5,1,257394,257394,257395,0,1,3
73505,4,3,257398,257398,257401,0,3,3
73506,3,1,257401,257401,257402,0,1,0
73507,3,2,257404,257404,257406,0,2,2
73508,2,3,257406,257406,257409,0,3,0
73509,5,2,257411,257411,257413,0,2,2
73510,2,3,257413,257413,257416,0,3,0
73511,6,1,257419,257419,257420,0,1,3
73512,3,1,257422,257422,257423,0,1,2
73513,1,2,257423,257423,257425,0,2,0
73514,3,1,257426,257426,257427,0,1,1
73515,5,3,257431,257431,257434,0,3,4
73516,6,3,257437,257437,257440,0,3,3
73517,5,3,257442,257442,257445,0,3,2
73518,2,1,257444,257445,257446,1,2,0
73519,3,2,257447,257447,257449,0,2,1
73520,2,2,257449,257449,257451,0,2,0
73521,3,2,257452,257452,257454,0,2,1
73522,2,3,257454,257454,257457,0,3,0
73523,3,3,257457,257457,257460,0,3,0
73524,1,1,257458,257460,257461,2,3,0
73525,1,1,257459,257461,257462,2,3,0
73526,1,1,257460,257462,257463,2,3,0
73527,3,3,257463,257463,257466,0,3,0
73528,1,3,257464,257466,257469,2,5,0
73529,1,1,257465,257469,257470,4,5,0
73530,6,3,257471,257471,257474,0,3,1
73531,6,3,257477,257477,257480,0,3,3
73532,3,1,257480,257480,257481,0,1,0
73533,4,2,257484,257484,257486,0,2,3
73534,6,2,257490,257490,257492,0,2,4
73535,3,2,257493,257493,257495,0,2,1
73536,3,1,257496,257496,257497,0,1,1
73537,4,1,257500,257500,257501,0,1,3
73538,6,2,257506,257506,257508,0,2,5
73539,1,3,257507,257508,257511,1,4,0
73540,6,2,257513,257513,257515,0,2,2
73541,2,2,257515,257515,257517,0,2,0
73542,3,2,257518,257518,257520,0,2,1
73543,5,3,257523,257523,257526,0,3,3
73544,6,3,257529,257529,257532,0,3,3
73545,6,2,257535,257535,257537,0,2,3
73546,3,3,257538,257538,257541,0,3,1
73547,5,3,257543,257543,257546,0,3,2
73548,1,1,257544,257546,257547,2,3,0
73549,3,1,257547,257547,257548,0,1,0
73550,6,1,257553,257553,257554,0,1,5
73551,1,1,257554,257554,257555,0,1,0
73552,1,1,257555,257555,257556,0,1,0
73553,3,1,257558,257558,257559,0,1,2
73554,1,3,257559,257559,257562,0,3,0
73555,1,2,257560,257562,257564,2,4,0
73556,6,3,257566,257566,257569,0,3,2
73557,4,1,257570,257570,257571,0,1,1
73558,2,2,257572,257572,257574,0,2,1
73559,2,2,257574,257574,257576,0,2,0
73560,3,2,257577,257577,257579,0,2,1
73561,6,3,257583,257583,257586,0,3,4
73562,3,1,257586,257586,257587,0,1,0
73563,3,1,257589,257589,257590,0,1,2
73564,3,2,257592,257592,257594,0,2,2
73565,1,1,257593,257594,257595,1,2,0
73566,3,1,257596,257596,257597,0,1,1
73567,5,1,257601,257601,257602,0,1,4
73568,3,2,257604,257604,257606,0,2,2
73569,5,3,257609,257609,257612,0,3,3
73570,4,3,257613,257613,257616,0,3,1
73571,4,1,257617,257617,257618,0,1,1
73572,3,3,257620,257620,257623,0,3,2
73573,2,2,257622,257623,257625,1,3,0
73574,5,2,257627,257627,257629,0,2,2
73575,2,2,257629,257629,257631,0,2,0
73576,4,2,257633,257633,257635,0,2,2
73577,6,2,257639,257639,257641,0,2,4
73578,5,1,257644,257644,257645,0,1,3
73579,4,1,257648,257648,257649,0,1,3
73580,5,2,257653,257653,257655,0,2,4
73581,2,2,257655,257655,257657,0,2,0
73582,2,2,257657,257657,257659,0,2,0
73583,4,2,257661,257661,257663,0,2,2
73584,5,3,257666,257666,257669,0,3,3
73585,1,3,257667,257669,257672,2,5,0
73586,3,2,257670,257672,257674,2,4,0
73587,5,3,257675,257675,257678,0,3,1
73588,5,1,257680,257680,257681,0,1,2
73589,1,3,257681,257681,257684,0,3,0
73590,1,2,257682,257684,257686,2,4,0
73591,1,2,257683,257686,257688,3,5,0
73592,4,3,257687,257688,257691,1,4,0
73593,1,2,257688,257691,257693,3,5,0
73594,6,3,257694,257694,257697,0,3,1
73595,4,2,257698,257698,257700,0,2,1
73596,5,3,257703,257703,257706,0,3,3
73597,3,1,257706,257706,257707,0,1,0
73598,1,2,257707,257707,257709,0,2,0
73599,4,2,257711,257711,257713,0,2,2
73600,4,3,257715,257715,257718,0,3,2
73601,4,1,257719,257719,257720,0,1,1
73602,4,2,257723,257723,257725,0,2,3
73603,1,3,257724,257725,257728,1,4,0
73604,1,1,257725,257728,257729,3,4,0
73605,5,2,257730,257730,257732,0,2,1
73606,3,3,257733,257733,257736,0,3,1
73607,6,3,257739,257739,257742,0,3,3
73608,3,2,257742,257742,257744,0,2,0
73609,3,3,257745,257745,257748,0,3,1
73610,4,1,257749,257749,257750,0,1,1
73611,5,3,257754,257754,257757,0,3,4
73612,6,2,257760,257760,257762,0,2,3
73613,4,1,257764,257764,257765,0,1,2
73614,3,1,257767,257767,257768,0,1,2
73615,1,3,257768,257768,257771,0,3,0
73616,4,1,257772,257772,257773,0,1,1
73617,1,2,257773,257773,257775,0,2,0
73618,6,3,257779,257779,257782,0,3,4
73619,4,2,257783,257783,257785,0,2,1
73620,3,2,257786,257786,257788,0,2,1
73621,3,3,257789,257789,257792,0,3,1
73622,3,1,257792,257792,257793,0,1,0
73623,4,2,257796,257796,257798,0,2,3
73624,6,1,257802,257802,257803,0,1,4
73625,2,2,257804,257804,257806,0,2,1
73626,3,1,257807,257807,257808,0,1,1
73627,5,3,257812,257812,257815,0,3,4
73628,1,2,257813,257815,257817,2,4,0
73629,3,1,257816,257817,257818,1,2,0
73630,4,2,257820,257820,257822,0,2,2
73631,5,3,257825,257825,257828,0,3,3
73632,2,1,257827,257828,257829,1,2,0
73633,3,3,257830,257830,257833,0,3,1
73634,2,3,257832,257833,257836,1,4,0
73635,6,3,257838,257838,257841,0,3,2
73636,4,2,257842,257842,257844,0,2,1
73637,1,1,257843,257844,257845,1,2,0
73638,1,2,257844,257845,257847,1,3,0
73639,6,3,257850,257850,257853,0,3,3
73640,3,2,257853,257853,257855,0,2,0
73641,2,1,257855,257855,257856,0,1,0
73642,6,2,257861,257861,257863,0,2,5
73643,4,2,257865,257865,257867,0,2,2
73644,5,1,257870,257870,257871,0,1,3
73645,1,3,257871,257871,257874,0,3,0
73646,4,2,257875,257875,257877,0,2,1
73647,5,1,257880,257880,257881,0,1,3
73648,2,2,257882,257882,257884,0,2,1
73649,3,2,257885,257885,257887,0,2,1
73650,5,3,257890,257890,257893,0,3,3
73651,2,3,257892,257893,257896,1,4,0
73652,3,3,257895,257896,257899,1,4,0
73653,5,2,257900,257900,257902,0,2,1
73654,1,1,257901,257902,257903,1,2,0
73655,3,2,257904,257904,257906,0,2,1
73656,6,3,257910,257910,257913,0,3,4
73657,6,2,257916,257916,257918,0,2,3
73658,6,1,257922,257922,257923,0,1,4
73659,3,1,257925,257925,257926,0,1,2
73660,6,2,257931,257931,257933,0,2,5
73661,4,3,257935,257935,257938,0,3,2
73662,6,1,257941,257941,257942,0,1,3
73663,1,2,257942,257942,257944,0,2,0
73664,6,3,257948,257948,257951,0,3,4
73665,2,2,257950,257951,257953,1,3,0
73666,6,1,257956,257956,257957,0,1,3
73667,1,3,257957,257957,257960,0,3,0
73668,1,2,257958,257960,257962,2,4,0
73669,2,3,257960,257962,257965,2,5,0
73670,5,2,257965,257965,257967,0,2,0
73671,4,1,257969,257969,257970,0,1,2
73672,1,3,257970,257970,257973,0,3,0
73673,2,3,257972,257973,257976,1,4,0
73674,4,3,257976,257976,257979,0,3,0
73675,5,1,257981,257981,257982,0,1,2
73676,2,1,257983,257983,257984,0,1,1
73677,3,3,257986,257986,257989,0,3,2
73678,6,3,257992,257992,257995,0,3,3
73679,5,2,257997,257997,257999,0,2,2
73680,4,3,258001,258001,258004,0,3,2
73681,1,3,258002,258004,258007,2,5,0
73682,1,1,258003,258007,258008,4,5,0
73683,3,1,258006,258008,258009,2,3,0
73684,3,3,258009,258009,258012,0,3,0
73685,6,3,258015,258015,258018,0,3,3
73686,1,3,258016,258018,258021,2,5,0
73687,2,2,258018,258021,258023,3,5,0
73688,3,3,258021,258023,258026,2,5,0
73689,3,2,258024,258026,258028,2,4,0
73690,5,3,258029,258029,258032,0,3,1
73691,2,3,258031,258032,258035,1,4,0
73692,6,2,258037,258037,258039,0,2,2
73693,6,2,258043,258043,258045,0,2,4
73694,4,3,258047,258047,258050,0,3,2
73695,1,1,258048,258050,258051,2,3,0
73696,3,1,258051,258051,258052,0,1,0
73697,5,2,258056,258056,258058,0,2,4
73698,3,3,258059,258059,258062,0,3,1
73699,1,2,258060,258062,258064,2,4,0
73700,6,1,258066,258066,258067,0,1,2
73701,4,2,258070,258070,258072,0,2,3
73702,5,3,258075,258075,258078,0,3,3
73703,6,3,258081,258081,258084,0,3,3
73704,3,3,258084,258084,258087,0,3,0
73705,4,1,258088,258088,258089,0,1,1
73706,6,1,258094,258094,258095,0,1,5
73707,5,1,258099,258099,258100,0,1,4
73708,4,3,258103,258103,258106,0,3,3
73709,5,1,258108,258108,258109,0,1,2
73710,6,3,258114,258114,258117,0,3,5
73711,2,2,258116,258117,258119,1,3,0
73712,3,1,258119,258119,258120,0,1,0
73713,6,3,258125,258125,258128,0,3,5
73714,3,2,258128,258128,258130,0,2,0
73715,5,3,258133,258133,258136,0,3,3
73716,1,3,258134,258136,258139,2,5,0
73717,3,3,258137,258139,258142,2,5,0
73718,3,1,258140,258142,258143,2,3,0
73719,1,1,258141,258143,258144,2,3,0
73720,5,3,258146,258146,258149,0,3,2
73721,1,3,258147,258149,258152,2,5,0
73722,6,1,258153,258153,258154,0,1,1
73723,5,3,258158,258158,258161,0,3,4
73724,2,1,258160,258161,258162,1,2,0
73725,6,2,258166,258166,258168,0,2,4
73726,4,1,258170,258170,258171,0,1,2
73727,5,2,258175,258175,258177,0,2,4
73728,1,2,258176,258177,258179,1,3,0
73729,5,1,258181,258181,258182,0,1,2
73730,3,2,258184,258184,258186,0,2,2
73731,6,1,258190,258190,258191,0,1,4
73732,3,3,258193,258193,258196,0,3,2
73733,6,3,258199,258199,258202,0,3,3
73734,4,3,258203,258203,258206,0,3,1
73735,6,1,258209,258209,258210,0,1,3
73736,5,1,258214,258214,258215,0,1,4
73737,3,2,258217,258217,258219,0,2,2
73738,2,1,258219,258219,258220,0,1,0
73739,1,3,258220,258220,258223,0,3,0
73740,1,1,258221,258223,258224,2,3,0
73741,1,2,258222,258224,258226,2,4,0
73742,2,2,258224,258226,258228,2,4,0
73743,4,2,258228,258228,258230,0,2,0
73744,6,2,258234,258234,258236,0,2,4
73745,2,3,258236,258236,258239,0,3,0
73746,2,1,258238,258239,258240,1,2,0
73747,1,1,258239,258240,258241,1,2,0
73748,3,2,258242,258242,258244,0,2,1
73749,2,2,258244,258244,258246,0,2,0
73750,6,1,258250,258250,258251,0,1,4
73751,1,1,258251,258251,258252,0,1,0
73752,5,3,258256,258256,258259,0,3,4
73753,5,3,258261,258261,258264,0,3,2
73754,3,3,258264,258264,258267,0,3,0
73755,4,1,258268,258268,258269,0,1,1
73756,4,2,258272,258272,258274,0,2,3
73757,3,2,258275,258275,258277,0,2,1
73758,6,3,258281,258281,258284,0,3,4
73759,4,1,258285,258285,258286,0,1,1
73760,2,1,258287,258287,258288,0,1,1
73761,2,1,258289,258289,258290,0,1,1
73762,6,2,258295,258295,258297,0,2,5
73763,1,3,258296,258297,258300,1,4,0
73764,5,2,258301,258301,258303,0,2,1
73765,6,2,258307,258307,258309,0,2,4
73766,3,3,258310,258310,258313,0,3,1
73767,1,2,258311,258313,258315,2,4,0
73768,6,1,258317,258317,258318,0,1,2
73769,2,1,258319,258319,258320,0,1,1
73770,1,3,258320,258320,258323,0,3,0
73771,4,3,258324,258324,258327,0,3,1
73772,1,1,258325,258327,258328,2,3,0
73773,2,2,258327,258328,258330,1,3,0
73774,5,2,258332,258332,258334,0,2,2
73775,5,3,258337,258337,258340,0,3,3
73776,6,3,258343,258343,258346,0,3,3
73777,1,2,258344,258346,258348,2,4,0
73778,1,1,258345,258348,258349,3,4,0
73779,5,1,258350,258350,258351,0,1,1
73780,2,3,258352,258352,258355,0,3,1
73781,4,2,258356,258356,258358,0,2,1
73782,3,3,258359,258359,258362,0,3,1
73783,5,3,258364,258364,258367,0,3,2
73784,5,2,258369,258369,258371,0,2,2
73785,5,2,258374,258374,258376,0,2,3
73786,6,2,258380,258380,258382,0,2,4
73787,6,2,258386,258386,258388,0,2,4
73788,2,1,258388,258388,258389,0,1,0
73789,6,3,258394,258394,258397,0,3,5
73790,2,1,258396,258397,258398,1,2,0
73791,6,2,258402,258402,258404,0,2,4
73792,6,3,258408,258408,258411,0,3,4
73793,3,1,258411,258411,258412,0,1,0
73794,2,1,258413,258413,258414,0,1,1
73795,1,1,258414,258414,258415,0,1,0
73796,4,3,258418,258418,258421,0,3,3
73797,6,1,258424,258424,258425,0,1,3
73798,5,1,258429,258429,258430,0,1,4
73799,3,2,258432,258432,258434,0,2,2
73800,5,3,258437,258437,258440,0,3,3
73801,2,2,258439,258440,258442,1,3,0
73802,3,3,258442,258442,258445,0,3,0
73803,4,3,258446,258446,258449,0,3,1
73804,3,3,258449,258449,258452,0,3,0
73805,2,3,258451,258452,258455,1,4,0
73806,6,3,258457,258457,258460,0,3,2
73807,5,3,258462,258462,258465,0,3,2
73808,1,3,258463,258465,258468,2,5,0
73809,3,2,258466,258468,258470,2,4,0
73810,2,3,258468,258470,258473,2,5,0
73811,5,3,258473,258473,258476,0,3,0
73812,6,3,258479,258479,258482,0,3,3
73813,4,1,258483,258483,258484,0,1,1
73814,1,3,258484,258484,258487,0,3,0
73815,2,2,258486,258487,258489,1,3,0
73816,4,3,258490,258490,258493,0,3,1
73817,2,2,258492,258493,258495,1,3,0
73818,1,2,258493,258495,258497,2,4,0
73819,5,2,258498,258498,258500,0,2,1
73820,5,1,258503,258503,258504,0,1,3
73821,6,3,258509,258509,258512,0,3,5
73822,4,1,258513,258513,258514,0,1,1
73823,5,1,258518,258518,258519,0,1,4
73824,2,1,258520,258520,258521,0,1,1
73825,4,2,258524,258524,258526,0,2,3
73826,5,1,258529,258529,258530,0,1,3
73827,2,2,258531,258531,258533,0,2,1
73828,6,3,258537,258537,258540,0,3,4
73829,2,1,258539,258540,258541,1,2,0
73830,6,1,258545,258545,258546,0,1,4
73831,4,2,258549,258549,258551,0,2,3
73832,3,3,258552,258552,258555,0,3,1
73833,3,1,258555,258555,258556,0,1,0
73834,2,1,258557,258557,258558,0,1,1
73835,1,3,258558,258558,258561,0,3,0
73836,6,1,258564,258564,258565,0,1,3
73837,1,1,258565,258565,258566,0,1,0
73838,2,3,258567,258567,258570,0,3,1
73839,6,3,258573,258573,258576,0,3,3
73840,1,1,258574,258576,258577,2,3,0
73841,1,1,258575,258577,258578,2,3,0
73842,5,2,258580,258580,258582,0,2,2
73843,2,3,258582,258582,258585,0,3,0
73844,3,2,258585,258585,258587,0,2,0
73845,6,3,258591,258591,258594,0,3,4
73846,2,2,258593,258594,258596,1,3,0
73847,6,3,258599,258599,258602,0,3,3
73848,3,2,258602,258602,258604,0,2,0
73849,6,2,258608,258608,258610,0,2,4
73850,2,2,258610,258610,258612,0,2,0
73851,3,1,258613,258613,258614,0,1,1
73852,1,2,258614,258614,258616,0,2,0
73853,6,3,258620,258620,258623,0,3,4
73854,3,2,258623,258623,258625,0,2,0
73855,4,2,258627,258627,258629,0,2,2
73856,6,1,258633,258633,258634,0,1,4
73857,5,3,258638,258638,258641,0,3,4
73858,1,1,258639,258641,258642,2,3,0
73859,3,3,258642,258642,258645,0,3,0
73860,3,2,258645,258645,258647,0,2,0
73861,2,1,258647,258647,258648,0,1,0
73862,6,2,258653,258653,258655,0,2,5
73863,1,3,258654,258655,258658,1,4,0
73864,3,3,258657,258658,258661,1,4,0
73865,3,1,258660,258661,258662,1,2,0
73866,4,3,258664,258664,258667,0,3,2
73867,6,1,258670,258670,258671,0,1,3
73868,3,3,258673,258673,258676,0,3,2
73869,4,1,258677,258677,258678,0,1,1
73870,2,2,258679,258679,258681,0,2,1
73871,5,1,258684,258684,258685,0,1,3
73872,2,3,258686,258686,258689,0,3,1
73873,5,1,258691,258691,258692,0,1,2
73874,1,2,258692,258692,258694,0,2,0
73875,4,1,258696,258696,258697,0,1,2
73876,5,2,258701,258701,258703,0,2,4
73877,3,2,258704,258704,258706,0,2,1
73878,5,1,258709,258709,258710,0,1,3
73879,4,1,258713,258713,258714,0,1,3
73880,3,3,258716,258716,258719,0,3,2
73881,6,1,258722,258722,258723,0,1,3
73882,5,1,258727,258727,258728,0,1,4
73883,3,1,258730,258730,258731,0,1,2
73884,3,3,258733,258733,258736,0,3,2
73885,1,1,258734,258736,258737,2,3,0
73886,6,2,258740,258740,258742,0,2,3
73887,2,2,258742,258742,258744,0,2,0
73888,2,3,258744,258744,258747,0,3,0
73889,5,1,258749,258749,258750,0,1,2
73890,3,1,258752,258752,258753,0,1,2
73891,3,3,258755,258755,258758,0,3,2
73892,6,2,258761,258761,258763,0,2,3
73893,5,2,258766,258766,258768,0,2,3
73894,2,3,258768,258768,258771,0,3,0
73895,5,1,258773,258773,258774,0,1,2
73896,3,3,258776,258776,258779,0,3,2
73897,2,3,258778,258779,258782,1,4,0
73898,1,2,258779,258782,258784,3,5,0
73899,3,3,258782,258784,258787,2,5,0
73900,6,1,258788,258788,258789,0,1,1
73901,3,2,258791,258791,258793,0,2,2
73902,1,2,258792,258793,258795,1,3,0
73903,5,3,258797,258797,258800,0,3,2
73904,6,2,258803,258803,258805,0,2,3
73905,1,1,258804,258805,258806,1,2,0
73906,5,3,258809,258809,258812,0,3,3
73907,4,3,258813,258813,258816,0,3,1
73908,5,2,258818,258818,258820,0,2,2
73909,4,3,258822,258822,258825,0,3,2
73910,1,3,258823,258825,258828,2,5,0
73911,2,2,258825,258828,258830,3,5,0
73912,1,3,258826,258830,258833,4,7,0
73913,2,3,258828,258833,258836,5,8,0
73914,2,1,258830,258836,258837,6,7,0
73915,1,2,258831,258837,258839,6,8,0
73916,3,3,258834,258839,258842,5,8,0
73917,4,3,258838,258842,258845,4,7,0
73918,5,1,258843,258845,258846,2,3,0
73919,6,1,258849,258849,258850,0,1,3
73920,4,1,258853,258853,258854,0,1,3
73921,6,1,258859,258859,258860,0,1,5
73922,6,2,258865,258865,258867,0,2,5
73923,3,2,258868,258868,258870,0,2,1
73924,6,3,258874,258874,258877,0,3,4
73925,6,3,258880,258880,258883,0,3,3
73926,6,2,258886,258886,258888,0,2,3
73927,6,3,258892,258892,258895,0,3,4
73928,6,3,258898,258898,258901,0,3,3
73929,2,2,258900,258901,258903,1,3,0
73930,2,1,258902,258903,258904,1,2,0
73931,5,2,258907,258907,258909,0,2,3
73932,6,2,258913,258913,258915,0,2,4
73933,2,3,258915,258915,258918,0,3,0
73934,1,2,258916,258918,258920,2,4,0
73935,2,2,258918,258920,258922,2,4,0
73936,4,2,258922,258922,258924,0,2,0
73937,4,2,258926,258926,258928,0,2,2
73938,1,2,258927,258928,258930,1,3,0
73939,2,1,258929,258930,258931,1,2,0
73940,2,1,258931,258931,258932,0,1,0
73941,4,1,258935,258935,258936,0,1,3
73942,2,1,258937,258937,258938,0,1,1
73943,1,3,258938,258938,258941,0,3,0
73944,1,2,258939,258941,258943,2,4,0
73945,4,3,258943,258943,258946,0,3,0
73946,5,1,258948,258948,258949,0,1,2
73947,3,1,258951,258951,258952,0,1,2
73948,6,3,258957,258957,258960,0,3,5
73949,5,1,258962,258962,258963,0,1,2
73950,6,1,258968,258968,258969,0,1,5
73951,5,1,258973,258973,258974,0,1,4
73952,2,3,258975,258975,258978,0,3,1
73953,6,3,258981,258981,258984,0,3,3
73954,5,3,258986,258986,258989,0,3,2
73955,2,3,258988,258989,258992,1,4,0
73956,3,3,258991,258992,258995,1,4,0
73957,4,2,258995,258995,258997,0,2,0
73958,2,3,258997,258997,259000,0,3,0
73959,2,2,258999,259000,259002,1,3,0
73960,6,1,259005,259005,259006,0,1,3
73961,5,3,259010,259010,259013,0,3,4
73962,6,2,259016,259016,259018,0,2,3
73963,2,3,259018,259018,259021,0,3,0
73964,5,3,259023,259023,259026,0,3,2
73965,3,1,259026,259026,259027,0,1,0
73966,2,3,259028,259028,259031,0,3,1
73967,1,2,259029,259031,259033,2,4,0
73968,4,3,259033,259033,259036,0,3,0
73969,1,2,259034,259036,259038,2,4,0
73970,3,3,259037,259038,259041,1,4,0
73971,5,3,259042,259042,259045,0,3,1
73972,3,2,259045,259045,259047,0,2,0
73973,2,1,259047,259047,259048,0,1,0
73974,2,3,259049,259049,259052,0,3,1
73975,3,2,259052,259052,259054,0,2,0
73976,6,1,259058,259058,259059,0,1,4
73977,6,3,259064,259064,259067,0,3,5
73978,3,2,259067,259067,259069,0,2,0
73979,1,3,259068,259069,259072,1,4,0
73980,3,1,259071,259072,259073,1,2,0
73981,6,3,259077,259077,259080,0,3,4
73982,6,1,259083,259083,259084,0,1,3
73983,4,2,259087,259087,259089,0,2,3
73984,3,1,259090,259090,259091,0,1,1
73985,1,1,259091,259091,259092,0,1,0
73986,2,2,259093,259093,259095,0,2,1
73987,1,1,259094,259095,259096,1,2,0
73988,5,2,259099,259099,259101,0,2,3
73989,5,1,259104,259104,259105,0,1,3
73990,4,1,259108,259108,259109,0,1,3
73991,5,1,259113,259113,259114,0,1,4
73992,6,1,259119,259119,259120,0,1,5
73993,2,3,259121,259121,259124,0,3,1
73994,4,2,259125,259125,259127,0,2,1
73995,2,2,259127,259127,259129,0,2,0
73996,6,1,259133,259133,259134,0,1,4
73997,3,3,259136,259136,259139,0,3,2
73998,6,2,259142,259142,259144,0,2,3
73999,1,3,259143,259144,259147,1,4,0
74000,3,3,259146,259147,259150,1,4,0
74001,5,2,259151,259151,259153,0,2,1
74002,6,1,259157,259157,259158,0,1,4
74003,3,1,259160,259160,259161,0,1,2
74004,4,3,259164,259164,259167,0,3,3
74005,5,3,259169,259169,259172,0,3,2
74006,3,1,259172,259172,259173,0,1,0
74007,1,3,259173,259173,259176,0,3,0
74008,1,3,259174,259176,259179,2,5,0
74009,4,1,259178,259179,259180,1,2,0
74010,6,2,259184,259184,259186,0,2,4
74011,3,2,259187,259187,259189,0,2,1
74012,6,1,259193,259193,259194,0,1,4
74013,5,1,259198,259198,259199,0,1,4
74014,6,2,259204,259204,259206,0,2,5
74015,1,2,259205,259206,259208,1,3,0
74016,5,1,259210,259210,259211,0,1,2
74017,5,3,259215,259215,259218,0,3,4
74018,2,1,259217,259218,259219,1,2,0
74019,4,1,259221,259221,259222,0,1,2
74020,1,2,259222,259222,259224,0,2,0
74021,1,3,259223,259224,259227,1,4,0
74022,3,3,259226,259227,259230,1,4,0
74023,4,3,259230,259230,259233,0,3,0
74024,2,3,259232,259233,259236,1,4,0
74025,2,1,259234,259236,259237,2,3,0
74026,4,3,259238,259238,259241,0,3,1
74027,1,3,259239,259241,259244,2,5,0
74028,6,1,259245,259245,259246,0,1,1
74029,5,3,259250,259250,259253,0,3,4
74030,6,2,259256,259256,259258,0,2,3
74031,6,2,259262,259262,259264,0,2,4
74032,6,2,259268,259268,259270,0,2,4
74033,5,1,259273,259273,259274,0,1,3
74034,6,2,259279,259279,259281,0,2,5
74035,5,1,259284,259284,259285,0,1,3
74036,5,3,259289,259289,259292,0,3,4
74037,5,3,259294,259294,259297,0,3,2
74038,4,2,259298,259298,259300,0,2,1
74039,6,1,259304,259304,259305,0,1,4
74040,6,2,259310,259310,259312,0,2,5
74041,4,3,259314,259314,259317,0,3,2
74042,4,2,259318,259318,259320,0,2,1
74043,6,3,259324,259324,259327,0,3,4
74044,6,3,259330,259330,259333,0,3,3
74045,6,3,259336,259336,259339,0,3,3
74046,6,1,259342,259342,259343,0,1,3
74047,6,1,259348,259348,259349,0,1,5
74048,1,2,259349,259349,259351,0,2,0
74049,2,2,259351,259351,259353,0,2,0
74050,4,1,259355,259355,259356,0,1,2
74051,4,2,259359,259359,259361,0,2,3
74052,4,2,259363,259363,259365,0,2,2
74053,5,2,259368,259368,259370,0,2,3
74054,3,3,259371,259371,259374,0,3,1
74055,6,2,259377,259377,259379,0,2,3
74056,5,2,259382,259382,259384,0,2,3
74057,2,2,259384,259384,259386,0,2,0
74058,4,2,259388,259388,259390,0,2,2
74059,5,3,259393,259393,259396,0,3,3
74060,1,1,259394,259396,259397,2,3,0
74061,5,1,259399,259399,259400,0,1,2
74062,2,2,259401,259401,259403,0,2,1
74063,1,2,259402,259403,259405,1,3,0
74064,1,2,259403,259405,259407,2,4,0
74065,1,1,259404,259407,259408,3,4,0
74066,2,1,259406,259408,259409,2,3,0
74067,4,3,259410,259410,259413,0,3,1
74068,5,2,259415,259415,259417,0,2,2
74069,6,1,259421,259421,259422,0,1,4
74070,1,2,259422,259422,259424,0,2,0
74071,3,2,259425,259425,259427,0,2,1
74072,4,1,259429,259429,259430,0,1,2
74073,3,3,259432,259432,259435,0,3,2
74074,6,3,259438,259438,259441,0,3,3
74075,5,2,259443,259443,259445,0,2,2
74076,2,2,259445,259445,259447,0,2,0
74077,1,1,259446,259447,259448,1,2,0
74078,3,2,259449,259449,259451,0,2,1
74079,3,3,259452,259452,259455,0,3,1
74080,4,1,259456,259456,259457,0,1,1
74081,2,1,259458,259458,259459,0,1,1
74082,3,1,259461,259461,259462,0,1,2
74083,3,1,259464,259464,259465,0,1,2
74084,3,1,259467,259467,259468,0,1,2
74085,1,2,259468,259468,259470,0,2,0
74086,4,2,259472,259472,259474,0,2,2
74087,4,3,259476,259476,259479,0,3,2
74088,5,1,259481,259481,259482,0,1,2
74089,2,2,259483,259483,259485,0,2,1
74090,2,3,259485,259485,259488,0,3,0
74091,5,1,259490,259490,259491,0,1,2
74092,1,1,259491,259491,259492,0,1,0
74093,2,3,259493,259493,259496,0,3,1
74094,6,3,259499,259499,259502,0,3,3
74095,6,3,259505,259505,259508,0,3,3
74096,3,2,259508,259508,259510,0,2,0
74097,6,2,259514,259514,259516,0,2,4
74098,3,2,259517,259517,259519,0,2,1
74099,2,3,259519,259519,259522,0,3,0
74100,4,3,259523,259523,259526,0,3,1
74101,3,3,259526,259526,259529,0,3,0
74102,2,3,259528,259529,259532,1,4,0
74103,4,2,259532,259532,259534,0,2,0
74104,5,1,259537,259537,259538,0,1,3
74105,3,2,259540,259540,259542,0,2,2
74106,1,1,259541,259542,259543,1,2,0
74107,2,1,259543,259543,259544,0,1,0
74108,4,2,259547,259547,259549,0,2,3
74109,6,2,259553,259553,259555,0,2,4
74110,1,2,259554,259555,259557,1,3,0
74111,6,3,259560,259560,259563,0,3,3
74112,5,3,259565,259565,259568,0,3,2
74113,5,2,259570,259570,259572,0,2,2
74114,1,2,259571,259572,259574,1,3,0
74115,4,3,259575,259575,259578,0,3,1
74116,5,1,259580,259580,259581,0,1,2
74117,5,1,259585,259585,259586,0,1,4
74118,1,1,259586,259586,259587,0,1,0
74119,5,1,259591,259591,259592,0,1,4
74120,6,3,259597,259597,259600,0,3,5
74121,3,2,259600,259600,259602,0,2,0
74122,5,2,259605,259605,259607,0,2,3
74123,6,3,259611,259611,259614,0,3,4
74124,6,1,259617,259617,259618,0,1,3
74125,1,3,259618,259618,259621,0,3,0
74126,6,1,259624,259624,259625,0,1,3
74127,1,1,259625,259625,259626,0,1,0
74128,1,2,259626,259626,259628,0,2,0
74129,1,3,259627,259628,259631,1,4,0
74130,2,1,259629,259631,259632,2,3,0
74131,3,1,259632,259632,259633,0,1,0
74132,1,1,259633,259633,259634,0,1,0
74133,2,1,259635,259635,259636,0,1,1
74134,5,2,259640,259640,259642,0,2,4
74135,1,1,259641,259642,259643,1,2,0
74136,3,2,259644,259644,259646,0,2,1
74137,1,3,259645,259646,259649,1,4,0
74138,4,3,259649,259649,259652,0,3,0
74139,3,3,259652,259652,259655,0,3,0
74140,4,3,259656,259656,259659,0,3,1
74141,5,2,259661,259661,259663,0,2,2
74142,4,1,259665,259665,259666,0,1,2
74143,4,2,259669,259669,259671,0,2,3
74144,1,1,259670,259671,259672,1,2,0
74145,3,2,259673,259673,259675,0,2,1
74146,4,2,259677,259677,259679,0,2,2
74147,1,1,259678,259679,259680,1,2,0
74148,3,2,259681,259681,259683,0,2,1
74149,4,1,259685,259685,259686,0,1,2
74150,5,1,259690,259690,259691,0,1,4
74151,3,2,259693,259693,259695,0,2,2
74152,3,2,259696,259696,259698,0,2,1
74153,6,2,259702,259702,259704,0,2,4
74154,3,1,259705,259705,259706,0,1,1
74155,2,2,259707,259707,259709,0,2,1
74156,6,1,259713,259713,259714,0,1,4
74157,5,3,259718,259718,259721,0,3,4
74158,5,3,259723,259723,259726,0,3,2
74159,5,3,259728,259728,259731,0,3,2
74160,2,2,259730,259731,259733,1,3,0
74161,1,3,259731,259733,259736,2,5,0
74162,4,3,259735,259736,259739,1,4,0
74163,1,1,259736,259739,259740,3,4,0
74164,2,2,259738,259740,259742,2,4,0
74165,6,3,259744,259744,259747,0,3,2
74166,1,2,259745,259747,259749,2,4,0
74167,3,2,259748,259749,259751,1,3,0
74168,4,2,259752,259752,259754,0,2,1
74169,4,3,259756,259756,259759,0,3,2
74170,6,1,259762,259762,259763,0,1,3
74171,5,1,259767,259767,259768,0,1,4
74172,1,1,259768,259768,259769,0,1,0
74173,1,3,259769,259769,259772,0,3,0
74174,2,3,259771,259772,259775,1,4,0
74175,5,3,259776,259776,259779,0,3,1
74176,3,1,259779,259779,259780,0,1,0
74177,6,3,259785,259785,259788,0,3,5
74178,5,2,259790,259790,259792,0,2,2
74179,6,3,259796,259796,259799,0,3,4
74180,6,1,259802,259802,259803,0,1,3
74181,5,1,259807,259807,259808,0,1,4
74182,2,3,259809,259809,259812,0,3,1
74183,6,2,259815,259815,259817,0,2,3
74184,1,2,259816,259817,259819,1,3,0
74185,1,1,259817,259819,259820,2,3,0
74186,6,2,259823,259823,259825,0,2,3
74187,2,1,259825,259825,259826,0,1,0
74188,1,3,259826,259826,259829,0,3,0
74189,2,2,259828,259829,259831,1,3,0
74190,2,1,259830,259831,259832,1,2,0
74191,5,3,259835,259835,259838,0,3,3
74192,5,1,259840,259840,259841,0,1,2
74193,2,2,259842,259842,259844,0,2,1
74194,6,1,259848,259848,259849,0,1,4
74195,5,3,259853,259853,259856,0,3,4
74196,3,3,259856,259856,259859,0,3,0
74197,5,3,259861,259861,259864,0,3,2
74198,1,3,259862,259864,259867,2,5,0
74199,6,1,259868,259868,259869,0,1,1
74200,3,3,259871,259871,259874,0,3,2
74201,5,3,259876,259876,259879,0,3,2
74202,4,1,259880,259880,259881,0,1,1
74203,5,1,259885,259885,259886,0,1,4
74204,6,3,259891,259891,259894,0,3,5
74205,6,3,259897,259897,259900,0,3,3
74206,5,3,259902,259902,259905,0,3,2
74207,6,3,259908,259908,259911,0,3,3
74208,6,1,259914,259914,259915,0,1,3
74209,1,1,259915,259915,259916,0,1,0
74210,3,2,259918,259918,259920,0,2,2
74211,4,1,259922,259922,259923,0,1,2
74212,6,2,259928,259928,259930,0,2,5
74213,5,1,259933,259933,259934,0,1,3
74214,1,1,259934,259934,259935,0,1,0
74215,3,2,259937,259937,259939,0,2,2
74216,4,2,259941,259941,259943,0,2,2
74217,4,2,259945,259945,259947,0,2,2
74218,6,3,259951,259951,259954,0,3,4
74219,1,1,259952,259954,259955,2,3,0
74220,3,3,259955,259955,259958,0,3,0
74221,6,2,259961,259961,259963,0,2,3
74222,5,1,259966,259966,259967,0,1,3
74223,6,3,259972,259972,259975,0,3,5
74224,5,2,259977,259977,259979,0,2,2
74225,6,1,259983,259983,259984,0,1,4
74226,2,1,259985,259985,259986,0,1,1
74227,1,3,259986,259986,259989,0,3,0
74228,6,1,259992,259992,259993,0,1,3
74229,4,1,259996,259996,259997,0,1,3
74230,5,1,260001,260001,260002,0,1,4
74231,5,2,260006,260006,260008,0,2,4
74232,1,2,260007,260008,260010,1,3,0
74233,4,2,260011,260011,260013,0,2,1
74234,5,3,260016,260016,260019,0,3,3
74235,2,1,260018,260019,260020,1,2,0
74236,1,3,260019,260020,260023,1,4,0
74237,3,2,260022,260023,260025,1,3,0
74238,3,1,260025,260025,260026,0,1,0
74239,4,3,260029,260029,260032,0,3,3
74240,3,2,260032,260032,260034,0,2,0
74241,2,1,260034,260034,260035,0,1,0
74242,2,1,260036,260036,260037,0,1,1
74243,5,3,260041,260041,260044,0,3,4
74244,1,1,260042,260044,260045,2,3,0
74245,4,2,260046,260046,260048,0,2,1
74246,6,1,260052,260052,260053,0,1,4
74247,4,2,260056,260056,260058,0,2,3
74248,3,3,260059,260059,260062,0,3,1
74249,2,1,260061,260062,260063,1,2,0
74250,3,1,260064,260064,260065,0,1,1
74251,5,1,260069,260069,260070,0,1,4
74252,6,2,260075,260075,260077,0,2,5
74253,4,1,260079,260079,260080,0,1,2
74254,6,3,260085,260085,260088,0,3,5
74255,6,3,260091,260091,260094,0,3,3
74256,3,3,260094,260094,260097,0,3,0
74257,5,3,260099,260099,260102,0,3,2
74258,3,3,260102,260102,260105,0,3,0
74259,5,3,260107,260107,260110,0,3,2
74260,5,3,260112,260112,260115,0,3,2
74261,3,2,260115,260115,260117,0,2,0
74262,5,3,260120,260120,260123,0,3,3
74263,1,1,260121,260123,260124,2,3,0
74264,1,2,260122,260124,260126,2,4,0
74265,6,3,260128,260128,260131,0,3,2
74266,1,1,260129,260131,260132,2,3,0
74267,4,3,260133,260133,260136,0,3,1
74268,3,2,260136,260136,260138,0,2,0
74269,2,3,260138,260138,260141,0,3,0
74270,4,2,260142,260142,260144,0,2,1
74271,3,2,260145,260145,260147,0,2,1
74272,3,2,260148,260148,260150,0,2,1
74273,5,3,260153,260153,260156,0,3,3
74274,5,2,260158,260158,260160,0,2,2
74275,4,2,260162,260162,260164,0,2,2
74276,4,3,260166,260166,260169,0,3,2
74277,5,1,260171,260171,260172,0,1,2
74278,1,1,260172,260172,260173,0,1,0
74279,5,3,260177,260177,260180,0,3,4
74280,5,2,260182,260182,260184,0,2,2
74281,1,3,260183,260184,260187,1,4,0
74282,3,3,260186,260187,260190,1,4,0
74283,1,1,260187,260190,260191,3,4,0
74284,4,3,260191,260191,260194,0,3,0
74285,1,3,260192,260194,260197,2,5,0
74286,1,2,260193,260197,260199,4,6,0
74287,1,2,260194,260199,260201,5,7,0
74288,1,2,260195,260201,260203,6,8,0
74289,5,2,260200,260203,260205,3,5,0
74290,2,3,260202,260205,260208,3,6,0
74291,4,3,260206,260208,260211,2,5,0
74292,2,3,260208,260211,260214,3,6,0
74293,2,2,260210,260214,260216,4,6,0
74294,2,3,260212,260216,260219,4,7,0
74295,3,1,260215,260219,260220,4,5,0
74296,5,3,260220,260220,260223,0,3,0
74297,6,3,260226,260226,260229,0,3,3
74298,3,3,260229,260229,260232,0,3,0
74299,5,2,260234,260234,260236,0,2,2
74300,2,1,260236,260236,260237,0,1,0
74301,1,2,260237,260237,260239,0,2,0
74302,1,2,260238,260239,260241,1,3,0
74303,1,2,260239,260241,260243,2,4,0
74304,3,1,260242,260243,260244,1,2,0
74305,6,2,260248,260248,260250,0,2,4
74306,4,2,260252,260252,260254,0,2,2
74307,5,3,260257,260257,260260,0,3,3
74308,3,1,260260,260260,260261,0,1,0
74309,1,1,260261,260261,260262,0,1,0
74310,2,2,260263,260263,260265,0,2,1
74311,3,3,260266,260266,260269,0,3,1
74312,4,1,260270,260270,260271,0,1,1
74313,1,3,260271,260271,260274,0,3,0
74314,5,3,260276,260276,260279,0,3,2
74315,2,3,260278,260279,260282,1,4,0
74316,1,1,260279,260282,260283,3,4,0
74317,3,3,260282,260283,260286,1,4,0
74318,2,3,260284,260286,260289,2,5,0
74319,3,3,260287,260289,260292,2,5,0
74320,3,1,260290,260292,260293,2,3,0
74321,4,2,260294,260294,260296,0,2,1
74322,2,3,260296,260296,260299,0,3,0
74323,2,2,260298,260299,260301,1,3,0
74324,6,2,260304,260304,260306,0,2,3
74325,4,3,260308,260308,260311,0,3,2
74326,2,3,260310,260311,260314,1,4,0
74327,2,3,260312,260314,260317,2,5,0
74328,6,3,260318,260318,260321,0,3,1
74329,6,1,260324,260324,260325,0,1,3
74330,6,1,260330,260330,260331,0,1,5
74331,4,1,260334,260334,260335,0,1,3
74332,1,2,260335,260335,260337,0,2,0
74333,1,2,260336,260337,260339,1,3,0
74334,4,2,260340,260340,260342,0,2,1
74335,4,2,260344,260344,260346,0,2,2
74336,4,3,260348,260348,260351,0,3,2
74337,4,1,260352,260352,260353,0,1,1
74338,2,3,260354,260354,260357,0,3,1
74339,2,1,260356,260357,260358,1,2,0
74340,2,1,260358,260358,260359,0,1,0
74341,3,1,260361,260361,260362,0,1,2
74342,3,1,260364,260364,260365,0,1,2
74343,4,3,260368,260368,260371,0,3,3
74344,6,3,260374,260374,260377,0,3,3
74345,6,2,260380,260380,260382,0,2,3
74346,4,3,260384,260384,260387,0,3,2
74347,6,3,260390,260390,260393,0,3,3
74348,5,2,260395,260395,260397,0,2,2
74349,6,3,260401,260401,260404,0,3,4
74350,4,3,260405,260405,260408,0,3,1
74351,3,2,260408,260408,260410,0,2,0
74352,2,1,260410,260410,260411,0,1,0
74353,2,1,260412,260412,260413,0,1,1
74354,1,1,260413,260413,260414,0,1,0
74355,1,3,260414,260414,260417,0,3,0
74356,1,3,260415,260417,260420,2,5,0
74357,5,1,260420,260420,260421,0,1,0
74358,6,2,260426,260426,260428,0,2,5
74359,4,3,260430,260430,260433,0,3,2
74360,3,2,260433,260433,260435,0,2,0
74361,5,3,260438,260438,260441,0,3,3
74362,4,2,260442,260442,260444,0,2,1
74363,6,2,260448,260448,260450,0,2,4
74364,6,1,260454,260454,260455,0,1,4
74365,3,3,260457,260457,260460,0,3,2
74366,6,2,260463,260463,260465,0,2,3
74367,2,3,260465,260465,260468,0,3,0
74368,5,2,260470,260470,260472,0,2,2
74369,3,2,260473,260473,260475,0,2,1
74370,5,1,260478,260478,260479,0,1,3
74371,1,1,260479,260479,260480,0,1,0
74372,2,2,260481,260481,260483,0,2,1
74373,6,2,260487,260487,260489,0,2,4
74374,4,3,260491,260491,260494,0,3,2
74375,1,3,260492,260494,260497,2,5,0
74376,3,2,260495,260497,260499,2,4,0
74377,4,1,260499,260499,260500,0,1,0
74378,4,2,260503,260503,260505,0,2,3
74379,3,1,260506,260506,260507,0,1,1
74380,4,3,260510,260510,260513,0,3,3
74381,6,3,260516,260516,260519,0,3,3
74382,2,2,260518,260519,260521,1,3,0
74383,1,3,260519,260521,260524,2,5,0
74384,6,3,260525,260525,260528,0,3,1
74385,4,2,260529,260529,260531,0,2,1
74386,2,3,260531,260531,260534,0,3,0
74387,4,1,260535,260535,260536,0,1,1
74388,6,2,260541,260541,260543,0,2,5
74389,5,2,260546,260546,260548,0,2,3
74390,3,1,260549,260549,260550,0,1,1
74391,4,1,260553,260553,260554,0,1,3
74392,2,2,260555,260555,260557,0,2,1
74393,2,2,260557,260557,260559,0,2,0
74394,2,3,260559,260559,260562,0,3,0
74395,6,1,260565,260565,260566,0,1,3
74396,4,2,260569,260569,260571,0,2,3
74397,4,3,260573,260573,260576,0,3,2
74398,1,3,260574,260576,260579,2,5,0
74399,4,3,260578,260579,260582,1,4,0
74400,6,1,260584,260584,260585,0,1,2
74401,4,1,260588,260588,260589,0,1,3
74402,3,3,260591,260591,260594,0,3,2
74403,5,3,260596,260596,260599,0,3,2
74404,2,1,260598,260599,260600,1,2,0
74405,4,1,260602,260602,260603,0,1,2
74406,1,2,260603,260603,260605,0,2,0
74407,3,2,260606,260606,260608,0,2,1
74408,5,3,260611,260611,260614,0,3,3
74409,1,1,260612,260614,260615,2,3,0
74410,3,3,260615,260615,260618,0,3,0
74411,6,2,260621,260621,260623,0,2,3
74412,6,1,260627,260627,260628,0,1,4
74413,6,1,260633,260633,260634,0,1,5
74414,6,3,260639,260639,260642,0,3,5
74415,5,2,260644,260644,260646,0,2,2
74416,4,3,260648,260648,260651,0,3,2
74417,1,2,260649,260651,260653,2,4,0
74418,2,3,260651,260653,260656,2,5,0
74419,2,1,260653,260656,260657,3,4,0
74420,6,2,260659,260659,260661,0,2,2
74421,2,1,260661,260661,260662,0,1,0
74422,2,2,260663,260663,260665,0,2,1
74423,6,3,260669,260669,260672,0,3,4
74424,5,2,260674,260674,260676,0,2,2
74425,3,1,260677,260677,260678,0,1,1
74426,2,3,260679,260679,260682,0,3,1
74427,1,3,260680,260682,260685,2,5,0
74428,2,1,260682,260685,260686,3,4,0
74429,2,1,260684,260686,260687,2,3,0
74430,6,3,260690,260690,260693,0,3,3
74431,1,1,260691,260693,260694,2,3,0
74432,6,3,260697,260697,260700,0,3,3
74433,1,2,260698,260700,260702,2,4,0
74434,2,2,260700,260702,260704,2,4,0
74435,6,2,260706,260706,260708,0,2,2
74436,3,1,260709,260709,260710,0,1,1
74437,5,1,260714,260714,260715,0,1,4
74438,1,2,260715,260715,260717,0,2,0
74439,2,2,260717,260717,260719,0,2,0
74440,4,2,260721,260721,260723,0,2,2
74441,3,3,260724,260724,260727,0,3,1
74442,6,1,260730,260730,260731,0,1,3
74443,6,2,260736,260736,260738,0,2,5
74444,1,3,260737,260738,260741,1,4,0
74445,4,3,260741,260741,260744,0,3,0
74446,5,2,260746,260746,260748,0,2,2
74447,4,1,260750,260750,260751,0,1,2
74448,2,1,260752,260752,260753,0,1,1
74449,1,1,260753,260753,260754,0,1,0
74450,6,3,260759,260759,260762,0,3,5
74451,1,3,260760,260762,260765,2,5,0
74452,3,1,260763,260765,260766,2,3,0
74453,3,2,260766,260766,260768,0,2,0
74454,1,1,260767,260768,260769,1,2,0
74455,4,1,260771,260771,260772,0,1,2
74456,4,3,260775,260775,260778,0,3,3
74457,1,3,260776,260778,260781,2,5,0
74458,5,2,260781,260781,260783,0,2,0
74459,5,1,260786,260786,260787,0,1,3
74460,5,2,260791,260791,260793,0,2,4
74461,1,1,260792,260793,260794,1,2,0
74462,1,3,260793,260794,260797,1,4,0
74463,3,3,260796,260797,260800,1,4,0
74464,5,1,260801,260801,260802,0,1,1
74465,6,3,260807,260807,260810,0,3,5
74466,4,2,260811,260811,260813,0,2,1
74467,3,1,260814,260814,260815,0,1,1
74468,1,1,260815,260815,260816,0,1,0
74469,6,3,260821,260821,260824,0,3,5
74470,3,3,260824,260824,260827,0,3,0
74471,6,2,260830,260830,260832,0,2,3
74472,3,1,260833,260833,260834,0,1,1
74473,1,3,260834,260834,260837,0,3,0
74474,5,3,260839,260839,260842,0,3,2
74475,1,1,260840,260842,260843,2,3,0
74476,4,2,260844,260844,260846,0,2,1
74477,1,2,260845,260846,260848,1,3,0
74478,2,3,260847,260848,260851,1,4,0
74479,3,2,260850,260851,260853,1,3,0
74480,2,1,260852,260853,260854,1,2,0
74481,1,2,260853,260854,260856,1,3,0
74482,2,2,260855,260856,260858,1,3,0
74483,2,2,260857,260858,260860,1,3,0
74484,1,2,260858,260860,260862,2,4,0
74485,5,3,260863,260863,260866,0,3,1
74486,6,3,260869,260869,260872,0,3,3
74487,1,1,260870,260872,260873,2,3,0
74488,1,2,260871,260873,260875,2,4,0
74489,4,2,260875,260875,260877,0,2,0
74490,6,2,260881,260881,260883,0,2,4
74491,4,2,260885,260885,260887,0,2,2
74492,4,1,260889,260889,260890,0,1,2
74493,2,1,260891,260891,260892,0,1,1
74494,6,3,260897,260897,260900,0,3,5
74495,5,2,260902,260902,260904,0,2,2
74496,3,1,260905,260905,260906,0,1,1
74497,2,2,260907,260907,260909,0,2,1
74498,6,2,260913,260913,260915,0,2,4
74499,3,2,260916,260916,260918,0,2,1
74500,3,2,260919,260919,260921,0,2,1
74501,5,3,260924,260924,260927,0,3,3
74502,1,2,260925,260927,260929,2,4,0
74503,6,2,260931,260931,260933,0,2,2
74504,4,2,260935,260935,260937,0,2,2
74505,4,3,260939,260939,260942,0,3,2
74506,1,2,260940,260942,260944,2,4,0
74507,6,2,260946,260946,260948,0,2,2
74508,3,2,260949,260949,260951,0,2,1
74509,4,2,260953,260953,260955,0,2,2
74510,3,2,260956,260956,260958,0,2,1
74511,5,3,260961,260961,260964,0,3,3
74512,5,2,260966,260966,260968,0,2,2
74513,1,2,260967,260968,260970,1,3,0
74514,6,2,260973,260973,260975,0,2,3
74515,4,2,260977,260977,260979,0,2,2
74516,3,2,260980,260980,260982,0,2,1
74517,1,3,260981,260982,260985,1,4,0
74518,5,2,260986,260986,260988,0,2,1
74519,3,1,260989,260989,260990,0,1,1
74520,3,1,260992,260992,260993,0,1,2
74521,5,2,260997,260997,260999,0,2,4
74522,4,3,261001,261001,261004,0,3,2
74523,5,1,261006,261006,261007,0,1,2
74524,4,2,261010,261010,261012,0,2,3
74525,5,1,261015,261015,261016,0,1,3
74526,4,1,261019,261019,261020,0,1,3
74527,1,3,261020,261020,261023,0,3,0
74528,6,2,261026,261026,261028,0,2,3
74529,2,3,261028,261028,261031,0,3,0
74530,4,1,261032,261032,261033,0,1,1
74531,2,2,261034,261034,261036,0,2,1
74532,1,3,261035,261036,261039,1,4,0
74533,2,3,261037,261039,261042,2,5,0
74534,3,3,261040,261042,261045,2,5,0
74535,1,1,261041,261045,261046,4,5,0
74536,1,1,261042,261046,261047,4,5,0
74537,6,2,261048,261048,261050,0,2,1
74538,5,3,261053,261053,261056,0,3,3
74539,3,3,261056,261056,261059,0,3,0
74540,3,1,261059,261059,261060,0,1,0
74541,3,3,261062,261062,261065,0,3,2
74542,5,1,261067,261067,261068,0,1,2
74543,1,2,261068,261068,261070,0,2,0
74544,4,2,261072,261072,261074,0,2,2
74545,1,2,261073,261074,261076,1,3,0
74546,3,2,261076,261076,261078,0,2,0
74547,1,2,261077,261078,261080,1,3,0
74548,3,2,261080,261080,261082,0,2,0
74549,5,3,261085,261085,261088,0,3,3
74550,5,1,261090,261090,261091,0,1,2
74551,2,2,261092,261092,261094,0,2,1
74552,3,1,261095,261095,261096,0,1,1
74553,2,1,261097,261097,261098,0,1,1
74554,3,1,261100,261100,261101,0,1,2
74555,5,2,261105,261105,261107,0,2,4
74556,1,2,261106,261107,261109,1,3,0
74557,5,1,261111,261111,261112,0,1,2
74558,6,1,261117,261117,261118,0,1,5
74559,5,1,261122,261122,261123,0,1,4
74560,5,1,261127,261127,261128,0,1,4
74561,4,1,261131,261131,261132,0,1,3
74562,4,2,261135,261135,261137,0,2,3
74563,2,1,261137,261137,261138,0,1,0
74564,5,3,261142,261142,261145,0,3,4
74565,5,1,261147,261147,261148,0,1,2
74566,4,3,261151,261151,261154,0,3,3
74567,1,1,261152,261154,261155,2,3,0
74568,6,1,261158,261158,261159,0,1,3
74569,6,2,261164,261164,261166,0,2,5
74570,3,2,261167,261167,261169,0,2,1
74571,1,1,261168,261169,261170,1,2,0
74572,1,1,261169,261170,261171,1,2,0
74573,5,2,261174,261174,261176,0,2,3
74574,4,3,261178,261178,261181,0,3,2
74575,3,2,261181,261181,261183,0,2,0
74576,4,2,261185,261185,261187,0,2,2
74577,1,1,261186,261187,261188,1,2,0
74578,5,2,261191,261191,261193,0,2,3
74579,2,3,261193,261193,261196,0,3,0
74580,5,3,261198,261198,261201,0,3,2
74581,3,2,261201,261201,261203,0,2,0
74582,2,1,261203,261203,261204,0,1,0
74583,2,2,261205,261205,261207,0,2,1
74584,4,2,261209,261209,261211,0,2,2
74585,2,2,261211,261211,261213,0,2,0
74586,5,1,261216,261216,261217,0,1,3
74587,4,3,261220,261220,261223,0,3,3
74588,5,3,261225,261225,261228,0,3,2
74589,6,1,261231,261231,261232,0,1,3
74590,2,1,261233,261233,261234,0,1,1
74591,5,1,261238,261238,261239,0,1,4
74592,5,1,261243,261243,261244,0,1,4
74593,3,1,261246,261246,261247,0,1,2
74594,1,1,261247,261247,261248,0,1,0
74595,2,2,261249,261249,261251,0,2,1
74596,1,2,261250,261251,261253,1,3,0
74597,3,2,261253,261253,261255,0,2,0
74598,3,1,261256,261256,261257,0,1,1
74599,5,3,261261,261261,261264,0,3,4
74600,1,2,261262,261264,261266,2,4,0
74601,2,2,261264,261266,261268,2,4,0
74602,6,1,261270,261270,261271,0,1,2
74603,5,2,261275,261275,261277,0,2,4
74604,2,1,261277,261277,261278,0,1,0
74605,4,1,261281,261281,261282,0,1,3
74606,4,2,261285,261285,261287,0,2,3
74607,2,1,261287,261287,261288,0,1,0
74608,6,1,261293,261293,261294,0,1,5
74609,4,2,261297,261297,261299,0,2,3
74610,4,2,261301,261301,261303,0,2,2
74611,5,1,261306,261306,261307,0,1,3
74612,5,1,261311,261311,261312,0,1,4
74613,3,1,261314,261314,261315,0,1,2
74614,2,2,261316,261316,261318,0,2,1
74615,3,2,261319,261319,261321,0,2,1
74616,6,3,261325,261325,261328,0,3,4
74617,1,3,261326,261328,261331,2,5,0
74618,4,2,261330,261331,261333,1,3,0
74619,5,3,261335,261335,261338,0,3,2
74620,4,3,261339,261339,261342,0,3,1
74621,5,2,261344,261344,261346,0,2,2
74622,6,2,261350,261350,261352,0,2,4
74623,5,1,261355,261355,261356,0,1,3
74624,4,2,261359,261359,261361,0,2,3
74625,5,2,261364,261364,261366,0,2,3
74626,5,3,261369,261369,261372,0,3,3
74627,1,2,261370,261372,261374,2,4,0
74628,2,2,261372,261374,261376,2,4,0
74629,2,1,261374,261376,261377,2,3,0
74630,3,2,261377,261377,261379,0,2,0
74631,1,2,261378,261379,261381,1,3,0
74632,5,1,261383,261383,261384,0,1,2
74633,3,3,261386,261386,261389,0,3,2
74634,2,3,261388,261389,261392,1,4,0
74635,1,2,261389,261392,261394,3,5,0
74636,4,3,261393,261394,261397,1,4,0
74637,4,1,261397,261397,261398,0,1,0
74638,6,3,261403,261403,261406,0,3,5
74639,1,1,261404,261406,261407,2,3,0
74640,4,1,261408,261408,261409,0,1,1
74641,6,1,261414,261414,261415,0,1,5
74642,1,3,261415,261415,261418,0,3,0
74643,6,2,261421,261421,261423,0,2,3
74644,3,2,261424,261424,261426,0,2,1
74645,2,3,261426,261426,261429,0,3,0
74646,3,3,261429,261429,261432,0,3,0
74647,1,1,261430,261432,261433,2,3,0
74648,5,2,261435,261435,261437,0,2,2
74649,5,3,261440,261440,261443,0,3,3
74650,1,1,261441,261443,261444,2,3,0
74651,3,1,261444,261444,261445,0,1,0
74652,4,1,261448,261448,261449,0,1,3
74653,3,2,261451,261451,261453,0,2,2
74654,6,3,261457,261457,261460,0,3,4
74655,1,2,261458,261460,261462,2,4,0
74656,5,1,261463,261463,261464,0,1,1
74657,3,3,261466,261466,261469,0,3,2
74658,2,1,261468,261469,261470,1,2,0
74659,3,2,261471,261471,261473,0,2,1
74660,2,2,261473,261473,261475,0,2,0
74661,4,1,261477,261477,261478,0,1,2
74662,2,1,261479,261479,261480,0,1,1
74663,2,2,261481,261481,261483,0,2,1
74664,5,1,261486,261486,261487,0,1,3
74665,4,3,261490,261490,261493,0,3,3
74666,4,1,261494,261494,261495,0,1,1
74667,3,1,261497,261497,261498,0,1,2
74668,2,3,261499,261499,261502,0,3,1
74669,4,3,261503,261503,261506,0,3,1
74670,6,1,261509,261509,261510,0,1,3
74671,6,2,261515,261515,261517,0,2,5
74672,4,2,261519,261519,261521,0,2,2
74673,2,3,261521,261521,261524,0,3,0
74674,4,2,261525,261525,261527,0,2,1
74675,3,3,261528,261528,261531,0,3,1
74676,2,3,261530,261531,261534,1,4,0
74677,4,1,261534,261534,261535,0,1,0
74678,6,3,261540,261540,261543,0,3,5
74679,5,1,261545,261545,261546,0,1,2
74680,4,1,261549,261549,261550,0,1,3
74681,2,3,261551,261551,261554,0,3,1
74682,5,2,261556,261556,261558,0,2,2
74683,5,1,261561,261561,261562,0,1,3
74684,1,2,261562,261562,261564,0,2,0
74685,4,3,261566,261566,261569,0,3,2
74686,2,1,261568,261569,261570,1,2,0
74687,1,1,261569,261570,261571,1,2,0
74688,6,3,261575,261575,261578,0,3,4
74689,2,1,261577,261578,261579,1,2,0
74690,3,2,261580,261580,261582,0,2,1
74691,6,3,261586,261586,261589,0,3,4
74692,5,3,261591,261591,261594,0,3,2
74693,4,1,261595,261595,261596,0,1,1
74694,3,3,261598,261598,261601,0,3,2
74695,4,3,261602,261602,261605,0,3,1
74696,3,3,261605,261605,261608,0,3,0
74697,3,3,261608,261608,261611,0,3,0
74698,2,2,261610,261611,261613,1,3,0
74699,4,2,261614,261614,261616,0,2,1
74700,3,2,261617,261617,261619,0,2,1
74701,4,1,261621,261621,261622,0,1,2
74702,1,1,261622,261622,261623,0,1,0
74703,4,2,261626,261626,261628,0,2,3
74704,6,3,261632,261632,261635,0,3,4
74705,4,2,261636,261636,261638,0,2,1
74706,2,2,261638,261638,261640,0,2,0
74707,1,1,261639,261640,261641,1,2,0
74708,6,2,261645,261645,261647,0,2,4
74709,1,1,261646,261647,261648,1,2,0
74710,5,1,261651,261651,261652,0,1,3
74711,4,3,261655,261655,261658,0,3,3
74712,3,3,261658,261658,261661,0,3,0
74713,3,3,261661,261661,261664,0,3,0
74714,6,1,261667,261667,261668,0,1,3
74715,3,2,261670,261670,261672,0,2,2
74716,4,1,261674,261674,261675,0,1,2
74717,5,2,261679,261679,261681,0,2,4
74718,5,2,261684,261684,261686,0,2,3
74719,1,2,261685,261686,261688,1,3,0
74720,3,2,261688,261688,261690,0,2,0
74721,6,2,261694,261694,261696,0,2,4
74722,4,1,261698,261698,261699,0,1,2
74723,1,1,261699,261699,261700,0,1,0
74724,2,3,261701,261701,261704,0,3,1
74725,1,2,261702,261704,261706,2,4,0
74726,5,2,261707,261707,261709,0,2,1
74727,1,1,261708,261709,261710,1,2,0
74728,4,3,261712,261712,261715,0,3,2
74729,2,2,261714,261715,261717,1,3,0
74730,5,3,261719,261719,261722,0,3,2
74731,6,2,261725,261725,261727,0,2,3
74732,6,3,261731,261731,261734,0,3,4
74733,3,3,261734,261734,261737,0,3,0
74734,5,2,261739,261739,261741,0,2,2
74735,6,1,261745,261745,261746,0,1,4
74736,2,1,261747,261747,261748,0,1,1
74737,1,1,261748,261748,261749,0,1,0
74738,6,2,261754,261754,261756,0,2,5
74739,2,1,261756,261756,261757,0,1,0
74740,3,3,261759,261759,261762,0,3,2
74741,5,2,261764,261764,261766,0,2,2
74742,3,2,261767,261767,261769,0,2,1
74743,1,1,261768,261769,261770,1,2,0
74744,2,1,261770,261770,261771,0,1,0
74745,5,1,261775,261775,261776,0,1,4
74746,4,2,261779,261779,261781,0,2,3
74747,3,1,261782,261782,261783,0,1,1
74748,2,1,261784,261784,261785,0,1,1
74749,1,1,261785,261785,261786,0,1,0
74750,6,3,261791,261791,261794,0,3,5
74751,6,1,261797,261797,261798,0,1,3
74752,2,2,261799,261799,261801,0,2,1
74753,1,1,261800,261801,261802,1,2,0
74754,5,1,261805,261805,261806,0,1,3
74755,6,1,261811,261811,261812,0,1,5
74756,4,3,261815,261815,261818,0,3,3
74757,5,3,261820,261820,261823,0,3,2
74758,5,3,261825,261825,261828,0,3,2
74759,4,3,261829,261829,261832,0,3,1
74760,1,1,261830,261832,261833,2,3,0
74761,1,2,261831,261833,261835,2,4,0
74762,2,1,261833,261835,261836,2,3,0
74763,1,1,261834,261836,261837,2,3,0
74764,6,1,261840,261840,261841,0,1,3
74765,1,1,261841,261841,261842,0,1,0
74766,2,2,261843,261843,261845,0,2,1
74767,3,2,261846,261846,261848,0,2,1
74768,6,3,261852,261852,261855,0,3,4
74769,5,1,261857,261857,261858,0,1,2
74770,4,1,261861,261861,261862,0,1,3
74771,3,2,261864,261864,261866,0,2,2
74772,4,2,261868,261868,261870,0,2,2
74773,2,2,261870,261870,261872,0,2,0
74774,2,3,261872,261872,261875,0,3,0
74775,3,3,261875,261875,261878,0,3,0
74776,4,1,261879,261879,261880,0,1,1
74777,3,2,261882,261882,261884,0,2,2
74778,4,2,261886,261886,261888,0,2,2
74779,2,1,261888,261888,261889,0,1,0
74780,2,1,261890,261890,261891,0,1,1
74781,2,2,261892,261892,261894,0,2,1
74782,3,3,261895,261895,261898,0,3,1
74783,6,2,261901,261901,261903,0,2,3
74784,2,2,261903,261903,261905,0,2,0
74785,6,3,261909,261909,261912,0,3,4
74786,6,1,261915,261915,261916,0,1,3
74787,4,3,261919,261919,261922,0,3,3
74788,2,2,261921,261922,261924,1,3,0
74789,2,3,261923,261924,261927,1,4,0
74790,1,3,261924,261927,261930,3,6,0
74791,4,2,261928,261930,261932,2,4,0
74792,2,1,261930,261932,261933,2,3,0
74793,2,2,261932,261933,261935,1,3,0
74794,5,1,261937,261937,261938,0,1,2
74795,1,2,261938,261938,261940,0,2,0
74796,3,3,261941,261941,261944,0,3,1
74797,3,1,261944,261944,261945,0,1,0
74798,6,3,261950,261950,261953,0,3,5
74799,6,1,261956,261956,261957,0,1,3
74800,3,3,261959,261959,261962,0,3,2
74801,3,3,261962,261962,261965,0,3,0
74802,3,1,261965,261965,261966,0,1,0
74803,5,1,261970,261970,261971,0,1,4
74804,3,1,261973,261973,261974,0,1,2
74805,4,1,261977,261977,261978,0,1,3
74806,3,2,261980,261980,261982,0,2,2
74807,6,2,261986,261986,261988,0,2,4
74808,5,3,261991,261991,261994,0,3,3
74809,1,2,261992,261994,261996,2,4,0
74810,5,2,261997,261997,261999,0,2,1
74811,3,3,262000,262000,262003,0,3,1
74812,3,3,262003,262003,262006,0,3,0
74813,3,2,262006,262006,262008,0,2,0
74814,2,3,262008,262008,262011,0,3,0
74815,3,2,262011,262011,262013,0,2,0
74816,6,3,262017,262017,262020,0,3,4
74817,4,2,262021,262021,262023,0,2,1
74818,1,2,262022,262023,262025,1,3,0
74819,5,3,262027,262027,262030,0,3,2
74820,1,1,262028,262030,262031,2,3,0
74821,1,3,262029,262031,262034,2,5,0
74822,6,3,262035,262035,262038,0,3,1
74823,1,1,262036,262038,262039,2,3,0
74824,5,2,262041,262041,262043,0,2,2
74825,4,1,262045,262045,262046,0,1,2
74826,6,2,262051,262051,262053,0,2,5
74827,5,1,262056,262056,262057,0,1,3
74828,5,1,262061,262061,262062,0,1,4
74829,5,2,262066,262066,262068,0,2,4
74830,3,2,262069,262069,262071,0,2,1
74831,5,1,262074,262074,262075,0,1,3
74832,1,1,262075,262075,262076,0,1,0
74833,2,3,262077,262077,262080,0,3,1
74834,4,1,262081,262081,262082,0,1,1
74835,2,3,262083,262083,262086,0,3,1
74836,4,1,262087,262087,262088,0,1,1
74837,6,2,262093,262093,262095,0,2,5
74838,2,2,262095,262095,262097,0,2,0
74839,2,1,262097,262097,262098,0,1,0
74840,2,1,262099,262099,262100,0,1,1
74841,5,1,262104,262104,262105,0,1,4
74842,2,1,262106,262106,262107,0,1,1
74843,1,1,262107,262107,262108,0,1,0
74844,2,2,262109,262109,262111,0,2,1
74845,1,3,262110,262111,262114,1,4,0
74846,6,2,262116,262116,262118,0,2,2
74847,5,1,262121,262121,262122,0,1,3
74848,3,3,262124,262124,262127,0,3,2
74849,3,2,262127,262127,262129,0,2,0
74850,3,3,262130,262130,262133,0,3,1
74851,1,3,262131,262133,262136,2,5,0
74852,6,2,262137,262137,262139,0,2,1
74853,1,2,262138,262139,262141,1,3,0
74854,4,1,262142,262142,262143,0,1,1
74855,6,2,262148,262148,262150,0,2,5
74856,1,1,262149,262150,262151,1,2,0
74857,4,3,262153,262153,262156,0,3,2
74858,4,1,262157,262157,262158,0,1,1
74859,6,1,262163,262163,262164,0,1,5
74860,2,2,262165,262165,262167,0,2,1
74861,3,1,262168,262168,262169,0,1,1
74862,1,3,262169,262169,262172,0,3,0
74863,2,1,262171,262172,262173,1,2,0
74864,2,3,262173,262173,262176,0,3,0
74865,5,2,262178,262178,262180,0,2,2
74866,4,3,262182,262182,262185,0,3,2
74867,4,2,262186,262186,262188,0,2,1
74868,5,3,262191,262191,262194,0,3,3
74869,2,3,262193,262194,262197,1,4,0
74870,5,1,262198,262198,262199,0,1,1
74871,5,3,262203,262203,262206,0,3,4
74872,1,1,262204,262206,262207,2,3,0
74873,1,1,262205,262207,262208,2,3,0
74874,3,2,262208,262208,262210,0,2,0
74875,4,2,262212,262212,262214,0,2,2
74876,2,1,262214,262214,262215,0,1,0
74877,5,1,262219,262219,262220,0,1,4
74878,5,2,262224,262224,262226,0,2,4
74879,2,2,262226,262226,262228,0,2,0
74880,4,2,262230,262230,262232,0,2,2
74881,1,3,262231,262232,262235,1,4,0
74882,6,3,262237,262237,262240,0,3,2
74883,6,2,262243,262243,262245,0,2,3
74884,4,1,262247,262247,262248,0,1,2
74885,6,1,262253,262253,262254,0,1,5
74886,6,3,262259,262259,262262,0,3,5
74887,4,3,262263,262263,262266,0,3,1
74888,2,2,262265,262266,262268,1,3,0
74889,1,1,262266,262268,262269,2,3,0
74890,5,3,262271,262271,262274,0,3,2
74891,6,2,262277,262277,262279,0,2,3
74892,2,3,262279,262279,262282,0,3,0
74893,5,1,262284,262284,262285,0,1,2
74894,3,1,262287,262287,262288,0,1,2
74895,4,1,262291,262291,262292,0,1,3
74896,1,2,262292,262292,262294,0,2,0
74897,4,1,262296,262296,262297,0,1,2
74898,5,2,262301,262301,262303,0,2,4
74899,4,3,262305,262305,262308,0,3,2
74900,6,2,262311,262311,262313,0,2,3
74901,2,3,262313,262313,262316,0,3,0
74902,3,3,262316,262316,262319,0,3,0
74903,5,3,262321,262321,262324,0,3,2
74904,6,3,262327,262327,262330,0,3,3
74905,3,2,262330,262330,262332,0,2,0
74906,5,2,262335,262335,262337,0,2,3
74907,6,3,262341,262341,262344,0,3,4
74908,5,2,262346,262346,262348,0,2,2
74909,5,1,262351,262351,262352,0,1,3
74910,4,1,262355,262355,262356,0,1,3
74911,2,1,262357,262357,262358,0,1,1
74912,2,3,262359,262359,262362,0,3,1
74913,4,1,262363,262363,262364,0,1,1
74914,2,2,262365,262365,262367,0,2,1
74915,1,3,262366,262367,262370,1,4,0
74916,1,3,262367,262370,262373,3,6,0
74917,1,3,262368,262373,262376,5,8,0
74918,4,1,262372,262376,262377,4,5,0
74919,4,2,262376,262377,262379,1,3,0
74920,3,1,262379,262379,262380,0,1,0
74921,4,2,262383,262383,262385,0,2,3
74922,5,2,262388,262388,262390,0,2,3
74923,4,1,262392,262392,262393,0,1,2
74924,3,2,262395,262395,262397,0,2,2
74925,1,1,262396,262397,262398,1,2,0
74926,1,3,262397,262398,262401,1,4,0
74927,1,2,262398,262401,262403,3,5,0
74928,4,2,262402,262403,262405,1,3,0
74929,6,1,262408,262408,262409,0,1,3
74930,5,2,262413,262413,262415,0,2,4
74931,6,3,262419,262419,262422,0,3,4
74932,6,1,262425,262425,262426,0,1,3
74933,4,3,262429,262429,262432,0,3,3
74934,5,1,262434,262434,262435,0,1,2
74935,6,1,262440,262440,262441,0,1,5
74936,4,3,262444,262444,262447,0,3,3
74937,6,3,262450,262450,262453,0,3,3
74938,6,3,262456,262456,262459,0,3,3
74939,4,3,262460,262460,262463,0,3,1
74940,3,2,262463,262463,262465,0,2,0
74941,1,3,262464,262465,262468,1,4,0
74942,2,2,262466,262468,262470,2,4,0
74943,4,3,262470,262470,262473,0,3,0
74944,3,1,262473,262473,262474,0,1,0
74945,4,2,262477,262477,262479,0,2,3
74946,2,1,262479,262479,262480,0,1,0
74947,2,2,262481,262481,262483,0,2,1
74948,2,1,262483,262483,262484,0,1,0
74949,5,2,262488,262488,262490,0,2,4
74950,1,3,262489,262490,262493,1,4,0
74951,6,2,262495,262495,262497,0,2,2
74952,5,2,262500,262500,262502,0,2,3
74953,6,3,262506,262506,262509,0,3,4
74954,4,1,262510,262510,262511,0,1,1
74955,6,2,262516,262516,262518,0,2,5
74956,3,1,262519,262519,262520,0,1,1
74957,6,3,262525,262525,262528,0,3,5
74958,1,2,262526,262528,262530,2,4,0
74959,5,1,262531,262531,262532,0,1,1
74960,6,2,262537,262537,262539,0,2,5
74961,3,1,262540,262540,262541,0,1,1
74962,6,1,262546,262546,262547,0,1,5
74963,2,2,262548,262548,262550,0,2,1
74964,6,1,262554,262554,262555,0,1,4
74965,3,2,262557,262557,262559,0,2,2
74966,2,3,262559,262559,262562,0,3,0
74967,6,3,262565,262565,262568,0,3,3
74968,6,2,262571,262571,262573,0,2,3
74969,2,3,262573,262573,262576,0,3,0
74970,1,3,262574,262576,262579,2,5,0
74971,6,2,262580,262580,262582,0,2,1
74972,6,1,262586,262586,262587,0,1,4
74973,1,1,262587,262587,262588,0,1,0
74974,6,2,262593,262593,262595,0,2,5
74975,6,3,262599,262599,262602,0,3,4
74976,6,1,262605,262605,262606,0,1,3
74977,6,2,262611,262611,262613,0,2,5
74978,2,1,262613,262613,262614,0,1,0
74979,6,1,262619,262619,262620,0,1,5
74980,2,3,262621,262621,262624,0,3,1
74981,5,1,262626,262626,262627,0,1,2
74982,3,3,262629,262629,262632,0,3,2
74983,5,1,262634,262634,262635,0,1,2
74984,3,1,262637,262637,262638,0,1,2
74985,1,3,262638,262638,262641,0,3,0
74986,2,3,262640,262641,262644,1,4,0
74987,1,1,262641,262644,262645,3,4,0
74988,2,1,262643,262645,262646,2,3,0
74989,1,3,262644,262646,262649,2,5,0
74990,4,1,262648,262649,262650,1,2,0
74991,3,2,262651,262651,262653,0,2,1
74992,6,2,262657,262657,262659,0,2,4
74993,3,3,262660,262660,262663,0,3,1
74994,1,1,262661,262663,262664,2,3,0
74995,2,2,262663,262664,262666,1,3,0
74996,2,3,262665,262666,262669,1,4,0
74997,6,2,262671,262671,262673,0,2,2
74998,5,1,262676,262676,262677,0,1,3
74999,2,1,262678,262678,262679,0,1,1
75000,2,1,262680,262680,262681,0,1,1
75001,6,1,262686,262686,262687,0,1,5
75002,1,3,262687,262687,262690,0,3,0
75003,3,1,262690,262690,262691,0,1,0
75004,6,3,262696,262696,262699,0,3,5
75005,5,1,262701,262701,262702,0,1,2
75006,5,2,262706,262706,262708,0,2,4
75007,4,1,262710,262710,262711,0,1,2
75008,4,1,262714,262714,262715,0,1,3
75009,4,2,262718,262718,262720,0,2,3
75010,3,3,262721,262721,262724,0,3,1
75011,3,2,262724,262724,262726,0,2,0
75012,4,3,262728,262728,262731,0,3,2
75013,4,2,262732,262732,262734,0,2,1
75014,4,2,262736,262736,262738,0,2,2
75015,5,2,262741,262741,262743,0,2,3
75016,1,2,262742,262743,262745,1,3,0
75017,4,2,262746,262746,262748,0,2,1
75018,6,1,262752,262752,262753,0,1,4
75019,3,1,262755,262755,262756,0,1,2
75020,5,3,262760,262760,262763,0,3,4
75021,3,2,262763,262763,262765,0,2,0
75022,4,1,262767,262767,262768,0,1,2
75023,6,2,262773,262773,262775,0,2,5
75024,2,2,262775,262775,262777,0,2,0
75025,2,3,262777,262777,262780,0,3,0
75026,2,3,262779,262780,262783,1,4,0
75027,6,2,262785,262785,262787,0,2,2
75028,5,1,262790,262790,262791,0,1,3
75029,4,2,262794,262794,262796,0,2,3
75030,1,1,262795,262796,262797,1,2,0
75031,6,2,262801,262801,262803,0,2,4
75032,3,1,262804,262804,262805,0,1,1
75033,5,3,262809,262809,262812,0,3,4
75034,1,2,262810,262812,262814,2,4,0
75035,3,1,262813,262814,262815,1,2,0
75036,4,2,262817,262817,262819,0,2,2
75037,5,1,262822,262822,262823,0,1,3
75038,1,2,262823,262823,262825,0,2,0
75039,6,2,262829,262829,262831,0,2,4
75040,5,1,262834,262834,262835,0,1,3
75041,3,1,262837,262837,262838,0,1,2
75042,4,2,262841,262841,262843,0,2,3
75043,6,3,262847,262847,262850,0,3,4
75044,4,3,262851,262851,262854,0,3,1
75045,3,3,262854,262854,262857,0,3,0
75046,6,3,262860,262860,262863,0,3,3
75047,6,1,262866,262866,262867,0,1,3
75048,6,2,262872,262872,262874,0,2,5
75049,2,2,262874,262874,262876,0,2,0
75050,3,2,262877,262877,262879,0,2,1
75051,3,3,262880,262880,262883,0,3,1
75052,2,1,262882,262883,262884,1,2,0
75053,1,3,262883,262884,262887,1,4,0
75054,4,1,262887,262887,262888,0,1,0
75055,6,2,262893,262893,262895,0,2,5
75056,3,1,262896,262896,262897,0,1,1
75057,3,1,262899,262899,262900,0,1,2
75058,6,2,262905,262905,262907,0,2,5
75059,2,3,262907,262907,262910,0,3,0
75060,3,3,262910,262910,262913,0,3,0
75061,3,2,262913,262913,262915,0,2,0
75062,4,1,262917,262917,262918,0,1,2
75063,5,2,262922,262922,262924,0,2,4
75064,6,2,262928,262928,262930,0,2,4
75065,5,3,262933,262933,262936,0,3,3
75066,5,2,262938,262938,262940,0,2,2
75067,3,2,262941,262941,262943,0,2,1
75068,4,2,262945,262945,262947,0,2,2
75069,1,3,262946,262947,262950,1,4,0
75070,2,3,262948,262950,262953,2,5,0
75071,3,1,262951,262953,262954,2,3,0
75072,6,3,262957,262957,262960,0,3,3
75073,6,1,262963,262963,262964,0,1,3
75074,3,1,262966,262966,262967,0,1,2
75075,2,2,262968,262968,262970,0,2,1
75076,1,2,262969,262970,262972,1,3,0
75077,1,1,262970,262972,262973,2,3,0
75078,6,2,262976,262976,262978,0,2,3
75079,5,1,262981,262981,262982,0,1,3
75080,3,1,262984,262984,262985,0,1,2
75081,5,1,262989,262989,262990,0,1,4
75082,5,1,262994,262994,262995,0,1,4
75083,5,2,262999,262999,263001,0,2,4
75084,1,1,263000,263001,263002,1,2,0
75085,2,2,263002,263002,263004,0,2,0
75086,2,2,263004,263004,263006,0,2,0
75087,5,1,263009,263009,263010,0,1,3
75088,4,3,263013,263013,263016,0,3,3
75089,1,3,263014,263016,263019,2,5,0
75090,2,3,263016,263019,263022,3,6,0
75091,2,1,263018,263022,263023,4,5,0
75092,5,3,263023,263023,263026,0,3,0
75093,4,2,263027,263027,263029,0,2,1
75094,1,3,263028,263029,263032,1,4,0
75095,2,3,263030,263032,263035,2,5,0
75096,6,3,263036,263036,263039,0,3,1
75097,4,1,263040,263040,263041,0,1,1
75098,6,1,263046,263046,263047,0,1,5
75099,3,3,263049,263049,263052,0,3,2
75100,1,1,263050,263052,263053,2,3,0
75101,2,2,263052,263053,263055,1,3,0
75102,6,1,263058,263058,263059,0,1,3
75103,5,3,263063,263063,263066,0,3,4
75104,1,1,263064,263066,263067,2,3,0
75105,4,1,263068,263068,263069,0,1,1
75106,3,2,263071,263071,263073,0,2,2
75107,3,3,263074,263074,263077,0,3,1
75108,6,3,263080,263080,263083,0,3,3
75109,6,2,263086,263086,263088,0,2,3
75110,6,1,263092,263092,263093,0,1,4
75111,3,3,263095,263095,263098,0,3,2
75112,2,1,263097,263098,263099,1,2,0
75113,1,2,263098,263099,263101,1,3,0
75114,6,2,263104,263104,263106,0,2,3
75115,2,3,263106,263106,263109,0,3,0
75116,2,3,263108,263109,263112,1,4,0
75117,5,1,263113,263113,263114,0,1,1
75118,1,1,263114,263114,263115,0,1,0
75119,2,3,263116,263116,263119,0,3,1
75120,6,3,263122,263122,263125,0,3,3
75121,6,1,263128,263128,263129,0,1,3
75122,6,2,263134,263134,263136,0,2,5
75123,3,1,263137,263137,263138,0,1,1
75124,5,1,263142,263142,263143,0,1,4
75125,3,3,263145,263145,263148,0,3,2
75126,3,1,263148,263148,263149,0,1,0
75127,4,2,263152,263152,263154,0,2,3
75128,5,1,263157,263157,263158,0,1,3
75129,3,3,263160,263160,263163,0,3,2
75130,4,3,263164,263164,263167,0,3,1
75131,3,3,263167,263167,263170,0,3,0
75132,5,2,263172,263172,263174,0,2,2
75133,4,3,263176,263176,263179,0,3,2
75134,2,1,263178,263179,263180,1,2,0
75135,1,3,263179,263180,263183,1,4,0
75136,4,2,263183,263183,263185,0,2,0
75137,5,1,263188,263188,263189,0,1,3
75138,5,2,263193,263193,263195,0,2,4
75139,3,1,263196,263196,263197,0,1,1
75140,1,1,263197,263197,263198,0,1,0
75141,5,1,263202,263202,263203,0,1,4
75142,4,3,263206,263206,263209,0,3,3
75143,2,2,263208,263209,263211,1,3,0
75144,2,2,263210,263211,263213,1,3,0
75145,6,2,263216,263216,263218,0,2,3
75146,2,1,263218,263218,263219,0,1,0
75147,5,2,263223,263223,263225,0,2,4
75148,4,3,263227,263227,263230,0,3,2
75149,4,1,263231,263231,263232,0,1,1
75150,5,3,263236,263236,263239,0,3,4
75151,2,3,263238,263239,263242,1,4,0
75152,5,1,263243,263243,263244,0,1,1
75153,1,1,263244,263244,263245,0,1,0
75154,5,3,263249,263249,263252,0,3,4
75155,3,1,263252,263252,263253,0,1,0
75156,3,2,263255,263255,263257,0,2,2
75157,6,3,263261,263261,263264,0,3,4
75158,1,2,263262,263264,263266,2,4,0
75159,3,2,263265,263266,263268,1,3,0
75160,4,3,263269,263269,263272,0,3,1
75161,1,2,263270,263272,263274,2,4,0
75162,3,2,263273,263274,263276,1,3,0
75163,6,2,263279,263279,263281,0,2,3
75164,6,3,263285,263285,263288,0,3,4
75165,4,3,263289,263289,263292,0,3,1
75166,2,2,263291,263292,263294,1,3,0
75167,3,1,263294,263294,263295,0,1,0
75168,4,1,263298,263298,263299,0,1,3
75169,3,1,263301,263301,263302,0,1,2
75170,1,2,263302,263302,263304,0,2,0
75171,5,3,263307,263307,263310,0,3,3
75172,3,2,263310,263310,263312,0,2,0
75173,5,1,263315,263315,263316,0,1,3
75174,2,3,263317,263317,263320,0,3,1
75175,2,2,263319,263320,263322,1,3,0
75176,1,1,263320,263322,263323,2,3,0
75177,2,2,263322,263323,263325,1,3,0
75178,3,1,263325,263325,263326,0,1,0
75179,5,1,263330,263330,263331,0,1,4
75180,5,3,263335,263335,263338,0,3,4
75181,4,2,263339,263339,263341,0,2,1
75182,4,2,263343,263343,263345,0,2,2
75183,2,1,263345,263345,263346,0,1,0
75184,2,1,263347,263347,263348,0,1,1
75185,1,2,263348,263348,263350,0,2,0
75186,1,2,263349,263350,263352,1,3,0
75187,4,3,263353,263353,263356,0,3,1
75188,6,1,263359,263359,263360,0,1,3
75189,1,3,263360,263360,263363,0,3,0
75190,5,1,263365,263365,263366,0,1,2
75191,5,1,263370,263370,263371,0,1,4
75192,1,3,263371,263371,263374,0,3,0
75193,2,2,263373,263374,263376,1,3,0
75194,1,1,263374,263376,263377,2,3,0
75195,6,3,263380,263380,263383,0,3,3
75196,2,2,263382,263383,263385,1,3,0
75197,6,1,263388,263388,263389,0,1,3
75198,3,3,263391,263391,263394,0,3,2
75199,5,1,263396,263396,263397,0,1,2
75200,1,2,263397,263397,263399,0,2,0
75201,6,1,263403,263403,263404,0,1,4
75202,5,3,263408,263408,263411,0,3,4
75203,5,3,263413,263413,263416,0,3,2
75204,6,1,263419,263419,263420,0,1,3
75205,4,2,263423,263423,263425,0,2,3
75206,4,1,263427,263427,263428,0,1,2
75207,1,3,263428,263428,263431,0,3,0
75208,2,2,263430,263431,263433,1,3,0
75209,2,2,263432,263433,263435,1,3,0
75210,1,3,263433,263435,263438,2,5,0
75211,1,2,263434,263438,263440,4,6,0
75212,5,2,263439,263440,263442,1,3,0
75213,3,3,263442,263442,263445,0,3,0
75214,4,3,263446,263446,263449,0,3,1
75215,5,2,263451,263451,263453,0,2,2
75216,4,1,263455,263455,263456,0,1,2
75217,5,2,263460,263460,263462,0,2,4
75218,3,2,263463,263463,263465,0,2,1
75219,1,2,263464,263465,263467,1,3,0
75220,2,2,263466,263467,263469,1,3,0
75221,2,1,263468,263469,263470,1,2,0
75222,1,3,263469,263470,263473,1,4,0
75223,4,3,263473,263473,263476,0,3,0
75224,6,1,263479,263479,263480,0,1,3
75225,1,3,263480,263480,263483,0,3,0
75226,4,1,263484,263484,263485,0,1,1
75227,5,1,263489,263489,263490,0,1,4
75228,2,2,263491,263491,263493,0,2,1
75229,6,3,263497,263497,263500,0,3,4
75230,6,1,263503,263503,263504,0,1,3
75231,6,1,263509,263509,263510,0,1,5
75232,4,2,263513,263513,263515,0,2,3
75233,3,1,263516,263516,263517,0,1,1
75234,5,3,263521,263521,263524,0,3,4
75235,4,1,263525,263525,263526,0,1,1
75236,3,1,263528,263528,263529,0,1,2
75237,5,3,263533,263533,263536,0,3,4
75238,2,3,263535,263536,263539,1,4,0
75239,2,2,263537,263539,263541,2,4,0
75240,6,3,263543,263543,263546,0,3,2
75241,4,2,263547,263547,263549,0,2,1
75242,1,3,263548,263549,263552,1,4,0
75243,1,2,263549,263552,263554,3,5,0
75244,3,1,263552,263554,263555,2,3,0
75245,4,1,263556,263556,263557,0,1,1
75246,2,1,263558,263558,263559,0,1,1
75247,3,2,263561,263561,263563,0,2,2
75248,5,3,263566,263566,263569,0,3,3
75249,5,2,263571,263571,263573,0,2,2
75250,6,2,263577,263577,263579,0,2,4
75251,2,1,263579,263579,263580,0,1,0
75252,2,2,263581,263581,263583,0,2,1
75253,3,3,263584,263584,263587,0,3,1
75254,4,2,263588,263588,263590,0,2,1
75255,1,3,263589,263590,263593,1,4,0
75256,2,2,263591,263593,263595,2,4,0
75257,1,2,263592,263595,263597,3,5,0
75258,1,3,263593,263597,263600,4,7,0
75259,6,1,263599,263600,263601,1,2,0
75260,5,1,263604,263604,263605,0,1,3
75261,5,1,263609,263609,263610,0,1,4
75262,2,2,263611,263611,263613,0,2,1
75263,1,1,263612,263613,263614,1,2,0
75264,1,3,263613,263614,263617,1,4,0
75265,2,1,263615,263617,263618,2,3,0
75266,2,2,263617,263618,263620,1,3,0
75267,2,2,263619,263620,263622,1,3,0
75268,2,3,263621,263622,263625,1,4,0
75269,5,3,263626,263626,263629,0,3,1
75270,5,1,263631,263631,263632,0,1,2
75271,3,1,263634,263634,263635,0,1,2
75272,5,1,263639,263639,263640,0,1,4
75273,1,1,263640,263640,263641,0,1,0
75274,1,3,263641,263641,263644,0,3,0
75275,6,3,263647,263647,263650,0,3,3
75276,4,3,263651,263651,263654,0,3,1
75277,4,1,263655,263655,263656,0,1,1
75278,4,2,263659,263659,263661,0,2,3
75279,6,3,263665,263665,263668,0,3,4
75280,1,3,263666,263668,263671,2,5,0
75281,5,1,263671,263671,263672,0,1,0
75282,5,1,263676,263676,263677,0,1,4
75283,5,1,263681,263681,263682,0,1,4
75284,2,1,263683,263683,263684,0,1,1
75285,2,3,263685,263685,263688,0,3,1
75286,2,1,263687,263688,263689,1,2,0
75287,5,2,263692,263692,263694,0,2,3
75288,1,3,263693,263694,263697,1,4,0
75289,1,3,263694,263697,263700,3,6,0
75290,4,1,263698,263700,263701,2,3,0
75291,2,1,263700,263701,263702,1,2,0
75292,2,1,263702,263702,263703,0,1,0
75293,6,2,263708,263708,263710,0,2,5
75294,6,1,263714,263714,263715,0,1,4
75295,2,3,263716,263716,263719,0,3,1
75296,2,1,263718,263719,263720,1,2,0
75297,2,1,263720,263720,263721,0,1,0
75298,3,3,263723,263723,263726,0,3,2
75299,1,1,263724,263726,263727,2,3,0
75300,6,3,263730,263730,263733,0,3,3
75301,1,2,263731,263733,263735,2,4,0
75302,2,1,263733,263735,263736,2,3,0
75303,3,1,263736,263736,263737,0,1,0
75304,5,1,263741,263741,263742,0,1,4
75305,6,2,263747,263747,263749,0,2,5
75306,1,3,263748,263749,263752,1,4,0
75307,1,2,263749,263752,263754,3,5,0
75308,3,3,263752,263754,263757,2,5,0
75309,5,3,263757,263757,263760,0,3,0
75310,2,2,263759,263760,263762,1,3,0
75311,1,2,263760,263762,263764,2,4,0
75312,6,2,263766,263766,263768,0,2,2
75313,3,2,263769,263769,263771,0,2,1
75314,5,2,263774,263774,263776,0,2,3
75315,4,2,263778,263778,263780,0,2,2
75316,5,1,263783,263783,263784,0,1,3
75317,1,3,263784,263784,263787,0,3,0
75318,1,2,263785,263787,263789,2,4,0
75319,6,2,263791,263791,263793,0,2,2
75320,5,2,263796,263796,263798,0,2,3
75321,3,2,263799,263799,263801,0,2,1
75322,4,2,263803,263803,263805,0,2,2
75323,1,3,263804,263805,263808,1,4,0
75324,2,2,263806,263808,263810,2,4,0
75325,3,3,263809,263810,263813,1,4,0
75326,2,2,263811,263813,263815,2,4,0
75327,1,3,263812,263815,263818,3,6,0
75328,5,1,263817,263818,263819,1,2,0
75329,2,1,263819,263819,263820,0,1,0
75330,6,1,263825,263825,263826,0,1,5
75331,3,2,263828,263828,263830,0,2,2
75332,1,2,263829,263830,263832,1,3,0
75333,4,1,263833,263833,263834,0,1,1
75334,3,2,263836,263836,263838,0,2,2
75335,4,3,263840,263840,263843,0,3,2
75336,4,2,263844,263844,263846,0,2,1
75337,5,3,263849,263849,263852,0,3,3
75338,1,3,263850,263852,263855,2,5,0
75339,4,1,263854,263855,263856,1,2,0
75340,5,3,263859,263859,263862,0,3,3
75341,5,1,263864,263864,263865,0,1,2
75342,3,2,263867,263867,263869,0,2,2
75343,5,1,263872,263872,263873,0,1,3
75344,3,2,263875,263875,263877,0,2,2
75345,5,1,263880,263880,263881,0,1,3
75346,1,3,263881,263881,263884,0,3,0
75347,6,1,263887,263887,263888,0,1,3
75348,3,2,263890,263890,263892,0,2,2
75349,4,2,263894,263894,263896,0,2,2
75350,2,2,263896,263896,263898,0,2,0
75351,4,2,263900,263900,263902,0,2,2
75352,4,3,263904,263904,263907,0,3,2
75353,2,2,263906,263907,263909,1,3,0
75354,3,3,263909,263909,263912,0,3,0
75355,2,2,263911,263912,263914,1,3,0
75356,4,3,263915,263915,263918,0,3,1
75357,1,1,263916,263918,263919,2,3,0
75358,1,1,263917,263919,263920,2,3,0
75359,1,3,263918,263920,263923,2,5,0
75360,2,3,263920,263923,263926,3,6,0
75361,2,3,263922,263926,263929,4,7,0
75362,3,2,263925,263929,263931,4,6,0
75363,4,1,263929,263931,263932,2,3,0
75364,4,3,263933,263933,263936,0,3,1
75365,6,2,263939,263939,263941,0,2,3
75366,4,3,263943,263943,263946,0,3,2
75367,3,3,263946,263946,263949,0,3,0
75368,6,1,263952,263952,263953,0,1,3
75369,5,1,263957,263957,263958,0,1,4
75370,1,2,263958,263958,263960,0,2,0
75371,3,1,263961,263961,263962,0,1,1
75372,1,3,263962,263962,263965,0,3,0
75373,1,1,263963,263965,263966,2,3,0
75374,6,3,263969,263969,263972,0,3,3
75375,4,2,263973,263973,263975,0,2,1
75376,5,1,263978,263978,263979,0,1,3
75377,1,3,263979,263979,263982,0,3,0
75378,6,2,263985,263985,263987,0,2,3
75379,5,1,263990,263990,263991,0,1,3
75380,1,2,263991,263991,263993,0,2,0
75381,1,2,263992,263993,263995,1,3,0
75382,4,3,263996,263996,263999,0,3,1
75383,5,3,264001,264001,264004,0,3,2
75384,1,3,264002,264004,264007,2,5,0
75385,2,2,264004,264007,264009,3,5,0
75386,2,3,264006,264009,264012,3,6,0
75387,6,2,264012,264012,264014,0,2,0
75388,6,1,264018,264018,264019,0,1,4
75389,6,3,264024,264024,264027,0,3,5
75390,5,1,264029,264029,264030,0,1,2
75391,4,3,264033,264033,264036,0,3,3
75392,6,1,264039,264039,264040,0,1,3
75393,2,2,264041,264041,264043,0,2,1
75394,1,3,264042,264043,264046,1,4,0
75395,4,3,264046,264046,264049,0,3,0
75396,3,1,264049,264049,264050,0,1,0
75397,4,2,264053,264053,264055,0,2,3
75398,3,2,264056,264056,264058,0,2,1
75399,5,2,264061,264061,264063,0,2,3
75400,5,2,264066,264066,264068,0,2,3
75401,1,3,264067,264068,264071,1,4,0
75402,2,3,264069,264071,264074,2,5,0
75403,1,1,264070,264074,264075,4,5,0
75404,1,3,264071,264075,264078,4,7,0
75405,6,1,264077,264078,264079,1,2,0
75406,3,2,264080,264080,264082,0,2,1
75407,4,2,264084,264084,264086,0,2,2
75408,2,3,264086,264086,264089,0,3,0
75409,1,3,264087,264089,264092,2,5,0
75410,4,3,264091,264092,264095,1,4,0
75411,1,3,264092,264095,264098,3,6,0
75412,5,1,264097,264098,264099,1,2,0
75413,3,2,264100,264100,264102,0,2,1
75414,1,3,264101,264102,264105,1,4,0
75415,3,1,264104,264105,264106,1,2,0
75416,1,1,264105,264106,264107,1,2,0
75417,1,1,264106,264107,264108,1,2,0
75418,6,3,264112,264112,264115,0,3,4
75419,4,3,264116,264116,264119,0,3,1
75420,5,1,264121,264121,264122,0,1,2
75421,4,1,264125,264125,264126,0,1,3
75422,2,3,264127,264127,264130,0,3,1
75423,6,2,264133,264133,264135,0,2,3
75424,1,3,264134,264135,264138,1,4,0
75425,1,1,264135,264138,264139,3,4,0
75426,4,1,264139,264139,264140,0,1,0
75427,2,1,264141,264141,264142,0,1,1
75428,3,1,264144,264144,264145,0,1,2
75429,3,3,264147,264147,264150,0,3,2
75430,1,2,264148,264150,264152,2,4,0
75431,2,1,264150,264152,264153,2,3,0
75432,6,1,264156,264156,264157,0,1,3
75433,6,2,264162,264162,264164,0,2,5
75434,4,3,264166,264166,264169,0,3,2
75435,1,3,264167,264169,264172,2,5,0
75436,3,1,264170,264172,264173,2,3,0
75437,6,2,264176,264176,264178,0,2,3
75438,4,3,264180,264180,264183,0,3,2
75439,5,3,264185,264185,264188,0,3,2
75440,3,1,264188,264188,264189,0,1,0
75441,2,2,264190,264190,264192,0,2,1
75442,4,2,264194,264194,264196,0,2,2
75443,5,1,264199,264199,264200,0,1,3
75444,4,1,264203,264203,264204,0,1,3
75445,1,1,264204,264204,264205,0,1,0
75446,3,2,264207,264207,264209,0,2,2
75447,2,2,264209,264209,264211,0,2,0
75448,3,3,264212,264212,264215,0,3,1
75449,5,3,264217,264217,264220,0,3,2
75450,2,2,264219,264220,264222,1,3,0
75451,3,2,264222,264222,264224,0,2,0
75452,2,1,264224,264224,264225,0,1,0
75453,5,1,264229,264229,264230,0,1,4
75454,4,3,264233,264233,264236,0,3,3
75455,4,1,264237,264237,264238,0,1,1
75456,4,1,264241,264241,264242,0,1,3
75457,5,1,264246,264246,264247,0,1,4
75458,1,3,264247,264247,264250,0,3,0
75459,5,1,264252,264252,264253,0,1,2
75460,3,2,264255,264255,264257,0,2,2
75461,3,1,264258,264258,264259,0,1,1
75462,6,2,264264,264264,264266,0,2,5
75463,3,1,264267,264267,264268,0,1,1
75464,5,2,264272,264272,264274,0,2,4
75465,2,1,264274,264274,264275,0,1,0
75466,6,1,264280,264280,264281,0,1,5
75467,4,1,264284,264284,264285,0,1,3
75468,3,1,264287,264287,264288,0,1,2
75469,2,3,264289,264289,264292,0,3,1
75470,6,1,264295,264295,264296,0,1,3
75471,2,1,264297,264297,264298,0,1,1
75472,5,1,264302,264302,264303,0,1,4
75473,1,1,264303,264303,264304,0,1,0
75474,4,3,264307,264307,264310,0,3,3
75475,5,2,264312,264312,264314,0,2,2
75476,3,3,264315,264315,264318,0,3,1
75477,2,1,264317,264318,264319,1,2,0
75478,2,1,264319,264319,264320,0,1,0
75479,1,2,264320,264320,264322,0,2,0
75480,5,2,264325,264325,264327,0,2,3
75481,3,1,264328,264328,264329,0,1,1
75482,2,1,264330,264330,264331,0,1,1
75483,4,3,264334,264334,264337,0,3,3
75484,5,3,264339,264339,264342,0,3,2
75485,1,1,264340,264342,264343,2,3,0
75486,3,2,264343,264343,264345,0,2,0
75487,2,1,264345,264345,264346,0,1,0
75488,3,2,264348,264348,264350,0,2,2
75489,5,1,264353,264353,264354,0,1,3
75490,1,2,264354,264354,264356,0,2,0
75491,6,3,264360,264360,264363,0,3,4
75492,5,1,264365,264365,264366,0,1,2
75493,5,3,264370,264370,264373,0,3,4
75494,1,2,264371,264373,264375,2,4,0
75495,2,3,264373,264375,264378,2,5,0
75496,6,3,264379,264379,264382,0,3,1
75497,6,3,264385,264385,264388,0,3,3
75498,5,1,264390,264390,264391,0,1,2
75499,2,2,264392,264392,264394,0,2,1
75500,4,1,264396,264396,264397,0,1,2
75501,2,1,264398,264398,264399,0,1,1
75502,5,1,264403,264403,264404,0,1,4
75503,6,2,264409,264409,264411,0,2,5
75504,1,2,264410,264411,264413,1,3,0
75505,2,1,264412,264413,264414,1,2,0
75506,5,3,264417,264417,264420,0,3,3
75507,2,1,264419,264420,264421,1,2,0
75508,5,1,264424,264424,264425,0,1,3
75509,2,3,264426,264426,264429,0,3,1
75510,2,3,264428,264429,264432,1,4,0
75511,6,1,264434,264434,264435,0,1,2
75512,2,3,264436,264436,264439,0,3,1
75513,4,1,264440,264440,264441,0,1,1
75514,2,3,264442,264442,264445,0,3,1
75515,4,2,264446,264446,264448,0,2,1
75516,2,1,264448,264448,264449,0,1,0
75517,6,3,264454,264454,264457,0,3,5
75518,1,3,264455,264457,264460,2,5,0
75519,5,2,264460,264460,264462,0,2,0
75520,5,1,264465,264465,264466,0,1,3
75521,4,3,264469,264469,264472,0,3,3
75522,3,2,264472,264472,264474,0,2,0
75523,1,1,264473,264474,264475,1,2,0
75524,5,3,264478,264478,264481,0,3,3
75525,1,2,264479,264481,264483,2,4,0
75526,6,1,264485,264485,264486,0,1,2
75527,2,1,264487,264487,264488,0,1,1
75528,2,2,264489,264489,264491,0,2,1
75529,4,1,264493,264493,264494,0,1,2
75530,5,1,264498,264498,264499,0,1,4
75531,6,1,264504,264504,264505,0,1,5
75532,4,1,264508,264508,264509,0,1,3
75533,5,3,264513,264513,264516,0,3,4
75534,6,1,264519,264519,264520,0,1,3
75535,3,2,264522,264522,264524,0,2,2
75536,3,1,264525,264525,264526,0,1,1
75537,5,3,264530,264530,264533,0,3,4
75538,5,2,264535,264535,264537,0,2,2
75539,4,2,264539,264539,264541,0,2,2
75540,3,2,264542,264542,264544,0,2,1
75541,1,2,264543,264544,264546,1,3,0
75542,5,1,264548,264548,264549,0,1,2
75543,5,3,264553,264553,264556,0,3,4
75544,1,1,264554,264556,264557,2,3,0
75545,3,1,264557,264557,264558,0,1,0
75546,1,2,264558,264558,264560,0,2,0
75547,6,1,264564,264564,264565,0,1,4
75548,1,2,264565,264565,264567,0,2,0
75549,5,1,264570,264570,264571,0,1,3
75550,4,2,264574,264574,264576,0,2,3
75551,3,1,264577,264577,264578,0,1,1
75552,4,1,264581,264581,264582,0,1,3
75553,6,2,264587,264587,264589,0,2,5
75554,2,1,264589,264589,264590,0,1,0
75555,5,1,264594,264594,264595,0,1,4
75556,5,1,264599,264599,264600,0,1,4
75557,6,1,264605,264605,264606,0,1,5
75558,6,3,264611,264611,264614,0,3,5
75559,6,3,264617,264617,264620,0,3,3
75560,6,1,264623,264623,264624,0,1,3
75561,2,1,264625,264625,264626,0,1,1
75562,5,3,264630,264630,264633,0,3,4
75563,2,1,264632,264633,264634,1,2,0
75564,3,1,264635,264635,264636,0,1,1
75565,6,3,264641,264641,264644,0,3,5
75566,1,2,264642,264644,264646,2,4,0
75567,5,2,264647,264647,264649,0,2,1
75568,3,1,264650,264650,264651,0,1,1
75569,3,3,264653,264653,264656,0,3,2
75570,3,2,264656,264656,264658,0,2,0
75571,5,3,264661,264661,264664,0,3,3
75572,1,3,264662,264664,264667,2,5,0
75573,1,3,264663,264667,264670,4,7,0
75574,1,2,264664,264670,264672,6,8,0
75575,5,3,264669,264672,264675,3,6,0
75576,2,1,264671,264675,264676,4,5,0
75577,6,3,264677,264677,264680,0,3,1
75578,2,2,264679,264680,264682,1,3,0
75579,5,2,264684,264684,264686,0,2,2
75580,5,2,264689,264689,264691,0,2,3
75581,5,3,264694,264694,264697,0,3,3
75582,4,1,264698,264698,264699,0,1,1
75583,4,1,264702,264702,264703,0,1,3
75584,2,3,264704,264704,264707,0,3,1
75585,4,2,264708,264708,264710,0,2,1
75586,5,2,264713,264713,264715,0,2,3
75587,4,1,264717,264717,264718,0,1,2
75588,1,2,264718,264718,264720,0,2,0
75589,4,2,264722,264722,264724,0,2,2
75590,5,1,264727,264727,264728,0,1,3
75591,4,3,264731,264731,264734,0,3,3
75592,4,3,264735,264735,264738,0,3,1
75593,4,1,264739,264739,264740,0,1,1
75594,3,3,264742,264742,264745,0,3,2
75595,1,3,264743,264745,264748,2,5,0
75596,3,2,264746,264748,264750,2,4,0
75597,4,2,264750,264750,264752,0,2,0
75598,5,3,264755,264755,264758,0,3,3
75599,5,1,264760,264760,264761,0,1,2
75600,3,2,264763,264763,264765,0,2,2
75601,4,2,264767,264767,264769,0,2,2
75602,5,3,264772,264772,264775,0,3,3
75603,6,3,264778,264778,264781,0,3,3
75604,6,2,264784,264784,264786,0,2,3
75605,2,2,264786,264786,264788,0,2,0
75606,6,1,264792,264792,264793,0,1,4
75607,3,2,264795,264795,264797,0,2,2
75608,6,1,264801,264801,264802,0,1,4
75609,3,3,264804,264804,264807,0,3,2
75610,6,1,264810,264810,264811,0,1,3
75611,4,3,264814,264814,264817,0,3,3
75612,4,1,264818,264818,264819,0,1,1
75613,3,1,264821,264821,264822,0,1,2
75614,1,1,264822,264822,264823,0,1,0
75615,3,1,264825,264825,264826,0,1,2
75616,2,1,264827,264827,264828,0,1,1
75617,3,2,264830,264830,264832,0,2,2
75618,5,1,264835,264835,264836,0,1,3
75619,4,1,264839,264839,264840,0,1,3
75620,3,2,264842,264842,264844,0,2,2
75621,3,2,264845,264845,264847,0,2,1
75622,1,3,264846,264847,264850,1,4,0
75623,5,1,264851,264851,264852,0,1,1
75624,1,1,264852,264852,264853,0,1,0
75625,6,3,264858,264858,264861,0,3,5
75626,2,3,264860,264861,264864,1,4,0
75627,1,2,264861,264864,264866,3,5,0
75628,2,3,264863,264866,264869,3,6,0
75629,3,1,264866,264869,264870,3,4,0
75630,6,3,264872,264872,264875,0,3,2
75631,4,1,264876,264876,264877,0,1,1
75632,5,2,264881,264881,264883,0,2,4
75633,2,1,264883,264883,264884,0,1,0
75634,3,3,264886,264886,264889,0,3,2
75635,3,3,264889,264889,264892,0,3,0
75636,1,3,264890,264892,264895,2,5,0
75637,2,3,264892,264895,264898,3,6,0
75638,4,1,264896,264898,264899,2,3,0
75639,4,1,264900,264900,264901,0,1,1
75640,5,3,264905,264905,264908,0,3,4
75641,6,3,264911,264911,264914,0,3,3
75642,3,1,264914,264914,264915,0,1,0
75643,1,3,264915,264915,264918,0,3,0
75644,5,2,264920,264920,264922,0,2,2
75645,3,1,264923,264923,264924,0,1,1
75646,1,1,264924,264924,264925,0,1,0
75647,1,3,264925,264925,264928,0,3,0
75648,6,1,264931,264931,264932,0,1,3
75649,6,3,264937,264937,264940,0,3,5
75650,6,1,264943,264943,264944,0,1,3
75651,6,3,264949,264949,264952,0,3,5
75652,2,2,264951,264952,264954,1,3,0
75653,4,3,264955,264955,264958,0,3,1
75654,2,2,264957,264958,264960,1,3,0
75655,2,3,264959,264960,264963,1,4,0
75656,5,2,264964,264964,264966,0,2,1
75657,3,1,264967,264967,264968,0,1,1
75658,5,2,264972,264972,264974,0,2,4
75659,2,1,264974,264974,264975,0,1,0
75660,6,3,264980,264980,264983,0,3,5
75661,1,2,264981,264983,264985,2,4,0
75662,6,2,264987,264987,264989,0,2,2
75663,6,2,264993,264993,264995,0,2,4
75664,4,3,264997,264997,265000,0,3,2
75665,2,1,264999,265000,265001,1,2,0
75666,1,1,265000,265001,265002,1,2,0
75667,3,3,265003,265003,265006,0,3,1
75668,4,2,265007,265007,265009,0,2,1
75669,4,3,265011,265011,265014,0,3,2
75670,4,3,265015,265015,265018,0,3,1
75671,2,1,265017,265018,265019,1,2,0
75672,1,1,265018,265019,265020,1,2,0
75673,2,2,265020,265020,265022,0,2,0
75674,6,3,265026,265026,265029,0,3,4
75675,3,3,265029,265029,265032,0,3,0
75676,4,1,265033,265033,265034,0,1,1
75677,6,3,265039,265039,265042,0,3,5
75678,6,3,265045,265045,265048,0,3,3
75679,5,1,265050,265050,265051,0,1,2
75680,1,3,265051,265051,265054,0,3,0
75681,5,1,265056,265056,265057,0,1,2
75682,5,1,265061,265061,265062,0,1,4
75683,1,2,265062,265062,265064,0,2,0
75684,6,1,265068,265068,265069,0,1,4
75685,6,3,265074,265074,265077,0,3,5
75686,6,3,265080,265080,265083,0,3,3
75687,1,2,265081,265083,265085,2,4,0
75688,3,2,265084,265085,265087,1,3,0
75689,3,3,265087,265087,265090,0,3,0
75690,1,2,265088,265090,265092,2,4,0
75691,3,1,265091,265092,265093,1,2,0
75692,2,2,265093,265093,265095,0,2,0
75693,6,2,265099,265099,265101,0,2,4
75694,6,1,265105,265105,265106,0,1,4
75695,1,1,265106,265106,265107,0,1,0
75696,2,1,265108,265108,265109,0,1,1
75697,6,1,265114,265114,265115,0,1,5
75698,2,1,265116,265116,265117,0,1,1
75699,1,2,265117,265117,265119,0,2,0
75700,3,2,265120,265120,265122,0,2,1
75701,4,1,265124,265124,265125,0,1,2
75702,2,1,265126,265126,265127,0,1,1
75703,6,2,265132,265132,265134,0,2,5
75704,3,2,265135,265135,265137,0,2,1
75705,1,3,265136,265137,265140,1,4,0
75706,4,3,265140,265140,265143,0,3,0
75707,1,1,265141,265143,265144,2,3,0
75708,2,3,265143,265144,265147,1,4,0
75709,3,3,265146,265147,265150,1,4,0
75710,5,2,265151,265151,265153,0,2,1
75711,3,2,265154,265154,265156,0,2,1
75712,5,3,265159,265159,265162,0,3,3
75713,2,1,265161,265162,265163,1,2,0
75714,3,2,265164,265164,265166,0,2,1
75715,5,3,265169,265169,265172,0,3,3
75716,4,1,265173,265173,265174,0,1,1
75717,4,2,265177,265177,265179,0,2,3
75718,3,3,265180,265180,265183,0,3,1
75719,6,3,265186,265186,265189,0,3,3
75720,4,1,265190,265190,265191,0,1,1
75721,1,2,265191,265191,265193,0,2,0
75722,4,1,265195,265195,265196,0,1,2
75723,3,1,265198,265198,265199,0,1,2
75724,6,2,265204,265204,265206,0,2,5
75725,3,1,265207,265207,265208,0,1,1
75726,6,2,265213,265213,265215,0,2,5
75727,6,3,265219,265219,265222,0,3,4
75728,4,1,265223,265223,265224,0,1,1
75729,2,3,265225,265225,265228,0,3,1
75730,1,2,265226,265228,265230,2,4,0
75731,4,2,265230,265230,265232,0,2,0
75732,5,2,265235,265235,265237,0,2,3
75733,1,2,265236,265237,265239,1,3,0
75734,1,1,265237,265239,265240,2,3,0
75735,2,2,265239,265240,265242,1,3,0
75736,1,3,265240,265242,265245,2,5,0
75737,4,2,265244,265245,265247,1,3,0
75738,4,2,265248,265248,265250,0,2,1
75739,6,2,265254,265254,265256,0,2,4
75740,6,2,265260,265260,265262,0,2,4
75741,4,1,265264,265264,265265,0,1,2
75742,2,3,265266,265266,265269,0,3,1
75743,2,2,265268,265269,265271,1,3,0
75744,3,2,265271,265271,265273,0,2,0
75745,4,3,265275,265275,265278,0,3,2
75746,1,2,265276,265278,265280,2,4,0
75747,6,3,265282,265282,265285,0,3,2
75748,5,3,265287,265287,265290,0,3,2
75749,4,1,265291,265291,265292,0,1,1
75750,3,2,265294,265294,265296,0,2,2
75751,6,2,265300,265300,265302,0,2,4
75752,6,3,265306,265306,265309,0,3,4
75753,1,1,265307,265309,265310,2,3,0
75754,5,3,265312,265312,265315,0,3,2
75755,1,3,265313,265315,265318,2,5,0
75756,5,2,265318,265318,265320,0,2,0
75757,3,2,265321,265321,265323,0,2,1
75758,2,3,265323,265323,265326,0,3,0
75759,4,3,265327,265327,265330,0,3,1
75760,5,2,265332,265332,265334,0,2,2
75761,4,3,265336,265336,265339,0,3,2
75762,3,3,265339,265339,265342,0,3,0
75763,5,2,265344,265344,265346,0,2,2
75764,2,1,265346,265346,265347,0,1,0
75765,2,3,265348,265348,265351,0,3,1
75766,6,1,265354,265354,265355,0,1,3
75767,3,1,265357,265357,265358,0,1,2
75768,4,3,265361,265361,265364,0,3,3
75769,1,3,265362,265364,265367,2,5,0
75770,5,1,265367,265367,265368,0,1,0
75771,4,1,265371,265371,265372,0,1,3
75772,6,1,265377,265377,265378,0,1,5
75773,1,3,265378,265378,265381,0,3,0
75774,5,3,265383,265383,265386,0,3,2
75775,6,2,265389,265389,265391,0,2,3
75776,3,1,265392,265392,265393,0,1,1
75777,1,2,265393,265393,265395,0,2,0
75778,3,3,265396,265396,265399,0,3,1
75779,3,2,265399,265399,265401,0,2,0
75780,1,1,265400,265401,265402,1,2,0
75781,2,1,265402,265402,265403,0,1,0
75782,5,3,265407,265407,265410,0,3,4
75783,3,1,265410,265410,265411,0,1,0
75784,4,2,265414,265414,265416,0,2,3
75785,1,1,265415,265416,265417,1,2,0
75786,5,2,265420,265420,265422,0,2,3
75787,6,1,265426,265426,265427,0,1,4
75788,6,1,265432,265432,265433,0,1,5
75789,3,2,265435,265435,265437,0,2,2
75790,3,1,265438,265438,265439,0,1,1
75791,5,3,265443,265443,265446,0,3,4
75792,2,3,265445,265446,265449,1,4,0
75793,5,1,265450,265450,265451,0,1,1
75794,6,1,265456,265456,265457,0,1,5
75795,2,3,265458,265458,265461,0,3,1
75796,1,3,265459,265461,265464,2,5,0
75797,4,1,265463,265464,265465,1,2,0
75798,3,2,265466,265466,265468,0,2,1
75799,3,2,265469,265469,265471,0,2,1
75800,4,1,265473,265473,265474,0,1,2
75801,5,3,265478,265478,265481,0,3,4
75802,6,2,265484,265484,265486,0,2,3
75803,1,2,265485,265486,265488,1,3,0
75804,6,3,265491,265491,265494,0,3,3
75805,5,3,265496,265496,265499,0,3,2
75806,1,1,265497,265499,265500,2,3,0
75807,6,3,265503,265503,265506,0,3,3
75808,3,1,265506,265506,265507,0,1,0
75809,4,1,265510,265510,265511,0,1,3
75810,1,3,265511,265511,265514,0,3,0
75811,4,2,265515,265515,265517,0,2,1
75812,6,3,265521,265521,265524,0,3,4
75813,6,3,265527,265527,265530,0,3,3
75814,1,3,265528,265530,265533,2,5,0
75815,2,1,265530,265533,265534,3,4,0
75816,6,3,265536,265536,265539,0,3,2
75817,1,1,265537,265539,265540,2,3,0
75818,3,1,265540,265540,265541,0,1,0
75819,2,2,265542,265542,265544,0,2,1
75820,4,2,265546,265546,265548,0,2,2
75821,4,2,265550,265550,265552,0,2,2
75822,5,2,265555,265555,265557,0,2,3
75823,6,1,265561,265561,265562,0,1,4
75824,5,1,265566,265566,265567,0,1,4
75825,5,3,265571,265571,265574,0,3,4
75826,2,1,265573,265574,265575,1,2,0
75827,3,2,265576,265576,265578,0,2,1
75828,5,3,265581,265581,265584,0,3,3
75829,2,2,265583,265584,265586,1,3,0
75830,5,3,265588,265588,265591,0,3,2
75831,4,2,265592,265592,265594,0,2,1
75832,1,2,265593,265594,265596,1,3,0
75833,5,2,265598,265598,265600,0,2,2
75834,5,1,265603,265603,265604,0,1,3
75835,2,1,265605,265605,265606,0,1,1
75836,1,1,265606,265606,265607,0,1,0
75837,5,3,265611,265611,265614,0,3,4
75838,2,2,265613,265614,265616,1,3,0
75839,5,3,265618,265618,265621,0,3,2
75840,4,3,265622,265622,265625,0,3,1
75841,6,1,265628,265628,265629,0,1,3
75842,4,2,265632,265632,265634,0,2,3
75843,3,3,265635,265635,265638,0,3,1
75844,2,3,265637,265638,265641,1,4,0
75845,6,2,265643,265643,265645,0,2,2
75846,4,1,265647,265647,265648,0,1,2
75847,4,3,265651,265651,265654,0,3,3
75848,5,1,265656,265656,265657,0,1,2
75849,6,3,265662,265662,265665,0,3,5
75850,6,3,265668,265668,265671,0,3,3
75851,4,2,265672,265672,265674,0,2,1
75852,4,2,265676,265676,265678,0,2,2
75853,3,1,265679,265679,265680,0,1,1
75854,6,1,265685,265685,265686,0,1,5
75855,2,1,265687,265687,265688,0,1,1
75856,3,3,265690,265690,265693,0,3,2
75857,3,3,265693,265693,265696,0,3,0
75858,4,1,265697,265697,265698,0,1,1
75859,4,3,265701,265701,265704,0,3,3
75860,1,3,265702,265704,265707,2,5,0
75861,6,1,265708,265708,265709,0,1,1
75862,3,1,265711,265711,265712,0,1,2
75863,6,2,265717,265717,265719,0,2,5
75864,4,1,265721,265721,265722,0,1,2
75865,4,3,265725,265725,265728,0,3,3
75866,3,3,265728,265728,265731,0,3,0
75867,3,1,265731,265731,265732,0,1,0
75868,2,1,265733,265733,265734,0,1,1
75869,4,1,265737,265737,265738,0,1,3
75870,4,1,265741,265741,265742,0,1,3
75871,4,2,265745,265745,265747,0,2,3
75872,5,3,265750,265750,265753,0,3,3
75873,1,2,265751,265753,265755,2,4,0
75874,5,1,265756,265756,265757,0,1,1
75875,4,1,265760,265760,265761,0,1,3
75876,3,3,265763,265763,265766,0,3,2
75877,4,2,265767,265767,265769,0,2,1
75878,1,2,265768,265769,265771,1,3,0
75879,4,1,265772,265772,265773,0,1,1
75880,5,2,265777,265777,265779,0,2,4
75881,3,1,265780,265780,265781,0,1,1
75882,6,1,265786,265786,265787,0,1,5
75883,5,2,265791,265791,265793,0,2,4
75884,6,1,265797,265797,265798,0,1,4
75885,6,3,265803,265803,265806,0,3,5
75886,3,2,265806,265806,265808,0,2,0
75887,2,1,265808,265808,265809,0,1,0
75888,5,3,265813,265813,265816,0,3,4
75889,2,2,265815,265816,265818,1,3,0
75890,2,2,265817,265818,265820,1,3,0
75891,4,3,265821,265821,265824,0,3,1
75892,2,3,265823,265824,265827,1,4,0
75893,3,3,265826,265827,265830,1,4,0
75894,2,2,265828,265830,265832,2,4,0
75895,4,3,265832,265832,265835,0,3,0
75896,2,2,265834,265835,265837,1,3,0
75897,2,2,265836,265837,265839,1,3,0
75898,2,3,265838,265839,265842,1,4,0
75899,1,3,265839,265842,265845,3,6,0
75900,2,3,265841,265845,265848,4,7,0
75901,4,1,265845,265848,265849,3,4,0
75902,1,2,265846,265849,265851,3,5,0
75903,4,1,265850,265851,265852,1,2,0
75904,4,1,265854,265854,265855,0,1,2
75905,1,3,265855,265855,265858,0,3,0
75906,3,3,265858,265858,265861,0,3,0
75907,1,2,265859,265861,265863,2,4,0
75908,5,2,265864,265864,265866,0,2,1
75909,3,3,265867,265867,265870,0,3,1
75910,6,1,265873,265873,265874,0,1,3
75911,4,3,265877,265877,265880,0,3,3
75912,4,1,265881,265881,265882,0,1,1
75913,3,2,265884,265884,265886,0,2,2
75914,4,3,265888,265888,265891,0,3,2
75915,3,1,265891,265891,265892,0,1,0
75916,2,1,265893,265893,265894,0,1,1
75917,3,3,265896,265896,265899,0,3,2
75918,6,2,265902,265902,265904,0,2,3
75919,4,3,265906,265906,265909,0,3,2
75920,3,2,265909,265909,265911,0,2,0
75921,5,1,265914,265914,265915,0,1,3
75922,2,1,265916,265916,265917,0,1,1
75923,6,2,265922,265922,265924,0,2,5
75924,2,1,265924,265924,265925,0,1,0
75925,1,3,265925,265925,265928,0,3,0
75926,4,2,265929,265929,265931,0,2,1
75927,5,2,265934,265934,265936,0,2,3
75928,2,3,265936,265936,265939,0,3,0
75929,5,3,265941,265941,265944,0,3,2
75930,2,3,265943,265944,265947,1,4,0
75931,3,2,265946,265947,265949,1,3,0
75932,3,1,265949,265949,265950,0,1,0
75933,6,1,265955,265955,265956,0,1,5
75934,1,1,265956,265956,265957,0,1,0
75935,6,1,265962,265962,265963,0,1,5
75936,6,1,265968,265968,265969,0,1,5
75937,2,1,265970,265970,265971,0,1,1
75938,4,3,265974,265974,265977,0,3,3
75939,1,3,265975,265977,265980,2,5,0
75940,5,2,265980,265980,265982,0,2,0
75941,5,1,265985,265985,265986,0,1,3
75942,3,2,265988,265988,265990,0,2,2
75943,1,2,265989,265990,265992,1,3,0
75944,6,1,265995,265995,265996,0,1,3
75945,1,3,265996,265996,265999,0,3,0
75946,3,2,265999,265999,266001,0,2,0
75947,6,1,266005,266005,266006,0,1,4
75948,5,1,266010,266010,266011,0,1,4
75949,1,2,266011,266011,266013,0,2,0
75950,2,2,266013,266013,266015,0,2,0
75951,1,1,266014,266015,266016,1,2,0
75952,5,3,266019,266019,266022,0,3,3
75953,3,3,266022,266022,266025,0,3,0
75954,6,2,266028,266028,266030,0,2,3
75955,6,2,266034,266034,266036,0,2,4
75956,4,1,266038,266038,266039,0,1,2
75957,6,1,266044,266044,266045,0,1,5
75958,1,1,266045,266045,266046,0,1,0
75959,4,2,266049,266049,266051,0,2,3
75960,2,3,266051,266051,266054,0,3,0
75961,1,3,266052,266054,266057,2,5,0
75962,5,2,266057,266057,266059,0,2,0
75963,1,2,266058,266059,266061,1,3,0
75964,3,1,266061,266061,266062,0,1,0
75965,1,3,266062,266062,266065,0,3,0
75966,3,3,266065,266065,266068,0,3,0
75967,4,2,266069,266069,266071,0,2,1
75968,3,1,266072,266072,266073,0,1,1
75969,4,1,266076,266076,266077,0,1,3
75970,5,3,266081,266081,266084,0,3,4
75971,5,3,266086,266086,266089,0,3,2
75972,6,3,266092,266092,266095,0,3,3
75973,3,1,266095,266095,266096,0,1,0
75974,5,1,266100,266100,266101,0,1,4
75975,1,1,266101,266101,266102,0,1,0
75976,6,1,266107,266107,266108,0,1,5
75977,5,3,266112,266112,266115,0,3,4
75978,4,1,266116,266116,266117,0,1,1
75979,5,3,266121,266121,266124,0,3,4
75980,1,3,266122,266124,266127,2,5,0
75981,4,3,266126,266127,266130,1,4,0
75982,5,3,266131,266131,266134,0,3,1
75983,1,1,266132,266134,266135,2,3,0
75984,6,1,266138,266138,266139,0,1,3
75985,1,1,266139,266139,266140,0,1,0
75986,3,1,266142,266142,266143,0,1,2
75987,1,1,266143,266143,266144,0,1,0
75988,3,1,266146,266146,266147,0,1,2
75989,4,1,266150,266150,266151,0,1,3
75990,6,2,266156,266156,266158,0,2,5
75991,2,3,266158,266158,266161,0,3,0
75992,2,3,266160,266161,266164,1,4,0
75993,3,2,266163,266164,266166,1,3,0
75994,3,2,266166,266166,266168,0,2,0
75995,2,3,266168,266168,266171,0,3,0
75996,5,2,266173,266173,266175,0,2,2
75997,4,1,266177,266177,266178,0,1,2
75998,1,1,266178,266178,266179,0,1,0
75999,4,1,266182,266182,266183,0,1,3
76000,4,1,266186,266186,266187,0,1,3
76001,3,3,266189,266189,266192,0,3,2
76002,1,1,266190,266192,266193,2,3,0
76003,1,1,266191,266193,266194,2,3,0
76004,2,2,266193,266194,266196,1,3,0
76005,6,3,266199,266199,266202,0,3,3
76006,1,3,266200,266202,266205,2,5,0
76007,4,2,266204,266205,266207,1,3,0
76008,3,1,266207,266207,266208,0,1,0
76009,2,3,266209,266209,266212,0,3,1
76010,5,3,266214,266214,266217,0,3,2
76011,1,3,266215,266217,266220,2,5,0
76012,4,3,266219,266220,266223,1,4,0
76013,1,3,266220,266223,266226,3,6,0
76014,5,3,266225,266226,266229,1,4,0
76015,6,3,266231,266231,266234,0,3,2
76016,5,3,266236,266236,266239,0,3,2
76017,1,1,266237,266239,266240,2,3,0
76018,1,2,266238,266240,266242,2,4,0
76019,5,3,266243,266243,266246,0,3,1
76020,5,1,266248,266248,266249,0,1,2
76021,4,3,266252,266252,266255,0,3,3
76022,5,3,266257,266257,266260,0,3,2
76023,5,2,266262,266262,266264,0,2,2
76024,4,3,266266,266266,266269,0,3,2
76025,2,3,266268,266269,266272,1,4,0
76026,2,2,266270,266272,266274,2,4,0
76027,6,2,266276,266276,266278,0,2,2
76028,1,2,266277,266278,266280,1,3,0
76029,2,3,266279,266280,266283,1,4,0
76030,3,3,266282,266283,266286,1,4,0
76031,4,3,266286,266286,266289,0,3,0
76032,3,3,266289,266289,266292,0,3,0
76033,4,2,266293,266293,266295,0,2,1
76034,1,3,266294,266295,266298,1,4,0
76035,5,1,266299,266299,266300,0,1,1
76036,5,1,266304,266304,266305,0,1,4
76037,5,1,266309,266309,266310,0,1,4
76038,6,3,266315,266315,266318,0,3,5
76039,6,2,266321,266321,266323,0,2,3
76040,6,3,266327,266327,266330,0,3,4
76041,5,3,266332,266332,266335,0,3,2
76042,3,1,266335,266335,266336,0,1,0
76043,4,2,266339,266339,266341,0,2,3
76044,5,3,266344,266344,266347,0,3,3
76045,1,3,266345,266347,266350,2,5,0
76046,4,2,266349,266350,266352,1,3,0
76047,6,3,266355,266355,266358,0,3,3
76048,4,1,266359,266359,266360,0,1,1
76049,2,2,266361,266361,266363,0,2,1
76050,6,2,266367,266367,266369,0,2,4
76051,2,3,266369,266369,266372,0,3,0
76052,5,2,266374,266374,266376,0,2,2
76053,2,2,266376,266376,266378,0,2,0
76054,2,1,266378,266378,266379,0,1,0
76055,6,1,266384,266384,266385,0,1,5
76056,3,1,266387,266387,266388,0,1,2
76057,3,1,266390,266390,266391,0,1,2
76058,1,2,266391,266391,266393,0,2,0
76059,3,3,266394,266394,266397,0,3,1
76060,2,1,266396,266397,266398,1,2,0
76061,6,2,266402,266402,266404,0,2,4
76062,4,1,266406,266406,266407,0,1,2
76063,4,2,266410,266410,266412,0,2,3
76064,3,2,266413,266413,266415,0,2,1
76065,2,1,266415,266415,266416,0,1,0
76066,2,1,266417,266417,266418,0,1,1
76067,3,3,266420,266420,266423,0,3,2
76068,1,2,266421,266423,266425,2,4,0
76069,6,1,266427,266427,266428,0,1,2
76070,4,1,266431,266431,266432,0,1,3
76071,6,3,266437,266437,266440,0,3,5
76072,6,3,266443,266443,266446,0,3,3
76073,1,3,266444,266446,266449,2,5,0
76074,2,1,266446,266449,266450,3,4,0
76075,3,1,266449,266450,266451,1,2,0
76076,5,2,266454,266454,266456,0,2,3
76077,6,3,266460,266460,266463,0,3,4
76078,3,1,266463,266463,266464,0,1,0
76079,1,2,266464,266464,266466,0,2,0
76080,2,2,266466,266466,266468,0,2,0
76081,6,1,266472,266472,266473,0,1,4
76082,3,1,266475,266475,266476,0,1,2
76083,4,3,266479,266479,266482,0,3,3
76084,6,1,266485,266485,266486,0,1,3
76085,4,2,266489,266489,266491,0,2,3
76086,1,2,266490,266491,266493,1,3,0
76087,5,3,266495,266495,266498,0,3,2
76088,2,1,266497,266498,266499,1,2,0
76089,1,1,266498,266499,266500,1,2,0
76090,6,1,266504,266504,266505,0,1,4
76091,5,2,266509,266509,266511,0,2,4
76092,4,1,266513,266513,266514,0,1,2
76093,1,1,266514,266514,266515,0,1,0
76094,3,1,266517,266517,266518,0,1,2
76095,1,1,266518,266518,266519,0,1,0
76096,1,2,266519,266519,266521,0,2,0
76097,2,3,266521,266521,266524,0,3,0
76098,2,2,266523,266524,266526,1,3,0
76099,6,2,266529,266529,266531,0,2,3
76100,4,1,266533,266533,266534,0,1,2
76101,6,2,266539,266539,266541,0,2,5
76102,3,3,266542,266542,266545,0,3,1
76103,6,3,266548,266548,266551,0,3,3
76104,4,1,266552,266552,266553,0,1,1
76105,5,2,266557,266557,266559,0,2,4
76106,5,1,266562,266562,266563,0,1,3
76107,2,3,266564,266564,266567,0,3,1
76108,5,2,266569,266569,266571,0,2,2
76109,5,2,266574,266574,266576,0,2,3
76110,6,1,266580,266580,266581,0,1,4
76111,4,3,266584,266584,266587,0,3,3
76112,1,3,266585,266587,266590,2,5,0
76113,5,1,266590,266590,266591,0,1,0
76114,6,2,266596,266596,266598,0,2,5
76115,3,1,266599,266599,266600,0,1,1
76116,3,1,266602,266602,266603,0,1,2
76117,1,1,266603,266603,266604,0,1,0
76118,6,1,266609,266609,266610,0,1,5
76119,5,3,266614,266614,266617,0,3,4
76120,5,1,266619,266619,266620,0,1,2
76121,1,1,266620,266620,266621,0,1,0
76122,4,3,266624,266624,266627,0,3,3
76123,2,3,266626,266627,266630,1,4,0
76124,6,1,266632,266632,266633,0,1,2
76125,3,3,266635,266635,266638,0,3,2
76126,4,2,266639,266639,266641,0,2,1
76127,3,1,266642,266642,266643,0,1,1
76128,3,1,266645,266645,266646,0,1,2
76129,1,1,266646,266646,266647,0,1,0
76130,2,1,266648,266648,266649,0,1,1
76131,5,3,266653,266653,266656,0,3,4
76132,6,2,266659,266659,266661,0,2,3
76133,3,3,266662,266662,266665,0,3,1
76134,4,2,266666,266666,266668,0,2,1
76135,5,3,266671,266671,266674,0,3,3
76136,4,1,266675,266675,266676,0,1,1
76137,5,2,266680,266680,266682,0,2,4
76138,2,3,266682,266682,266685,0,3,0
76139,5,2,266687,266687,266689,0,2,2
76140,3,3,266690,266690,266693,0,3,1
76141,1,1,266691,266693,266694,2,3,0
76142,3,3,266694,266694,266697,0,3,0
76143,2,3,266696,266697,266700,1,4,0
76144,2,2,266698,266700,266702,2,4,0
76145,5,1,266703,266703,266704,0,1,1
76146,1,3,266704,266704,266707,0,3,0
76147,5,2,266709,266709,266711,0,2,2
76148,6,3,266715,266715,266718,0,3,4
76149,2,1,266717,266718,266719,1,2,0
76150,6,3,266723,266723,266726,0,3,4
76151,5,1,266728,266728,266729,0,1,2
76152,2,3,266730,266730,266733,0,3,1
76153,2,1,266732,266733,266734,1,2,0
76154,1,1,266733,266734,266735,1,2,0
76155,4,1,266737,266737,266738,0,1,2
76156,5,1,266742,266742,266743,0,1,4
76157,2,2,266744,266744,266746,0,2,1
76158,3,3,266747,266747,266750,0,3,1
76159,3,1,266750,266750,266751,0,1,0
76160,4,2,266754,266754,266756,0,2,3
76161,3,3,266757,266757,266760,0,3,1
76162,2,3,266759,266760,266763,1,4,0
76163,4,3,266763,266763,266766,0,3,0
76164,5,3,266768,266768,266771,0,3,2
76165,6,2,266774,266774,266776,0,2,3
76166,3,3,266777,266777,266780,0,3,1
76167,6,2,266783,266783,266785,0,2,3
76168,6,2,266789,266789,266791,0,2,4
76169,5,1,266794,266794,266795,0,1,3
76170,5,1,266799,266799,266800,0,1,4
76171,1,3,266800,266800,266803,0,3,0
76172,2,1,266802,266803,266804,1,2,0
76173,4,3,266806,266806,266809,0,3,2
76174,3,3,266809,266809,266812,0,3,0
76175,3,3,266812,266812,266815,0,3,0
76176,6,2,266818,266818,266820,0,2,3
76177,1,3,266819,266820,266823,1,4,0
76178,6,3,266825,266825,266828,0,3,2
76179,5,3,266830,266830,266833,0,3,2
76180,6,1,266836,266836,266837,0,1,3
76181,6,1,266842,266842,266843,0,1,5
76182,2,3,266844,266844,266847,0,3,1
76183,1,2,266845,266847,266849,2,4,0
76184,1,3,266846,266849,266852,3,6,0
76185,6,3,266852,266852,266855,0,3,0
76186,3,2,266855,266855,266857,0,2,0
76187,6,2,266861,266861,266863,0,2,4
76188,5,2,266866,266866,266868,0,2,3
76189,5,2,266871,266871,266873,0,2,3
76190,6,3,266877,266877,266880,0,3,4
76191,5,3,266882,266882,266885,0,3,2
76192,3,2,266885,266885,266887,0,2,0
76193,6,2,266891,266891,266893,0,2,4
76194,6,1,266897,266897,266898,0,1,4
76195,4,2,266901,266901,266903,0,2,3
76196,4,1,266905,266905,266906,0,1,2
76197,2,2,266907,266907,266909,0,2,1
76198,5,1,266912,266912,266913,0,1,3
76199,4,2,266916,266916,266918,0,2,3
76200,5,2,266921,266921,266923,0,2,3
76201,4,3,266925,266925,266928,0,3,2
76202,3,2,266928,266928,266930,0,2,0
76203,2,3,266930,266930,266933,0,3,0
76204,2,2,266932,266933,266935,1,3,0
76205,5,2,266937,266937,266939,0,2,2
76206,1,2,266938,266939,266941,1,3,0
76207,3,3,266941,266941,266944,0,3,0
76208,5,1,266946,266946,266947,0,1,2
76209,1,2,266947,266947,266949,0,2,0
76210,1,2,266948,266949,266951,1,3,0
76211,5,3,266953,266953,266956,0,3,2
76212,6,3,266959,266959,266962,0,3,3
76213,1,3,266960,266962,266965,2,5,0
76214,2,2,266962,266965,266967,3,5,0
76215,2,2,266964,266967,266969,3,5,0
76216,4,3,266968,266969,266972,1,4,0
76217,2,3,266970,266972,266975,2,5,0
76218,6,3,266976,266976,266979,0,3,1
76219,5,2,266981,266981,266983,0,2,2
76220,6,2,266987,266987,266989,0,2,4
76221,6,2,266993,266993,266995,0,2,4
76222,4,3,266997,266997,267000,0,3,2
76223,6,1,267003,267003,267004,0,1,3
76224,4,3,267007,267007,267010,0,3,3
76225,2,2,267009,267010,267012,1,3,0
76226,4,1,267013,267013,267014,0,1,1
76227,3,3,267016,267016,267019,0,3,2
76228,5,3,267021,267021,267024,0,3,2
76229,5,2,267026,267026,267028,0,2,2
76230,1,1,267027,267028,267029,1,2,0
76231,3,1,267030,267030,267031,0,1,1
76232,6,3,267036,267036,267039,0,3,5
76233,1,1,267037,267039,267040,2,3,0
76234,1,2,267038,267040,267042,2,4,0
76235,4,2,267042,267042,267044,0,2,0
76236,1,1,267043,267044,267045,1,2,0
76237,3,3,267046,267046,267049,0,3,1
76238,3,3,267049,267049,267052,0,3,0
76239,2,1,267051,267052,267053,1,2,0
76240,5,2,267056,267056,267058,0,2,3
76241,2,2,267058,267058,267060,0,2,0
76242,6,3,267064,267064,267067,0,3,4
76243,1,2,267065,267067,267069,2,4,0
76244,4,2,267069,267069,267071,0,2,0
76245,3,3,267072,267072,267075,0,3,1
76246,2,2,267074,267075,267077,1,3,0
76247,5,1,267079,267079,267080,0,1,2
76248,5,3,267084,267084,267087,0,3,4
76249,2,1,267086,267087,267088,1,2,0
76250,5,1,267091,267091,267092,0,1,3
76251,1,2,267092,267092,267094,0,2,0
76252,1,2,267093,267094,267096,1,3,0
76253,2,1,267095,267096,267097,1,2,0
76254,6,2,267101,267101,267103,0,2,4
76255,4,2,267105,267105,267107,0,2,2
76256,6,1,267111,267111,267112,0,1,4
76257,1,2,267112,267112,267114,0,2,0
76258,4,3,267116,267116,267119,0,3,2
76259,2,3,267118,267119,267122,1,4,0
76260,6,1,267124,267124,267125,0,1,2
76261,4,1,267128,267128,267129,0,1,3
76262,1,3,267129,267129,267132,0,3,0
76263,6,1,267135,267135,267136,0,1,3
76264,5,2,267140,267140,267142,0,2,4
76265,6,2,267146,267146,267148,0,2,4
76266,1,2,267147,267148,267150,1,3,0
76267,1,3,267148,267150,267153,2,5,0
76268,5,1,267153,267153,267154,0,1,0
76269,3,2,267156,267156,267158,0,2,2
76270,1,2,267157,267158,267160,1,3,0
76271,1,3,267158,267160,267163,2,5,0
76272,2,1,267160,267163,267164,3,4,0
76273,2,3,267162,267164,267167,2,5,0
76274,3,2,267165,267167,267169,2,4,0
76275,1,2,267166,267169,267171,3,5,0
76276,4,2,267170,267171,267173,1,3,0
76277,4,2,267174,267174,267176,0,2,1
76278,4,3,267178,267178,267181,0,3,2
76279,1,1,267179,267181,267182,2,3,0
76280,1,1,267180,267182,267183,2,3,0
76281,2,3,267182,267183,267186,1,4,0
76282,2,2,267184,267186,267188,2,4,0
76283,3,1,267187,267188,267189,1,2,0
76284,3,2,267190,267190,267192,0,2,1
76285,5,2,267195,267195,267197,0,2,3
76286,3,2,267198,267198,267200,0,2,1
76287,2,3,267200,267200,267203,0,3,0
76288,3,1,267203,267203,267204,0,1,0
76289,6,3,267209,267209,267212,0,3,5
76290,6,1,267215,267215,267216,0,1,3
76291,2,2,267217,267217,267219,0,2,1
76292,5,2,267222,267222,267224,0,2,3
76293,3,2,267225,267225,267227,0,2,1
76294,5,2,267230,267230,267232,0,2,3
76295,6,2,267236,267236,267238,0,2,4
76296,5,1,267241,267241,267242,0,1,3
76297,2,2,267243,267243,267245,0,2,1
76298,6,2,267249,267249,267251,0,2,4
76299,5,1,267254,267254,267255,0,1,3
76300,2,3,267256,267256,267259,0,3,1
76301,3,1,267259,267259,267260,0,1,0
76302,4,2,267263,267263,267265,0,2,3
76303,4,3,267267,267267,267270,0,3,2
76304,6,1,267273,267273,267274,0,1,3
76305,2,3,267275,267275,267278,0,3,1
76306,2,3,267277,267278,267281,1,4,0
76307,1,2,267278,267281,267283,3,5,0
76308,3,3,267281,267283,267286,2,5,0
76309,4,1,267285,267286,267287,1,2,0
76310,1,2,267286,267287,267289,1,3,0
76311,2,1,267288,267289,267290,1,2,0
76312,1,3,267289,267290,267293,1,4,0
76313,4,3,267293,267293,267296,0,3,0
76314,1,2,267294,267296,267298,2,4,0
76315,6,2,267300,267300,267302,0,2,2
76316,4,3,267304,267304,267307,0,3,2
76317,1,2,267305,267307,267309,2,4,0
76318,1,1,267306,267309,267310,3,4,0
76319,1,1,267307,267310,267311,3,4,0
76320,5,3,267312,267312,267315,0,3,1
76321,2,3,267314,267315,267318,1,4,0
76322,1,2,267315,267318,267320,3,5,0
76323,6,1,267321,267321,267322,0,1,1
76324,3,1,267324,267324,267325,0,1,2
76325,3,2,267327,267327,267329,0,2,2
76326,6,1,267333,267333,267334,0,1,4
76327,1,3,267334,267334,267337,0,3,0
76328,6,1,267340,267340,267341,0,1,3
76329,6,2,267346,267346,267348,0,2,5
76330,6,2,267352,267352,267354,0,2,4
76331,1,1,267353,267354,267355,1,2,0
76332,6,2,267359,267359,267361,0,2,4
76333,1,2,267360,267361,267363,1,3,0
76334,5,1,267365,267365,267366,0,1,2
76335,4,1,267369,267369,267370,0,1,3
76336,1,3,267370,267370,267373,0,3,0
76337,1,3,267371,267373,267376,2,5,0
76338,2,3,267373,267376,267379,3,6,0
76339,1,2,267374,267379,267381,5,7,0
76340,1,2,267375,267381,267383,6,8,0
76341,6,2,267381,267383,267385,2,4,0
76342,6,1,267387,267387,267388,0,1,2
76343,3,3,267390,267390,267393,0,3,2
76344,4,3,267394,267394,267397,0,3,1
76345,1,2,267395,267397,267399,2,4,0
76346,4,2,267399,267399,267401,0,2,0
76347,3,3,267402,267402,267405,0,3,1
76348,3,3,267405,267405,267408,0,3,0
76349,1,2,267406,267408,267410,2,4,0
76350,4,2,267410,267410,267412,0,2,0
76351,2,1,267412,267412,267413,0,1,0
76352,2,3,267414,267414,267417,0,3,1
76353,6,3,267420,267420,267423,0,3,3
76354,2,3,267422,267423,267426,1,4,0
76355,2,3,267424,267426,267429,2,5,0
76356,1,1,267425,267429,267430,4,5,0
76357,1,2,267426,267430,267432,4,6,0
76358,5,3,267431,267432,267435,1,4,0
76359,6,3,267437,267437,267440,0,3,2
76360,2,2,267439,267440,267442,1,3,0
76361,4,3,267443,267443,267446,0,3,1
76362,3,1,267446,267446,267447,0,1,0
76363,1,1,267447,267447,267448,0,1,0
76364,6,1,267453,267453,267454,0,1,5
76365,1,1,267454,267454,267455,0,1,0
76366,6,1,267460,267460,267461,0,1,5
76367,2,3,267462,267462,267465,0,3,1
76368,6,1,267468,267468,267469,0,1,3
76369,1,1,267469,267469,267470,0,1,0
76370,3,3,267472,267472,267475,0,3,2
76371,5,2,267477,267477,267479,0,2,2
76372,4,2,267481,267481,267483,0,2,2
76373,1,3,267482,267483,267486,1,4,0
76374,4,1,267486,267486,267487,0,1,0
76375,3,2,267489,267489,267491,0,2,2
76376,5,3,267494,267494,267497,0,3,3
76377,1,3,267495,267497,267500,2,5,0
76378,1,1,267496,267500,267501,4,5,0
76379,6,1,267502,267502,267503,0,1,1
76380,3,1,267505,267505,267506,0,1,2
76381,5,2,267510,267510,267512,0,2,4
76382,4,2,267514,267514,267516,0,2,2
76383,4,2,267518,267518,267520,0,2,2
76384,1,2,267519,267520,267522,1,3,0
76385,5,2,267524,267524,267526,0,2,2
76386,2,3,267526,267526,267529,0,3,0
76387,4,3,267530,267530,267533,0,3,1
76388,5,2,267535,267535,267537,0,2,2
76389,1,1,267536,267537,267538,1,2,0
76390,6,1,267542,267542,267543,0,1,4
76391,4,3,267546,267546,267549,0,3,3
76392,5,3,267551,267551,267554,0,3,2
76393,1,1,267552,267554,267555,2,3,0
76394,1,1,267553,267555,267556,2,3,0
76395,4,2,267557,267557,267559,0,2,1
76396,2,3,267559,267559,267562,0,3,0
76397,5,2,267564,267564,267566,0,2,2
76398,5,1,267569,267569,267570,0,1,3
76399,5,1,267574,267574,267575,0,1,4
76400,4,1,267578,267578,267579,0,1,3
76401,4,1,267582,267582,267583,0,1,3
76402,4,1,267586,267586,267587,0,1,3
76403,2,1,267588,267588,267589,0,1,1
76404,2,2,267590,267590,267592,0,2,1
76405,5,1,267595,267595,267596,0,1,3
76406,4,2,267599,267599,267601,0,2,3
76407,5,1,267604,267604,267605,0,1,3
76408,4,2,267608,267608,267610,0,2,3
76409,1,1,267609,267610,267611,1,2,0
76410,6,1,267615,267615,267616,0,1,4
76411,6,3,267621,267621,267624,0,3,5
76412,1,2,267622,267624,267626,2,4,0
76413,6,1,267628,267628,267629,0,1,2
76414,4,1,267632,267632,267633,0,1,3
76415,6,2,267638,267638,267640,0,2,5
76416,2,3,267640,267640,267643,0,3,0
76417,6,2,267646,267646,267648,0,2,3
76418,3,2,267649,267649,267651,0,2,1
76419,2,1,267651,267651,267652,0,1,0
76420,1,3,267652,267652,267655,0,3,0
76421,4,3,267656,267656,267659,0,3,1
76422,2,2,267658,267659,267661,1,3,0
76423,1,1,267659,267661,267662,2,3,0
76424,5,1,267664,267664,267665,0,1,2
76425,1,1,267665,267665,267666,0,1,0
76426,4,3,267669,267669,267672,0,3,3
76427,3,3,267672,267672,267675,0,3,0
76428,1,2,267673,267675,267677,2,4,0
76429,3,3,267676,267677,267680,1,4,0
76430,1,1,267677,267680,267681,3,4,0
76431,2,2,267679,267681,267683,2,4,0
76432,6,3,267685,267685,267688,0,3,2
76433,4,1,267689,267689,267690,0,1,1
76434,2,2,267691,267691,267693,0,2,1
76435,6,1,267697,267697,267698,0,1,4
76436,6,1,267703,267703,267704,0,1,5
76437,5,1,267708,267708,267709,0,1,4
76438,5,2,267713,267713,267715,0,2,4
76439,5,3,267718,267718,267721,0,3,3
76440,2,1,267720,267721,267722,1,2,0
76441,1,3,267721,267722,267725,1,4,0
76442,3,3,267724,267725,267728,1,4,0
76443,2,2,267726,267728,267730,2,4,0
76444,2,1,267728,267730,267731,2,3,0
76445,2,2,267730,267731,267733,1,3,0
76446,6,2,267736,267736,267738,0,2,3
76447,1,2,267737,267738,267740,1,3,0
76448,1,1,267738,267740,267741,2,3,0
76449,5,2,267743,267743,267745,0,2,2
76450,2,1,267745,267745,267746,0,1,0
76451,4,1,267749,267749,267750,0,1,3
76452,6,3,267755,267755,267758,0,3,5
76453,5,2,267760,267760,267762,0,2,2
76454,1,1,267761,267762,267763,1,2,0
76455,3,2,267764,267764,267766,0,2,1
76456,3,1,267767,267767,267768,0,1,1
76457,2,3,267769,267769,267772,0,3,1
76458,6,1,267775,267775,267776,0,1,3
76459,4,1,267779,267779,267780,0,1,3
76460,1,2,267780,267780,267782,0,2,0
76461,4,1,267784,267784,267785,0,1,2
76462,1,2,267785,267785,267787,0,2,0
76463,6,2,267791,267791,267793,0,2,4
76464,3,3,267794,267794,267797,0,3,1
76465,4,2,267798,267798,267800,0,2,1
76466,2,1,267800,267800,267801,0,1,0
76467,6,1,267806,267806,267807,0,1,5
76468,2,2,267808,267808,267810,0,2,1
76469,6,3,267814,267814,267817,0,3,4
76470,5,3,267819,267819,267822,0,3,2
76471,2,1,267821,267822,267823,1,2,0
76472,3,3,267824,267824,267827,0,3,1
76473,3,2,267827,267827,267829,0,2,0
76474,3,2,267830,267830,267832,0,2,1
76475,6,2,267836,267836,267838,0,2,4
76476,4,1,267840,267840,267841,0,1,2
76477,4,2,267844,267844,267846,0,2,3
76478,1,3,267845,267846,267849,1,4,0
76479,3,3,267848,267849,267852,1,4,0
76480,5,1,267853,267853,267854,0,1,1
76481,1,2,267854,267854,267856,0,2,0
76482,4,3,267858,267858,267861,0,3,2
76483,5,2,267863,267863,267865,0,2,2
76484,3,2,267866,267866,267868,0,2,1
76485,4,3,267870,267870,267873,0,3,2
76486,5,3,267875,267875,267878,0,3,2
76487,3,1,267878,267878,267879,0,1,0
76488,4,3,267882,267882,267885,0,3,3
76489,3,1,267885,267885,267886,0,1,0
76490,1,3,267886,267886,267889,0,3,0
76491,6,1,267892,267892,267893,0,1,3
76492,3,1,267895,267895,267896,0,1,2
76493,1,1,267896,267896,267897,0,1,0
76494,5,1,267901,267901,267902,0,1,4
76495,2,3,267903,267903,267906,0,3,1
76496,4,1,267907,267907,267908,0,1,1
76497,2,2,267909,267909,267911,0,2,1
76498,2,1,267911,267911,267912,0,1,0
76499,3,1,267914,267914,267915,0,1,2
76500,1,3,267915,267915,267918,0,3,0
76501,5,2,267920,267920,267922,0,2,2
76502,6,3,267926,267926,267929,0,3,4
76503,6,3,267932,267932,267935,0,3,3
76504,4,1,267936,267936,267937,0,1,1
76505,4,1,267940,267940,267941,0,1,3
76506,5,1,267945,267945,267946,0,1,4
76507,5,3,267950,267950,267953,0,3,4
76508,6,2,267956,267956,267958,0,2,3
76509,4,3,267960,267960,267963,0,3,2
76510,4,1,267964,267964,267965,0,1,1
76511,6,2,267970,267970,267972,0,2,5
76512,6,2,267976,267976,267978,0,2,4
76513,5,1,267981,267981,267982,0,1,3
76514,5,1,267986,267986,267987,0,1,4
76515,4,1,267990,267990,267991,0,1,3
76516,3,1,267993,267993,267994,0,1,2
76517,4,3,267997,267997,268000,0,3,3
76518,5,1,268002,268002,268003,0,1,2
76519,3,1,268005,268005,268006,0,1,2
76520,1,2,268006,268006,268008,0,2,0
76521,4,1,268010,268010,268011,0,1,2
76522,5,2,268015,268015,268017,0,2,4
76523,2,3,268017,268017,268020,0,3,0
76524,6,3,268023,268023,268026,0,3,3
76525,6,1,268029,268029,268030,0,1,3
76526,6,2,268035,268035,268037,0,2,5
76527,1,2,268036,268037,268039,1,3,0
76528,3,1,268039,268039,268040,0,1,0
76529,5,2,268044,268044,268046,0,2,4
76530,4,1,268048,268048,268049,0,1,2
76531,6,1,268054,268054,268055,0,1,5
76532,3,1,268057,268057,268058,0,1,2
76533,3,2,268060,268060,268062,0,2,2
76534,2,2,268062,268062,268064,0,2,0
76535,5,2,268067,268067,268069,0,2,3
76536,3,3,268070,268070,268073,0,3,1
76537,4,3,268074,268074,268077,0,3,1
76538,1,3,268075,268077,268080,2,5,0
76539,3,3,268078,268080,268083,2,5,0
76540,6,3,268084,268084,268087,0,3,1
76541,4,1,268088,268088,268089,0,1,1
76542,2,3,268090,268090,268093,0,3,1
76543,1,3,268091,268093,268096,2,5,0
76544,1,1,268092,268096,268097,4,5,0
76545,5,2,268097,268097,268099,0,2,0
76546,1,3,268098,268099,268102,1,4,0
76547,3,1,268101,268102,268103,1,2,0
76548,3,2,268104,268104,268106,0,2,1
76549,5,1,268109,268109,268110,0,1,3
76550,5,3,268114,268114,268117,0,3,4
76551,5,1,268119,268119,268120,0,1,2
76552,5,2,268124,268124,268126,0,2,4
76553,5,1,268129,268129,268130,0,1,3
76554,5,2,268134,268134,268136,0,2,4
76555,4,3,268138,268138,268141,0,3,2
76556,5,1,268143,268143,268144,0,1,2
76557,2,2,268145,268145,268147,0,2,1
76558,1,1,268146,268147,268148,1,2,0
76559,6,2,268152,268152,268154,0,2,4
76560,2,2,268154,268154,268156,0,2,0
76561,4,1,268158,268158,268159,0,1,2
76562,5,1,268163,268163,268164,0,1,4
76563,1,3,268164,268164,268167,0,3,0
76564,3,1,268167,268167,268168,0,1,0
76565,4,3,268171,268171,268174,0,3,3
76566,4,1,268175,268175,268176,0,1,1
76567,2,3,268177,268177,268180,0,3,1
76568,4,1,268181,268181,268182,0,1,1
76569,2,3,268183,268183,268186,0,3,1
76570,2,1,268185,268186,268187,1,2,0
76571,4,1,268189,268189,268190,0,1,2
76572,6,1,268195,268195,268196,0,1,5
76573,3,3,268198,268198,268201,0,3,2
76574,4,2,268202,268202,268204,0,2,1
76575,1,2,268203,268204,268206,1,3,0
76576,3,2,268206,268206,268208,0,2,0
76577,3,1,268209,268209,268210,0,1,1
76578,5,3,268214,268214,268217,0,3,4
76579,2,2,268216,268217,268219,1,3,0
76580,6,3,268222,268222,268225,0,3,3
76581,4,1,268226,268226,268227,0,1,1
76582,1,1,268227,268227,268228,0,1,0
76583,3,2,268230,268230,268232,0,2,2
76584,5,1,268235,268235,268236,0,1,3
76585,2,3,268237,268237,268240,0,3,1
76586,3,2,268240,268240,268242,0,2,0
76587,4,1,268244,268244,268245,0,1,2
76588,3,1,268247,268247,268248,0,1,2
76589,1,1,268248,268248,268249,0,1,0
76590,5,3,268253,268253,268256,0,3,4
76591,5,2,268258,268258,268260,0,2,2
76592,4,1,268262,268262,268263,0,1,2
76593,6,2,268268,268268,268270,0,2,5
76594,3,1,268271,268271,268272,0,1,1
76595,2,3,268273,268273,268276,0,3,1
76596,2,2,268275,268276,268278,1,3,0
76597,3,3,268278,268278,268281,0,3,0
76598,6,2,268284,268284,268286,0,2,3
76599,6,2,268290,268290,268292,0,2,4
76600,4,2,268294,268294,268296,0,2,2
76601,4,2,268298,268298,268300,0,2,2
76602,5,1,268303,268303,268304,0,1,3
76603,5,2,268308,268308,268310,0,2,4
76604,2,1,268310,268310,268311,0,1,0
76605,4,3,268314,268314,268317,0,3,3
76606,2,1,268316,268317,268318,1,2,0
76607,4,2,268320,268320,268322,0,2,2
76608,4,1,268324,268324,268325,0,1,2
76609,1,2,268325,268325,268327,0,2,0
76610,1,2,268326,268327,268329,1,3,0
76611,2,3,268328,268329,268332,1,4,0
76612,3,1,268331,268332,268333,1,2,0
76613,1,2,268332,268333,268335,1,3,0
76614,3,2,268335,268335,268337,0,2,0
76615,1,2,268336,268337,268339,1,3,0
76616,3,3,268339,268339,268342,0,3,0
76617,1,1,268340,268342,268343,2,3,0
76618,2,1,268342,268343,268344,1,2,0
76619,1,1,268343,268344,268345,1,2,0
76620,5,2,268348,268348,268350,0,2,3
76621,6,3,268354,268354,268357,0,3,4
76622,3,3,268357,268357,268360,0,3,0
76623,1,3,268358,268360,268363,2,5,0
76624,2,2,268360,268363,268365,3,5,0
76625,3,1,268363,268365,268366,2,3,0
76626,1,2,268364,268366,268368,2,4,0
76627,3,3,268367,268368,268371,1,4,0
76628,6,1,268373,268373,268374,0,1,2
76629,3,1,268376,268376,268377,0,1,2
76630,1,3,268377,268377,268380,0,3,0
76631,4,1,268381,268381,268382,0,1,1
76632,4,1,268385,268385,268386,0,1,3
76633,4,2,268389,268389,268391,0,2,3
76634,4,2,268393,268393,268395,0,2,2
76635,4,1,268397,268397,268398,0,1,2
76636,3,3,268400,268400,268403,0,3,2
76637,3,3,268403,268403,268406,0,3,0
76638,4,3,268407,268407,268410,0,3,1
76639,1,1,268408,268410,268411,2,3,0
76640,4,3,268412,268412,268415,0,3,1
76641,4,3,268416,268416,268419,0,3,1
76642,6,3,268422,268422,268425,0,3,3
76643,2,1,268424,268425,268426,1,2,0
76644,6,3,268430,268430,268433,0,3,4
76645,2,2,268432,268433,268435,1,3,0
76646,2,1,268434,268435,268436,1,2,0
76647,1,2,268435,268436,268438,1,3,0
76648,5,1,268440,268440,268441,0,1,2
76649,1,3,268441,268441,268444,0,3,0
76650,6,1,268447,268447,268448,0,1,3
76651,3,1,268450,268450,268451,0,1,2
76652,1,1,268451,268451,268452,0,1,0
76653,6,1,268457,268457,268458,0,1,5
76654,4,3,268461,268461,268464,0,3,3
76655,3,3,268464,268464,268467,0,3,0
76656,1,1,268465,268467,268468,2,3,0
76657,4,1,268469,268469,268470,0,1,1
76658,3,1,268472,268472,268473,0,1,2
76659,3,1,268475,268475,268476,0,1,2
76660,2,2,268477,268477,268479,0,2,1
76661,4,1,268481,268481,268482,0,1,2
76662,1,3,268482,268482,268485,0,3,0
76663,6,3,268488,268488,268491,0,3,3
76664,6,1,268494,268494,268495,0,1,3
76665,6,2,268500,268500,268502,0,2,5
76666,6,1,268506,268506,268507,0,1,4
76667,6,2,268512,268512,268514,0,2,5
76668,2,1,268514,268514,268515,0,1,0
76669,6,1,268520,268520,268521,0,1,5
76670,1,1,268521,268521,268522,0,1,0
76671,3,1,268524,268524,268525,0,1,2
76672,2,1,268526,268526,268527,0,1,1
76673,1,2,268527,268527,268529,0,2,0
76674,1,3,268528,268529,268532,1,4,0
76675,6,3,268534,268534,268537,0,3,2
76676,5,3,268539,268539,268542,0,3,2
76677,1,3,268540,268542,268545,2,5,0
76678,4,2,268544,268545,268547,1,3,0
76679,5,2,268549,268549,268551,0,2,2
76680,3,1,268552,268552,268553,0,1,1
76681,5,2,268557,268557,268559,0,2,4
76682,3,2,268560,268560,268562,0,2,1
76683,3,1,268563,268563,268564,0,1,1
76684,3,1,268566,268566,268567,0,1,2
76685,6,1,268572,268572,268573,0,1,5
76686,4,3,268576,268576,268579,0,3,3
76687,3,2,268579,268579,268581,0,2,0
76688,6,3,268585,268585,268588,0,3,4
76689,6,3,268591,268591,268594,0,3,3
76690,3,2,268594,268594,268596,0,2,0
76691,5,2,268599,268599,268601,0,2,3
76692,1,2,268600,268601,268603,1,3,0
76693,5,3,268605,268605,268608,0,3,2
76694,1,1,268606,268608,268609,2,3,0
76695,6,1,268612,268612,268613,0,1,3
76696,5,2,268617,268617,268619,0,2,4
76697,1,2,268618,268619,268621,1,3,0
76698,3,2,268621,268621,268623,0,2,0
76699,5,1,268626,268626,268627,0,1,3
76700,6,3,268632,268632,268635,0,3,5
76701,5,1,268637,268637,268638,0,1,2
76702,2,1,268639,268639,268640,0,1,1
76703,1,2,268640,268640,268642,0,2,0
76704,2,1,268642,268642,268643,0,1,0
76705,3,3,268645,268645,268648,0,3,2
76706,2,3,268647,268648,268651,1,4,0
76707,2,3,268649,268651,268654,2,5,0
76708,3,1,268652,268654,268655,2,3,0
76709,5,3,268657,268657,268660,0,3,2
76710,5,3,268662,268662,268665,0,3,2
76711,2,1,268664,268665,268666,1,2,0
76712,1,2,268665,268666,268668,1,3,0
76713,6,1,268671,268671,268672,0,1,3
76714,3,3,268674,268674,268677,0,3,2
76715,4,2,268678,268678,268680,0,2,1
76716,3,2,268681,268681,268683,0,2,1
76717,3,2,268684,268684,268686,0,2,1
76718,5,3,268689,268689,268692,0,3,3
76719,4,3,268693,268693,268696,0,3,1
76720,1,2,268694,268696,268698,2,4,0
76721,5,2,268699,268699,268701,0,2,1
76722,2,2,268701,268701,268703,0,2,0
76723,4,2,268705,268705,268707,0,2,2
76724,5,1,268710,268710,268711,0,1,3
76725,5,1,268715,268715,268716,0,1,4
76726,3,2,268718,268718,268720,0,2,2
76727,6,2,268724,268724,268726,0,2,4
76728,3,3,268727,268727,268730,0,3,1
76729,3,3,268730,268730,268733,0,3,0
76730,5,1,268735,268735,268736,0,1,2
76731,5,3,268740,268740,268743,0,3,4
76732,1,3,268741,268743,268746,2,5,0
76733,1,1,268742,268746,268747,4,5,0
76734,1,3,268743,268747,268750,4,7,0
76735,5,2,268748,268750,268752,2,4,0
76736,4,1,268752,268752,268753,0,1,0
76737,3,2,268755,268755,268757,0,2,2
76738,3,3,268758,268758,268761,0,3,1
76739,2,3,268760,268761,268764,1,4,0
76740,5,2,268765,268765,268767,0,2,1
76741,4,2,268769,268769,268771,0,2,2
76742,4,2,268773,268773,268775,0,2,2
76743,4,3,268777,268777,268780,0,3,2
76744,5,3,268782,268782,268785,0,3,2
76745,5,2,268787,268787,268789,0,2,2
76746,4,3,268791,268791,268794,0,3,2
76747,1,2,268792,268794,268796,2,4,0
76748,5,2,268797,268797,268799,0,2,1
76749,1,1,268798,268799,268800,1,2,0
76750,3,2,268801,268801,268803,0,2,1
76751,2,1,268803,268803,268804,0,1,0
76752,2,3,268805,268805,268808,0,3,1
76753,6,2,268811,268811,268813,0,2,3
76754,5,3,268816,268816,268819,0,3,3
76755,6,1,268822,268822,268823,0,1,3
76756,3,3,268825,268825,268828,0,3,2
76757,1,1,268826,268828,268829,2,3,0
76758,1,3,268827,268829,268832,2,5,0
76759,5,3,268832,268832,268835,0,3,0
76760,2,2,268834,268835,268837,1,3,0
76761,2,1,268836,268837,268838,1,2,0
76762,4,3,268840,268840,268843,0,3,2
76763,2,1,268842,268843,268844,1,2,0
76764,2,2,268844,268844,268846,0,2,0
76765,5,3,268849,268849,268852,0,3,3
76766,2,2,268851,268852,268854,1,3,0
76767,3,3,268854,268854,268857,0,3,0
76768,6,2,268860,268860,268862,0,2,3
76769,1,1,268861,268862,268863,1,2,0
76770,2,1,268863,268863,268864,0,1,0
76771,5,3,268868,268868,268871,0,3,4
76772,3,3,268871,268871,268874,0,3,0
76773,5,1,268876,268876,268877,0,1,2
76774,6,3,268882,268882,268885,0,3,5
76775,4,2,268886,268886,268888,0,2,1
76776,2,2,268888,268888,268890,0,2,0
76777,2,2,268890,268890,268892,0,2,0
76778,6,3,268896,268896,268899,0,3,4
76779,4,3,268900,268900,268903,0,3,1
76780,4,3,268904,268904,268907,0,3,1
76781,1,1,268905,268907,268908,2,3,0
76782,4,2,268909,268909,268911,0,2,1
76783,6,1,268915,268915,268916,0,1,4
76784,6,3,268921,268921,268924,0,3,5
76785,2,3,268923,268924,268927,1,4,0
76786,3,3,268926,268927,268930,1,4,0
76787,5,1,268931,268931,268932,0,1,1
76788,1,3,268932,268932,268935,0,3,0
76789,6,2,268938,268938,268940,0,2,3
76790,6,2,268944,268944,268946,0,2,4
76791,1,3,268945,268946,268949,1,4,0
76792,4,2,268949,268949,268951,0,2,0
76793,2,3,268951,268951,268954,0,3,0
76794,2,2,268953,268954,268956,1,3,0
76795,3,1,268956,268956,268957,0,1,0
76796,4,3,268960,268960,268963,0,3,3
76797,5,3,268965,268965,268968,0,3,2
76798,1,2,268966,268968,268970,2,4,0
76799,4,3,268970,268970,268973,0,3,0
76800,1,3,268971,268973,268976,2,5,0
76801,2,1,268973,268976,268977,3,4,0
76802,1,3,268974,268977,268980,3,6,0
76803,4,2,268978,268980,268982,2,4,0
76804,4,1,268982,268982,268983,0,1,0
76805,5,1,268987,268987,268988,0,1,4
76806,5,3,268992,268992,268995,0,3,4
76807,5,2,268997,268997,268999,0,2,2
76808,5,3,269002,269002,269005,0,3,3
76809,5,3,269007,269007,269010,0,3,2
76810,2,1,269009,269010,269011,1,2,0
76811,5,3,269014,269014,269017,0,3,3
76812,4,3,269018,269018,269021,0,3,1
76813,1,1,269019,269021,269022,2,3,0
76814,6,2,269025,269025,269027,0,2,3
76815,6,1,269031,269031,269032,0,1,4
76816,5,2,269036,269036,269038,0,2,4
76817,2,3,269038,269038,269041,0,3,0
76818,4,1,269042,269042,269043,0,1,1
76819,1,2,269043,269043,269045,0,2,0
76820,6,1,269049,269049,269050,0,1,4
76821,1,1,269050,269050,269051,0,1,0
76822,3,3,269053,269053,269056,0,3,2
76823,5,2,269058,269058,269060,0,2,2
76824,4,3,269062,269062,269065,0,3,2
76825,4,2,269066,269066,269068,0,2,1
76826,1,3,269067,269068,269071,1,4,0
76827,4,3,269071,269071,269074,0,3,0
76828,1,3,269072,269074,269077,2,5,0
76829,6,1,269078,269078,269079,0,1,1
76830,3,2,269081,269081,269083,0,2,2
76831,3,3,269084,269084,269087,0,3,1
76832,6,1,269090,269090,269091,0,1,3
76833,1,1,269091,269091,269092,0,1,0
76834,4,3,269095,269095,269098,0,3,3
76835,4,3,269099,269099,269102,0,3,1
76836,2,1,269101,269102,269103,1,2,0
76837,1,2,269102,269103,269105,1,3,0
76838,1,2,269103,269105,269107,2,4,0
76839,5,1,269108,269108,269109,0,1,1
76840,3,3,269111,269111,269114,0,3,2
76841,3,1,269114,269114,269115,0,1,0
76842,4,1,269118,269118,269119,0,1,3
76843,5,1,269123,269123,269124,0,1,4
76844,1,2,269124,269124,269126,0,2,0
76845,5,3,269129,269129,269132,0,3,3
76846,2,3,269131,269132,269135,1,4,0
76847,3,2,269134,269135,269137,1,3,0
76848,5,1,269139,269139,269140,0,1,2
76849,1,3,269140,269140,269143,0,3,0
76850,4,3,269144,269144,269147,0,3,1
76851,3,1,269147,269147,269148,0,1,0
76852,2,3,269149,269149,269152,0,3,1
76853,5,3,269154,269154,269157,0,3,2
76854,1,3,269155,269157,269160,2,5,0
76855,4,3,269159,269160,269163,1,4,0
76856,4,2,269163,269163,269165,0,2,0
76857,3,3,269166,269166,269169,0,3,1
76858,1,2,269167,269169,269171,2,4,0
76859,3,3,269170,269171,269174,1,4,0
76860,2,1,269172,269174,269175,2,3,0
76861,2,3,269174,269175,269178,1,4,0
76862,6,1,269180,269180,269181,0,1,2
76863,2,3,269182,269182,269185,0,3,1
76864,4,3,269186,269186,269189,0,3,1
76865,5,1,269191,269191,269192,0,1,2
76866,2,2,269193,269193,269195,0,2,1
76867,2,3,269195,269195,269198,0,3,0
76868,5,2,269200,269200,269202,0,2,2
76869,5,3,269205,269205,269208,0,3,3
76870,5,1,269210,269210,269211,0,1,2
76871,1,1,269211,269211,269212,0,1,0
76872,2,1,269213,269213,269214,0,1,1
76873,5,1,269218,269218,269219,0,1,4
76874,2,1,269220,269220,269221,0,1,1
76875,1,1,269221,269221,269222,0,1,0
76876,4,2,269225,269225,269227,0,2,3
76877,1,2,269226,269227,269229,1,3,0
76878,1,3,269227,269229,269232,2,5,0
76879,1,3,269228,269232,269235,4,7,0
76880,4,2,269232,269235,269237,3,5,0
76881,2,3,269234,269237,269240,3,6,0
76882,4,1,269238,269240,269241,2,3,0
76883,2,1,269240,269241,269242,1,2,0
76884,3,1,269243,269243,269244,0,1,1
76885,6,2,269249,269249,269251,0,2,5
76886,3,2,269252,269252,269254,0,2,1
76887,2,3,269254,269254,269257,0,3,0
76888,3,2,269257,269257,269259,0,2,0
76889,4,3,269261,269261,269264,0,3,2
76890,5,2,269266,269266,269268,0,2,2
76891,5,1,269271,269271,269272,0,1,3
76892,1,3,269272,269272,269275,0,3,0
76893,6,1,269278,269278,269279,0,1,3
76894,1,1,269279,269279,269280,0,1,0
76895,5,1,269284,269284,269285,0,1,4
76896,2,3,269286,269286,269289,0,3,1
76897,3,3,269289,269289,269292,0,3,0
76898,2,3,269291,269292,269295,1,4,0
76899,1,3,269292,269295,269298,3,6,0
76900,4,1,269296,269298,269299,2,3,0
76901,3,2,269299,269299,269301,0,2,0
76902,4,3,269303,269303,269306,0,3,2
76903,3,1,269306,269306,269307,0,1,0
76904,1,3,269307,269307,269310,0,3,0
76905,4,3,269311,269311,269314,0,3,1
76906,4,2,269315,269315,269317,0,2,1
76907,1,1,269316,269317,269318,1,2,0
76908,6,3,269322,269322,269325,0,3,4
76909,1,3,269323,269325,269328,2,5,0
76910,5,1,269328,269328,269329,0,1,0
76911,2,1,269330,269330,269331,0,1,1
76912,5,3,269335,269335,269338,0,3,4
76913,5,1,269340,269340,269341,0,1,2
76914,4,1,269344,269344,269345,0,1,3
76915,6,2,269350,269350,269352,0,2,5
76916,6,2,269356,269356,269358,0,2,4
76917,6,3,269362,269362,269365,0,3,4
76918,1,2,269363,269365,269367,2,4,0
76919,5,3,269368,269368,269371,0,3,1
76920,3,1,269371,269371,269372,0,1,0
76921,5,3,269376,269376,269379,0,3,4
76922,1,3,269377,269379,269382,2,5,0
76923,4,2,269381,269382,269384,1,3,0
76924,2,1,269383,269384,269385,1,2,0
76925,1,1,269384,269385,269386,1,2,0
76926,4,2,269388,269388,269390,0,2,2
76927,4,3,269392,269392,269395,0,3,2
76928,1,2,269393,269395,269397,2,4,0
76929,4,3,269397,269397,269400,0,3,0
76930,4,3,269401,269401,269404,0,3,1
76931,1,1,269402,269404,269405,2,3,0
76932,1,3,269403,269405,269408,2,5,0
76933,6,3,269409,269409,269412,0,3,1
76934,5,2,269414,269414,269416,0,2,2
76935,2,1,269416,269416,269417,0,1,0
76936,4,2,269420,269420,269422,0,2,3
76937,5,1,269425,269425,269426,0,1,3
76938,5,3,269430,269430,269433,0,3,4
76939,4,3,269434,269434,269437,0,3,1
76940,5,1,269439,269439,269440,0,1,2
76941,5,2,269444,269444,269446,0,2,4
76942,3,2,269447,269447,269449,0,2,1
76943,1,1,269448,269449,269450,1,2,0
76944,6,2,269454,269454,269456,0,2,4
76945,4,1,269458,269458,269459,0,1,2
76946,3,3,269461,269461,269464,0,3,2
76947,3,3,269464,269464,269467,0,3,0
76948,6,1,269470,269470,269471,0,1,3
76949,6,3,269476,269476,269479,0,3,5
76950,1,2,269477,269479,269481,2,4,0
76951,1,3,269478,269481,269484,3,6,0
76952,2,2,269480,269484,269486,4,6,0
76953,5,2,269485,269486,269488,1,3,0
76954,1,2,269486,269488,269490,2,4,0
76955,4,1,269490,269490,269491,0,1,0
76956,2,1,269492,269492,269493,0,1,1
76957,6,3,269498,269498,269501,0,3,5
76958,6,3,269504,269504,269507,0,3,3
76959,3,2,269507,269507,269509,0,2,0
76960,2,3,269509,269509,269512,0,3,0
76961,2,2,269511,269512,269514,1,3,0
76962,2,1,269513,269514,269515,1,2,0
76963,6,3,269519,269519,269522,0,3,4
76964,5,2,269524,269524,269526,0,2,2
76965,1,2,269525,269526,269528,1,3,0
76966,6,1,269531,269531,269532,0,1,3
76967,1,1,269532,269532,269533,0,1,0
76968,1,1,269533,269533,269534,0,1,0
76969,6,2,269539,269539,269541,0,2,5
76970,1,2,269540,269541,269543,1,3,0
76971,3,1,269543,269543,269544,0,1,0
76972,4,3,269547,269547,269550,0,3,3
76973,1,3,269548,269550,269553,2,5,0
76974,1,2,269549,269553,269555,4,6,0
76975,1,1,269550,269555,269556,5,6,0
76976,2,2,269552,269556,269558,4,6,0
76977,5,3,269557,269558,269561,1,4,0
76978,5,2,269562,269562,269564,0,2,1
76979,5,3,269567,269567,269570,0,3,3
76980,6,1,269573,269573,269574,0,1,3
76981,6,1,269579,269579,269580,0,1,5
76982,6,3,269585,269585,269588,0,3,5
76983,3,2,269588,269588,269590,0,2,0
76984,4,2,269592,269592,269594,0,2,2
76985,6,3,269598,269598,269601,0,3,4
76986,6,3,269604,269604,269607,0,3,3
76987,6,3,269610,269610,269613,0,3,3
76988,6,3,269616,269616,269619,0,3,3
76989,5,2,269621,269621,269623,0,2,2
76990,2,3,269623,269623,269626,0,3,0
76991,3,3,269626,269626,269629,0,3,0
76992,6,1,269632,269632,269633,0,1,3
76993,1,3,269633,269633,269636,0,3,0
76994,3,1,269636,269636,269637,0,1,0
76995,2,3,269638,269638,269641,0,3,1
76996,1,2,269639,269641,269643,2,4,0
76997,6,2,269645,269645,269647,0,2,2
76998,5,3,269650,269650,269653,0,3,3
76999,3,3,269653,269653,269656,0,3,0
77000,4,2,269657,269657,269659,0,2,1
77001,5,1,269662,269662,269663,0,1,3
77002,6,2,269668,269668,269670,0,2,5
77003,2,3,269670,269670,269673,0,3,0
77004,1,1,269671,269673,269674,2,3,0
77005,2,3,269673,269674,269677,1,4,0
77006,3,3,269676,269677,269680,1,4,0
77007,6,1,269682,269682,269683,0,1,2
77008,4,1,269686,269686,269687,0,1,3
77009,1,3,269687,269687,269690,0,3,0
77010,3,2,269690,269690,269692,0,2,0
77011,1,1,269691,269692,269693,1,2,0
77012,6,2,269697,269697,269699,0,2,4
77013,2,3,269699,269699,269702,0,3,0
77014,4,1,269703,269703,269704,0,1,1
77015,2,2,269705,269705,269707,0,2,1
77016,4,3,269709,269709,269712,0,3,2
77017,5,1,269714,269714,269715,0,1,2
77018,3,3,269717,269717,269720,0,3,2
77019,1,2,269718,269720,269722,2,4,0
77020,4,3,269722,269722,269725,0,3,0
77021,4,1,269726,269726,269727,0,1,1
77022,1,3,269727,269727,269730,0,3,0
77023,4,3,269731,269731,269734,0,3,1
77024,4,1,269735,269735,269736,0,1,1
77025,2,1,269737,269737,269738,0,1,1
77026,5,3,269742,269742,269745,0,3,4
77027,1,1,269743,269745,269746,2,3,0
77028,2,1,269745,269746,269747,1,2,0
77029,3,2,269748,269748,269750,0,2,1
77030,4,2,269752,269752,269754,0,2,2
77031,6,2,269758,269758,269760,0,2,4
77032,5,3,269763,269763,269766,0,3,3
77033,2,3,269765,269766,269769,1,4,0
77034,1,2,269766,269769,269771,3,5,0
77035,1,1,269767,269771,269772,4,5,0
77036,2,1,269769,269772,269773,3,4,0
77037,2,1,269771,269773,269774,2,3,0
77038,1,2,269772,269774,269776,2,4,0
77039,5,3,269777,269777,269780,0,3,1
77040,3,3,269780,269780,269783,0,3,0
77041,3,2,269783,269783,269785,0,2,0
77042,4,3,269787,269787,269790,0,3,2
77043,4,3,269791,269791,269794,0,3,1
77044,2,2,269793,269794,269796,1,3,0
77045,1,2,269794,269796,269798,2,4,0
77046,2,2,269796,269798,269800,2,4,0
77047,1,2,269797,269800,269802,3,5,0
77048,1,3,269798,269802,269805,4,7,0
77049,6,2,269804,269805,269807,1,3,0
77050,4,3,269808,269808,269811,0,3,1
77051,1,1,269809,269811,269812,2,3,0
77052,4,2,269813,269813,269815,0,2,1
77053,5,3,269818,269818,269821,0,3,3
77054,1,3,269819,269821,269824,2,5,0
77055,6,1,269825,269825,269826,0,1,1
77056,5,1,269830,269830,269831,0,1,4
77057,4,3,269834,269834,269837,0,3,3
77058,1,3,269835,269837,269840,2,5,0
77059,4,1,269839,269840,269841,1,2,0
77060,5,2,269844,269844,269846,0,2,3
77061,2,2,269846,269846,269848,0,2,0
77062,4,3,269850,269850,269853,0,3,2
77063,2,2,269852,269853,269855,1,3,0
77064,3,2,269855,269855,269857,0,2,0
77065,4,3,269859,269859,269862,0,3,2
77066,4,3,269863,269863,269866,0,3,1
77067,6,1,269869,269869,269870,0,1,3
77068,2,3,269871,269871,269874,0,3,1
77069,5,2,269876,269876,269878,0,2,2
77070,5,3,269881,269881,269884,0,3,3
77071,4,1,269885,269885,269886,0,1,1
77072,2,2,269887,269887,269889,0,2,1
77073,5,3,269892,269892,269895,0,3,3
77074,4,2,269896,269896,269898,0,2,1
77075,4,2,269900,269900,269902,0,2,2
77076,1,2,269901,269902,269904,1,3,0
77077,3,2,269904,269904,269906,0,2,0
77078,6,2,269910,269910,269912,0,2,4
77079,1,2,269911,269912,269914,1,3,0
77080,4,3,269915,269915,269918,0,3,1
77081,4,1,269919,269919,269920,0,1,1
77082,6,1,269925,269925,269926,0,1,5
77083,2,2,269927,269927,269929,0,2,1
77084,6,1,269933,269933,269934,0,1,4
77085,5,2,269938,269938,269940,0,2,4
77086,4,3,269942,269942,269945,0,3,2
77087,2,1,269944,269945,269946,1,2,0
77088,3,3,269947,269947,269950,0,3,1
77089,2,2,269949,269950,269952,1,3,0
77090,2,3,269951,269952,269955,1,4,0
77091,1,2,269952,269955,269957,3,5,0
77092,1,1,269953,269957,269958,4,5,0
77093,5,1,269958,269958,269959,0,1,0
77094,1,3,269959,269959,269962,0,3,0
77095,5,2,269964,269964,269966,0,2,2
77096,4,3,269968,269968,269971,0,3,2
77097,4,1,269972,269972,269973,0,1,1
77098,4,1,269976,269976,269977,0,1,3
77099,2,1,269978,269978,269979,0,1,1
77100,4,1,269982,269982,269983,0,1,3
77101,5,3,269987,269987,269990,0,3,4
77102,5,2,269992,269992,269994,0,2,2
77103,3,2,269995,269995,269997,0,2,1
77104,4,1,269999,269999,270000,0,1,2
77105,5,2,270004,270004,270006,0,2,4
77106,1,3,270005,270006,270009,1,4,0
77107,1,1,270006,270009,270010,3,4,0
77108,5,3,270011,270011,270014,0,3,1
77109,2,1,270013,270014,270015,1,2,0
77110,4,2,270017,270017,270019,0,2,2
77111,2,2,270019,270019,270021,0,2,0
77112,1,1,270020,270021,270022,1,2,0
77113,3,3,270023,270023,270026,0,3,1
77114,4,3,270027,270027,270030,0,3,1
77115,4,3,270031,270031,270034,0,3,1
77116,2,2,270033,270034,270036,1,3,0
77117,4,2,270037,270037,270039,0,2,1
77118,5,3,270042,270042,270045,0,3,3
77119,2,2,270044,270045,270047,1,3,0
77120,6,2,270050,270050,270052,0,2,3
77121,1,3,270051,270052,270055,1,4,0
77122,5,3,270056,270056,270059,0,3,1
77123,6,2,270062,270062,270064,0,2,3
77124,4,2,270066,270066,270068,0,2,2
77125,3,2,270069,270069,270071,0,2,1
77126,2,3,270071,270071,270074,0,3,0
77127,2,1,270073,270074,270075,1,2,0
77128,6,3,270079,270079,270082,0,3,4
77129,4,2,270083,270083,270085,0,2,1
77130,2,3,270085,270085,270088,0,3,0
77131,1,3,270086,270088,270091,2,5,0
77132,3,1,270089,270091,270092,2,3,0
77133,1,2,270090,270092,270094,2,4,0
77134,6,3,270096,270096,270099,0,3,2
77135,6,3,270102,270102,270105,0,3,3
77136,5,2,270107,270107,270109,0,2,2
77137,5,1,270112,270112,270113,0,1,3
77138,4,1,270116,270116,270117,0,1,3
77139,5,1,270121,270121,270122,0,1,4
77140,2,1,270123,270123,270124,0,1,1
77141,5,1,270128,270128,270129,0,1,4
77142,3,3,270131,270131,270134,0,3,2
77143,3,1,270134,270134,270135,0,1,0
77144,6,3,270140,270140,270143,0,3,5
77145,2,1,270142,270143,270144,1,2,0
77146,1,1,270143,270144,270145,1,2,0
77147,3,3,270146,270146,270149,0,3,1
77148,6,1,270152,270152,270153,0,1,3
77149,4,2,270156,270156,270158,0,2,3
77150,6,2,270162,270162,270164,0,2,4
77151,2,1,270164,270164,270165,0,1,0
77152,4,2,270168,270168,270170,0,2,3
77153,4,1,270172,270172,270173,0,1,2
77154,2,3,270174,270174,270177,0,3,1
77155,4,2,270178,270178,270180,0,2,1
77156,4,2,270182,270182,270184,0,2,2
77157,1,3,270183,270184,270187,1,4,0
77158,5,2,270188,270188,270190,0,2,1
77159,5,2,270193,270193,270195,0,2,3
77160,3,3,270196,270196,270199,0,3,1
77161,3,2,270199,270199,270201,0,2,0
77162,4,1,270203,270203,270204,0,1,2
77163,5,1,270208,270208,270209,0,1,4
77164,3,1,270211,270211,270212,0,1,2
77165,1,1,270212,270212,270213,0,1,0
77166,2,3,270214,270214,270217,0,3,1
77167,3,2,270217,270217,270219,0,2,0
77168,5,2,270222,270222,270224,0,2,3
77169,1,2,270223,270224,270226,1,3,0
77170,6,3,270229,270229,270232,0,3,3
77171,4,2,270233,270233,270235,0,2,1
77172,6,1,270239,270239,270240,0,1,4
77173,5,1,270244,270244,270245,0,1,4
77174,5,1,270249,270249,270250,0,1,4
77175,1,3,270250,270250,270253,0,3,0
77176,6,1,270256,270256,270257,0,1,3
77177,4,2,270260,270260,270262,0,2,3
77178,2,2,270262,270262,270264,0,2,0
77179,1,3,270263,270264,270267,1,4,0
77180,1,2,270264,270267,270269,3,5,0
77181,3,1,270267,270269,270270,2,3,0
77182,3,1,270270,270270,270271,0,1,0
77183,5,1,270275,270275,270276,0,1,4
77184,3,3,270278,270278,270281,0,3,2
77185,2,1,270280,270281,270282,1,2,0
77186,4,1,270284,270284,270285,0,1,2
77187,3,3,270287,270287,270290,0,3,2
77188,5,2,270292,270292,270294,0,2,2
77189,1,1,270293,270294,270295,1,2,0
77190,5,3,270298,270298,270301,0,3,3
77191,3,1,270301,270301,270302,0,1,0
77192,5,3,270306,270306,270309,0,3,4
77193,3,1,270309,270309,270310,0,1,0
77194,5,2,270314,270314,270316,0,2,4
77195,1,2,270315,270316,270318,1,3,0
77196,4,1,270319,270319,270320,0,1,1
77197,4,1,270323,270323,270324,0,1,3
77198,1,1,270324,270324,270325,0,1,0
77199,6,1,270330,270330,270331,0,1,5
77200,4,1,270334,270334,270335,0,1,3
77201,3,1,270337,270337,270338,0,1,2
77202,5,2,270342,270342,270344,0,2,4
77203,4,1,270346,270346,270347,0,1,2
77204,3,3,270349,270349,270352,0,3,2
77205,1,1,270350,270352,270353,2,3,0
77206,6,2,270356,270356,270358,0,2,3
77207,2,1,270358,270358,270359,0,1,0
77208,6,3,270364,270364,270367,0,3,5
77209,2,1,270366,270367,270368,1,2,0
77210,3,1,270369,270369,270370,0,1,1
77211,5,2,270374,270374,270376,0,2,4
77212,6,3,270380,270380,270383,0,3,4
77213,2,3,270382,270383,270386,1,4,0
77214,2,2,270384,270386,270388,2,4,0
77215,4,3,270388,270388,270391,0,3,0
77216,6,2,270394,270394,270396,0,2,3
77217,3,2,270397,270397,270399,0,2,1
77218,1,3,270398,270399,270402,1,4,0
77219,6,2,270404,270404,270406,0,2,2
77220,1,2,270405,270406,270408,1,3,0
77221,2,1,270407,270408,270409,1,2,0
77222,3,2,270410,270410,270412,0,2,1
77223,6,1,270416,270416,270417,0,1,4
77224,2,3,270418,270418,270421,0,3,1
77225,1,2,270419,270421,270423,2,4,0
77226,5,1,270424,270424,270425,0,1,1
77227,5,3,270429,270429,270432,0,3,4
77228,1,3,270430,270432,270435,2,5,0
77229,4,1,270434,270435,270436,1,2,0
77230,1,1,270435,270436,270437,1,2,0
77231,1,3,270436,270437,270440,1,4,0
77232,4,2,270440,270440,270442,0,2,0
77233,1,1,270441,270442,270443,1,2,0
77234,1,2,270442,270443,270445,1,3,0
77235,2,2,270444,270445,270447,1,3,0
77236,3,3,270447,270447,270450,0,3,0
77237,2,2,270449,270450,270452,1,3,0
77238,2,2,270451,270452,270454,1,3,0
77239,4,3,270455,270455,270458,0,3,1
77240,5,2,270460,270460,270462,0,2,2
77241,2,1,270462,270462,270463,0,1,0
77242,5,3,270467,270467,270470,0,3,4
77243,2,1,270469,270470,270471,1,2,0
77244,3,1,270472,270472,270473,0,1,1
77245,2,1,270474,270474,270475,0,1,1
77246,2,3,270476,270476,270479,0,3,1
77247,2,2,270478,270479,270481,1,3,0
77248,4,2,270482,270482,270484,0,2,1
77249,5,2,270487,270487,270489,0,2,3
77250,1,1,270488,270489,270490,1,2,0
77251,3,2,270491,270491,270493,0,2,1
77252,1,2,270492,270493,270495,1,3,0
77253,1,1,270493,270495,270496,2,3,0
77254,3,3,270496,270496,270499,0,3,0
77255,2,3,270498,270499,270502,1,4,0
77256,3,1,270501,270502,270503,1,2,0
77257,2,3,270503,270503,270506,0,3,0
77258,1,2,270504,270506,270508,2,4,0
77259,3,2,270507,270508,270510,1,3,0
77260,2,2,270509,270510,270512,1,3,0
77261,2,3,270511,270512,270515,1,4,0
77262,5,2,270516,270516,270518,0,2,1
77263,6,2,270522,270522,270524,0,2,4
77264,2,2,270524,270524,270526,0,2,0
77265,4,2,270528,270528,270530,0,2,2
77266,3,1,270531,270531,270532,0,1,1
77267,5,3,270536,270536,270539,0,3,4
77268,4,2,270540,270540,270542,0,2,1
77269,1,3,270541,270542,270545,1,4,0
77270,5,2,270546,270546,270548,0,2,1
77271,3,3,270549,270549,270552,0,3,1
77272,2,3,270551,270552,270555,1,4,0
77273,1,1,270552,270555,270556,3,4,0
77274,5,2,270557,270557,270559,0,2,1
77275,5,2,270562,270562,270564,0,2,3
77276,2,1,270564,270564,270565,0,1,0
77277,1,3,270565,270565,270568,0,3,0
77278,2,3,270567,270568,270571,1,4,0
77279,1,2,270568,270571,270573,3,5,0
77280,3,2,270571,270573,270575,2,4,0
77281,2,1,270573,270575,270576,2,3,0
77282,2,3,270575,270576,270579,1,4,0
77283,2,3,270577,270579,270582,2,5,0
77284,2,1,270579,270582,270583,3,4,0
77285,6,3,270585,270585,270588,0,3,2
77286,2,1,270587,270588,270589,1,2,0
77287,2,2,270589,270589,270591,0,2,0
77288,2,2,270591,270591,270593,0,2,0
77289,1,1,270592,270593,270594,1,2,0
77290,3,3,270595,270595,270598,0,3,1
77291,3,1,270598,270598,270599,0,1,0
77292,1,2,270599,270599,270601,0,2,0
77293,5,2,270604,270604,270606,0,2,3
77294,3,2,270607,270607,270609,0,2,1
77295,1,3,270608,270609,270612,1,4,0
77296,3,1,270611,270612,270613,1,2,0
77297,6,1,270617,270617,270618,0,1,4
77298,3,1,270620,270620,270621,0,1,2
77299,4,2,270624,270624,270626,0,2,3
77300,2,2,270626,270626,270628,0,2,0
77301,4,3,270630,270630,270633,0,3,2
77302,5,1,270635,270635,270636,0,1,2
77303,6,2,270641,270641,270643,0,2,5
77304,3,1,270644,270644,270645,0,1,1
77305,2,1,270646,270646,270647,0,1,1
77306,2,1,270648,270648,270649,0,1,1
77307,5,1,270653,270653,270654,0,1,4
77308,5,3,270658,270658,270661,0,3,4
77309,1,2,270659,270661,270663,2,4,0
77310,4,3,270663,270663,270666,0,3,0
77311,4,2,270667,270667,270669,0,2,1
77312,5,2,270672,270672,270674,0,2,3
77313,2,2,270674,270674,270676,0,2,0
77314,6,3,270680,270680,270683,0,3,4
77315,2,2,270682,270683,270685,1,3,0
77316,1,2,270683,270685,270687,2,4,0
77317,4,2,270687,270687,270689,0,2,0
77318,1,3,270688,270689,270692,1,4,0
77319,4,2,270692,270692,270694,0,2,0
77320,3,3,270695,270695,270698,0,3,1
77321,6,1,270701,270701,270702,0,1,3
77322,4,2,270705,270705,270707,0,2,3
77323,3,1,270708,270708,270709,0,1,1
77324,2,3,270710,270710,270713,0,3,1
77325,3,1,270713,270713,270714,0,1,0
77326,4,2,270717,270717,270719,0,2,3
77327,3,2,270720,270720,270722,0,2,1
77328,5,2,270725,270725,270727,0,2,3
77329,2,3,270727,270727,270730,0,3,0
77330,6,1,270733,270733,270734,0,1,3
77331,4,3,270737,270737,270740,0,3,3
77332,3,1,270740,270740,270741,0,1,0
77333,6,1,270746,270746,270747,0,1,5
77334,5,1,270751,270751,270752,0,1,4
77335,4,3,270755,270755,270758,0,3,3
77336,3,1,270758,270758,270759,0,1,0
77337,3,1,270761,270761,270762,0,1,2
77338,4,1,270765,270765,270766,0,1,3
77339,1,3,270766,270766,270769,0,3,0
77340,5,2,270771,270771,270773,0,2,2
77341,1,2,270772,270773,270775,1,3,0
77342,3,2,270775,270775,270777,0,2,0
77343,5,3,270780,270780,270783,0,3,3
77344,2,3,270782,270783,270786,1,4,0
77345,3,2,270785,270786,270788,1,3,0
77346,6,3,270791,270791,270794,0,3,3
77347,3,3,270794,270794,270797,0,3,0
77348,4,2,270798,270798,270800,0,2,1
77349,4,3,270802,270802,270805,0,3,2
77350,6,3,270808,270808,270811,0,3,3
77351,4,3,270812,270812,270815,0,3,1
77352,3,2,270815,270815,270817,0,2,0
77353,2,2,270817,270817,270819,0,2,0
77354,3,1,270820,270820,270821,0,1,1
77355,5,2,270825,270825,270827,0,2,4
77356,2,2,270827,270827,270829,0,2,0
77357,2,1,270829,270829,270830,0,1,0
77358,1,3,270830,270830,270833,0,3,0
77359,2,2,270832,270833,270835,1,3,0
77360,5,2,270837,270837,270839,0,2,2
77361,5,1,270842,270842,270843,0,1,3
77362,1,2,270843,270843,270845,0,2,0
77363,6,2,270849,270849,270851,0,2,4
77364,6,1,270855,270855,270856,0,1,4
77365,5,2,270860,270860,270862,0,2,4
77366,2,3,270862,270862,270865,0,3,0
77367,4,2,270866,270866,270868,0,2,1
77368,4,3,270870,270870,270873,0,3,2
77369,1,3,270871,270873,270876,2,5,0
77370,6,1,270877,270877,270878,0,1,1
77371,1,3,270878,270878,270881,0,3,0
77372,4,3,270882,270882,270885,0,3,1
77373,3,2,270885,270885,270887,0,2,0
77374,4,2,270889,270889,270891,0,2,2
77375,1,2,270890,270891,270893,1,3,0
77376,4,3,270894,270894,270897,0,3,1
77377,5,1,270899,270899,270900,0,1,2
77378,2,1,270901,270901,270902,0,1,1
77379,2,1,270903,270903,270904,0,1,1
77380,4,2,270907,270907,270909,0,2,3
77381,5,2,270912,270912,270914,0,2,3
77382,3,1,270915,270915,270916,0,1,1
77383,3,3,270918,270918,270921,0,3,2
77384,5,3,270923,270923,270926,0,3,2
77385,2,3,270925,270926,270929,1,4,0
77386,3,3,270928,270929,270932,1,4,0
77387,4,3,270932,270932,270935,0,3,0
77388,1,1,270933,270935,270936,2,3,0
77389,6,1,270939,270939,270940,0,1,3
77390,2,2,270941,270941,270943,0,2,1
77391,2,2,270943,270943,270945,0,2,0
77392,1,2,270944,270945,270947,1,3,0
77393,3,3,270947,270947,270950,0,3,0
77394,1,2,270948,270950,270952,2,4,0
77395,6,3,270954,270954,270957,0,3,2
77396,6,2,270960,270960,270962,0,2,3
77397,4,2,270964,270964,270966,0,2,2
77398,4,1,270968,270968,270969,0,1,2
77399,3,1,270971,270971,270972,0,1,2
77400,6,1,270977,270977,270978,0,1,5
77401,2,1,270979,270979,270980,0,1,1
77402,2,2,270981,270981,270983,0,2,1
77403,1,3,270982,270983,270986,1,4,0
77404,3,3,270985,270986,270989,1,4,0
77405,5,1,270990,270990,270991,0,1,1
77406,1,1,270991,270991,270992,0,1,0
77407,1,1,270992,270992,270993,0,1,0
77408,2,2,270994,270994,270996,0,2,1
77409,3,3,270997,270997,271000,0,3,1
77410,1,3,270998,271000,271003,2,5,0
77411,3,3,271001,271003,271006,2,5,0
77412,6,2,271007,271007,271009,0,2,1
77413,5,1,271012,271012,271013,0,1,3
77414,4,2,271016,271016,271018,0,2,3
77415,6,2,271022,271022,271024,0,2,4
77416,2,1,271024,271024,271025,0,1,0
77417,2,2,271026,271026,271028,0,2,1
77418,5,3,271031,271031,271034,0,3,3
77419,3,2,271034,271034,271036,0,2,0
77420,4,1,271038,271038,271039,0,1,2
77421,1,1,271039,271039,271040,0,1,0
77422,6,2,271045,271045,271047,0,2,5
77423,4,2,271049,271049,271051,0,2,2
77424,3,3,271052,271052,271055,0,3,1
77425,3,2,271055,271055,271057,0,2,0
77426,2,1,271057,271057,271058,0,1,0
77427,3,1,271060,271060,271061,0,1,2
77428,2,2,271062,271062,271064,0,2,1
77429,2,2,271064,271064,271066,0,2,0
77430,6,3,271070,271070,271073,0,3,4
77431,3,3,271073,271073,271076,0,3,0
77432,5,1,271078,271078,271079,0,1,2
77433,5,1,271083,271083,271084,0,1,4
77434,5,1,271088,271088,271089,0,1,4
77435,2,1,271090,271090,271091,0,1,1
77436,2,1,271092,271092,271093,0,1,1
77437,1,2,271093,271093,271095,0,2,0
77438,4,2,271097,271097,271099,0,2,2
77439,4,3,271101,271101,271104,0,3,2
77440,2,3,271103,271104,271107,1,4,0
77441,3,2,271106,271107,271109,1,3,0
77442,4,1,271110,271110,271111,0,1,1
77443,5,1,271115,271115,271116,0,1,4
77444,5,3,271120,271120,271123,0,3,4
77445,3,3,271123,271123,271126,0,3,0
77446,6,3,271129,271129,271132,0,3,3
77447,6,3,271135,271135,271138,0,3,3
77448,2,1,271137,271138,271139,1,2,0
77449,2,1,271139,271139,271140,0,1,0
77450,2,3,271141,271141,271144,0,3,1
77451,2,3,271143,271144,271147,1,4,0
77452,4,1,271147,271147,271148,0,1,0
77453,1,1,271148,271148,271149,0,1,0
77454,3,2,271151,271151,271153,0,2,2
77455,1,2,271152,271153,271155,1,3,0
77456,1,2,271153,271155,271157,2,4,0
77457,3,3,271156,271157,271160,1,4,0
77458,6,2,271162,271162,271164,0,2,2
77459,2,1,271164,271164,271165,0,1,0
77460,2,2,271166,271166,271168,0,2,1
77461,5,3,271171,271171,271174,0,3,3
77462,1,3,271172,271174,271177,2,5,0
77463,2,3,271174,271177,271180,3,6,0
77464,3,2,271177,271180,271182,3,5,0
77465,1,2,271178,271182,271184,4,6,0
77466,4,2,271182,271184,271186,2,4,0
77467,4,2,271186,271186,271188,0,2,0
77468,2,3,271188,271188,271191,0,3,0
77469,2,3,271190,271191,271194,1,4,0
77470,3,2,271193,271194,271196,1,3,0
77471,2,1,271195,271196,271197,1,2,0
77472,4,3,271199,271199,271202,0,3,2
77473,4,2,271203,271203,271205,0,2,1
77474,5,1,271208,271208,271209,0,1,3
77475,5,1,271213,271213,271214,0,1,4
77476,6,2,271219,271219,271221,0,2,5
77477,5,3,271224,271224,271227,0,3,3
77478,1,3,271225,271227,271230,2,5,0
77479,1,2,271226,271230,271232,4,6,0
77480,5,2,271231,271232,271234,1,3,0
77481,4,2,271235,271235,271237,0,2,1
77482,1,2,271236,271237,271239,1,3,0
77483,3,2,271239,271239,271241,0,2,0
77484,3,1,271242,271242,271243,0,1,1
77485,3,1,271245,271245,271246,0,1,2
77486,2,2,271247,271247,271249,0,2,1
77487,4,3,271251,271251,271254,0,3,2
77488,6,2,271257,271257,271259,0,2,3
77489,4,1,271261,271261,271262,0,1,2
77490,4,2,271265,271265,271267,0,2,3
77491,1,1,271266,271267,271268,1,2,0
77492,3,2,271269,271269,271271,0,2,1
77493,4,1,271273,271273,271274,0,1,2
77494,3,3,271276,271276,271279,0,3,2
77495,3,3,271279,271279,271282,0,3,0
77496,1,2,271280,271282,271284,2,4,0
77497,3,2,271283,271284,271286,1,3,0
77498,6,1,271289,271289,271290,0,1,3
77499,6,3,271295,271295,271298,0,3,5
77500,3,3,271298,271298,271301,0,3,0
77501,2,2,271300,271301,271303,1,3,0
77502,5,1,271305,271305,271306,0,1,2
77503,4,1,271309,271309,271310,0,1,3
77504,6,1,271315,271315,271316,0,1,5
77505,2,3,271317,271317,271320,0,3,1
77506,4,2,271321,271321,271323,0,2,1
77507,4,3,271325,271325,271328,0,3,2
77508,1,1,271326,271328,271329,2,3,0
77509,6,1,271332,271332,271333,0,1,3
77510,1,3,271333,271333,271336,0,3,0
77511,5,2,271338,271338,271340,0,2,2
77512,2,3,271340,271340,271343,0,3,0
77513,1,2,271341,271343,271345,2,4,0
77514,4,3,271345,271345,271348,0,3,0
77515,1,2,271346,271348,271350,2,4,0
77516,1,3,271347,271350,271353,3,6,0
77517,6,3,271353,271353,271356,0,3,0
77518,3,3,271356,271356,271359,0,3,0
77519,5,2,271361,271361,271363,0,2,2
77520,5,3,271366,271366,271369,0,3,3
77521,4,2,271370,271370,271372,0,2,1
77522,5,1,271375,271375,271376,0,1,3
77523,5,3,271380,271380,271383,0,3,4
77524,3,2,271383,271383,271385,0,2,0
77525,3,3,271386,271386,271389,0,3,1
77526,4,1,271390,271390,271391,0,1,1
77527,3,2,271393,271393,271395,0,2,2
77528,3,1,271396,271396,271397,0,1,1
77529,5,2,271401,271401,271403,0,2,4
77530,3,3,271404,271404,271407,0,3,1
77531,2,3,271406,271407,271410,1,4,0
77532,6,3,271412,271412,271415,0,3,2
77533,2,3,271414,271415,271418,1,4,0
77534,3,3,271417,271418,271421,1,4,0
77535,4,3,271421,271421,271424,0,3,0
77536,4,2,271425,271425,271427,0,2,1
77537,4,3,271429,271429,271432,0,3,2
77538,4,2,271433,271433,271435,0,2,1
77539,2,3,271435,271435,271438,0,3,0
77540,3,2,271438,271438,271440,0,2,0
77541,5,1,271443,271443,271444,0,1,3
77542,3,3,271446,271446,271449,0,3,2
77543,4,1,271450,271450,271451,0,1,1
77544,4,3,271454,271454,271457,0,3,3
77545,1,3,271455,271457,271460,2,5,0
77546,3,3,271458,271460,271463,2,5,0
77547,3,3,271461,271463,271466,2,5,0
77548,6,3,271467,271467,271470,0,3,1
77549,4,1,271471,271471,271472,0,1,1
77550,6,3,271477,271477,271480,0,3,5
77551,2,1,271479,271480,271481,1,2,0
77552,1,2,271480,271481,271483,1,3,0
77553,6,2,271486,271486,271488,0,2,3
77554,1,2,271487,271488,271490,1,3,0
77555,6,1,271493,271493,271494,0,1,3
77556,5,2,271498,271498,271500,0,2,4
77557,5,2,271503,271503,271505,0,2,3
77558,6,1,271509,271509,271510,0,1,4
77559,3,2,271512,271512,271514,0,2,2
77560,4,1,271516,271516,271517,0,1,2
77561,5,2,271521,271521,271523,0,2,4
77562,3,1,271524,271524,271525,0,1,1
77563,5,1,271529,271529,271530,0,1,4
77564,6,3,271535,271535,271538,0,3,5
77565,6,3,271541,271541,271544,0,3,3
77566,2,2,271543,271544,271546,1,3,0
77567,2,3,271545,271546,271549,1,4,0
77568,3,3,271548,271549,271552,1,4,0
77569,1,2,271549,271552,271554,3,5,0
77570,5,2,271554,271554,271556,0,2,0
77571,6,1,271560,271560,271561,0,1,4
77572,1,1,271561,271561,271562,0,1,0
77573,3,3,271564,271564,271567,0,3,2
77574,2,3,271566,271567,271570,1,4,0
77575,5,1,271571,271571,271572,0,1,1
77576,4,2,271575,271575,271577,0,2,3
77577,3,3,271578,271578,271581,0,3,1
77578,2,1,271580,271581,271582,1,2,0
77579,5,3,271585,271585,271588,0,3,3
77580,2,2,271587,271588,271590,1,3,0
77581,2,3,271589,271590,271593,1,4,0
77582,6,2,271595,271595,271597,0,2,2
77583,5,1,271600,271600,271601,0,1,3
77584,4,2,271604,271604,271606,0,2,3
77585,5,3,271609,271609,271612,0,3,3
77586,3,1,271612,271612,271613,0,1,0
77587,6,3,271618,271618,271621,0,3,5
77588,1,3,271619,271621,271624,2,5,0
77589,2,3,271621,271624,271627,3,6,0
77590,1,3,271622,271627,271630,5,8,0
77591,2,1,271624,271630,271631,6,7,0
77592,6,3,271630,271631,271634,1,4,0
77593,4,3,271634,271634,271637,0,3,0
77594,3,3,271637,271637,271640,0,3,0
77595,2,2,271639,271640,271642,1,3,0
77596,5,1,271644,271644,271645,0,1,2
77597,2,2,271646,271646,271648,0,2,1
77598,4,3,271650,271650,271653,0,3,2
77599,6,1,271656,271656,271657,0,1,3
77600,6,3,271662,271662,271665,0,3,5
77601,4,3,271666,271666,271669,0,3,1
77602,2,2,271668,271669,271671,1,3,0
77603,1,1,271669,271671,271672,2,3,0
77604,5,2,271674,271674,271676,0,2,2
77605,1,2,271675,271676,271678,1,3,0
77606,4,3,271679,271679,271682,0,3,1
77607,6,1,271685,271685,271686,0,1,3
77608,5,3,271690,271690,271693,0,3,4
77609,3,1,271693,271693,271694,0,1,0
77610,3,3,271696,271696,271699,0,3,2
77611,1,2,271697,271699,271701,2,4,0
77612,4,2,271701,271701,271703,0,2,0
77613,6,2,271707,271707,271709,0,2,4
77614,6,3,271713,271713,271716,0,3,4
77615,1,2,271714,271716,271718,2,4,0
77616,6,1,271720,271720,271721,0,1,2
77617,1,3,271721,271721,271724,0,3,0
77618,4,3,271725,271725,271728,0,3,1
77619,2,3,271727,271728,271731,1,4,0
77620,3,1,271730,271731,271732,1,2,0
77621,3,2,271733,271733,271735,0,2,1
77622,3,2,271736,271736,271738,0,2,1
77623,5,2,271741,271741,271743,0,2,3
77624,5,1,271746,271746,271747,0,1,3
77625,6,1,271752,271752,271753,0,1,5
77626,5,3,271757,271757,271760,0,3,4
77627,6,1,271763,271763,271764,0,1,3
77628,2,1,271765,271765,271766,0,1,1
77629,5,1,271770,271770,271771,0,1,4
77630,6,1,271776,271776,271777,0,1,5
77631,4,3,271780,271780,271783,0,3,3
77632,5,1,271785,271785,271786,0,1,2
77633,1,3,271786,271786,271789,0,3,0
77634,4,2,271790,271790,271792,0,2,1
77635,4,1,271794,271794,271795,0,1,2
77636,6,2,271800,271800,271802,0,2,5
77637,2,2,271802,271802,271804,0,2,0
77638,5,1,271807,271807,271808,0,1,3
77639,5,2,271812,271812,271814,0,2,4
77640,2,3,271814,271814,271817,0,3,0
77641,2,1,271816,271817,271818,1,2,0
77642,1,2,271817,271818,271820,1,3,0
77643,2,1,271819,271820,271821,1,2,0
77644,5,3,271824,271824,271827,0,3,3
77645,1,3,271825,271827,271830,2,5,0
77646,1,2,271826,271830,271832,4,6,0
77647,4,3,271830,271832,271835,2,5,0
77648,4,2,271834,271835,271837,1,3,0
77649,6,1,271840,271840,271841,0,1,3
77650,2,1,271842,271842,271843,0,1,1
77651,2,3,271844,271844,271847,0,3,1
77652,2,3,271846,271847,271850,1,4,0
77653,1,1,271847,271850,271851,3,4,0
77654,4,3,271851,271851,271854,0,3,0
77655,3,1,271854,271854,271855,0,1,0
77656,3,1,271857,271857,271858,0,1,2
77657,4,2,271861,271861,271863,0,2,3
77658,5,2,271866,271866,271868,0,2,3
77659,5,3,271871,271871,271874,0,3,3
77660,6,3,271877,271877,271880,0,3,3
77661,2,3,271879,271880,271883,1,4,0
77662,2,2,271881,271883,271885,2,4,0
77663,3,2,271884,271885,271887,1,3,0
77664,2,2,271886,271887,271889,1,3,0
77665,5,1,271891,271891,271892,0,1,2
77666,1,3,271892,271892,271895,0,3,0
77667,2,1,271894,271895,271896,1,2,0
77668,1,1,271895,271896,271897,1,2,0
77669,3,2,271898,271898,271900,0,2,1
77670,4,2,271902,271902,271904,0,2,2
77671,4,2,271906,271906,271908,0,2,2
77672,1,2,271907,271908,271910,1,3,0
77673,2,1,271909,271910,271911,1,2,0
77674,3,1,271912,271912,271913,0,1,1
77675,1,2,271913,271913,271915,0,2,0
77676,6,2,271919,271919,271921,0,2,4
77677,3,1,271922,271922,271923,0,1,1
77678,6,1,271928,271928,271929,0,1,5
77679,3,1,271931,271931,271932,0,1,2
77680,6,3,271937,271937,271940,0,3,5
77681,4,1,271941,271941,271942,0,1,1
77682,5,2,271946,271946,271948,0,2,4
77683,3,1,271949,271949,271950,0,1,1
77684,3,2,271952,271952,271954,0,2,2
77685,1,3,271953,271954,271957,1,4,0
77686,3,3,271956,271957,271960,1,4,0
77687,2,3,271958,271960,271963,2,5,0
77688,1,2,271959,271963,271965,4,6,0
77689,6,3,271965,271965,271968,0,3,0
77690,1,1,271966,271968,271969,2,3,0
77691,1,3,271967,271969,271972,2,5,0
77692,5,1,271972,271972,271973,0,1,0
77693,5,1,271977,271977,271978,0,1,4
77694,2,1,271979,271979,271980,0,1,1
77695,5,2,271984,271984,271986,0,2,4
77696,1,3,271985,271986,271989,1,4,0
77697,5,2,271990,271990,271992,0,2,1
77698,1,2,271991,271992,271994,1,3,0
77699,1,3,271992,271994,271997,2,5,0
77700,1,2,271993,271997,271999,4,6,0
77701,6,2,271999,271999,272001,0,2,0
77702,3,3,272002,272002,272005,0,3,1
77703,5,1,272007,272007,272008,0,1,2
77704,2,1,272009,272009,272010,0,1,1
77705,6,3,272015,272015,272018,0,3,5
77706,5,1,272020,272020,272021,0,1,2
77707,1,2,272021,272021,272023,0,2,0
77708,4,1,272025,272025,272026,0,1,2
77709,2,2,272027,272027,272029,0,2,1
77710,6,2,272033,272033,272035,0,2,4
77711,4,2,272037,272037,272039,0,2,2
77712,2,2,272039,272039,272041,0,2,0
77713,4,2,272043,272043,272045,0,2,2
77714,2,2,272045,272045,272047,0,2,0
77715,1,3,272046,272047,272050,1,4,0
77716,6,3,272052,272052,272055,0,3,2
77717,1,3,272053,272055,272058,2,5,0
77718,1,2,272054,272058,272060,4,6,0
77719,5,3,272059,272060,272063,1,4,0
77720,2,1,272061,272063,272064,2,3,0
77721,2,2,272063,272064,272066,1,3,0
77722,1,2,272064,272066,272068,2,4,0
77723,5,2,272069,272069,272071,0,2,1
77724,6,1,272075,272075,272076,0,1,4
77725,4,1,272079,272079,272080,0,1,3
77726,5,2,272084,272084,272086,0,2,4
77727,4,2,272088,272088,272090,0,2,2
77728,3,2,272091,272091,272093,0,2,1
77729,4,3,272095,272095,272098,0,3,2
77730,5,2,272100,272100,272102,0,2,2
77731,2,1,272102,272102,272103,0,1,0
77732,5,3,272107,272107,272110,0,3,4
77733,2,3,272109,272110,272113,1,4,0
77734,2,1,272111,272113,272114,2,3,0
77735,1,1,272112,272114,272115,2,3,0
77736,6,2,272118,272118,272120,0,2,3
77737,2,3,272120,272120,272123,0,3,0
77738,5,2,272125,272125,272127,0,2,2
77739,2,1,272127,272127,272128,0,1,0
77740,3,1,272130,272130,272131,0,1,2
77741,5,1,272135,272135,272136,0,1,4
77742,1,1,272136,272136,272137,0,1,0
77743,4,3,272140,272140,272143,0,3,3
77744,5,1,272145,272145,272146,0,1,2
77745,6,1,272151,272151,272152,0,1,5
77746,1,3,272152,272152,272155,0,3,0
77747,1,1,272153,272155,272156,2,3,0
77748,2,1,272155,272156,272157,1,2,0
77749,4,2,272159,272159,272161,0,2,2
77750,1,2,272160,272161,272163,1,3,0
77751,5,3,272165,272165,272168,0,3,2
77752,4,2,272169,272169,272171,0,2,1
77753,5,3,272174,272174,272177,0,3,3
77754,4,3,272178,272178,272181,0,3,1
77755,5,3,272183,272183,272186,0,3,2
77756,3,3,272186,272186,272189,0,3,0
77757,3,2,272189,272189,272191,0,2,0
77758,5,1,272194,272194,272195,0,1,3
77759,5,2,272199,272199,272201,0,2,4
77760,4,2,272203,272203,272205,0,2,2
77761,3,3,272206,272206,272209,0,3,1
77762,5,3,272211,272211,272214,0,3,2
77763,4,2,272215,272215,272217,0,2,1
77764,1,1,272216,272217,272218,1,2,0
77765,6,1,272222,272222,272223,0,1,4
77766,6,2,272228,272228,272230,0,2,5
77767,3,2,272231,272231,272233,0,2,1
77768,6,3,272237,272237,272240,0,3,4
77769,3,1,272240,272240,272241,0,1,0
77770,5,1,272245,272245,272246,0,1,4
77771,1,2,272246,272246,272248,0,2,0
77772,5,2,272251,272251,272253,0,2,3
77773,2,3,272253,272253,272256,0,3,0
77774,3,3,272256,272256,272259,0,3,0
77775,6,1,272262,272262,272263,0,1,3
77776,1,1,272263,272263,272264,0,1,0
77777,2,3,272265,272265,272268,0,3,1
77778,1,3,272266,272268,272271,2,5,0
77779,1,2,272267,272271,272273,4,6,0
77780,1,1,272268,272273,272274,5,6,0
77781,6,3,272274,272274,272277,0,3,0
77782,6,1,272280,272280,272281,0,1,3
77783,5,2,272285,272285,272287,0,2,4
77784,5,2,272290,272290,272292,0,2,3
77785,6,1,272296,272296,272297,0,1,4
77786,6,3,272302,272302,272305,0,3,5
77787,3,2,272305,272305,272307,0,2,0
77788,6,3,272311,272311,272314,0,3,4
77789,4,3,272315,272315,272318,0,3,1
77790,3,1,272318,272318,272319,0,1,0
77791,3,1,272321,272321,272322,0,1,2
77792,5,3,272326,272326,272329,0,3,4
77793,2,1,272328,272329,272330,1,2,0
77794,2,3,272330,272330,272333,0,3,0
77795,1,1,272331,272333,272334,2,3,0
77796,5,2,272336,272336,272338,0,2,2
77797,5,1,272341,272341,272342,0,1,3
77798,2,2,272343,272343,272345,0,2,1
77799,1,1,272344,272345,272346,1,2,0
77800,3,2,272347,272347,272349,0,2,1
77801,3,3,272350,272350,272353,0,3,1
77802,6,1,272356,272356,272357,0,1,3
77803,4,1,272360,272360,272361,0,1,3
77804,3,3,272363,272363,272366,0,3,2
77805,6,1,272369,272369,272370,0,1,3
77806,4,3,272373,272373,272376,0,3,3
77807,5,3,272378,272378,272381,0,3,2
77808,5,1,272383,272383,272384,0,1,2
77809,4,3,272387,272387,272390,0,3,3
77810,3,1,272390,272390,272391,0,1,0
77811,5,2,272395,272395,272397,0,2,4
77812,5,1,272400,272400,272401,0,1,3
77813,6,1,272406,272406,272407,0,1,5
77814,2,3,272408,272408,272411,0,3,1
77815,4,3,272412,272412,272415,0,3,1
77816,5,1,272417,272417,272418,0,1,2
77817,1,2,272418,272418,272420,0,2,0
77818,5,1,272423,272423,272424,0,1,3
77819,2,2,272425,272425,272427,0,2,1
77820,1,2,272426,272427,272429,1,3,0
77821,2,2,272428,272429,272431,1,3,0
77822,4,3,272432,272432,272435,0,3,1
77823,1,1,272433,272435,272436,2,3,0
77824,3,2,272436,272436,272438,0,2,0
77825,6,3,272442,272442,272445,0,3,4
77826,3,1,272445,272445,272446,0,1,0
77827,4,2,272449,272449,272451,0,2,3
77828,4,2,272453,272453,272455,0,2,2
77829,3,2,272456,272456,272458,0,2,1
77830,6,2,272462,272462,272464,0,2,4
77831,1,3,272463,272464,272467,1,4,0
77832,6,3,272469,272469,272472,0,3,2
77833,5,3,272474,272474,272477,0,3,2
77834,3,3,272477,272477,272480,0,3,0
77835,3,3,272480,272480,272483,0,3,0
77836,3,2,272483,272483,272485,0,2,0
77837,2,2,272485,272485,272487,0,2,0
77838,6,1,272491,272491,272492,0,1,4
77839,3,2,272494,272494,272496,0,2,2
77840,2,3,272496,272496,272499,0,3,0
77841,6,1,272502,272502,272503,0,1,3
77842,5,2,272507,272507,272509,0,2,4
77843,1,2,272508,272509,272511,1,3,0
77844,2,3,272510,272511,272514,1,4,0
77845,6,1,272516,272516,272517,0,1,2
77846,4,2,272520,272520,272522,0,2,3
77847,5,2,272525,272525,272527,0,2,3
77848,6,3,272531,272531,272534,0,3,4
77849,5,1,272536,272536,272537,0,1,2
77850,6,1,272542,272542,272543,0,1,5
77851,3,2,272545,272545,272547,0,2,2
77852,1,1,272546,272547,272548,1,2,0
77853,3,1,272549,272549,272550,0,1,1
77854,6,2,272555,272555,272557,0,2,5
77855,4,3,272559,272559,272562,0,3,2
77856,6,1,272565,272565,272566,0,1,3
77857,6,2,272571,272571,272573,0,2,5
77858,2,1,272573,272573,272574,0,1,0
77859,1,3,272574,272574,272577,0,3,0
77860,6,1,272580,272580,272581,0,1,3
77861,5,3,272585,272585,272588,0,3,4
77862,6,1,272591,272591,272592,0,1,3
77863,6,1,272597,272597,272598,0,1,5
77864,3,2,272600,272600,272602,0,2,2
77865,1,1,272601,272602,272603,1,2,0
77866,2,3,272603,272603,272606,0,3,0
77867,4,3,272607,272607,272610,0,3,1
77868,4,2,272611,272611,272613,0,2,1
77869,6,1,272617,272617,272618,0,1,4
77870,4,1,272621,272621,272622,0,1,3
77871,3,2,272624,272624,272626,0,2,2
77872,4,1,272628,272628,272629,0,1,2
77873,6,1,272634,272634,272635,0,1,5
77874,1,2,272635,272635,272637,0,2,0
77875,6,2,272641,272641,272643,0,2,4
77876,5,1,272646,272646,272647,0,1,3
77877,4,1,272650,272650,272651,0,1,3
77878,3,3,272653,272653,272656,0,3,2
77879,3,3,272656,272656,272659,0,3,0
77880,6,2,272662,272662,272664,0,2,3
77881,2,3,272664,272664,272667,0,3,0
77882,3,3,272667,272667,272670,0,3,0
77883,1,3,272668,272670,272673,2,5,0
77884,2,2,272670,272673,272675,3,5,0
77885,4,2,272674,272675,272677,1,3,0
77886,2,3,272676,272677,272680,1,4,0
77887,6,3,272682,272682,272685,0,3,2
77888,1,3,272683,272685,272688,2,5,0
77889,5,3,272688,272688,272691,0,3,0
77890,3,1,272691,272691,272692,0,1,0
77891,3,2,272694,272694,272696,0,2,2
77892,5,3,272699,272699,272702,0,3,3
77893,1,1,272700,272702,272703,2,3,0
77894,6,1,272706,272706,272707,0,1,3
77895,5,1,272711,272711,272712,0,1,4
77896,3,2,272714,272714,272716,0,2,2
77897,1,1,272715,272716,272717,1,2,0
77898,2,1,272717,272717,272718,0,1,0
77899,3,2,272720,272720,272722,0,2,2
77900,2,1,272722,272722,272723,0,1,0
77901,4,3,272726,272726,272729,0,3,3
77902,1,3,272727,272729,272732,2,5,0
77903,2,1,272729,272732,272733,3,4,0
77904,5,2,272734,272734,272736,0,2,1
77905,4,3,272738,272738,272741,0,3,2
77906,6,3,272744,272744,272747,0,3,3
77907,5,1,272749,272749,272750,0,1,2
77908,2,2,272751,272751,272753,0,2,1
77909,5,2,272756,272756,272758,0,2,3
77910,2,1,272758,272758,272759,0,1,0
77911,4,1,272762,272762,272763,0,1,3
77912,3,2,272765,272765,272767,0,2,2
77913,4,2,272769,272769,272771,0,2,2
77914,6,3,272775,272775,272778,0,3,4
77915,4,3,272779,272779,272782,0,3,1
77916,1,1,272780,272782,272783,2,3,0
77917,4,2,272784,272784,272786,0,2,1
77918,6,1,272790,272790,272791,0,1,4
77919,4,1,272794,272794,272795,0,1,3
77920,1,1,272795,272795,272796,0,1,0
77921,4,1,272799,272799,272800,0,1,3
77922,3,2,272802,272802,272804,0,2,2
77923,3,1,272805,272805,272806,0,1,1
77924,5,3,272810,272810,272813,0,3,4
77925,6,2,272816,272816,272818,0,2,3
77926,5,2,272821,272821,272823,0,2,3
77927,2,1,272823,272823,272824,0,1,0
77928,1,3,272824,272824,272827,0,3,0
77929,6,1,272830,272830,272831,0,1,3
77930,2,1,272832,272832,272833,0,1,1
77931,3,3,272835,272835,272838,0,3,2
77932,5,3,272840,272840,272843,0,3,2
77933,2,1,272842,272843,272844,1,2,0
77934,5,1,272847,272847,272848,0,1,3
77935,2,2,272849,272849,272851,0,2,1
77936,2,2,272851,272851,272853,0,2,0
77937,3,1,272854,272854,272855,0,1,1
77938,3,3,272857,272857,272860,0,3,2
77939,5,3,272862,272862,272865,0,3,2
77940,1,3,272863,272865,272868,2,5,0
77941,2,2,272865,272868,272870,3,5,0
77942,5,3,272870,272870,272873,0,3,0
77943,1,3,272871,272873,272876,2,5,0
77944,2,3,272873,272876,272879,3,6,0
77945,6,1,272879,272879,272880,0,1,0
77946,3,2,272882,272882,272884,0,2,2
77947,3,2,272885,272885,272887,0,2,1
77948,2,2,272887,272887,272889,0,2,0
77949,5,1,272892,272892,272893,0,1,3
77950,3,2,272895,272895,272897,0,2,2
77951,1,1,272896,272897,272898,1,2,0
77952,2,1,272898,272898,272899,0,1,0
77953,6,1,272904,272904,272905,0,1,5
77954,2,3,272906,272906,272909,0,3,1
77955,6,2,272912,272912,272914,0,2,3
77956,1,2,272913,272914,272916,1,3,0
77957,2,3,272915,272916,272919,1,4,0
77958,1,1,272916,272919,272920,3,4,0
77959,2,3,272918,272920,272923,2,5,0
77960,5,2,272923,272923,272925,0,2,0
77961,2,1,272925,272925,272926,0,1,0
77962,5,2,272930,272930,272932,0,2,4
77963,1,2,272931,272932,272934,1,3,0
77964,1,3,272932,272934,272937,2,5,0
77965,5,3,272937,272937,272940,0,3,0
77966,1,1,272938,272940,272941,2,3,0
77967,1,1,272939,272941,272942,2,3,0
77968,1,3,272940,272942,272945,2,5,0
77969,5,2,272945,272945,272947,0,2,0
77970,3,1,272948,272948,272949,0,1,1
77971,2,1,272950,272950,272951,0,1,1
77972,6,3,272956,272956,272959,0,3,5
77973,2,2,272958,272959,272961,1,3,0
77974,4,2,272962,272962,272964,0,2,1
77975,2,2,272964,272964,272966,0,2,0
77976,5,3,272969,272969,272972,0,3,3
77977,4,2,272973,272973,272975,0,2,1
77978,4,2,272977,272977,272979,0,2,2
77979,3,2,272980,272980,272982,0,2,1
77980,4,3,272984,272984,272987,0,3,2
77981,1,3,272985,272987,272990,2,5,0
77982,2,2,272987,272990,272992,3,5,0
77983,5,2,272992,272992,272994,0,2,0
77984,5,1,272997,272997,272998,0,1,3
77985,6,2,273003,273003,273005,0,2,5
77986,2,2,273005,273005,273007,0,2,0
77987,4,2,273009,273009,273011,0,2,2
77988,2,1,273011,273011,273012,0,1,0
77989,5,3,273016,273016,273019,0,3,4
77990,4,3,273020,273020,273023,0,3,1
77991,6,3,273026,273026,273029,0,3,3
77992,5,2,273031,273031,273033,0,2,2
77993,6,2,273037,273037,273039,0,2,4
77994,3,2,273040,273040,273042,0,2,1
77995,1,3,273041,273042,273045,1,4,0
77996,1,3,273042,273045,273048,3,6,0
77997,6,2,273048,273048,273050,0,2,0
77998,2,1,273050,273050,273051,0,1,0
77999,1,1,273051,273051,273052,0,1,0
78000,6,2,273057,273057,273059,0,2,5
78001,2,1,273059,273059,273060,0,1,0
78002,1,2,273060,273060,273062,0,2,0
78003,6,1,273066,273066,273067,0,1,4
78004,5,3,273071,273071,273074,0,3,4
78005,2,2,273073,273074,273076,1,3,0
78006,1,3,273074,273076,273079,2,5,0
78007,1,3,273075,273079,273082,4,7,0
78008,3,3,273078,273082,273085,4,7,0
78009,5,3,273083,273085,273088,2,5,0
78010,3,2,273086,273088,273090,2,4,0
78011,6,1,273092,273092,273093,0,1,2
78012,6,1,273098,273098,273099,0,1,5
78013,1,2,273099,273099,273101,0,2,0
78014,6,3,273105,273105,273108,0,3,4
78015,5,3,273110,273110,273113,0,3,2
78016,1,3,273111,273113,273116,2,5,0
78017,4,1,273115,273116,273117,1,2,0
78018,2,3,273117,273117,273120,0,3,0
78019,1,1,273118,273120,273121,2,3,0
78020,4,3,273122,273122,273125,0,3,1
78021,1,3,273123,273125,273128,2,5,0
78022,5,2,273128,273128,273130,0,2,0
78023,6,1,273134,273134,273135,0,1,4
78024,5,1,273139,273139,273140,0,1,4
78025,3,2,273142,273142,273144,0,2,2
78026,4,2,273146,273146,273148,0,2,2
78027,6,3,273152,273152,273155,0,3,4
78028,5,3,273157,273157,273160,0,3,2
78029,1,3,273158,273160,273163,2,5,0
78030,6,3,273164,273164,273167,0,3,1
78031,1,3,273165,273167,273170,2,5,0
78032,6,3,273171,273171,273174,0,3,1
78033,1,1,273172,273174,273175,2,3,0
78034,2,1,273174,273175,273176,1,2,0
78035,2,2,273176,273176,273178,0,2,0
78036,1,3,273177,273178,273181,1,4,0
78037,3,3,273180,273181,273184,1,4,0
78038,4,1,273184,273184,273185,0,1,0
78039,5,1,273189,273189,273190,0,1,4
78040,5,3,273194,273194,273197,0,3,4
78041,2,1,273196,273197,273198,1,2,0
78042,2,3,273198,273198,273201,0,3,0
78043,5,2,273203,273203,273205,0,2,2
78044,1,2,273204,273205,273207,1,3,0
78045,1,2,273205,273207,273209,2,4,0
78046,5,2,273210,273210,273212,0,2,1
78047,1,1,273211,273212,273213,1,2,0
78048,3,1,273214,273214,273215,0,1,1
78049,2,1,273216,273216,273217,0,1,1
78050,3,2,273219,273219,273221,0,2,2
78051,6,2,273225,273225,273227,0,2,4
78052,1,2,273226,273227,273229,1,3,0
78053,6,1,273232,273232,273233,0,1,3
78054,4,2,273236,273236,273238,0,2,3
78055,1,2,273237,273238,273240,1,3,0
78056,3,3,273240,273240,273243,0,3,0
78057,5,3,273245,273245,273248,0,3,2
78058,2,2,273247,273248,273250,1,3,0
78059,5,3,273252,273252,273255,0,3,2
78060,4,2,273256,273256,273258,0,2,1
78061,2,3,273258,273258,273261,0,3,0
78062,2,3,273260,273261,273264,1,4,0
78063,2,3,273262,273264,273267,2,5,0
78064,4,1,273266,273267,273268,1,2,0
78065,2,3,273268,273268,273271,0,3,0
78066,3,2,273271,273271,273273,0,2,0
78067,4,1,273275,273275,273276,0,1,2
78068,6,2,273281,273281,273283,0,2,5
78069,5,1,273286,273286,273287,0,1,3
78070,5,2,273291,273291,273293,0,2,4
78071,1,3,273292,273293,273296,1,4,0
78072,1,1,273293,273296,273297,3,4,0
78073,1,3,273294,273297,273300,3,6,0
78074,3,1,273297,273300,273301,3,4,0
78075,4,3,273301,273301,273304,0,3,0
78076,5,3,273306,273306,273309,0,3,2
78077,3,1,273309,273309,273310,0,1,0
78078,3,2,273312,273312,273314,0,2,2
78079,3,1,273315,273315,273316,0,1,1
78080,4,2,273319,273319,273321,0,2,3
78081,4,2,273323,273323,273325,0,2,2
78082,5,3,273328,273328,273331,0,3,3
78083,3,1,273331,273331,273332,0,1,0
78084,3,1,273334,273334,273335,0,1,2
78085,2,2,273336,273336,273338,0,2,1
78086,2,2,273338,273338,273340,0,2,0
78087,5,1,273343,273343,273344,0,1,3
78088,1,3,273344,273344,273347,0,3,0
78089,5,2,273349,273349,273351,0,2,2
78090,1,1,273350,273351,273352,1,2,0
78091,3,2,273353,273353,273355,0,2,1
78092,1,2,273354,273355,273357,1,3,0
78093,6,2,273360,273360,273362,0,2,3
78094,2,2,273362,273362,273364,0,2,0
78095,5,1,273367,273367,273368,0,1,3
78096,3,3,273370,273370,273373,0,3,2
78097,4,2,273374,273374,273376,0,2,1
78098,5,3,273379,273379,273382,0,3,3
78099,6,2,273385,273385,273387,0,2,3
78100,5,1,273390,273390,273391,0,1,3
78101,6,3,273396,273396,273399,0,3,5
78102,1,3,273397,273399,273402,2,5,0
78103,2,3,273399,273402,273405,3,6,0
78104,3,3,273402,273405,273408,3,6,0
78105,6,2,273408,273408,273410,0,2,0
78106,5,3,273413,273413,273416,0,3,3
78107,3,3,273416,273416,273419,0,3,0
78108,1,3,273417,273419,273422,2,5,0
78109,6,3,273423,273423,273426,0,3,1
78110,1,1,273424,273426,273427,2,3,0
78111,1,1,273425,273427,273428,2,3,0
78112,6,2,273431,273431,273433,0,2,3
78113,1,3,273432,273433,273436,1,4,0
78114,5,1,273437,273437,273438,0,1,1
78115,3,1,273440,273440,273441,0,1,2
78116,5,1,273445,273445,273446,0,1,4
78117,2,1,273447,273447,273448,0,1,1
78118,6,2,273453,273453,273455,0,2,5
78119,3,3,273456,273456,273459,0,3,1
78120,5,2,273461,273461,273463,0,2,2
78121,4,1,273465,273465,273466,0,1,2
78122,6,2,273471,273471,273473,0,2,5
78123,3,1,273474,273474,273475,0,1,1
78124,6,1,273480,273480,273481,0,1,5
78125,6,3,273486,273486,273489,0,3,5
78126,1,1,273487,273489,273490,2,3,0
78127,5,2,273492,273492,273494,0,2,2
78128,5,1,273497,273497,273498,0,1,3
78129,2,3,273499,273499,273502,0,3,1
78130,5,3,273504,273504,273507,0,3,2
78131,3,3,273507,273507,273510,0,3,0
78132,4,2,273511,273511,273513,0,2,1
78133,4,2,273515,273515,273517,0,2,2
78134,3,3,273518,273518,273521,0,3,1
78135,5,3,273523,273523,273526,0,3,2
78136,1,2,273524,273526,273528,2,4,0
78137,2,2,273526,273528,273530,2,4,0
78138,3,3,273529,273530,273533,1,4,0
78139,2,2,273531,273533,273535,2,4,0
78140,4,2,273535,273535,273537,0,2,0
78141,1,3,273536,273537,273540,1,4,0
78142,5,3,273541,273541,273544,0,3,1
78143,3,2,273544,273544,273546,0,2,0
78144,5,2,273549,273549,273551,0,2,3
78145,5,1,273554,273554,273555,0,1,3
78146,2,3,273556,273556,273559,0,3,1
78147,5,1,273561,273561,273562,0,1,2
78148,3,2,273564,273564,273566,0,2,2
78149,6,1,273570,273570,273571,0,1,4
78150,3,3,273573,273573,273576,0,3,2
78151,3,1,273576,273576,273577,0,1,0
78152,1,3,273577,273577,273580,0,3,0
78153,2,2,273579,273580,273582,1,3,0
78154,1,2,273580,273582,273584,2,4,0
78155,5,1,273585,273585,273586,0,1,1
78156,6,1,273591,273591,273592,0,1,5
78157,1,3,273592,273592,273595,0,3,0
78158,6,3,273598,273598,273601,0,3,3
78159,4,3,273602,273602,273605,0,3,1
78160,2,3,273604,273605,273608,1,4,0
78161,6,2,273610,273610,273612,0,2,2
78162,1,1,273611,273612,273613,1,2,0
78163,2,2,273613,273613,273615,0,2,0
78164,5,2,273618,273618,273620,0,2,3
78165,1,1,273619,273620,273621,1,2,0
78166,1,2,273620,273621,273623,1,3,0
78167,5,1,273625,273625,273626,0,1,2
78168,4,3,273629,273629,273632,0,3,3
78169,3,2,273632,273632,273634,0,2,0
78170,4,2,273636,273636,273638,0,2,2
78171,3,2,273639,273639,273641,0,2,1
78172,5,2,273644,273644,273646,0,2,3
78173,4,2,273648,273648,273650,0,2,2
78174,5,3,273653,273653,273656,0,3,3
78175,1,1,273654,273656,273657,2,3,0
78176,6,1,273660,273660,273661,0,1,3
78177,6,1,273666,273666,273667,0,1,5
78178,1,2,273667,273667,273669,0,2,0
78179,1,1,273668,273669,273670,1,2,0
78180,2,1,273670,273670,273671,0,1,0
78181,1,1,273671,273671,273672,0,1,0
78182,2,1,273673,273673,273674,0,1,1
78183,3,2,273676,273676,273678,0,2,2
78184,5,2,273681,273681,273683,0,2,3
78185,3,2,273684,273684,273686,0,2,1
78186,3,2,273687,273687,273689,0,2,1
78187,1,1,273688,273689,273690,1,2,0
78188,5,1,273693,273693,273694,0,1,3
78189,1,1,273694,273694,273695,0,1,0
78190,2,1,273696,273696,273697,0,1,1
78191,3,1,273699,273699,273700,0,1,2
78192,3,1,273702,273702,273703,0,1,2
78193,6,2,273708,273708,273710,0,2,5
78194,4,2,273712,273712,273714,0,2,2
78195,1,2,273713,273714,273716,1,3,0
78196,5,2,273718,273718,273720,0,2,2
78197,3,3,273721,273721,273724,0,3,1
78198,1,1,273722,273724,273725,2,3,0
78199,2,3,273724,273725,273728,1,4,0
78200,4,3,273728,273728,273731,0,3,0
78201,3,2,273731,273731,273733,0,2,0
78202,3,3,273734,273734,273737,0,3,1
78203,4,3,273738,273738,273741,0,3,1
78204,1,3,273739,273741,273744,2,5,0
78205,5,1,273744,273744,273745,0,1,0
78206,4,3,273748,273748,273751,0,3,3
78207,4,1,273752,273752,273753,0,1,1
78208,1,1,273753,273753,273754,0,1,0
78209,1,1,273754,273754,273755,0,1,0
78210,5,3,273759,273759,273762,0,3,4
78211,2,2,273761,273762,273764,1,3,0
78212,6,2,273767,273767,273769,0,2,3
78213,5,2,273772,273772,273774,0,2,3
78214,2,1,273774,273774,273775,0,1,0
78215,4,3,273778,273778,273781,0,3,3
78216,2,2,273780,273781,273783,1,3,0
78217,5,3,273785,273785,273788,0,3,2
78218,1,3,273786,273788,273791,2,5,0
78219,6,3,273792,273792,273795,0,3,1
78220,4,1,273796,273796,273797,0,1,1
78221,4,1,273800,273800,273801,0,1,3
78222,1,1,273801,273801,273802,0,1,0
78223,2,1,273803,273803,273804,0,1,1
78224,3,2,273806,273806,273808,0,2,2
78225,2,3,273808,273808,273811,0,3,0
78226,4,1,273812,273812,273813,0,1,1
78227,4,2,273816,273816,273818,0,2,3
78228,1,2,273817,273818,273820,1,3,0
78229,6,3,273823,273823,273826,0,3,3
78230,4,3,273827,273827,273830,0,3,1
78231,3,3,273830,273830,273833,0,3,0
78232,2,2,273832,273833,273835,1,3,0
78233,6,3,273838,273838,273841,0,3,3
78234,2,1,273840,273841,273842,1,2,0
78235,2,3,273842,273842,273845,0,3,0
78236,3,2,273845,273845,273847,0,2,0
78237,5,3,273850,273850,273853,0,3,3
78238,6,1,273856,273856,273857,0,1,3
78239,3,2,273859,273859,273861,0,2,2
78240,1,3,273860,273861,273864,1,4,0
78241,1,3,273861,273864,273867,3,6,0
78242,4,2,273865,273867,273869,2,4,0
78243,6,3,273871,273871,273874,0,3,2
78244,3,1,273874,273874,273875,0,1,0
78245,1,3,273875,273875,273878,0,3,0
78246,3,3,273878,273878,273881,0,3,0
78247,4,3,273882,273882,273885,0,3,1
78248,1,3,273883,273885,273888,2,5,0
78249,2,3,273885,273888,273891,3,6,0
78250,5,3,273890,273891,273894,1,4,0
78251,4,2,273894,273894,273896,0,2,0
78252,4,2,273898,273898,273900,0,2,2
78253,5,1,273903,273903,273904,0,1,3
78254,2,1,273905,273905,273906,0,1,1
78255,3,2,273908,273908,273910,0,2,2
78256,4,1,273912,273912,273913,0,1,2
78257,6,1,273918,273918,273919,0,1,5
78258,2,3,273920,273920,273923,0,3,1
78259,5,2,273925,273925,273927,0,2,2
78260,3,1,273928,273928,273929,0,1,1
78261,2,2,273930,273930,273932,0,2,1
78262,4,3,273934,273934,273937,0,3,2
78263,1,3,273935,273937,273940,2,5,0
78264,1,3,273936,273940,273943,4,7,0
78265,1,3,273937,273943,273946,6,9,0
78266,1,2,273938,273946,273948,8,10,0
78267,1,2,273939,273948,273950,9,11,0
78268,6,3,273945,273950,273953,5,8,0
78269,4,1,273949,273953,273954,4,5,0
78270,5,3,273954,273954,273957,0,3,0
78271,1,3,273955,273957,273960,2,5,0
78272,5,2,273960,273960,273962,0,2,0
78273,1,3,273961,273962,273965,1,4,0
78274,1,2,273962,273965,273967,3,5,0
78275,3,1,273965,273967,273968,2,3,0
78276,6,2,273971,273971,273973,0,2,3
78277,6,1,273977,273977,273978,0,1,4
78278,3,2,273980,273980,273982,0,2,2
78279,1,1,273981,273982,273983,1,2,0
78280,4,1,273985,273985,273986,0,1,2
78281,2,2,273987,273987,273989,0,2,1
78282,5,2,273992,273992,273994,0,2,3
78283,2,3,273994,273994,273997,0,3,0
78284,4,1,273998,273998,273999,0,1,1
78285,5,3,274003,274003,274006,0,3,4
78286,2,3,274005,274006,274009,1,4,0
78287,1,1,274006,274009,274010,3,4,0
78288,2,3,274008,274010,274013,2,5,0
78289,6,2,274014,274014,274016,0,2,1
78290,4,1,274018,274018,274019,0,1,2
78291,4,2,274022,274022,274024,0,2,3
78292,4,1,274026,274026,274027,0,1,2
78293,5,2,274031,274031,274033,0,2,4
78294,2,3,274033,274033,274036,0,3,0
78295,4,1,274037,274037,274038,0,1,1
78296,4,2,274041,274041,274043,0,2,3
78297,5,3,274046,274046,274049,0,3,3
78298,5,2,274051,274051,274053,0,2,2
78299,2,3,274053,274053,274056,0,3,0
78300,2,2,274055,274056,274058,1,3,0
78301,2,3,274057,274058,274061,1,4,0
78302,5,3,274062,274062,274065,0,3,1
78303,5,2,274067,274067,274069,0,2,2
78304,1,2,274068,274069,274071,1,3,0
78305,6,1,274074,274074,274075,0,1,3
78306,4,3,274078,274078,274081,0,3,3
78307,2,3,274080,274081,274084,1,4,0
78308,3,2,274083,274084,274086,1,3,0
78309,4,1,274087,274087,274088,0,1,1
78310,6,1,274093,274093,274094,0,1,5
78311,5,2,274098,274098,274100,0,2,4
78312,5,1,274103,274103,274104,0,1,3
78313,1,1,274104,274104,274105,0,1,0
78314,3,3,274107,274107,274110,0,3,2
78315,5,2,274112,274112,274114,0,2,2
78316,1,1,274113,274114,274115,1,2,0
78317,2,1,274115,274115,274116,0,1,0
78318,6,3,274121,274121,274124,0,3,5
78319,6,2,274127,274127,274129,0,2,3
78320,4,2,274131,274131,274133,0,2,2
78321,5,1,274136,274136,274137,0,1,3
78322,5,1,274141,274141,274142,0,1,4
78323,2,2,274143,274143,274145,0,2,1
78324,2,1,274145,274145,274146,0,1,0
78325,6,2,274151,274151,274153,0,2,5
78326,4,3,274155,274155,274158,0,3,2
78327,3,3,274158,274158,274161,0,3,0
78328,4,1,274162,274162,274163,0,1,1
78329,4,3,274166,274166,274169,0,3,3
78330,1,3,274167,274169,274172,2,5,0
78331,1,1,274168,274172,274173,4,5,0
78332,4,2,274172,274173,274175,1,3,0
78333,2,2,274174,274175,274177,1,3,0
78334,5,2,274179,274179,274181,0,2,2
78335,5,1,274184,274184,274185,0,1,3
78336,5,3,274189,274189,274192,0,3,4
78337,5,1,274194,274194,274195,0,1,2
78338,6,1,274200,274200,274201,0,1,5
78339,1,3,274201,274201,274204,0,3,0
78340,6,3,274207,274207,274210,0,3,3
78341,5,2,274212,274212,274214,0,2,2
78342,3,2,274215,274215,274217,0,2,1
78343,2,2,274217,274217,274219,0,2,0
78344,5,2,274222,274222,274224,0,2,3
78345,1,3,274223,274224,274227,1,4,0
78346,2,1,274225,274227,274228,2,3,0
78347,1,2,274226,274228,274230,2,4,0
78348,4,3,274230,274230,274233,0,3,0
78349,4,3,274234,274234,274237,0,3,1
78350,3,3,274237,274237,274240,0,3,0
78351,3,2,274240,274240,274242,0,2,0
78352,6,1,274246,274246,274247,0,1,4
78353,2,2,274248,274248,274250,0,2,1
78354,6,1,274254,274254,274255,0,1,4
78355,4,3,274258,274258,274261,0,3,3
78356,1,1,274259,274261,274262,2,3,0
78357,4,3,274263,274263,274266,0,3,1
78358,3,2,274266,274266,274268,0,2,0
78359,1,3,274267,274268,274271,1,4,0
78360,6,3,274273,274273,274276,0,3,2
78361,5,3,274278,274278,274281,0,3,2
78362,6,1,274284,274284,274285,0,1,3
78363,2,1,274286,274286,274287,0,1,1
78364,1,3,274287,274287,274290,0,3,0
78365,1,1,274288,274290,274291,2,3,0
78366,5,3,274293,274293,274296,0,3,2
78367,2,2,274295,274296,274298,1,3,0
78368,4,1,274299,274299,274300,0,1,1
78369,6,2,274305,274305,274307,0,2,5
78370,3,3,274308,274308,274311,0,3,1
78371,5,1,274313,274313,274314,0,1,2
78372,5,3,274318,274318,274321,0,3,4
78373,5,2,274323,274323,274325,0,2,2
78374,3,3,274326,274326,274329,0,3,1
78375,1,3,274327,274329,274332,2,5,0
78376,6,2,274333,274333,274335,0,2,1
78377,5,3,274338,274338,274341,0,3,3
78378,1,2,274339,274341,274343,2,4,0
78379,6,3,274345,274345,274348,0,3,2
78380,6,2,274351,274351,274353,0,2,3
78381,6,2,274357,274357,274359,0,2,4
78382,3,3,274360,274360,274363,0,3,1
78383,2,2,274362,274363,274365,1,3,0
78384,6,1,274368,274368,274369,0,1,3
78385,4,2,274372,274372,274374,0,2,3
78386,2,3,274374,274374,274377,0,3,0
78387,2,2,274376,274377,274379,1,3,0
78388,2,3,274378,274379,274382,1,4,0
78389,5,1,274383,274383,274384,0,1,1
78390,4,2,274387,274387,274389,0,2,3
78391,1,1,274388,274389,274390,1,2,0
78392,5,2,274393,274393,274395,0,2,3
78393,2,3,274395,274395,274398,0,3,0
78394,3,2,274398,274398,274400,0,2,0
78395,4,2,274402,274402,274404,0,2,2
78396,1,3,274403,274404,274407,1,4,0
78397,4,2,274407,274407,274409,0,2,0
78398,4,3,274411,274411,274414,0,3,2
78399,3,3,274414,274414,274417,0,3,0
78400,3,3,274417,274417,274420,0,3,0
78401,5,3,274422,274422,274425,0,3,2
78402,5,3,274427,274427,274430,0,3,2
78403,3,2,274430,274430,274432,0,2,0
78404,4,2,274434,274434,274436,0,2,2
78405,5,1,274439,274439,274440,0,1,3
78406,2,3,274441,274441,274444,0,3,1
78407,3,2,274444,274444,274446,0,2,0
78408,1,3,274445,274446,274449,1,4,0
78409,3,3,274448,274449,274452,1,4,0
78410,1,1,274449,274452,274453,3,4,0
78411,1,3,274450,274453,274456,3,6,0
78412,4,1,274454,274456,274457,2,3,0
78413,2,2,274456,274457,274459,1,3,0
78414,3,1,274459,274459,274460,0,1,0
78415,1,3,274460,274460,274463,0,3,0
78416,2,1,274462,274463,274464,1,2,0
78417,5,2,274467,274467,274469,0,2,3
78418,1,2,274468,274469,274471,1,3,0
78419,2,3,274470,274471,274474,1,4,0
78420,1,1,274471,274474,274475,3,4,0
78421,4,2,274475,274475,274477,0,2,0
78422,6,3,274481,274481,274484,0,3,4
78423,3,3,274484,274484,274487,0,3,0
78424,5,2,274489,274489,274491,0,2,2
78425,2,3,274491,274491,274494,0,3,0
78426,5,3,274496,274496,274499,0,3,2
78427,2,3,274498,274499,274502,1,4,0
78428,5,2,274503,274503,274505,0,2,1
78429,3,2,274506,274506,274508,0,2,1
78430,4,3,274510,274510,274513,0,3,2
78431,3,3,274513,274513,274516,0,3,0
78432,1,1,274514,274516,274517,2,3,0
78433,3,3,274517,274517,274520,0,3,0
78434,2,1,274519,274520,274521,1,2,0
78435,4,1,274523,274523,274524,0,1,2
78436,2,2,274525,274525,274527,0,2,1
78437,4,2,274529,274529,274531,0,2,2
78438,1,2,274530,274531,274533,1,3,0
78439,5,1,274535,274535,274536,0,1,2
78440,1,1,274536,274536,274537,0,1,0
78441,2,1,274538,274538,274539,0,1,1
78442,1,3,274539,274539,274542,0,3,0
78443,4,3,274543,274543,274546,0,3,1
78444,4,3,274547,274547,274550,0,3,1
78445,1,2,274548,274550,274552,2,4,0
78446,1,2,274549,274552,274554,3,5,0
78447,4,3,274553,274554,274557,1,4,0
78448,2,2,274555,274557,274559,2,4,0
78449,4,2,274559,274559,274561,0,2,0
78450,2,3,274561,274561,274564,0,3,0
78451,5,3,274566,274566,274569,0,3,2
78452,2,2,274568,274569,274571,1,3,0
78453,3,1,274571,274571,274572,0,1,0
78454,1,2,274572,274572,274574,0,2,0
78455,1,1,274573,274574,274575,1,2,0
78456,5,2,274578,274578,274580,0,2,3
78457,3,1,274581,274581,274582,0,1,1
78458,6,1,274587,274587,274588,0,1,5
78459,1,1,274588,274588,274589,0,1,0
78460,3,1,274591,274591,274592,0,1,2
78461,4,2,274595,274595,274597,0,2,3
78462,5,1,274600,274600,274601,0,1,3
78463,3,3,274603,274603,274606,0,3,2
78464,4,1,274607,274607,274608,0,1,1
78465,1,1,274608,274608,274609,0,1,0
78466,6,1,274614,274614,274615,0,1,5
78467,5,1,274619,274619,274620,0,1,4
78468,1,1,274620,274620,274621,0,1,0
78469,1,1,274621,274621,274622,0,1,0
78470,1,1,274622,274622,274623,0,1,0
78471,6,2,274628,274628,274630,0,2,5
78472,5,2,274633,274633,274635,0,2,3
78473,6,2,274639,274639,274641,0,2,4
78474,2,3,274641,274641,274644,0,3,0
78475,1,1,274642,274644,274645,2,3,0
78476,4,1,274646,274646,274647,0,1,1
78477,6,1,274652,274652,274653,0,1,5
78478,2,1,274654,274654,274655,0,1,1
78479,6,1,274660,274660,274661,0,1,5
78480,4,2,274664,274664,274666,0,2,3
78481,1,1,274665,274666,274667,1,2,0
78482,1,2,274666,274667,274669,1,3,0
78483,2,1,274668,274669,274670,1,2,0
78484,3,2,274671,274671,274673,0,2,1
78485,6,3,274677,274677,274680,0,3,4
78486,4,2,274681,274681,274683,0,2,1
78487,2,2,274683,274683,274685,0,2,0
78488,1,1,274684,274685,274686,1,2,0
78489,3,2,274687,274687,274689,0,2,1
78490,6,1,274693,274693,274694,0,1,4
78491,3,2,274696,274696,274698,0,2,2
78492,6,3,274702,274702,274705,0,3,4
78493,5,3,274707,274707,274710,0,3,2
78494,2,3,274709,274710,274713,1,4,0
78495,3,1,274712,274713,274714,1,2,0
78496,3,1,274715,274715,274716,0,1,1
78497,4,3,274719,274719,274722,0,3,3
78498,6,2,274725,274725,274727,0,2,3
78499,6,1,274731,274731,274732,0,1,4
78500,4,2,274735,274735,274737,0,2,3
78501,2,3,274737,274737,274740,0,3,0
78502,4,3,274741,274741,274744,0,3,1
78503,6,2,274747,274747,274749,0,2,3
78504,2,2,274749,274749,274751,0,2,0
78505,4,2,274753,274753,274755,0,2,2
78506,2,3,274755,274755,274758,0,3,0
78507,5,1,274760,274760,274761,0,1,2
78508,2,2,274762,274762,274764,0,2,1
78509,6,1,274768,274768,274769,0,1,4
78510,4,1,274772,274772,274773,0,1,3
78511,2,2,274774,274774,274776,0,2,1
78512,4,2,274778,274778,274780,0,2,2
78513,5,1,274783,274783,274784,0,1,3
78514,1,2,274784,274784,274786,0,2,0
78515,5,2,274789,274789,274791,0,2,3
78516,6,2,274795,274795,274797,0,2,4
78517,5,2,274800,274800,274802,0,2,3
78518,1,1,274801,274802,274803,1,2,0
78519,1,2,274802,274803,274805,1,3,0
78520,1,2,274803,274805,274807,2,4,0
78521,3,3,274806,274807,274810,1,4,0
78522,6,1,274812,274812,274813,0,1,2
78523,5,1,274817,274817,274818,0,1,4
78524,6,2,274823,274823,274825,0,2,5
78525,5,3,274828,274828,274831,0,3,3
78526,4,2,274832,274832,274834,0,2,1
78527,5,3,274837,274837,274840,0,3,3
78528,1,2,274838,274840,274842,2,4,0
78529,6,3,274844,274844,274847,0,3,2
78530,2,2,274846,274847,274849,1,3,0
78531,6,3,274852,274852,274855,0,3,3
78532,6,1,274858,274858,274859,0,1,3
78533,4,3,274862,274862,274865,0,3,3
78534,1,2,274863,274865,274867,2,4,0
78535,4,1,274867,274867,274868,0,1,0
78536,4,3,274871,274871,274874,0,3,3
78537,4,2,274875,274875,274877,0,2,1
78538,6,2,274881,274881,274883,0,2,4
78539,4,1,274885,274885,274886,0,1,2
78540,3,2,274888,274888,274890,0,2,2
78541,1,1,274889,274890,274891,1,2,0
78542,1,3,274890,274891,274894,1,4,0
78543,6,1,274896,274896,274897,0,1,2
78544,5,1,274901,274901,274902,0,1,4
78545,4,3,274905,274905,274908,0,3,3
78546,3,3,274908,274908,274911,0,3,0
78547,5,2,274913,274913,274915,0,2,2
78548,1,2,274914,274915,274917,1,3,0
78549,3,1,274917,274917,274918,0,1,0
78550,1,2,274918,274918,274920,0,2,0
78551,5,3,274923,274923,274926,0,3,3
78552,4,2,274927,274927,274929,0,2,1
78553,4,3,274931,274931,274934,0,3,2
78554,1,3,274932,274934,274937,2,5,0
78555,3,3,274935,274937,274940,2,5,0
78556,3,1,274938,274940,274941,2,3,0
78557,5,1,274943,274943,274944,0,1,2
78558,6,1,274949,274949,274950,0,1,5
78559,3,3,274952,274952,274955,0,3,2
78560,1,3,274953,274955,274958,2,5,0
78561,4,2,274957,274958,274960,1,3,0
78562,2,3,274959,274960,274963,1,4,0
78563,1,2,274960,274963,274965,3,5,0
78564,6,2,274966,274966,274968,0,2,1
78565,4,2,274970,274970,274972,0,2,2
78566,2,3,274972,274972,274975,0,3,0
78567,1,1,274973,274975,274976,2,3,0
78568,3,2,274976,274976,274978,0,2,0
78569,6,3,274982,274982,274985,0,3,4
78570,6,3,274988,274988,274991,0,3,3
78571,1,2,274989,274991,274993,2,4,0
78572,5,2,274994,274994,274996,0,2,1
78573,1,2,274995,274996,274998,1,3,0
78574,3,2,274998,274998,275000,0,2,0
78575,6,3,275004,275004,275007,0,3,4
78576,1,2,275005,275007,275009,2,4,0
78577,3,2,275008,275009,275011,1,3,0
78578,6,2,275014,275014,275016,0,2,3
78579,1,2,275015,275016,275018,1,3,0
78580,6,1,275021,275021,275022,0,1,3
78581,5,3,275026,275026,275029,0,3,4
78582,2,1,275028,275029,275030,1,2,0
78583,3,1,275031,275031,275032,0,1,1
78584,6,3,275037,275037,275040,0,3,5
78585,6,2,275043,275043,275045,0,2,3
78586,4,1,275047,275047,275048,0,1,2
78587,3,2,275050,275050,275052,0,2,2
78588,6,2,275056,275056,275058,0,2,4
78589,6,1,275062,275062,275063,0,1,4
78590,2,3,275064,275064,275067,0,3,1
78591,2,3,275066,275067,275070,1,4,0
78592,6,2,275072,275072,275074,0,2,2
78593,6,3,275078,275078,275081,0,3,4
78594,4,3,275082,275082,275085,0,3,1
78595,5,1,275087,275087,275088,0,1,2
78596,2,3,275089,275089,275092,0,3,1
78597,1,2,275090,275092,275094,2,4,0
78598,6,1,275096,275096,275097,0,1,2
78599,5,1,275101,275101,275102,0,1,4
78600,5,3,275106,275106,275109,0,3,4
78601,6,1,275112,275112,275113,0,1,3
78602,2,3,275114,275114,275117,0,3,1
78603,6,3,275120,275120,275123,0,3,3
78604,3,1,275123,275123,275124,0,1,0
78605,1,3,275124,275124,275127,0,3,0
78606,1,3,275125,275127,275130,2,5,0
78607,4,2,275129,275130,275132,1,3,0
78608,1,3,275130,275132,275135,2,5,0
78609,2,1,275132,275135,275136,3,4,0
78610,1,1,275133,275136,275137,3,4,0
78611,1,1,275134,275137,275138,3,4,0
78612,1,1,275135,275138,275139,3,4,0
78613,4,3,275139,275139,275142,0,3,0
78614,4,2,275143,275143,275145,0,2,1
78615,6,2,275149,275149,275151,0,2,4
78616,1,1,275150,275151,275152,1,2,0
78617,2,1,275152,275152,275153,0,1,0
78618,2,1,275154,275154,275155,0,1,1
78619,1,3,275155,275155,275158,0,3,0
78620,4,1,275159,275159,275160,0,1,1
78621,2,1,275161,275161,275162,0,1,1
78622,6,1,275167,275167,275168,0,1,5
78623,1,2,275168,275168,275170,0,2,0
78624,1,1,275169,275170,275171,1,2,0
78625,4,2,275173,275173,275175,0,2,2
78626,1,1,275174,275175,275176,1,2,0
78627,3,1,275177,275177,275178,0,1,1
78628,4,1,275181,275181,275182,0,1,3
78629,3,3,275184,275184,275187,0,3,2
78630,1,3,275185,275187,275190,2,5,0
78631,6,2,275191,275191,275193,0,2,1
78632,4,2,275195,275195,275197,0,2,2
78633,1,1,275196,275197,275198,1,2,0
78634,4,1,275200,275200,275201,0,1,2
78635,1,1,275201,275201,275202,0,1,0
78636,2,2,275203,275203,275205,0,2,1
78637,1,2,275204,275205,275207,1,3,0
78638,5,2,275209,275209,275211,0,2,2
78639,5,3,275214,275214,275217,0,3,3
78640,6,3,275220,275220,275223,0,3,3
78641,3,1,275223,275223,275224,0,1,0
78642,1,2,275224,275224,275226,0,2,0
78643,5,1,275229,275229,275230,0,1,3
78644,6,1,275235,275235,275236,0,1,5
78645,4,3,275239,275239,275242,0,3,3
78646,2,2,275241,275242,275244,1,3,0
78647,3,2,275244,275244,275246,0,2,0
78648,1,3,275245,275246,275249,1,4,0
78649,6,2,275251,275251,275253,0,2,2
78650,3,2,275254,275254,275256,0,2,1
78651,2,2,275256,275256,275258,0,2,0
78652,2,2,275258,275258,275260,0,2,0
78653,1,1,275259,275260,275261,1,2,0
78654,3,2,275262,275262,275264,0,2,1
78655,6,1,275268,275268,275269,0,1,4
78656,1,1,275269,275269,275270,0,1,0
78657,1,2,275270,275270,275272,0,2,0
78658,6,2,275276,275276,275278,0,2,4
78659,2,3,275278,275278,275281,0,3,0
78660,4,1,275282,275282,275283,0,1,1
78661,5,2,275287,275287,275289,0,2,4
78662,2,3,275289,275289,275292,0,3,0
78663,1,1,275290,275292,275293,2,3,0
78664,5,1,275295,275295,275296,0,1,2
78665,6,1,275301,275301,275302,0,1,5
78666,6,2,275307,275307,275309,0,2,5
78667,3,2,275310,275310,275312,0,2,1
78668,6,3,275316,275316,275319,0,3,4
78669,1,2,275317,275319,275321,2,4,0
78670,5,3,275322,275322,275325,0,3,1
78671,1,1,275323,275325,275326,2,3,0
78672,6,2,275329,275329,275331,0,2,3
78673,2,2,275331,275331,275333,0,2,0
78674,1,1,275332,275333,275334,1,2,0
78675,3,1,275335,275335,275336,0,1,1
78676,6,1,275341,275341,275342,0,1,5
78677,2,1,275343,275343,275344,0,1,1
78678,2,2,275345,275345,275347,0,2,1
78679,3,3,275348,275348,275351,0,3,1
78680,4,3,275352,275352,275355,0,3,1
78681,2,3,275354,275355,275358,1,4,0
78682,2,3,275356,275358,275361,2,5,0
78683,4,2,275360,275361,275363,1,3,0
78684,5,2,275365,275365,275367,0,2,2
78685,3,1,275368,275368,275369,0,1,1
78686,3,3,275371,275371,275374,0,3,2
78687,1,1,275372,275374,275375,2,3,0
78688,2,3,275374,275375,275378,1,4,0
78689,2,2,275376,275378,275380,2,4,0
78690,4,2,275380,275380,275382,0,2,0
78691,1,1,275381,275382,275383,1,2,0
78692,5,2,275386,275386,275388,0,2,3
78693,2,3,275388,275388,275391,0,3,0
78694,4,2,275392,275392,275394,0,2,1
78695,3,1,275395,275395,275396,0,1,1
78696,3,1,275398,275398,275399,0,1,2
78697,5,2,275403,275403,275405,0,2,4
78698,6,3,275409,275409,275412,0,3,4
78699,2,3,275411,275412,275415,1,4,0
78700,5,2,275416,275416,275418,0,2,1
78701,3,2,275419,275419,275421,0,2,1
78702,5,2,275424,275424,275426,0,2,3
78703,3,2,275427,275427,275429,0,2,1
78704,5,1,275432,275432,275433,0,1,3
78705,5,1,275437,275437,275438,0,1,4
78706,2,1,275439,275439,275440,0,1,1
78707,4,3,275443,275443,275446,0,3,3
78708,1,3,275444,275446,275449,2,5,0
78709,6,2,275450,275450,275452,0,2,1
78710,3,2,275453,275453,275455,0,2,1
78711,1,3,275454,275455,275458,1,4,0
78712,6,2,275460,275460,275462,0,2,2
78713,5,3,275465,275465,275468,0,3,3
78714,5,1,275470,275470,275471,0,1,2
78715,5,2,275475,275475,275477,0,2,4
78716,4,2,275479,275479,275481,0,2,2
78717,3,3,275482,275482,275485,0,3,1
78718,5,2,275487,275487,275489,0,2,2
78719,4,2,275491,275491,275493,0,2,2
78720,1,2,275492,275493,275495,1,3,0
78721,3,2,275495,275495,275497,0,2,0
78722,2,2,275497,275497,275499,0,2,0
78723,2,2,275499,275499,275501,0,2,0
78724,4,1,275503,275503,275504,0,1,2
78725,2,2,275505,275505,275507,0,2,1
78726,6,3,275511,275511,275514,0,3,4
78727,4,1,275515,275515,275516,0,1,1
78728,6,1,275521,275521,275522,0,1,5
78729,2,1,275523,275523,275524,0,1,1
78730,4,2,275527,275527,275529,0,2,3
78731,6,1,275533,275533,275534,0,1,4
78732,3,2,275536,275536,275538,0,2,2
78733,6,2,275542,275542,275544,0,2,4
78734,5,3,275547,275547,275550,0,3,3
78735,6,2,275553,275553,275555,0,2,3
78736,4,2,275557,275557,275559,0,2,2
78737,2,1,275559,275559,275560,0,1,0
78738,1,3,275560,275560,275563,0,3,0
78739,6,2,275566,275566,275568,0,2,3
78740,1,3,275567,275568,275571,1,4,0
78741,4,1,275571,275571,275572,0,1,0
78742,4,1,275575,275575,275576,0,1,3
78743,3,1,275578,275578,275579,0,1,2
78744,6,1,275584,275584,275585,0,1,5
78745,6,2,275590,275590,275592,0,2,5
78746,3,2,275593,275593,275595,0,2,1
78747,3,2,275596,275596,275598,0,2,1
78748,5,2,275601,275601,275603,0,2,3
78749,2,2,275603,275603,275605,0,2,0
78750,1,1,275604,275605,275606,1,2,0
78751,2,2,275606,275606,275608,0,2,0
78752,5,2,275611,275611,275613,0,2,3
78753,4,2,275615,275615,275617,0,2,2
78754,1,2,275616,275617,275619,1,3,0
78755,2,3,275618,275619,275622,1,4,0
78756,3,2,275621,275622,275624,1,3,0
78757,3,3,275624,275624,275627,0,3,0
78758,2,3,275626,275627,275630,1,4,0
78759,4,1,275630,275630,275631,0,1,0
78760,2,2,275632,275632,275634,0,2,1
78761,2,3,275634,275634,275637,0,3,0
78762,6,1,275640,275640,275641,0,1,3
78763,1,1,275641,275641,275642,0,1,0
78764,3,1,275644,275644,275645,0,1,2
78765,6,3,275650,275650,275653,0,3,5
78766,4,1,275654,275654,275655,0,1,1
78767,2,2,275656,275656,275658,0,2,1
78768,6,2,275662,275662,275664,0,2,4
78769,6,1,275668,275668,275669,0,1,4
78770,5,3,275673,275673,275676,0,3,4
78771,2,2,275675,275676,275678,1,3,0
78772,1,3,275676,275678,275681,2,5,0
78773,3,3,275679,275681,275684,2,5,0
78774,2,2,275681,275684,275686,3,5,0
78775,5,3,275686,275686,275689,0,3,0
78776,6,1,275692,275692,275693,0,1,3
78777,4,1,275696,275696,275697,0,1,3
78778,1,1,275697,275697,275698,0,1,0
78779,1,3,275698,275698,275701,0,3,0
78780,4,1,275702,275702,275703,0,1,1
78781,1,3,275703,275703,275706,0,3,0
78782,3,3,275706,275706,275709,0,3,0
78783,5,3,275711,275711,275714,0,3,2
78784,4,1,275715,275715,275716,0,1,1
78785,2,2,275717,275717,275719,0,2,1
78786,6,1,275723,275723,275724,0,1,4
78787,1,1,275724,275724,275725,0,1,0
78788,6,1,275730,275730,275731,0,1,5
78789,4,2,275734,275734,275736,0,2,3
78790,3,3,275737,275737,275740,0,3,1
78791,3,1,275740,275740,275741,0,1,0
78792,6,3,275746,275746,275749,0,3,5
78793,4,1,275750,275750,275751,0,1,1
78794,4,2,275754,275754,275756,0,2,3
78795,2,2,275756,275756,275758,0,2,0
78796,5,3,275761,275761,275764,0,3,3
78797,2,2,275763,275764,275766,1,3,0
78798,4,1,275767,275767,275768,0,1,1
78799,2,2,275769,275769,275771,0,2,1
78800,2,2,275771,275771,275773,0,2,0
78801,5,2,275776,275776,275778,0,2,3
78802,4,3,275780,275780,275783,0,3,2
78803,2,1,275782,275783,275784,1,2,0
78804,4,2,275786,275786,275788,0,2,2
78805,4,3,275790,275790,275793,0,3,2
78806,6,3,275796,275796,275799,0,3,3
78807,1,2,275797,275799,275801,2,4,0
78808,1,2,275798,275801,275803,3,5,0
78809,2,1,275800,275803,275804,3,4,0
78810,6,3,275806,275806,275809,0,3,2
78811,4,2,275810,275810,275812,0,2,1
78812,5,1,275815,275815,275816,0,1,3
78813,4,2,275819,275819,275821,0,2,3
78814,5,1,275824,275824,275825,0,1,3
78815,3,3,275827,275827,275830,0,3,2
78816,3,1,275830,275830,275831,0,1,0
78817,4,3,275834,275834,275837,0,3,3
78818,5,2,275839,275839,275841,0,2,2
78819,2,1,275841,275841,275842,0,1,0
78820,6,3,275847,275847,275850,0,3,5
78821,4,2,275851,275851,275853,0,2,1
78822,3,1,275854,275854,275855,0,1,1
78823,3,3,275857,275857,275860,0,3,2
78824,2,1,275859,275860,275861,1,2,0
78825,5,1,275864,275864,275865,0,1,3
78826,1,2,275865,275865,275867,0,2,0
78827,1,3,275866,275867,275870,1,4,0
78828,1,1,275867,275870,275871,3,4,0
78829,4,2,275871,275871,275873,0,2,0
78830,6,2,275877,275877,275879,0,2,4
78831,4,2,275881,275881,275883,0,2,2
78832,5,3,275886,275886,275889,0,3,3
78833,3,2,275889,275889,275891,0,2,0
78834,2,3,275891,275891,275894,0,3,0
78835,5,1,275896,275896,275897,0,1,2
78836,1,1,275897,275897,275898,0,1,0
78837,2,1,275899,275899,275900,0,1,1
78838,4,2,275903,275903,275905,0,2,3
78839,2,1,275905,275905,275906,0,1,0
78840,2,2,275907,275907,275909,0,2,1
78841,1,1,275908,275909,275910,1,2,0
78842,1,3,275909,275910,275913,1,4,0
78843,5,3,275914,275914,275917,0,3,1
78844,6,2,275920,275920,275922,0,2,3
78845,5,1,275925,275925,275926,0,1,3
78846,1,3,275926,275926,275929,0,3,0
78847,6,2,275932,275932,275934,0,2,3
78848,6,2,275938,275938,275940,0,2,4
78849,6,1,275944,275944,275945,0,1,4
78850,5,3,275949,275949,275952,0,3,4
78851,4,3,275953,275953,275956,0,3,1
78852,1,3,275954,275956,275959,2,5,0
78853,4,1,275958,275959,275960,1,2,0
78854,4,1,275962,275962,275963,0,1,2
78855,6,1,275968,275968,275969,0,1,5
78856,6,3,275974,275974,275977,0,3,5
78857,6,2,275980,275980,275982,0,2,3
78858,3,1,275983,275983,275984,0,1,1
78859,2,1,275985,275985,275986,0,1,1
78860,5,2,275990,275990,275992,0,2,4
78861,1,1,275991,275992,275993,1,2,0
78862,5,1,275996,275996,275997,0,1,3
78863,6,2,276002,276002,276004,0,2,5
78864,6,2,276008,276008,276010,0,2,4
78865,5,3,276013,276013,276016,0,3,3
78866,3,3,276016,276016,276019,0,3,0
78867,6,1,276022,276022,276023,0,1,3
78868,5,1,276027,276027,276028,0,1,4
78869,3,2,276030,276030,276032,0,2,2
78870,5,3,276035,276035,276038,0,3,3
78871,4,3,276039,276039,276042,0,3,1
78872,3,1,276042,276042,276043,0,1,0
78873,4,1,276046,276046,276047,0,1,3
78874,3,3,276049,276049,276052,0,3,2
78875,2,1,276051,276052,276053,1,2,0
78876,6,1,276057,276057,276058,0,1,4
78877,6,3,276063,276063,276066,0,3,5
78878,6,1,276069,276069,276070,0,1,3
78879,6,2,276075,276075,276077,0,2,5
78880,6,1,276081,276081,276082,0,1,4
78881,3,3,276084,276084,276087,0,3,2
78882,6,1,276090,276090,276091,0,1,3
78883,2,3,276092,276092,276095,0,3,1
78884,5,3,276097,276097,276100,0,3,2
78885,6,1,276103,276103,276104,0,1,3
78886,5,1,276108,276108,276109,0,1,4
78887,3,1,276111,276111,276112,0,1,2
78888,5,3,276116,276116,276119,0,3,4
78889,6,1,276122,276122,276123,0,1,3
78890,6,2,276128,276128,276130,0,2,5
78891,3,1,276131,276131,276132,0,1,1
78892,2,3,276133,276133,276136,0,3,1
78893,6,3,276139,276139,276142,0,3,3
78894,1,3,276140,276142,276145,2,5,0
78895,1,3,276141,276145,276148,4,7,0
78896,4,3,276145,276148,276151,3,6,0
78897,2,1,276147,276151,276152,4,5,0
78898,2,2,276149,276152,276154,3,5,0
78899,3,3,276152,276154,276157,2,5,0
78900,4,1,276156,276157,276158,1,2,0
78901,4,1,276160,276160,276161,0,1,2
78902,2,3,276162,276162,276165,0,3,1
78903,1,2,276163,276165,276167,2,4,0
78904,4,1,276167,276167,276168,0,1,0
78905,4,3,276171,276171,276174,0,3,3
78906,3,2,276174,276174,276176,0,2,0
78907,5,3,276179,276179,276182,0,3,3
78908,2,2,276181,276182,276184,1,3,0
78909,1,2,276182,276184,276186,2,4,0
78910,3,2,276185,276186,276188,1,3,0
78911,1,1,276186,276188,276189,2,3,0
78912,1,1,276187,276189,276190,2,3,0
78913,6,3,276193,276193,276196,0,3,3
78914,1,1,276194,276196,276197,2,3,0
78915,2,1,276196,276197,276198,1,2,0
78916,2,1,276198,276198,276199,0,1,0
78917,1,1,276199,276199,276200,0,1,0
78918,4,3,276203,276203,276206,0,3,3
78919,2,3,276205,276206,276209,1,4,0
78920,5,1,276210,276210,276211,0,1,1
78921,4,1,276214,276214,276215,0,1,3
78922,4,2,276218,276218,276220,0,2,3
78923,5,3,276223,276223,276226,0,3,3
78924,6,2,276229,276229,276231,0,2,3
78925,4,1,276233,276233,276234,0,1,2
78926,2,1,276235,276235,276236,0,1,1
78927,5,1,276240,276240,276241,0,1,4
78928,4,2,276244,276244,276246,0,2,3
78929,2,1,276246,276246,276247,0,1,0
78930,5,1,276251,276251,276252,0,1,4
78931,6,3,276257,276257,276260,0,3,5
78932,1,1,276258,276260,276261,2,3,0
78933,6,1,276264,276264,276265,0,1,3
78934,5,1,276269,276269,276270,0,1,4
78935,1,3,276270,276270,276273,0,3,0
78936,3,2,276273,276273,276275,0,2,0
78937,1,1,276274,276275,276276,1,2,0
78938,5,3,276279,276279,276282,0,3,3
78939,3,3,276282,276282,276285,0,3,0
78940,4,2,276286,276286,276288,0,2,1
78941,5,1,276291,276291,276292,0,1,3
78942,4,3,276295,276295,276298,0,3,3
78943,3,1,276298,276298,276299,0,1,0
78944,2,3,276300,276300,276303,0,3,1
78945,6,1,276306,276306,276307,0,1,3
78946,1,1,276307,276307,276308,0,1,0
78947,1,2,276308,276308,276310,0,2,0
78948,5,2,276313,276313,276315,0,2,3
78949,2,1,276315,276315,276316,0,1,0
78950,6,2,276321,276321,276323,0,2,5
78951,6,3,276327,276327,276330,0,3,4
78952,3,2,276330,276330,276332,0,2,0
78953,6,3,276336,276336,276339,0,3,4
78954,4,2,276340,276340,276342,0,2,1
78955,4,1,276344,276344,276345,0,1,2
78956,2,1,276346,276346,276347,0,1,1
78957,1,3,276347,276347,276350,0,3,0
78958,1,3,276348,276350,276353,2,5,0
78959,4,2,276352,276353,276355,1,3,0
78960,6,3,276358,276358,276361,0,3,3
78961,4,2,276362,276362,276364,0,2,1
78962,4,1,276366,276366,276367,0,1,2
78963,3,2,276369,276369,276371,0,2,2
78964,6,1,276375,276375,276376,0,1,4
78965,6,2,276381,276381,276383,0,2,5
78966,5,1,276386,276386,276387,0,1,3
78967,6,3,276392,276392,276395,0,3,5
78968,1,1,276393,276395,276396,2,3,0
78969,3,2,276396,276396,276398,0,2,0
78970,4,1,276400,276400,276401,0,1,2
78971,1,2,276401,276401,276403,0,2,0
78972,1,1,276402,276403,276404,1,2,0
78973,5,2,276407,276407,276409,0,2,3
78974,6,2,276413,276413,276415,0,2,4
78975,1,3,276414,276415,276418,1,4,0
78976,1,3,276415,276418,276421,3,6,0
78977,4,1,276419,276421,276422,2,3,0
78978,3,1,276422,276422,276423,0,1,0
78979,4,3,276426,276426,276429,0,3,3
78980,1,3,276427,276429,276432,2,5,0
78981,2,1,276429,276432,276433,3,4,0
78982,3,1,276432,276433,276434,1,2,0
78983,4,2,276436,276436,276438,0,2,2
78984,3,2,276439,276439,276441,0,2,1
78985,4,2,276443,276443,276445,0,2,2
78986,4,3,276447,276447,276450,0,3,2
78987,6,1,276453,276453,276454,0,1,3
78988,5,2,276458,276458,276460,0,2,4
78989,6,3,276464,276464,276467,0,3,4
78990,1,2,276465,276467,276469,2,4,0
78991,2,1,276467,276469,276470,2,3,0
78992,2,1,276469,276470,276471,1,2,0
78993,2,3,276471,276471,276474,0,3,0
78994,5,3,276476,276476,276479,0,3,2
78995,5,3,276481,276481,276484,0,3,2
78996,3,3,276484,276484,276487,0,3,0
78997,4,3,276488,276488,276491,0,3,1
78998,5,2,276493,276493,276495,0,2,2
78999,3,1,276496,276496,276497,0,1,1
79000,3,2,276499,276499,276501,0,2,2
79001,5,3,276504,276504,276507,0,3,3
79002,5,2,276509,276509,276511,0,2,2
79003,1,3,276510,276511,276514,1,4,0
79004,2,1,276512,276514,276515,2,3,0
79005,2,1,276514,276515,276516,1,2,0
79006,6,2,276520,276520,276522,0,2,4
79007,4,2,276524,276524,276526,0,2,2
79008,2,3,276526,276526,276529,0,3,0
79009,4,1,276530,276530,276531,0,1,1
79010,4,1,276534,276534,276535,0,1,3
79011,2,1,276536,276536,276537,0,1,1
79012,5,3,276541,276541,276544,0,3,4
79013,4,1,276545,276545,276546,0,1,1
79014,2,3,276547,276547,276550,0,3,1
79015,1,1,276548,276550,276551,2,3,0
79016,2,2,276550,276551,276553,1,3,0
79017,1,1,276551,276553,276554,2,3,0
79018,6,3,276557,276557,276560,0,3,3
79019,1,3,276558,276560,276563,2,5,0
79020,6,3,276564,276564,276567,0,3,1
79021,1,1,276565,276567,276568,2,3,0
79022,5,1,276570,276570,276571,0,1,2
79023,1,2,276571,276571,276573,0,2,0
79024,1,3,276572,276573,276576,1,4,0
79025,2,3,276574,276576,276579,2,5,0
79026,1,3,276575,276579,276582,4,7,0
79027,1,2,276576,276582,276584,6,8,0
79028,1,3,276577,276584,276587,7,10,0
79029,4,1,276581,276587,276588,6,7,0
79030,1,3,276582,276588,276591,6,9,0
79031,3,2,276585,276591,276593,6,8,0
79032,5,3,276590,276593,276596,3,6,0
79033,2,2,276592,276596,276598,4,6,0
79034,6,1,276598,276598,276599,0,1,0
79035,3,1,276601,276601,276602,0,1,2
79036,1,3,276602,276602,276605,0,3,0
79037,5,3,276607,276607,276610,0,3,2
79038,4,2,276611,276611,276613,0,2,1
79039,5,2,276616,276616,276618,0,2,3
79040,1,2,276617,276618,276620,1,3,0
79041,2,3,276619,276620,276623,1,4,0
79042,1,1,276620,276623,276624,3,4,0
79043,5,1,276625,276625,276626,0,1,1
79044,5,3,276630,276630,276633,0,3,4
79045,5,1,276635,276635,276636,0,1,2
79046,4,2,276639,276639,276641,0,2,3
79047,1,1,276640,276641,276642,1,2,0
79048,5,2,276645,276645,276647,0,2,3
79049,5,3,276650,276650,276653,0,3,3
79050,3,1,276653,276653,276654,0,1,0
79051,5,1,276658,276658,276659,0,1,4
79052,5,1,276663,276663,276664,0,1,4
79053,1,1,276664,276664,276665,0,1,0
79054,4,2,276668,276668,276670,0,2,3
79055,2,3,276670,276670,276673,0,3,0
79056,5,2,276675,276675,276677,0,2,2
79057,1,1,276676,276677,276678,1,2,0
79058,6,1,276682,276682,276683,0,1,4
79059,6,3,276688,276688,276691,0,3,5
79060,3,1,276691,276691,276692,0,1,0
79061,3,2,276694,276694,276696,0,2,2
79062,4,3,276698,276698,276701,0,3,2
79063,6,3,276704,276704,276707,0,3,3
79064,2,2,276706,276707,276709,1,3,0
79065,4,3,276710,276710,276713,0,3,1
79066,5,3,276715,276715,276718,0,3,2
79067,6,3,276721,276721,276724,0,3,3
79068,2,1,276723,276724,276725,1,2,0
79069,3,3,276726,276726,276729,0,3,1
79070,4,3,276730,276730,276733,0,3,1
79071,1,2,276731,276733,276735,2,4,0
79072,5,1,276736,276736,276737,0,1,1
79073,3,2,276739,276739,276741,0,2,2
79074,5,1,276744,276744,276745,0,1,3
79075,6,3,276750,276750,276753,0,3,5
79076,3,1,276753,276753,276754,0,1,0
79077,1,3,276754,276754,276757,0,3,0
79078,1,3,276755,276757,276760,2,5,0
79079,4,2,276759,276760,276762,1,3,0
79080,4,2,276763,276763,276765,0,2,1
79081,3,1,276766,276766,276767,0,1,1
79082,6,1,276772,276772,276773,0,1,5
79083,1,2,276773,276773,276775,0,2,0
79084,6,3,276779,276779,276782,0,3,4
79085,4,2,276783,276783,276785,0,2,1
79086,3,1,276786,276786,276787,0,1,1
79087,6,1,276792,276792,276793,0,1,5
79088,6,2,276798,276798,276800,0,2,5
79089,5,1,276803,276803,276804,0,1,3
79090,2,3,276805,276805,276808,0,3,1
79091,4,1,276809,276809,276810,0,1,1
79092,4,1,276813,276813,276814,0,1,3
79093,3,1,276816,276816,276817,0,1,2
79094,1,3,276817,276817,276820,0,3,0
79095,3,3,276820,276820,276823,0,3,0
79096,4,2,276824,276824,276826,0,2,1
79097,5,2,276829,276829,276831,0,2,3
79098,3,2,276832,276832,276834,0,2,1
79099,4,3,276836,276836,276839,0,3,2
79100,5,3,276841,276841,276844,0,3,2
79101,2,1,276843,276844,276845,1,2,0
79102,5,1,276848,276848,276849,0,1,3
79103,5,1,276853,276853,276854,0,1,4
79104,4,1,276857,276857,276858,0,1,3
79105,5,2,276862,276862,276864,0,2,4
79106,5,3,276867,276867,276870,0,3,3
79107,6,3,276873,276873,276876,0,3,3
79108,6,1,276879,276879,276880,0,1,3
79109,6,2,276885,276885,276887,0,2,5
79110,2,1,276887,276887,276888,0,1,0
79111,2,3,276889,276889,276892,0,3,1
79112,5,2,276894,276894,276896,0,2,2
79113,4,3,276898,276898,276901,0,3,2
79114,4,1,276902,276902,276903,0,1,1
79115,4,3,276906,276906,276909,0,3,3
79116,5,1,276911,276911,276912,0,1,2
79117,4,3,276915,276915,276918,0,3,3
79118,3,3,276918,276918,276921,0,3,0
79119,3,1,276921,276921,276922,0,1,0
79120,1,1,276922,276922,276923,0,1,0
79121,2,2,276924,276924,276926,0,2,1
79122,2,1,276926,276926,276927,0,1,0
79123,5,2,276931,276931,276933,0,2,4
79124,6,1,276937,276937,276938,0,1,4
79125,6,3,276943,276943,276946,0,3,5
79126,5,2,276948,276948,276950,0,2,2
79127,2,2,276950,276950,276952,0,2,0
79128,6,3,276956,276956,276959,0,3,4
79129,3,2,276959,276959,276961,0,2,0
79130,5,2,276964,276964,276966,0,2,3
79131,3,1,276967,276967,276968,0,1,1
79132,3,1,276970,276970,276971,0,1,2
79133,2,1,276972,276972,276973,0,1,1
79134,4,1,276976,276976,276977,0,1,3
79135,1,1,276977,276977,276978,0,1,0
79136,2,1,276979,276979,276980,0,1,1
79137,6,2,276985,276985,276987,0,2,5
79138,1,1,276986,276987,276988,1,2,0
79139,4,1,276990,276990,276991,0,1,2
79140,2,2,276992,276992,276994,0,2,1
79141,6,3,276998,276998,277001,0,3,4
79142,3,2,277001,277001,277003,0,2,0
79143,5,1,277006,277006,277007,0,1,3
79144,1,2,277007,277007,277009,0,2,0
79145,4,1,277011,277011,277012,0,1,2
79146,6,1,277017,277017,277018,0,1,5
79147,2,2,277019,277019,277021,0,2,1
79148,4,2,277023,277023,277025,0,2,2
79149,5,1,277028,277028,277029,0,1,3
79150,2,2,277030,277030,277032,0,2,1
79151,4,2,277034,277034,277036,0,2,2
79152,1,2,277035,277036,277038,1,3,0
79153,5,3,277040,277040,277043,0,3,2
79154,4,2,277044,277044,277046,0,2,1
79155,4,1,277048,277048,277049,0,1,2
79156,4,1,277052,277052,277053,0,1,3
79157,4,2,277056,277056,277058,0,2,3
79158,2,3,277058,277058,277061,0,3,0
79159,4,3,277062,277062,277065,0,3,1
79160,3,2,277065,277065,277067,0,2,0
79161,4,1,277069,277069,277070,0,1,2
79162,3,1,277072,277072,277073,0,1,2
79163,5,3,277077,277077,277080,0,3,4
79164,2,2,277079,277080,277082,1,3,0
79165,1,1,277080,277082,277083,2,3,0
79166,1,2,277081,277083,277085,2,4,0
79167,3,1,277084,277085,277086,1,2,0
79168,2,3,277086,277086,277089,0,3,0
79169,5,2,277091,277091,277093,0,2,2
79170,1,2,277092,277093,277095,1,3,0
79171,3,2,277095,277095,277097,0,2,0
79172,1,3,277096,277097,277100,1,4,0
79173,3,1,277099,277100,277101,1,2,0
79174,6,3,277105,277105,277108,0,3,4
79175,4,1,277109,277109,277110,0,1,1
79176,2,1,277111,277111,277112,0,1,1
79177,2,2,277113,277113,277115,0,2,1
79178,4,2,277117,277117,277119,0,2,2
79179,1,2,277118,277119,277121,1,3,0
79180,1,3,277119,277121,277124,2,5,0
79181,3,2,277122,277124,277126,2,4,0
79182,4,2,277126,277126,277128,0,2,0
79183,2,1,277128,277128,277129,0,1,0
79184,1,3,277129,277129,277132,0,3,0
79185,3,3,277132,277132,277135,0,3,0
79186,4,1,277136,277136,277137,0,1,1
79187,5,1,277141,277141,277142,0,1,4
79188,4,2,277145,277145,277147,0,2,3
79189,1,3,277146,277147,277150,1,4,0
79190,4,3,277150,277150,277153,0,3,0
79191,2,3,277152,277153,277156,1,4,0
79192,5,3,277157,277157,277160,0,3,1
79193,4,3,277161,277161,277164,0,3,1
79194,2,1,277163,277164,277165,1,2,0
79195,5,3,277168,277168,277171,0,3,3
79196,3,1,277171,277171,277172,0,1,0
79197,3,1,277174,277174,277175,0,1,2
79198,6,1,277180,277180,277181,0,1,5
79199,3,3,277183,277183,277186,0,3,2
79200,2,3,277185,277186,277189,1,4,0
79201,1,3,277186,277189,277192,3,6,0
79202,4,2,277190,277192,277194,2,4,0
79203,3,2,277193,277194,277196,1,3,0
79204,3,1,277196,277196,277197,0,1,0
79205,2,1,277198,277198,277199,0,1,1
79206,1,2,277199,277199,277201,0,2,0
79207,1,3,277200,277201,277204,1,4,0
79208,1,2,277201,277204,277206,3,5,0
79209,4,3,277205,277206,277209,1,4,0
79210,2,1,277207,277209,277210,2,3,0
79211,3,1,277210,277210,277211,0,1,0
79212,2,3,277212,277212,277215,0,3,1
79213,5,1,277217,277217,277218,0,1,2
79214,4,1,277221,277221,277222,0,1,3
79215,4,3,277225,277225,277228,0,3,3
79216,2,3,277227,277228,277231,1,4,0
79217,2,1,277229,277231,277232,2,3,0
79218,5,2,277234,277234,277236,0,2,2
79219,6,3,277240,277240,277243,0,3,4
79220,1,3,277241,277243,277246,2,5,0
79221,2,1,277243,277246,277247,3,4,0
79222,3,1,277246,277247,277248,1,2,0
79223,3,2,277249,277249,277251,0,2,1
79224,6,3,277255,277255,277258,0,3,4
79225,1,3,277256,277258,277261,2,5,0
79226,2,3,277258,277261,277264,3,6,0
79227,2,3,277260,277264,277267,4,7,0
79228,1,2,277261,277267,277269,6,8,0
79229,2,2,277263,277269,277271,6,8,0
79230,2,1,277265,277271,277272,6,7,0
79231,3,3,277268,277272,277275,4,7,0
79232,4,2,277272,277275,277277,3,5,0
79233,2,3,277274,277277,277280,3,6,0
79234,6,3,277280,277280,277283,0,3,0
79235,3,2,277283,277283,277285,0,2,0
79236,1,2,277284,277285,277287,1,3,0
79237,5,1,277289,277289,277290,0,1,2
79238,1,3,277290,277290,277293,0,3,0
79239,3,2,277293,277293,277295,0,2,0
79240,4,2,277297,277297,277299,0,2,2
79241,5,1,277302,277302,277303,0,1,3
79242,2,2,277304,277304,277306,0,2,1
79243,1,3,277305,277306,277309,1,4,0
79244,2,1,277307,277309,277310,2,3,0
79245,3,3,277310,277310,277313,0,3,0
79246,2,2,277312,277313,277315,1,3,0
79247,1,2,277313,277315,277317,2,4,0
79248,3,3,277316,277317,277320,1,4,0
79249,3,3,277319,277320,277323,1,4,0
79250,6,1,277325,277325,277326,0,1,2
79251,2,1,277327,277327,277328,0,1,1
79252,5,3,277332,277332,277335,0,3,4
79253,5,2,277337,277337,277339,0,2,2
79254,4,3,277341,277341,277344,0,3,2
79255,2,1,277343,277344,277345,1,2,0
79256,3,1,277346,277346,277347,0,1,1
79257,6,2,277352,277352,277354,0,2,5
79258,2,2,277354,277354,277356,0,2,0
79259,5,2,277359,277359,277361,0,2,3
79260,6,3,277365,277365,277368,0,3,4
79261,5,1,277370,277370,277371,0,1,2
79262,5,1,277375,277375,277376,0,1,4
79263,5,3,277380,277380,277383,0,3,4
79264,1,2,277381,277383,277385,2,4,0
79265,6,1,277387,277387,277388,0,1,2
79266,2,1,277389,277389,277390,0,1,1
79267,3,2,277392,277392,277394,0,2,2
79268,4,3,277396,277396,277399,0,3,2
79269,3,1,277399,277399,277400,0,1,0
79270,1,3,277400,277400,277403,0,3,0
79271,4,3,277404,277404,277407,0,3,1
79272,3,1,277407,277407,277408,0,1,0
79273,3,1,277410,277410,277411,0,1,2
79274,6,3,277416,277416,277419,0,3,5
79275,3,2,277419,277419,277421,0,2,0
79276,5,2,277424,277424,277426,0,2,3
79277,1,2,277425,277426,277428,1,3,0
79278,2,2,277427,277428,277430,1,3,0
79279,2,1,277429,277430,277431,1,2,0
79280,6,2,277435,277435,277437,0,2,4
79281,6,3,277441,277441,277444,0,3,4
79282,6,1,277447,277447,277448,0,1,3
79283,1,1,277448,277448,277449,0,1,0
79284,1,2,277449,277449,277451,0,2,0
79285,3,1,277452,277452,277453,0,1,1
79286,1,3,277453,277453,277456,0,3,0
79287,3,3,277456,277456,277459,0,3,0
79288,4,3,277460,277460,277463,0,3,1
79289,3,2,277463,277463,277465,0,2,0
79290,6,3,277469,277469,277472,0,3,4
79291,5,3,277474,277474,277477,0,3,2
79292,3,1,277477,277477,277478,0,1,0
79293,2,2,277479,277479,277481,0,2,1
79294,6,1,277485,277485,277486,0,1,4
79295,4,3,277489,277489,277492,0,3,3
79296,3,3,277492,277492,277495,0,3,0
79297,6,3,277498,277498,277501,0,3,3
79298,1,1,277499,277501,277502,2,3,0
79299,5,2,277504,277504,277506,0,2,2
79300,4,2,277508,277508,277510,0,2,2
79301,3,3,277511,277511,277514,0,3,1
79302,4,2,277515,277515,277517,0,2,1
79303,1,3,277516,277517,277520,1,4,0
79304,1,2,277517,277520,277522,3,5,0
79305,3,1,277520,277522,277523,2,3,0
79306,4,1,277524,277524,277525,0,1,1
79307,6,2,277530,277530,277532,0,2,5
79308,2,1,277532,277532,277533,0,1,0
79309,6,3,277538,277538,277541,0,3,5
79310,2,3,277540,277541,277544,1,4,0
79311,4,1,277544,277544,277545,0,1,0
79312,6,1,277550,277550,277551,0,1,5
79313,4,2,277554,277554,277556,0,2,3
79314,5,2,277559,277559,277561,0,2,3
79315,3,1,277562,277562,277563,0,1,1
79316,6,2,277568,277568,277570,0,2,5
79317,4,2,277572,277572,277574,0,2,2
79318,2,1,277574,277574,277575,0,1,0
79319,5,1,277579,277579,277580,0,1,4
79320,1,2,277580,277580,277582,0,2,0
79321,6,3,277586,277586,277589,0,3,4
79322,5,2,277591,277591,277593,0,2,2
79323,2,3,277593,277593,277596,0,3,0
79324,4,2,277597,277597,277599,0,2,1
79325,2,1,277599,277599,277600,0,1,0
79326,1,3,277600,277600,277603,0,3,0
79327,5,2,277605,277605,277607,0,2,2
79328,3,3,277608,277608,277611,0,3,1
79329,3,3,277611,277611,277614,0,3,0
79330,3,3,277614,277614,277617,0,3,0
79331,1,1,277615,277617,277618,2,3,0
79332,6,3,277621,277621,277624,0,3,3
79333,5,3,277626,277626,277629,0,3,2
79334,6,1,277632,277632,277633,0,1,3
79335,4,1,277636,277636,277637,0,1,3
79336,6,1,277642,277642,277643,0,1,5
79337,2,1,277644,277644,277645,0,1,1
79338,3,1,277647,277647,277648,0,1,2
79339,2,2,277649,277649,277651,0,2,1
79340,2,2,277651,277651,277653,0,2,0
79341,5,3,277656,277656,277659,0,3,3
79342,3,2,277659,277659,277661,0,2,0
79343,3,3,277662,277662,277665,0,3,1
79344,6,2,277668,277668,277670,0,2,3
79345,1,1,277669,277670,277671,1,2,0
79346,5,3,277674,277674,277677,0,3,3
79347,5,2,277679,277679,277681,0,2,2
79348,5,2,277684,277684,277686,0,2,3
79349,6,3,277690,277690,277693,0,3,4
79350,2,1,277692,277693,277694,1,2,0
79351,6,2,277698,277698,277700,0,2,4
79352,6,2,277704,277704,277706,0,2,4
79353,1,3,277705,277706,277709,1,4,0
79354,4,3,277709,277709,277712,0,3,0
79355,4,3,277713,277713,277716,0,3,1
79356,5,1,277718,277718,277719,0,1,2
79357,5,3,277723,277723,277726,0,3,4
79358,6,2,277729,277729,277731,0,2,3
79359,4,1,277733,277733,277734,0,1,2
79360,3,2,277736,277736,277738,0,2,2
79361,2,1,277738,277738,277739,0,1,0
79362,4,1,277742,277742,277743,0,1,3
79363,6,2,277748,277748,277750,0,2,5
79364,4,1,277752,277752,277753,0,1,2
79365,4,3,277756,277756,277759,0,3,3
79366,6,1,277762,277762,277763,0,1,3
79367,5,2,277767,277767,277769,0,2,4
79368,2,1,277769,277769,277770,0,1,0
79369,6,3,277775,277775,277778,0,3,5
79370,1,2,277776,277778,277780,2,4,0
79371,3,1,277779,277780,277781,1,2,0
79372,6,3,277785,277785,277788,0,3,4
79373,3,2,277788,277788,277790,0,2,0
79374,6,3,277794,277794,277797,0,3,4
79375,6,2,277800,277800,277802,0,2,3
79376,3,2,277803,277803,277805,0,2,1
79377,6,1,277809,277809,277810,0,1,4
79378,4,2,277813,277813,277815,0,2,3
79379,4,3,277817,277817,277820,0,3,2
79380,5,2,277822,277822,277824,0,2,2
79381,1,2,277823,277824,277826,1,3,0
79382,1,2,277824,277826,277828,2,4,0
79383,1,2,277825,277828,277830,3,5,0
79384,4,1,277829,277830,277831,1,2,0
79385,1,3,277830,277831,277834,1,4,0
79386,6,1,277836,277836,277837,0,1,2
79387,5,3,277841,277841,277844,0,3,4
79388,3,2,277844,277844,277846,0,2,0
79389,5,2,277849,277849,277851,0,2,3
79390,4,3,277853,277853,277856,0,3,2
79391,5,2,277858,277858,277860,0,2,2
79392,3,1,277861,277861,277862,0,1,1
79393,2,1,277863,277863,277864,0,1,1
79394,1,1,277864,277864,277865,0,1,0
79395,3,1,277867,277867,277868,0,1,2
79396,4,3,277871,277871,277874,0,3,3
79397,1,2,277872,277874,277876,2,4,0
79398,3,2,277875,277876,277878,1,3,0
79399,3,2,277878,277878,277880,0,2,0
79400,4,2,277882,277882,277884,0,2,2
79401,3,3,277885,277885,277888,0,3,1
79402,1,3,277886,277888,277891,2,5,0
79403,2,2,277888,277891,277893,3,5,0
79404,2,1,277890,277893,277894,3,4,0
79405,2,3,277892,277894,277897,2,5,0
79406,1,2,277893,277897,277899,4,6,0
79407,1,1,277894,277899,277900,5,6,0
79408,3,3,277897,277900,277903,3,6,0
79409,6,3,277903,277903,277906,0,3,0
79410,3,1,277906,277906,277907,0,1,0
79411,2,3,277908,277908,277911,0,3,1
79412,6,3,277914,277914,277917,0,3,3
79413,1,3,277915,277917,277920,2,5,0
79414,1,2,277916,277920,277922,4,6,0
79415,5,3,277921,277922,277925,1,4,0
79416,3,1,277924,277925,277926,1,2,0
79417,6,2,277930,277930,277932,0,2,4
79418,6,2,277936,277936,277938,0,2,4
79419,6,1,277942,277942,277943,0,1,4
79420,4,3,277946,277946,277949,0,3,3
79421,6,1,277952,277952,277953,0,1,3
79422,2,3,277954,277954,277957,0,3,1
79423,2,2,277956,277957,277959,1,3,0
79424,3,1,277959,277959,277960,0,1,0
79425,6,3,277965,277965,277968,0,3,5
79426,5,1,277970,277970,277971,0,1,2
79427,3,1,277973,277973,277974,0,1,2
79428,6,1,277979,277979,277980,0,1,5
79429,2,1,277981,277981,277982,0,1,1
79430,2,3,277983,277983,277986,0,3,1
79431,3,3,277986,277986,277989,0,3,0
79432,2,3,277988,277989,277992,1,4,0
79433,6,3,277994,277994,277997,0,3,2
79434,5,2,277999,277999,278001,0,2,2
79435,3,3,278002,278002,278005,0,3,1
79436,1,2,278003,278005,278007,2,4,0
79437,5,1,278008,278008,278009,0,1,1
79438,5,1,278013,278013,278014,0,1,4
79439,2,2,278015,278015,278017,0,2,1
79440,6,1,278021,278021,278022,0,1,4
79441,6,2,278027,278027,278029,0,2,5
79442,2,1,278029,278029,278030,0,1,0
79443,1,2,278030,278030,278032,0,2,0
79444,3,3,278033,278033,278036,0,3,1
79445,3,1,278036,278036,278037,0,1,0
79446,1,1,278037,278037,278038,0,1,0
79447,5,2,278042,278042,278044,0,2,4
79448,5,1,278047,278047,278048,0,1,3
79449,4,1,278051,278051,278052,0,1,3
79450,2,2,278053,278053,278055,0,2,1
79451,6,3,278059,278059,278062,0,3,4
79452,2,1,278061,278062,278063,1,2,0
79453,5,1,278066,278066,278067,0,1,3
79454,2,2,278068,278068,278070,0,2,1
79455,5,1,278073,278073,278074,0,1,3
79456,1,3,278074,278074,278077,0,3,0
79457,2,1,278076,278077,278078,1,2,0
79458,4,1,278080,278080,278081,0,1,2
79459,5,3,278085,278085,278088,0,3,4
79460,4,3,278089,278089,278092,0,3,1
79461,6,2,278095,278095,278097,0,2,3
79462,4,1,278099,278099,278100,0,1,2
79463,2,2,278101,278101,278103,0,2,1
79464,1,1,278102,278103,278104,1,2,0
79465,2,1,278104,278104,278105,0,1,0
79466,4,3,278108,278108,278111,0,3,3
79467,5,3,278113,278113,278116,0,3,2
79468,2,3,278115,278116,278119,1,4,0
79469,6,2,278121,278121,278123,0,2,2
79470,1,3,278122,278123,278126,1,4,0
79471,5,2,278127,278127,278129,0,2,1
79472,5,3,278132,278132,278135,0,3,3
79473,5,2,278137,278137,278139,0,2,2
79474,2,1,278139,278139,278140,0,1,0
79475,4,3,278143,278143,278146,0,3,3
79476,4,1,278147,278147,278148,0,1,1
79477,2,3,278149,278149,278152,0,3,1
79478,6,3,278155,278155,278158,0,3,3
79479,3,3,278158,278158,278161,0,3,0
79480,6,2,278164,278164,278166,0,2,3
79481,1,3,278165,278166,278169,1,4,0
79482,6,3,278171,278171,278174,0,3,2
79483,3,2,278174,278174,278176,0,2,0
79484,4,3,278178,278178,278181,0,3,2
79485,4,2,278182,278182,278184,0,2,1
79486,4,2,278186,278186,278188,0,2,2
79487,3,3,278189,278189,278192,0,3,1
79488,1,2,278190,278192,278194,2,4,0
79489,2,2,278192,278194,278196,2,4,0
79490,5,2,278197,278197,278199,0,2,1
79491,1,3,278198,278199,278202,1,4,0
79492,5,2,278203,278203,278205,0,2,1
79493,6,3,278209,278209,278212,0,3,4
79494,1,2,278210,278212,278214,2,4,0
79495,5,2,278215,278215,278217,0,2,1
79496,2,2,278217,278217,278219,0,2,0
79497,4,1,278221,278221,278222,0,1,2
79498,6,2,278227,278227,278229,0,2,5
79499,5,1,278232,278232,278233,0,1,3
79500,4,3,278236,278236,278239,0,3,3
79501,3,3,278239,278239,278242,0,3,0
79502,1,3,278240,278242,278245,2,5,0
79503,4,1,278244,278245,278246,1,2,0
79504,3,1,278247,278247,278248,0,1,1
79505,3,3,278250,278250,278253,0,3,2
79506,5,3,278255,278255,278258,0,3,2
79507,1,3,278256,278258,278261,2,5,0
79508,6,3,278262,278262,278265,0,3,1
79509,1,1,278263,278265,278266,2,3,0
79510,1,1,278264,278266,278267,2,3,0
79511,4,3,278268,278268,278271,0,3,1
79512,6,3,278274,278274,278277,0,3,3
79513,5,1,278279,278279,278280,0,1,2
79514,6,3,278285,278285,278288,0,3,5
79515,2,1,278287,278288,278289,1,2,0
79516,2,2,278289,278289,278291,0,2,0
79517,5,1,278294,278294,278295,0,1,3
79518,3,1,278297,278297,278298,0,1,2
79519,3,1,278300,278300,278301,0,1,2
79520,1,1,278301,278301,278302,0,1,0
79521,3,1,278304,278304,278305,0,1,2
79522,5,1,278309,278309,278310,0,1,4
79523,5,1,278314,278314,278315,0,1,4
79524,4,3,278318,278318,278321,0,3,3
79525,3,1,278321,278321,278322,0,1,0
79526,2,1,278323,278323,278324,0,1,1
79527,2,1,278325,278325,278326,0,1,1
79528,5,2,278330,278330,278332,0,2,4
79529,1,2,278331,278332,278334,1,3,0
79530,4,1,278335,278335,278336,0,1,1
79531,4,2,278339,278339,278341,0,2,3
79532,6,3,278345,278345,278348,0,3,4
79533,1,2,278346,278348,278350,2,4,0
79534,3,2,278349,278350,278352,1,3,0
79535,6,2,278355,278355,278357,0,2,3
79536,5,2,278360,278360,278362,0,2,3
79537,3,3,278363,278363,278366,0,3,1
79538,2,2,278365,278366,278368,1,3,0
79539,1,3,278366,278368,278371,2,5,0
79540,5,1,278371,278371,278372,0,1,0
79541,1,3,278372,278372,278375,0,3,0
79542,4,3,278376,278376,278379,0,3,1
79543,6,2,278382,278382,278384,0,2,3
79544,4,3,278386,278386,278389,0,3,2
79545,3,2,278389,278389,278391,0,2,0
79546,5,3,278394,278394,278397,0,3,3
79547,2,3,278396,278397,278400,1,4,0
79548,1,3,278397,278400,278403,3,6,0
79549,2,2,278399,278403,278405,4,6,0
79550,1,1,278400,278405,278406,5,6,0
79551,1,1,278401,278406,278407,5,6,0
79552,6,3,278407,278407,278410,0,3,0
79553,1,3,278408,278410,278413,2,5,0
79554,6,1,278414,278414,278415,0,1,1
79555,6,3,278420,278420,278423,0,3,5
79556,3,2,278423,278423,278425,0,2,0
79557,4,1,278427,278427,278428,0,1,2
79558,1,3,278428,278428,278431,0,3,0
79559,3,2,278431,278431,278433,0,2,0
79560,4,2,278435,278435,278437,0,2,2
79561,3,3,278438,278438,278441,0,3,1
79562,2,1,278440,278441,278442,1,2,0
79563,3,3,278443,278443,278446,0,3,1
79564,3,1,278446,278446,278447,0,1,0
79565,2,2,278448,278448,278450,0,2,1
79566,5,3,278453,278453,278456,0,3,3
79567,1,2,278454,278456,278458,2,4,0
79568,6,1,278460,278460,278461,0,1,2
79569,1,3,278461,278461,278464,0,3,0
79570,6,1,278467,278467,278468,0,1,3
79571,6,3,278473,278473,278476,0,3,5
79572,2,3,278475,278476,278479,1,4,0
79573,3,3,278478,278479,278482,1,4,0
79574,4,3,278482,278482,278485,0,3,0
79575,5,2,278487,278487,278489,0,2,2
79576,5,3,278492,278492,278495,0,3,3
79577,4,2,278496,278496,278498,0,2,1
79578,5,1,278501,278501,278502,0,1,3
79579,5,1,278506,278506,278507,0,1,4
79580,2,3,278508,278508,278511,0,3,1
79581,4,2,278512,278512,278514,0,2,1
79582,4,1,278516,278516,278517,0,1,2
79583,3,1,278519,278519,278520,0,1,2
79584,4,1,278523,278523,278524,0,1,3
79585,2,3,278525,278525,278528,0,3,1
79586,1,3,278526,278528,278531,2,5,0
79587,4,1,278530,278531,278532,1,2,0
79588,1,1,278531,278532,278533,1,2,0
79589,3,3,278534,278534,278537,0,3,1
79590,1,2,278535,278537,278539,2,4,0
79591,4,3,278539,278539,278542,0,3,0
79592,4,3,278543,278543,278546,0,3,1
79593,1,2,278544,278546,278548,2,4,0
79594,1,3,278545,278548,278551,3,6,0
79595,6,2,278551,278551,278553,0,2,0
79596,5,2,278556,278556,278558,0,2,3
79597,5,2,278561,278561,278563,0,2,3
79598,3,3,278564,278564,278567,0,3,1
79599,3,1,278567,278567,278568,0,1,0
79600,2,1,278569,278569,278570,0,1,1
79601,2,2,278571,278571,278573,0,2,1
79602,3,2,278574,278574,278576,0,2,1
79603,6,3,278580,278580,278583,0,3,4
79604,5,1,278585,278585,278586,0,1,2
79605,1,3,278586,278586,278589,0,3,0
79606,3,3,278589,278589,278592,0,3,0
79607,4,2,278593,278593,278595,0,2,1
79608,6,1,278599,278599,278600,0,1,4
79609,5,3,278604,278604,278607,0,3,4
79610,2,3,278606,278607,278610,1,4,0
79611,6,1,278612,278612,278613,0,1,2
79612,5,1,278617,278617,278618,0,1,4
79613,3,3,278620,278620,278623,0,3,2
79614,3,1,278623,278623,278624,0,1,0
79615,5,3,278628,278628,278631,0,3,4
79616,6,2,278634,278634,278636,0,2,3
79617,1,3,278635,278636,278639,1,4,0
79618,1,1,278636,278639,278640,3,4,0
79619,6,1,278642,278642,278643,0,1,2
79620,1,2,278643,278643,278645,0,2,0
79621,2,3,278645,278645,278648,0,3,0
79622,1,2,278646,278648,278650,2,4,0
79623,6,3,278652,278652,278655,0,3,2
79624,1,3,278653,278655,278658,2,5,0
79625,5,3,278658,278658,278661,0,3,0
79626,4,3,278662,278662,278665,0,3,1
79627,1,1,278663,278665,278666,2,3,0
79628,1,3,278664,278666,278669,2,5,0
79629,5,3,278669,278669,278672,0,3,0
79630,5,3,278674,278674,278677,0,3,2
79631,5,3,278679,278679,278682,0,3,2
79632,6,3,278685,278685,278688,0,3,3
79633,2,3,278687,278688,278691,1,4,0
79634,2,3,278689,278691,278694,2,5,0
79635,1,2,278690,278694,278696,4,6,0
79636,4,1,278694,278696,278697,2,3,0
79637,1,1,278695,278697,278698,2,3,0
79638,4,2,278699,278699,278701,0,2,1
79639,6,3,278705,278705,278708,0,3,4
79640,2,3,278707,278708,278711,1,4,0
79641,2,2,278709,278711,278713,2,4,0
79642,6,2,278715,278715,278717,0,2,2
79643,3,1,278718,278718,278719,0,1,1
79644,4,3,278722,278722,278725,0,3,3
79645,3,1,278725,278725,278726,0,1,0
79646,1,3,278726,278726,278729,0,3,0
79647,4,2,278730,278730,278732,0,2,1
79648,4,2,278734,278734,278736,0,2,2
79649,6,3,278740,278740,278743,0,3,4
79650,5,3,278745,278745,278748,0,3,2
79651,3,1,278748,278748,278749,0,1,0
79652,5,3,278753,278753,278756,0,3,4
79653,6,2,278759,278759,278761,0,2,3
79654,5,2,278764,278764,278766,0,2,3
79655,5,1,278769,278769,278770,0,1,3
79656,2,2,278771,278771,278773,0,2,1
79657,6,3,278777,278777,278780,0,3,4
79658,1,2,278778,278780,278782,2,4,0
79659,2,2,278780,278782,278784,2,4,0
79660,4,1,278784,278784,278785,0,1,0
79661,1,1,278785,278785,278786,0,1,0
79662,4,2,278789,278789,278791,0,2,3
79663,4,3,278793,278793,278796,0,3,2
79664,4,1,278797,278797,278798,0,1,1
79665,5,3,278802,278802,278805,0,3,4
79666,1,2,278803,278805,278807,2,4,0
79667,4,2,278807,278807,278809,0,2,0
79668,1,1,278808,278809,278810,1,2,0
79669,6,2,278814,278814,278816,0,2,4
79670,4,2,278818,278818,278820,0,2,2
79671,6,2,278824,278824,278826,0,2,4
79672,4,2,278828,278828,278830,0,2,2
79673,2,1,278830,278830,278831,0,1,0
79674,3,3,278833,278833,278836,0,3,2
79675,4,1,278837,278837,278838,0,1,1
79676,2,1,278839,278839,278840,0,1,1
79677,1,1,278840,278840,278841,0,1,0
79678,5,3,278845,278845,278848,0,3,4
79679,1,2,278846,278848,278850,2,4,0
79680,3,2,278849,278850,278852,1,3,0
79681,4,1,278853,278853,278854,0,1,1
79682,1,2,278854,278854,278856,0,2,0
79683,1,3,278855,278856,278859,1,4,0
79684,5,1,278860,278860,278861,0,1,1
79685,4,1,278864,278864,278865,0,1,3
79686,5,3,278869,278869,278872,0,3,4
79687,3,2,278872,278872,278874,0,2,0
79688,3,2,278875,278875,278877,0,2,1
79689,6,1,278881,278881,278882,0,1,4
79690,5,1,278886,278886,278887,0,1,4
79691,3,1,278889,278889,278890,0,1,2
79692,2,1,278891,278891,278892,0,1,1
79693,4,2,278895,278895,278897,0,2,3
79694,3,2,278898,278898,278900,0,2,1
79695,2,2,278900,278900,278902,0,2,0
79696,1,3,278901,278902,278905,1,4,0
79697,3,3,278904,278905,278908,1,4,0
79698,4,1,278908,278908,278909,0,1,0
79699,3,2,278911,278911,278913,0,2,2
79700,5,2,278916,278916,278918,0,2,3
79701,3,1,278919,278919,278920,0,1,1
79702,2,3,278921,278921,278924,0,3,1
79703,5,3,278926,278926,278929,0,3,2
79704,1,1,278927,278929,278930,2,3,0
79705,1,2,278928,278930,278932,2,4,0
79706,1,3,278929,278932,278935,3,6,0
79707,6,2,278935,278935,278937,0,2,0
79708,6,3,278941,278941,278944,0,3,4
79709,2,2,278943,278944,278946,1,3,0
79710,1,1,278944,278946,278947,2,3,0
79711,1,3,278945,278947,278950,2,5,0
79712,6,1,278951,278951,278952,0,1,1
79713,1,2,278952,278952,278954,0,2,0
79714,2,1,278954,278954,278955,0,1,0
79715,2,1,278956,278956,278957,0,1,1
79716,2,1,278958,278958,278959,0,1,1
79717,5,2,278963,278963,278965,0,2,4
79718,2,1,278965,278965,278966,0,1,0
79719,5,1,278970,278970,278971,0,1,4
79720,4,3,278974,278974,278977,0,3,3
79721,5,2,278979,278979,278981,0,2,2
79722,4,1,278983,278983,278984,0,1,2
79723,4,1,278987,278987,278988,0,1,3
79724,6,1,278993,278993,278994,0,1,5
79725,4,1,278997,278997,278998,0,1,3
79726,1,1,278998,278998,278999,0,1,0
79727,5,2,279003,279003,279005,0,2,4
79728,5,2,279008,279008,279010,0,2,3
79729,2,3,279010,279010,279013,0,3,0
79730,3,1,279013,279013,279014,0,1,0
79731,3,2,279016,279016,279018,0,2,2
79732,4,2,279020,279020,279022,0,2,2
79733,3,1,279023,279023,279024,0,1,1
79734,3,3,279026,279026,279029,0,3,2
79735,1,3,279027,279029,279032,2,5,0
79736,6,3,279033,279033,279036,0,3,1
79737,5,3,279038,279038,279041,0,3,2
79738,1,1,279039,279041,279042,2,3,0
79739,4,2,279043,279043,279045,0,2,1
79740,3,3,279046,279046,279049,0,3,1
79741,6,1,279052,279052,279053,0,1,3
79742,4,3,279056,279056,279059,0,3,3
79743,6,1,279062,279062,279063,0,1,3
79744,5,3,279067,279067,279070,0,3,4
79745,5,3,279072,279072,279075,0,3,2
79746,1,1,279073,279075,279076,2,3,0
79747,5,3,279078,279078,279081,0,3,2
79748,4,1,279082,279082,279083,0,1,1
79749,2,2,279084,279084,279086,0,2,1
79750,1,3,279085,279086,279089,1,4,0
79751,2,2,279087,279089,279091,2,4,0
79752,3,3,279090,279091,279094,1,4,0
79753,2,3,279092,279094,279097,2,5,0
79754,2,1,279094,279097,279098,3,4,0
79755,4,3,279098,279098,279101,0,3,0
79756,4,2,279102,279102,279104,0,2,1
79757,5,1,279107,279107,279108,0,1,3
79758,2,3,279109,279109,279112,0,3,1
79759,4,3,279113,279113,279116,0,3,1
79760,4,3,279117,279117,279120,0,3,1
79761,1,3,279118,279120,279123,2,5,0
79762,1,1,279119,279123,279124,4,5,0
79763,6,2,279125,279125,279127,0,2,1
79764,1,1,279126,279127,279128,1,2,0
79765,3,2,279129,279129,279131,0,2,1
79766,1,1,279130,279131,279132,1,2,0
79767,6,2,279136,279136,279138,0,2,4
79768,1,3,279137,279138,279141,1,4,0
79769,2,2,279139,279141,279143,2,4,0
79770,4,3,279143,279143,279146,0,3,0
79771,1,1,279144,279146,279147,2,3,0
79772,1,1,279145,279147,279148,2,3,0
79773,1,2,279146,279148,279150,2,4,0
79774,3,2,279149,279150,279152,1,3,0
79775,3,1,279152,279152,279153,0,1,0
79776,3,1,279155,279155,279156,0,1,2
79777,5,2,279160,279160,279162,0,2,4
79778,4,3,279164,279164,279167,0,3,2
79779,6,2,279170,279170,279172,0,2,3
79780,1,2,279171,279172,279174,1,3,0
79781,2,1,279173,279174,279175,1,2,0
79782,3,3,279176,279176,279179,0,3,1
79783,2,3,279178,279179,279182,1,4,0
79784,2,3,279180,279182,279185,2,5,0
79785,1,1,279181,279185,279186,4,5,0
79786,3,1,279184,279186,279187,2,3,0
79787,5,1,279189,279189,279190,0,1,2
79788,2,2,279191,279191,279193,0,2,1
79789,6,3,279197,279197,279200,0,3,4
79790,4,3,279201,279201,279204,0,3,1
79791,2,3,279203,279204,279207,1,4,0
79792,5,3,279208,279208,279211,0,3,1
79793,4,3,279212,279212,279215,0,3,1
79794,4,2,279216,279216,279218,0,2,1
79795,4,1,279220,279220,279221,0,1,2
79796,5,3,279225,279225,279228,0,3,4
79797,5,3,279230,279230,279233,0,3,2
79798,2,3,279232,279233,279236,1,4,0
79799,2,2,279234,279236,279238,2,4,0
79800,3,2,279237,279238,279240,1,3,0
79801,2,3,279239,279240,279243,1,4,0
79802,1,1,279240,279243,279244,3,4,0
79803,1,3,279241,279244,279247,3,6,0
79804,5,1,279246,279247,279248,1,2,0
79805,1,1,279247,279248,279249,1,2,0
79806,1,3,279248,279249,279252,1,4,0
79807,1,3,279249,279252,279255,3,6,0
79808,4,1,279253,279255,279256,2,3,0
79809,4,3,279257,279257,279260,0,3,1
79810,5,1,279262,279262,279263,0,1,2
79811,5,3,279267,279267,279270,0,3,4
79812,5,2,279272,279272,279274,0,2,2
79813,5,1,279277,279277,279278,0,1,3
79814,6,2,279283,279283,279285,0,2,5
79815,1,3,279284,279285,279288,1,4,0
79816,5,1,279289,279289,279290,0,1,1
79817,4,2,279293,279293,279295,0,2,3
79818,1,1,279294,279295,279296,1,2,0
79819,4,1,279298,279298,279299,0,1,2
79820,1,2,279299,279299,279301,0,2,0
79821,5,3,279304,279304,279307,0,3,3
79822,1,2,279305,279307,279309,2,4,0
79823,1,2,279306,279309,279311,3,5,0
79824,2,1,279308,279311,279312,3,4,0
79825,2,3,279310,279312,279315,2,5,0
79826,1,1,279311,279315,279316,4,5,0
79827,4,1,279315,279316,279317,1,2,0
79828,2,2,279317,279317,279319,0,2,0
79829,5,3,279322,279322,279325,0,3,3
79830,3,1,279325,279325,279326,0,1,0
79831,1,2,279326,279326,279328,0,2,0
79832,5,1,279331,279331,279332,0,1,3
79833,5,3,279336,279336,279339,0,3,4
79834,3,2,279339,279339,279341,0,2,0
79835,2,2,279341,279341,279343,0,2,0
79836,6,3,279347,279347,279350,0,3,4
79837,3,3,279350,279350,279353,0,3,0
79838,3,2,279353,279353,279355,0,2,0
79839,6,2,279359,279359,279361,0,2,4
79840,5,3,279364,279364,279367,0,3,3
79841,1,3,279365,279367,279370,2,5,0
79842,1,2,279366,279370,279372,4,6,0
79843,3,2,279369,279372,279374,3,5,0
79844,2,2,279371,279374,279376,3,5,0
79845,2,2,279373,279376,279378,3,5,0
79846,2,1,279375,279378,279379,3,4,0
79847,5,1,279380,279380,279381,0,1,1
79848,1,1,279381,279381,279382,0,1,0
79849,3,3,279384,279384,279387,0,3,2
79850,5,1,279389,279389,279390,0,1,2
79851,3,1,279392,279392,279393,0,1,2
79852,3,1,279395,279395,279396,0,1,2
79853,2,2,279397,279397,279399,0,2,1
79854,3,1,279400,279400,279401,0,1,1
79855,4,3,279404,279404,279407,0,3,3
79856,4,1,279408,279408,279409,0,1,1
79857,4,2,279412,279412,279414,0,2,3
79858,1,3,279413,279414,279417,1,4,0
79859,3,1,279416,279417,279418,1,2,0
79860,5,1,279421,279421,279422,0,1,3
79861,5,2,279426,279426,279428,0,2,4
79862,6,1,279432,279432,279433,0,1,4
79863,2,2,279434,279434,279436,0,2,1
79864,2,2,279436,279436,279438,0,2,0
79865,5,1,279441,279441,279442,0,1,3
79866,3,1,279444,279444,279445,0,1,2
79867,5,3,279449,279449,279452,0,3,4
79868,4,1,279453,279453,279454,0,1,1
79869,6,2,279459,279459,279461,0,2,5
79870,6,2,279465,279465,279467,0,2,4
79871,6,3,279471,279471,279474,0,3,4
79872,6,1,279477,279477,279478,0,1,3
79873,4,2,279481,279481,279483,0,2,3
79874,1,3,279482,279483,279486,1,4,0
79875,1,1,279483,279486,279487,3,4,0
79876,2,1,279485,279487,279488,2,3,0
79877,6,1,279491,279491,279492,0,1,3
79878,6,2,279497,279497,279499,0,2,5
79879,6,2,279503,279503,279505,0,2,4
79880,5,3,279508,279508,279511,0,3,3
79881,6,3,279514,279514,279517,0,3,3
79882,5,3,279519,279519,279522,0,3,2
79883,5,3,279524,279524,279527,0,3,2
79884,3,3,279527,279527,279530,0,3,0
79885,2,3,279529,279530,279533,1,4,0
79886,5,3,279534,279534,279537,0,3,1
79887,3,3,279537,279537,279540,0,3,0
79888,3,2,279540,279540,279542,0,2,0
79889,5,3,279545,279545,279548,0,3,3
79890,5,3,279550,279550,279553,0,3,2
79891,6,1,279556,279556,279557,0,1,3
79892,1,1,279557,279557,279558,0,1,0
79893,1,1,279558,279558,279559,0,1,0
79894,3,3,279561,279561,279564,0,3,2
79895,6,2,279567,279567,279569,0,2,3
79896,3,2,279570,279570,279572,0,2,1
79897,2,1,279572,279572,279573,0,1,0
79898,6,3,279578,279578,279581,0,3,5
79899,4,2,279582,279582,279584,0,2,1
79900,1,1,279583,279584,279585,1,2,0
79901,5,3,279588,279588,279591,0,3,3
79902,1,3,279589,279591,279594,2,5,0
79903,6,3,279595,279595,279598,0,3,1
79904,4,3,279599,279599,279602,0,3,1
79905,5,3,279604,279604,279607,0,3,2
79906,5,3,279609,279609,279612,0,3,2
79907,3,1,279612,279612,279613,0,1,0
79908,5,2,279617,279617,279619,0,2,4
79909,1,2,279618,279619,279621,1,3,0
79910,2,3,279620,279621,279624,1,4,0
79911,4,2,279624,279624,279626,0,2,0
79912,1,2,279625,279626,279628,1,3,0
79913,1,1,279626,279628,279629,2,3,0
79914,2,3,279628,279629,279632,1,4,0
79915,1,1,279629,279632,279633,3,4,0
79916,5,1,279634,279634,279635,0,1,1
79917,5,2,279639,279639,279641,0,2,4
79918,3,2,279642,279642,279644,0,2,1
79919,2,3,279644,279644,279647,0,3,0
79920,3,3,279647,279647,279650,0,3,0
79921,2,1,279649,279650,279651,1,2,0
79922,6,1,279655,279655,279656,0,1,4
79923,6,1,279661,279661,279662,0,1,5
79924,3,1,279664,279664,279665,0,1,2
79925,2,1,279666,279666,279667,0,1,1
79926,4,3,279670,279670,279673,0,3,3
79927,2,3,279672,279673,279676,1,4,0
79928,4,3,279676,279676,279679,0,3,0
79929,4,3,279680,279680,279683,0,3,1
79930,5,3,279685,279685,279688,0,3,2
79931,1,3,279686,279688,279691,2,5,0
79932,4,1,279690,279691,279692,1,2,0
79933,4,3,279694,279694,279697,0,3,2
79934,6,2,279700,279700,279702,0,2,3
79935,6,1,279706,279706,279707,0,1,4
79936,2,3,279708,279708,279711,0,3,1
79937,2,1,279710,279711,279712,1,2,0
79938,5,2,279715,279715,279717,0,2,3
79939,3,2,279718,279718,279720,0,2,1
79940,4,1,279722,279722,279723,0,1,2
79941,5,3,279727,279727,279730,0,3,4
79942,6,3,279733,279733,279736,0,3,3
79943,1,2,279734,279736,279738,2,4,0
79944,3,2,279737,279738,279740,1,3,0
79945,1,3,279738,279740,279743,2,5,0
79946,6,1,279744,279744,279745,0,1,1
79947,1,3,279745,279745,279748,0,3,0
79948,1,1,279746,279748,279749,2,3,0
79949,5,3,279751,279751,279754,0,3,2
79950,2,2,279753,279754,279756,1,3,0
79951,2,1,279755,279756,279757,1,2,0
79952,2,3,279757,279757,279760,0,3,0
79953,1,1,279758,279760,279761,2,3,0
79954,1,1,279759,279761,279762,2,3,0
79955,1,3,279760,279762,279765,2,5,0
79956,2,3,279762,279765,279768,3,6,0
79957,5,2,279767,279768,279770,1,3,0
79958,3,3,279770,279770,279773,0,3,0
79959,4,3,279774,279774,279777,0,3,1
79960,4,2,279778,279778,279780,0,2,1
79961,6,1,279784,279784,279785,0,1,4
79962,5,3,279789,279789,279792,0,3,4
79963,6,3,279795,279795,279798,0,3,3
79964,4,2,279799,279799,279801,0,2,1
79965,4,2,279803,279803,279805,0,2,2
79966,5,1,279808,279808,279809,0,1,3
79967,2,2,279810,279810,279812,0,2,1
79968,4,1,279814,279814,279815,0,1,2
79969,5,1,279819,279819,279820,0,1,4
79970,2,1,279821,279821,279822,0,1,1
79971,3,1,279824,279824,279825,0,1,2
79972,4,1,279828,279828,279829,0,1,3
79973,4,3,279832,279832,279835,0,3,3
79974,1,2,279833,279835,279837,2,4,0
79975,1,2,279834,279837,279839,3,5,0
79976,6,1,279840,279840,279841,0,1,1
79977,1,2,279841,279841,279843,0,2,0
79978,4,1,279845,279845,279846,0,1,2
79979,4,1,279849,279849,279850,0,1,3
79980,4,3,279853,279853,279856,0,3,3
79981,5,2,279858,279858,279860,0,2,2
79982,2,2,279860,279860,279862,0,2,0
79983,2,1,279862,279862,279863,0,1,0
79984,6,2,279868,279868,279870,0,2,5
79985,3,3,279871,279871,279874,0,3,1
79986,1,3,279872,279874,279877,2,5,0
79987,2,3,279874,279877,279880,3,6,0
79988,2,1,279876,279880,279881,4,5,0
79989,1,2,279877,279881,279883,4,6,0
79990,3,1,279880,279883,279884,3,4,0
79991,4,1,279884,279884,279885,0,1,0
79992,4,3,279888,279888,279891,0,3,3
79993,2,2,279890,279891,279893,1,3,0
79994,1,2,279891,279893,279895,2,4,0
79995,6,2,279897,279897,279899,0,2,2
79996,2,3,279899,279899,279902,0,3,0
79997,6,3,279905,279905,279908,0,3,3
79998,5,1,279910,279910,279911,0,1,2
79999,1,3,279911,279911,279914,0,3,0
80000,5,1,279916,279916,279917,0,1,2
80001,4,2,279920,279920,279922,0,2,3
80002,5,2,279925,279925,279927,0,2,3
80003,5,3,279930,279930,279933,0,3,3
80004,2,2,279932,279933,279935,1,3,0
80005,6,1,279938,279938,279939,0,1,3
80006,2,3,279940,279940,279943,0,3,1
80007,5,1,279945,279945,279946,0,1,2
80008,6,2,279951,279951,279953,0,2,5
80009,6,1,279957,279957,279958,0,1,4
80010,4,2,279961,279961,279963,0,2,3
80011,1,1,279962,279963,279964,1,2,0
80012,4,2,279966,279966,279968,0,2,2
80013,3,1,279969,279969,279970,0,1,1
80014,5,1,279974,279974,279975,0,1,4
80015,6,1,279980,279980,279981,0,1,5
80016,2,2,279982,279982,279984,0,2,1
80017,4,2,279986,279986,279988,0,2,2
80018,4,1,279990,279990,279991,0,1,2
80019,1,3,279991,279991,279994,0,3,0
80020,1,2,279992,279994,279996,2,4,0
80021,1,1,279993,279996,279997,3,4,0
80022,6,3,279999,279999,280002,0,3,2
80023,2,2,280001,280002,280004,1,3,0
80024,1,1,280002,280004,280005,2,3,0
80025,5,3,280007,280007,280010,0,3,2
80026,3,2,280010,280010,280012,0,2,0
80027,3,3,280013,280013,280016,0,3,1
80028,1,1,280014,280016,280017,2,3,0
80029,3,3,280017,280017,280020,0,3,0
80030,6,1,280023,280023,280024,0,1,3
80031,6,1,280029,280029,280030,0,1,5
80032,2,1,280031,280031,280032,0,1,1
80033,5,3,280036,280036,280039,0,3,4
80034,5,3,280041,280041,280044,0,3,2
80035,3,2,280044,280044,280046,0,2,0
80036,4,1,280048,280048,280049,0,1,2
80037,4,1,280052,280052,280053,0,1,3
80038,6,3,280058,280058,280061,0,3,5
80039,2,1,280060,280061,280062,1,2,0
80040,6,3,280066,280066,280069,0,3,4
80041,5,2,280071,280071,280073,0,2,2
80042,3,3,280074,280074,280077,0,3,1
80043,5,3,280079,280079,280082,0,3,2
80044,4,2,280083,280083,280085,0,2,1
80045,6,1,280089,280089,280090,0,1,4
80046,2,1,280091,280091,280092,0,1,1
80047,5,3,280096,280096,280099,0,3,4
80048,2,2,280098,280099,280101,1,3,0
80049,3,1,280101,280101,280102,0,1,0
80050,1,2,280102,280102,280104,0,2,0
80051,1,2,280103,280104,280106,1,3,0
80052,3,2,280106,280106,280108,0,2,0
80053,6,1,280112,280112,280113,0,1,4
80054,5,3,280117,280117,280120,0,3,4
80055,3,3,280120,280120,280123,0,3,0
80056,5,3,280125,280125,280128,0,3,2
80057,6,3,280131,280131,280134,0,3,3
80058,2,3,280133,280134,280137,1,4,0
80059,5,2,280138,280138,280140,0,2,1
80060,1,2,280139,280140,280142,1,3,0
80061,5,2,280144,280144,280146,0,2,2
80062,6,2,280150,280150,280152,0,2,4
80063,6,1,280156,280156,280157,0,1,4
80064,5,2,280161,280161,280163,0,2,4
80065,2,2,280163,280163,280165,0,2,0
80066,4,1,280167,280167,280168,0,1,2
80067,2,3,280169,280169,280172,0,3,1
80068,5,2,280174,280174,280176,0,2,2
80069,3,1,280177,280177,280178,0,1,1
80070,2,2,280179,280179,280181,0,2,1
80071,2,2,280181,280181,280183,0,2,0
80072,4,3,280185,280185,280188,0,3,2
80073,2,3,280187,280188,280191,1,4,0
80074,6,2,280193,280193,280195,0,2,2
80075,4,1,280197,280197,280198,0,1,2
80076,3,1,280200,280200,280201,0,1,2
80077,4,2,280204,280204,280206,0,2,3
80078,5,1,280209,280209,280210,0,1,3
80079,1,1,280210,280210,280211,0,1,0
80080,2,3,280212,280212,280215,0,3,1
80081,3,1,280215,280215,280216,0,1,0
80082,5,1,280220,280220,280221,0,1,4
80083,5,2,280225,280225,280227,0,2,4
80084,1,3,280226,280227,280230,1,4,0
80085,1,1,280227,280230,280231,3,4,0
80086,2,2,280229,280231,280233,2,4,0
80087,3,3,280232,280233,280236,1,4,0
80088,3,2,280235,280236,280238,1,3,0
80089,6,1,280241,280241,280242,0,1,3
80090,5,3,280246,280246,280249,0,3,4
80091,1,3,280247,280249,280252,2,5,0
80092,6,2,280253,280253,280255,0,2,1
80093,2,2,280255,280255,280257,0,2,0
80094,1,1,280256,280257,280258,1,2,0
80095,5,1,280261,280261,280262,0,1,3
80096,1,1,280262,280262,280263,0,1,0
80097,4,1,280266,280266,280267,0,1,3
80098,1,3,280267,280267,280270,0,3,0
80099,6,3,280273,280273,280276,0,3,3
80100,6,2,280279,280279,280281,0,2,3
80101,4,1,280283,280283,280284,0,1,2
80102,4,1,280287,280287,280288,0,1,3
80103,4,3,280291,280291,280294,0,3,3
80104,3,1,280294,280294,280295,0,1,0
80105,6,1,280300,280300,280301,0,1,5
80106,4,1,280304,280304,280305,0,1,3
80107,3,1,280307,280307,280308,0,1,2
80108,1,1,280308,280308,280309,0,1,0
80109,2,3,280310,280310,280313,0,3,1
80110,4,2,280314,280314,280316,0,2,1
80111,6,2,280320,280320,280322,0,2,4
80112,4,1,280324,280324,280325,0,1,2
80113,1,3,280325,280325,280328,0,3,0
80114,2,2,280327,280328,280330,1,3,0
80115,4,1,280331,280331,280332,0,1,1
80116,2,1,280333,280333,280334,0,1,1
80117,2,2,280335,280335,280337,0,2,1
80118,2,2,280337,280337,280339,0,2,0
80119,1,1,280338,280339,280340,1,2,0
80120,5,2,280343,280343,280345,0,2,3
80121,5,3,280348,280348,280351,0,3,3
80122,5,3,280353,280353,280356,0,3,2
80123,5,1,280358,280358,280359,0,1,2
80124,1,1,280359,280359,280360,0,1,0
80125,2,2,280361,280361,280363,0,2,1
80126,4,3,280365,280365,280368,0,3,2
80127,6,1,280371,280371,280372,0,1,3
80128,5,3,280376,280376,280379,0,3,4
80129,2,1,280378,280379,280380,1,2,0
80130,2,2,280380,280380,280382,0,2,0
80131,3,3,280383,280383,280386,0,3,1
80132,5,2,280388,280388,280390,0,2,2
80133,2,1,280390,280390,280391,0,1,0
80134,4,1,280394,280394,280395,0,1,3
80135,4,1,280398,280398,280399,0,1,3
80136,2,2,280400,280400,280402,0,2,1
80137,6,1,280406,280406,280407,0,1,4
80138,6,2,280412,280412,280414,0,2,5
80139,1,3,280413,280414,280417,1,4,0
80140,2,2,280415,280417,280419,2,4,0
80141,3,1,280418,280419,280420,1,2,0
80142,4,2,280422,280422,280424,0,2,2
80143,3,3,280425,280425,280428,0,3,1
80144,4,2,280429,280429,280431,0,2,1
80145,5,3,280434,280434,280437,0,3,3
80146,1,3,280435,280437,280440,2,5,0
80147,5,3,280440,280440,280443,0,3,0
80148,1,1,280441,280443,280444,2,3,0
80149,3,1,280444,280444,280445,0,1,0
80150,6,1,280450,280450,280451,0,1,5
80151,3,2,280453,280453,280455,0,2,2
80152,5,3,280458,280458,280461,0,3,3
80153,1,2,280459,280461,280463,2,4,0
80154,5,3,280464,280464,280467,0,3,1
80155,2,2,280466,280467,280469,1,3,0
80156,2,2,280468,280469,280471,1,3,0
80157,4,1,280472,280472,280473,0,1,1
80158,5,3,280477,280477,280480,0,3,4
80159,2,1,280479,280480,280481,1,2,0
80160,2,3,280481,280481,280484,0,3,0
80161,5,3,280486,280486,280489,0,3,2
80162,6,1,280492,280492,280493,0,1,3
80163,3,2,280495,280495,280497,0,2,2
80164,6,3,280501,280501,280504,0,3,4
80165,4,2,280505,280505,280507,0,2,1
80166,6,2,280511,280511,280513,0,2,4
80167,4,1,280515,280515,280516,0,1,2
80168,4,1,280519,280519,280520,0,1,3
80169,2,2,280521,280521,280523,0,2,1
80170,3,1,280524,280524,280525,0,1,1
80171,4,2,280528,280528,280530,0,2,3
80172,4,2,280532,280532,280534,0,2,2
80173,2,1,280534,280534,280535,0,1,0
80174,4,2,280538,280538,280540,0,2,3
80175,1,2,280539,280540,280542,1,3,0
80176,3,1,280542,280542,280543,0,1,0
80177,3,1,280545,280545,280546,0,1,2
80178,5,1,280550,280550,280551,0,1,4
80179,6,2,280556,280556,280558,0,2,5
80180,4,2,280560,280560,280562,0,2,2
80181,1,3,280561,280562,280565,1,4,0
80182,1,3,280562,280565,280568,3,6,0
80183,3,3,280565,280568,280571,3,6,0
80184,3,2,280568,280571,280573,3,5,0
80185,5,3,280573,280573,280576,0,3,0
80186,2,3,280575,280576,280579,1,4,0
80187,1,2,280576,280579,280581,3,5,0
80188,1,2,280577,280581,280583,4,6,0
80189,4,1,280581,280583,280584,2,3,0
80190,1,2,280582,280584,280586,2,4,0
80191,5,1,280587,280587,280588,0,1,1
80192,5,3,280592,280592,280595,0,3,4
80193,6,2,280598,280598,280600,0,2,3
80194,1,1,280599,280600,280601,1,2,0
80195,2,3,280601,280601,280604,0,3,0
80196,1,1,280602,280604,280605,2,3,0
80197,3,3,280605,280605,280608,0,3,0
80198,5,1,280610,280610,280611,0,1,2
80199,2,2,280612,280612,280614,0,2,1
80200,6,3,280618,280618,280621,0,3,4
80201,4,2,280622,280622,280624,0,2,1
80202,3,3,280625,280625,280628,0,3,1
80203,1,3,280626,280628,280631,2,5,0
80204,2,1,280628,280631,280632,3,4,0
80205,5,1,280633,280633,280634,0,1,1
80206,3,2,280636,280636,280638,0,2,2
80207,6,1,280642,280642,280643,0,1,4
80208,2,3,280644,280644,280647,0,3,1
80209,3,3,280647,280647,280650,0,3,0
80210,2,3,280649,280650,280653,1,4,0
80211,5,3,280654,280654,280657,0,3,1
80212,3,2,280657,280657,280659,0,2,0
80213,2,3,280659,280659,280662,0,3,0
80214,6,2,280665,280665,280667,0,2,3
80215,2,3,280667,280667,280670,0,3,0
80216,6,1,280673,280673,280674,0,1,3
80217,6,2,280679,280679,280681,0,2,5
80218,2,1,280681,280681,280682,0,1,0
80219,4,1,280685,280685,280686,0,1,3
80220,2,3,280687,280687,280690,0,3,1
80221,3,2,280690,280690,280692,0,2,0
80222,6,2,280696,280696,280698,0,2,4
80223,4,3,280700,280700,280703,0,3,2
80224,5,3,280705,280705,280708,0,3,2
80225,2,1,280707,280708,280709,1,2,0
80226,6,2,280713,280713,280715,0,2,4
80227,2,3,280715,280715,280718,0,3,0
80228,2,2,280717,280718,280720,1,3,0
80229,2,3,280719,280720,280723,1,4,0
80230,5,1,280724,280724,280725,0,1,1
80231,2,3,280726,280726,280729,0,3,1
80232,5,3,280731,280731,280734,0,3,2
80233,5,1,280736,280736,280737,0,1,2
80234,1,3,280737,280737,280740,0,3,0
80235,5,1,280742,280742,280743,0,1,2
80236,2,1,280744,280744,280745,0,1,1
80237,5,2,280749,280749,280751,0,2,4
80238,2,3,280751,280751,280754,0,3,0
80239,4,1,280755,280755,280756,0,1,1
80240,2,2,280757,280757,280759,0,2,1
80241,6,2,280763,280763,280765,0,2,4
80242,4,3,280767,280767,280770,0,3,2
80243,2,1,280769,280770,280771,1,2,0
80244,2,3,280771,280771,280774,0,3,0
80245,4,2,280775,280775,280777,0,2,1
80246,2,2,280777,280777,280779,0,2,0
80247,4,2,280781,280781,280783,0,2,2
80248,1,2,280782,280783,280785,1,3,0
80249,2,1,280784,280785,280786,1,2,0
80250,1,2,280785,280786,280788,1,3,0
80251,4,3,280789,280789,280792,0,3,1
80252,2,3,280791,280792,280795,1,4,0
80253,1,1,280792,280795,280796,3,4,0
80254,2,1,280794,280796,280797,2,3,0
80255,5,1,280799,280799,280800,0,1,2
80256,1,2,280800,280800,280802,0,2,0
80257,3,2,280803,280803,280805,0,2,1
80258,4,2,280807,280807,280809,0,2,2
80259,4,1,280811,280811,280812,0,1,2
80260,4,1,280815,280815,280816,0,1,3
80261,3,3,280818,280818,280821,0,3,2
80262,2,2,280820,280821,280823,1,3,0
80263,1,2,280821,280823,280825,2,4,0
80264,1,2,280822,280825,280827,3,5,0
80265,2,3,280824,280827,280830,3,6,0
80266,3,2,280827,280830,280832,3,5,0
80267,2,2,280829,280832,280834,3,5,0
80268,2,2,280831,280834,280836,3,5,0
80269,4,2,280835,280836,280838,1,3,0
80270,3,2,280838,280838,280840,0,2,0
80271,6,1,280844,280844,280845,0,1,4
80272,6,1,280850,280850,280851,0,1,5
80273,2,2,280852,280852,280854,0,2,1
80274,5,2,280857,280857,280859,0,2,3
80275,1,1,280858,280859,280860,1,2,0
80276,6,1,280864,280864,280865,0,1,4
80277,5,2,280869,280869,280871,0,2,4
80278,4,2,280873,280873,280875,0,2,2
80279,4,3,280877,280877,280880,0,3,2
80280,3,3,280880,280880,280883,0,3,0
80281,4,1,280884,280884,280885,0,1,1
80282,4,3,280888,280888,280891,0,3,3
80283,5,1,280893,280893,280894,0,1,2
80284,4,3,280897,280897,280900,0,3,3
80285,3,3,280900,280900,280903,0,3,0
80286,3,2,280903,280903,280905,0,2,0
80287,4,1,280907,280907,280908,0,1,2
80288,5,3,280912,280912,280915,0,3,4
80289,6,2,280918,280918,280920,0,2,3
80290,4,3,280922,280922,280925,0,3,2
80291,1,1,280923,280925,280926,2,3,0
80292,1,2,280924,280926,280928,2,4,0
80293,5,2,280929,280929,280931,0,2,1
80294,4,2,280933,280933,280935,0,2,2
80295,3,1,280936,280936,280937,0,1,1
80296,6,3,280942,280942,280945,0,3,5
80297,2,1,280944,280945,280946,1,2,0
80298,2,1,280946,280946,280947,0,1,0
80299,3,2,280949,280949,280951,0,2,2
80300,2,2,280951,280951,280953,0,2,0
80301,1,2,280952,280953,280955,1,3,0
80302,4,1,280956,280956,280957,0,1,1
80303,1,1,280957,280957,280958,0,1,0
80304,5,3,280962,280962,280965,0,3,4
80305,3,3,280965,280965,280968,0,3,0
80306,4,3,280969,280969,280972,0,3,1
80307,6,3,280975,280975,280978,0,3,3
80308,2,3,280977,280978,280981,1,4,0
80309,6,2,280983,280983,280985,0,2,2
80310,3,3,280986,280986,280989,0,3,1
80311,3,2,280989,280989,280991,0,2,0
80312,5,3,280994,280994,280997,0,3,3
80313,3,3,280997,280997,281000,0,3,0
80314,6,3,281003,281003,281006,0,3,3
80315,1,3,281004,281006,281009,2,5,0
80316,2,1,281006,281009,281010,3,4,0
80317,1,1,281007,281010,281011,3,4,0
80318,1,3,281008,281011,281014,3,6,0
80319,6,1,281014,281014,281015,0,1,0
80320,6,1,281020,281020,281021,0,1,5
80321,6,3,281026,281026,281029,0,3,5
80322,2,1,281028,281029,281030,1,2,0
80323,2,3,281030,281030,281033,0,3,0
80324,3,3,281033,281033,281036,0,3,0
80325,5,2,281038,281038,281040,0,2,2
80326,2,3,281040,281040,281043,0,3,0
80327,5,3,281045,281045,281048,0,3,2
80328,6,3,281051,281051,281054,0,3,3
80329,5,1,281056,281056,281057,0,1,2
80330,1,2,281057,281057,281059,0,2,0
80331,2,2,281059,281059,281061,0,2,0
80332,2,3,281061,281061,281064,0,3,0
80333,6,1,281067,281067,281068,0,1,3
80334,2,2,281069,281069,281071,0,2,1
80335,6,3,281075,281075,281078,0,3,4
80336,1,2,281076,281078,281080,2,4,0
80337,5,3,281081,281081,281084,0,3,1
80338,3,3,281084,281084,281087,0,3,0
80339,6,1,281090,281090,281091,0,1,3
80340,3,2,281093,281093,281095,0,2,2
80341,5,2,281098,281098,281100,0,2,3
80342,1,1,281099,281100,281101,1,2,0
80343,5,2,281104,281104,281106,0,2,3
80344,1,3,281105,281106,281109,1,4,0
80345,1,2,281106,281109,281111,3,5,0
80346,1,3,281107,281111,281114,4,7,0
80347,6,2,281113,281114,281116,1,3,0
80348,3,3,281116,281116,281119,0,3,0
80349,4,1,281120,281120,281121,0,1,1
80350,4,1,281124,281124,281125,0,1,3
80351,1,3,281125,281125,281128,0,3,0
80352,1,2,281126,281128,281130,2,4,0
80353,4,2,281130,281130,281132,0,2,0
80354,6,1,281136,281136,281137,0,1,4
80355,4,2,281140,281140,281142,0,2,3
80356,6,2,281146,281146,281148,0,2,4
80357,3,3,281149,281149,281152,0,3,1
80358,6,1,281155,281155,281156,0,1,3
80359,1,3,281156,281156,281159,0,3,0
80360,6,1,281162,281162,281163,0,1,3
80361,4,1,281166,281166,281167,0,1,3
80362,4,3,281170,281170,281173,0,3,3
80363,3,2,281173,281173,281175,0,2,0
80364,3,3,281176,281176,281179,0,3,1
80365,3,1,281179,281179,281180,0,1,0
80366,3,2,281182,281182,281184,0,2,2
80367,2,2,281184,281184,281186,0,2,0
80368,4,3,281188,281188,281191,0,3,2
80369,1,2,281189,281191,281193,2,4,0
80370,2,1,281191,281193,281194,2,3,0
80371,5,1,281196,281196,281197,0,1,2
80372,4,1,281200,281200,281201,0,1,3
80373,5,3,281205,281205,281208,0,3,4
80374,1,3,281206,281208,281211,2,5,0
80375,4,1,281210,281211,281212,1,2,0
80376,5,3,281215,281215,281218,0,3,3
80377,1,3,281216,281218,281221,2,5,0
80378,2,2,281218,281221,281223,3,5,0
80379,5,3,281223,281223,281226,0,3,0
80380,4,1,281227,281227,281228,0,1,1
80381,1,1,281228,281228,281229,0,1,0
80382,6,3,281234,281234,281237,0,3,5
80383,5,3,281239,281239,281242,0,3,2
80384,3,2,281242,281242,281244,0,2,0
80385,3,3,281245,281245,281248,0,3,1
80386,2,1,281247,281248,281249,1,2,0
80387,2,3,281249,281249,281252,0,3,0
80388,6,2,281255,281255,281257,0,2,3
80389,4,3,281259,281259,281262,0,3,2
80390,2,2,281261,281262,281264,1,3,0
80391,5,1,281266,281266,281267,0,1,2
80392,3,2,281269,281269,281271,0,2,2
80393,1,1,281270,281271,281272,1,2,0
80394,4,2,281274,281274,281276,0,2,2
80395,1,1,281275,281276,281277,1,2,0
80396,6,3,281281,281281,281284,0,3,4
80397,2,2,281283,281284,281286,1,3,0
80398,1,2,281284,281286,281288,2,4,0
80399,2,1,281286,281288,281289,2,3,0
80400,4,3,281290,281290,281293,0,3,1
80401,5,3,281295,281295,281298,0,3,2
80402,6,3,281301,281301,281304,0,3,3
80403,3,2,281304,281304,281306,0,2,0
80404,3,3,281307,281307,281310,0,3,1
80405,6,3,281313,281313,281316,0,3,3
80406,1,3,281314,281316,281319,2,5,0
80407,2,2,281316,281319,281321,3,5,0
80408,3,2,281319,281321,281323,2,4,0
80409,2,3,281321,281323,281326,2,5,0
80410,6,1,281327,281327,281328,0,1,1
80411,6,1,281333,281333,281334,0,1,5
80412,3,1,281336,281336,281337,0,1,2
80413,3,3,281339,281339,281342,0,3,2
80414,5,3,281344,281344,281347,0,3,2
80415,2,1,281346,281347,281348,1,2,0
80416,1,3,281347,281348,281351,1,4,0
80417,2,2,281349,281351,281353,2,4,0
80418,5,1,281354,281354,281355,0,1,1
80419,5,1,281359,281359,281360,0,1,4
80420,4,2,281363,281363,281365,0,2,3
80421,1,3,281364,281365,281368,1,4,0
80422,5,2,281369,281369,281371,0,2,1
80423,2,2,281371,281371,281373,0,2,0
80424,3,1,281374,281374,281375,0,1,1
80425,3,1,281377,281377,281378,0,1,2
80426,2,3,281379,281379,281382,0,3,1
80427,1,3,281380,281382,281385,2,5,0
80428,2,2,281382,281385,281387,3,5,0
80429,5,1,281387,281387,281388,0,1,0
80430,5,2,281392,281392,281394,0,2,4
80431,4,3,281396,281396,281399,0,3,2
80432,1,1,281397,281399,281400,2,3,0
80433,5,3,281402,281402,281405,0,3,2
80434,4,3,281406,281406,281409,0,3,1
80435,2,1,281408,281409,281410,1,2,0
80436,5,3,281413,281413,281416,0,3,3
80437,6,1,281419,281419,281420,0,1,3
80438,1,1,281420,281420,281421,0,1,0
80439,2,1,281422,281422,281423,0,1,1
80440,2,3,281424,281424,281427,0,3,1
80441,2,2,281426,281427,281429,1,3,0
80442,2,2,281428,281429,281431,1,3,0
80443,2,2,281430,281431,281433,1,3,0
80444,2,3,281432,281433,281436,1,4,0
80445,5,2,281437,281437,281439,0,2,1
80446,1,2,281438,281439,281441,1,3,0
80447,5,3,281443,281443,281446,0,3,2
80448,1,2,281444,281446,281448,2,4,0
80449,2,3,281446,281448,281451,2,5,0
80450,6,2,281452,281452,281454,0,2,1
80451,6,1,281458,281458,281459,0,1,4
80452,6,3,281464,281464,281467,0,3,5
80453,6,2,281470,281470,281472,0,2,3
80454,4,3,281474,281474,281477,0,3,2
80455,6,3,281480,281480,281483,0,3,3
80456,3,3,281483,281483,281486,0,3,0
80457,4,3,281487,281487,281490,0,3,1
80458,1,2,281488,281490,281492,2,4,0
80459,6,3,281494,281494,281497,0,3,2
80460,2,1,281496,281497,281498,1,2,0
80461,2,1,281498,281498,281499,0,1,0
80462,5,3,281503,281503,281506,0,3,4
80463,5,1,281508,281508,281509,0,1,2
80464,3,2,281511,281511,281513,0,2,2
80465,2,1,281513,281513,281514,0,1,0
80466,5,3,281518,281518,281521,0,3,4
80467,5,1,281523,281523,281524,0,1,2
80468,2,3,281525,281525,281528,0,3,1
80469,3,2,281528,281528,281530,0,2,0
80470,2,3,281530,281530,281533,0,3,0
80471,4,3,281534,281534,281537,0,3,1
80472,5,1,281539,281539,281540,0,1,2
80473,2,2,281541,281541,281543,0,2,1
80474,1,3,281542,281543,281546,1,4,0
80475,4,3,281546,281546,281549,0,3,0
80476,1,3,281547,281549,281552,2,5,0
80477,6,2,281553,281553,281555,0,2,1
80478,5,1,281558,281558,281559,0,1,3
80479,3,3,281561,281561,281564,0,3,2
80480,5,3,281566,281566,281569,0,3,2
80481,6,3,281572,281572,281575,0,3,3
80482,3,2,281575,281575,281577,0,2,0
80483,2,2,281577,281577,281579,0,2,0
80484,4,3,281581,281581,281584,0,3,2
80485,2,3,281583,281584,281587,1,4,0
80486,1,2,281584,281587,281589,3,5,0
80487,1,2,281585,281589,281591,4,6,0
80488,5,1,281590,281591,281592,1,2,0
80489,5,1,281595,281595,281596,0,1,3
80490,3,2,281598,281598,281600,0,2,2
80491,2,3,281600,281600,281603,0,3,0
80492,2,3,281602,281603,281606,1,4,0
80493,4,3,281606,281606,281609,0,3,0
80494,1,1,281607,281609,281610,2,3,0
80495,1,1,281608,281610,281611,2,3,0
80496,2,3,281610,281611,281614,1,4,0
80497,6,3,281616,281616,281619,0,3,2
80498,2,2,281618,281619,281621,1,3,0
80499,2,3,281620,281621,281624,1,4,0
80500,1,3,281621,281624,281627,3,6,0
80501,4,2,281625,281627,281629,2,4,0
80502,6,2,281631,281631,281633,0,2,2
80503,3,2,281634,281634,281636,0,2,1
80504,2,2,281636,281636,281638,0,2,0
80505,5,2,281641,281641,281643,0,2,3
80506,2,1,281643,281643,281644,0,1,0
80507,3,1,281646,281646,281647,0,1,2
80508,5,1,281651,281651,281652,0,1,4
80509,5,1,281656,281656,281657,0,1,4
80510,5,1,281661,281661,281662,0,1,4
80511,1,2,281662,281662,281664,0,2,0
80512,5,2,281667,281667,281669,0,2,3
80513,2,2,281669,281669,281671,0,2,0
80514,2,2,281671,281671,281673,0,2,0
80515,6,1,281677,281677,281678,0,1,4
80516,3,2,281680,281680,281682,0,2,2
80517,3,2,281683,281683,281685,0,2,1
80518,1,1,281684,281685,281686,1,2,0
80519,2,3,281686,281686,281689,0,3,0
80520,4,2,281690,281690,281692,0,2,1
80521,1,2,281691,281692,281694,1,3,0
80522,3,3,281694,281694,281697,0,3,0
80523,6,2,281700,281700,281702,0,2,3
80524,2,1,281702,281702,281703,0,1,0
80525,2,1,281704,281704,281705,0,1,1
80526,6,2,281710,281710,281712,0,2,5
80527,1,1,281711,281712,281713,1,2,0
80528,4,1,281715,281715,281716,0,1,2
80529,5,2,281720,281720,281722,0,2,4
80530,4,2,281724,281724,281726,0,2,2
80531,1,1,281725,281726,281727,1,2,0
80532,4,1,281729,281729,281730,0,1,2
80533,1,3,281730,281730,281733,0,3,0
80534,4,3,281734,281734,281737,0,3,1
80535,2,3,281736,281737,281740,1,4,0
80536,2,2,281738,281740,281742,2,4,0
80537,1,3,281739,281742,281745,3,6,0
80538,6,2,281745,281745,281747,0,2,0
80539,2,1,281747,281747,281748,0,1,0
80540,2,2,281749,281749,281751,0,2,1
80541,3,1,281752,281752,281753,0,1,1
80542,6,2,281758,281758,281760,0,2,5
80543,1,3,281759,281760,281763,1,4,0
80544,6,2,281765,281765,281767,0,2,2
80545,5,3,281770,281770,281773,0,3,3
80546,2,3,281772,281773,281776,1,4,0
80547,2,3,281774,281776,281779,2,5,0
80548,6,2,281780,281780,281782,0,2,1
80549,1,1,281781,281782,281783,1,2,0
80550,6,3,281787,281787,281790,0,3,4
80551,6,2,281793,281793,281795,0,2,3
80552,4,2,281797,281797,281799,0,2,2
80553,2,3,281799,281799,281802,0,3,0
80554,2,1,281801,281802,281803,1,2,0
80555,3,1,281804,281804,281805,0,1,1
80556,2,3,281806,281806,281809,0,3,1
80557,2,3,281808,281809,281812,1,4,0
80558,6,1,281814,281814,281815,0,1,2
80559,3,1,281817,281817,281818,0,1,2
80560,1,2,281818,281818,281820,0,2,0
80561,4,3,281822,281822,281825,0,3,2
80562,2,1,281824,281825,281826,1,2,0
80563,1,2,281825,281826,281828,1,3,0
80564,3,1,281828,281828,281829,0,1,0
80565,2,3,281830,281830,281833,0,3,1
80566,6,1,281836,281836,281837,0,1,3
80567,2,3,281838,281838,281841,0,3,1
80568,1,1,281839,281841,281842,2,3,0
80569,2,2,281841,281842,281844,1,3,0
80570,6,2,281847,281847,281849,0,2,3
80571,6,1,281853,281853,281854,0,1,4
80572,4,2,281857,281857,281859,0,2,3
80573,1,1,281858,281859,281860,1,2,0
80574,1,3,281859,281860,281863,1,4,0
80575,1,1,281860,281863,281864,3,4,0
80576,5,1,281865,281865,281866,0,1,1
80577,6,2,281871,281871,281873,0,2,5
80578,6,2,281877,281877,281879,0,2,4
80579,5,1,281882,281882,281883,0,1,3
80580,4,3,281886,281886,281889,0,3,3
80581,3,3,281889,281889,281892,0,3,0
80582,4,2,281893,281893,281895,0,2,1
80583,2,1,281895,281895,281896,0,1,0
80584,4,2,281899,281899,281901,0,2,3
80585,4,3,281903,281903,281906,0,3,2
80586,1,2,281904,281906,281908,2,4,0
80587,6,3,281910,281910,281913,0,3,2
80588,5,3,281915,281915,281918,0,3,2
80589,3,3,281918,281918,281921,0,3,0
80590,1,3,281919,281921,281924,2,5,0
80591,1,1,281920,281924,281925,4,5,0
80592,2,3,281922,281925,281928,3,6,0
80593,2,3,281924,281928,281931,4,7,0
80594,1,3,281925,281931,281934,6,9,0
80595,6,1,281931,281934,281935,3,4,0
80596,3,1,281934,281935,281936,1,2,0
80597,2,2,281936,281936,281938,0,2,0
80598,6,2,281942,281942,281944,0,2,4
80599,2,3,281944,281944,281947,0,3,0
80600,4,3,281948,281948,281951,0,3,1
80601,3,1,281951,281951,281952,0,1,0
80602,3,1,281954,281954,281955,0,1,2
80603,3,3,281957,281957,281960,0,3,2
80604,5,1,281962,281962,281963,0,1,2
80605,5,3,281967,281967,281970,0,3,4
80606,6,2,281973,281973,281975,0,2,3
80607,4,3,281977,281977,281980,0,3,2
80608,5,1,281982,281982,281983,0,1,2
80609,1,3,281983,281983,281986,0,3,0
80610,2,2,281985,281986,281988,1,3,0
80611,5,2,281990,281990,281992,0,2,2
80612,6,2,281996,281996,281998,0,2,4
80613,6,3,282002,282002,282005,0,3,4
80614,6,2,282008,282008,282010,0,2,3
80615,3,1,282011,282011,282012,0,1,1
80616,6,3,282017,282017,282020,0,3,5
80617,5,1,282022,282022,282023,0,1,2
80618,4,1,282026,282026,282027,0,1,3
80619,3,2,282029,282029,282031,0,2,2
80620,3,3,282032,282032,282035,0,3,1
80621,2,3,282034,282035,282038,1,4,0
80622,4,3,282038,282038,282041,0,3,0
80623,1,1,282039,282041,282042,2,3,0
80624,5,3,282044,282044,282047,0,3,2
80625,4,3,282048,282048,282051,0,3,1
80626,2,3,282050,282051,282054,1,4,0
80627,3,1,282053,282054,282055,1,2,0
80628,3,3,282056,282056,282059,0,3,1
80629,4,3,282060,282060,282063,0,3,1
80630,3,1,282063,282063,282064,0,1,0
80631,2,1,282065,282065,282066,0,1,1
80632,2,1,282067,282067,282068,0,1,1
80633,2,1,282069,282069,282070,0,1,1
80634,5,1,282074,282074,282075,0,1,4
80635,1,1,282075,282075,282076,0,1,0
80636,4,3,282079,282079,282082,0,3,3
80637,1,3,282080,282082,282085,2,5,0
80638,1,2,282081,282085,282087,4,6,0
80639,6,1,282087,282087,282088,0,1,0
80640,2,1,282089,282089,282090,0,1,1
80641,2,2,282091,282091,282093,0,2,1
80642,4,1,282095,282095,282096,0,1,2
80643,5,2,282100,282100,282102,0,2,4
80644,2,1,282102,282102,282103,0,1,0
80645,3,1,282105,282105,282106,0,1,2
80646,5,3,282110,282110,282113,0,3,4
80647,1,1,282111,282113,282114,2,3,0
80648,4,2,282115,282115,282117,0,2,1
80649,6,3,282121,282121,282124,0,3,4
80650,5,3,282126,282126,282129,0,3,2
80651,1,2,282127,282129,282131,2,4,0
80652,1,3,282128,282131,282134,3,6,0
80653,5,3,282133,282134,282137,1,4,0
80654,1,1,282134,282137,282138,3,4,0
80655,5,1,282139,282139,282140,0,1,1
80656,4,2,282143,282143,282145,0,2,3
80657,1,1,282144,282145,282146,1,2,0
80658,4,1,282148,282148,282149,0,1,2
80659,2,2,282150,282150,282152,0,2,1
80660,6,2,282156,282156,282158,0,2,4
80661,4,1,282160,282160,282161,0,1,2
80662,2,2,282162,282162,282164,0,2,1
80663,4,1,282166,282166,282167,0,1,2
80664,3,1,282169,282169,282170,0,1,2
80665,2,1,282171,282171,282172,0,1,1
80666,3,2,282174,282174,282176,0,2,2
80667,5,2,282179,282179,282181,0,2,3
80668,4,3,282183,282183,282186,0,3,2
80669,3,1,282186,282186,282187,0,1,0
80670,3,3,282189,282189,282192,0,3,2
80671,3,2,282192,282192,282194,0,2,0
80672,5,3,282197,282197,282200,0,3,3
80673,5,1,282202,282202,282203,0,1,2
80674,1,2,282203,282203,282205,0,2,0
80675,5,2,282208,282208,282210,0,2,3
80676,4,3,282212,282212,282215,0,3,2
80677,5,1,282217,282217,282218,0,1,2
80678,1,3,282218,282218,282221,0,3,0
80679,6,3,282224,282224,282227,0,3,3
80680,4,2,282228,282228,282230,0,2,1
80681,2,2,282230,282230,282232,0,2,0
80682,5,1,282235,282235,282236,0,1,3
80683,1,2,282236,282236,282238,0,2,0
80684,3,3,282239,282239,282242,0,3,1
80685,4,2,282243,282243,282245,0,2,1
80686,5,3,282248,282248,282251,0,3,3
80687,6,2,282254,282254,282256,0,2,3
80688,1,2,282255,282256,282258,1,3,0
80689,6,3,282261,282261,282264,0,3,3
80690,5,3,282266,282266,282269,0,3,2
80691,3,3,282269,282269,282272,0,3,0
80692,3,1,282272,282272,282273,0,1,0
80693,4,2,282276,282276,282278,0,2,3
80694,6,1,282282,282282,282283,0,1,4
80695,5,3,282287,282287,282290,0,3,4
80696,1,2,282288,282290,282292,2,4,0
80697,4,2,282292,282292,282294,0,2,0
80698,5,3,282297,282297,282300,0,3,3
80699,5,1,282302,282302,282303,0,1,2
80700,6,1,282308,282308,282309,0,1,5
80701,1,1,282309,282309,282310,0,1,0
80702,2,2,282311,282311,282313,0,2,1
80703,1,3,282312,282313,282316,1,4,0
80704,4,2,282316,282316,282318,0,2,0
80705,6,3,282322,282322,282325,0,3,4
80706,2,3,282324,282325,282328,1,4,0
80707,6,2,282330,282330,282332,0,2,2
80708,4,3,282334,282334,282337,0,3,2
80709,1,2,282335,282337,282339,2,4,0
80710,2,1,282337,282339,282340,2,3,0
80711,4,2,282341,282341,282343,0,2,1
80712,4,2,282345,282345,282347,0,2,2
80713,5,3,282350,282350,282353,0,3,3
80714,5,2,282355,282355,282357,0,2,2
80715,5,1,282360,282360,282361,0,1,3
80716,5,2,282365,282365,282367,0,2,4
80717,4,3,282369,282369,282372,0,3,2
80718,4,2,282373,282373,282375,0,2,1
80719,5,2,282378,282378,282380,0,2,3
80720,2,1,282380,282380,282381,0,1,0
80721,2,1,282382,282382,282383,0,1,1
80722,6,2,282388,282388,282390,0,2,5
80723,4,1,282392,282392,282393,0,1,2
80724,5,2,282397,282397,282399,0,2,4
80725,3,1,282400,282400,282401,0,1,1
80726,2,2,282402,282402,282404,0,2,1
80727,1,1,282403,282404,282405,1,2,0
80728,1,3,282404,282405,282408,1,4,0
80729,1,3,282405,282408,282411,3,6,0
80730,2,1,282407,282411,282412,4,5,0
80731,5,2,282412,282412,282414,0,2,0
80732,3,3,282415,282415,282418,0,3,1
80733,5,2,282420,282420,282422,0,2,2
80734,5,2,282425,282425,282427,0,2,3
80735,4,1,282429,282429,282430,0,1,2
80736,5,2,282434,282434,282436,0,2,4
80737,5,3,282439,282439,282442,0,3,3
80738,3,3,282442,282442,282445,0,3,0
80739,2,2,282444,282445,282447,1,3,0
80740,2,3,282446,282447,282450,1,4,0
80741,6,2,282452,282452,282454,0,2,2
80742,5,3,282457,282457,282460,0,3,3
80743,2,2,282459,282460,282462,1,3,0
80744,4,1,282463,282463,282464,0,1,1
80745,2,3,282465,282465,282468,0,3,1
80746,6,1,282471,282471,282472,0,1,3
80747,5,2,282476,282476,282478,0,2,4
80748,3,3,282479,282479,282482,0,3,1
80749,4,3,282483,282483,282486,0,3,1
80750,3,3,282486,282486,282489,0,3,0
80751,4,1,282490,282490,282491,0,1,1
80752,3,2,282493,282493,282495,0,2,2
80753,4,3,282497,282497,282500,0,3,2
80754,4,2,282501,282501,282503,0,2,1
80755,3,2,282504,282504,282506,0,2,1
80756,4,3,282508,282508,282511,0,3,2
80757,3,1,282511,282511,282512,0,1,0
80758,4,2,282515,282515,282517,0,2,3
80759,2,3,282517,282517,282520,0,3,0
80760,3,2,282520,282520,282522,0,2,0
80761,5,1,282525,282525,282526,0,1,3
80762,1,2,282526,282526,282528,0,2,0
80763,5,1,282531,282531,282532,0,1,3
80764,4,2,282535,282535,282537,0,2,3
80765,1,1,282536,282537,282538,1,2,0
80766,4,1,282540,282540,282541,0,1,2
80767,1,3,282541,282541,282544,0,3,0
80768,3,1,282544,282544,282545,0,1,0
80769,6,3,282550,282550,282553,0,3,5
80770,4,2,282554,282554,282556,0,2,1
80771,6,2,282560,282560,282562,0,2,4
80772,5,3,282565,282565,282568,0,3,3
80773,5,2,282570,282570,282572,0,2,2
80774,6,3,282576,282576,282579,0,3,4
80775,4,1,282580,282580,282581,0,1,1
80776,6,1,282586,282586,282587,0,1,5
80777,5,2,282591,282591,282593,0,2,4
80778,3,3,282594,282594,282597,0,3,1
80779,5,2,282599,282599,282601,0,2,2
80780,6,1,282605,282605,282606,0,1,4
80781,5,3,282610,282610,282613,0,3,4
80782,3,1,282613,282613,282614,0,1,0
80783,6,2,282619,282619,282621,0,2,5
80784,3,3,282622,282622,282625,0,3,1
80785,2,3,282624,282625,282628,1,4,0
80786,4,3,282628,282628,282631,0,3,0
80787,5,3,282633,282633,282636,0,3,2
80788,6,3,282639,282639,282642,0,3,3
80789,5,1,282644,282644,282645,0,1,2
80790,6,3,282650,282650,282653,0,3,5
80791,6,3,282656,282656,282659,0,3,3
80792,4,2,282660,282660,282662,0,2,1
80793,4,1,282664,282664,282665,0,1,2
80794,3,1,282667,282667,282668,0,1,2
80795,4,3,282671,282671,282674,0,3,3
80796,4,2,282675,282675,282677,0,2,1
80797,1,1,282676,282677,282678,1,2,0
80798,5,3,282681,282681,282684,0,3,3
80799,5,3,282686,282686,282689,0,3,2
80800,1,3,282687,282689,282692,2,5,0
80801,4,1,282691,282692,282693,1,2,0
80802,2,1,282693,282693,282694,0,1,0
80803,6,1,282699,282699,282700,0,1,5
80804,3,1,282702,282702,282703,0,1,2
80805,4,1,282706,282706,282707,0,1,3
80806,2,1,282708,282708,282709,0,1,1
80807,1,2,282709,282709,282711,0,2,0
80808,2,3,282711,282711,282714,0,3,0
80809,6,3,282717,282717,282720,0,3,3
80810,2,3,282719,282720,282723,1,4,0
80811,3,2,282722,282723,282725,1,3,0
80812,2,1,282724,282725,282726,1,2,0
80813,4,1,282728,282728,282729,0,1,2
80814,4,1,282732,282732,282733,0,1,3
80815,3,3,282735,282735,282738,0,3,2
80816,4,2,282739,282739,282741,0,2,1
80817,1,2,282740,282741,282743,1,3,0
80818,4,2,282744,282744,282746,0,2,1
80819,1,1,282745,282746,282747,1,2,0
80820,3,2,282748,282748,282750,0,2,1
80821,6,1,282754,282754,282755,0,1,4
80822,3,2,282757,282757,282759,0,2,2
80823,5,3,282762,282762,282765,0,3,3
80824,3,1,282765,282765,282766,0,1,0
80825,5,2,282770,282770,282772,0,2,4
80826,3,1,282773,282773,282774,0,1,1
80827,6,3,282779,282779,282782,0,3,5
80828,4,2,282783,282783,282785,0,2,1
80829,2,2,282785,282785,282787,0,2,0
80830,5,1,282790,282790,282791,0,1,3
80831,5,3,282795,282795,282798,0,3,4
80832,6,3,282801,282801,282804,0,3,3
80833,2,3,282803,282804,282807,1,4,0
80834,2,3,282805,282807,282810,2,5,0
80835,4,2,282809,282810,282812,1,3,0
80836,3,3,282812,282812,282815,0,3,0
80837,5,3,282817,282817,282820,0,3,2
80838,4,2,282821,282821,282823,0,2,1
80839,1,2,282822,282823,282825,1,3,0
80840,2,3,282824,282825,282828,1,4,0
80841,4,3,282828,282828,282831,0,3,0
80842,1,1,282829,282831,282832,2,3,0
80843,3,3,282832,282832,282835,0,3,0
80844,3,3,282835,282835,282838,0,3,0
80845,4,3,282839,282839,282842,0,3,1
80846,6,1,282845,282845,282846,0,1,3
80847,5,3,282850,282850,282853,0,3,4
80848,2,3,282852,282853,282856,1,4,0
80849,4,1,282856,282856,282857,0,1,0
80850,1,3,282857,282857,282860,0,3,0
80851,6,2,282863,282863,282865,0,2,3
80852,3,2,282866,282866,282868,0,2,1
80853,5,1,282871,282871,282872,0,1,3
80854,6,1,282877,282877,282878,0,1,5
80855,3,3,282880,282880,282883,0,3,2
80856,2,2,282882,282883,282885,1,3,0
80857,5,1,282887,282887,282888,0,1,2
80858,5,2,282892,282892,282894,0,2,4
80859,3,1,282895,282895,282896,0,1,1
80860,5,3,282900,282900,282903,0,3,4
80861,4,1,282904,282904,282905,0,1,1
80862,1,2,282905,282905,282907,0,2,0
80863,6,1,282911,282911,282912,0,1,4
80864,2,1,282913,282913,282914,0,1,1
80865,5,2,282918,282918,282920,0,2,4
80866,1,2,282919,282920,282922,1,3,0
80867,5,1,282924,282924,282925,0,1,2
80868,4,2,282928,282928,282930,0,2,3
80869,2,1,282930,282930,282931,0,1,0
80870,6,1,282936,282936,282937,0,1,5
80871,3,2,282939,282939,282941,0,2,2
80872,2,1,282941,282941,282942,0,1,0
80873,5,1,282946,282946,282947,0,1,4
80874,2,3,282948,282948,282951,0,3,1
80875,6,3,282954,282954,282957,0,3,3
80876,5,1,282959,282959,282960,0,1,2
80877,2,3,282961,282961,282964,0,3,1
80878,2,3,282963,282964,282967,1,4,0
80879,2,3,282965,282967,282970,2,5,0
80880,1,3,282966,282970,282973,4,7,0
80881,1,1,282967,282973,282974,6,7,0
80882,2,1,282969,282974,282975,5,6,0
80883,3,2,282972,282975,282977,3,5,0
80884,4,1,282976,282977,282978,1,2,0
80885,5,3,282981,282981,282984,0,3,3
80886,5,2,282986,282986,282988,0,2,2
80887,1,3,282987,282988,282991,1,4,0
80888,3,3,282990,282991,282994,1,4,0
80889,3,1,282993,282994,282995,1,2,0
80890,4,3,282997,282997,283000,0,3,2
80891,3,2,283000,283000,283002,0,2,0
80892,5,3,283005,283005,283008,0,3,3
80893,1,1,283006,283008,283009,2,3,0
80894,6,1,283012,283012,283013,0,1,3
80895,1,2,283013,283013,283015,0,2,0
80896,5,2,283018,283018,283020,0,2,3
80897,1,3,283019,283020,283023,1,4,0
80898,6,1,283025,283025,283026,0,1,2
80899,5,1,283030,283030,283031,0,1,4
80900,4,2,283034,283034,283036,0,2,3
80901,3,3,283037,283037,283040,0,3,1
80902,3,2,283040,283040,283042,0,2,0
80903,2,3,283042,283042,283045,0,3,0
80904,6,2,283048,283048,283050,0,2,3
80905,6,1,283054,283054,283055,0,1,4
80906,2,2,283056,283056,283058,0,2,1
80907,2,2,283058,283058,283060,0,2,0
80908,2,3,283060,283060,283063,0,3,0
80909,1,2,283061,283063,283065,2,4,0
80910,5,2,283066,283066,283068,0,2,1
80911,6,3,283072,283072,283075,0,3,4
80912,6,2,283078,283078,283080,0,2,3
80913,5,2,283083,283083,283085,0,2,3
80914,3,3,283086,283086,283089,0,3,1
80915,2,1,283088,283089,283090,1,2,0
80916,6,3,283094,283094,283097,0,3,4
80917,6,2,283100,283100,283102,0,2,3
80918,4,2,283104,283104,283106,0,2,2
80919,4,1,283108,283108,283109,0,1,2
80920,2,1,283110,283110,283111,0,1,1
80921,5,2,283115,283115,283117,0,2,4
80922,5,2,283120,283120,283122,0,2,3
80923,6,3,283126,283126,283129,0,3,4
80924,6,3,283132,283132,283135,0,3,3
80925,4,1,283136,283136,283137,0,1,1
80926,2,3,283138,283138,283141,0,3,1
80927,2,2,283140,283141,283143,1,3,0
80928,4,3,283144,283144,283147,0,3,1
80929,4,2,283148,283148,283150,0,2,1
80930,1,3,283149,283150,283153,1,4,0
80931,3,1,283152,283153,283154,1,2,0
80932,5,1,283157,283157,283158,0,1,3
80933,3,1,283160,283160,283161,0,1,2
80934,2,1,283162,283162,283163,0,1,1
80935,6,2,283168,283168,283170,0,2,5
80936,5,2,283173,283173,283175,0,2,3
80937,3,1,283176,283176,283177,0,1,1
80938,4,2,283180,283180,283182,0,2,3
80939,4,1,283184,283184,283185,0,1,2
80940,2,1,283186,283186,283187,0,1,1
80941,2,1,283188,283188,283189,0,1,1
80942,1,2,283189,283189,283191,0,2,0
80943,1,2,283190,283191,283193,1,3,0
80944,6,1,283196,283196,283197,0,1,3
80945,6,3,283202,283202,283205,0,3,5
80946,4,2,283206,283206,283208,0,2,1
80947,4,1,283210,283210,283211,0,1,2
80948,6,1,283216,283216,283217,0,1,5
80949,5,1,283221,283221,283222,0,1,4
80950,2,2,283223,283223,283225,0,2,1
80951,6,1,283229,283229,283230,0,1,4
80952,2,1,283231,283231,283232,0,1,1
80953,6,1,283237,283237,283238,0,1,5
80954,5,3,283242,283242,283245,0,3,4
80955,2,3,283244,283245,283248,1,4,0
80956,1,2,283245,283248,283250,3,5,0
80957,5,3,283250,283250,283253,0,3,0
80958,5,3,283255,283255,283258,0,3,2
80959,5,2,283260,283260,283262,0,2,2
80960,6,2,283266,283266,283268,0,2,4
80961,2,1,283268,283268,283269,0,1,0
80962,3,2,283271,283271,283273,0,2,2
80963,2,3,283273,283273,283276,0,3,0
80964,5,3,283278,283278,283281,0,3,2
80965,6,2,283284,283284,283286,0,2,3
80966,6,1,283290,283290,283291,0,1,4
80967,6,3,283296,283296,283299,0,3,5
80968,6,2,283302,283302,283304,0,2,3
80969,2,3,283304,283304,283307,0,3,0
80970,4,3,283308,283308,283311,0,3,1
80971,6,1,283314,283314,283315,0,1,3
80972,3,1,283317,283317,283318,0,1,2
80973,2,3,283319,283319,283322,0,3,1
80974,5,2,283324,283324,283326,0,2,2
80975,4,2,283328,283328,283330,0,2,2
80976,2,1,283330,283330,283331,0,1,0
80977,5,3,283335,283335,283338,0,3,4
80978,4,3,283339,283339,283342,0,3,1
80979,4,3,283343,283343,283346,0,3,1
80980,5,1,283348,283348,283349,0,1,2
80981,2,3,283350,283350,283353,0,3,1
80982,1,1,283351,283353,283354,2,3,0
80983,5,2,283356,283356,283358,0,2,2
80984,6,1,283362,283362,283363,0,1,4
80985,3,2,283365,283365,283367,0,2,2
80986,2,3,283367,283367,283370,0,3,0
80987,3,3,283370,283370,283373,0,3,0
80988,1,2,283371,283373,283375,2,4,0
80989,5,1,283376,283376,283377,0,1,1
80990,6,1,283382,283382,283383,0,1,5
80991,5,2,283387,283387,283389,0,2,4
80992,6,3,283393,283393,283396,0,3,4
80993,1,2,283394,283396,283398,2,4,0
80994,5,2,283399,283399,283401,0,2,1
80995,1,3,283400,283401,283404,1,4,0
80996,2,1,283402,283404,283405,2,3,0
80997,5,2,283407,283407,283409,0,2,2
80998,2,2,283409,283409,283411,0,2,0
80999,5,2,283414,283414,283416,0,2,3
81000,3,2,283417,283417,283419,0,2,1
81001,3,1,283420,283420,283421,0,1,1
81002,5,1,283425,283425,283426,0,1,4
81003,2,2,283427,283427,283429,0,2,1
81004,4,2,283431,283431,283433,0,2,2
81005,1,1,283432,283433,283434,1,2,0
81006,2,2,283434,283434,283436,0,2,0
81007,6,1,283440,283440,283441,0,1,4
81008,2,2,283442,283442,283444,0,2,1
81009,3,3,283445,283445,283448,0,3,1
81010,5,1,283450,283450,283451,0,1,2
81011,1,3,283451,283451,283454,0,3,0
81012,2,1,283453,283454,283455,1,2,0
81013,4,3,283457,283457,283460,0,3,2
81014,5,1,283462,283462,283463,0,1,2
81015,2,2,283464,283464,283466,0,2,1
81016,6,3,283470,283470,283473,0,3,4
81017,5,3,283475,283475,283478,0,3,2
81018,1,1,283476,283478,283479,2,3,0
81019,6,1,283482,283482,283483,0,1,3
81020,3,2,283485,283485,283487,0,2,2
81021,5,1,283490,283490,283491,0,1,3
81022,4,1,283494,283494,283495,0,1,3
81023,6,3,283500,283500,283503,0,3,5
81024,3,3,283503,283503,283506,0,3,0
81025,4,1,283507,283507,283508,0,1,1
81026,2,2,283509,283509,283511,0,2,1
81027,1,2,283510,283511,283513,1,3,0
81028,1,1,283511,283513,283514,2,3,0
81029,2,3,283513,283514,283517,1,4,0
81030,1,2,283514,283517,283519,3,5,0
81031,6,2,283520,283520,283522,0,2,1
81032,3,2,283523,283523,283525,0,2,1
81033,6,3,283529,283529,283532,0,3,4
81034,3,3,283532,283532,283535,0,3,0
81035,3,3,283535,283535,283538,0,3,0
81036,3,3,283538,283538,283541,0,3,0
81037,2,1,283540,283541,283542,1,2,0
81038,2,1,283542,283542,283543,0,1,0
81039,5,1,283547,283547,283548,0,1,4
81040,1,1,283548,283548,283549,0,1,0
81041,1,2,283549,283549,283551,0,2,0
81042,3,3,283552,283552,283555,0,3,1
81043,4,3,283556,283556,283559,0,3,1
81044,6,3,283562,283562,283565,0,3,3
81045,1,2,283563,283565,283567,2,4,0
81046,4,3,283567,283567,283570,0,3,0
81047,2,2,283569,283570,283572,1,3,0
81048,1,2,283570,283572,283574,2,4,0
81049,4,1,283574,283574,283575,0,1,0
81050,3,3,283577,283577,283580,0,3,2
81051,2,3,283579,283580,283583,1,4,0
81052,5,3,283584,283584,283587,0,3,1
81053,3,2,283587,283587,283589,0,2,0
81054,6,2,283593,283593,283595,0,2,4
81055,1,2,283594,283595,283597,1,3,0
81056,5,3,283599,283599,283602,0,3,2
81057,4,1,283603,283603,283604,0,1,1
81058,6,3,283609,283609,283612,0,3,5
81059,1,1,283610,283612,283613,2,3,0
81060,3,1,283613,283613,283614,0,1,0
81061,5,1,283618,283618,283619,0,1,4
81062,5,2,283623,283623,283625,0,2,4
81063,1,2,283624,283625,283627,1,3,0
81064,1,2,283625,283627,283629,2,4,0
81065,3,3,283628,283629,283632,1,4,0
81066,3,1,283631,283632,283633,1,2,0
81067,5,3,283636,283636,283639,0,3,3
81068,4,2,283640,283640,283642,0,2,1
81069,4,1,283644,283644,283645,0,1,2
81070,6,1,283650,283650,283651,0,1,5
81071,6,1,283656,283656,283657,0,1,5
81072,4,1,283660,283660,283661,0,1,3
81073,4,2,283664,283664,283666,0,2,3
81074,2,2,283666,283666,283668,0,2,0
81075,3,2,283669,283669,283671,0,2,1
81076,5,2,283674,283674,283676,0,2,3
81077,2,2,283676,283676,283678,0,2,0
81078,3,3,283679,283679,283682,0,3,1
81079,3,2,283682,283682,283684,0,2,0
81080,5,2,283687,283687,283689,0,2,3
81081,4,1,283691,283691,283692,0,1,2
81082,3,1,283694,283694,283695,0,1,2
81083,1,2,283695,283695,283697,0,2,0
81084,1,2,283696,283697,283699,1,3,0
81085,6,1,283702,283702,283703,0,1,3
81086,5,1,283707,283707,283708,0,1,4
81087,5,1,283712,283712,283713,0,1,4
81088,1,3,283713,283713,283716,0,3,0
81089,2,1,283715,283716,283717,1,2,0
81090,4,3,283719,283719,283722,0,3,2
81091,5,3,283724,283724,283727,0,3,2
81092,6,1,283730,283730,283731,0,1,3
81093,3,1,283733,283733,283734,0,1,2
81094,6,3,283739,283739,283742,0,3,5
81095,4,2,283743,283743,283745,0,2,1
81096,3,1,283746,283746,283747,0,1,1
81097,4,2,283750,283750,283752,0,2,3
81098,1,2,283751,283752,283754,1,3,0
81099,4,2,283755,283755,283757,0,2,1
81100,6,2,283761,283761,283763,0,2,4
81101,3,1,283764,283764,283765,0,1,1
81102,5,2,283769,283769,283771,0,2,4
81103,1,3,283770,283771,283774,1,4,0
81104,1,3,283771,283774,283777,3,6,0
81105,5,3,283776,283777,283780,1,4,0
81106,3,2,283779,283780,283782,1,3,0
81107,6,1,283785,283785,283786,0,1,3
81108,5,3,283790,283790,283793,0,3,4
81109,5,2,283795,283795,283797,0,2,2
81110,4,3,283799,283799,283802,0,3,2
81111,1,3,283800,283802,283805,2,5,0
81112,5,3,283805,283805,283808,0,3,0
81113,6,2,283811,283811,283813,0,2,3
81114,2,1,283813,283813,283814,0,1,0
81115,5,1,283818,283818,283819,0,1,4
81116,6,3,283824,283824,283827,0,3,5
81117,6,1,283830,283830,283831,0,1,3
81118,1,1,283831,283831,283832,0,1,0
81119,6,2,283837,283837,283839,0,2,5
81120,3,1,283840,283840,283841,0,1,1
81121,3,2,283843,283843,283845,0,2,2
81122,3,2,283846,283846,283848,0,2,1
81123,5,1,283851,283851,283852,0,1,3
81124,6,3,283857,283857,283860,0,3,5
81125,5,3,283862,283862,283865,0,3,2
81126,3,3,283865,283865,283868,0,3,0
81127,6,1,283871,283871,283872,0,1,3
81128,4,3,283875,283875,283878,0,3,3
81129,3,2,283878,283878,283880,0,2,0
81130,5,2,283883,283883,283885,0,2,3
81131,4,1,283887,283887,283888,0,1,2
81132,5,2,283892,283892,283894,0,2,4
81133,2,3,283894,283894,283897,0,3,0
81134,1,1,283895,283897,283898,2,3,0
81135,6,1,283901,283901,283902,0,1,3
81136,6,2,283907,283907,283909,0,2,5
81137,5,3,283912,283912,283915,0,3,3
81138,3,2,283915,283915,283917,0,2,0
81139,6,2,283921,283921,283923,0,2,4
81140,5,3,283926,283926,283929,0,3,3
81141,3,2,283929,283929,283931,0,2,0
81142,6,3,283935,283935,283938,0,3,4
81143,2,1,283937,283938,283939,1,2,0
81144,4,1,283941,283941,283942,0,1,2
81145,6,1,283947,283947,283948,0,1,5
81146,5,2,283952,283952,283954,0,2,4
81147,4,1,283956,283956,283957,0,1,2
81148,2,2,283958,283958,283960,0,2,1
81149,6,1,283964,283964,283965,0,1,4
81150,2,3,283966,283966,283969,0,3,1
81151,2,2,283968,283969,283971,1,3,0
81152,1,2,283969,283971,283973,2,4,0
81153,6,2,283975,283975,283977,0,2,2
81154,6,1,283981,283981,283982,0,1,4
81155,5,1,283986,283986,283987,0,1,4
81156,3,3,283989,283989,283992,0,3,2
81157,2,2,283991,283992,283994,1,3,0
81158,4,2,283995,283995,283997,0,2,1
81159,4,1,283999,283999,284000,0,1,2
81160,2,3,284001,284001,284004,0,3,1
81161,6,2,284007,284007,284009,0,2,3
81162,3,2,284010,284010,284012,0,2,1
81163,3,2,284013,284013,284015,0,2,1
81164,5,3,284018,284018,284021,0,3,3
81165,1,1,284019,284021,284022,2,3,0
81166,6,3,284025,284025,284028,0,3,3
81167,4,1,284029,284029,284030,0,1,1
81168,6,1,284035,284035,284036,0,1,5
81169,2,3,284037,284037,284040,0,3,1
81170,6,2,284043,284043,284045,0,2,3
81171,2,2,284045,284045,284047,0,2,0
81172,5,3,284050,284050,284053,0,3,3
81173,6,1,284056,284056,284057,0,1,3
81174,4,1,284060,284060,284061,0,1,3
81175,1,2,284061,284061,284063,0,2,0
81176,4,3,284065,284065,284068,0,3,2
81177,4,3,284069,284069,284072,0,3,1
81178,3,3,284072,284072,284075,0,3,0
81179,1,1,284073,284075,284076,2,3,0
81180,3,3,284076,284076,284079,0,3,0
81181,4,1,284080,284080,284081,0,1,1
81182,3,1,284083,284083,284084,0,1,2
81183,5,2,284088,284088,284090,0,2,4
81184,4,3,284092,284092,284095,0,3,2
81185,5,3,284097,284097,284100,0,3,2
81186,6,3,284103,284103,284106,0,3,3
81187,5,3,284108,284108,284111,0,3,2
81188,6,3,284114,284114,284117,0,3,3
81189,1,3,284115,284117,284120,2,5,0
81190,3,1,284118,284120,284121,2,3,0
81191,2,2,284120,284121,284123,1,3,0
81192,4,1,284124,284124,284125,0,1,1
81193,1,3,284125,284125,284128,0,3,0
81194,6,2,284131,284131,284133,0,2,3
81195,4,2,284135,284135,284137,0,2,2
81196,3,1,284138,284138,284139,0,1,1
81197,5,2,284143,284143,284145,0,2,4
81198,6,3,284149,284149,284152,0,3,4
81199,2,1,284151,284152,284153,1,2,0
81200,2,2,284153,284153,284155,0,2,0
81201,4,3,284157,284157,284160,0,3,2
81202,1,2,284158,284160,284162,2,4,0
81203,4,1,284162,284162,284163,0,1,0
81204,1,2,284163,284163,284165,0,2,0
81205,6,3,284169,284169,284172,0,3,4
81206,4,2,284173,284173,284175,0,2,1
81207,5,1,284178,284178,284179,0,1,3
81208,2,1,284180,284180,284181,0,1,1
81209,6,2,284186,284186,284188,0,2,5
81210,3,3,284189,284189,284192,0,3,1
81211,1,1,284190,284192,284193,2,3,0
81212,5,1,284195,284195,284196,0,1,2
81213,4,3,284199,284199,284202,0,3,3
81214,2,1,284201,284202,284203,1,2,0
81215,6,3,284207,284207,284210,0,3,4
81216,1,2,284208,284210,284212,2,4,0
81217,2,1,284210,284212,284213,2,3,0
81218,3,2,284213,284213,284215,0,2,0
81219,4,3,284217,284217,284220,0,3,2
81220,6,1,284223,284223,284224,0,1,3
81221,1,2,284224,284224,284226,0,2,0
81222,5,3,284229,284229,284232,0,3,3
81223,1,2,284230,284232,284234,2,4,0
81224,3,2,284233,284234,284236,1,3,0
81225,1,3,284234,284236,284239,2,5,0
81226,3,3,284237,284239,284242,2,5,0
81227,3,2,284240,284242,284244,2,4,0
81228,4,1,284244,284244,284245,0,1,0
81229,1,1,284245,284245,284246,0,1,0
81230,5,3,284250,284250,284253,0,3,4
81231,5,1,284255,284255,284256,0,1,2
81232,4,3,284259,284259,284262,0,3,3
81233,2,2,284261,284262,284264,1,3,0
81234,1,1,284262,284264,284265,2,3,0
81235,6,1,284268,284268,284269,0,1,3
81236,2,3,284270,284270,284273,0,3,1
81237,5,3,284275,284275,284278,0,3,2
81238,4,1,284279,284279,284280,0,1,1
81239,3,1,284282,284282,284283,0,1,2
81240,6,1,284288,284288,284289,0,1,5
81241,1,1,284289,284289,284290,0,1,0
81242,3,1,284292,284292,284293,0,1,2
81243,3,2,284295,284295,284297,0,2,2
81244,1,1,284296,284297,284298,1,2,0
81245,6,1,284302,284302,284303,0,1,4
81246,5,2,284307,284307,284309,0,2,4
81247,6,3,284313,284313,284316,0,3,4
81248,5,2,284318,284318,284320,0,2,2
81249,5,1,284323,284323,284324,0,1,3
81250,1,2,284324,284324,284326,0,2,0
81251,2,3,284326,284326,284329,0,3,0
81252,3,1,284329,284329,284330,0,1,0
81253,5,3,284334,284334,284337,0,3,4
81254,2,1,284336,284337,284338,1,2,0
81255,6,2,284342,284342,284344,0,2,4
81256,3,1,284345,284345,284346,0,1,1
81257,5,1,284350,284350,284351,0,1,4
81258,3,1,284353,284353,284354,0,1,2
81259,4,3,284357,284357,284360,0,3,3
81260,3,1,284360,284360,284361,0,1,0
81261,1,2,284361,284361,284363,0,2,0
81262,5,2,284366,284366,284368,0,2,3
81263,2,3,284368,284368,284371,0,3,0
81264,6,1,284374,284374,284375,0,1,3
81265,1,1,284375,284375,284376,0,1,0
81266,1,2,284376,284376,284378,0,2,0
81267,1,3,284377,284378,284381,1,4,0
81268,3,3,284380,284381,284384,1,4,0
81269,6,1,284386,284386,284387,0,1,2
81270,4,1,284390,284390,284391,0,1,3
81271,5,2,284395,284395,284397,0,2,4
81272,1,3,284396,284397,284400,1,4,0
81273,3,2,284399,284400,284402,1,3,0
81274,4,1,284403,284403,284404,0,1,1
81275,2,3,284405,284405,284408,0,3,1
81276,1,1,284406,284408,284409,2,3,0
81277,1,1,284407,284409,284410,2,3,0
81278,1,3,284408,284410,284413,2,5,0
81279,4,1,284412,284413,284414,1,2,0
81280,3,2,284415,284415,284417,0,2,1
81281,2,3,284417,284417,284420,0,3,0
81282,5,1,284422,284422,284423,0,1,2
81283,2,3,284424,284424,284427,0,3,1
81284,5,1,284429,284429,284430,0,1,2
81285,3,1,284432,284432,284433,0,1,2
81286,2,1,284434,284434,284435,0,1,1
81287,4,3,284438,284438,284441,0,3,3
81288,6,3,284444,284444,284447,0,3,3
81289,3,1,284447,284447,284448,0,1,0
81290,6,3,284453,284453,284456,0,3,5
81291,2,1,284455,284456,284457,1,2,0
81292,6,1,284461,284461,284462,0,1,4
81293,3,3,284464,284464,284467,0,3,2
81294,1,1,284465,284467,284468,2,3,0
81295,3,1,284468,284468,284469,0,1,0
81296,2,3,284470,284470,284473,0,3,1
81297,1,3,284471,284473,284476,2,5,0
81298,6,2,284477,284477,284479,0,2,1
81299,4,3,284481,284481,284484,0,3,2
81300,3,2,284484,284484,284486,0,2,0
81301,4,2,284488,284488,284490,0,2,2
81302,1,3,284489,284490,284493,1,4,0
81303,5,1,284494,284494,284495,0,1,1
81304,5,2,284499,284499,284501,0,2,4
81305,5,3,284504,284504,284507,0,3,3
81306,1,2,284505,284507,284509,2,4,0
81307,6,2,284511,284511,284513,0,2,2
81308,5,2,284516,284516,284518,0,2,3
81309,6,3,284522,284522,284525,0,3,4
81310,2,2,284524,284525,284527,1,3,0
81311,1,1,284525,284527,284528,2,3,0
81312,3,1,284528,284528,284529,0,1,0
81313,3,1,284531,284531,284532,0,1,2
81314,3,1,284534,284534,284535,0,1,2
81315,5,1,284539,284539,284540,0,1,4
81316,4,3,284543,284543,284546,0,3,3
81317,4,2,284547,284547,284549,0,2,1
81318,4,2,284551,284551,284553,0,2,2
81319,2,3,284553,284553,284556,0,3,0
81320,4,3,284557,284557,284560,0,3,1
81321,6,1,284563,284563,284564,0,1,3
81322,2,3,284565,284565,284568,0,3,1
81323,1,2,284566,284568,284570,2,4,0
81324,5,3,284571,284571,284574,0,3,1
81325,5,1,284576,284576,284577,0,1,2
81326,3,1,284579,284579,284580,0,1,2
81327,1,3,284580,284580,284583,0,3,0
81328,6,3,284586,284586,284589,0,3,3
81329,5,3,284591,284591,284594,0,3,2
81330,4,3,284595,284595,284598,0,3,1
81331,6,3,284601,284601,284604,0,3,3
81332,5,3,284606,284606,284609,0,3,2
81333,2,1,284608,284609,284610,1,2,0
81334,6,2,284614,284614,284616,0,2,4
81335,6,2,284620,284620,284622,0,2,4
81336,5,2,284625,284625,284627,0,2,3
81337,5,3,284630,284630,284633,0,3,3
81338,1,1,284631,284633,284634,2,3,0
81339,6,1,284637,284637,284638,0,1,3
81340,2,1,284639,284639,284640,0,1,1
81341,5,1,284644,284644,284645,0,1,4
81342,5,3,284649,284649,284652,0,3,4
81343,4,2,284653,284653,284655,0,2,1
81344,4,2,284657,284657,284659,0,2,2
81345,6,2,284663,284663,284665,0,2,4
81346,1,2,284664,284665,284667,1,3,0
81347,2,3,284666,284667,284670,1,4,0
81348,3,2,284669,284670,284672,1,3,0
81349,5,2,284674,284674,284676,0,2,2
81350,3,3,284677,284677,284680,0,3,1
81351,3,3,284680,284680,284683,0,3,0
81352,2,2,284682,284683,284685,1,3,0
81353,4,3,284686,284686,284689,0,3,1
81354,2,1,284688,284689,284690,1,2,0
81355,1,1,284689,284690,284691,1,2,0
81356,5,3,284694,284694,284697,0,3,3
81357,3,1,284697,284697,284698,0,1,0
81358,3,2,284700,284700,284702,0,2,2
81359,2,1,284702,284702,284703,0,1,0
81360,5,1,284707,284707,284708,0,1,4
81361,3,3,284710,284710,284713,0,3,2
81362,4,1,284714,284714,284715,0,1,1
81363,3,2,284717,284717,284719,0,2,2
81364,1,3,284718,284719,284722,1,4,0
81365,3,2,284721,284722,284724,1,3,0
81366,3,2,284724,284724,284726,0,2,0
81367,1,1,284725,284726,284727,1,2,0
81368,4,3,284729,284729,284732,0,3,2
81369,5,3,284734,284734,284737,0,3,2
81370,6,1,284740,284740,284741,0,1,3
81371,1,3,284741,284741,284744,0,3,0
81372,5,2,284746,284746,284748,0,2,2
81373,3,3,284749,284749,284752,0,3,1
81374,3,1,284752,284752,284753,0,1,0
81375,5,1,284757,284757,284758,0,1,4
81376,4,2,284761,284761,284763,0,2,3
81377,4,1,284765,284765,284766,0,1,2
81378,2,1,284767,284767,284768,0,1,1
81379,4,3,284771,284771,284774,0,3,3
81380,5,3,284776,284776,284779,0,3,2
81381,1,3,284777,284779,284782,2,5,0
81382,6,3,284783,284783,284786,0,3,1
81383,6,3,284789,284789,284792,0,3,3
81384,5,3,284794,284794,284797,0,3,2
81385,6,1,284800,284800,284801,0,1,3
81386,6,1,284806,284806,284807,0,1,5
81387,4,3,284810,284810,284813,0,3,3
81388,3,3,284813,284813,284816,0,3,0
81389,4,1,284817,284817,284818,0,1,1
81390,4,3,284821,284821,284824,0,3,3
81391,1,1,284822,284824,284825,2,3,0
81392,4,2,284826,284826,284828,0,2,1
81393,1,3,284827,284828,284831,1,4,0
81394,4,2,284831,284831,284833,0,2,0
81395,2,2,284833,284833,284835,0,2,0
81396,3,1,284836,284836,284837,0,1,1
81397,6,1,284842,284842,284843,0,1,5
81398,6,2,284848,284848,284850,0,2,5
81399,2,3,284850,284850,284853,0,3,0
81400,2,1,284852,284853,284854,1,2,0
81401,4,2,284856,284856,284858,0,2,2
81402,6,2,284862,284862,284864,0,2,4
81403,6,1,284868,284868,284869,0,1,4
81404,3,2,284871,284871,284873,0,2,2
81405,5,2,284876,284876,284878,0,2,3
81406,2,2,284878,284878,284880,0,2,0
81407,6,3,284884,284884,284887,0,3,4
81408,4,2,284888,284888,284890,0,2,1
81409,2,3,284890,284890,284893,0,3,0
81410,1,2,284891,284893,284895,2,4,0
81411,4,3,284895,284895,284898,0,3,0
81412,5,2,284900,284900,284902,0,2,2
81413,6,2,284906,284906,284908,0,2,4
81414,3,3,284909,284909,284912,0,3,1
81415,3,2,284912,284912,284914,0,2,0
81416,4,1,284916,284916,284917,0,1,2
81417,5,2,284921,284921,284923,0,2,4
81418,1,3,284922,284923,284926,1,4,0
81419,5,3,284927,284927,284930,0,3,1
81420,1,2,284928,284930,284932,2,4,0
81421,3,3,284931,284932,284935,1,4,0
81422,5,1,284936,284936,284937,0,1,1
81423,5,2,284941,284941,284943,0,2,4
81424,2,3,284943,284943,284946,0,3,0
81425,1,1,284944,284946,284947,2,3,0
81426,3,1,284947,284947,284948,0,1,0
81427,3,1,284950,284950,284951,0,1,2
81428,3,1,284953,284953,284954,0,1,2
81429,6,1,284959,284959,284960,0,1,5
81430,5,3,284964,284964,284967,0,3,4
81431,3,1,284967,284967,284968,0,1,0
81432,2,3,284969,284969,284972,0,3,1
81433,2,1,284971,284972,284973,1,2,0
81434,2,2,284973,284973,284975,0,2,0
81435,4,2,284977,284977,284979,0,2,2
81436,6,3,284983,284983,284986,0,3,4
81437,4,3,284987,284987,284990,0,3,1
81438,6,3,284993,284993,284996,0,3,3
81439,4,1,284997,284997,284998,0,1,1
81440,4,3,285001,285001,285004,0,3,3
81441,3,3,285004,285004,285007,0,3,0
81442,1,2,285005,285007,285009,2,4,0
81443,1,1,285006,285009,285010,3,4,0
81444,3,1,285009,285010,285011,1,2,0
81445,3,2,285012,285012,285014,0,2,1
81446,4,3,285016,285016,285019,0,3,2
81447,2,1,285018,285019,285020,1,2,0
81448,6,3,285024,285024,285027,0,3,4
81449,2,1,285026,285027,285028,1,2,0
81450,6,1,285032,285032,285033,0,1,4
81451,5,2,285037,285037,285039,0,2,4
81452,1,3,285038,285039,285042,1,4,0
81453,4,3,285042,285042,285045,0,3,0
81454,4,2,285046,285046,285048,0,2,1
81455,3,3,285049,285049,285052,0,3,1
81456,4,3,285053,285053,285056,0,3,1
81457,6,3,285059,285059,285062,0,3,3
81458,6,3,285065,285065,285068,0,3,3
81459,2,1,285067,285068,285069,1,2,0
81460,1,3,285068,285069,285072,1,4,0
81461,5,2,285073,285073,285075,0,2,1
81462,6,1,285079,285079,285080,0,1,4
81463,1,3,285080,285080,285083,0,3,0
81464,4,2,285084,285084,285086,0,2,1
81465,3,2,285087,285087,285089,0,2,1
81466,6,3,285093,285093,285096,0,3,4
81467,1,2,285094,285096,285098,2,4,0
81468,3,2,285097,285098,285100,1,3,0
81469,6,1,285103,285103,285104,0,1,3
81470,3,2,285106,285106,285108,0,2,2
81471,2,2,285108,285108,285110,0,2,0
81472,6,2,285114,285114,285116,0,2,4
81473,1,3,285115,285116,285119,1,4,0
81474,3,2,285118,285119,285121,1,3,0
81475,3,2,285121,285121,285123,0,2,0
81476,6,1,285127,285127,285128,0,1,4
81477,2,3,285129,285129,285132,0,3,1
81478,1,1,285130,285132,285133,2,3,0
81479,3,3,285133,285133,285136,0,3,0
81480,1,1,285134,285136,285137,2,3,0
81481,6,2,285140,285140,285142,0,2,3
81482,2,2,285142,285142,285144,0,2,0
81483,5,1,285147,285147,285148,0,1,3
81484,3,2,285150,285150,285152,0,2,2
81485,3,1,285153,285153,285154,0,1,1
81486,4,3,285157,285157,285160,0,3,3
81487,4,3,285161,285161,285164,0,3,1
81488,4,1,285165,285165,285166,0,1,1
81489,2,3,285167,285167,285170,0,3,1
81490,4,1,285171,285171,285172,0,1,1
81491,5,1,285176,285176,285177,0,1,4
81492,2,3,285178,285178,285181,0,3,1
81493,5,1,285183,285183,285184,0,1,2
81494,5,1,285188,285188,285189,0,1,4
81495,3,3,285191,285191,285194,0,3,2
81496,4,3,285195,285195,285198,0,3,1
81497,4,3,285199,285199,285202,0,3,1
81498,3,3,285202,285202,285205,0,3,0
81499,4,2,285206,285206,285208,0,2,1
81500,3,1,285209,285209,285210,0,1,1
81501,4,2,285213,285213,285215,0,2,3
81502,1,3,285214,285215,285218,1,4,0
81503,5,1,285219,285219,285220,0,1,1
81504,1,2,285220,285220,285222,0,2,0
81505,6,3,285226,285226,285229,0,3,4
81506,6,3,285232,285232,285235,0,3,3
81507,2,3,285234,285235,285238,1,4,0
81508,2,3,285236,285238,285241,2,5,0
81509,1,2,285237,285241,285243,4,6,0
81510,6,1,285243,285243,285244,0,1,0
81511,1,1,285244,285244,285245,0,1,0
81512,3,1,285247,285247,285248,0,1,2
81513,3,3,285250,285250,285253,0,3,2
81514,4,2,285254,285254,285256,0,2,1
81515,4,2,285258,285258,285260,0,2,2
81516,1,2,285259,285260,285262,1,3,0
81517,1,2,285260,285262,285264,2,4,0
81518,3,2,285263,285264,285266,1,3,0
81519,3,3,285266,285266,285269,0,3,0
81520,5,3,285271,285271,285274,0,3,2
81521,4,2,285275,285275,285277,0,2,1
81522,1,3,285276,285277,285280,1,4,0
81523,3,3,285279,285280,285283,1,4,0
81524,5,2,285284,285284,285286,0,2,1
81525,6,3,285290,285290,285293,0,3,4
81526,4,1,285294,285294,285295,0,1,1
81527,4,3,285298,285298,285301,0,3,3
81528,4,1,285302,285302,285303,0,1,1
81529,6,1,285308,285308,285309,0,1,5
81530,2,2,285310,285310,285312,0,2,1
81531,2,3,285312,285312,285315,0,3,0
81532,4,3,285316,285316,285319,0,3,1
81533,1,2,285317,285319,285321,2,4,0
81534,2,2,285319,285321,285323,2,4,0
81535,4,3,285323,285323,285326,0,3,0
81536,2,3,285325,285326,285329,1,4,0
81537,6,3,285331,285331,285334,0,3,2
81538,5,3,285336,285336,285339,0,3,2
81539,5,2,285341,285341,285343,0,2,2
81540,1,3,285342,285343,285346,1,4,0
81541,3,2,285345,285346,285348,1,3,0
81542,4,3,285349,285349,285352,0,3,1
81543,3,2,285352,285352,285354,0,2,0
81544,3,3,285355,285355,285358,0,3,1
81545,5,3,285360,285360,285363,0,3,2
81546,4,3,285364,285364,285367,0,3,1
81547,4,3,285368,285368,285371,0,3,1
81548,6,1,285374,285374,285375,0,1,3
81549,6,1,285380,285380,285381,0,1,5
81550,6,3,285386,285386,285389,0,3,5
81551,1,3,285387,285389,285392,2,5,0
81552,6,3,285393,285393,285396,0,3,1
81553,1,2,285394,285396,285398,2,4,0
81554,6,1,285400,285400,285401,0,1,2
81555,2,3,285402,285402,285405,0,3,1
81556,5,3,285407,285407,285410,0,3,2
81557,5,3,285412,285412,285415,0,3,2
81558,2,3,285414,285415,285418,1,4,0
81559,6,1,285420,285420,285421,0,1,2
81560,6,3,285426,285426,285429,0,3,5
81561,1,2,285427,285429,285431,2,4,0
81562,3,3,285430,285431,285434,1,4,0
81563,6,2,285436,285436,285438,0,2,2
81564,4,1,285440,285440,285441,0,1,2
81565,3,3,285443,285443,285446,0,3,2
81566,5,3,285448,285448,285451,0,3,2
81567,6,2,285454,285454,285456,0,2,3
81568,5,2,285459,285459,285461,0,2,3
81569,3,1,285462,285462,285463,0,1,1
81570,6,2,285468,285468,285470,0,2,5
81571,2,3,285470,285470,285473,0,3,0
81572,1,3,285471,285473,285476,2,5,0
81573,3,3,285474,285476,285479,2,5,0
81574,5,1,285479,285479,285480,0,1,0
81575,4,3,285483,285483,285486,0,3,3
81576,6,3,285489,285489,285492,0,3,3
81577,5,3,285494,285494,285497,0,3,2
81578,4,2,285498,285498,285500,0,2,1
81579,3,2,285501,285501,285503,0,2,1
81580,5,3,285506,285506,285509,0,3,3
81581,3,1,285509,285509,285510,0,1,0
81582,5,3,285514,285514,285517,0,3,4
81583,6,2,285520,285520,285522,0,2,3
81584,3,1,285523,285523,285524,0,1,1
81585,2,2,285525,285525,285527,0,2,1
81586,6,2,285531,285531,285533,0,2,4
81587,4,1,285535,285535,285536,0,1,2
81588,6,3,285541,285541,285544,0,3,5
81589,5,2,285546,285546,285548,0,2,2
81590,2,2,285548,285548,285550,0,2,0
81591,2,3,285550,285550,285553,0,3,0
81592,4,1,285554,285554,285555,0,1,1
81593,6,1,285560,285560,285561,0,1,5
81594,4,2,285564,285564,285566,0,2,3
81595,2,1,285566,285566,285567,0,1,0
81596,6,2,285572,285572,285574,0,2,5
81597,1,3,285573,285574,285577,1,4,0
81598,6,3,285579,285579,285582,0,3,2
81599,1,3,285580,285582,285585,2,5,0
81600,3,3,285583,285585,285588,2,5,0
81601,6,2,285589,285589,285591,0,2,1
81602,5,1,285594,285594,285595,0,1,3
81603,4,1,285598,285598,285599,0,1,3
81604,5,1,285603,285603,285604,0,1,4
81605,3,1,285606,285606,285607,0,1,2
81606,1,1,285607,285607,285608,0,1,0
81607,2,1,285609,285609,285610,0,1,1
81608,3,3,285612,285612,285615,0,3,2
81609,5,3,285617,285617,285620,0,3,2
81610,2,3,285619,285620,285623,1,4,0
81611,1,3,285620,285623,285626,3,6,0
81612,4,1,285624,285626,285627,2,3,0
81613,1,1,285625,285627,285628,2,3,0
81614,3,1,285628,285628,285629,0,1,0
81615,4,3,285632,285632,285635,0,3,3
81616,1,2,285633,285635,285637,2,4,0
81617,4,1,285637,285637,285638,0,1,0
81618,6,2,285643,285643,285645,0,2,5
81619,1,3,285644,285645,285648,1,4,0
81620,3,3,285647,285648,285651,1,4,0
81621,1,2,285648,285651,285653,3,5,0
81622,5,3,285653,285653,285656,0,3,0
81623,1,2,285654,285656,285658,2,4,0
81624,4,2,285658,285658,285660,0,2,0
81625,6,2,285664,285664,285666,0,2,4
81626,4,1,285668,285668,285669,0,1,2
81627,2,2,285670,285670,285672,0,2,1
81628,2,3,285672,285672,285675,0,3,0
81629,3,1,285675,285675,285676,0,1,0
81630,6,2,285681,285681,285683,0,2,5
81631,6,3,285687,285687,285690,0,3,4
81632,6,2,285693,285693,285695,0,2,3
81633,2,3,285695,285695,285698,0,3,0
81634,6,3,285701,285701,285704,0,3,3
81635,4,1,285705,285705,285706,0,1,1
81636,3,3,285708,285708,285711,0,3,2
81637,2,2,285710,285711,285713,1,3,0
81638,4,2,285714,285714,285716,0,2,1
81639,2,2,285716,285716,285718,0,2,0
81640,5,1,285721,285721,285722,0,1,3
81641,4,2,285725,285725,285727,0,2,3
81642,5,1,285730,285730,285731,0,1,3
81643,3,3,285733,285733,285736,0,3,2
81644,4,3,285737,285737,285740,0,3,1
81645,6,1,285743,285743,285744,0,1,3
81646,1,1,285744,285744,285745,0,1,0
81647,4,1,285748,285748,285749,0,1,3
81648,6,2,285754,285754,285756,0,2,5
81649,3,3,285757,285757,285760,0,3,1
81650,3,1,285760,285760,285761,0,1,0
81651,4,1,285764,285764,285765,0,1,3
81652,2,1,285766,285766,285767,0,1,1
81653,2,1,285768,285768,285769,0,1,1
81654,6,2,285774,285774,285776,0,2,5
81655,1,3,285775,285776,285779,1,4,0
81656,5,3,285780,285780,285783,0,3,1
81657,5,2,285785,285785,285787,0,2,2
81658,6,1,285791,285791,285792,0,1,4
81659,1,2,285792,285792,285794,0,2,0
81660,6,2,285798,285798,285800,0,2,4
81661,2,2,285800,285800,285802,0,2,0
81662,1,3,285801,285802,285805,1,4,0
81663,5,3,285806,285806,285809,0,3,1
81664,2,2,285808,285809,285811,1,3,0
81665,2,2,285810,285811,285813,1,3,0
81666,6,2,285816,285816,285818,0,2,3
81667,6,2,285822,285822,285824,0,2,4
81668,3,1,285825,285825,285826,0,1,1
81669,1,3,285826,285826,285829,0,3,0
81670,2,1,285828,285829,285830,1,2,0
81671,3,1,285831,285831,285832,0,1,1
81672,3,2,285834,285834,285836,0,2,2
81673,4,2,285838,285838,285840,0,2,2
81674,1,1,285839,285840,285841,1,2,0
81675,5,2,285844,285844,285846,0,2,3
81676,2,1,285846,285846,285847,0,1,0
81677,3,1,285849,285849,285850,0,1,2
81678,4,2,285853,285853,285855,0,2,3
81679,6,1,285859,285859,285860,0,1,4
81680,1,1,285860,285860,285861,0,1,0
81681,5,2,285865,285865,285867,0,2,4
81682,3,2,285868,285868,285870,0,2,1
81683,1,1,285869,285870,285871,1,2,0
81684,1,3,285870,285871,285874,1,4,0
81685,4,1,285874,285874,285875,0,1,0
81686,4,1,285878,285878,285879,0,1,3
81687,1,1,285879,285879,285880,0,1,0
81688,1,1,285880,285880,285881,0,1,0
81689,3,1,285883,285883,285884,0,1,2
81690,5,1,285888,285888,285889,0,1,4
81691,2,3,285890,285890,285893,0,3,1
81692,6,2,285896,285896,285898,0,2,3
81693,6,3,285902,285902,285905,0,3,4
81694,1,1,285903,285905,285906,2,3,0
81695,4,3,285907,285907,285910,0,3,1
81696,2,2,285909,285910,285912,1,3,0
81697,6,2,285915,285915,285917,0,2,3
81698,5,3,285920,285920,285923,0,3,3
81699,5,1,285925,285925,285926,0,1,2
81700,2,1,285927,285927,285928,0,1,1
81701,4,1,285931,285931,285932,0,1,3
81702,4,2,285935,285935,285937,0,2,3
81703,2,2,285937,285937,285939,0,2,0
81704,2,1,285939,285939,285940,0,1,0
81705,3,2,285942,285942,285944,0,2,2
81706,3,1,285945,285945,285946,0,1,1
81707,5,1,285950,285950,285951,0,1,4
81708,6,3,285956,285956,285959,0,3,5
81709,4,2,285960,285960,285962,0,2,1
81710,3,2,285963,285963,285965,0,2,1
81711,6,2,285969,285969,285971,0,2,4
81712,3,3,285972,285972,285975,0,3,1
81713,5,1,285977,285977,285978,0,1,2
81714,5,2,285982,285982,285984,0,2,4
81715,4,3,285986,285986,285989,0,3,2
81716,1,1,285987,285989,285990,2,3,0
81717,1,1,285988,285990,285991,2,3,0
81718,4,3,285992,285992,285995,0,3,1
81719,6,2,285998,285998,286000,0,2,3
81720,2,2,286000,286000,286002,0,2,0
81721,4,2,286004,286004,286006,0,2,2
81722,6,3,286010,286010,286013,0,3,4
81723,1,3,286011,286013,286016,2,5,0
81724,1,3,286012,286016,286019,4,7,0
81725,6,2,286018,286019,286021,1,3,0
81726,2,1,286020,286021,286022,1,2,0
81727,3,2,286023,286023,286025,0,2,1
81728,4,1,286027,286027,286028,0,1,2
81729,6,3,286033,286033,286036,0,3,5
81730,1,3,286034,286036,286039,2,5,0
81731,6,3,286040,286040,286043,0,3,1
81732,4,2,286044,286044,286046,0,2,1
81733,1,1,286045,286046,286047,1,2,0
81734,5,2,286050,286050,286052,0,2,3
81735,5,1,286055,286055,286056,0,1,3
81736,1,1,286056,286056,286057,0,1,0
81737,4,2,286060,286060,286062,0,2,3
81738,3,1,286063,286063,286064,0,1,1
81739,5,3,286068,286068,286071,0,3,4
81740,1,3,286069,286071,286074,2,5,0
81741,2,1,286071,286074,286075,3,4,0
81742,4,2,286075,286075,286077,0,2,0
81743,1,3,286076,286077,286080,1,4,0
81744,5,1,286081,286081,286082,0,1,1
81745,6,3,286087,286087,286090,0,3,5
81746,4,2,286091,286091,286093,0,2,1
81747,4,3,286095,286095,286098,0,3,2
81748,1,3,286096,286098,286101,2,5,0
81749,4,2,286100,286101,286103,1,3,0
81750,6,1,286106,286106,286107,0,1,3
81751,3,2,286109,286109,286111,0,2,2
81752,5,3,286114,286114,286117,0,3,3
81753,4,2,286118,286118,286120,0,2,1
81754,2,3,286120,286120,286123,0,3,0
81755,1,2,286121,286123,286125,2,4,0
81756,4,2,286125,286125,286127,0,2,0
81757,2,2,286127,286127,286129,0,2,0
81758,3,2,286130,286130,286132,0,2,1
81759,1,3,286131,286132,286135,1,4,0
81760,1,2,286132,286135,286137,3,5,0
81761,3,2,286135,286137,286139,2,4,0
81762,3,2,286138,286139,286141,1,3,0
81763,1,2,286139,286141,286143,2,4,0
81764,4,2,286143,286143,286145,0,2,0
81765,4,1,286147,286147,286148,0,1,2
81766,2,2,286149,286149,286151,0,2,1
81767,6,2,286155,286155,286157,0,2,4
81768,6,1,286161,286161,286162,0,1,4
81769,3,3,286164,286164,286167,0,3,2
81770,5,3,286169,286169,286172,0,3,2
81771,2,2,286171,286172,286174,1,3,0
81772,1,3,286172,286174,286177,2,5,0
81773,3,1,286175,286177,286178,2,3,0
81774,1,2,286176,286178,286180,2,4,0
81775,1,1,286177,286180,286181,3,4,0
81776,2,1,286179,286181,286182,2,3,0
81777,2,2,286181,286182,286184,1,3,0
81778,5,3,286186,286186,286189,0,3,2
81779,6,2,286192,286192,286194,0,2,3
81780,5,1,286197,286197,286198,0,1,3
81781,3,3,286200,286200,286203,0,3,2
81782,3,3,286203,286203,286206,0,3,0
81783,5,3,286208,286208,286211,0,3,2
81784,6,1,286214,286214,286215,0,1,3
81785,6,2,286220,286220,286222,0,2,5
81786,5,3,286225,286225,286228,0,3,3
81787,5,1,286230,286230,286231,0,1,2
81788,5,1,286235,286235,286236,0,1,4
81789,6,2,286241,286241,286243,0,2,5
81790,1,1,286242,286243,286244,1,2,0
81791,2,2,286244,286244,286246,0,2,0
81792,6,1,286250,286250,286251,0,1,4
81793,4,3,286254,286254,286257,0,3,3
81794,4,2,286258,286258,286260,0,2,1
81795,4,2,286262,286262,286264,0,2,2
81796,1,3,286263,286264,286267,1,4,0
81797,2,1,286265,286267,286268,2,3,0
81798,5,1,286270,286270,286271,0,1,2
81799,5,3,286275,286275,286278,0,3,4
81800,1,3,286276,286278,286281,2,5,0
81801,5,2,286281,286281,286283,0,2,0
81802,4,3,286285,286285,286288,0,3,2
81803,6,3,286291,286291,286294,0,3,3
81804,1,3,286292,286294,286297,2,5,0
81805,2,1,286294,286297,286298,3,4,0
81806,5,3,286299,286299,286302,0,3,1
81807,6,1,286305,286305,286306,0,1,3
81808,5,1,286310,286310,286311,0,1,4
81809,6,2,286316,286316,286318,0,2,5
81810,4,2,286320,286320,286322,0,2,2
81811,1,1,286321,286322,286323,1,2,0
81812,1,1,286322,286323,286324,1,2,0
81813,5,2,286327,286327,286329,0,2,3
81814,2,3,286329,286329,286332,0,3,0
81815,3,2,286332,286332,286334,0,2,0
81816,4,3,286336,286336,286339,0,3,2
81817,3,1,286339,286339,286340,0,1,0
81818,2,1,286341,286341,286342,0,1,1
81819,1,3,286342,286342,286345,0,3,0
81820,2,3,286344,286345,286348,1,4,0
81821,2,2,286346,286348,286350,2,4,0
81822,4,2,286350,286350,286352,0,2,0
81823,3,1,286353,286353,286354,0,1,1
81824,3,1,286356,286356,286357,0,1,2
81825,3,1,286359,286359,286360,0,1,2
81826,5,2,286364,286364,286366,0,2,4
81827,4,3,286368,286368,286371,0,3,2
81828,1,1,286369,286371,286372,2,3,0
81829,1,2,286370,286372,286374,2,4,0
81830,4,1,286374,286374,286375,0,1,0
81831,5,2,286379,286379,286381,0,2,4
81832,4,2,286383,286383,286385,0,2,2
81833,3,3,286386,286386,286389,0,3,1
81834,2,2,286388,286389,286391,1,3,0
81835,5,2,286393,286393,286395,0,2,2
81836,1,3,286394,286395,286398,1,4,0
81837,2,2,286396,286398,286400,2,4,0
81838,2,1,286398,286400,286401,2,3,0
81839,5,1,286403,286403,286404,0,1,2
81840,6,2,286409,286409,286411,0,2,5
81841,3,1,286412,286412,286413,0,1,1
81842,1,2,286413,286413,286415,0,2,0
81843,4,1,286417,286417,286418,0,1,2
81844,3,2,286420,286420,286422,0,2,2
81845,1,1,286421,286422,286423,1,2,0
81846,1,3,286422,286423,286426,1,4,0
81847,2,2,286424,286426,286428,2,4,0
81848,2,1,286426,286428,286429,2,3,0
81849,3,1,286429,286429,286430,0,1,0
81850,6,3,286435,286435,286438,0,3,5
81851,5,2,286440,286440,286442,0,2,2
81852,4,2,286444,286444,286446,0,2,2
81853,2,3,286446,286446,286449,0,3,0
81854,6,2,286452,286452,286454,0,2,3
81855,4,2,286456,286456,286458,0,2,2
81856,1,2,286457,286458,286460,1,3,0
81857,3,2,286460,286460,286462,0,2,0
81858,5,2,286465,286465,286467,0,2,3
81859,6,3,286471,286471,286474,0,3,4
81860,3,1,286474,286474,286475,0,1,0
81861,5,1,286479,286479,286480,0,1,4
81862,5,1,286484,286484,286485,0,1,4
81863,3,1,286487,286487,286488,0,1,2
81864,2,2,286489,286489,286491,0,2,1
81865,5,3,286494,286494,286497,0,3,3
81866,3,3,286497,286497,286500,0,3,0
81867,4,2,286501,286501,286503,0,2,1
81868,4,3,286505,286505,286508,0,3,2
81869,1,1,286506,286508,286509,2,3,0
81870,4,2,286510,286510,286512,0,2,1
81871,3,3,286513,286513,286516,0,3,1
81872,4,2,286517,286517,286519,0,2,1
81873,2,3,286519,286519,286522,0,3,0
81874,1,2,286520,286522,286524,2,4,0
81875,2,2,286522,286524,286526,2,4,0
81876,1,3,286523,286526,286529,3,6,0
81877,3,2,286526,286529,286531,3,5,0
81878,4,3,286530,286531,286534,1,4,0
81879,1,2,286531,286534,286536,3,5,0
81880,6,1,286537,286537,286538,0,1,1
81881,2,3,286539,286539,286542,0,3,1
81882,1,3,286540,286542,286545,2,5,0
81883,1,1,286541,286545,286546,4,5,0
81884,3,1,286544,286546,286547,2,3,0
81885,1,2,286545,286547,286549,2,4,0
81886,3,1,286548,286549,286550,1,2,0
81887,3,3,286551,286551,286554,0,3,1
81888,3,1,286554,286554,286555,0,1,0
81889,3,1,286557,286557,286558,0,1,2
81890,5,2,286562,286562,286564,0,2,4
81891,5,1,286567,286567,286568,0,1,3
81892,2,2,286569,286569,286571,0,2,1
81893,3,2,286572,286572,286574,0,2,1
81894,2,2,286574,286574,286576,0,2,0
81895,4,2,286578,286578,286580,0,2,2
81896,5,2,286583,286583,286585,0,2,3
81897,4,3,286587,286587,286590,0,3,2
81898,2,2,286589,286590,286592,1,3,0
81899,5,3,286594,286594,286597,0,3,2
81900,5,3,286599,286599,286602,0,3,2
81901,1,2,286600,286602,286604,2,4,0
81902,2,3,286602,286604,286607,2,5,0
81903,2,1,286604,286607,286608,3,4,0
81904,3,3,286607,286608,286611,1,4,0
81905,3,3,286610,286611,286614,1,4,0
81906,3,1,286613,286614,286615,1,2,0
81907,3,2,286616,286616,286618,0,2,1
81908,5,3,286621,286621,286624,0,3,3
81909,4,1,286625,286625,286626,0,1,1
81910,5,2,286630,286630,286632,0,2,4
81911,3,3,286633,286633,286636,0,3,1
81912,2,1,286635,286636,286637,1,2,0
81913,4,2,286639,286639,286641,0,2,2
81914,2,2,286641,286641,286643,0,2,0
81915,4,3,286645,286645,286648,0,3,2
81916,5,2,286650,286650,286652,0,2,2
81917,1,1,286651,286652,286653,1,2,0
81918,3,3,286654,286654,286657,0,3,1
81919,2,2,286656,286657,286659,1,3,0
81920,4,3,286660,286660,286663,0,3,1
81921,5,1,286665,286665,286666,0,1,2
81922,5,3,286670,286670,286673,0,3,4
81923,5,3,286675,286675,286678,0,3,2
81924,1,3,286676,286678,286681,2,5,0
81925,6,2,286682,286682,286684,0,2,1
81926,1,3,286683,286684,286687,1,4,0
81927,6,1,286689,286689,286690,0,1,2
81928,4,1,286693,286693,286694,0,1,3
81929,6,2,286699,286699,286701,0,2,5
81930,6,2,286705,286705,286707,0,2,4
81931,4,3,286709,286709,286712,0,3,2
81932,4,3,286713,286713,286716,0,3,1
81933,5,3,286718,286718,286721,0,3,2
81934,5,2,286723,286723,286725,0,2,2
81935,5,1,286728,286728,286729,0,1,3
81936,6,1,286734,286734,286735,0,1,5
81937,2,2,286736,286736,286738,0,2,1
81938,1,2,286737,286738,286740,1,3,0
81939,1,1,286738,286740,286741,2,3,0
81940,6,1,286744,286744,286745,0,1,3
81941,5,1,286749,286749,286750,0,1,4
81942,4,3,286753,286753,286756,0,3,3
81943,4,3,286757,286757,286760,0,3,1
81944,5,1,286762,286762,286763,0,1,2
81945,6,1,286768,286768,286769,0,1,5
81946,5,3,286773,286773,286776,0,3,4
81947,4,3,286777,286777,286780,0,3,1
81948,1,2,286778,286780,286782,2,4,0
81949,4,2,286782,286782,286784,0,2,0
81950,6,2,286788,286788,286790,0,2,4
81951,1,1,286789,286790,286791,1,2,0
81952,1,2,286790,286791,286793,1,3,0
81953,1,1,286791,286793,286794,2,3,0
81954,1,2,286792,286794,286796,2,4,0
81955,2,2,286794,286796,286798,2,4,0
81956,6,3,286800,286800,286803,0,3,2
81957,4,3,286804,286804,286807,0,3,1
81958,1,3,286805,286807,286810,2,5,0
81959,1,3,286806,286810,286813,4,7,0
81960,2,2,286808,286813,286815,5,7,0
81961,5,3,286813,286815,286818,2,5,0
81962,3,2,286816,286818,286820,2,4,0
81963,6,1,286822,286822,286823,0,1,2
81964,2,1,286824,286824,286825,0,1,1
81965,4,3,286828,286828,286831,0,3,3
81966,6,2,286834,286834,286836,0,2,3
81967,1,3,286835,286836,286839,1,4,0
81968,3,1,286838,286839,286840,1,2,0
81969,2,3,286840,286840,286843,0,3,0
81970,5,2,286845,286845,286847,0,2,2
81971,3,2,286848,286848,286850,0,2,1
81972,1,3,286849,286850,286853,1,4,0
81973,2,2,286851,286853,286855,2,4,0
81974,3,2,286854,286855,286857,1,3,0
81975,2,1,286856,286857,286858,1,2,0
81976,4,3,286860,286860,286863,0,3,2
81977,5,1,286865,286865,286866,0,1,2
81978,6,1,286871,286871,286872,0,1,5
81979,5,1,286876,286876,286877,0,1,4
81980,1,3,286877,286877,286880,0,3,0
81981,5,1,286882,286882,286883,0,1,2
81982,6,3,286888,286888,286891,0,3,5
81983,5,2,286893,286893,286895,0,2,2
81984,6,2,286899,286899,286901,0,2,4
81985,2,1,286901,286901,286902,0,1,0
81986,2,2,286903,286903,286905,0,2,1
81987,1,1,286904,286905,286906,1,2,0
81988,1,3,286905,286906,286909,1,4,0
81989,3,1,286908,286909,286910,1,2,0
81990,3,1,286911,286911,286912,0,1,1
81991,6,1,286917,286917,286918,0,1,5
81992,4,1,286921,286921,286922,0,1,3
81993,1,1,286922,286922,286923,0,1,0
81994,1,1,286923,286923,286924,0,1,0
81995,1,1,286924,286924,286925,0,1,0
81996,2,2,286926,286926,286928,0,2,1
81997,6,2,286932,286932,286934,0,2,4
81998,3,3,286935,286935,286938,0,3,1
81999,1,3,286936,286938,286941,2,5,0
82000,2,1,286938,286941,286942,3,4,0
82001,1,2,286939,286942,286944,3,5,0
82002,6,2,286945,286945,286947,0,2,1
82003,5,1,286950,286950,286951,0,1,3
82004,1,3,286951,286951,286954,0,3,0
82005,1,1,286952,286954,286955,2,3,0
82006,4,3,286956,286956,286959,0,3,1
82007,2,2,286958,286959,286961,1,3,0
82008,6,1,286964,286964,286965,0,1,3
82009,4,2,286968,286968,286970,0,2,3
82010,2,3,286970,286970,286973,0,3,0
82011,6,3,286976,286976,286979,0,3,3
82012,3,1,286979,286979,286980,0,1,0
82013,1,3,286980,286980,286983,0,3,0
82014,4,1,286984,286984,286985,0,1,1
82015,1,2,286985,286985,286987,0,2,0
82016,5,3,286990,286990,286993,0,3,3
82017,2,3,286992,286993,286996,1,4,0
82018,1,1,286993,286996,286997,3,4,0
82019,6,2,286999,286999,287001,0,2,2
82020,6,2,287005,287005,287007,0,2,4
82021,2,1,287007,287007,287008,0,1,0
82022,3,3,287010,287010,287013,0,3,2
82023,5,1,287015,287015,287016,0,1,2
82024,3,2,287018,287018,287020,0,2,2
82025,1,1,287019,287020,287021,1,2,0
82026,5,2,287024,287024,287026,0,2,3
82027,4,2,287028,287028,287030,0,2,2
82028,2,2,287030,287030,287032,0,2,0
82029,2,2,287032,287032,287034,0,2,0
82030,6,1,287038,287038,287039,0,1,4
82031,5,2,287043,287043,287045,0,2,4
82032,6,2,287049,287049,287051,0,2,4
82033,6,3,287055,287055,287058,0,3,4
82034,5,1,287060,287060,287061,0,1,2
82035,5,2,287065,287065,287067,0,2,4
82036,4,3,287069,287069,287072,0,3,2
82037,1,3,287070,287072,287075,2,5,0
82038,3,2,287073,287075,287077,2,4,0
82039,6,1,287079,287079,287080,0,1,2
82040,6,1,287085,287085,287086,0,1,5
82041,5,2,287090,287090,287092,0,2,4
82042,6,3,287096,287096,287099,0,3,4
82043,4,1,287100,287100,287101,0,1,1
82044,1,3,287101,287101,287104,0,3,0
82045,6,3,287107,287107,287110,0,3,3
82046,1,3,287108,287110,287113,2,5,0
82047,4,2,287112,287113,287115,1,3,0
82048,6,1,287118,287118,287119,0,1,3
82049,1,2,287119,287119,287121,0,2,0
82050,5,2,287124,287124,287126,0,2,3
82051,6,1,287130,287130,287131,0,1,4
82052,3,2,287133,287133,287135,0,2,2
82053,2,2,287135,287135,287137,0,2,0
82054,6,2,287141,287141,287143,0,2,4
82055,1,3,287142,287143,287146,1,4,0
82056,1,3,287143,287146,287149,3,6,0
82057,6,2,287149,287149,287151,0,2,0
82058,1,2,287150,287151,287153,1,3,0
82059,1,2,287151,287153,287155,2,4,0
82060,6,3,287157,287157,287160,0,3,2
82061,3,1,287160,287160,287161,0,1,0
82062,1,2,287161,287161,287163,0,2,0
82063,5,1,287166,287166,287167,0,1,3
82064,2,3,287168,287168,287171,0,3,1
82065,4,1,287172,287172,287173,0,1,1
82066,5,2,287177,287177,287179,0,2,4
82067,1,1,287178,287179,287180,1,2,0
82068,5,1,287183,287183,287184,0,1,3
82069,1,1,287184,287184,287185,0,1,0
82070,1,1,287185,287185,287186,0,1,0
82071,4,1,287189,287189,287190,0,1,3
82072,2,3,287191,287191,287194,0,3,1
82073,4,1,287195,287195,287196,0,1,1
82074,1,3,287196,287196,287199,0,3,0
82075,2,1,287198,287199,287200,1,2,0
82076,1,1,287199,287200,287201,1,2,0
82077,1,2,287200,287201,287203,1,3,0
82078,2,1,287202,287203,287204,1,2,0
82079,6,3,287208,287208,287211,0,3,4
82080,2,2,287210,287211,287213,1,3,0
82081,2,1,287212,287213,287214,1,2,0
82082,6,3,287218,287218,287221,0,3,4
82083,6,2,287224,287224,287226,0,2,3
82084,2,1,287226,287226,287227,0,1,0
82085,4,1,287230,287230,287231,0,1,3
82086,3,3,287233,287233,287236,0,3,2
82087,1,1,287234,287236,287237,2,3,0
82088,5,3,287239,287239,287242,0,3,2
82089,3,2,287242,287242,287244,0,2,0
82090,1,3,287243,287244,287247,1,4,0
82091,1,1,287244,287247,287248,3,4,0
82092,5,2,287249,287249,287251,0,2,1
82093,4,1,287253,287253,287254,0,1,2
82094,1,2,287254,287254,287256,0,2,0
82095,3,1,287257,287257,287258,0,1,1
82096,6,3,287263,287263,287266,0,3,5
82097,1,3,287264,287266,287269,2,5,0
82098,6,3,287270,287270,287273,0,3,1
82099,2,3,287272,287273,287276,1,4,0
82100,5,2,287277,287277,287279,0,2,1
82101,2,2,287279,287279,287281,0,2,0
82102,1,3,287280,287281,287284,1,4,0
82103,6,1,287286,287286,287287,0,1,2
82104,5,1,287291,287291,287292,0,1,4
82105,6,2,287297,287297,287299,0,2,5
82106,5,3,287302,287302,287305,0,3,3
82107,3,3,287305,287305,287308,0,3,0
82108,5,3,287310,287310,287313,0,3,2
82109,6,2,287316,287316,287318,0,2,3
82110,4,1,287320,287320,287321,0,1,2
82111,5,3,287325,287325,287328,0,3,4
82112,5,2,287330,287330,287332,0,2,2
82113,3,3,287333,287333,287336,0,3,1
82114,3,2,287336,287336,287338,0,2,0
82115,1,2,287337,287338,287340,1,3,0
82116,4,2,287341,287341,287343,0,2,1
82117,6,2,287347,287347,287349,0,2,4
82118,2,2,287349,287349,287351,0,2,0
82119,5,2,287354,287354,287356,0,2,3
82120,4,1,287358,287358,287359,0,1,2
82121,3,1,287361,287361,287362,0,1,2
82122,4,1,287365,287365,287366,0,1,3
82123,2,2,287367,287367,287369,0,2,1
82124,1,3,287368,287369,287372,1,4,0
82125,5,3,287373,287373,287376,0,3,1
82126,6,2,287379,287379,287381,0,2,3
82127,3,2,287382,287382,287384,0,2,1
82128,5,2,287387,287387,287389,0,2,3
82129,3,3,287390,287390,287393,0,3,1
82130,2,2,287392,287393,287395,1,3,0
82131,6,2,287398,287398,287400,0,2,3
82132,3,1,287401,287401,287402,0,1,1
82133,6,2,287407,287407,287409,0,2,5
82134,2,1,287409,287409,287410,0,1,0
82135,2,2,287411,287411,287413,0,2,1
82136,1,1,287412,287413,287414,1,2,0
82137,3,3,287415,287415,287418,0,3,1
82138,4,1,287419,287419,287420,0,1,1
82139,1,2,287420,287420,287422,0,2,0
82140,4,2,287424,287424,287426,0,2,2
82141,3,1,287427,287427,287428,0,1,1
82142,6,2,287433,287433,287435,0,2,5
82143,4,1,287437,287437,287438,0,1,2
82144,6,1,287443,287443,287444,0,1,5
82145,3,2,287446,287446,287448,0,2,2
82146,3,2,287449,287449,287451,0,2,1
82147,3,2,287452,287452,287454,0,2,1
82148,5,3,287457,287457,287460,0,3,3
82149,5,2,287462,287462,287464,0,2,2
82150,2,1,287464,287464,287465,0,1,0
82151,3,2,287467,287467,287469,0,2,2
82152,5,2,287472,287472,287474,0,2,3
82153,2,2,287474,287474,287476,0,2,0
82154,6,3,287480,287480,287483,0,3,4
82155,3,1,287483,287483,287484,0,1,0
82156,3,2,287486,287486,287488,0,2,2
82157,3,1,287489,287489,287490,0,1,1
82158,1,3,287490,287490,287493,0,3,0
82159,5,3,287495,287495,287498,0,3,2
82160,6,3,287501,287501,287504,0,3,3
82161,1,3,287502,287504,287507,2,5,0
82162,1,3,287503,287507,287510,4,7,0
82163,3,3,287506,287510,287513,4,7,0
82164,4,1,287510,287513,287514,3,4,0
82165,6,1,287516,287516,287517,0,1,2
82166,2,1,287518,287518,287519,0,1,1
82167,2,1,287520,287520,287521,0,1,1
82168,3,3,287523,287523,287526,0,3,2
82169,2,2,287525,287526,287528,1,3,0
82170,4,3,287529,287529,287532,0,3,1
82171,1,2,287530,287532,287534,2,4,0
82172,2,2,287532,287534,287536,2,4,0
82173,6,3,287538,287538,287541,0,3,2
82174,6,2,287544,287544,287546,0,2,3
82175,5,2,287549,287549,287551,0,2,3
82176,2,2,287551,287551,287553,0,2,0
82177,1,2,287552,287553,287555,1,3,0
82178,1,1,287553,287555,287556,2,3,0
82179,1,1,287554,287556,287557,2,3,0
82180,2,2,287556,287557,287559,1,3,0
82181,5,3,287561,287561,287564,0,3,2
82182,3,3,287564,287564,287567,0,3,0
82183,4,1,287568,287568,287569,0,1,1
82184,3,1,287571,287571,287572,0,1,2
82185,1,1,287572,287572,287573,0,1,0
82186,6,2,287578,287578,287580,0,2,5
82187,6,1,287584,287584,287585,0,1,4
82188,3,2,287587,287587,287589,0,2,2
82189,2,2,287589,287589,287591,0,2,0
82190,2,2,287591,287591,287593,0,2,0
82191,1,1,287592,287593,287594,1,2,0
82192,5,2,287597,287597,287599,0,2,3
82193,1,1,287598,287599,287600,1,2,0
82194,1,1,287599,287600,287601,1,2,0
82195,1,3,287600,287601,287604,1,4,0
82196,6,2,287606,287606,287608,0,2,2
82197,3,2,287609,287609,287611,0,2,1
82198,3,1,287612,287612,287613,0,1,1
82199,4,1,287616,287616,287617,0,1,3
82200,5,3,287621,287621,287624,0,3,4
82201,3,3,287624,287624,287627,0,3,0
82202,6,3,287630,287630,287633,0,3,3
82203,2,3,287632,287633,287636,1,4,0
82204,3,1,287635,287636,287637,1,2,0
82205,1,3,287636,287637,287640,1,4,0
82206,5,1,287641,287641,287642,0,1,1
82207,5,2,287646,287646,287648,0,2,4
82208,6,2,287652,287652,287654,0,2,4
82209,5,2,287657,287657,287659,0,2,3
82210,2,1,287659,287659,287660,0,1,0
82211,5,3,287664,287664,287667,0,3,4
82212,5,1,287669,287669,287670,0,1,2
82213,4,1,287673,287673,287674,0,1,3
82214,6,1,287679,287679,287680,0,1,5
82215,4,1,287683,287683,287684,0,1,3
82216,5,2,287688,287688,287690,0,2,4
82217,5,2,287693,287693,287695,0,2,3
82218,5,3,287698,287698,287701,0,3,3
82219,6,1,287704,287704,287705,0,1,3
82220,5,1,287709,287709,287710,0,1,4
82221,5,2,287714,287714,287716,0,2,4
82222,1,2,287715,287716,287718,1,3,0
82223,4,3,287719,287719,287722,0,3,1
82224,5,3,287724,287724,287727,0,3,2
82225,5,1,287729,287729,287730,0,1,2
82226,3,1,287732,287732,287733,0,1,2
82227,1,2,287733,287733,287735,0,2,0
82228,2,2,287735,287735,287737,0,2,0
82229,4,3,287739,287739,287742,0,3,2
82230,3,3,287742,287742,287745,0,3,0
82231,3,3,287745,287745,287748,0,3,0
82232,4,2,287749,287749,287751,0,2,1
82233,6,3,287755,287755,287758,0,3,4
82234,2,3,287757,287758,287761,1,4,0
82235,2,2,287759,287761,287763,2,4,0
82236,5,1,287764,287764,287765,0,1,1
82237,3,2,287767,287767,287769,0,2,2
82238,6,1,287773,287773,287774,0,1,4
82239,4,3,287777,287777,287780,0,3,3
82240,5,2,287782,287782,287784,0,2,2
82241,1,2,287783,287784,287786,1,3,0
82242,1,3,287784,287786,287789,2,5,0
82243,6,3,287790,287790,287793,0,3,1
82244,1,1,287791,287793,287794,2,3,0
82245,6,1,287797,287797,287798,0,1,3
82246,3,1,287800,287800,287801,0,1,2
82247,2,1,287802,287802,287803,0,1,1
82248,2,1,287804,287804,287805,0,1,1
82249,6,2,287810,287810,287812,0,2,5
82250,2,3,287812,287812,287815,0,3,0
82251,4,3,287816,287816,287819,0,3,1
82252,3,1,287819,287819,287820,0,1,0
82253,2,3,287821,287821,287824,0,3,1
82254,5,2,287826,287826,287828,0,2,2
82255,2,1,287828,287828,287829,0,1,0
82256,1,2,287829,287829,287831,0,2,0
82257,5,3,287834,287834,287837,0,3,3
82258,1,3,287835,287837,287840,2,5,0
82259,6,2,287841,287841,287843,0,2,1
82260,4,1,287845,287845,287846,0,1,2
82261,4,1,287849,287849,287850,0,1,3
82262,1,3,287850,287850,287853,0,3,0
82263,5,3,287855,287855,287858,0,3,2
82264,3,3,287858,287858,287861,0,3,0
82265,1,3,287859,287861,287864,2,5,0
82266,4,3,287863,287864,287867,1,4,0
82267,5,3,287868,287868,287871,0,3,1
82268,5,1,287873,287873,287874,0,1,2
82269,4,2,287877,287877,287879,0,2,3
82270,4,1,287881,287881,287882,0,1,2
82271,2,2,287883,287883,287885,0,2,1
82272,4,1,287887,287887,287888,0,1,2
82273,2,1,287889,287889,287890,0,1,1
82274,1,3,287890,287890,287893,0,3,0
82275,6,2,287896,287896,287898,0,2,3
82276,4,3,287900,287900,287903,0,3,2
82277,1,1,287901,287903,287904,2,3,0
82278,6,1,287907,287907,287908,0,1,3
82279,5,3,287912,287912,287915,0,3,4
82280,3,1,287915,287915,287916,0,1,0
82281,5,2,287920,287920,287922,0,2,4
82282,5,3,287925,287925,287928,0,3,3
82283,3,1,287928,287928,287929,0,1,0
82284,4,3,287932,287932,287935,0,3,3
82285,3,1,287935,287935,287936,0,1,0
82286,2,3,287937,287937,287940,0,3,1
82287,4,3,287941,287941,287944,0,3,1
82288,1,3,287942,287944,287947,2,5,0
82289,2,1,287944,287947,287948,3,4,0
82290,1,1,287945,287948,287949,3,4,0
82291,4,3,287949,287949,287952,0,3,0
82292,3,2,287952,287952,287954,0,2,0
82293,1,1,287953,287954,287955,1,2,0
82294,1,1,287954,287955,287956,1,2,0
82295,4,2,287958,287958,287960,0,2,2
82296,5,2,287963,287963,287965,0,2,3
82297,4,1,287967,287967,287968,0,1,2
82298,6,2,287973,287973,287975,0,2,5
82299,1,1,287974,287975,287976,1,2,0
82300,4,1,287978,287978,287979,0,1,2
82301,4,1,287982,287982,287983,0,1,3
82302,1,2,287983,287983,287985,0,2,0
82303,1,3,287984,287985,287988,1,4,0
82304,4,1,287988,287988,287989,0,1,0
82305,3,2,287991,287991,287993,0,2,2
82306,3,2,287994,287994,287996,0,2,1
82307,5,1,287999,287999,288000,0,1,3
82308,2,3,288001,288001,288004,0,3,1
82309,2,2,288003,288004,288006,1,3,0
82310,3,1,288006,288006,288007,0,1,0
82311,5,3,288011,288011,288014,0,3,4
82312,4,3,288015,288015,288018,0,3,1
82313,3,1,288018,288018,288019,0,1,0
82314,2,3,288020,288020,288023,0,3,1
82315,1,2,288021,288023,288025,2,4,0
82316,3,1,288024,288025,288026,1,2,0
82317,1,2,288025,288026,288028,1,3,0
82318,3,3,288028,288028,288031,0,3,0
82319,4,2,288032,288032,288034,0,2,1
82320,3,2,288035,288035,288037,0,2,1
82321,5,2,288040,288040,288042,0,2,3
82322,3,3,288043,288043,288046,0,3,1
82323,3,2,288046,288046,288048,0,2,0
82324,3,3,288049,288049,288052,0,3,1
82325,5,1,288054,288054,288055,0,1,2
82326,5,1,288059,288059,288060,0,1,4
82327,1,2,288060,288060,288062,0,2,0
82328,1,1,288061,288062,288063,1,2,0
82329,6,3,288067,288067,288070,0,3,4
82330,3,3,288070,288070,288073,0,3,0
82331,5,2,288075,288075,288077,0,2,2
82332,5,3,288080,288080,288083,0,3,3
82333,1,2,288081,288083,288085,2,4,0
82334,5,2,288086,288086,288088,0,2,1
82335,4,1,288090,288090,288091,0,1,2
82336,4,1,288094,288094,288095,0,1,3
82337,3,2,288097,288097,288099,0,2,2
82338,4,2,288101,288101,288103,0,2,2
82339,2,1,288103,288103,288104,0,1,0
82340,2,3,288105,288105,288108,0,3,1
82341,1,1,288106,288108,288109,2,3,0
82342,1,3,288107,288109,288112,2,5,0
82343,1,3,288108,288112,288115,4,7,0
82344,6,2,288114,288115,288117,1,3,0
82345,6,2,288120,288120,288122,0,2,3
82346,6,3,288126,288126,288129,0,3,4
82347,2,3,288128,288129,288132,1,4,0
82348,6,3,288134,288134,288137,0,3,2
82349,1,1,288135,288137,288138,2,3,0
82350,2,3,288137,288138,288141,1,4,0
82351,1,1,288138,288141,288142,3,4,0
82352,6,3,288144,288144,288147,0,3,2
82353,3,3,288147,288147,288150,0,3,0
82354,1,3,288148,288150,288153,2,5,0
82355,6,1,288154,288154,288155,0,1,1
82356,5,2,288159,288159,288161,0,2,4
82357,3,2,288162,288162,288164,0,2,1
82358,1,1,288163,288164,288165,1,2,0
82359,4,3,288167,288167,288170,0,3,2
82360,3,3,288170,288170,288173,0,3,0
82361,1,2,288171,288173,288175,2,4,0
82362,2,1,288173,288175,288176,2,3,0
82363,5,3,288178,288178,288181,0,3,2
82364,1,3,288179,288181,288184,2,5,0
82365,4,1,288183,288184,288185,1,2,0
82366,4,3,288187,288187,288190,0,3,2
82367,5,3,288192,288192,288195,0,3,2
82368,1,1,288193,288195,288196,2,3,0
82369,4,1,288197,288197,288198,0,1,1
82370,2,2,288199,288199,288201,0,2,1
82371,1,1,288200,288201,288202,1,2,0
82372,5,1,288205,288205,288206,0,1,3
82373,3,1,288208,288208,288209,0,1,2
82374,6,3,288214,288214,288217,0,3,5
82375,1,3,288215,288217,288220,2,5,0
82376,4,3,288219,288220,288223,1,4,0
82377,3,1,288222,288223,288224,1,2,0
82378,3,2,288225,288225,288227,0,2,1
82379,4,1,288229,288229,288230,0,1,2
82380,1,1,288230,288230,288231,0,1,0
82381,4,1,288234,288234,288235,0,1,3
82382,3,2,288237,288237,288239,0,2,2
82383,1,1,288238,288239,288240,1,2,0
82384,6,1,288244,288244,288245,0,1,4
82385,3,3,288247,288247,288250,0,3,2
82386,2,3,288249,288250,288253,1,4,0
82387,3,3,288252,288253,288256,1,4,0
82388,5,2,288257,288257,288259,0,2,1
82389,4,1,288261,288261,288262,0,1,2
82390,3,3,288264,288264,288267,0,3,2
82391,4,2,288268,288268,288270,0,2,1
82392,1,3,288269,288270,288273,1,4,0
82393,3,2,288272,288273,288275,1,3,0
82394,6,2,288278,288278,288280,0,2,3
82395,6,1,288284,288284,288285,0,1,4
82396,6,2,288290,288290,288292,0,2,5
82397,3,1,288293,288293,288294,0,1,1
82398,3,2,288296,288296,288298,0,2,2
82399,6,1,288302,288302,288303,0,1,4
82400,1,2,288303,288303,288305,0,2,0
82401,2,1,288305,288305,288306,0,1,0
82402,3,1,288308,288308,288309,0,1,2
82403,4,1,288312,288312,288313,0,1,3
82404,2,1,288314,288314,288315,0,1,1
82405,5,2,288319,288319,288321,0,2,4
82406,5,1,288324,288324,288325,0,1,3
82407,1,3,288325,288325,288328,0,3,0
82408,4,2,288329,288329,288331,0,2,1
82409,6,1,288335,288335,288336,0,1,4
82410,1,2,288336,288336,288338,0,2,0
82411,2,2,288338,288338,288340,0,2,0
82412,6,3,288344,288344,288347,0,3,4
82413,3,3,288347,288347,288350,0,3,0
82414,1,2,288348,288350,288352,2,4,0
82415,6,1,288354,288354,288355,0,1,2
82416,1,1,288355,288355,288356,0,1,0
82417,5,3,288360,288360,288363,0,3,4
82418,2,2,288362,288363,288365,1,3,0
82419,3,1,288365,288365,288366,0,1,0
82420,6,1,288371,288371,288372,0,1,5
82421,2,3,288373,288373,288376,0,3,1
82422,2,1,288375,288376,288377,1,2,0
82423,1,1,288376,288377,288378,1,2,0
82424,6,2,288382,288382,288384,0,2,4
82425,2,2,288384,288384,288386,0,2,0
82426,1,3,288385,288386,288389,1,4,0
82427,3,1,288388,288389,288390,1,2,0
82428,1,2,288389,288390,288392,1,3,0
82429,1,1,288390,288392,288393,2,3,0
82430,2,2,288392,288393,288395,1,3,0
82431,2,1,288394,288395,288396,1,2,0
82432,2,3,288396,288396,288399,0,3,0
82433,2,1,288398,288399,288400,1,2,0
82434,2,1,288400,288400,288401,0,1,0
82435,1,2,288401,288401,288403,0,2,0
82436,4,2,288405,288405,288407,0,2,2
82437,4,3,288409,288409,288412,0,3,2
82438,1,2,288410,288412,288414,2,4,0
82439,6,2,288416,288416,288418,0,2,2
82440,5,1,288421,288421,288422,0,1,3
82441,3,3,288424,288424,288427,0,3,2
82442,5,3,288429,288429,288432,0,3,2
82443,2,1,288431,288432,288433,1,2,0
82444,5,1,288436,288436,288437,0,1,3
82445,6,2,288442,288442,288444,0,2,5
82446,5,3,288447,288447,288450,0,3,3
82447,2,2,288449,288450,288452,1,3,0
82448,5,1,288454,288454,288455,0,1,2
82449,4,2,288458,288458,288460,0,2,3
82450,2,3,288460,288460,288463,0,3,0
82451,5,2,288465,288465,288467,0,2,2
82452,5,3,288470,288470,288473,0,3,3
82453,5,1,288475,288475,288476,0,1,2
82454,5,2,288480,288480,288482,0,2,4
82455,3,2,288483,288483,288485,0,2,1
82456,1,3,288484,288485,288488,1,4,0
82457,4,3,288488,288488,288491,0,3,0
82458,5,1,288493,288493,288494,0,1,2
82459,5,2,288498,288498,288500,0,2,4
82460,5,1,288503,288503,288504,0,1,3
82461,5,1,288508,288508,288509,0,1,4
82462,2,2,288510,288510,288512,0,2,1
82463,1,2,288511,288512,288514,1,3,0
82464,4,2,288515,288515,288517,0,2,1
82465,3,2,288518,288518,288520,0,2,1
82466,4,2,288522,288522,288524,0,2,2
82467,6,2,288528,288528,288530,0,2,4
82468,5,1,288533,288533,288534,0,1,3
82469,6,1,288539,288539,288540,0,1,5
82470,1,2,288540,288540,288542,0,2,0
82471,2,2,288542,288542,288544,0,2,0
82472,5,1,288547,288547,288548,0,1,3
82473,2,1,288549,288549,288550,0,1,1
82474,5,2,288554,288554,288556,0,2,4
82475,6,3,288560,288560,288563,0,3,4
82476,2,3,288562,288563,288566,1,4,0
82477,4,1,288566,288566,288567,0,1,0
82478,5,2,288571,288571,288573,0,2,4
82479,2,1,288573,288573,288574,0,1,0
82480,6,3,288579,288579,288582,0,3,5
82481,6,3,288585,288585,288588,0,3,3
82482,4,3,288589,288589,288592,0,3,1
82483,3,1,288592,288592,288593,0,1,0
82484,2,3,288594,288594,288597,0,3,1
82485,5,2,288599,288599,288601,0,2,2
82486,1,2,288600,288601,288603,1,3,0
82487,3,2,288603,288603,288605,0,2,0
82488,4,1,288607,288607,288608,0,1,2
82489,5,1,288612,288612,288613,0,1,4
82490,5,2,288617,288617,288619,0,2,4
82491,6,1,288623,288623,288624,0,1,4
82492,5,2,288628,288628,288630,0,2,4
82493,2,1,288630,288630,288631,0,1,0
82494,6,3,288636,288636,288639,0,3,5
82495,1,1,288637,288639,288640,2,3,0
82496,4,1,288641,288641,288642,0,1,1
82497,4,2,288645,288645,288647,0,2,3
82498,3,1,288648,288648,288649,0,1,1
82499,1,1,288649,288649,288650,0,1,0
82500,3,1,288652,288652,288653,0,1,2
82501,4,1,288656,288656,288657,0,1,3
82502,2,1,288658,288658,288659,0,1,1
82503,3,1,288661,288661,288662,0,1,2
82504,3,3,288664,288664,288667,0,3,2
82505,4,3,288668,288668,288671,0,3,1
82506,3,3,288671,288671,288674,0,3,0
82507,1,2,288672,288674,288676,2,4,0
82508,6,2,288678,288678,288680,0,2,2
82509,4,2,288682,288682,288684,0,2,2
82510,6,3,288688,288688,288691,0,3,4
82511,5,1,288693,288693,288694,0,1,2
82512,5,3,288698,288698,288701,0,3,4
82513,1,1,288699,288701,288702,2,3,0
82514,1,3,288700,288702,288705,2,5,0
82515,4,1,288704,288705,288706,1,2,0
82516,3,2,288707,288707,288709,0,2,1
82517,3,1,288710,288710,288711,0,1,1
82518,4,3,288714,288714,288717,0,3,3
82519,1,2,288715,288717,288719,2,4,0
82520,2,3,288717,288719,288722,2,5,0
82521,4,3,288721,288722,288725,1,4,0
82522,3,2,288724,288725,288727,1,3,0
82523,4,3,288728,288728,288731,0,3,1
82524,3,2,288731,288731,288733,0,2,0
82525,2,2,288733,288733,288735,0,2,0
82526,4,3,288737,288737,288740,0,3,2
82527,6,3,288743,288743,288746,0,3,3
82528,2,2,288745,288746,288748,1,3,0
82529,3,1,288748,288748,288749,0,1,0
82530,3,2,288751,288751,288753,0,2,2
82531,1,3,288752,288753,288756,1,4,0
82532,2,3,288754,288756,288759,2,5,0
82533,1,2,288755,288759,288761,4,6,0
82534,3,1,288758,288761,288762,3,4,0
82535,2,1,288760,288762,288763,2,3,0
82536,3,2,288763,288763,288765,0,2,0
82537,5,2,288768,288768,288770,0,2,3
82538,1,2,288769,288770,288772,1,3,0
82539,1,3,288770,288772,288775,2,5,0
82540,4,2,288774,288775,288777,1,3,0
82541,6,3,288780,288780,288783,0,3,3
82542,5,3,288785,288785,288788,0,3,2
82543,6,1,288791,288791,288792,0,1,3
82544,5,3,288796,288796,288799,0,3,4
82545,1,3,288797,288799,288802,2,5,0
82546,2,2,288799,288802,288804,3,5,0
82547,1,2,288800,288804,288806,4,6,0
82548,2,3,288802,288806,288809,4,7,0
82549,5,2,288807,288809,288811,2,4,0
82550,1,2,288808,288811,288813,3,5,0
82551,1,2,288809,288813,288815,4,6,0
82552,5,1,288814,288815,288816,1,2,0
82553,3,1,288817,288817,288818,0,1,1
82554,4,2,288821,288821,288823,0,2,3
82555,6,3,288827,288827,288830,0,3,4
82556,4,1,288831,288831,288832,0,1,1
82557,1,2,288832,288832,288834,0,2,0
82558,4,2,288836,288836,288838,0,2,2
82559,3,1,288839,288839,288840,0,1,1
82560,4,1,288843,288843,288844,0,1,3
82561,6,1,288849,288849,288850,0,1,5
82562,2,3,288851,288851,288854,0,3,1
82563,2,1,288853,288854,288855,1,2,0
82564,2,2,288855,288855,288857,0,2,0
82565,5,1,288860,288860,288861,0,1,3
82566,5,2,288865,288865,288867,0,2,4
82567,4,2,288869,288869,288871,0,2,2
82568,6,3,288875,288875,288878,0,3,4
82569,4,3,288879,288879,288882,0,3,1
82570,1,2,288880,288882,288884,2,4,0
82571,5,1,288885,288885,288886,0,1,1
82572,6,3,288891,288891,288894,0,3,5
82573,3,2,288894,288894,288896,0,2,0
82574,4,2,288898,288898,288900,0,2,2
82575,5,2,288903,288903,288905,0,2,3
82576,5,3,288908,288908,288911,0,3,3
82577,1,2,288909,288911,288913,2,4,0
82578,3,2,288912,288913,288915,1,3,0
82579,1,1,288913,288915,288916,2,3,0
82580,6,1,288919,288919,288920,0,1,3
82581,3,2,288922,288922,288924,0,2,2
82582,4,3,288926,288926,288929,0,3,2
82583,5,2,288931,288931,288933,0,2,2
82584,1,2,288932,288933,288935,1,3,0
82585,6,3,288938,288938,288941,0,3,3
82586,1,2,288939,288941,288943,2,4,0
82587,6,2,288945,288945,288947,0,2,2
82588,6,1,288951,288951,288952,0,1,4
82589,2,3,288953,288953,288956,0,3,1
82590,2,2,288955,288956,288958,1,3,0
82591,2,3,288957,288958,288961,1,4,0
82592,3,3,288960,288961,288964,1,4,0
82593,3,1,288963,288964,288965,1,2,0
82594,6,2,288969,288969,288971,0,2,4
82595,5,3,288974,288974,288977,0,3,3
82596,1,3,288975,288977,288980,2,5,0
82597,1,3,288976,288980,288983,4,7,0
82598,2,3,288978,288983,288986,5,8,0
82599,4,2,288982,288986,288988,4,6,0
82600,1,3,288983,288988,288991,5,8,0
82601,4,1,288987,288991,288992,4,5,0
82602,5,3,288992,288992,288995,0,3,0
82603,5,3,288997,288997,289000,0,3,2
82604,4,1,289001,289001,289002,0,1,1
82605,1,1,289002,289002,289003,0,1,0
82606,4,3,289006,289006,289009,0,3,3
82607,2,1,289008,289009,289010,1,2,0
82608,3,2,289011,289011,289013,0,2,1
82609,6,1,289017,289017,289018,0,1,4
82610,1,3,289018,289018,289021,0,3,0
82611,1,2,289019,289021,289023,2,4,0
82612,3,2,289022,289023,289025,1,3,0
82613,4,2,289026,289026,289028,0,2,1
82614,3,2,289029,289029,289031,0,2,1
82615,2,3,289031,289031,289034,0,3,0
82616,6,3,289037,289037,289040,0,3,3
82617,5,3,289042,289042,289045,0,3,2
82618,3,3,289045,289045,289048,0,3,0
82619,4,2,289049,289049,289051,0,2,1
82620,4,1,289053,289053,289054,0,1,2
82621,1,1,289054,289054,289055,0,1,0
82622,2,3,289056,289056,289059,0,3,1
82623,1,3,289057,289059,289062,2,5,0
82624,2,1,289059,289062,289063,3,4,0
82625,3,3,289062,289063,289066,1,4,0
82626,1,2,289063,289066,289068,3,5,0
82627,6,1,289069,289069,289070,0,1,1
82628,4,1,289073,289073,289074,0,1,3
82629,3,1,289076,289076,289077,0,1,2
82630,3,3,289079,289079,289082,0,3,2
82631,4,3,289083,289083,289086,0,3,1
82632,2,3,289085,289086,289089,1,4,0
82633,6,2,289091,289091,289093,0,2,2
82634,1,2,289092,289093,289095,1,3,0
82635,5,2,289097,289097,289099,0,2,2
82636,5,2,289102,289102,289104,0,2,3
82637,5,1,289107,289107,289108,0,1,3
82638,2,1,289109,289109,289110,0,1,1
82639,6,3,289115,289115,289118,0,3,5
82640,1,2,289116,289118,289120,2,4,0
82641,3,3,289119,289120,289123,1,4,0
82642,3,1,289122,289123,289124,1,2,0
82643,1,3,289123,289124,289127,1,4,0
82644,6,1,289129,289129,289130,0,1,2
82645,1,3,289130,289130,289133,0,3,0
82646,4,2,289134,289134,289136,0,2,1
82647,1,1,289135,289136,289137,1,2,0
82648,6,2,289141,289141,289143,0,2,4
82649,6,3,289147,289147,289150,0,3,4
82650,2,3,289149,289150,289153,1,4,0
82651,3,2,289152,289153,289155,1,3,0
82652,2,2,289154,289155,289157,1,3,0
82653,5,3,289159,289159,289162,0,3,2
82654,1,3,289160,289162,289165,2,5,0
82655,5,3,289165,289165,289168,0,3,0
82656,1,3,289166,289168,289171,2,5,0
82657,6,2,289172,289172,289174,0,2,1
82658,4,2,289176,289176,289178,0,2,2
82659,1,2,289177,289178,289180,1,3,0
82660,3,3,289180,289180,289183,0,3,0
82661,3,1,289183,289183,289184,0,1,0
82662,3,2,289186,289186,289188,0,2,2
82663,3,2,289189,289189,289191,0,2,1
82664,5,1,289194,289194,289195,0,1,3
82665,4,1,289198,289198,289199,0,1,3
82666,6,3,289204,289204,289207,0,3,5
82667,2,2,289206,289207,289209,1,3,0
82668,1,1,289207,289209,289210,2,3,0
82669,5,1,289212,289212,289213,0,1,2
82670,1,3,289213,289213,289216,0,3,0
82671,5,1,289218,289218,289219,0,1,2
82672,3,3,289221,289221,289224,0,3,2
82673,3,2,289224,289224,289226,0,2,0
82674,5,3,289229,289229,289232,0,3,3
82675,4,2,289233,289233,289235,0,2,1
82676,4,1,289237,289237,289238,0,1,2
82677,4,3,289241,289241,289244,0,3,3
82678,5,2,289246,289246,289248,0,2,2
82679,1,3,289247,289248,289251,1,4,0
82680,3,3,289250,289251,289254,1,4,0
82681,2,1,289252,289254,289255,2,3,0
82682,2,1,289254,289255,289256,1,2,0
82683,3,2,289257,289257,289259,0,2,1
82684,3,3,289260,289260,289263,0,3,1
82685,3,1,289263,289263,289264,0,1,0
82686,6,1,289269,289269,289270,0,1,5
82687,3,2,289272,289272,289274,0,2,2
82688,5,2,289277,289277,289279,0,2,3
82689,4,2,289281,289281,289283,0,2,2
82690,6,3,289287,289287,289290,0,3,4
82691,3,1,289290,289290,289291,0,1,0
82692,1,3,289291,289291,289294,0,3,0
82693,5,2,289296,289296,289298,0,2,2
82694,3,1,289299,289299,289300,0,1,1
82695,4,3,289303,289303,289306,0,3,3
82696,3,2,289306,289306,289308,0,2,0
82697,1,1,289307,289308,289309,1,2,0
82698,2,3,289309,289309,289312,0,3,0
82699,1,2,289310,289312,289314,2,4,0
82700,3,3,289313,289314,289317,1,4,0
82701,6,3,289319,289319,289322,0,3,2
82702,5,1,289324,289324,289325,0,1,2
82703,5,2,289329,289329,289331,0,2,4
82704,1,1,289330,289331,289332,1,2,0
82705,5,2,289335,289335,289337,0,2,3
82706,1,3,289336,289337,289340,1,4,0
82707,4,2,289340,289340,289342,0,2,0
82708,5,1,289345,289345,289346,0,1,3
82709,6,1,289351,289351,289352,0,1,5
82710,6,1,289357,289357,289358,0,1,5
82711,3,1,289360,289360,289361,0,1,2
82712,2,3,289362,289362,289365,0,3,1
82713,4,3,289366,289366,289369,0,3,1
82714,4,1,289370,289370,289371,0,1,1
82715,3,3,289373,289373,289376,0,3,2
82716,1,2,289374,289376,289378,2,4,0
82717,5,1,289379,289379,289380,0,1,1
82718,4,3,289383,289383,289386,0,3,3
82719,4,1,289387,289387,289388,0,1,1
82720,2,2,289389,289389,289391,0,2,1
82721,4,2,289393,289393,289395,0,2,2
82722,4,1,289397,289397,289398,0,1,2
82723,5,2,289402,289402,289404,0,2,4
82724,3,2,289405,289405,289407,0,2,1
82725,2,3,289407,289407,289410,0,3,0
82726,5,1,289412,289412,289413,0,1,2
82727,6,1,289418,289418,289419,0,1,5
82728,5,2,289423,289423,289425,0,2,4
82729,4,2,289427,289427,289429,0,2,2
82730,5,1,289432,289432,289433,0,1,3
82731,1,2,289433,289433,289435,0,2,0
82732,2,3,289435,289435,289438,0,3,0
82733,6,2,289441,289441,289443,0,2,3
82734,5,3,289446,289446,289449,0,3,3
82735,2,2,289448,289449,289451,1,3,0
82736,3,3,289451,289451,289454,0,3,0
82737,6,1,289457,289457,289458,0,1,3
82738,4,1,289461,289461,289462,0,1,3
82739,4,2,289465,289465,289467,0,2,3
82740,4,1,289469,289469,289470,0,1,2
82741,4,2,289473,289473,289475,0,2,3
82742,2,2,289475,289475,289477,0,2,0
82743,1,3,289476,289477,289480,1,4,0
82744,2,3,289478,289480,289483,2,5,0
82745,3,1,289481,289483,289484,2,3,0
82746,5,3,289486,289486,289489,0,3,2
82747,3,3,289489,289489,289492,0,3,0
82748,2,2,289491,289492,289494,1,3,0
82749,3,1,289494,289494,289495,0,1,0
82750,4,1,289498,289498,289499,0,1,3
82751,6,3,289504,289504,289507,0,3,5
82752,3,3,289507,289507,289510,0,3,0
82753,1,3,289508,289510,289513,2,5,0
82754,4,1,289512,289513,289514,1,2,0
82755,6,1,289518,289518,289519,0,1,4
82756,4,3,289522,289522,289525,0,3,3
82757,6,3,289528,289528,289531,0,3,3
82758,2,1,289530,289531,289532,1,2,0
82759,4,1,289534,289534,289535,0,1,2
82760,6,3,289540,289540,289543,0,3,5
82761,4,1,289544,289544,289545,0,1,1
82762,3,3,289547,289547,289550,0,3,2
82763,4,2,289551,289551,289553,0,2,1
82764,5,2,289556,289556,289558,0,2,3
82765,5,1,289561,289561,289562,0,1,3
82766,6,3,289567,289567,289570,0,3,5
82767,4,1,289571,289571,289572,0,1,1
82768,3,2,289574,289574,289576,0,2,2
82769,1,1,289575,289576,289577,1,2,0
82770,5,2,289580,289580,289582,0,2,3
82771,2,3,289582,289582,289585,0,3,0
82772,2,2,289584,289585,289587,1,3,0
82773,5,2,289589,289589,289591,0,2,2
82774,6,1,289595,289595,289596,0,1,4
82775,4,3,289599,289599,289602,0,3,3
82776,6,2,289605,289605,289607,0,2,3
82777,4,1,289609,289609,289610,0,1,2
82778,3,3,289612,289612,289615,0,3,2
82779,6,1,289618,289618,289619,0,1,3
82780,5,2,289623,289623,289625,0,2,4
82781,4,3,289627,289627,289630,0,3,2
82782,4,1,289631,289631,289632,0,1,1
82783,3,3,289634,289634,289637,0,3,2
82784,1,1,289635,289637,289638,2,3,0
82785,2,2,289637,289638,289640,1,3,0
82786,3,3,289640,289640,289643,0,3,0
82787,5,2,289645,289645,289647,0,2,2
82788,2,3,289647,289647,289650,0,3,0
82789,1,1,289648,289650,289651,2,3,0
82790,1,2,289649,289651,289653,2,4,0
82791,5,2,289654,289654,289656,0,2,1
82792,3,2,289657,289657,289659,0,2,1
82793,2,2,289659,289659,289661,0,2,0
82794,6,1,289665,289665,289666,0,1,4
82795,4,3,289669,289669,289672,0,3,3
82796,4,2,289673,289673,289675,0,2,1
82797,4,3,289677,289677,289680,0,3,2
82798,3,2,289680,289680,289682,0,2,0
82799,4,3,289684,289684,289687,0,3,2
82800,2,1,289686,289687,289688,1,2,0
82801,6,3,289692,289692,289695,0,3,4
82802,5,2,289697,289697,289699,0,2,2
82803,1,2,289698,289699,289701,1,3,0
82804,6,2,289704,289704,289706,0,2,3
82805,3,3,289707,289707,289710,0,3,1
82806,4,3,289711,289711,289714,0,3,1
82807,3,2,289714,289714,289716,0,2,0
82808,1,1,289715,289716,289717,1,2,0
82809,3,1,289718,289718,289719,0,1,1
82810,2,1,289720,289720,289721,0,1,1
82811,1,3,289721,289721,289724,0,3,0
82812,6,3,289727,289727,289730,0,3,3
82813,1,2,289728,289730,289732,2,4,0
82814,1,3,289729,289732,289735,3,6,0
82815,1,2,289730,289735,289737,5,7,0
82816,4,3,289734,289737,289740,3,6,0
82817,6,2,289740,289740,289742,0,2,0
82818,2,3,289742,289742,289745,0,3,0
82819,1,3,289743,289745,289748,2,5,0
82820,4,2,289747,289748,289750,1,3,0
82821,5,3,289752,289752,289755,0,3,2
82822,1,2,289753,289755,289757,2,4,0
82823,2,3,289755,289757,289760,2,5,0
82824,5,3,289760,289760,289763,0,3,0
82825,1,3,289761,289763,289766,2,5,0
82826,4,2,289765,289766,289768,1,3,0
82827,4,2,289769,289769,289771,0,2,1
82828,2,3,289771,289771,289774,0,3,0
82829,6,2,289777,289777,289779,0,2,3
82830,1,3,289778,289779,289782,1,4,0
82831,4,1,289782,289782,289783,0,1,0
82832,3,3,289785,289785,289788,0,3,2
82833,6,2,289791,289791,289793,0,2,3
82834,5,2,289796,289796,289798,0,2,3
82835,3,1,289799,289799,289800,0,1,1
82836,4,1,289803,289803,289804,0,1,3
82837,1,3,289804,289804,289807,0,3,0
82838,2,2,289806,289807,289809,1,3,0
82839,2,1,289808,289809,289810,1,2,0
82840,6,2,289814,289814,289816,0,2,4
82841,1,2,289815,289816,289818,1,3,0
82842,2,3,289817,289818,289821,1,4,0
82843,1,1,289818,289821,289822,3,4,0
82844,3,3,289821,289822,289825,1,4,0
82845,5,2,289826,289826,289828,0,2,1
82846,3,2,289829,289829,289831,0,2,1
82847,6,3,289835,289835,289838,0,3,4
82848,3,1,289838,289838,289839,0,1,0
82849,3,3,289841,289841,289844,0,3,2
82850,4,1,289845,289845,289846,0,1,1
82851,1,3,289846,289846,289849,0,3,0
82852,1,1,289847,289849,289850,2,3,0
82853,5,3,289852,289852,289855,0,3,2
82854,6,2,289858,289858,289860,0,2,3
82855,4,3,289862,289862,289865,0,3,2
82856,1,3,289863,289865,289868,2,5,0
82857,3,1,289866,289868,289869,2,3,0
82858,2,3,289868,289869,289872,1,4,0
82859,1,2,289869,289872,289874,3,5,0
82860,6,3,289875,289875,289878,0,3,1
82861,4,3,289879,289879,289882,0,3,1
82862,2,1,289881,289882,289883,1,2,0
82863,2,1,289883,289883,289884,0,1,0
82864,1,3,289884,289884,289887,0,3,0
82865,1,1,289885,289887,289888,2,3,0
82866,3,1,289888,289888,289889,0,1,0
82867,5,2,289893,289893,289895,0,2,4
82868,3,1,289896,289896,289897,0,1,1
82869,3,2,289899,289899,289901,0,2,2
82870,1,2,289900,289901,289903,1,3,0
82871,4,3,289904,289904,289907,0,3,1
82872,4,1,289908,289908,289909,0,1,1
82873,6,2,289914,289914,289916,0,2,5
82874,5,2,289919,289919,289921,0,2,3
82875,5,1,289924,289924,289925,0,1,3
82876,1,3,289925,289925,289928,0,3,0
82877,3,2,289928,289928,289930,0,2,0
82878,2,1,289930,289930,289931,0,1,0
82879,3,2,289933,289933,289935,0,2,2
82880,5,1,289938,289938,289939,0,1,3
82881,1,1,289939,289939,289940,0,1,0
82882,2,2,289941,289941,289943,0,2,1
82883,2,2,289943,289943,289945,0,2,0
82884,6,2,289949,289949,289951,0,2,4
82885,3,2,289952,289952,289954,0,2,1
82886,3,1,289955,289955,289956,0,1,1
82887,2,3,289957,289957,289960,0,3,1
82888,1,1,289958,289960,289961,2,3,0
82889,2,1,289960,289961,289962,1,2,0
82890,6,3,289966,289966,289969,0,3,4
82891,2,1,289968,289969,289970,1,2,0
82892,3,3,289971,289971,289974,0,3,1
82893,6,1,289977,289977,289978,0,1,3
82894,5,1,289982,289982,289983,0,1,4
82895,3,2,289985,289985,289987,0,2,2
82896,2,3,289987,289987,289990,0,3,0
82897,1,3,289988,289990,289993,2,5,0
82898,6,1,289994,289994,289995,0,1,1
82899,3,1,289997,289997,289998,0,1,2
82900,1,3,289998,289998,290001,0,3,0
82901,4,2,290002,290002,290004,0,2,1
82902,4,3,290006,290006,290009,0,3,2
82903,1,1,290007,290009,290010,2,3,0
82904,5,2,290012,290012,290014,0,2,2
82905,1,3,290013,290014,290017,1,4,0
82906,1,2,290014,290017,290019,3,5,0
82907,5,3,290019,290019,290022,0,3,0
82908,4,2,290023,290023,290025,0,2,1
82909,6,1,290029,290029,290030,0,1,4
82910,5,3,290034,290034,290037,0,3,4
82911,6,2,290040,290040,290042,0,2,3
82912,5,2,290045,290045,290047,0,2,3
82913,2,1,290047,290047,290048,0,1,0
82914,5,2,290052,290052,290054,0,2,4
82915,5,2,290057,290057,290059,0,2,3
82916,6,3,290063,290063,290066,0,3,4
82917,1,3,290064,290066,290069,2,5,0
82918,4,3,290068,290069,290072,1,4,0
82919,2,3,290070,290072,290075,2,5,0
82920,1,1,290071,290075,290076,4,5,0
82921,2,1,290073,290076,290077,3,4,0
82922,4,3,290077,290077,290080,0,3,0
82923,5,1,290082,290082,290083,0,1,2
82924,3,3,290085,290085,290088,0,3,2
82925,5,2,290090,290090,290092,0,2,2
82926,3,3,290093,290093,290096,0,3,1
82927,1,1,290094,290096,290097,2,3,0
82928,3,1,290097,290097,290098,0,1,0
82929,3,3,290100,290100,290103,0,3,2
82930,5,2,290105,290105,290107,0,2,2
82931,4,2,290109,290109,290111,0,2,2
82932,2,3,290111,290111,290114,0,3,0
82933,2,1,290113,290114,290115,1,2,0
82934,1,3,290114,290115,290118,1,4,0
82935,3,1,290117,290118,290119,1,2,0
82936,4,1,290121,290121,290122,0,1,2
82937,6,3,290127,290127,290130,0,3,5
82938,2,2,290129,290130,290132,1,3,0
82939,2,2,290131,290132,290134,1,3,0
82940,3,2,290134,290134,290136,0,2,0
82941,6,1,290140,290140,290141,0,1,4
82942,6,3,290146,290146,290149,0,3,5
82943,3,1,290149,290149,290150,0,1,0
82944,3,1,290152,290152,290153,0,1,2
82945,6,2,290158,290158,290160,0,2,5
82946,3,1,290161,290161,290162,0,1,1
82947,6,1,290167,290167,290168,0,1,5
82948,1,1,290168,290168,290169,0,1,0
82949,4,3,290172,290172,290175,0,3,3
82950,6,2,290178,290178,290180,0,2,3
82951,2,3,290180,290180,290183,0,3,0
82952,6,3,290186,290186,290189,0,3,3
82953,6,2,290192,290192,290194,0,2,3
82954,1,2,290193,290194,290196,1,3,0
82955,1,3,290194,290196,290199,2,5,0
82956,1,3,290195,290199,290202,4,7,0
82957,6,2,290201,290202,290204,1,3,0
82958,5,2,290206,290206,290208,0,2,2
82959,1,1,290207,290208,290209,1,2,0
82960,3,2,290210,290210,290212,0,2,1
82961,3,2,290213,290213,290215,0,2,1
82962,4,1,290217,290217,290218,0,1,2
82963,6,2,290223,290223,290225,0,2,5
82964,6,3,290229,290229,290232,0,3,4
82965,5,1,290234,290234,290235,0,1,2
82966,2,1,290236,290236,290237,0,1,1
82967,6,1,290242,290242,290243,0,1,5
82968,2,3,290244,290244,290247,0,3,1
82969,2,2,290246,290247,290249,1,3,0
82970,2,1,290248,290249,290250,1,2,0
82971,4,2,290252,290252,290254,0,2,2
82972,1,3,290253,290254,290257,1,4,0
82973,3,3,290256,290257,290260,1,4,0
82974,5,3,290261,290261,290264,0,3,1
82975,6,1,290267,290267,290268,0,1,3
82976,2,2,290269,290269,290271,0,2,1
82977,3,3,290272,290272,290275,0,3,1
82978,5,2,290277,290277,290279,0,2,2
82979,1,1,290278,290279,290280,1,2,0
82980,5,3,290283,290283,290286,0,3,3
82981,5,3,290288,290288,290291,0,3,2
82982,4,1,290292,290292,290293,0,1,1
82983,4,2,290296,290296,290298,0,2,3
82984,6,1,290302,290302,290303,0,1,4
82985,3,3,290305,290305,290308,0,3,2
82986,1,3,290306,290308,290311,2,5,0
82987,2,2,290308,290311,290313,3,5,0
82988,2,2,290310,290313,290315,3,5,0
82989,4,3,290314,290315,290318,1,4,0
82990,5,2,290319,290319,290321,0,2,1
82991,2,1,290321,290321,290322,0,1,0
82992,3,3,290324,290324,290327,0,3,2
82993,2,2,290326,290327,290329,1,3,0
82994,1,2,290327,290329,290331,2,4,0
82995,1,3,290328,290331,290334,3,6,0
82996,6,1,290334,290334,290335,0,1,0
82997,2,3,290336,290336,290339,0,3,1
82998,2,1,290338,290339,290340,1,2,0
82999,1,1,290339,290340,290341,1,2,0
83000,3,2,290342,290342,290344,0,2,1
83001,4,3,290346,290346,290349,0,3,2
83002,6,3,290352,290352,290355,0,3,3
83003,6,2,290358,290358,290360,0,2,3
83004,5,2,290363,290363,290365,0,2,3
83005,2,3,290365,290365,290368,0,3,0
83006,1,3,290366,290368,290371,2,5,0
83007,2,1,290368,290371,290372,3,4,0
83008,5,2,290373,290373,290375,0,2,1
83009,1,2,290374,290375,290377,1,3,0
83010,4,3,290378,290378,290381,0,3,1
83011,4,2,290382,290382,290384,0,2,1
83012,3,1,290385,290385,290386,0,1,1
83013,2,3,290387,290387,290390,0,3,1
83014,5,3,290392,290392,290395,0,3,2
83015,4,2,290396,290396,290398,0,2,1
83016,1,1,290397,290398,290399,1,2,0
83017,3,3,290400,290400,290403,0,3,1
83018,2,3,290402,290403,290406,1,4,0
83019,2,3,290404,290406,290409,2,5,0
83020,1,1,290405,290409,290410,4,5,0
83021,6,1,290411,290411,290412,0,1,1
83022,3,1,290414,290414,290415,0,1,2
83023,2,3,290416,290416,290419,0,3,1
83024,5,3,290421,290421,290424,0,3,2
83025,3,1,290424,290424,290425,0,1,0
83026,5,2,290429,290429,290431,0,2,4
83027,5,1,290434,290434,290435,0,1,3
83028,3,3,290437,290437,290440,0,3,2
83029,2,3,290439,290440,290443,1,4,0
83030,3,1,290442,290443,290444,1,2,0
83031,1,1,290443,290444,290445,1,2,0
83032,4,2,290447,290447,290449,0,2,2
83033,2,1,290449,290449,290450,0,1,0
83034,1,3,290450,290450,290453,0,3,0
83035,2,2,290452,290453,290455,1,3,0
83036,1,1,290453,290455,290456,2,3,0
83037,2,2,290455,290456,290458,1,3,0
83038,6,3,290461,290461,290464,0,3,3
83039,6,2,290467,290467,290469,0,2,3
83040,3,3,290470,290470,290473,0,3,1
83041,4,2,290474,290474,290476,0,2,1
83042,1,1,290475,290476,290477,1,2,0
83043,2,1,290477,290477,290478,0,1,0
83044,2,2,290479,290479,290481,0,2,1
83045,2,2,290481,290481,290483,0,2,0
83046,4,3,290485,290485,290488,0,3,2
83047,6,2,290491,290491,290493,0,2,3
83048,4,2,290495,290495,290497,0,2,2
83049,3,3,290498,290498,290501,0,3,1
83050,3,2,290501,290501,290503,0,2,0
83051,6,3,290507,290507,290510,0,3,4
83052,1,2,290508,290510,290512,2,4,0
83053,1,3,290509,290512,290515,3,6,0
83054,4,1,290513,290515,290516,2,3,0
83055,6,3,290519,290519,290522,0,3,3
83056,1,2,290520,290522,290524,2,4,0
83057,5,3,290525,290525,290528,0,3,1
83058,4,1,290529,290529,290530,0,1,1
83059,2,2,290531,290531,290533,0,2,1
83060,5,1,290536,290536,290537,0,1,3
83061,2,1,290538,290538,290539,0,1,1
83062,2,1,290540,290540,290541,0,1,1
83063,3,3,290543,290543,290546,0,3,2
83064,5,1,290548,290548,290549,0,1,2
83065,5,1,290553,290553,290554,0,1,4
83066,5,2,290558,290558,290560,0,2,4
83067,4,3,290562,290562,290565,0,3,2
83068,4,3,290566,290566,290569,0,3,1
83069,6,3,290572,290572,290575,0,3,3
83070,4,3,290576,290576,290579,0,3,1
83071,4,3,290580,290580,290583,0,3,1
83072,3,3,290583,290583,290586,0,3,0
83073,5,2,290588,290588,290590,0,2,2
83074,6,2,290594,290594,290596,0,2,4
83075,1,3,290595,290596,290599,1,4,0
83076,3,1,290598,290599,290600,1,2,0
83077,2,3,290600,290600,290603,0,3,0
83078,2,3,290602,290603,290606,1,4,0
83079,2,3,290604,290606,290609,2,5,0
83080,2,3,290606,290609,290612,3,6,0
83081,4,2,290610,290612,290614,2,4,0
83082,1,3,290611,290614,290617,3,6,0
83083,4,2,290615,290617,290619,2,4,0
83084,4,1,290619,290619,290620,0,1,0
83085,4,2,290623,290623,290625,0,2,3
83086,5,1,290628,290628,290629,0,1,3
83087,2,3,290630,290630,290633,0,3,1
83088,5,2,290635,290635,290637,0,2,2
83089,1,3,290636,290637,290640,1,4,0
83090,4,2,290640,290640,290642,0,2,0
83091,4,3,290644,290644,290647,0,3,2
83092,3,3,290647,290647,290650,0,3,0
83093,6,3,290653,290653,290656,0,3,3
83094,4,1,290657,290657,290658,0,1,1
83095,1,1,290658,290658,290659,0,1,0
83096,6,2,290664,290664,290666,0,2,5
83097,1,1,290665,290666,290667,1,2,0
83098,4,2,290669,290669,290671,0,2,2
83099,5,3,290674,290674,290677,0,3,3
83100,2,1,290676,290677,290678,1,2,0
83101,1,1,290677,290678,290679,1,2,0
83102,5,2,290682,290682,290684,0,2,3
83103,6,2,290688,290688,290690,0,2,4
83104,3,3,290691,290691,290694,0,3,1
83105,2,2,290693,290694,290696,1,3,0
83106,3,3,290696,290696,290699,0,3,0
83107,2,1,290698,290699,290700,1,2,0
83108,5,2,290703,290703,290705,0,2,3
83109,3,2,290706,290706,290708,0,2,1
83110,3,1,290709,290709,290710,0,1,1
83111,1,1,290710,290710,290711,0,1,0
83112,6,3,290716,290716,290719,0,3,5
83113,4,2,290720,290720,290722,0,2,1
83114,1,1,290721,290722,290723,1,2,0
83115,1,3,290722,290723,290726,1,4,0
83116,4,3,290726,290726,290729,0,3,0
83117,4,1,290730,290730,290731,0,1,1
83118,5,3,290735,290735,290738,0,3,4
83119,3,1,290738,290738,290739,0,1,0
83120,6,1,290744,290744,290745,0,1,5
83121,5,2,290749,290749,290751,0,2,4
83122,4,3,290753,290753,290756,0,3,2
83123,1,2,290754,290756,290758,2,4,0
83124,1,3,290755,290758,290761,3,6,0
83125,4,1,290759,290761,290762,2,3,0
83126,1,1,290760,290762,290763,2,3,0
83127,6,3,290766,290766,290769,0,3,3
83128,1,1,290767,290769,290770,2,3,0
83129,5,2,290772,290772,290774,0,2,2
83130,2,2,290774,290774,290776,0,2,0
83131,4,1,290778,290778,290779,0,1,2
83132,3,1,290781,290781,290782,0,1,2
83133,1,2,290782,290782,290784,0,2,0
83134,4,3,290786,290786,290789,0,3,2
83135,5,3,290791,290791,290794,0,3,2
83136,2,1,290793,290794,290795,1,2,0
83137,6,2,290799,290799,290801,0,2,4
83138,3,3,290802,290802,290805,0,3,1
83139,5,1,290807,290807,290808,0,1,2
83140,4,3,290811,290811,290814,0,3,3
83141,4,1,290815,290815,290816,0,1,1
83142,3,2,290818,290818,290820,0,2,2
83143,4,1,290822,290822,290823,0,1,2
83144,1,1,290823,290823,290824,0,1,0
83145,3,1,290826,290826,290827,0,1,2
83146,2,3,290828,290828,290831,0,3,1
83147,4,3,290832,290832,290835,0,3,1
83148,5,2,290837,290837,290839,0,2,2
83149,3,1,290840,290840,290841,0,1,1
83150,1,3,290841,290841,290844,0,3,0
83151,6,2,290847,290847,290849,0,2,3
83152,2,3,290849,290849,290852,0,3,0
83153,2,1,290851,290852,290853,1,2,0
83154,2,2,290853,290853,290855,0,2,0
83155,5,3,290858,290858,290861,0,3,3
83156,3,2,290861,290861,290863,0,2,0
83157,4,1,290865,290865,290866,0,1,2
83158,1,3,290866,290866,290869,0,3,0
83159,4,2,290870,290870,290872,0,2,1
83160,2,3,290872,290872,290875,0,3,0
83161,5,1,290877,290877,290878,0,1,2
83162,1,1,290878,290878,290879,0,1,0
83163,2,2,290880,290880,290882,0,2,1
83164,3,1,290883,290883,290884,0,1,1
83165,6,2,290889,290889,290891,0,2,5
83166,3,1,290892,290892,290893,0,1,1
83167,4,2,290896,290896,290898,0,2,3
83168,3,3,290899,290899,290902,0,3,1
83169,5,3,290904,290904,290907,0,3,2
83170,4,2,290908,290908,290910,0,2,1
83171,3,3,290911,290911,290914,0,3,1
83172,6,1,290917,290917,290918,0,1,3
83173,5,1,290922,290922,290923,0,1,4
83174,2,1,290924,290924,290925,0,1,1
83175,3,3,290927,290927,290930,0,3,2
83176,2,1,290929,290930,290931,1,2,0
83177,5,2,290934,290934,290936,0,2,3
83178,5,2,290939,290939,290941,0,2,3
83179,1,1,290940,290941,290942,1,2,0
83180,5,3,290945,290945,290948,0,3,3
83181,4,2,290949,290949,290951,0,2,1
83182,6,3,290955,290955,290958,0,3,4
83183,1,3,290956,290958,290961,2,5,0
83184,3,2,290959,290961,290963,2,4,0
83185,1,2,290960,290963,290965,3,5,0
83186,4,2,290964,290965,290967,1,3,0
83187,5,2,290969,290969,290971,0,2,2
83188,3,2,290972,290972,290974,0,2,1
83189,5,2,290977,290977,290979,0,2,3
83190,4,3,290981,290981,290984,0,3,2
83191,5,2,290986,290986,290988,0,2,2
83192,1,3,290987,290988,290991,1,4,0
83193,6,3,290993,290993,290996,0,3,2
83194,5,3,290998,290998,291001,0,3,2
83195,1,3,290999,291001,291004,2,5,0
83196,2,2,291001,291004,291006,3,5,0
83197,2,1,291003,291006,291007,3,4,0
83198,3,3,291006,291007,291010,1,4,0
83199,1,2,291007,291010,291012,3,5,0
83200,1,2,291008,291012,291014,4,6,0
83201,5,1,291013,291014,291015,1,2,0
83202,6,2,291019,291019,291021,0,2,4
83203,2,2,291021,291021,291023,0,2,0
83204,4,1,291025,291025,291026,0,1,2
83205,6,3,291031,291031,291034,0,3,5
83206,1,3,291032,291034,291037,2,5,0
83207,3,1,291035,291037,291038,2,3,0
83208,6,2,291041,291041,291043,0,2,3
83209,3,2,291044,291044,291046,0,2,1
83210,1,2,291045,291046,291048,1,3,0
83211,3,1,291048,291048,291049,0,1,0
83212,3,3,291051,291051,291054,0,3,2
83213,6,1,291057,291057,291058,0,1,3
83214,1,1,291058,291058,291059,0,1,0
83215,2,3,291060,291060,291063,0,3,1
83216,2,2,291062,291063,291065,1,3,0
83217,2,1,291064,291065,291066,1,2,0
83218,1,1,291065,291066,291067,1,2,0
83219,3,3,291068,291068,291071,0,3,1
83220,5,3,291073,291073,291076,0,3,2
83221,4,1,291077,291077,291078,0,1,1
83222,3,1,291080,291080,291081,0,1,2
83223,2,1,291082,291082,291083,0,1,1
83224,3,3,291085,291085,291088,0,3,2
83225,5,1,291090,291090,291091,0,1,2
83226,3,2,291093,291093,291095,0,2,2
83227,1,3,291094,291095,291098,1,4,0
83228,2,2,291096,291098,291100,2,4,0
83229,4,2,291100,291100,291102,0,2,0
83230,2,2,291102,291102,291104,0,2,0
83231,6,1,291108,291108,291109,0,1,4
83232,4,2,291112,291112,291114,0,2,3
83233,5,2,291117,291117,291119,0,2,3
83234,3,1,291120,291120,291121,0,1,1
83235,2,3,291122,291122,291125,0,3,1
83236,2,1,291124,291125,291126,1,2,0
83237,4,3,291128,291128,291131,0,3,2
83238,6,2,291134,291134,291136,0,2,3
83239,3,3,291137,291137,291140,0,3,1
83240,5,3,291142,291142,291145,0,3,2
83241,4,2,291146,291146,291148,0,2,1
83242,2,3,291148,291148,291151,0,3,0
83243,2,3,291150,291151,291154,1,4,0
83244,5,3,291155,291155,291158,0,3,1
83245,1,3,291156,291158,291161,2,5,0
83246,5,3,291161,291161,291164,0,3,0
83247,2,3,291163,291164,291167,1,4,0
83248,3,1,291166,291167,291168,1,2,0
83249,6,1,291172,291172,291173,0,1,4
83250,5,2,291177,291177,291179,0,2,4
83251,5,1,291182,291182,291183,0,1,3
83252,4,1,291186,291186,291187,0,1,3
83253,3,1,291189,291189,291190,0,1,2
83254,1,2,291190,291190,291192,0,2,0
83255,1,2,291191,291192,291194,1,3,0
83256,4,3,291195,291195,291198,0,3,1
83257,6,2,291201,291201,291203,0,2,3
83258,6,2,291207,291207,291209,0,2,4
83259,4,2,291211,291211,291213,0,2,2
83260,2,1,291213,291213,291214,0,1,0
83261,1,3,291214,291214,291217,0,3,0
83262,4,2,291218,291218,291220,0,2,1
83263,5,1,291223,291223,291224,0,1,3
83264,4,1,291227,291227,291228,0,1,3
83265,3,1,291230,291230,291231,0,1,2
83266,4,3,291234,291234,291237,0,3,3
83267,3,1,291237,291237,291238,0,1,0
83268,3,3,291240,291240,291243,0,3,2
83269,2,1,291242,291243,291244,1,2,0
83270,1,1,291243,291244,291245,1,2,0
83271,3,2,291246,291246,291248,0,2,1
83272,1,3,291247,291248,291251,1,4,0
83273,3,1,291250,291251,291252,1,2,0
83274,3,3,291253,291253,291256,0,3,1
83275,2,2,291255,291256,291258,1,3,0
83276,4,2,291259,291259,291261,0,2,1
83277,6,1,291265,291265,291266,0,1,4
83278,1,1,291266,291266,291267,0,1,0
83279,1,1,291267,291267,291268,0,1,0
83280,1,2,291268,291268,291270,0,2,0
83281,5,1,291273,291273,291274,0,1,3
83282,1,2,291274,291274,291276,0,2,0
83283,4,1,291278,291278,291279,0,1,2
83284,4,2,291282,291282,291284,0,2,3
83285,3,2,291285,291285,291287,0,2,1
83286,4,1,291289,291289,291290,0,1,2
83287,1,1,291290,291290,291291,0,1,0
83288,2,3,291292,291292,291295,0,3,1
83289,3,1,291295,291295,291296,0,1,0
83290,5,2,291300,291300,291302,0,2,4
83291,5,1,291305,291305,291306,0,1,3
83292,5,3,291310,291310,291313,0,3,4
83293,4,3,291314,291314,291317,0,3,1
83294,3,3,291317,291317,291320,0,3,0
83295,2,3,291319,291320,291323,1,4,0
83296,1,2,291320,291323,291325,3,5,0
83297,6,2,291326,291326,291328,0,2,1
83298,1,1,291327,291328,291329,1,2,0
83299,6,1,291333,291333,291334,0,1,4
83300,2,3,291335,291335,291338,0,3,1
83301,5,2,291340,291340,291342,0,2,2
83302,1,3,291341,291342,291345,1,4,0
83303,1,3,291342,291345,291348,3,6,0
83304,3,1,291345,291348,291349,3,4,0
83305,2,1,291347,291349,291350,2,3,0
83306,1,3,291348,291350,291353,2,5,0
83307,6,2,291354,291354,291356,0,2,1
83308,1,1,291355,291356,291357,1,2,0
83309,6,2,291361,291361,291363,0,2,4
83310,2,1,291363,291363,291364,0,1,0
83311,5,2,291368,291368,291370,0,2,4
83312,2,1,291370,291370,291371,0,1,0
83313,1,1,291371,291371,291372,0,1,0
83314,3,1,291374,291374,291375,0,1,2
83315,4,1,291378,291378,291379,0,1,3
83316,5,2,291383,291383,291385,0,2,4
83317,6,1,291389,291389,291390,0,1,4
83318,4,2,291393,291393,291395,0,2,3
83319,2,1,291395,291395,291396,0,1,0
83320,2,1,291397,291397,291398,0,1,1
83321,6,1,291403,291403,291404,0,1,5
83322,2,1,291405,291405,291406,0,1,1
83323,6,3,291411,291411,291414,0,3,5
83324,4,1,291415,291415,291416,0,1,1
83325,3,3,291418,291418,291421,0,3,2
83326,2,1,291420,291421,291422,1,2,0
83327,1,1,291421,291422,291423,1,2,0
83328,5,1,291426,291426,291427,0,1,3
83329,3,1,291429,291429,291430,0,1,2
83330,6,3,291435,291435,291438,0,3,5
83331,2,1,291437,291438,291439,1,2,0
83332,3,3,291440,291440,291443,0,3,1
83333,1,2,291441,291443,291445,2,4,0
83334,5,2,291446,291446,291448,0,2,1
83335,3,2,291449,291449,291451,0,2,1
83336,4,1,291453,291453,291454,0,1,2
83337,3,3,291456,291456,291459,0,3,2
83338,3,2,291459,291459,291461,0,2,0
83339,6,1,291465,291465,291466,0,1,4
83340,4,3,291469,291469,291472,0,3,3
83341,4,1,291473,291473,291474,0,1,1
83342,4,3,291477,291477,291480,0,3,3
83343,3,2,291480,291480,291482,0,2,0
83344,1,2,291481,291482,291484,1,3,0
83345,6,1,291487,291487,291488,0,1,3
83346,6,1,291493,291493,291494,0,1,5
83347,5,1,291498,291498,291499,0,1,4
83348,1,1,291499,291499,291500,0,1,0
83349,5,2,291504,291504,291506,0,2,4
83350,2,1,291506,291506,291507,0,1,0
83351,4,2,291510,291510,291512,0,2,3
83352,6,3,291516,291516,291519,0,3,4
83353,1,2,291517,291519,291521,2,4,0
83354,4,2,291521,291521,291523,0,2,0
83355,1,3,291522,291523,291526,1,4,0
83356,6,3,291528,291528,291531,0,3,2
83357,5,3,291533,291533,291536,0,3,2
83358,4,3,291537,291537,291540,0,3,1
83359,6,3,291543,291543,291546,0,3,3
83360,3,3,291546,291546,291549,0,3,0
83361,3,1,291549,291549,291550,0,1,0
83362,2,1,291551,291551,291552,0,1,1
83363,4,2,291555,291555,291557,0,2,3
83364,4,2,291559,291559,291561,0,2,2
83365,1,3,291560,291561,291564,1,4,0
83366,5,3,291565,291565,291568,0,3,1
83367,6,2,291571,291571,291573,0,2,3
83368,3,3,291574,291574,291577,0,3,1
83369,5,2,291579,291579,291581,0,2,2
83370,5,2,291584,291584,291586,0,2,3
83371,5,3,291589,291589,291592,0,3,3
83372,2,2,291591,291592,291594,1,3,0
83373,3,2,291594,291594,291596,0,2,0
83374,5,1,291599,291599,291600,0,1,3
83375,3,1,291602,291602,291603,0,1,2
83376,2,2,291604,291604,291606,0,2,1
83377,2,1,291606,291606,291607,0,1,0
83378,1,1,291607,291607,291608,0,1,0
83379,5,2,291612,291612,291614,0,2,4
83380,4,3,291616,291616,291619,0,3,2
83381,4,3,291620,291620,291623,0,3,1
83382,6,1,291626,291626,291627,0,1,3
83383,3,1,291629,291629,291630,0,1,2
83384,2,1,291631,291631,291632,0,1,1
83385,4,3,291635,291635,291638,0,3,3
83386,6,3,291641,291641,291644,0,3,3
83387,2,2,291643,291644,291646,1,3,0
83388,6,2,291649,291649,291651,0,2,3
83389,1,1,291650,291651,291652,1,2,0
83390,5,2,291655,291655,291657,0,2,3
83391,6,1,291661,291661,291662,0,1,4
83392,2,1,291663,291663,291664,0,1,1
83393,3,3,291666,291666,291669,0,3,2
83394,5,1,291671,291671,291672,0,1,2
83395,5,3,291676,291676,291679,0,3,4
83396,6,1,291682,291682,291683,0,1,3
83397,1,3,291683,291683,291686,0,3,0
83398,3,1,291686,291686,291687,0,1,0
83399,5,2,291691,291691,291693,0,2,4
83400,3,3,291694,291694,291697,0,3,1
83401,5,1,291699,291699,291700,0,1,2
83402,4,1,291703,291703,291704,0,1,3
83403,2,2,291705,291705,291707,0,2,1
83404,2,3,291707,291707,291710,0,3,0
83405,4,2,291711,291711,291713,0,2,1
83406,1,3,291712,291713,291716,1,4,0
83407,2,3,291714,291716,291719,2,5,0
83408,5,1,291719,291719,291720,0,1,0
83409,2,2,291721,291721,291723,0,2,1
83410,4,1,291725,291725,291726,0,1,2
83411,6,1,291731,291731,291732,0,1,5
83412,3,1,291734,291734,291735,0,1,2
83413,4,2,291738,291738,291740,0,2,3
83414,1,3,291739,291740,291743,1,4,0
83415,1,1,291740,291743,291744,3,4,0
83416,5,3,291745,291745,291748,0,3,1
83417,4,1,291749,291749,291750,0,1,1
83418,5,1,291754,291754,291755,0,1,4
83419,1,2,291755,291755,291757,0,2,0
83420,3,1,291758,291758,291759,0,1,1
83421,3,3,291761,291761,291764,0,3,2
83422,6,3,291767,291767,291770,0,3,3
83423,6,3,291773,291773,291776,0,3,3
83424,2,2,291775,291776,291778,1,3,0
83425,5,2,291780,291780,291782,0,2,2
83426,6,1,291786,291786,291787,0,1,4
83427,2,2,291788,291788,291790,0,2,1
83428,2,3,291790,291790,291793,0,3,0
83429,3,1,291793,291793,291794,0,1,0
83430,1,3,291794,291794,291797,0,3,0
83431,6,2,291800,291800,291802,0,2,3
83432,6,1,291806,291806,291807,0,1,4
83433,3,2,291809,291809,291811,0,2,2
83434,4,3,291813,291813,291816,0,3,2
83435,5,1,291818,291818,291819,0,1,2
83436,4,1,291822,291822,291823,0,1,3
83437,3,2,291825,291825,291827,0,2,2
83438,4,2,291829,291829,291831,0,2,2
83439,3,3,291832,291832,291835,0,3,1
83440,4,3,291836,291836,291839,0,3,1
83441,6,1,291842,291842,291843,0,1,3
83442,3,3,291845,291845,291848,0,3,2
83443,5,2,291850,291850,291852,0,2,2
83444,5,1,291855,291855,291856,0,1,3
83445,5,2,291860,291860,291862,0,2,4
83446,1,1,291861,291862,291863,1,2,0
83447,2,2,291863,291863,291865,0,2,0
83448,1,2,291864,291865,291867,1,3,0
83449,3,3,291867,291867,291870,0,3,0
83450,3,2,291870,291870,291872,0,2,0
83451,2,2,291872,291872,291874,0,2,0
83452,6,3,291878,291878,291881,0,3,4
83453,5,1,291883,291883,291884,0,1,2
83454,1,3,291884,291884,291887,0,3,0
83455,4,1,291888,291888,291889,0,1,1
83456,4,3,291892,291892,291895,0,3,3
83457,3,2,291895,291895,291897,0,2,0
83458,2,2,291897,291897,291899,0,2,0
83459,6,2,291903,291903,291905,0,2,4
83460,1,3,291904,291905,291908,1,4,0
83461,6,3,291910,291910,291913,0,3,2
83462,3,1,291913,291913,291914,0,1,0
83463,4,2,291917,291917,291919,0,2,3
83464,2,2,291919,291919,291921,0,2,0
83465,5,1,291924,291924,291925,0,1,3
83466,3,2,291927,291927,291929,0,2,2
83467,6,3,291933,291933,291936,0,3,4
83468,6,2,291939,291939,291941,0,2,3
83469,3,2,291942,291942,291944,0,2,1
83470,2,2,291944,291944,291946,0,2,0
83471,6,3,291950,291950,291953,0,3,4
83472,2,1,291952,291953,291954,1,2,0
83473,5,3,291957,291957,291960,0,3,3
83474,4,2,291961,291961,291963,0,2,1
83475,5,3,291966,291966,291969,0,3,3
83476,1,1,291967,291969,291970,2,3,0
83477,1,2,291968,291970,291972,2,4,0
83478,5,1,291973,291973,291974,0,1,1
83479,1,3,291974,291974,291977,0,3,0
83480,6,1,291980,291980,291981,0,1,3
83481,1,3,291981,291981,291984,0,3,0
83482,4,3,291985,291985,291988,0,3,1
83483,6,1,291991,291991,291992,0,1,3
83484,2,1,291993,291993,291994,0,1,1
83485,2,3,291995,291995,291998,0,3,1
83486,4,1,291999,291999,292000,0,1,1
83487,1,1,292000,292000,292001,0,1,0
83488,6,3,292006,292006,292009,0,3,5
83489,5,2,292011,292011,292013,0,2,2
83490,3,3,292014,292014,292017,0,3,1
83491,5,3,292019,292019,292022,0,3,2
83492,1,3,292020,292022,292025,2,5,0
83493,2,2,292022,292025,292027,3,5,0
83494,4,1,292026,292027,292028,1,2,0
83495,5,3,292031,292031,292034,0,3,3
83496,6,2,292037,292037,292039,0,2,3
83497,4,3,292041,292041,292044,0,3,2
83498,3,2,292044,292044,292046,0,2,0
83499,3,1,292047,292047,292048,0,1,1
83500,1,3,292048,292048,292051,0,3,0
83501,2,1,292050,292051,292052,1,2,0
83502,4,3,292054,292054,292057,0,3,2
83503,2,1,292056,292057,292058,1,2,0
83504,3,3,292059,292059,292062,0,3,1
83505,1,2,292060,292062,292064,2,4,0
83506,1,1,292061,292064,292065,3,4,0
83507,4,1,292065,292065,292066,0,1,0
83508,6,1,292071,292071,292072,0,1,5
83509,4,1,292075,292075,292076,0,1,3
83510,1,2,292076,292076,292078,0,2,0
83511,1,1,292077,292078,292079,1,2,0
83512,2,2,292079,292079,292081,0,2,0
83513,2,1,292081,292081,292082,0,1,0
83514,6,3,292087,292087,292090,0,3,5
83515,3,2,292090,292090,292092,0,2,0
83516,3,1,292093,292093,292094,0,1,1
83517,1,2,292094,292094,292096,0,2,0
83518,4,3,292098,292098,292101,0,3,2
83519,1,3,292099,292101,292104,2,5,0
83520,4,1,292103,292104,292105,1,2,0
83521,1,2,292104,292105,292107,1,3,0
83522,2,2,292106,292107,292109,1,3,0
83523,3,1,292109,292109,292110,0,1,0
83524,2,1,292111,292111,292112,0,1,1
83525,3,1,292114,292114,292115,0,1,2
83526,6,3,292120,292120,292123,0,3,5
83527,3,2,292123,292123,292125,0,2,0
83528,6,2,292129,292129,292131,0,2,4
83529,3,3,292132,292132,292135,0,3,1
83530,6,3,292138,292138,292141,0,3,3
83531,4,3,292142,292142,292145,0,3,1
83532,1,3,292143,292145,292148,2,5,0
83533,4,3,292147,292148,292151,1,4,0
83534,6,3,292153,292153,292156,0,3,2
83535,2,1,292155,292156,292157,1,2,0
83536,5,1,292160,292160,292161,0,1,3
83537,4,1,292164,292164,292165,0,1,3
83538,4,2,292168,292168,292170,0,2,3
83539,1,3,292169,292170,292173,1,4,0
83540,2,2,292171,292173,292175,2,4,0
83541,2,3,292173,292175,292178,2,5,0
83542,1,2,292174,292178,292180,4,6,0
83543,1,3,292175,292180,292183,5,8,0
83544,2,3,292177,292183,292186,6,9,0
83545,6,1,292183,292186,292187,3,4,0
83546,1,3,292184,292187,292190,3,6,0
83547,4,3,292188,292190,292193,2,5,0
83548,1,1,292189,292193,292194,4,5,0
83549,6,3,292195,292195,292198,0,3,1
83550,4,2,292199,292199,292201,0,2,1
83551,6,1,292205,292205,292206,0,1,4
83552,6,3,292211,292211,292214,0,3,5
83553,5,1,292216,292216,292217,0,1,2
83554,1,2,292217,292217,292219,0,2,0
83555,4,2,292221,292221,292223,0,2,2
83556,1,3,292222,292223,292226,1,4,0
83557,2,2,292224,292226,292228,2,4,0
83558,1,2,292225,292228,292230,3,5,0
83559,5,2,292230,292230,292232,0,2,0
83560,5,3,292235,292235,292238,0,3,3
83561,2,3,292237,292238,292241,1,4,0
83562,6,3,292243,292243,292246,0,3,2
83563,1,3,292244,292246,292249,2,5,0
83564,6,3,292250,292250,292253,0,3,1
83565,5,3,292255,292255,292258,0,3,2
83566,4,3,292259,292259,292262,0,3,1
83567,4,3,292263,292263,292266,0,3,1
83568,4,2,292267,292267,292269,0,2,1
83569,2,1,292269,292269,292270,0,1,0
83570,5,2,292274,292274,292276,0,2,4
83571,6,2,292280,292280,292282,0,2,4
83572,6,2,292286,292286,292288,0,2,4
83573,6,3,292292,292292,292295,0,3,4
83574,6,1,292298,292298,292299,0,1,3
83575,5,3,292303,292303,292306,0,3,4
83576,6,2,292309,292309,292311,0,2,3
83577,6,1,292315,292315,292316,0,1,4
83578,1,2,292316,292316,292318,0,2,0
83579,5,2,292321,292321,292323,0,2,3
83580,6,1,292327,292327,292328,0,1,4
83581,5,3,292332,292332,292335,0,3,4
83582,2,1,292334,292335,292336,1,2,0
83583,4,1,292338,292338,292339,0,1,2
83584,6,3,292344,292344,292347,0,3,5
83585,5,1,292349,292349,292350,0,1,2
83586,6,3,292355,292355,292358,0,3,5
83587,2,1,292357,292358,292359,1,2,0
83588,3,1,292360,292360,292361,0,1,1
83589,5,3,292365,292365,292368,0,3,4
83590,2,3,292367,292368,292371,1,4,0
83591,1,3,292368,292371,292374,3,6,0
83592,3,2,292371,292374,292376,3,5,0
83593,6,1,292377,292377,292378,0,1,1
83594,5,3,292382,292382,292385,0,3,4
83595,6,3,292388,292388,292391,0,3,3
83596,6,2,292394,292394,292396,0,2,3
83597,3,3,292397,292397,292400,0,3,1
83598,4,1,292401,292401,292402,0,1,1
83599,5,2,292406,292406,292408,0,2,4
83600,4,2,292410,292410,292412,0,2,2
83601,6,1,292416,292416,292417,0,1,4
83602,3,1,292419,292419,292420,0,1,2
83603,6,1,292425,292425,292426,0,1,5
83604,3,3,292428,292428,292431,0,3,2
83605,6,2,292434,292434,292436,0,2,3
83606,3,3,292437,292437,292440,0,3,1
83607,4,2,292441,292441,292443,0,2,1
83608,6,1,292447,292447,292448,0,1,4
83609,6,1,292453,292453,292454,0,1,5
83610,5,2,292458,292458,292460,0,2,4
83611,3,2,292461,292461,292463,0,2,1
83612,5,1,292466,292466,292467,0,1,3
83613,6,3,292472,292472,292475,0,3,5
83614,4,2,292476,292476,292478,0,2,1
83615,2,2,292478,292478,292480,0,2,0
83616,4,3,292482,292482,292485,0,3,2
83617,5,3,292487,292487,292490,0,3,2
83618,4,2,292491,292491,292493,0,2,1
83619,6,2,292497,292497,292499,0,2,4
83620,6,3,292503,292503,292506,0,3,4
83621,6,2,292509,292509,292511,0,2,3
83622,4,3,292513,292513,292516,0,3,2
83623,1,2,292514,292516,292518,2,4,0
83624,1,1,292515,292518,292519,3,4,0
83625,6,2,292521,292521,292523,0,2,2
83626,5,1,292526,292526,292527,0,1,3
83627,5,3,292531,292531,292534,0,3,4
83628,4,3,292535,292535,292538,0,3,1
83629,5,3,292540,292540,292543,0,3,2
83630,6,1,292546,292546,292547,0,1,3
83631,6,3,292552,292552,292555,0,3,5
83632,4,2,292556,292556,292558,0,2,1
83633,4,1,292560,292560,292561,0,1,2
83634,1,1,292561,292561,292562,0,1,0
83635,1,3,292562,292562,292565,0,3,0
83636,5,3,292567,292567,292570,0,3,2
83637,3,2,292570,292570,292572,0,2,0
83638,2,3,292572,292572,292575,0,3,0
83639,5,3,292577,292577,292580,0,3,2
83640,2,3,292579,292580,292583,1,4,0
83641,2,3,292581,292583,292586,2,5,0
83642,3,3,292584,292586,292589,2,5,0
83643,2,2,292586,292589,292591,3,5,0
83644,4,3,292590,292591,292594,1,4,0
83645,6,3,292596,292596,292599,0,3,2
83646,5,1,292601,292601,292602,0,1,2
83647,1,3,292602,292602,292605,0,3,0
83648,6,3,292608,292608,292611,0,3,3
83649,3,1,292611,292611,292612,0,1,0
83650,1,3,292612,292612,292615,0,3,0
83651,2,3,292614,292615,292618,1,4,0
83652,6,1,292620,292620,292621,0,1,2
83653,6,1,292626,292626,292627,0,1,5
83654,2,1,292628,292628,292629,0,1,1
83655,1,3,292629,292629,292632,0,3,0
83656,6,3,292635,292635,292638,0,3,3
83657,6,2,292641,292641,292643,0,2,3
83658,3,2,292644,292644,292646,0,2,1
83659,2,1,292646,292646,292647,0,1,0
83660,5,3,292651,292651,292654,0,3,4
83661,4,2,292655,292655,292657,0,2,1
83662,6,3,292661,292661,292664,0,3,4
83663,6,2,292667,292667,292669,0,2,3
83664,1,3,292668,292669,292672,1,4,0
83665,3,3,292671,292672,292675,1,4,0
83666,3,2,292674,292675,292677,1,3,0
83667,1,1,292675,292677,292678,2,3,0
83668,5,2,292680,292680,292682,0,2,2
83669,3,1,292683,292683,292684,0,1,1
83670,6,3,292689,292689,292692,0,3,5
83671,3,2,292692,292692,292694,0,2,0
83672,3,3,292695,292695,292698,0,3,1
83673,3,3,292698,292698,292701,0,3,0
83674,5,3,292703,292703,292706,0,3,2
83675,2,3,292705,292706,292709,1,4,0
83676,5,1,292710,292710,292711,0,1,1
83677,3,3,292713,292713,292716,0,3,2
83678,5,2,292718,292718,292720,0,2,2
83679,4,3,292722,292722,292725,0,3,2
83680,1,2,292723,292725,292727,2,4,0
83681,4,3,292727,292727,292730,0,3,0
83682,4,1,292731,292731,292732,0,1,1
83683,3,1,292734,292734,292735,0,1,2
83684,4,2,292738,292738,292740,0,2,3
83685,6,2,292744,292744,292746,0,2,4
83686,6,1,292750,292750,292751,0,1,4
83687,3,3,292753,292753,292756,0,3,2
83688,3,2,292756,292756,292758,0,2,0
83689,2,2,292758,292758,292760,0,2,0
83690,6,3,292764,292764,292767,0,3,4
83691,1,1,292765,292767,292768,2,3,0
83692,2,2,292767,292768,292770,1,3,0
83693,4,3,292771,292771,292774,0,3,1
83694,4,3,292775,292775,292778,0,3,1
83695,4,1,292779,292779,292780,0,1,1
83696,3,2,292782,292782,292784,0,2,2
83697,5,1,292787,292787,292788,0,1,3
83698,3,2,292790,292790,292792,0,2,2
83699,6,3,292796,292796,292799,0,3,4
83700,1,1,292797,292799,292800,2,3,0
83701,2,2,292799,292800,292802,1,3,0
83702,4,1,292803,292803,292804,0,1,1
83703,1,1,292804,292804,292805,0,1,0
83704,6,1,292810,292810,292811,0,1,5
83705,6,1,292816,292816,292817,0,1,5
83706,4,3,292820,292820,292823,0,3,3
83707,2,1,292822,292823,292824,1,2,0
83708,4,2,292826,292826,292828,0,2,2
83709,6,1,292832,292832,292833,0,1,4
83710,4,1,292836,292836,292837,0,1,3
83711,2,3,292838,292838,292841,0,3,1
83712,3,2,292841,292841,292843,0,2,0
83713,4,1,292845,292845,292846,0,1,2
83714,6,3,292851,292851,292854,0,3,5
83715,3,1,292854,292854,292855,0,1,0
83716,4,3,292858,292858,292861,0,3,3
83717,2,2,292860,292861,292863,1,3,0
83718,3,3,292863,292863,292866,0,3,0
83719,6,1,292869,292869,292870,0,1,3
83720,4,1,292873,292873,292874,0,1,3
83721,2,1,292875,292875,292876,0,1,1
83722,2,3,292877,292877,292880,0,3,1
83723,1,1,292878,292880,292881,2,3,0
83724,4,3,292882,292882,292885,0,3,1
83725,1,1,292883,292885,292886,2,3,0
83726,1,3,292884,292886,292889,2,5,0
83727,1,2,292885,292889,292891,4,6,0
83728,3,1,292888,292891,292892,3,4,0
83729,1,3,292889,292892,292895,3,6,0
83730,3,2,292892,292895,292897,3,5,0
83731,3,3,292895,292897,292900,2,5,0
83732,1,1,292896,292900,292901,4,5,0
83733,1,3,292897,292901,292904,4,7,0
83734,1,3,292898,292904,292907,6,9,0
83735,2,2,292900,292907,292909,7,9,0
83736,2,3,292902,292909,292912,7,10,0
83737,4,3,292906,292912,292915,6,9,0
83738,6,3,292912,292915,292918,3,6,0
83739,1,3,292913,292918,292921,5,8,0
83740,3,3,292916,292921,292924,5,8,0
83741,4,2,292920,292924,292926,4,6,0
83742,2,3,292922,292926,292929,4,7,0
83743,1,3,292923,292929,292932,6,9,0
83744,5,1,292928,292932,292933,4,5,0
83745,6,3,292934,292934,292937,0,3,1
83746,6,1,292940,292940,292941,0,1,3
83747,4,2,292944,292944,292946,0,2,3
83748,1,3,292945,292946,292949,1,4,0
83749,6,3,292951,292951,292954,0,3,2
83750,2,3,292953,292954,292957,1,4,0
83751,5,1,292958,292958,292959,0,1,1
83752,3,3,292961,292961,292964,0,3,2
83753,3,3,292964,292964,292967,0,3,0
83754,1,3,292965,292967,292970,2,5,0
83755,2,1,292967,292970,292971,3,4,0
83756,2,3,292969,292971,292974,2,5,0
83757,1,3,292970,292974,292977,4,7,0
83758,3,3,292973,292977,292980,4,7,0
83759,1,2,292974,292980,292982,6,8,0
83760,3,2,292977,292982,292984,5,7,0
83761,1,1,292978,292984,292985,6,7,0
83762,1,3,292979,292985,292988,6,9,0
83763,2,2,292981,292988,292990,7,9,0
83764,6,1,292987,292990,292991,3,4,0
83765,2,2,292989,292991,292993,2,4,0
83766,3,2,292992,292993,292995,1,3,0
83767,6,3,292998,292998,293001,0,3,3
83768,6,3,293004,293004,293007,0,3,3
83769,6,3,293010,293010,293013,0,3,3
83770,4,2,293014,293014,293016,0,2,1
83771,4,3,293018,293018,293021,0,3,2
83772,3,3,293021,293021,293024,0,3,0
83773,4,1,293025,293025,293026,0,1,1
83774,1,3,293026,293026,293029,0,3,0
83775,4,1,293030,293030,293031,0,1,1
83776,2,2,293032,293032,293034,0,2,1
83777,6,1,293038,293038,293039,0,1,4
83778,1,2,293039,293039,293041,0,2,0
83779,3,1,293042,293042,293043,0,1,1
83780,4,3,293046,293046,293049,0,3,3
83781,3,3,293049,293049,293052,0,3,0
83782,2,2,293051,293052,293054,1,3,0
83783,6,3,293057,293057,293060,0,3,3
83784,2,3,293059,293060,293063,1,4,0
83785,1,1,293060,293063,293064,3,4,0
83786,2,2,293062,293064,293066,2,4,0
83787,3,1,293065,293066,293067,1,2,0
83788,5,1,293070,293070,293071,0,1,3
83789,4,2,293074,293074,293076,0,2,3
83790,1,1,293075,293076,293077,1,2,0
83791,2,2,293077,293077,293079,0,2,0
83792,6,1,293083,293083,293084,0,1,4
83793,3,1,293086,293086,293087,0,1,2
83794,4,3,293090,293090,293093,0,3,3
83795,4,2,293094,293094,293096,0,2,1
83796,4,3,293098,293098,293101,0,3,2
83797,4,3,293102,293102,293105,0,3,1
83798,4,1,293106,293106,293107,0,1,1
83799,1,1,293107,293107,293108,0,1,0
83800,1,1,293108,293108,293109,0,1,0
83801,4,2,293112,293112,293114,0,2,3
83802,3,3,293115,293115,293118,0,3,1
83803,5,3,293120,293120,293123,0,3,2
83804,1,1,293121,293123,293124,2,3,0
83805,3,2,293124,293124,293126,0,2,0
83806,5,3,293129,293129,293132,0,3,3
83807,2,1,293131,293132,293133,1,2,0
83808,2,1,293133,293133,293134,0,1,0
83809,2,3,293135,293135,293138,0,3,1
83810,2,1,293137,293138,293139,1,2,0
83811,5,3,293142,293142,293145,0,3,3
83812,2,2,293144,293145,293147,1,3,0
83813,2,2,293146,293147,293149,1,3,0
83814,3,3,293149,293149,293152,0,3,0
83815,3,1,293152,293152,293153,0,1,0
83816,6,1,293158,293158,293159,0,1,5
83817,6,3,293164,293164,293167,0,3,5
83818,2,3,293166,293167,293170,1,4,0
83819,3,2,293169,293170,293172,1,3,0
83820,5,2,293174,293174,293176,0,2,2
83821,3,2,293177,293177,293179,0,2,1
83822,3,1,293180,293180,293181,0,1,1
83823,2,2,293182,293182,293184,0,2,1
83824,1,3,293183,293184,293187,1,4,0
83825,6,3,293189,293189,293192,0,3,2
83826,4,3,293193,293193,293196,0,3,1
83827,2,3,293195,293196,293199,1,4,0
83828,5,1,293200,293200,293201,0,1,1
83829,5,3,293205,293205,293208,0,3,4
83830,5,2,293210,293210,293212,0,2,2
83831,6,3,293216,293216,293219,0,3,4
83832,3,2,293219,293219,293221,0,2,0
83833,5,1,293224,293224,293225,0,1,3
83834,1,1,293225,293225,293226,0,1,0
83835,1,1,293226,293226,293227,0,1,0
83836,3,1,293229,293229,293230,0,1,2
83837,5,2,293234,293234,293236,0,2,4
83838,1,2,293235,293236,293238,1,3,0
83839,3,3,293238,293238,293241,0,3,0
83840,6,2,293244,293244,293246,0,2,3
83841,6,1,293250,293250,293251,0,1,4
83842,6,2,293256,293256,293258,0,2,5
83843,2,2,293258,293258,293260,0,2,0
83844,1,2,293259,293260,293262,1,3,0
83845,5,1,293264,293264,293265,0,1,2
83846,4,1,293268,293268,293269,0,1,3
83847,5,1,293273,293273,293274,0,1,4
83848,3,3,293276,293276,293279,0,3,2
83849,5,3,293281,293281,293284,0,3,2
83850,6,2,293287,293287,293289,0,2,3
83851,2,2,293289,293289,293291,0,2,0
83852,6,2,293295,293295,293297,0,2,4
83853,1,1,293296,293297,293298,1,2,0
83854,1,1,293297,293298,293299,1,2,0
83855,4,1,293301,293301,293302,0,1,2
83856,2,3,293303,293303,293306,0,3,1
83857,6,2,293309,293309,293311,0,2,3
83858,5,3,293314,293314,293317,0,3,3
83859,1,2,293315,293317,293319,2,4,0
83860,4,3,293319,293319,293322,0,3,0
83861,4,3,293323,293323,293326,0,3,1
83862,4,2,293327,293327,293329,0,2,1
83863,5,2,293332,293332,293334,0,2,3
83864,6,3,293338,293338,293341,0,3,4
83865,6,2,293344,293344,293346,0,2,3
83866,5,2,293349,293349,293351,0,2,3
83867,1,2,293350,293351,293353,1,3,0
83868,5,3,293355,293355,293358,0,3,2
83869,6,2,293361,293361,293363,0,2,3
83870,1,2,293362,293363,293365,1,3,0
83871,1,3,293363,293365,293368,2,5,0
83872,6,1,293369,293369,293370,0,1,1
83873,1,3,293370,293370,293373,0,3,0
83874,5,3,293375,293375,293378,0,3,2
83875,3,2,293378,293378,293380,0,2,0
83876,1,3,293379,293380,293383,1,4,0
83877,4,2,293383,293383,293385,0,2,0
83878,5,2,293388,293388,293390,0,2,3
83879,6,2,293394,293394,293396,0,2,4
83880,1,1,293395,293396,293397,1,2,0
83881,1,2,293396,293397,293399,1,3,0
83882,2,2,293398,293399,293401,1,3,0
83883,4,3,293402,293402,293405,0,3,1
83884,1,1,293403,293405,293406,2,3,0
83885,2,1,293405,293406,293407,1,2,0
83886,6,1,293411,293411,293412,0,1,4
83887,4,2,293415,293415,293417,0,2,3
83888,2,1,293417,293417,293418,0,1,0
83889,5,3,293422,293422,293425,0,3,4
83890,2,2,293424,293425,293427,1,3,0
83891,6,2,293430,293430,293432,0,2,3
83892,3,2,293433,293433,293435,0,2,1
83893,4,2,293437,293437,293439,0,2,2
83894,5,3,293442,293442,293445,0,3,3
83895,4,3,293446,293446,293449,0,3,1
83896,3,2,293449,293449,293451,0,2,0
83897,3,2,293452,293452,293454,0,2,1
83898,1,3,293453,293454,293457,1,4,0
83899,1,1,293454,293457,293458,3,4,0
83900,6,3,293460,293460,293463,0,3,2
83901,5,2,293465,293465,293467,0,2,2
83902,2,3,293467,293467,293470,0,3,0
83903,3,1,293470,293470,293471,0,1,0
83904,3,3,293473,293473,293476,0,3,2
83905,1,3,293474,293476,293479,2,5,0
83906,6,1,293480,293480,293481,0,1,1
83907,5,2,293485,293485,293487,0,2,4
83908,3,1,293488,293488,293489,0,1,1
83909,3,2,293491,293491,293493,0,2,2
83910,3,1,293494,293494,293495,0,1,1
83911,6,1,293500,293500,293501,0,1,5
83912,3,2,293503,293503,293505,0,2,2
83913,1,1,293504,293505,293506,1,2,0
83914,3,3,293507,293507,293510,0,3,1
83915,3,2,293510,293510,293512,0,2,0
83916,3,3,293513,293513,293516,0,3,1
83917,6,1,293519,293519,293520,0,1,3
83918,4,2,293523,293523,293525,0,2,3
83919,6,1,293529,293529,293530,0,1,4
83920,4,1,293533,293533,293534,0,1,3
83921,5,3,293538,293538,293541,0,3,4
83922,3,2,293541,293541,293543,0,2,0
83923,4,1,293545,293545,293546,0,1,2
83924,5,2,293550,293550,293552,0,2,4
83925,4,1,293554,293554,293555,0,1,2
83926,6,3,293560,293560,293563,0,3,5
83927,2,3,293562,293563,293566,1,4,0
83928,4,2,293566,293566,293568,0,2,0
83929,6,2,293572,293572,293574,0,2,4
83930,4,1,293576,293576,293577,0,1,2
83931,2,2,293578,293578,293580,0,2,1
83932,2,1,293580,293580,293581,0,1,0
83933,6,3,293586,293586,293589,0,3,5
83934,2,3,293588,293589,293592,1,4,0
83935,3,1,293591,293592,293593,1,2,0
83936,5,2,293596,293596,293598,0,2,3
83937,4,3,293600,293600,293603,0,3,2
83938,4,3,293604,293604,293607,0,3,1
83939,5,2,293609,293609,293611,0,2,2
83940,6,3,293615,293615,293618,0,3,4
83941,4,3,293619,293619,293622,0,3,1
83942,4,1,293623,293623,293624,0,1,1
83943,5,3,293628,293628,293631,0,3,4
83944,4,1,293632,293632,293633,0,1,1
83945,1,2,293633,293633,293635,0,2,0
83946,4,3,293637,293637,293640,0,3,2
83947,2,1,293639,293640,293641,1,2,0
83948,6,2,293645,293645,293647,0,2,4
83949,3,1,293648,293648,293649,0,1,1
83950,4,2,293652,293652,293654,0,2,3
83951,2,2,293654,293654,293656,0,2,0
83952,1,2,293655,293656,293658,1,3,0
83953,5,3,293660,293660,293663,0,3,2
83954,5,1,293665,293665,293666,0,1,2
83955,5,3,293670,293670,293673,0,3,4
83956,4,1,293674,293674,293675,0,1,1
83957,5,3,293679,293679,293682,0,3,4
83958,6,1,293685,293685,293686,0,1,3
83959,4,3,293689,293689,293692,0,3,3
83960,3,3,293692,293692,293695,0,3,0
83961,1,2,293693,293695,293697,2,4,0
83962,4,3,293697,293697,293700,0,3,0
83963,1,3,293698,293700,293703,2,5,0
83964,1,2,293699,293703,293705,4,6,0
83965,3,1,293702,293705,293706,3,4,0
83966,5,3,293707,293707,293710,0,3,1
83967,5,2,293712,293712,293714,0,2,2
83968,5,3,293717,293717,293720,0,3,3
83969,4,2,293721,293721,293723,0,2,1
83970,6,3,293727,293727,293730,0,3,4
83971,2,3,293729,293730,293733,1,4,0
83972,1,2,293730,293733,293735,3,5,0
83973,3,3,293733,293735,293738,2,5,0
83974,6,1,293739,293739,293740,0,1,1
83975,1,3,293740,293740,293743,0,3,0
83976,1,2,293741,293743,293745,2,4,0
83977,2,1,293743,293745,293746,2,3,0
83978,1,2,293744,293746,293748,2,4,0
83979,1,3,293745,293748,293751,3,6,0
83980,4,2,293749,293751,293753,2,4,0
83981,4,2,293753,293753,293755,0,2,0
83982,4,2,293757,293757,293759,0,2,2
83983,3,1,293760,293760,293761,0,1,1
83984,2,1,293762,293762,293763,0,1,1
83985,2,1,293764,293764,293765,0,1,1
83986,2,1,293766,293766,293767,0,1,1
83987,1,3,293767,293767,293770,0,3,0
83988,6,2,293773,293773,293775,0,2,3
83989,5,2,293778,293778,293780,0,2,3
83990,1,3,293779,293780,293783,1,4,0
83991,6,1,293785,293785,293786,0,1,2
83992,5,1,293790,293790,293791,0,1,4
83993,5,2,293795,293795,293797,0,2,4
83994,3,3,293798,293798,293801,0,3,1
83995,1,3,293799,293801,293804,2,5,0
83996,1,1,293800,293804,293805,4,5,0
83997,2,3,293802,293805,293808,3,6,0
83998,2,3,293804,293808,293811,4,7,0
83999,3,2,293807,293811,293813,4,6,0
84000,1,1,293808,293813,293814,5,6,0
84001,1,1,293809,293814,293815,5,6,0
84002,1,1,293810,293815,293816,5,6,0
84003,1,2,293811,293816,293818,5,7,0
84004,4,1,293815,293818,293819,3,4,0
84005,3,3,293818,293819,293822,1,4,0
84006,1,2,293819,293822,293824,3,5,0
84007,4,1,293823,293824,293825,1,2,0
84008,6,1,293829,293829,293830,0,1,4
84009,1,2,293830,293830,293832,0,2,0
84010,4,1,293834,293834,293835,0,1,2
84011,1,2,293835,293835,293837,0,2,0
84012,6,1,293841,293841,293842,0,1,4
84013,3,3,293844,293844,293847,0,3,2
84014,4,3,293848,293848,293851,0,3,1
84015,1,1,293849,293851,293852,2,3,0
84016,5,3,293854,293854,293857,0,3,2
84017,1,2,293855,293857,293859,2,4,0
84018,4,1,293859,293859,293860,0,1,0
84019,6,2,293865,293865,293867,0,2,5
84020,5,2,293870,293870,293872,0,2,3
84021,5,2,293875,293875,293877,0,2,3
84022,4,2,293879,293879,293881,0,2,2
84023,4,1,293883,293883,293884,0,1,2
84024,4,3,293887,293887,293890,0,3,3
84025,2,3,293889,293890,293893,1,4,0
84026,4,1,293893,293893,293894,0,1,0
84027,5,2,293898,293898,293900,0,2,4
84028,2,2,293900,293900,293902,0,2,0
84029,1,3,293901,293902,293905,1,4,0
84030,1,2,293902,293905,293907,3,5,0
84031,2,2,293904,293907,293909,3,5,0
84032,2,2,293906,293909,293911,3,5,0
84033,4,3,293910,293911,293914,1,4,0
84034,2,2,293912,293914,293916,2,4,0
84035,6,2,293918,293918,293920,0,2,2
84036,6,3,293924,293924,293927,0,3,4
84037,1,3,293925,293927,293930,2,5,0
84038,6,1,293931,293931,293932,0,1,1
84039,6,2,293937,293937,293939,0,2,5
84040,6,2,293943,293943,293945,0,2,4
84041,6,1,293949,293949,293950,0,1,4
84042,1,2,293950,293950,293952,0,2,0
84043,1,2,293951,293952,293954,1,3,0
84044,6,1,293957,293957,293958,0,1,3
84045,4,1,293961,293961,293962,0,1,3
84046,1,2,293962,293962,293964,0,2,0
84047,3,2,293965,293965,293967,0,2,1
84048,2,1,293967,293967,293968,0,1,0
84049,1,2,293968,293968,293970,0,2,0
84050,5,2,293973,293973,293975,0,2,3
84051,4,2,293977,293977,293979,0,2,2
84052,1,2,293978,293979,293981,1,3,0
84053,3,3,293981,293981,293984,0,3,0
84054,2,3,293983,293984,293987,1,4,0
84055,4,1,293987,293987,293988,0,1,0
84056,1,2,293988,293988,293990,0,2,0
84057,1,1,293989,293990,293991,1,2,0
84058,6,1,293995,293995,293996,0,1,4
84059,1,1,293996,293996,293997,0,1,0
84060,6,3,294002,294002,294005,0,3,5
84061,5,2,294007,294007,294009,0,2,2
84062,5,2,294012,294012,294014,0,2,3
84063,5,1,294017,294017,294018,0,1,3
84064,4,3,294021,294021,294024,0,3,3
84065,2,1,294023,294024,294025,1,2,0
84066,4,1,294027,294027,294028,0,1,2
84067,1,1,294028,294028,294029,0,1,0
84068,5,3,294033,294033,294036,0,3,4
84069,3,1,294036,294036,294037,0,1,0
84070,6,1,294042,294042,294043,0,1,5
84071,4,3,294046,294046,294049,0,3,3
84072,6,2,294052,294052,294054,0,2,3
84073,5,2,294057,294057,294059,0,2,3
84074,5,1,294062,294062,294063,0,1,3
84075,1,3,294063,294063,294066,0,3,0
84076,6,3,294069,294069,294072,0,3,3
84077,3,1,294072,294072,294073,0,1,0
84078,1,1,294073,294073,294074,0,1,0
84079,6,1,294079,294079,294080,0,1,5
84080,1,3,294080,294080,294083,0,3,0
84081,5,3,294085,294085,294088,0,3,2
84082,1,3,294086,294088,294091,2,5,0
84083,5,2,294091,294091,294093,0,2,0
84084,2,3,294093,294093,294096,0,3,0
84085,5,2,294098,294098,294100,0,2,2
84086,4,1,294102,294102,294103,0,1,2
84087,3,1,294105,294105,294106,0,1,2
84088,5,1,294110,294110,294111,0,1,4
84089,6,3,294116,294116,294119,0,3,5
84090,5,3,294121,294121,294124,0,3,2
84091,4,2,294125,294125,294127,0,2,1
84092,3,2,294128,294128,294130,0,2,1
84093,3,2,294131,294131,294133,0,2,1
84094,5,3,294136,294136,294139,0,3,3
84095,4,2,294140,294140,294142,0,2,1
84096,5,2,294145,294145,294147,0,2,3
84097,6,2,294151,294151,294153,0,2,4
84098,1,3,294152,294153,294156,1,4,0
84099,2,3,294154,294156,294159,2,5,0
84100,2,3,294156,294159,294162,3,6,0
84101,5,2,294161,294162,294164,1,3,0
84102,5,3,294166,294166,294169,0,3,2
84103,6,2,294172,294172,294174,0,2,3
84104,3,3,294175,294175,294178,0,3,1
84105,6,3,294181,294181,294184,0,3,3
84106,1,3,294182,294184,294187,2,5,0
84107,1,3,294183,294187,294190,4,7,0
84108,5,3,294188,294190,294193,2,5,0
84109,6,2,294194,294194,294196,0,2,1
84110,4,2,294198,294198,294200,0,2,2
84111,2,1,294200,294200,294201,0,1,0
84112,4,3,294204,294204,294207,0,3,3
84113,6,3,294210,294210,294213,0,3,3
84114,1,2,294211,294213,294215,2,4,0
84115,2,1,294213,294215,294216,2,3,0
84116,5,3,294218,294218,294221,0,3,2
84117,2,1,294220,294221,294222,1,2,0
84118,1,2,294221,294222,294224,1,3,0
84119,4,1,294225,294225,294226,0,1,1
84120,6,2,294231,294231,294233,0,2,5
84121,5,1,294236,294236,294237,0,1,3
84122,1,1,294237,294237,294238,0,1,0
84123,5,1,294242,294242,294243,0,1,4
84124,3,1,294245,294245,294246,0,1,2
84125,2,1,294247,294247,294248,0,1,1
84126,3,1,294250,294250,294251,0,1,2
84127,5,3,294255,294255,294258,0,3,4
84128,5,3,294260,294260,294263,0,3,2
84129,3,3,294263,294263,294266,0,3,0
84130,3,1,294266,294266,294267,0,1,0
84131,4,2,294270,294270,294272,0,2,3
84132,6,1,294276,294276,294277,0,1,4
84133,4,1,294280,294280,294281,0,1,3
84134,3,1,294283,294283,294284,0,1,2
84135,4,1,294287,294287,294288,0,1,3
84136,5,3,294292,294292,294295,0,3,4
84137,6,2,294298,294298,294300,0,2,3
84138,4,1,294302,294302,294303,0,1,2
84139,2,1,294304,294304,294305,0,1,1
84140,3,1,294307,294307,294308,0,1,2
84141,4,3,294311,294311,294314,0,3,3
84142,5,1,294316,294316,294317,0,1,2
84143,1,1,294317,294317,294318,0,1,0
84144,2,1,294319,294319,294320,0,1,1
84145,6,3,294325,294325,294328,0,3,5
84146,3,1,294328,294328,294329,0,1,0
84147,3,2,294331,294331,294333,0,2,2
84148,5,2,294336,294336,294338,0,2,3
84149,3,3,294339,294339,294342,0,3,1
84150,1,1,294340,294342,294343,2,3,0
84151,5,3,294345,294345,294348,0,3,2
84152,3,1,294348,294348,294349,0,1,0
84153,6,2,294354,294354,294356,0,2,5
84154,3,3,294357,294357,294360,0,3,1
84155,6,2,294363,294363,294365,0,2,3
84156,5,3,294368,294368,294371,0,3,3
84157,2,3,294370,294371,294374,1,4,0
84158,1,1,294371,294374,294375,3,4,0
84159,1,1,294372,294375,294376,3,4,0
84160,6,3,294378,294378,294381,0,3,2
84161,2,3,294380,294381,294384,1,4,0
84162,4,2,294384,294384,294386,0,2,0
84163,1,1,294385,294386,294387,1,2,0
84164,2,1,294387,294387,294388,0,1,0
84165,1,2,294388,294388,294390,0,2,0
84166,4,3,294392,294392,294395,0,3,2
84167,4,1,294396,294396,294397,0,1,1
84168,3,3,294399,294399,294402,0,3,2
84169,1,3,294400,294402,294405,2,5,0
84170,3,2,294403,294405,294407,2,4,0
84171,4,2,294407,294407,294409,0,2,0
84172,1,1,294408,294409,294410,1,2,0
84173,4,2,294412,294412,294414,0,2,2
84174,2,1,294414,294414,294415,0,1,0
84175,3,1,294417,294417,294418,0,1,2
84176,4,2,294421,294421,294423,0,2,3
84177,4,1,294425,294425,294426,0,1,2
84178,4,2,294429,294429,294431,0,2,3
84179,1,2,294430,294431,294433,1,3,0
84180,5,3,294435,294435,294438,0,3,2
84181,3,1,294438,294438,294439,0,1,0
84182,6,2,294444,294444,294446,0,2,5
84183,5,1,294449,294449,294450,0,1,3
84184,1,3,294450,294450,294453,0,3,0
84185,1,1,294451,294453,294454,2,3,0
84186,4,3,294455,294455,294458,0,3,1
84187,6,2,294461,294461,294463,0,2,3
84188,3,1,294464,294464,294465,0,1,1
84189,4,3,294468,294468,294471,0,3,3
84190,5,3,294473,294473,294476,0,3,2
84191,4,3,294477,294477,294480,0,3,1
84192,4,2,294481,294481,294483,0,2,1
84193,2,3,294483,294483,294486,0,3,0
84194,5,3,294488,294488,294491,0,3,2
84195,3,2,294491,294491,294493,0,2,0
84196,1,1,294492,294493,294494,1,2,0
84197,1,1,294493,294494,294495,1,2,0
84198,4,2,294497,294497,294499,0,2,2
84199,2,2,294499,294499,294501,0,2,0
84200,2,1,294501,294501,294502,0,1,0
84201,4,2,294505,294505,294507,0,2,3
84202,1,1,294506,294507,294508,1,2,0
84203,5,1,294511,294511,294512,0,1,3
84204,2,1,294513,294513,294514,0,1,1
84205,2,3,294515,294515,294518,0,3,1
84206,6,3,294521,294521,294524,0,3,3
84207,3,1,294524,294524,294525,0,1,0
84208,3,3,294527,294527,294530,0,3,2
84209,3,1,294530,294530,294531,0,1,0
84210,2,1,294532,294532,294533,0,1,1
84211,4,2,294536,294536,294538,0,2,3
84212,5,3,294541,294541,294544,0,3,3
84213,3,1,294544,294544,294545,0,1,0
84214,2,3,294546,294546,294549,0,3,1
84215,2,3,294548,294549,294552,1,4,0
84216,5,2,294553,294553,294555,0,2,1
84217,2,1,294555,294555,294556,0,1,0
84218,1,2,294556,294556,294558,0,2,0
84219,5,1,294561,294561,294562,0,1,3
84220,3,3,294564,294564,294567,0,3,2
84221,3,3,294567,294567,294570,0,3,0
84222,1,2,294568,294570,294572,2,4,0
84223,5,3,294573,294573,294576,0,3,1
84224,2,2,294575,294576,294578,1,3,0
84225,3,3,294578,294578,294581,0,3,0
84226,4,2,294582,294582,294584,0,2,1
84227,1,3,294583,294584,294587,1,4,0
84228,2,3,294585,294587,294590,2,5,0
84229,1,3,294586,294590,294593,4,7,0
84230,4,2,294590,294593,294595,3,5,0
84231,1,2,294591,294595,294597,4,6,0
84232,2,3,294593,294597,294600,4,7,0
84233,3,2,294596,294600,294602,4,6,0
84234,4,1,294600,294602,294603,2,3,0
84235,3,2,294603,294603,294605,0,2,0
84236,1,2,294604,294605,294607,1,3,0
84237,4,1,294608,294608,294609,0,1,1
84238,4,2,294612,294612,294614,0,2,3
84239,3,2,294615,294615,294617,0,2,1
84240,4,3,294619,294619,294622,0,3,2
84241,4,3,294623,294623,294626,0,3,1
84242,3,3,294626,294626,294629,0,3,0
84243,5,1,294631,294631,294632,0,1,2
84244,1,3,294632,294632,294635,0,3,0
84245,6,2,294638,294638,294640,0,2,3
84246,3,2,294641,294641,294643,0,2,1
84247,6,3,294647,294647,294650,0,3,4
84248,5,3,294652,294652,294655,0,3,2
84249,6,2,294658,294658,294660,0,2,3
84250,1,3,294659,294660,294663,1,4,0
84251,6,2,294665,294665,294667,0,2,2
84252,4,2,294669,294669,294671,0,2,2
84253,5,2,294674,294674,294676,0,2,3
84254,3,1,294677,294677,294678,0,1,1
84255,3,1,294680,294680,294681,0,1,2
84256,6,2,294686,294686,294688,0,2,5
84257,3,3,294689,294689,294692,0,3,1
84258,2,3,294691,294692,294695,1,4,0
84259,2,3,294693,294695,294698,2,5,0
84260,2,3,294695,294698,294701,3,6,0
84261,2,2,294697,294701,294703,4,6,0
84262,5,3,294702,294703,294706,1,4,0
84263,3,2,294705,294706,294708,1,3,0
84264,2,2,294707,294708,294710,1,3,0
84265,1,2,294708,294710,294712,2,4,0
84266,1,2,294709,294712,294714,3,5,0
84267,2,3,294711,294714,294717,3,6,0
84268,2,3,294713,294717,294720,4,7,0
84269,6,1,294719,294720,294721,1,2,0
84270,5,2,294724,294724,294726,0,2,3
84271,3,2,294727,294727,294729,0,2,1
84272,1,3,294728,294729,294732,1,4,0
84273,5,2,294733,294733,294735,0,2,1
84274,3,3,294736,294736,294739,0,3,1
84275,1,3,294737,294739,294742,2,5,0
84276,4,3,294741,294742,294745,1,4,0
84277,5,1,294746,294746,294747,0,1,1
84278,6,2,294752,294752,294754,0,2,5
84279,2,2,294754,294754,294756,0,2,0
84280,5,1,294759,294759,294760,0,1,3
84281,1,3,294760,294760,294763,0,3,0
84282,3,2,294763,294763,294765,0,2,0
84283,6,2,294769,294769,294771,0,2,4
84284,6,3,294775,294775,294778,0,3,4
84285,1,1,294776,294778,294779,2,3,0
84286,4,3,294780,294780,294783,0,3,1
84287,6,3,294786,294786,294789,0,3,3
84288,1,2,294787,294789,294791,2,4,0
84289,3,1,294790,294791,294792,1,2,0
84290,3,2,294793,294793,294795,0,2,1
84291,1,1,294794,294795,294796,1,2,0
84292,3,1,294797,294797,294798,0,1,1
84293,4,3,294801,294801,294804,0,3,3
84294,1,3,294802,294804,294807,2,5,0
84295,3,3,294805,294807,294810,2,5,0
84296,6,3,294811,294811,294814,0,3,1
84297,1,1,294812,294814,294815,2,3,0
84298,4,2,294816,294816,294818,0,2,1
84299,1,3,294817,294818,294821,1,4,0
84300,1,3,294818,294821,294824,3,6,0
84301,5,2,294823,294824,294826,1,3,0
84302,5,3,294828,294828,294831,0,3,2
84303,4,1,294832,294832,294833,0,1,1
84304,1,3,294833,294833,294836,0,3,0
84305,1,1,294834,294836,294837,2,3,0
84306,2,3,294836,294837,294840,1,4,0
84307,5,2,294841,294841,294843,0,2,1
84308,6,2,294847,294847,294849,0,2,4
84309,1,3,294848,294849,294852,1,4,0
84310,1,2,294849,294852,294854,3,5,0
84311,6,2,294855,294855,294857,0,2,1
84312,1,1,294856,294857,294858,1,2,0
84313,1,2,294857,294858,294860,1,3,0
84314,4,3,294861,294861,294864,0,3,1
84315,3,2,294864,294864,294866,0,2,0
84316,1,3,294865,294866,294869,1,4,0
84317,4,2,294869,294869,294871,0,2,0
84318,2,3,294871,294871,294874,0,3,0
84319,6,3,294877,294877,294880,0,3,3
84320,4,1,294881,294881,294882,0,1,1
84321,4,1,294885,294885,294886,0,1,3
84322,1,2,294886,294886,294888,0,2,0
84323,5,1,294891,294891,294892,0,1,3
84324,3,1,294894,294894,294895,0,1,2
84325,3,3,294897,294897,294900,0,3,2
84326,6,3,294903,294903,294906,0,3,3
84327,5,3,294908,294908,294911,0,3,2
84328,2,3,294910,294911,294914,1,4,0
84329,2,1,294912,294914,294915,2,3,0
84330,5,3,294917,294917,294920,0,3,2
84331,4,3,294921,294921,294924,0,3,1
84332,2,3,294923,294924,294927,1,4,0
84333,6,3,294929,294929,294932,0,3,2
84334,1,2,294930,294932,294934,2,4,0
84335,1,1,294931,294934,294935,3,4,0
84336,5,2,294936,294936,294938,0,2,1
84337,2,3,294938,294938,294941,0,3,0
84338,6,3,294944,294944,294947,0,3,3
84339,4,3,294948,294948,294951,0,3,1
84340,6,2,294954,294954,294956,0,2,3
84341,4,3,294958,294958,294961,0,3,2
84342,4,3,294962,294962,294965,0,3,1
84343,5,3,294967,294967,294970,0,3,2
84344,4,3,294971,294971,294974,0,3,1
84345,1,3,294972,294974,294977,2,5,0
84346,4,2,294976,294977,294979,1,3,0
84347,4,1,294980,294980,294981,0,1,1
84348,4,3,294984,294984,294987,0,3,3
84349,1,2,294985,294987,294989,2,4,0
84350,6,2,294991,294991,294993,0,2,2
84351,1,2,294992,294993,294995,1,3,0
84352,2,3,294994,294995,294998,1,4,0
84353,5,2,294999,294999,295001,0,2,1
84354,4,3,295003,295003,295006,0,3,2
84355,6,2,295009,295009,295011,0,2,3
84356,5,3,295014,295014,295017,0,3,3
84357,3,3,295017,295017,295020,0,3,0
84358,2,2,295019,295020,295022,1,3,0
84359,3,2,295022,295022,295024,0,2,0
84360,5,2,295027,295027,295029,0,2,3
84361,1,2,295028,295029,295031,1,3,0
84362,3,1,295031,295031,295032,0,1,0
84363,5,1,295036,295036,295037,0,1,4
84364,6,2,295042,295042,295044,0,2,5
84365,2,2,295044,295044,295046,0,2,0
84366,3,1,295047,295047,295048,0,1,1
84367,4,1,295051,295051,295052,0,1,3
84368,6,3,295057,295057,295060,0,3,5
84369,4,1,295061,295061,295062,0,1,1
84370,4,2,295065,295065,295067,0,2,3
84371,1,2,295066,295067,295069,1,3,0
84372,1,1,295067,295069,295070,2,3,0
84373,4,1,295071,295071,295072,0,1,1
84374,4,2,295075,295075,295077,0,2,3
84375,4,2,295079,295079,295081,0,2,2
84376,1,1,295080,295081,295082,1,2,0
84377,4,1,295084,295084,295085,0,1,2
84378,1,2,295085,295085,295087,0,2,0
84379,6,1,295091,295091,295092,0,1,4
84380,2,3,295093,295093,295096,0,3,1
84381,3,2,295096,295096,295098,0,2,0
84382,5,1,295101,295101,295102,0,1,3
84383,2,2,295103,295103,295105,0,2,1
84384,1,2,295104,295105,295107,1,3,0
84385,2,3,295106,295107,295110,1,4,0
84386,1,1,295107,295110,295111,3,4,0
84387,3,1,295110,295111,295112,1,2,0
84388,3,2,295113,295113,295115,0,2,1
84389,4,2,295117,295117,295119,0,2,2
84390,1,3,295118,295119,295122,1,4,0
84391,3,3,295121,295122,295125,1,4,0
84392,4,3,295125,295125,295128,0,3,0
84393,1,3,295126,295128,295131,2,5,0
84394,3,1,295129,295131,295132,2,3,0
84395,4,1,295133,295133,295134,0,1,1
84396,2,2,295135,295135,295137,0,2,1
84397,6,1,295141,295141,295142,0,1,4
84398,6,3,295147,295147,295150,0,3,5
84399,5,3,295152,295152,295155,0,3,2
84400,5,1,295157,295157,295158,0,1,2
84401,1,2,295158,295158,295160,0,2,0
84402,1,1,295159,295160,295161,1,2,0
84403,5,3,295164,295164,295167,0,3,3
84404,1,2,295165,295167,295169,2,4,0
84405,4,2,295169,295169,295171,0,2,0
84406,2,1,295171,295171,295172,0,1,0
84407,5,1,295176,295176,295177,0,1,4
84408,1,2,295177,295177,295179,0,2,0
84409,2,1,295179,295179,295180,0,1,0
84410,2,2,295181,295181,295183,0,2,1
84411,2,1,295183,295183,295184,0,1,0
84412,6,2,295189,295189,295191,0,2,5
84413,1,1,295190,295191,295192,1,2,0
84414,1,2,295191,295192,295194,1,3,0
84415,1,2,295192,295194,295196,2,4,0
84416,5,2,295197,295197,295199,0,2,1
84417,5,1,295202,295202,295203,0,1,3
84418,1,2,295203,295203,295205,0,2,0
84419,1,1,295204,295205,295206,1,2,0
84420,2,2,295206,295206,295208,0,2,0
84421,1,2,295207,295208,295210,1,3,0
84422,2,1,295209,295210,295211,1,2,0
84423,3,2,295212,295212,295214,0,2,1
84424,1,1,295213,295214,295215,1,2,0
84425,2,3,295215,295215,295218,0,3,0
84426,3,3,295218,295218,295221,0,3,0
84427,5,2,295223,295223,295225,0,2,2
84428,5,2,295228,295228,295230,0,2,3
84429,2,2,295230,295230,295232,0,2,0
84430,3,2,295233,295233,295235,0,2,1
84431,1,1,295234,295235,295236,1,2,0
84432,5,1,295239,295239,295240,0,1,3
84433,3,2,295242,295242,295244,0,2,2
84434,1,3,295243,295244,295247,1,4,0
84435,1,2,295244,295247,295249,3,5,0
84436,1,1,295245,295249,295250,4,5,0
84437,6,2,295251,295251,295253,0,2,1
84438,5,2,295256,295256,295258,0,2,3
84439,1,3,295257,295258,295261,1,4,0
84440,1,2,295258,295261,295263,3,5,0
84441,6,3,295264,295264,295267,0,3,1
84442,6,3,295270,295270,295273,0,3,3
84443,3,2,295273,295273,295275,0,2,0
84444,6,1,295279,295279,295280,0,1,4
84445,5,2,295284,295284,295286,0,2,4
84446,5,2,295289,295289,295291,0,2,3
84447,6,2,295295,295295,295297,0,2,4
84448,2,1,295297,295297,295298,0,1,0
84449,3,1,295300,295300,295301,0,1,2
84450,4,2,295304,295304,295306,0,2,3
84451,3,1,295307,295307,295308,0,1,1
84452,6,1,295313,295313,295314,0,1,5
84453,6,3,295319,295319,295322,0,3,5
84454,1,2,295320,295322,295324,2,4,0
84455,5,3,295325,295325,295328,0,3,1
84456,5,2,295330,295330,295332,0,2,2
84457,6,3,295336,295336,295339,0,3,4
84458,4,3,295340,295340,295343,0,3,1
84459,4,1,295344,295344,295345,0,1,1
84460,3,2,295347,295347,295349,0,2,2
84461,1,2,295348,295349,295351,1,3,0
84462,3,2,295351,295351,295353,0,2,0
84463,2,2,295353,295353,295355,0,2,0
84464,6,2,295359,295359,295361,0,2,4
84465,6,2,295365,295365,295367,0,2,4
84466,4,3,295369,295369,295372,0,3,2
84467,6,1,295375,295375,295376,0,1,3
84468,6,1,295381,295381,295382,0,1,5
84469,6,1,295387,295387,295388,0,1,5
84470,4,3,295391,295391,295394,0,3,3
84471,3,1,295394,295394,295395,0,1,0
84472,3,3,295397,295397,295400,0,3,2
84473,5,3,295402,295402,295405,0,3,2
84474,1,1,295403,295405,295406,2,3,0
84475,3,3,295406,295406,295409,0,3,0
84476,6,1,295412,295412,295413,0,1,3
84477,2,1,295414,295414,295415,0,1,1
84478,3,2,295417,295417,295419,0,2,2
84479,3,2,295420,295420,295422,0,2,1
84480,5,2,295425,295425,295427,0,2,3
84481,5,1,295430,295430,295431,0,1,3
84482,1,1,295431,295431,295432,0,1,0
84483,3,3,295434,295434,295437,0,3,2
84484,2,2,295436,295437,295439,1,3,0
84485,5,3,295441,295441,295444,0,3,2
84486,1,2,295442,295444,295446,2,4,0
84487,1,2,295443,295446,295448,3,5,0
84488,2,3,295445,295448,295451,3,6,0
84489,6,2,295451,295451,295453,0,2,0
84490,5,1,295456,295456,295457,0,1,3
84491,5,1,295461,295461,295462,0,1,4
84492,1,1,295462,295462,295463,0,1,0
84493,3,1,295465,295465,295466,0,1,2
84494,1,3,295466,295466,295469,0,3,0
84495,5,3,295471,295471,295474,0,3,2
84496,6,1,295477,295477,295478,0,1,3
84497,6,1,295483,295483,295484,0,1,5
84498,4,2,295487,295487,295489,0,2,3
84499,5,2,295492,295492,295494,0,2,3
84500,5,2,295497,295497,295499,0,2,3
84501,2,1,295499,295499,295500,0,1,0
84502,6,3,295505,295505,295508,0,3,5
84503,5,1,295510,295510,295511,0,1,2
84504,4,1,295514,295514,295515,0,1,3
84505,4,1,295518,295518,295519,0,1,3
84506,1,1,295519,295519,295520,0,1,0
84507,6,2,295525,295525,295527,0,2,5
84508,4,2,295529,295529,295531,0,2,2
84509,4,3,295533,295533,295536,0,3,2
84510,1,1,295534,295536,295537,2,3,0
84511,6,1,295540,295540,295541,0,1,3
84512,2,2,295542,295542,295544,0,2,1
84513,2,1,295544,295544,295545,0,1,0
84514,3,1,295547,295547,295548,0,1,2
84515,1,1,295548,295548,295549,0,1,0
84516,2,2,295550,295550,295552,0,2,1
84517,4,3,295554,295554,295557,0,3,2
84518,6,3,295560,295560,295563,0,3,3
84519,2,3,295562,295563,295566,1,4,0
84520,3,3,295565,295566,295569,1,4,0
84521,6,1,295571,295571,295572,0,1,2
84522,6,2,295577,295577,295579,0,2,5
84523,2,3,295579,295579,295582,0,3,0
84524,6,1,295585,295585,295586,0,1,3
84525,5,2,295590,295590,295592,0,2,4
84526,3,3,295593,295593,295596,0,3,1
84527,4,1,295597,295597,295598,0,1,1
84528,4,1,295601,295601,295602,0,1,3
84529,6,1,295607,295607,295608,0,1,5
84530,2,2,295609,295609,295611,0,2,1
84531,6,1,295615,295615,295616,0,1,4
84532,6,3,295621,295621,295624,0,3,5
84533,4,2,295625,295625,295627,0,2,1
84534,6,1,295631,295631,295632,0,1,4
84535,3,1,295634,295634,295635,0,1,2
84536,3,2,295637,295637,295639,0,2,2
84537,1,3,295638,295639,295642,1,4,0
84538,2,2,295640,295642,295644,2,4,0
84539,1,2,295641,295644,295646,3,5,0
84540,5,1,295646,295646,295647,0,1,0
84541,2,1,295648,295648,295649,0,1,1
84542,3,1,295651,295651,295652,0,1,2
84543,3,3,295654,295654,295657,0,3,2
84544,6,2,295660,295660,295662,0,2,3
84545,6,1,295666,295666,295667,0,1,4
84546,6,3,295672,295672,295675,0,3,5
84547,6,2,295678,295678,295680,0,2,3
84548,4,2,295682,295682,295684,0,2,2
84549,4,2,295686,295686,295688,0,2,2
84550,5,2,295691,295691,295693,0,2,3
84551,2,3,295693,295693,295696,0,3,0
84552,1,1,295694,295696,295697,2,3,0
84553,2,1,295696,295697,295698,1,2,0
84554,2,2,295698,295698,295700,0,2,0
84555,6,2,295704,295704,295706,0,2,4
84556,5,3,295709,295709,295712,0,3,3
84557,2,3,295711,295712,295715,1,4,0
84558,3,3,295714,295715,295718,1,4,0
84559,3,3,295717,295718,295721,1,4,0
84560,3,2,295720,295721,295723,1,3,0
84561,3,1,295723,295723,295724,0,1,0
84562,3,3,295726,295726,295729,0,3,2
84563,3,1,295729,295729,295730,0,1,0
84564,3,1,295732,295732,295733,0,1,2
84565,4,3,295736,295736,295739,0,3,3
84566,5,2,295741,295741,295743,0,2,2
84567,6,2,295747,295747,295749,0,2,4
84568,2,2,295749,295749,295751,0,2,0
84569,2,1,295751,295751,295752,0,1,0
84570,5,2,295756,295756,295758,0,2,4
84571,1,3,295757,295758,295761,1,4,0
84572,6,1,295763,295763,295764,0,1,2
84573,6,1,295769,295769,295770,0,1,5
84574,6,3,295775,295775,295778,0,3,5
84575,2,3,295777,295778,295781,1,4,0
84576,1,3,295778,295781,295784,3,6,0
84577,6,2,295784,295784,295786,0,2,0
84578,1,1,295785,295786,295787,1,2,0
84579,4,2,295789,295789,295791,0,2,2
84580,1,1,295790,295791,295792,1,2,0
84581,5,1,295795,295795,295796,0,1,3
84582,3,3,295798,295798,295801,0,3,2
84583,2,2,295800,295801,295803,1,3,0
84584,5,1,295805,295805,295806,0,1,2
84585,5,2,295810,295810,295812,0,2,4
84586,1,1,295811,295812,295813,1,2,0
84587,4,1,295815,295815,295816,0,1,2
84588,1,2,295816,295816,295818,0,2,0
84589,6,3,295822,295822,295825,0,3,4
84590,5,2,295827,295827,295829,0,2,2
84591,4,2,295831,295831,295833,0,2,2
84592,2,1,295833,295833,295834,0,1,0
84593,2,3,295835,295835,295838,0,3,1
84594,6,2,295841,295841,295843,0,2,3
84595,3,3,295844,295844,295847,0,3,1
84596,5,1,295849,295849,295850,0,1,2
84597,6,3,295855,295855,295858,0,3,5
84598,4,3,295859,295859,295862,0,3,1
84599,5,1,295864,295864,295865,0,1,2
84600,4,3,295868,295868,295871,0,3,3
84601,6,1,295874,295874,295875,0,1,3
84602,4,1,295878,295878,295879,0,1,3
84603,5,1,295883,295883,295884,0,1,4
84604,4,2,295887,295887,295889,0,2,3
84605,4,2,295891,295891,295893,0,2,2
84606,5,1,295896,295896,295897,0,1,3
84607,6,1,295902,295902,295903,0,1,5
84608,3,3,295905,295905,295908,0,3,2
84609,6,2,295911,295911,295913,0,2,3
84610,1,2,295912,295913,295915,1,3,0
84611,5,3,295917,295917,295920,0,3,2
84612,6,1,295923,295923,295924,0,1,3
84613,3,1,295926,295926,295927,0,1,2
84614,5,1,295931,295931,295932,0,1,4
84615,2,3,295933,295933,295936,0,3,1
84616,2,2,295935,295936,295938,1,3,0
84617,3,2,295938,295938,295940,0,2,0
84618,2,2,295940,295940,295942,0,2,0
84619,4,1,295944,295944,295945,0,1,2
84620,5,2,295949,295949,295951,0,2,4
84621,3,2,295952,295952,295954,0,2,1
84622,3,2,295955,295955,295957,0,2,1
84623,5,1,295960,295960,295961,0,1,3
84624,1,1,295961,295961,295962,0,1,0
84625,6,1,295967,295967,295968,0,1,5
84626,1,3,295968,295968,295971,0,3,0
84627,5,3,295973,295973,295976,0,3,2
84628,5,1,295978,295978,295979,0,1,2
84629,5,2,295983,295983,295985,0,2,4
84630,6,1,295989,295989,295990,0,1,4
84631,1,1,295990,295990,295991,0,1,0
84632,1,2,295991,295991,295993,0,2,0
84633,2,1,295993,295993,295994,0,1,0
84634,2,3,295995,295995,295998,0,3,1
84635,4,3,295999,295999,296002,0,3,1
84636,1,1,296000,296002,296003,2,3,0
84637,3,3,296003,296003,296006,0,3,0
84638,3,1,296006,296006,296007,0,1,0
84639,6,3,296012,296012,296015,0,3,5
84640,1,2,296013,296015,296017,2,4,0
84641,3,2,296016,296017,296019,1,3,0
84642,6,2,296022,296022,296024,0,2,3
84643,6,1,296028,296028,296029,0,1,4
84644,2,2,296030,296030,296032,0,2,1
84645,2,1,296032,296032,296033,0,1,0
84646,2,2,296034,296034,296036,0,2,1
84647,1,1,296035,296036,296037,1,2,0
84648,5,3,296040,296040,296043,0,3,3
84649,2,2,296042,296043,296045,1,3,0
84650,2,3,296044,296045,296048,1,4,0
84651,5,2,296049,296049,296051,0,2,1
84652,3,3,296052,296052,296055,0,3,1
84653,2,3,296054,296055,296058,1,4,0
84654,4,3,296058,296058,296061,0,3,0
84655,3,1,296061,296061,296062,0,1,0
84656,4,1,296065,296065,296066,0,1,3
84657,1,3,296066,296066,296069,0,3,0
84658,1,1,296067,296069,296070,2,3,0
84659,6,1,296073,296073,296074,0,1,3
84660,3,2,296076,296076,296078,0,2,2
84661,6,2,296082,296082,296084,0,2,4
84662,4,3,296086,296086,296089,0,3,2
84663,5,1,296091,296091,296092,0,1,2
84664,5,3,296096,296096,296099,0,3,4
84665,5,2,296101,296101,296103,0,2,2
84666,1,1,296102,296103,296104,1,2,0
84667,2,2,296104,296104,296106,0,2,0
84668,6,1,296110,296110,296111,0,1,4
84669,6,3,296116,296116,296119,0,3,5
84670,1,1,296117,296119,296120,2,3,0
84671,1,1,296118,296120,296121,2,3,0
84672,1,1,296119,296121,296122,2,3,0
84673,3,2,296122,296122,296124,0,2,0
84674,2,2,296124,296124,296126,0,2,0
84675,2,1,296126,296126,296127,0,1,0
84676,6,2,296132,296132,296134,0,2,5
84677,2,1,296134,296134,296135,0,1,0
84678,5,2,296139,296139,296141,0,2,4
84679,5,3,296144,296144,296147,0,3,3
84680,4,1,296148,296148,296149,0,1,1
84681,3,2,296151,296151,296153,0,2,2
84682,6,2,296157,296157,296159,0,2,4
84683,3,1,296160,296160,296161,0,1,1
84684,2,1,296162,296162,296163,0,1,1
84685,5,3,296167,296167,296170,0,3,4
84686,5,1,296172,296172,296173,0,1,2
84687,1,2,296173,296173,296175,0,2,0
84688,2,1,296175,296175,296176,0,1,0
84689,5,3,296180,296180,296183,0,3,4
84690,3,1,296183,296183,296184,0,1,0
84691,3,1,296186,296186,296187,0,1,2
84692,1,3,296187,296187,296190,0,3,0
84693,3,2,296190,296190,296192,0,2,0
84694,3,2,296193,296193,296195,0,2,1
84695,6,2,296199,296199,296201,0,2,4
84696,2,2,296201,296201,296203,0,2,0
84697,1,1,296202,296203,296204,1,2,0
84698,5,1,296207,296207,296208,0,1,3
84699,5,1,296212,296212,296213,0,1,4
84700,4,1,296216,296216,296217,0,1,3
84701,5,1,296221,296221,296222,0,1,4
84702,2,3,296223,296223,296226,0,3,1
84703,2,2,296225,296226,296228,1,3,0
84704,2,2,296227,296228,296230,1,3,0
84705,2,3,296229,296230,296233,1,4,0
84706,6,1,296235,296235,296236,0,1,2
84707,2,2,296237,296237,296239,0,2,1
84708,4,3,296241,296241,296244,0,3,2
84709,5,3,296246,296246,296249,0,3,2
84710,1,1,296247,296249,296250,2,3,0
84711,2,2,296249,296250,296252,1,3,0
84712,3,2,296252,296252,296254,0,2,0
84713,4,1,296256,296256,296257,0,1,2
84714,1,1,296257,296257,296258,0,1,0
84715,2,3,296259,296259,296262,0,3,1
84716,5,3,296264,296264,296267,0,3,2
84717,5,1,296269,296269,296270,0,1,2
84718,5,2,296274,296274,296276,0,2,4
84719,2,3,296276,296276,296279,0,3,0
84720,2,3,296278,296279,296282,1,4,0
84721,6,2,296284,296284,296286,0,2,2
84722,5,3,296289,296289,296292,0,3,3
84723,2,2,296291,296292,296294,1,3,0
84724,4,3,296295,296295,296298,0,3,1
84725,4,3,296299,296299,296302,0,3,1
84726,2,3,296301,296302,296305,1,4,0
84727,6,3,296307,296307,296310,0,3,2
84728,3,3,296310,296310,296313,0,3,0
84729,5,1,296315,296315,296316,0,1,2
84730,4,3,296319,296319,296322,0,3,3
84731,1,2,296320,296322,296324,2,4,0
84732,4,3,296324,296324,296327,0,3,0
84733,5,1,296329,296329,296330,0,1,2
84734,2,3,296331,296331,296334,0,3,1
84735,6,3,296337,296337,296340,0,3,3
84736,4,1,296341,296341,296342,0,1,1
84737,4,1,296345,296345,296346,0,1,3
84738,5,2,296350,296350,296352,0,2,4
84739,6,3,296356,296356,296359,0,3,4
84740,3,2,296359,296359,296361,0,2,0
84741,3,3,296362,296362,296365,0,3,1
84742,3,1,296365,296365,296366,0,1,0
84743,4,2,296369,296369,296371,0,2,3
84744,1,3,296370,296371,296374,1,4,0
84745,4,2,296374,296374,296376,0,2,0
84746,3,1,296377,296377,296378,0,1,1
84747,6,1,296383,296383,296384,0,1,5
84748,6,1,296389,296389,296390,0,1,5
84749,3,3,296392,296392,296395,0,3,2
84750,2,1,296394,296395,296396,1,2,0
84751,5,2,296399,296399,296401,0,2,3
84752,4,3,296403,296403,296406,0,3,2
84753,1,1,296404,296406,296407,2,3,0
84754,1,2,296405,296407,296409,2,4,0
84755,6,3,296411,296411,296414,0,3,2
84756,2,1,296413,296414,296415,1,2,0
84757,2,1,296415,296415,296416,0,1,0
84758,5,2,296420,296420,296422,0,2,4
84759,3,2,296423,296423,296425,0,2,1
84760,5,2,296428,296428,296430,0,2,3
84761,2,3,296430,296430,296433,0,3,0
84762,1,3,296431,296433,296436,2,5,0
84763,5,1,296436,296436,296437,0,1,0
84764,3,2,296439,296439,296441,0,2,2
84765,4,3,296443,296443,296446,0,3,2
84766,5,1,296448,296448,296449,0,1,2
84767,4,2,296452,296452,296454,0,2,3
84768,1,1,296453,296454,296455,1,2,0
84769,6,2,296459,296459,296461,0,2,4
84770,2,2,296461,296461,296463,0,2,0
84771,3,2,296464,296464,296466,0,2,1
84772,4,1,296468,296468,296469,0,1,2
84773,4,3,296472,296472,296475,0,3,3
84774,3,1,296475,296475,296476,0,1,0
84775,1,2,296476,296476,296478,0,2,0
84776,3,2,296479,296479,296481,0,2,1
84777,2,2,296481,296481,296483,0,2,0
84778,1,2,296482,296483,296485,1,3,0
84779,2,2,296484,296485,296487,1,3,0
84780,6,3,296490,296490,296493,0,3,3
84781,5,2,296495,296495,296497,0,2,2
84782,5,1,296500,296500,296501,0,1,3
84783,6,1,296506,296506,296507,0,1,5
84784,1,3,296507,296507,296510,0,3,0
84785,3,2,296510,296510,296512,0,2,0
84786,5,3,296515,296515,296518,0,3,3
84787,3,2,296518,296518,296520,0,2,0
84788,5,3,296523,296523,296526,0,3,3
84789,3,3,296526,296526,296529,0,3,0
84790,2,3,296528,296529,296532,1,4,0
84791,6,1,296534,296534,296535,0,1,2
84792,3,3,296537,296537,296540,0,3,2
84793,3,2,296540,296540,296542,0,2,0
84794,5,2,296545,296545,296547,0,2,3
84795,5,2,296550,296550,296552,0,2,3
84796,3,2,296553,296553,296555,0,2,1
84797,6,2,296559,296559,296561,0,2,4
84798,4,1,296563,296563,296564,0,1,2
84799,4,1,296567,296567,296568,0,1,3
84800,1,1,296568,296568,296569,0,1,0
84801,2,1,296570,296570,296571,0,1,1
84802,3,3,296573,296573,296576,0,3,2
84803,1,1,296574,296576,296577,2,3,0
84804,3,2,296577,296577,296579,0,2,0
84805,5,3,296582,296582,296585,0,3,3
84806,1,3,296583,296585,296588,2,5,0
84807,5,1,296588,296588,296589,0,1,0
84808,3,2,296591,296591,296593,0,2,2
84809,6,1,296597,296597,296598,0,1,4
84810,5,3,296602,296602,296605,0,3,4
84811,6,3,296608,296608,296611,0,3,3
84812,1,2,296609,296611,296613,2,4,0
84813,4,3,296613,296613,296616,0,3,0
84814,5,2,296618,296618,296620,0,2,2
84815,1,2,296619,296620,296622,1,3,0
84816,5,2,296624,296624,296626,0,2,2
84817,3,2,296627,296627,296629,0,2,1
84818,3,2,296630,296630,296632,0,2,1
84819,3,2,296633,296633,296635,0,2,1
84820,4,3,296637,296637,296640,0,3,2
84821,5,1,296642,296642,296643,0,1,2
84822,5,2,296647,296647,296649,0,2,4
84823,4,1,296651,296651,296652,0,1,2
84824,6,2,296657,296657,296659,0,2,5
84825,1,1,296658,296659,296660,1,2,0
84826,1,1,296659,296660,296661,1,2,0
84827,3,3,296662,296662,296665,0,3,1
84828,4,3,296666,296666,296669,0,3,1
84829,2,3,296668,296669,296672,1,4,0
84830,6,2,296674,296674,296676,0,2,2
84831,4,1,296678,296678,296679,0,1,2
84832,2,2,296680,296680,296682,0,2,1
84833,1,1,296681,296682,296683,1,2,0
84834,6,3,296687,296687,296690,0,3,4
84835,6,2,296693,296693,296695,0,2,3
84836,2,2,296695,296695,296697,0,2,0
84837,6,1,296701,296701,296702,0,1,4
84838,4,3,296705,296705,296708,0,3,3
84839,1,1,296706,296708,296709,2,3,0
84840,1,3,296707,296709,296712,2,5,0
84841,5,1,296712,296712,296713,0,1,0
84842,1,1,296713,296713,296714,0,1,0
84843,5,1,296718,296718,296719,0,1,4
84844,3,1,296721,296721,296722,0,1,2
84845,6,3,296727,296727,296730,0,3,5
84846,3,2,296730,296730,296732,0,2,0
84847,2,1,296732,296732,296733,0,1,0
84848,6,2,296738,296738,296740,0,2,5
84849,2,2,296740,296740,296742,0,2,0
84850,5,1,296745,296745,296746,0,1,3
84851,5,1,296750,296750,296751,0,1,4
84852,2,3,296752,296752,296755,0,3,1
84853,5,3,296757,296757,296760,0,3,2
84854,3,2,296760,296760,296762,0,2,0
84855,2,1,296762,296762,296763,0,1,0
84856,2,3,296764,296764,296767,0,3,1
84857,4,2,296768,296768,296770,0,2,1
84858,4,1,296772,296772,296773,0,1,2
84859,2,1,296774,296774,296775,0,1,1
84860,1,2,296775,296775,296777,0,2,0
84861,5,3,296780,296780,296783,0,3,3
84862,3,1,296783,296783,296784,0,1,0
84863,1,2,296784,296784,296786,0,2,0
84864,2,2,296786,296786,296788,0,2,0
84865,2,1,296788,296788,296789,0,1,0
84866,4,1,296792,296792,296793,0,1,3
84867,5,2,296797,296797,296799,0,2,4
84868,6,2,296803,296803,296805,0,2,4
84869,1,3,296804,296805,296808,1,4,0
84870,5,2,296809,296809,296811,0,2,1
84871,4,3,296813,296813,296816,0,3,2
84872,6,1,296819,296819,296820,0,1,3
84873,6,2,296825,296825,296827,0,2,5
84874,1,1,296826,296827,296828,1,2,0
84875,5,1,296831,296831,296832,0,1,3
84876,2,2,296833,296833,296835,0,2,1
84877,2,1,296835,296835,296836,0,1,0
84878,5,2,296840,296840,296842,0,2,4
84879,6,2,296846,296846,296848,0,2,4
84880,3,2,296849,296849,296851,0,2,1
84881,4,3,296853,296853,296856,0,3,2
84882,4,1,296857,296857,296858,0,1,1
84883,4,2,296861,296861,296863,0,2,3
84884,2,3,296863,296863,296866,0,3,0
84885,5,2,296868,296868,296870,0,2,2
84886,6,2,296874,296874,296876,0,2,4
84887,3,1,296877,296877,296878,0,1,1
84888,1,3,296878,296878,296881,0,3,0
84889,5,2,296883,296883,296885,0,2,2
84890,3,3,296886,296886,296889,0,3,1
84891,1,3,296887,296889,296892,2,5,0
84892,4,2,296891,296892,296894,1,3,0
84893,1,2,296892,296894,296896,2,4,0
84894,3,3,296895,296896,296899,1,4,0
84895,4,1,296899,296899,296900,0,1,0
84896,4,1,296903,296903,296904,0,1,3
84897,1,3,296904,296904,296907,0,3,0
84898,6,3,296910,296910,296913,0,3,3
84899,2,3,296912,296913,296916,1,4,0
84900,6,1,296918,296918,296919,0,1,2
84901,4,3,296922,296922,296925,0,3,3
84902,2,3,296924,296925,296928,1,4,0
84903,3,1,296927,296928,296929,1,2,0
84904,2,2,296929,296929,296931,0,2,0
84905,1,3,296930,296931,296934,1,4,0
84906,1,1,296931,296934,296935,3,4,0
84907,5,2,296936,296936,296938,0,2,1
84908,3,1,296939,296939,296940,0,1,1
84909,6,2,296945,296945,296947,0,2,5
84910,2,1,296947,296947,296948,0,1,0
84911,4,3,296951,296951,296954,0,3,3
84912,4,2,296955,296955,296957,0,2,1
84913,3,2,296958,296958,296960,0,2,1
84914,2,2,296960,296960,296962,0,2,0
84915,3,1,296963,296963,296964,0,1,1
84916,4,3,296967,296967,296970,0,3,3
84917,4,2,296971,296971,296973,0,2,1
84918,5,1,296976,296976,296977,0,1,3
84919,3,1,296979,296979,296980,0,1,2
84920,5,1,296984,296984,296985,0,1,4
84921,2,2,296986,296986,296988,0,2,1
84922,6,3,296992,296992,296995,0,3,4
84923,2,2,296994,296995,296997,1,3,0
84924,5,3,296999,296999,297002,0,3,2
84925,5,3,297004,297004,297007,0,3,2
84926,4,1,297008,297008,297009,0,1,1
84927,5,1,297013,297013,297014,0,1,4
84928,3,3,297016,297016,297019,0,3,2
84929,4,2,297020,297020,297022,0,2,1
84930,5,3,297025,297025,297028,0,3,3
84931,3,3,297028,297028,297031,0,3,0
84932,3,3,297031,297031,297034,0,3,0
84933,5,1,297036,297036,297037,0,1,2
84934,6,3,297042,297042,297045,0,3,5
84935,6,3,297048,297048,297051,0,3,3
84936,6,3,297054,297054,297057,0,3,3
84937,1,2,297055,297057,297059,2,4,0
84938,3,3,297058,297059,297062,1,4,0
84939,6,1,297064,297064,297065,0,1,2
84940,1,1,297065,297065,297066,0,1,0
84941,6,2,297071,297071,297073,0,2,5
84942,1,3,297072,297073,297076,1,4,0
84943,1,3,297073,297076,297079,3,6,0
84944,1,1,297074,297079,297080,5,6,0
84945,4,1,297078,297080,297081,2,3,0
84946,3,3,297081,297081,297084,0,3,0
84947,5,2,297086,297086,297088,0,2,2
84948,2,1,297088,297088,297089,0,1,0
84949,1,3,297089,297089,297092,0,3,0
84950,5,1,297094,297094,297095,0,1,2
84951,6,1,297100,297100,297101,0,1,5
84952,3,3,297103,297103,297106,0,3,2
84953,5,2,297108,297108,297110,0,2,2
84954,1,3,297109,297110,297113,1,4,0
84955,3,3,297112,297113,297116,1,4,0
84956,5,1,297117,297117,297118,0,1,1
84957,1,3,297118,297118,297121,0,3,0
84958,1,1,297119,297121,297122,2,3,0
84959,1,3,297120,297122,297125,2,5,0
84960,4,1,297124,297125,297126,1,2,0
84961,4,1,297128,297128,297129,0,1,2
84962,5,3,297133,297133,297136,0,3,4
84963,4,1,297137,297137,297138,0,1,1
84964,3,1,297140,297140,297141,0,1,2
84965,4,2,297144,297144,297146,0,2,3
84966,2,3,297146,297146,297149,0,3,0
84967,5,1,297151,297151,297152,0,1,2
84968,1,1,297152,297152,297153,0,1,0
84969,6,2,297158,297158,297160,0,2,5
84970,5,2,297163,297163,297165,0,2,3
84971,3,1,297166,297166,297167,0,1,1
84972,2,3,297168,297168,297171,0,3,1
84973,2,3,297170,297171,297174,1,4,0
84974,3,2,297173,297174,297176,1,3,0
84975,4,2,297177,297177,297179,0,2,1
84976,5,3,297182,297182,297185,0,3,3
84977,1,2,297183,297185,297187,2,4,0
84978,3,2,297186,297187,297189,1,3,0
84979,1,1,297187,297189,297190,2,3,0
84980,4,2,297191,297191,297193,0,2,1
84981,6,3,297197,297197,297200,0,3,4
84982,5,3,297202,297202,297205,0,3,2
84983,1,1,297203,297205,297206,2,3,0
84984,4,1,297207,297207,297208,0,1,1
84985,4,1,297211,297211,297212,0,1,3
84986,1,1,297212,297212,297213,0,1,0
84987,2,1,297214,297214,297215,0,1,1
84988,4,1,297218,297218,297219,0,1,3
84989,3,2,297221,297221,297223,0,2,2
84990,5,2,297226,297226,297228,0,2,3
84991,3,3,297229,297229,297232,0,3,1
84992,5,3,297234,297234,297237,0,3,2
84993,4,1,297238,297238,297239,0,1,1
84994,3,1,297241,297241,297242,0,1,2
84995,2,1,297243,297243,297244,0,1,1
84996,6,2,297249,297249,297251,0,2,5
84997,4,2,297253,297253,297255,0,2,2
84998,5,1,297258,297258,297259,0,1,3
84999,4,2,297262,297262,297264,0,2,3
85000,1,1,297263,297264,297265,1,2,0
85001,4,3,297267,297267,297270,0,3,2
85002,2,1,297269,297270,297271,1,2,0
85003,1,2,297270,297271,297273,1,3,0
85004,4,2,297274,297274,297276,0,2,1
85005,3,3,297277,297277,297280,0,3,1
85006,6,2,297283,297283,297285,0,2,3
85007,6,1,297289,297289,297290,0,1,4
85008,1,1,297290,297290,297291,0,1,0
85009,4,2,297294,297294,297296,0,2,3
85010,4,1,297298,297298,297299,0,1,2
85011,4,2,297302,297302,297304,0,2,3
85012,1,1,297303,297304,297305,1,2,0
85013,4,2,297307,297307,297309,0,2,2
85014,5,2,297312,297312,297314,0,2,3
85015,5,3,297317,297317,297320,0,3,3
85016,6,2,297323,297323,297325,0,2,3
85017,6,1,297329,297329,297330,0,1,4
85018,5,2,297334,297334,297336,0,2,4
85019,5,3,297339,297339,297342,0,3,3
85020,3,1,297342,297342,297343,0,1,0
85021,4,1,297346,297346,297347,0,1,3
85022,2,1,297348,297348,297349,0,1,1
85023,1,3,297349,297349,297352,0,3,0
85024,2,2,297351,297352,297354,1,3,0
85025,6,2,297357,297357,297359,0,2,3
85026,3,3,297360,297360,297363,0,3,1
85027,3,1,297363,297363,297364,0,1,0
85028,5,1,297368,297368,297369,0,1,4
85029,3,3,297371,297371,297374,0,3,2
85030,4,1,297375,297375,297376,0,1,1
85031,5,3,297380,297380,297383,0,3,4
85032,5,3,297385,297385,297388,0,3,2
85033,3,3,297388,297388,297391,0,3,0
85034,3,1,297391,297391,297392,0,1,0
85035,1,3,297392,297392,297395,0,3,0
85036,2,1,297394,297395,297396,1,2,0
85037,4,2,297398,297398,297400,0,2,2
85038,1,1,297399,297400,297401,1,2,0
85039,4,3,297403,297403,297406,0,3,2
85040,6,3,297409,297409,297412,0,3,3
85041,2,2,297411,297412,297414,1,3,0
85042,3,3,297414,297414,297417,0,3,0
85043,4,2,297418,297418,297420,0,2,1
85044,2,3,297420,297420,297423,0,3,0
85045,2,2,297422,297423,297425,1,3,0
85046,1,2,297423,297425,297427,2,4,0
85047,3,2,297426,297427,297429,1,3,0
85048,4,3,297430,297430,297433,0,3,1
85049,3,2,297433,297433,297435,0,2,0
85050,6,2,297439,297439,297441,0,2,4
85051,3,1,297442,297442,297443,0,1,1
85052,5,1,297447,297447,297448,0,1,4
85053,2,3,297449,297449,297452,0,3,1
85054,2,2,297451,297452,297454,1,3,0
85055,3,1,297454,297454,297455,0,1,0
85056,3,1,297457,297457,297458,0,1,2
85057,2,2,297459,297459,297461,0,2,1
85058,5,2,297464,297464,297466,0,2,3
85059,3,2,297467,297467,297469,0,2,1
85060,3,2,297470,297470,297472,0,2,1
85061,1,3,297471,297472,297475,1,4,0
85062,2,2,297473,297475,297477,2,4,0
85063,1,1,297474,297477,297478,3,4,0
85064,2,3,297476,297478,297481,2,5,0
85065,1,3,297477,297481,297484,4,7,0
85066,1,1,297478,297484,297485,6,7,0
85067,2,1,297480,297485,297486,5,6,0
85068,1,3,297481,297486,297489,5,8,0
85069,5,3,297486,297489,297492,3,6,0
85070,4,1,297490,297492,297493,2,3,0
85071,4,2,297494,297494,297496,0,2,1
85072,5,3,297499,297499,297502,0,3,3
85073,3,1,297502,297502,297503,0,1,0
85074,3,3,297505,297505,297508,0,3,2
85075,3,2,297508,297508,297510,0,2,0
85076,1,3,297509,297510,297513,1,4,0
85077,6,2,297515,297515,297517,0,2,2
85078,3,1,297518,297518,297519,0,1,1
85079,6,3,297524,297524,297527,0,3,5
85080,3,1,297527,297527,297528,0,1,0
85081,3,1,297530,297530,297531,0,1,2
85082,4,3,297534,297534,297537,0,3,3
85083,3,3,297537,297537,297540,0,3,0
85084,5,1,297542,297542,297543,0,1,2
85085,1,2,297543,297543,297545,0,2,0
85086,1,3,297544,297545,297548,1,4,0
85087,3,1,297547,297548,297549,1,2,0
85088,6,3,297553,297553,297556,0,3,4
85089,5,1,297558,297558,297559,0,1,2
85090,4,3,297562,297562,297565,0,3,3
85091,6,3,297568,297568,297571,0,3,3
85092,5,2,297573,297573,297575,0,2,2
85093,6,2,297579,297579,297581,0,2,4
85094,1,1,297580,297581,297582,1,2,0
85095,1,1,297581,297582,297583,1,2,0
85096,5,1,297586,297586,297587,0,1,3
85097,1,2,297587,297587,297589,0,2,0
85098,3,3,297590,297590,297593,0,3,1
85099,1,3,297591,297593,297596,2,5,0
85100,5,1,297596,297596,297597,0,1,0
85101,2,2,297598,297598,297600,0,2,1
85102,1,2,297599,297600,297602,1,3,0
85103,6,1,297605,297605,297606,0,1,3
85104,6,2,297611,297611,297613,0,2,5
85105,2,2,297613,297613,297615,0,2,0
85106,4,2,297617,297617,297619,0,2,2
85107,3,3,297620,297620,297623,0,3,1
85108,6,3,297626,297626,297629,0,3,3
85109,1,1,297627,297629,297630,2,3,0
85110,2,3,297629,297630,297633,1,4,0
85111,5,3,297634,297634,297637,0,3,1
85112,6,3,297640,297640,297643,0,3,3
85113,4,1,297644,297644,297645,0,1,1
85114,3,3,297647,297647,297650,0,3,2
85115,6,2,297653,297653,297655,0,2,3
85116,1,1,297654,297655,297656,1,2,0
85117,5,2,297659,297659,297661,0,2,3
85118,5,1,297664,297664,297665,0,1,3
85119,2,3,297666,297666,297669,0,3,1
85120,2,2,297668,297669,297671,1,3,0
85121,3,3,297671,297671,297674,0,3,0
85122,5,3,297676,297676,297679,0,3,2
85123,4,3,297680,297680,297683,0,3,1
85124,2,2,297682,297683,297685,1,3,0
85125,1,1,297683,297685,297686,2,3,0
85126,6,1,297689,297689,297690,0,1,3
85127,3,1,297692,297692,297693,0,1,2
85128,4,2,297696,297696,297698,0,2,3
85129,6,2,297702,297702,297704,0,2,4
85130,5,1,297707,297707,297708,0,1,3
85131,5,2,297712,297712,297714,0,2,4
85132,1,2,297713,297714,297716,1,3,0
85133,4,2,297717,297717,297719,0,2,1
85134,4,1,297721,297721,297722,0,1,2
85135,2,3,297723,297723,297726,0,3,1
85136,3,1,297726,297726,297727,0,1,0
85137,2,3,297728,297728,297731,0,3,1
85138,4,2,297732,297732,297734,0,2,1
85139,5,2,297737,297737,297739,0,2,3
85140,3,3,297740,297740,297743,0,3,1
85141,3,3,297743,297743,297746,0,3,0
85142,5,3,297748,297748,297751,0,3,2
85143,5,2,297753,297753,297755,0,2,2
85144,4,2,297757,297757,297759,0,2,2
85145,3,2,297760,297760,297762,0,2,1
85146,5,3,297765,297765,297768,0,3,3
85147,6,1,297771,297771,297772,0,1,3
85148,4,3,297775,297775,297778,0,3,3
85149,5,1,297780,297780,297781,0,1,2
85150,5,3,297785,297785,297788,0,3,4
85151,5,2,297790,297790,297792,0,2,2
85152,1,3,297791,297792,297795,1,4,0
85153,4,3,297795,297795,297798,0,3,0
85154,5,1,297800,297800,297801,0,1,2
85155,5,3,297805,297805,297808,0,3,4
85156,2,3,297807,297808,297811,1,4,0
85157,6,2,297813,297813,297815,0,2,2
85158,4,1,297817,297817,297818,0,1,2
85159,3,2,297820,297820,297822,0,2,2
85160,6,3,297826,297826,297829,0,3,4
85161,6,1,297832,297832,297833,0,1,3
85162,6,2,297838,297838,297840,0,2,5
85163,6,3,297844,297844,297847,0,3,4
85164,5,1,297849,297849,297850,0,1,2
85165,1,3,297850,297850,297853,0,3,0
85166,2,2,297852,297853,297855,1,3,0
85167,6,3,297858,297858,297861,0,3,3
85168,5,2,297863,297863,297865,0,2,2
85169,4,3,297867,297867,297870,0,3,2
85170,2,2,297869,297870,297872,1,3,0
85171,3,3,297872,297872,297875,0,3,0
85172,6,2,297878,297878,297880,0,2,3
85173,5,2,297883,297883,297885,0,2,3
85174,6,2,297889,297889,297891,0,2,4
85175,3,3,297892,297892,297895,0,3,1
85176,4,2,297896,297896,297898,0,2,1
85177,1,1,297897,297898,297899,1,2,0
85178,6,1,297903,297903,297904,0,1,4
85179,1,3,297904,297904,297907,0,3,0
85180,3,2,297907,297907,297909,0,2,0
85181,5,2,297912,297912,297914,0,2,3
85182,3,2,297915,297915,297917,0,2,1
85183,4,1,297919,297919,297920,0,1,2
85184,3,3,297922,297922,297925,0,3,2
85185,3,1,297925,297925,297926,0,1,0
85186,3,2,297928,297928,297930,0,2,2
85187,4,1,297932,297932,297933,0,1,2
85188,1,1,297933,297933,297934,0,1,0
85189,5,1,297938,297938,297939,0,1,4
85190,1,1,297939,297939,297940,0,1,0
85191,2,3,297941,297941,297944,0,3,1
85192,5,2,297946,297946,297948,0,2,2
85193,4,1,297950,297950,297951,0,1,2
85194,6,2,297956,297956,297958,0,2,5
85195,5,3,297961,297961,297964,0,3,3
85196,4,2,297965,297965,297967,0,2,1
85197,1,2,297966,297967,297969,1,3,0
85198,3,1,297969,297969,297970,0,1,0
85199,2,2,297971,297971,297973,0,2,1
85200,5,2,297976,297976,297978,0,2,3
85201,6,3,297982,297982,297985,0,3,4
85202,4,3,297986,297986,297989,0,3,1
85203,5,2,297991,297991,297993,0,2,2
85204,2,1,297993,297993,297994,0,1,0
85205,4,1,297997,297997,297998,0,1,3
85206,2,2,297999,297999,298001,0,2,1
85207,3,3,298002,298002,298005,0,3,1
85208,2,3,298004,298005,298008,1,4,0
85209,2,3,298006,298008,298011,2,5,0
85210,5,1,298011,298011,298012,0,1,0
85211,6,2,298017,298017,298019,0,2,5
85212,6,1,298023,298023,298024,0,1,4
85213,4,2,298027,298027,298029,0,2,3
85214,1,2,298028,298029,298031,1,3,0
85215,6,3,298034,298034,298037,0,3,3
85216,3,3,298037,298037,298040,0,3,0
85217,6,1,298043,298043,298044,0,1,3
85218,1,3,298044,298044,298047,0,3,0
85219,2,1,298046,298047,298048,1,2,0
85220,5,3,298051,298051,298054,0,3,3
85221,4,2,298055,298055,298057,0,2,1
85222,6,2,298061,298061,298063,0,2,4
85223,2,3,298063,298063,298066,0,3,0
85224,6,1,298069,298069,298070,0,1,3
85225,3,2,298072,298072,298074,0,2,2
85226,1,1,298073,298074,298075,1,2,0
85227,2,2,298075,298075,298077,0,2,0
85228,2,2,298077,298077,298079,0,2,0
85229,5,3,298082,298082,298085,0,3,3
85230,1,1,298083,298085,298086,2,3,0
85231,2,1,298085,298086,298087,1,2,0
85232,1,1,298086,298087,298088,1,2,0
85233,2,1,298088,298088,298089,0,1,0
85234,6,3,298094,298094,298097,0,3,5
85235,4,3,298098,298098,298101,0,3,1
85236,6,3,298104,298104,298107,0,3,3
85237,1,2,298105,298107,298109,2,4,0
85238,3,3,298108,298109,298112,1,4,0
85239,5,3,298113,298113,298116,0,3,1
85240,5,3,298118,298118,298121,0,3,2
85241,5,1,298123,298123,298124,0,1,2
85242,6,3,298129,298129,298132,0,3,5
85243,4,2,298133,298133,298135,0,2,1
85244,1,1,298134,298135,298136,1,2,0
85245,3,3,298137,298137,298140,0,3,1
85246,1,2,298138,298140,298142,2,4,0
85247,5,1,298143,298143,298144,0,1,1
85248,2,1,298145,298145,298146,0,1,1
85249,4,3,298149,298149,298152,0,3,3
85250,2,3,298151,298152,298155,1,4,0
85251,6,1,298157,298157,298158,0,1,2
85252,5,1,298162,298162,298163,0,1,4
85253,1,3,298163,298163,298166,0,3,0
85254,1,3,298164,298166,298169,2,5,0
85255,5,3,298169,298169,298172,0,3,0
85256,2,1,298171,298172,298173,1,2,0
85257,1,2,298172,298173,298175,1,3,0
85258,3,3,298175,298175,298178,0,3,0
85259,5,2,298180,298180,298182,0,2,2
85260,3,3,298183,298183,298186,0,3,1
85261,6,3,298189,298189,298192,0,3,3
85262,3,1,298192,298192,298193,0,1,0
85263,2,2,298194,298194,298196,0,2,1
85264,4,2,298198,298198,298200,0,2,2
85265,3,3,298201,298201,298204,0,3,1
85266,5,1,298206,298206,298207,0,1,2
85267,1,3,298207,298207,298210,0,3,0
85268,2,3,298209,298210,298213,1,4,0
85269,3,3,298212,298213,298216,1,4,0
85270,6,3,298218,298218,298221,0,3,2
85271,2,3,298220,298221,298224,1,4,0
85272,6,1,298226,298226,298227,0,1,2
85273,6,2,298232,298232,298234,0,2,5
85274,1,3,298233,298234,298237,1,4,0
85275,5,2,298238,298238,298240,0,2,1
85276,1,1,298239,298240,298241,1,2,0
85277,4,3,298243,298243,298246,0,3,2
85278,5,2,298248,298248,298250,0,2,2
85279,1,2,298249,298250,298252,1,3,0
85280,3,3,298252,298252,298255,0,3,0
85281,4,2,298256,298256,298258,0,2,1
85282,6,3,298262,298262,298265,0,3,4
85283,1,3,298263,298265,298268,2,5,0
85284,4,2,298267,298268,298270,1,3,0
85285,1,2,298268,298270,298272,2,4,0
85286,2,3,298270,298272,298275,2,5,0
85287,1,2,298271,298275,298277,4,6,0
85288,1,2,298272,298277,298279,5,7,0
85289,3,1,298275,298279,298280,4,5,0
85290,3,3,298278,298280,298283,2,5,0
85291,5,1,298283,298283,298284,0,1,0
85292,4,2,298287,298287,298289,0,2,3
85293,5,1,298292,298292,298293,0,1,3
85294,2,2,298294,298294,298296,0,2,1
85295,3,1,298297,298297,298298,0,1,1
85296,2,2,298299,298299,298301,0,2,1
85297,5,2,298304,298304,298306,0,2,3
85298,4,2,298308,298308,298310,0,2,2
85299,3,1,298311,298311,298312,0,1,1
85300,2,1,298313,298313,298314,0,1,1
85301,4,2,298317,298317,298319,0,2,3
85302,5,3,298322,298322,298325,0,3,3
85303,6,3,298328,298328,298331,0,3,3
85304,1,1,298329,298331,298332,2,3,0
85305,3,3,298332,298332,298335,0,3,0
85306,3,1,298335,298335,298336,0,1,0
85307,2,1,298337,298337,298338,0,1,1
85308,2,2,298339,298339,298341,0,2,1
85309,3,1,298342,298342,298343,0,1,1
85310,2,2,298344,298344,298346,0,2,1
85311,5,3,298349,298349,298352,0,3,3
85312,2,2,298351,298352,298354,1,3,0
85313,2,1,298353,298354,298355,1,2,0
85314,2,2,298355,298355,298357,0,2,0
85315,6,3,298361,298361,298364,0,3,4
85316,3,2,298364,298364,298366,0,2,0
85317,6,2,298370,298370,298372,0,2,4
85318,6,1,298376,298376,298377,0,1,4
85319,4,1,298380,298380,298381,0,1,3
85320,1,3,298381,298381,298384,0,3,0
85321,2,2,298383,298384,298386,1,3,0
85322,6,2,298389,298389,298391,0,2,3
85323,6,2,298395,298395,298397,0,2,4
85324,4,3,298399,298399,298402,0,3,2
85325,3,2,298402,298402,298404,0,2,0
85326,4,1,298406,298406,298407,0,1,2
85327,3,2,298409,298409,298411,0,2,2
85328,5,1,298414,298414,298415,0,1,3
85329,4,3,298418,298418,298421,0,3,3
85330,5,2,298423,298423,298425,0,2,2
85331,6,3,298429,298429,298432,0,3,4
85332,2,1,298431,298432,298433,1,2,0
85333,2,3,298433,298433,298436,0,3,0
85334,2,1,298435,298436,298437,1,2,0
85335,4,2,298439,298439,298441,0,2,2
85336,5,2,298444,298444,298446,0,2,3
85337,5,2,298449,298449,298451,0,2,3
85338,1,3,298450,298451,298454,1,4,0
85339,4,2,298454,298454,298456,0,2,0
85340,5,3,298459,298459,298462,0,3,3
85341,1,3,298460,298462,298465,2,5,0
85342,5,1,298465,298465,298466,0,1,0
85343,3,2,298468,298468,298470,0,2,2
85344,4,2,298472,298472,298474,0,2,2
85345,6,3,298478,298478,298481,0,3,4
85346,1,3,298479,298481,298484,2,5,0
85347,3,2,298482,298484,298486,2,4,0
85348,1,3,298483,298486,298489,3,6,0
85349,1,3,298484,298489,298492,5,8,0
85350,1,1,298485,298492,298493,7,8,0
85351,6,2,298491,298493,298495,2,4,0
85352,4,1,298495,298495,298496,0,1,0
85353,3,2,298498,298498,298500,0,2,2
85354,5,3,298503,298503,298506,0,3,3
85355,2,2,298505,298506,298508,1,3,0
85356,2,1,298507,298508,298509,1,2,0
85357,5,3,298512,298512,298515,0,3,3
85358,5,1,298517,298517,298518,0,1,2
85359,3,1,298520,298520,298521,0,1,2
85360,6,3,298526,298526,298529,0,3,5
85361,3,2,298529,298529,298531,0,2,0
85362,4,2,298533,298533,298535,0,2,2
85363,6,3,298539,298539,298542,0,3,4
85364,2,3,298541,298542,298545,1,4,0
85365,2,1,298543,298545,298546,2,3,0
85366,5,3,298548,298548,298551,0,3,2
85367,5,2,298553,298553,298555,0,2,2
85368,4,1,298557,298557,298558,0,1,2
85369,5,1,298562,298562,298563,0,1,4
85370,2,3,298564,298564,298567,0,3,1
85371,5,2,298569,298569,298571,0,2,2
85372,3,2,298572,298572,298574,0,2,1
85373,5,1,298577,298577,298578,0,1,3
85374,5,2,298582,298582,298584,0,2,4
85375,5,1,298587,298587,298588,0,1,3
85376,3,2,298590,298590,298592,0,2,2
85377,5,1,298595,298595,298596,0,1,3
85378,1,3,298596,298596,298599,0,3,0
85379,3,1,298599,298599,298600,0,1,0
85380,6,1,298605,298605,298606,0,1,5
85381,5,3,298610,298610,298613,0,3,4
85382,5,3,298615,298615,298618,0,3,2
85383,5,1,298620,298620,298621,0,1,2
85384,2,3,298622,298622,298625,0,3,1
85385,1,2,298623,298625,298627,2,4,0
85386,1,2,298624,298627,298629,3,5,0
85387,4,2,298628,298629,298631,1,3,0
85388,4,3,298632,298632,298635,0,3,1
85389,5,2,298637,298637,298639,0,2,2
85390,1,3,298638,298639,298642,1,4,0
85391,3,3,298641,298642,298645,1,4,0
85392,3,1,298644,298645,298646,1,2,0
85393,4,1,298648,298648,298649,0,1,2
85394,5,1,298653,298653,298654,0,1,4
85395,5,3,298658,298658,298661,0,3,4
85396,4,1,298662,298662,298663,0,1,1
85397,6,2,298668,298668,298670,0,2,5
85398,5,1,298673,298673,298674,0,1,3
85399,1,1,298674,298674,298675,0,1,0
85400,5,2,298679,298679,298681,0,2,4
85401,2,3,298681,298681,298684,0,3,0
85402,4,1,298685,298685,298686,0,1,1
85403,5,3,298690,298690,298693,0,3,4
85404,4,2,298694,298694,298696,0,2,1
85405,6,2,298700,298700,298702,0,2,4
85406,4,2,298704,298704,298706,0,2,2
85407,5,3,298709,298709,298712,0,3,3
85408,3,3,298712,298712,298715,0,3,0
85409,1,3,298713,298715,298718,2,5,0
85410,4,3,298717,298718,298721,1,4,0
85411,3,3,298720,298721,298724,1,4,0
85412,6,2,298726,298726,298728,0,2,2
85413,5,1,298731,298731,298732,0,1,3
85414,3,1,298734,298734,298735,0,1,2
85415,5,1,298739,298739,298740,0,1,4
85416,2,2,298741,298741,298743,0,2,1
85417,1,1,298742,298743,298744,1,2,0
85418,3,1,298745,298745,298746,0,1,1
85419,1,3,298746,298746,298749,0,3,0
85420,6,3,298752,298752,298755,0,3,3
85421,2,3,298754,298755,298758,1,4,0
85422,5,3,298759,298759,298762,0,3,1
85423,5,1,298764,298764,298765,0,1,2
85424,2,2,298766,298766,298768,0,2,1
85425,5,3,298771,298771,298774,0,3,3
85426,1,2,298772,298774,298776,2,4,0
85427,3,3,298775,298776,298779,1,4,0
85428,4,2,298779,298779,298781,0,2,0
85429,4,3,298783,298783,298786,0,3,2
85430,6,1,298789,298789,298790,0,1,3
85431,4,2,298793,298793,298795,0,2,3
85432,1,2,298794,298795,298797,1,3,0
85433,4,1,298798,298798,298799,0,1,1
85434,1,2,298799,298799,298801,0,2,0
85435,5,3,298804,298804,298807,0,3,3
85436,4,1,298808,298808,298809,0,1,1
85437,5,1,298813,298813,298814,0,1,4
85438,3,3,298816,298816,298819,0,3,2
85439,2,2,298818,298819,298821,1,3,0
85440,6,1,298824,298824,298825,0,1,3
85441,6,3,298830,298830,298833,0,3,5
85442,5,1,298835,298835,298836,0,1,2
85443,1,1,298836,298836,298837,0,1,0
85444,6,3,298842,298842,298845,0,3,5
85445,6,2,298848,298848,298850,0,2,3
85446,1,1,298849,298850,298851,1,2,0
85447,5,3,298854,298854,298857,0,3,3
85448,5,3,298859,298859,298862,0,3,2
85449,4,1,298863,298863,298864,0,1,1
85450,6,2,298869,298869,298871,0,2,5
85451,6,2,298875,298875,298877,0,2,4
85452,6,2,298881,298881,298883,0,2,4
85453,4,2,298885,298885,298887,0,2,2
85454,3,1,298888,298888,298889,0,1,1
85455,2,3,298890,298890,298893,0,3,1
85456,4,3,298894,298894,298897,0,3,1
85457,1,1,298895,298897,298898,2,3,0
85458,3,2,298898,298898,298900,0,2,0
85459,3,1,298901,298901,298902,0,1,1
85460,3,3,298904,298904,298907,0,3,2
85461,4,1,298908,298908,298909,0,1,1
85462,3,3,298911,298911,298914,0,3,2
85463,6,2,298917,298917,298919,0,2,3
85464,2,1,298919,298919,298920,0,1,0
85465,6,3,298925,298925,298928,0,3,5
85466,3,2,298928,298928,298930,0,2,0
85467,3,2,298931,298931,298933,0,2,1
85468,6,2,298937,298937,298939,0,2,4
85469,4,1,298941,298941,298942,0,1,2
85470,3,2,298944,298944,298946,0,2,2
85471,1,2,298945,298946,298948,1,3,0
85472,1,2,298946,298948,298950,2,4,0
85473,5,3,298951,298951,298954,0,3,1
85474,1,1,298952,298954,298955,2,3,0
85475,6,2,298958,298958,298960,0,2,3
85476,3,1,298961,298961,298962,0,1,1
85477,1,2,298962,298962,298964,0,2,0
85478,6,3,298968,298968,298971,0,3,4
85479,1,2,298969,298971,298973,2,4,0
85480,1,1,298970,298973,298974,3,4,0
85481,4,1,298974,298974,298975,0,1,0
85482,6,2,298980,298980,298982,0,2,5
85483,4,3,298984,298984,298987,0,3,2
85484,3,1,298987,298987,298988,0,1,0
85485,5,2,298992,298992,298994,0,2,4
85486,5,3,298997,298997,299000,0,3,3
85487,4,1,299001,299001,299002,0,1,1
85488,1,2,299002,299002,299004,0,2,0
85489,2,2,299004,299004,299006,0,2,0
85490,6,1,299010,299010,299011,0,1,4
85491,2,2,299012,299012,299014,0,2,1
85492,3,3,299015,299015,299018,0,3,1
85493,3,1,299018,299018,299019,0,1,0
85494,6,2,299024,299024,299026,0,2,5
85495,1,2,299025,299026,299028,1,3,0
85496,1,1,299026,299028,299029,2,3,0
85497,4,2,299030,299030,299032,0,2,1
85498,6,1,299036,299036,299037,0,1,4
85499,6,2,299042,299042,299044,0,2,5
85500,4,1,299046,299046,299047,0,1,2
85501,1,2,299047,299047,299049,0,2,0
85502,5,3,299052,299052,299055,0,3,3
85503,6,3,299058,299058,299061,0,3,3
85504,2,1,299060,299061,299062,1,2,0
85505,1,1,299061,299062,299063,1,2,0
85506,2,2,299063,299063,299065,0,2,0
85507,3,3,299066,299066,299069,0,3,1
85508,3,3,299069,299069,299072,0,3,0
85509,1,2,299070,299072,299074,2,4,0
85510,2,2,299072,299074,299076,2,4,0
85511,1,1,299073,299076,299077,3,4,0
85512,4,1,299077,299077,299078,0,1,0
85513,3,3,299080,299080,299083,0,3,2
85514,6,2,299086,299086,299088,0,2,3
85515,1,1,299087,299088,299089,1,2,0
85516,1,1,299088,299089,299090,1,2,0
85517,1,1,299089,299090,299091,1,2,0
85518,1,1,299090,299091,299092,1,2,0
85519,6,3,299096,299096,299099,0,3,4
85520,6,3,299102,299102,299105,0,3,3
85521,4,3,299106,299106,299109,0,3,1
85522,4,1,299110,299110,299111,0,1,1
85523,4,2,299114,299114,299116,0,2,3
85524,3,1,299117,299117,299118,0,1,1
85525,2,1,299119,299119,299120,0,1,1
85526,1,2,299120,299120,299122,0,2,0
85527,6,1,299126,299126,299127,0,1,4
85528,4,3,299130,299130,299133,0,3,3
85529,2,3,299132,299133,299136,1,4,0
85530,5,1,299137,299137,299138,0,1,1
85531,2,1,299139,299139,299140,0,1,1
85532,4,3,299143,299143,299146,0,3,3
85533,2,2,299145,299146,299148,1,3,0
85534,5,2,299150,299150,299152,0,2,2
85535,2,1,299152,299152,299153,0,1,0
85536,5,1,299157,299157,299158,0,1,4
85537,6,2,299163,299163,299165,0,2,5
85538,4,3,299167,299167,299170,0,3,2
85539,5,1,299172,299172,299173,0,1,2
85540,5,2,299177,299177,299179,0,2,4
85541,3,1,299180,299180,299181,0,1,1
85542,2,1,299182,299182,299183,0,1,1
85543,2,3,299184,299184,299187,0,3,1
85544,3,1,299187,299187,299188,0,1,0
85545,6,1,299193,299193,299194,0,1,5
85546,2,1,299195,299195,299196,0,1,1
85547,5,3,299200,299200,299203,0,3,4
85548,3,1,299203,299203,299204,0,1,0
85549,3,2,299206,299206,299208,0,2,2
85550,4,1,299210,299210,299211,0,1,2
85551,1,3,299211,299211,299214,0,3,0
85552,1,2,299212,299214,299216,2,4,0
85553,4,3,299216,299216,299219,0,3,0
85554,6,1,299222,299222,299223,0,1,3
85555,5,1,299227,299227,299228,0,1,4
85556,2,2,299229,299229,299231,0,2,1
85557,3,1,299232,299232,299233,0,1,1
85558,5,2,299237,299237,299239,0,2,4
85559,5,1,299242,299242,299243,0,1,3
85560,3,1,299245,299245,299246,0,1,2
85561,4,1,299249,299249,299250,0,1,3
85562,3,3,299252,299252,299255,0,3,2
85563,5,1,299257,299257,299258,0,1,2
85564,5,2,299262,299262,299264,0,2,4
85565,3,3,299265,299265,299268,0,3,1
85566,1,3,299266,299268,299271,2,5,0
85567,3,3,299269,299271,299274,2,5,0
85568,5,1,299274,299274,299275,0,1,0
85569,6,3,299280,299280,299283,0,3,5
85570,1,2,299281,299283,299285,2,4,0
85571,6,3,299287,299287,299290,0,3,2
85572,3,3,299290,299290,299293,0,3,0
85573,3,3,299293,299293,299296,0,3,0
85574,4,1,299297,299297,299298,0,1,1
85575,6,1,299303,299303,299304,0,1,5
85576,1,2,299304,299304,299306,0,2,0
85577,4,3,299308,299308,299311,0,3,2
85578,6,1,299314,299314,299315,0,1,3
85579,6,1,299320,299320,299321,0,1,5
85580,6,2,299326,299326,299328,0,2,5
85581,3,3,299329,299329,299332,0,3,1
85582,1,3,299330,299332,299335,2,5,0
85583,5,3,299335,299335,299338,0,3,0
85584,4,2,299339,299339,299341,0,2,1
85585,6,1,299345,299345,299346,0,1,4
85586,6,3,299351,299351,299354,0,3,5
85587,5,3,299356,299356,299359,0,3,2
85588,5,2,299361,299361,299363,0,2,2
85589,1,2,299362,299363,299365,1,3,0
85590,3,3,299365,299365,299368,0,3,0
85591,6,1,299371,299371,299372,0,1,3
85592,1,2,299372,299372,299374,0,2,0
85593,4,3,299376,299376,299379,0,3,2
85594,5,2,299381,299381,299383,0,2,2
85595,3,3,299384,299384,299387,0,3,1
85596,4,3,299388,299388,299391,0,3,1
85597,6,2,299394,299394,299396,0,2,3
85598,5,1,299399,299399,299400,0,1,3
85599,6,3,299405,299405,299408,0,3,5
85600,4,3,299409,299409,299412,0,3,1
85601,6,2,299415,299415,299417,0,2,3
85602,3,2,299418,299418,299420,0,2,1
85603,5,2,299423,299423,299425,0,2,3
85604,4,3,299427,299427,299430,0,3,2
85605,6,3,299433,299433,299436,0,3,3
85606,3,2,299436,299436,299438,0,2,0
85607,3,2,299439,299439,299441,0,2,1
85608,1,1,299440,299441,299442,1,2,0
85609,6,1,299446,299446,299447,0,1,4
85610,3,3,299449,299449,299452,0,3,2
85611,2,3,299451,299452,299455,1,4,0
85612,5,3,299456,299456,299459,0,3,1
85613,1,3,299457,299459,299462,2,5,0
85614,1,1,299458,299462,299463,4,5,0
85615,6,3,299464,299464,299467,0,3,1
85616,3,3,299467,299467,299470,0,3,0
85617,1,3,299468,299470,299473,2,5,0
85618,4,1,299472,299473,299474,1,2,0
85619,4,3,299476,299476,299479,0,3,2
85620,5,2,299481,299481,299483,0,2,2
85621,1,3,299482,299483,299486,1,4,0
85622,6,1,299488,299488,299489,0,1,2
85623,2,1,299490,299490,299491,0,1,1
85624,1,1,299491,299491,299492,0,1,0
85625,3,1,299494,299494,299495,0,1,2
85626,2,3,299496,299496,299499,0,3,1
85627,1,3,299497,299499,299502,2,5,0
85628,2,1,299499,299502,299503,3,4,0
85629,6,2,299505,299505,299507,0,2,2
85630,3,1,299508,299508,299509,0,1,1
85631,3,2,299511,299511,299513,0,2,2
85632,3,1,299514,299514,299515,0,1,1
85633,1,3,299515,299515,299518,0,3,0
85634,2,1,299517,299518,299519,1,2,0
85635,6,3,299523,299523,299526,0,3,4
85636,3,2,299526,299526,299528,0,2,0
85637,2,3,299528,299528,299531,0,3,0
85638,6,3,299534,299534,299537,0,3,3
85639,6,3,299540,299540,299543,0,3,3
85640,5,3,299545,299545,299548,0,3,2
85641,6,2,299551,299551,299553,0,2,3
85642,4,3,299555,299555,299558,0,3,2
85643,1,1,299556,299558,299559,2,3,0
85644,2,3,299558,299559,299562,1,4,0
85645,3,1,299561,299562,299563,1,2,0
85646,6,3,299567,299567,299570,0,3,4
85647,5,1,299572,299572,299573,0,1,2
85648,1,2,299573,299573,299575,0,2,0
85649,1,1,299574,299575,299576,1,2,0
85650,5,1,299579,299579,299580,0,1,3
85651,2,3,299581,299581,299584,0,3,1
85652,3,3,299584,299584,299587,0,3,0
85653,1,1,299585,299587,299588,2,3,0
85654,4,3,299589,299589,299592,0,3,1
85655,6,2,299595,299595,299597,0,2,3
85656,4,2,299599,299599,299601,0,2,2
85657,3,3,299602,299602,299605,0,3,1
85658,1,3,299603,299605,299608,2,5,0
85659,2,3,299605,299608,299611,3,6,0
85660,6,1,299611,299611,299612,0,1,0
85661,6,3,299617,299617,299620,0,3,5
85662,5,2,299622,299622,299624,0,2,2
85663,4,3,299626,299626,299629,0,3,2
85664,5,1,299631,299631,299632,0,1,2
85665,5,2,299636,299636,299638,0,2,4
85666,3,1,299639,299639,299640,0,1,1
85667,3,2,299642,299642,299644,0,2,2
85668,2,1,299644,299644,299645,0,1,0
85669,5,3,299649,299649,299652,0,3,4
85670,5,3,299654,299654,299657,0,3,2
85671,6,3,299660,299660,299663,0,3,3
85672,4,2,299664,299664,299666,0,2,1
85673,2,2,299666,299666,299668,0,2,0
85674,5,2,299671,299671,299673,0,2,3
85675,6,1,299677,299677,299678,0,1,4
85676,1,2,299678,299678,299680,0,2,0
85677,1,2,299679,299680,299682,1,3,0
85678,2,2,299681,299682,299684,1,3,0
85679,6,1,299687,299687,299688,0,1,3
85680,6,3,299693,299693,299696,0,3,5
85681,2,3,299695,299696,299699,1,4,0
85682,6,1,299701,299701,299702,0,1,2
85683,3,3,299704,299704,299707,0,3,2
85684,6,3,299710,299710,299713,0,3,3
85685,2,2,299712,299713,299715,1,3,0
85686,4,3,299716,299716,299719,0,3,1
85687,3,3,299719,299719,299722,0,3,0
85688,6,2,299725,299725,299727,0,2,3
85689,6,3,299731,299731,299734,0,3,4
85690,1,1,299732,299734,299735,2,3,0
85691,5,3,299737,299737,299740,0,3,2
85692,4,1,299741,299741,299742,0,1,1
85693,3,2,299744,299744,299746,0,2,2
85694,3,3,299747,299747,299750,0,3,1
85695,4,2,299751,299751,299753,0,2,1
85696,6,1,299757,299757,299758,0,1,4
85697,3,2,299760,299760,299762,0,2,2
85698,2,2,299762,299762,299764,0,2,0
85699,1,2,299763,299764,299766,1,3,0
85700,2,3,299765,299766,299769,1,4,0
85701,2,1,299767,299769,299770,2,3,0
85702,3,2,299770,299770,299772,0,2,0
85703,2,3,299772,299772,299775,0,3,0
85704,5,1,299777,299777,299778,0,1,2
85705,6,3,299783,299783,299786,0,3,5
85706,5,3,299788,299788,299791,0,3,2
85707,2,1,299790,299791,299792,1,2,0
85708,5,1,299795,299795,299796,0,1,3
85709,3,2,299798,299798,299800,0,2,2
85710,6,1,299804,299804,299805,0,1,4
85711,3,3,299807,299807,299810,0,3,2
85712,6,2,299813,299813,299815,0,2,3
85713,1,2,299814,299815,299817,1,3,0
85714,3,2,299817,299817,299819,0,2,0
85715,5,2,299822,299822,299824,0,2,3
85716,6,3,299828,299828,299831,0,3,4
85717,1,1,299829,299831,299832,2,3,0
85718,6,1,299835,299835,299836,0,1,3
85719,2,3,299837,299837,299840,0,3,1
85720,4,1,299841,299841,299842,0,1,1
85721,1,2,299842,299842,299844,0,2,0
85722,6,2,299848,299848,299850,0,2,4
85723,5,1,299853,299853,299854,0,1,3
85724,1,1,299854,299854,299855,0,1,0
85725,6,1,299860,299860,299861,0,1,5
85726,4,3,299864,299864,299867,0,3,3
85727,2,3,299866,299867,299870,1,4,0
85728,1,2,299867,299870,299872,3,5,0
85729,3,3,299870,299872,299875,2,5,0
85730,2,3,299872,299875,299878,3,6,0
85731,1,2,299873,299878,299880,5,7,0
85732,5,2,299878,299880,299882,2,4,0
85733,2,1,299880,299882,299883,2,3,0
85734,3,2,299883,299883,299885,0,2,0
85735,1,2,299884,299885,299887,1,3,0
85736,6,2,299890,299890,299892,0,2,3
85737,6,3,299896,299896,299899,0,3,4
85738,6,2,299902,299902,299904,0,2,3
85739,1,2,299903,299904,299906,1,3,0
85740,3,1,299906,299906,299907,0,1,0
85741,5,3,299911,299911,299914,0,3,4
85742,4,2,299915,299915,299917,0,2,1
85743,5,3,299920,299920,299923,0,3,3
85744,6,2,299926,299926,299928,0,2,3
85745,5,3,299931,299931,299934,0,3,3
85746,1,2,299932,299934,299936,2,4,0
85747,6,3,299938,299938,299941,0,3,2
85748,6,3,299944,299944,299947,0,3,3
85749,3,3,299947,299947,299950,0,3,0
85750,2,1,299949,299950,299951,1,2,0
85751,5,1,299954,299954,299955,0,1,3
85752,2,2,299956,299956,299958,0,2,1
85753,4,1,299960,299960,299961,0,1,2
85754,1,3,299961,299961,299964,0,3,0
85755,5,3,299966,299966,299969,0,3,2
85756,4,1,299970,299970,299971,0,1,1
85757,1,1,299971,299971,299972,0,1,0
85758,6,3,299977,299977,299980,0,3,5
85759,4,2,299981,299981,299983,0,2,1
85760,3,3,299984,299984,299987,0,3,1
85761,2,2,299986,299987,299989,1,3,0
85762,4,2,299990,299990,299992,0,2,1
85763,6,3,299996,299996,299999,0,3,4
85764,4,1,300000,300000,300001,0,1,1
85765,3,3,300003,300003,300006,0,3,2
85766,4,2,300007,300007,300009,0,2,1
85767,5,2,300012,300012,300014,0,2,3
85768,4,2,300016,300016,300018,0,2,2
85769,4,2,300020,300020,300022,0,2,2
85770,2,1,300022,300022,300023,0,1,0
85771,6,1,300028,300028,300029,0,1,5
85772,2,2,300030,300030,300032,0,2,1
85773,6,2,300036,300036,300038,0,2,4
85774,5,2,300041,300041,300043,0,2,3
85775,3,1,300044,300044,300045,0,1,1
85776,6,2,300050,300050,300052,0,2,5
85777,2,3,300052,300052,300055,0,3,0
85778,1,3,300053,300055,300058,2,5,0
85779,1,3,300054,300058,300061,4,7,0
85780,3,2,300057,300061,300063,4,6,0
85781,5,2,300062,300063,300065,1,3,0
85782,2,2,300064,300065,300067,1,3,0
85783,2,1,300066,300067,300068,1,2,0
85784,4,2,300070,300070,300072,0,2,2
85785,6,1,300076,300076,300077,0,1,4
85786,5,3,300081,300081,300084,0,3,4
85787,5,3,300086,300086,300089,0,3,2
85788,4,2,300090,300090,300092,0,2,1
85789,3,1,300093,300093,300094,0,1,1
85790,3,1,300096,300096,300097,0,1,2
85791,1,1,300097,300097,300098,0,1,0
85792,5,2,300102,300102,300104,0,2,4
85793,1,3,300103,300104,300107,1,4,0
85794,4,3,300107,300107,300110,0,3,0
85795,4,3,300111,300111,300114,0,3,1
85796,2,1,300113,300114,300115,1,2,0
85797,4,2,300117,300117,300119,0,2,2
85798,3,3,300120,300120,300123,0,3,1
85799,3,3,300123,300123,300126,0,3,0
85800,5,3,300128,300128,300131,0,3,2
85801,4,1,300132,300132,300133,0,1,1
85802,1,1,300133,300133,300134,0,1,0
85803,2,2,300135,300135,300137,0,2,1
85804,5,2,300140,300140,300142,0,2,3
85805,4,1,300144,300144,300145,0,1,2
85806,6,1,300150,300150,300151,0,1,5
85807,6,3,300156,300156,300159,0,3,5
85808,4,3,300160,300160,300163,0,3,1
85809,6,2,300166,300166,300168,0,2,3
85810,2,2,300168,300168,300170,0,2,0
85811,5,3,300173,300173,300176,0,3,3
85812,3,1,300176,300176,300177,0,1,0
85813,3,2,300179,300179,300181,0,2,2
85814,1,2,300180,300181,300183,1,3,0
85815,4,2,300184,300184,300186,0,2,1
85816,6,2,300190,300190,300192,0,2,4
85817,3,1,300193,300193,300194,0,1,1
85818,2,2,300195,300195,300197,0,2,1
85819,1,1,300196,300197,300198,1,2,0
85820,1,1,300197,300198,300199,1,2,0
85821,1,3,300198,300199,300202,1,4,0
85822,5,1,300203,300203,300204,0,1,1
85823,3,3,300206,300206,300209,0,3,2
85824,1,2,300207,300209,300211,2,4,0
85825,2,1,300209,300211,300212,2,3,0
85826,6,2,300215,300215,300217,0,2,3
85827,6,2,300221,300221,300223,0,2,4
85828,2,1,300223,300223,300224,0,1,0
85829,5,1,300228,300228,300229,0,1,4
85830,1,1,300229,300229,300230,0,1,0
85831,4,1,300233,300233,300234,0,1,3
85832,5,3,300238,300238,300241,0,3,4
85833,5,3,300243,300243,300246,0,3,2
85834,4,2,300247,300247,300249,0,2,1
85835,4,1,300251,300251,300252,0,1,2
85836,5,1,300256,300256,300257,0,1,4
85837,2,1,300258,300258,300259,0,1,1
85838,5,3,300263,300263,300266,0,3,4
85839,4,2,300267,300267,300269,0,2,1
85840,3,3,300270,300270,300273,0,3,1
85841,1,1,300271,300273,300274,2,3,0
85842,6,3,300277,300277,300280,0,3,3
85843,3,1,300280,300280,300281,0,1,0
85844,6,2,300286,300286,300288,0,2,5
85845,1,2,300287,300288,300290,1,3,0
85846,5,2,300292,300292,300294,0,2,2
85847,1,3,300293,300294,300297,1,4,0
85848,1,1,300294,300297,300298,3,4,0
85849,4,1,300298,300298,300299,0,1,0
85850,4,1,300302,300302,300303,0,1,3
85851,3,1,300305,300305,300306,0,1,2
85852,1,3,300306,300306,300309,0,3,0
85853,2,1,300308,300309,300310,1,2,0
85854,5,2,300313,300313,300315,0,2,3
85855,1,1,300314,300315,300316,1,2,0
85856,2,3,300316,300316,300319,0,3,0
85857,5,3,300321,300321,300324,0,3,2
85858,1,2,300322,300324,300326,2,4,0
85859,6,3,300328,300328,300331,0,3,2
85860,5,3,300333,300333,300336,0,3,2
85861,6,2,300339,300339,300341,0,2,3
85862,3,2,300342,300342,300344,0,2,1
85863,4,2,300346,300346,300348,0,2,2
85864,1,2,300347,300348,300350,1,3,0
85865,1,3,300348,300350,300353,2,5,0
85866,3,3,300351,300353,300356,2,5,0
85867,6,1,300357,300357,300358,0,1,1
85868,4,3,300361,300361,300364,0,3,3
85869,2,2,300363,300364,300366,1,3,0
85870,2,2,300365,300366,300368,1,3,0
85871,2,2,300367,300368,300370,1,3,0
85872,1,3,300368,300370,300373,2,5,0
85873,5,1,300373,300373,300374,0,1,0
85874,2,3,300375,300375,300378,0,3,1
85875,1,3,300376,300378,300381,2,5,0
85876,6,1,300382,300382,300383,0,1,1
85877,2,1,300384,300384,300385,0,1,1
85878,6,2,300390,300390,300392,0,2,5
85879,3,2,300393,300393,300395,0,2,1
85880,4,2,300397,300397,300399,0,2,2
85881,2,3,300399,300399,300402,0,3,0
85882,3,1,300402,300402,300403,0,1,0
85883,3,1,300405,300405,300406,0,1,2
85884,3,2,300408,300408,300410,0,2,2
85885,2,3,300410,300410,300413,0,3,0
85886,1,2,300411,300413,300415,2,4,0
85887,5,3,300416,300416,300419,0,3,1
85888,1,1,300417,300419,300420,2,3,0
85889,3,3,300420,300420,300423,0,3,0
85890,3,2,300423,300423,300425,0,2,0
85891,1,3,300424,300425,300428,1,4,0
85892,5,1,300429,300429,300430,0,1,1
85893,4,2,300433,300433,300435,0,2,3
85894,3,2,300436,300436,300438,0,2,1
85895,5,2,300441,300441,300443,0,2,3
85896,4,2,300445,300445,300447,0,2,2
85897,5,3,300450,300450,300453,0,3,3
85898,3,3,300453,300453,300456,0,3,0
85899,3,3,300456,300456,300459,0,3,0
85900,2,2,300458,300459,300461,1,3,0
85901,4,3,300462,300462,300465,0,3,1
85902,2,3,300464,300465,300468,1,4,0
85903,2,1,300466,300468,300469,2,3,0
85904,4,3,300470,300470,300473,0,3,1
85905,5,2,300475,300475,300477,0,2,2
85906,3,3,300478,300478,300481,0,3,1
85907,3,3,300481,300481,300484,0,3,0
85908,5,2,300486,300486,300488,0,2,2
85909,1,3,300487,300488,300491,1,4,0
85910,1,2,300488,300491,300493,3,5,0
85911,6,3,300494,300494,300497,0,3,1
85912,1,3,300495,300497,300500,2,5,0
85913,4,1,300499,300500,300501,1,2,0
85914,1,2,300500,300501,300503,1,3,0
85915,6,2,300506,300506,300508,0,2,3
85916,5,1,300511,300511,300512,0,1,3
85917,3,1,300514,300514,300515,0,1,2
85918,3,3,300517,300517,300520,0,3,2
85919,6,3,300523,300523,300526,0,3,3
85920,1,2,300524,300526,300528,2,4,0
85921,3,3,300527,300528,300531,1,4,0
85922,1,2,300528,300531,300533,3,5,0
85923,6,3,300534,300534,300537,0,3,1
85924,6,1,300540,300540,300541,0,1,3
85925,4,3,300544,300544,300547,0,3,3
85926,4,2,300548,300548,300550,0,2,1
85927,5,3,300553,300553,300556,0,3,3
85928,2,2,300555,300556,300558,1,3,0
85929,2,1,300557,300558,300559,1,2,0
85930,6,1,300563,300563,300564,0,1,4
85931,6,1,300569,300569,300570,0,1,5
85932,6,3,300575,300575,300578,0,3,5
85933,5,1,300580,300580,300581,0,1,2
85934,2,1,300582,300582,300583,0,1,1
85935,2,1,300584,300584,300585,0,1,1
85936,1,2,300585,300585,300587,0,2,0
85937,1,1,300586,300587,300588,1,2,0
85938,3,3,300589,300589,300592,0,3,1
85939,3,3,300592,300592,300595,0,3,0
85940,2,1,300594,300595,300596,1,2,0
85941,5,1,300599,300599,300600,0,1,3
85942,3,2,300602,300602,300604,0,2,2
85943,4,1,300606,300606,300607,0,1,2
85944,3,3,300609,300609,300612,0,3,2
85945,2,2,300611,300612,300614,1,3,0
85946,4,1,300615,300615,300616,0,1,1
85947,6,3,300621,300621,300624,0,3,5
85948,4,1,300625,300625,300626,0,1,1
85949,2,3,300627,300627,300630,0,3,1
85950,2,3,300629,300630,300633,1,4,0
85951,6,3,300635,300635,300638,0,3,2
85952,5,1,300640,300640,300641,0,1,2
85953,4,1,300644,300644,300645,0,1,3
85954,1,1,300645,300645,300646,0,1,0
85955,4,2,300649,300649,300651,0,2,3
85956,1,1,300650,300651,300652,1,2,0
85957,6,3,300656,300656,300659,0,3,4
85958,5,3,300661,300661,300664,0,3,2
85959,2,2,300663,300664,300666,1,3,0
85960,6,3,300669,300669,300672,0,3,3
85961,6,3,300675,300675,300678,0,3,3
85962,1,1,300676,300678,300679,2,3,0
85963,4,3,300680,300680,300683,0,3,1
85964,2,3,300682,300683,300686,1,4,0
85965,2,3,300684,300686,300689,2,5,0
85966,3,2,300687,300689,300691,2,4,0
85967,5,2,300692,300692,300694,0,2,1
85968,4,2,300696,300696,300698,0,2,2
85969,4,2,300700,300700,300702,0,2,2
85970,5,2,300705,300705,300707,0,2,3
85971,5,3,300710,300710,300713,0,3,3
85972,2,2,300712,300713,300715,1,3,0
85973,5,1,300717,300717,300718,0,1,2
85974,5,2,300722,300722,300724,0,2,4
85975,6,2,300728,300728,300730,0,2,4
85976,5,1,300733,300733,300734,0,1,3
85977,2,2,300735,300735,300737,0,2,1
85978,1,2,300736,300737,300739,1,3,0
85979,4,1,300740,300740,300741,0,1,1
85980,5,2,300745,300745,300747,0,2,4
85981,5,1,300750,300750,300751,0,1,3
85982,3,3,300753,300753,300756,0,3,2
85983,6,3,300759,300759,300762,0,3,3
85984,6,2,300765,300765,300767,0,2,3
85985,1,1,300766,300767,300768,1,2,0
85986,4,1,300770,300770,300771,0,1,2
85987,5,2,300775,300775,300777,0,2,4
85988,5,3,300780,300780,300783,0,3,3
85989,2,1,300782,300783,300784,1,2,0
85990,6,1,300788,300788,300789,0,1,4
85991,3,2,300791,300791,300793,0,2,2
85992,1,1,300792,300793,300794,1,2,0
85993,3,1,300795,300795,300796,0,1,1
85994,5,3,300800,300800,300803,0,3,4
85995,6,1,300806,300806,300807,0,1,3
85996,3,2,300809,300809,300811,0,2,2
85997,3,3,300812,300812,300815,0,3,1
85998,4,3,300816,300816,300819,0,3,1
85999,3,2,300819,300819,300821,0,2,0
86000,5,2,300824,300824,300826,0,2,3
86001,1,3,300825,300826,300829,1,4,0
86002,2,2,300827,300829,300831,2,4,0
86003,5,3,300832,300832,300835,0,3,1
86004,5,2,300837,300837,300839,0,2,2
86005,2,2,300839,300839,300841,0,2,0
86006,3,1,300842,300842,300843,0,1,1
86007,5,1,300847,300847,300848,0,1,4
86008,6,2,300853,300853,300855,0,2,5
86009,5,2,300858,300858,300860,0,2,3
86010,4,3,300862,300862,300865,0,3,2
86011,6,2,300868,300868,300870,0,2,3
86012,1,2,300869,300870,300872,1,3,0
86013,3,3,300872,300872,300875,0,3,0
86014,6,1,300878,300878,300879,0,1,3
86015,3,1,300881,300881,300882,0,1,2
86016,3,2,300884,300884,300886,0,2,2
86017,1,3,300885,300886,300889,1,4,0
86018,5,2,300890,300890,300892,0,2,1
86019,3,3,300893,300893,300896,0,3,1
86020,5,2,300898,300898,300900,0,2,2
86021,6,1,300904,300904,300905,0,1,4
86022,3,2,300907,300907,300909,0,2,2
86023,2,3,300909,300909,300912,0,3,0
86024,4,3,300913,300913,300916,0,3,1
86025,5,2,300918,300918,300920,0,2,2
86026,2,2,300920,300920,300922,0,2,0
86027,1,2,300921,300922,300924,1,3,0
86028,4,1,300925,300925,300926,0,1,1
86029,2,2,300927,300927,300929,0,2,1
86030,2,1,300929,300929,300930,0,1,0
86031,2,1,300931,300931,300932,0,1,1
86032,6,1,300937,300937,300938,0,1,5
86033,1,2,300938,300938,300940,0,2,0
86034,5,3,300943,300943,300946,0,3,3
86035,5,2,300948,300948,300950,0,2,2
86036,4,2,300952,300952,300954,0,2,2
86037,3,3,300955,300955,300958,0,3,1
86038,2,2,300957,300958,300960,1,3,0
86039,5,2,300962,300962,300964,0,2,2
86040,3,1,300965,300965,300966,0,1,1
86041,3,2,300968,300968,300970,0,2,2
86042,2,2,300970,300970,300972,0,2,0
86043,1,1,300971,300972,300973,1,2,0
86044,2,2,300973,300973,300975,0,2,0
86045,3,3,300976,300976,300979,0,3,1
86046,6,1,300982,300982,300983,0,1,3
86047,2,1,300984,300984,300985,0,1,1
86048,2,1,300986,300986,300987,0,1,1
86049,6,1,300992,300992,300993,0,1,5
86050,5,3,300997,300997,301000,0,3,4
86051,4,1,301001,301001,301002,0,1,1
86052,2,3,301003,301003,301006,0,3,1
86053,2,3,301005,301006,301009,1,4,0
86054,4,3,301009,301009,301012,0,3,0
86055,4,2,301013,301013,301015,0,2,1
86056,6,2,301019,301019,301021,0,2,4
86057,2,3,301021,301021,301024,0,3,0
86058,2,3,301023,301024,301027,1,4,0
86059,1,1,301024,301027,301028,3,4,0
86060,3,2,301027,301028,301030,1,3,0
86061,1,2,301028,301030,301032,2,4,0
86062,6,3,301034,301034,301037,0,3,2
86063,2,3,301036,301037,301040,1,4,0
86064,5,2,301041,301041,301043,0,2,1
86065,2,1,301043,301043,301044,0,1,0
86066,2,3,301045,301045,301048,0,3,1
86067,2,2,301047,301048,301050,1,3,0
86068,4,2,301051,301051,301053,0,2,1
86069,4,1,301055,301055,301056,0,1,2
86070,2,1,301057,301057,301058,0,1,1
86071,3,3,301060,301060,301063,0,3,2
86072,1,1,301061,301063,301064,2,3,0
86073,6,2,301067,301067,301069,0,2,3
86074,2,2,301069,301069,301071,0,2,0
86075,2,3,301071,301071,301074,0,3,0
86076,3,3,301074,301074,301077,0,3,0
86077,6,1,301080,301080,301081,0,1,3
86078,1,3,301081,301081,301084,0,3,0
86079,3,1,301084,301084,301085,0,1,0
86080,3,2,301087,301087,301089,0,2,2
86081,6,2,301093,301093,301095,0,2,4
86082,3,1,301096,301096,301097,0,1,1
86083,3,1,301099,301099,301100,0,1,2
86084,1,2,301100,301100,301102,0,2,0
86085,2,3,301102,301102,301105,0,3,0
86086,1,3,301103,301105,301108,2,5,0
86087,5,3,301108,301108,301111,0,3,0
86088,6,3,301114,301114,301117,0,3,3
86089,4,3,301118,301118,301121,0,3,1
86090,1,2,301119,301121,301123,2,4,0
86091,3,3,301122,301123,301126,1,4,0
86092,6,2,301128,301128,301130,0,2,2
86093,4,2,301132,301132,301134,0,2,2
86094,5,3,301137,301137,301140,0,3,3
86095,5,3,301142,301142,301145,0,3,2
86096,5,1,301147,301147,301148,0,1,2
86097,6,2,301153,301153,301155,0,2,5
86098,4,2,301157,301157,301159,0,2,2
86099,1,3,301158,301159,301162,1,4,0
86100,3,3,301161,301162,301165,1,4,0
86101,2,2,301163,301165,301167,2,4,0
86102,1,3,301164,301167,301170,3,6,0
86103,4,2,301168,301170,301172,2,4,0
86104,3,2,301171,301172,301174,1,3,0
86105,2,2,301173,301174,301176,1,3,0
86106,6,3,301179,301179,301182,0,3,3
86107,4,3,301183,301183,301186,0,3,1
86108,3,1,301186,301186,301187,0,1,0
86109,6,2,301192,301192,301194,0,2,5
86110,4,2,301196,301196,301198,0,2,2
86111,2,2,301198,301198,301200,0,2,0
86112,1,3,301199,301200,301203,1,4,0
86113,2,3,301201,301203,301206,2,5,0
86114,4,3,301205,301206,301209,1,4,0
86115,4,1,301209,301209,301210,0,1,0
86116,6,1,301215,301215,301216,0,1,5
86117,3,1,301218,301218,301219,0,1,2
86118,4,3,301222,301222,301225,0,3,3
86119,2,2,301224,301225,301227,1,3,0
86120,3,2,301227,301227,301229,0,2,0
86121,2,2,301229,301229,301231,0,2,0
86122,1,3,301230,301231,301234,1,4,0
86123,3,1,301233,301234,301235,1,2,0
86124,2,1,301235,301235,301236,0,1,0
86125,2,1,301237,301237,301238,0,1,1
86126,3,1,301240,301240,301241,0,1,2
86127,1,2,301241,301241,301243,0,2,0
86128,3,1,301244,301244,301245,0,1,1
86129,4,3,301248,301248,301251,0,3,3
86130,2,1,301250,301251,301252,1,2,0
86131,1,1,301251,301252,301253,1,2,0
86132,2,2,301253,301253,301255,0,2,0
86133,3,1,301256,301256,301257,0,1,1
86134,3,2,301259,301259,301261,0,2,2
86135,2,1,301261,301261,301262,0,1,0
86136,6,1,301267,301267,301268,0,1,5
86137,1,1,301268,301268,301269,0,1,0
86138,2,2,301270,301270,301272,0,2,1
86139,1,2,301271,301272,301274,1,3,0
86140,4,3,301275,301275,301278,0,3,1
86141,6,3,301281,301281,301284,0,3,3
86142,6,1,301287,301287,301288,0,1,3
86143,5,1,301292,301292,301293,0,1,4
86144,4,1,301296,301296,301297,0,1,3
86145,1,1,301297,301297,301298,0,1,0
86146,5,3,301302,301302,301305,0,3,4
86147,1,3,301303,301305,301308,2,5,0
86148,3,3,301306,301308,301311,2,5,0
86149,6,1,301312,301312,301313,0,1,1
86150,6,3,301318,301318,301321,0,3,5
86151,3,3,301321,301321,301324,0,3,0
86152,3,2,301324,301324,301326,0,2,0
86153,1,3,301325,301326,301329,1,4,0
86154,1,2,301326,301329,301331,3,5,0
86155,2,2,301328,301331,301333,3,5,0
86156,1,2,301329,301333,301335,4,6,0
86157,6,1,301335,301335,301336,0,1,0
86158,5,2,301340,301340,301342,0,2,4
86159,4,1,301344,301344,301345,0,1,2
86160,4,2,301348,301348,301350,0,2,3
86161,1,1,301349,301350,301351,1,2,0
86162,5,2,301354,301354,301356,0,2,3
86163,3,3,301357,301357,301360,0,3,1
86164,3,3,301360,301360,301363,0,3,0
86165,2,1,301362,301363,301364,1,2,0
86166,2,1,301364,301364,301365,0,1,0
86167,6,3,301370,301370,301373,0,3,5
86168,6,1,301376,301376,301377,0,1,3
86169,6,2,301382,301382,301384,0,2,5
86170,5,3,301387,301387,301390,0,3,3
86171,6,3,301393,301393,301396,0,3,3
86172,5,3,301398,301398,301401,0,3,2
86173,2,1,301400,301401,301402,1,2,0
86174,3,2,301403,301403,301405,0,2,1
86175,6,3,301409,301409,301412,0,3,4
86176,3,3,301412,301412,301415,0,3,0
86177,6,3,301418,301418,301421,0,3,3
86178,1,1,301419,301421,301422,2,3,0
86179,1,3,301420,301422,301425,2,5,0
86180,1,1,301421,301425,301426,4,5,0
86181,3,3,301424,301426,301429,2,5,0
86182,3,2,301427,301429,301431,2,4,0
86183,6,2,301433,301433,301435,0,2,2
86184,5,2,301438,301438,301440,0,2,3
86185,6,3,301444,301444,301447,0,3,4
86186,4,3,301448,301448,301451,0,3,1
86187,4,3,301452,301452,301455,0,3,1
86188,1,1,301453,301455,301456,2,3,0
86189,5,3,301458,301458,301461,0,3,2
86190,4,3,301462,301462,301465,0,3,1
86191,3,3,301465,301465,301468,0,3,0
86192,6,1,301471,301471,301472,0,1,3
86193,2,1,301473,301473,301474,0,1,1
86194,6,1,301479,301479,301480,0,1,5
86195,3,1,301482,301482,301483,0,1,2
86196,2,1,301484,301484,301485,0,1,1
86197,4,1,301488,301488,301489,0,1,3
86198,2,3,301490,301490,301493,0,3,1
86199,4,3,301494,301494,301497,0,3,1
86200,6,2,301500,301500,301502,0,2,3
86201,5,2,301505,301505,301507,0,2,3
86202,3,2,301508,301508,301510,0,2,1
86203,5,3,301513,301513,301516,0,3,3
86204,4,3,301517,301517,301520,0,3,1
86205,5,2,301522,301522,301524,0,2,2
86206,4,2,301526,301526,301528,0,2,2
86207,3,2,301529,301529,301531,0,2,1
86208,2,1,301531,301531,301532,0,1,0
86209,2,2,301533,301533,301535,0,2,1
86210,2,1,301535,301535,301536,0,1,0
86211,3,3,301538,301538,301541,0,3,2
86212,2,2,301540,301541,301543,1,3,0
86213,2,1,301542,301543,301544,1,2,0
86214,3,3,301545,301545,301548,0,3,1
86215,6,3,301551,301551,301554,0,3,3
86216,6,1,301557,301557,301558,0,1,3
86217,3,3,301560,301560,301563,0,3,2
86218,3,3,301563,301563,301566,0,3,0
86219,3,3,301566,301566,301569,0,3,0
86220,5,1,301571,301571,301572,0,1,2
86221,5,2,301576,301576,301578,0,2,4
86222,1,2,301577,301578,301580,1,3,0
86223,3,2,301580,301580,301582,0,2,0
86224,3,3,301583,301583,301586,0,3,1
86225,6,2,301589,301589,301591,0,2,3
86226,5,3,301594,301594,301597,0,3,3
86227,4,2,301598,301598,301600,0,2,1
86228,1,3,301599,301600,301603,1,4,0
86229,4,1,301603,301603,301604,0,1,0
86230,5,1,301608,301608,301609,0,1,4
86231,5,3,301613,301613,301616,0,3,4
86232,6,2,301619,301619,301621,0,2,3
86233,2,3,301621,301621,301624,0,3,0
86234,2,1,301623,301624,301625,1,2,0
86235,2,1,301625,301625,301626,0,1,0
86236,3,2,301628,301628,301630,0,2,2
86237,3,1,301631,301631,301632,0,1,1
86238,4,1,301635,301635,301636,0,1,3
86239,2,3,301637,301637,301640,0,3,1
86240,5,3,301642,301642,301645,0,3,2
86241,1,1,301643,301645,301646,2,3,0
86242,3,2,301646,301646,301648,0,2,0
86243,5,3,301651,301651,301654,0,3,3
86244,1,2,301652,301654,301656,2,4,0
86245,3,2,301655,301656,301658,1,3,0
86246,2,1,301657,301658,301659,1,2,0
86247,4,3,301661,301661,301664,0,3,2
86248,1,3,301662,301664,301667,2,5,0
86249,4,2,301666,301667,301669,1,3,0
86250,4,1,301670,301670,301671,0,1,1
86251,2,3,301672,301672,301675,0,3,1
86252,5,1,301677,301677,301678,0,1,2
86253,5,3,301682,301682,301685,0,3,4
86254,3,3,301685,301685,301688,0,3,0
86255,5,2,301690,301690,301692,0,2,2
86256,5,1,301695,301695,301696,0,1,3
86257,4,1,301699,301699,301700,0,1,3
86258,4,3,301703,301703,301706,0,3,3
86259,5,1,301708,301708,301709,0,1,2
86260,4,1,301712,301712,301713,0,1,3
86261,5,3,301717,301717,301720,0,3,4
86262,2,1,301719,301720,301721,1,2,0
86263,6,2,301725,301725,301727,0,2,4
86264,1,3,301726,301727,301730,1,4,0
86265,6,1,301732,301732,301733,0,1,2
86266,3,1,301735,301735,301736,0,1,2
86267,2,3,301737,301737,301740,0,3,1
86268,5,1,301742,301742,301743,0,1,2
86269,1,3,301743,301743,301746,0,3,0
86270,1,2,301744,301746,301748,2,4,0
86271,6,3,301750,301750,301753,0,3,2
86272,4,2,301754,301754,301756,0,2,1
86273,2,1,301756,301756,301757,0,1,0
86274,5,3,301761,301761,301764,0,3,4
86275,2,3,301763,301764,301767,1,4,0
86276,6,1,301769,301769,301770,0,1,2
86277,5,3,301774,301774,301777,0,3,4
86278,5,2,301779,301779,301781,0,2,2
86279,4,3,301783,301783,301786,0,3,2
86280,2,1,301785,301786,301787,1,2,0
86281,1,1,301786,301787,301788,1,2,0
86282,6,1,301792,301792,301793,0,1,4
86283,2,3,301794,301794,301797,0,3,1
86284,1,3,301795,301797,301800,2,5,0
86285,5,3,301800,301800,301803,0,3,0
86286,5,2,301805,301805,301807,0,2,2
86287,4,1,301809,301809,301810,0,1,2
86288,2,2,301811,301811,301813,0,2,1
86289,1,1,301812,301813,301814,1,2,0
86290,5,3,301817,301817,301820,0,3,3
86291,2,3,301819,301820,301823,1,4,0
86292,5,3,301824,301824,301827,0,3,1
86293,4,1,301828,301828,301829,0,1,1
86294,2,3,301830,301830,301833,0,3,1
86295,4,3,301834,301834,301837,0,3,1
86296,4,2,301838,301838,301840,0,2,1
86297,1,3,301839,301840,301843,1,4,0
86298,2,3,301841,301843,301846,2,5,0
86299,5,1,301846,301846,301847,0,1,0
86300,3,3,301849,301849,301852,0,3,2
86301,2,3,301851,301852,301855,1,4,0
86302,4,3,301855,301855,301858,0,3,0
86303,2,2,301857,301858,301860,1,3,0
86304,2,3,301859,301860,301863,1,4,0
86305,5,2,301864,301864,301866,0,2,1
86306,1,3,301865,301866,301869,1,4,0
86307,2,3,301867,301869,301872,2,5,0
86308,5,3,301872,301872,301875,0,3,0
86309,6,1,301878,301878,301879,0,1,3
86310,4,1,301882,301882,301883,0,1,3
86311,6,3,301888,301888,301891,0,3,5
86312,6,1,301894,301894,301895,0,1,3
86313,3,1,301897,301897,301898,0,1,2
86314,5,3,301902,301902,301905,0,3,4
86315,3,3,301905,301905,301908,0,3,0
86316,2,2,301907,301908,301910,1,3,0
86317,3,3,301910,301910,301913,0,3,0
86318,1,1,301911,301913,301914,2,3,0
86319,4,2,301915,301915,301917,0,2,1
86320,3,2,301918,301918,301920,0,2,1
86321,5,2,301923,301923,301925,0,2,3
86322,3,1,301926,301926,301927,0,1,1
86323,3,1,301929,301929,301930,0,1,2
86324,6,3,301935,301935,301938,0,3,5
86325,1,1,301936,301938,301939,2,3,0
86326,3,3,301939,301939,301942,0,3,0
86327,5,2,301944,301944,301946,0,2,2
86328,1,1,301945,301946,301947,1,2,0
86329,2,3,301947,301947,301950,0,3,0
86330,6,3,301953,301953,301956,0,3,3
86331,1,1,301954,301956,301957,2,3,0
86332,5,2,301959,301959,301961,0,2,2
86333,4,2,301963,301963,301965,0,2,2
86334,3,2,301966,301966,301968,0,2,1
86335,4,1,301970,301970,301971,0,1,2
86336,5,3,301975,301975,301978,0,3,4
86337,4,1,301979,301979,301980,0,1,1
86338,2,2,301981,301981,301983,0,2,1
86339,3,1,301984,301984,301985,0,1,1
86340,2,2,301986,301986,301988,0,2,1
86341,2,3,301988,301988,301991,0,3,0
86342,1,1,301989,301991,301992,2,3,0
86343,1,1,301990,301992,301993,2,3,0
86344,3,1,301993,301993,301994,0,1,0
86345,1,1,301994,301994,301995,0,1,0
86346,3,1,301997,301997,301998,0,1,2
86347,5,3,302002,302002,302005,0,3,4
86348,3,3,302005,302005,302008,0,3,0
86349,5,2,302010,302010,302012,0,2,2
86350,6,1,302016,302016,302017,0,1,4
86351,2,2,302018,302018,302020,0,2,1
86352,1,3,302019,302020,302023,1,4,0
86353,2,1,302021,302023,302024,2,3,0
86354,1,1,302022,302024,302025,2,3,0
86355,1,2,302023,302025,302027,2,4,0
86356,5,3,302028,302028,302031,0,3,1
86357,5,2,302033,302033,302035,0,2,2
86358,6,2,302039,302039,302041,0,2,4
86359,5,1,302044,302044,302045,0,1,3
86360,5,1,302049,302049,302050,0,1,4
86361,2,2,302051,302051,302053,0,2,1
86362,1,3,302052,302053,302056,1,4,0
86363,1,2,302053,302056,302058,3,5,0
86364,3,1,302056,302058,302059,2,3,0
86365,5,1,302061,302061,302062,0,1,2
86366,6,2,302067,302067,302069,0,2,5
86367,6,2,302073,302073,302075,0,2,4
86368,6,3,302079,302079,302082,0,3,4
86369,6,2,302085,302085,302087,0,2,3
86370,5,3,302090,302090,302093,0,3,3
86371,4,3,302094,302094,302097,0,3,1
86372,5,2,302099,302099,302101,0,2,2
86373,5,3,302104,302104,302107,0,3,3
86374,4,2,302108,302108,302110,0,2,1
86375,6,3,302114,302114,302117,0,3,4
86376,4,2,302118,302118,302120,0,2,1
86377,6,2,302124,302124,302126,0,2,4
86378,2,1,302126,302126,302127,0,1,0
86379,6,1,302132,302132,302133,0,1,5
86380,1,3,302133,302133,302136,0,3,0
86381,1,1,302134,302136,302137,2,3,0
86382,6,2,302140,302140,302142,0,2,3
86383,6,2,302146,302146,302148,0,2,4
86384,4,1,302150,302150,302151,0,1,2
86385,1,2,302151,302151,302153,0,2,0
86386,4,3,302155,302155,302158,0,3,2
86387,2,1,302157,302158,302159,1,2,0
86388,2,3,302159,302159,302162,0,3,0
86389,2,2,302161,302162,302164,1,3,0
86390,3,1,302164,302164,302165,0,1,0
86391,2,1,302166,302166,302167,0,1,1
86392,6,2,302172,302172,302174,0,2,5
86393,4,1,302176,302176,302177,0,1,2
86394,1,2,302177,302177,302179,0,2,0
86395,2,2,302179,302179,302181,0,2,0
86396,6,3,302185,302185,302188,0,3,4
86397,6,1,302191,302191,302192,0,1,3
86398,2,1,302193,302193,302194,0,1,1
86399,5,3,302198,302198,302201,0,3,4
86400,3,2,302201,302201,302203,0,2,0
86401,3,1,302204,302204,302205,0,1,1
86402,4,2,302208,302208,302210,0,2,3
86403,4,3,302212,302212,302215,0,3,2
86404,5,3,302217,302217,302220,0,3,2
86405,4,3,302221,302221,302224,0,3,1
86406,4,3,302225,302225,302228,0,3,1
86407,1,1,302226,302228,302229,2,3,0
86408,1,3,302227,302229,302232,2,5,0
86409,1,1,302228,302232,302233,4,5,0
86410,3,2,302231,302233,302235,2,4,0
86411,3,1,302234,302235,302236,1,2,0
86412,4,3,302238,302238,302241,0,3,2
86413,4,2,302242,302242,302244,0,2,1
86414,6,1,302248,302248,302249,0,1,4
86415,2,3,302250,302250,302253,0,3,1
86416,1,3,302251,302253,302256,2,5,0
86417,6,3,302257,302257,302260,0,3,1
86418,3,2,302260,302260,302262,0,2,0
86419,5,1,302265,302265,302266,0,1,3
86420,6,3,302271,302271,302274,0,3,5
86421,4,3,302275,302275,302278,0,3,1
86422,4,1,302279,302279,302280,0,1,1
86423,2,2,302281,302281,302283,0,2,1
86424,2,1,302283,302283,302284,0,1,0
86425,3,2,302286,302286,302288,0,2,2
86426,4,3,302290,302290,302293,0,3,2
86427,4,3,302294,302294,302297,0,3,1
86428,1,3,302295,302297,302300,2,5,0
86429,5,1,302300,302300,302301,0,1,0
86430,5,3,302305,302305,302308,0,3,4
86431,3,1,302308,302308,302309,0,1,0
86432,6,1,302314,302314,302315,0,1,5
86433,4,2,302318,302318,302320,0,2,3
86434,2,2,302320,302320,302322,0,2,0
86435,2,3,302322,302322,302325,0,3,0
86436,6,2,302328,302328,302330,0,2,3
86437,4,1,302332,302332,302333,0,1,2
86438,5,1,302337,302337,302338,0,1,4
86439,4,1,302341,302341,302342,0,1,3
86440,4,1,302345,302345,302346,0,1,3
86441,3,3,302348,302348,302351,0,3,2
86442,1,2,302349,302351,302353,2,4,0
86443,6,2,302355,302355,302357,0,2,2
86444,1,2,302356,302357,302359,1,3,0
86445,3,3,302359,302359,302362,0,3,0
86446,3,3,302362,302362,302365,0,3,0
86447,3,2,302365,302365,302367,0,2,0
86448,3,1,302368,302368,302369,0,1,1
86449,2,2,302370,302370,302372,0,2,1
86450,4,3,302374,302374,302377,0,3,2
86451,2,3,302376,302377,302380,1,4,0
86452,2,3,302378,302380,302383,2,5,0
86453,3,1,302381,302383,302384,2,3,0
86454,4,2,302385,302385,302387,0,2,1
86455,2,2,302387,302387,302389,0,2,0
86456,1,1,302388,302389,302390,1,2,0
86457,2,3,302390,302390,302393,0,3,0
86458,3,3,302393,302393,302396,0,3,0
86459,6,2,302399,302399,302401,0,2,3
86460,5,3,302404,302404,302407,0,3,3
86461,2,1,302406,302407,302408,1,2,0
86462,5,1,302411,302411,302412,0,1,3
86463,6,3,302417,302417,302420,0,3,5
86464,4,2,302421,302421,302423,0,2,1
86465,3,2,302424,302424,302426,0,2,1
86466,4,3,302428,302428,302431,0,3,2
86467,4,3,302432,302432,302435,0,3,1
86468,4,3,302436,302436,302439,0,3,1
86469,4,3,302440,302440,302443,0,3,1
86470,5,1,302445,302445,302446,0,1,2
86471,2,1,302447,302447,302448,0,1,1
86472,4,2,302451,302451,302453,0,2,3
86473,4,2,302455,302455,302457,0,2,2
86474,2,1,302457,302457,302458,0,1,0
86475,1,3,302458,302458,302461,0,3,0
86476,4,3,302462,302462,302465,0,3,1
86477,1,1,302463,302465,302466,2,3,0
86478,5,2,302468,302468,302470,0,2,2
86479,1,2,302469,302470,302472,1,3,0
86480,1,2,302470,302472,302474,2,4,0
86481,6,3,302476,302476,302479,0,3,2
86482,6,2,302482,302482,302484,0,2,3
86483,2,1,302484,302484,302485,0,1,0
86484,6,1,302490,302490,302491,0,1,5
86485,5,1,302495,302495,302496,0,1,4
86486,2,2,302497,302497,302499,0,2,1
86487,6,2,302503,302503,302505,0,2,4
86488,1,3,302504,302505,302508,1,4,0
86489,5,3,302509,302509,302512,0,3,1
86490,6,3,302515,302515,302518,0,3,3
86491,4,3,302519,302519,302522,0,3,1
86492,3,3,302522,302522,302525,0,3,0
86493,4,1,302526,302526,302527,0,1,1
86494,2,2,302528,302528,302530,0,2,1
86495,4,2,302532,302532,302534,0,2,2
86496,6,3,302538,302538,302541,0,3,4
86497,5,3,302543,302543,302546,0,3,2
86498,1,3,302544,302546,302549,2,5,0
86499,5,3,302549,302549,302552,0,3,0
86500,6,1,302555,302555,302556,0,1,3
86501,4,1,302559,302559,302560,0,1,3
86502,3,2,302562,302562,302564,0,2,2
86503,4,1,302566,302566,302567,0,1,2
86504,5,1,302571,302571,302572,0,1,4
86505,3,2,302574,302574,302576,0,2,2
86506,1,1,302575,302576,302577,1,2,0
86507,6,3,302581,302581,302584,0,3,4
86508,4,1,302585,302585,302586,0,1,1
86509,4,2,302589,302589,302591,0,2,3
86510,1,3,302590,302591,302594,1,4,0
86511,1,2,302591,302594,302596,3,5,0
86512,3,2,302594,302596,302598,2,4,0
86513,6,2,302600,302600,302602,0,2,2
86514,5,1,302605,302605,302606,0,1,3
86515,3,2,302608,302608,302610,0,2,2
86516,1,3,302609,302610,302613,1,4,0
86517,3,2,302612,302613,302615,1,3,0
86518,4,2,302616,302616,302618,0,2,1
86519,1,2,302617,302618,302620,1,3,0
86520,4,3,302621,302621,302624,0,3,1
86521,1,2,302622,302624,302626,2,4,0
86522,3,1,302625,302626,302627,1,2,0
86523,5,3,302630,302630,302633,0,3,3
86524,1,1,302631,302633,302634,2,3,0
86525,2,2,302633,302634,302636,1,3,0
86526,4,3,302637,302637,302640,0,3,1
86527,4,2,302641,302641,302643,0,2,1
86528,2,1,302643,302643,302644,0,1,0
86529,4,1,302647,302647,302648,0,1,3
86530,1,3,302648,302648,302651,0,3,0
86531,5,2,302653,302653,302655,0,2,2
86532,5,3,302658,302658,302661,0,3,3
86533,6,3,302664,302664,302667,0,3,3
86534,4,2,302668,302668,302670,0,2,1
86535,1,1,302669,302670,302671,1,2,0
86536,2,3,302671,302671,302674,0,3,0
86537,6,3,302677,302677,302680,0,3,3
86538,2,1,302679,302680,302681,1,2,0
86539,4,1,302683,302683,302684,0,1,2
86540,3,1,302686,302686,302687,0,1,2
86541,3,1,302689,302689,302690,0,1,2
86542,1,3,302690,302690,302693,0,3,0
86543,1,1,302691,302693,302694,2,3,0
86544,4,3,302695,302695,302698,0,3,1
86545,1,1,302696,302698,302699,2,3,0
86546,5,3,302701,302701,302704,0,3,2
86547,2,3,302703,302704,302707,1,4,0
86548,3,1,302706,302707,302708,1,2,0
86549,5,2,302711,302711,302713,0,2,3
86550,6,1,302717,302717,302718,0,1,4
86551,6,1,302723,302723,302724,0,1,5
86552,1,1,302724,302724,302725,0,1,0
86553,2,2,302726,302726,302728,0,2,1
86554,5,3,302731,302731,302734,0,3,3
86555,1,3,302732,302734,302737,2,5,0
86556,1,1,302733,302737,302738,4,5,0
86557,1,1,302734,302738,302739,4,5,0
86558,1,3,302735,302739,302742,4,7,0
86559,3,2,302738,302742,302744,4,6,0
86560,2,1,302740,302744,302745,4,5,0
86561,5,1,302745,302745,302746,0,1,0
86562,5,1,302750,302750,302751,0,1,4
86563,1,3,302751,302751,302754,0,3,0
86564,5,3,302756,302756,302759,0,3,2
86565,6,1,302762,302762,302763,0,1,3
86566,1,1,302763,302763,302764,0,1,0
86567,4,1,302767,302767,302768,0,1,3
86568,4,3,302771,302771,302774,0,3,3
86569,6,2,302777,302777,302779,0,2,3
86570,5,2,302782,302782,302784,0,2,3
86571,5,2,302787,302787,302789,0,2,3
86572,5,2,302792,302792,302794,0,2,3
86573,4,2,302796,302796,302798,0,2,2
86574,5,1,302801,302801,302802,0,1,3
86575,4,3,302805,302805,302808,0,3,3
86576,4,2,302809,302809,302811,0,2,1
86577,1,3,302810,302811,302814,1,4,0
86578,3,2,302813,302814,302816,1,3,0
86579,3,2,302816,302816,302818,0,2,0
86580,4,3,302820,302820,302823,0,3,2
86581,6,3,302826,302826,302829,0,3,3
86582,2,3,302828,302829,302832,1,4,0
86583,4,1,302832,302832,302833,0,1,0
86584,2,1,302834,302834,302835,0,1,1
86585,4,3,302838,302838,302841,0,3,3
86586,2,3,302840,302841,302844,1,4,0
86587,3,2,302843,302844,302846,1,3,0
86588,3,3,302846,302846,302849,0,3,0
86589,1,2,302847,302849,302851,2,4,0
86590,2,2,302849,302851,302853,2,4,0
86591,3,3,302852,302853,302856,1,4,0
86592,6,3,302858,302858,302861,0,3,2
86593,1,2,302859,302861,302863,2,4,0
86594,5,2,302864,302864,302866,0,2,1
86595,3,2,302867,302867,302869,0,2,1
86596,1,2,302868,302869,302871,1,3,0
86597,1,1,302869,302871,302872,2,3,0
86598,2,3,302871,302872,302875,1,4,0
86599,3,1,302874,302875,302876,1,2,0
86600,5,2,302879,302879,302881,0,2,3
86601,5,2,302884,302884,302886,0,2,3
86602,1,3,302885,302886,302889,1,4,0
86603,3,1,302888,302889,302890,1,2,0
86604,4,3,302892,302892,302895,0,3,2
86605,1,1,302893,302895,302896,2,3,0
86606,2,2,302895,302896,302898,1,3,0
86607,6,1,302901,302901,302902,0,1,3
86608,2,2,302903,302903,302905,0,2,1
86609,2,1,302905,302905,302906,0,1,0
86610,1,2,302906,302906,302908,0,2,0
86611,1,1,302907,302908,302909,1,2,0
86612,2,2,302909,302909,302911,0,2,0
86613,1,3,302910,302911,302914,1,4,0
86614,1,2,302911,302914,302916,3,5,0
86615,2,1,302913,302916,302917,3,4,0
86616,2,2,302915,302917,302919,2,4,0
86617,1,3,302916,302919,302922,3,6,0
86618,2,2,302918,302922,302924,4,6,0
86619,2,2,302920,302924,302926,4,6,0
86620,4,3,302924,302926,302929,2,5,0
86621,1,3,302925,302929,302932,4,7,0
86622,5,1,302930,302932,302933,2,3,0
86623,2,2,302932,302933,302935,1,3,0
86624,2,3,302934,302935,302938,1,4,0
86625,6,2,302940,302940,302942,0,2,2
86626,4,2,302944,302944,302946,0,2,2
86627,1,1,302945,302946,302947,1,2,0
86628,4,3,302949,302949,302952,0,3,2
86629,6,1,302955,302955,302956,0,1,3
86630,5,3,302960,302960,302963,0,3,4
86631,3,2,302963,302963,302965,0,2,0
86632,5,1,302968,302968,302969,0,1,3
86633,3,3,302971,302971,302974,0,3,2
86634,5,3,302976,302976,302979,0,3,2
86635,1,2,302977,302979,302981,2,4,0
86636,3,1,302980,302981,302982,1,2,0
86637,2,1,302982,302982,302983,0,1,0
86638,3,2,302985,302985,302987,0,2,2
86639,6,3,302991,302991,302994,0,3,4
86640,5,1,302996,302996,302997,0,1,2
86641,2,1,302998,302998,302999,0,1,1
86642,6,3,303004,303004,303007,0,3,5
86643,1,1,303005,303007,303008,2,3,0
86644,3,1,303008,303008,303009,0,1,0
86645,6,1,303014,303014,303015,0,1,5
86646,3,3,303017,303017,303020,0,3,2
86647,1,3,303018,303020,303023,2,5,0
86648,1,1,303019,303023,303024,4,5,0
86649,5,2,303024,303024,303026,0,2,0
86650,3,1,303027,303027,303028,0,1,1
86651,5,3,303032,303032,303035,0,3,4
86652,3,3,303035,303035,303038,0,3,0
86653,1,1,303036,303038,303039,2,3,0
86654,4,3,303040,303040,303043,0,3,1
86655,1,1,303041,303043,303044,2,3,0
86656,3,3,303044,303044,303047,0,3,0
86657,4,2,303048,303048,303050,0,2,1
86658,5,2,303053,303053,303055,0,2,3
86659,2,1,303055,303055,303056,0,1,0
86660,1,3,303056,303056,303059,0,3,0
86661,6,2,303062,303062,303064,0,2,3
86662,3,1,303065,303065,303066,0,1,1
86663,6,2,303071,303071,303073,0,2,5
86664,3,2,303074,303074,303076,0,2,1
86665,2,2,303076,303076,303078,0,2,0
86666,3,3,303079,303079,303082,0,3,1
86667,5,2,303084,303084,303086,0,2,2
86668,3,1,303087,303087,303088,0,1,1
86669,6,2,303093,303093,303095,0,2,5
86670,1,2,303094,303095,303097,1,3,0
86671,3,2,303097,303097,303099,0,2,0
86672,6,1,303103,303103,303104,0,1,4
86673,4,2,303107,303107,303109,0,2,3
86674,6,2,303113,303113,303115,0,2,4
86675,5,2,303118,303118,303120,0,2,3
86676,5,3,303123,303123,303126,0,3,3
86677,4,1,303127,303127,303128,0,1,1
86678,1,3,303128,303128,303131,0,3,0
86679,4,3,303132,303132,303135,0,3,1
86680,6,1,303138,303138,303139,0,1,3
86681,1,2,303139,303139,303141,0,2,0
86682,1,2,303140,303141,303143,1,3,0
86683,1,1,303141,303143,303144,2,3,0
86684,5,3,303146,303146,303149,0,3,2
86685,4,2,303150,303150,303152,0,2,1
86686,1,1,303151,303152,303153,1,2,0
86687,1,2,303152,303153,303155,1,3,0
86688,2,1,303154,303155,303156,1,2,0
86689,3,2,303157,303157,303159,0,2,1
86690,5,3,303162,303162,303165,0,3,3
86691,3,1,303165,303165,303166,0,1,0
86692,4,1,303169,303169,303170,0,1,3
86693,4,3,303173,303173,303176,0,3,3
86694,1,3,303174,303176,303179,2,5,0
86695,6,3,303180,303180,303183,0,3,1
86696,2,3,303182,303183,303186,1,4,0
86697,4,3,303186,303186,303189,0,3,0
86698,1,1,303187,303189,303190,2,3,0
86699,4,1,303191,303191,303192,0,1,1
86700,2,1,303193,303193,303194,0,1,1
86701,5,3,303198,303198,303201,0,3,4
86702,2,3,303200,303201,303204,1,4,0
86703,4,2,303204,303204,303206,0,2,0
86704,5,3,303209,303209,303212,0,3,3
86705,6,1,303215,303215,303216,0,1,3
86706,5,2,303220,303220,303222,0,2,4
86707,5,1,303225,303225,303226,0,1,3
86708,3,3,303228,303228,303231,0,3,2
86709,6,3,303234,303234,303237,0,3,3
86710,6,3,303240,303240,303243,0,3,3
86711,3,3,303243,303243,303246,0,3,0
86712,6,3,303249,303249,303252,0,3,3
86713,1,2,303250,303252,303254,2,4,0
86714,4,2,303254,303254,303256,0,2,0
86715,5,3,303259,303259,303262,0,3,3
86716,5,1,303264,303264,303265,0,1,2
86717,6,2,303270,303270,303272,0,2,5
86718,4,1,303274,303274,303275,0,1,2
86719,4,2,303278,303278,303280,0,2,3
86720,1,1,303279,303280,303281,1,2,0
86721,6,3,303285,303285,303288,0,3,4
86722,3,1,303288,303288,303289,0,1,0
86723,2,3,303290,303290,303293,0,3,1
86724,2,1,303292,303293,303294,1,2,0
86725,3,3,303295,303295,303298,0,3,1
86726,1,1,303296,303298,303299,2,3,0
86727,3,1,303299,303299,303300,0,1,0
86728,5,1,303304,303304,303305,0,1,4
86729,4,3,303308,303308,303311,0,3,3
86730,5,2,303313,303313,303315,0,2,2
86731,5,1,303318,303318,303319,0,1,3
86732,1,1,303319,303319,303320,0,1,0
86733,2,3,303321,303321,303324,0,3,1
86734,3,2,303324,303324,303326,0,2,0
86735,5,3,303329,303329,303332,0,3,3
86736,4,3,303333,303333,303336,0,3,1
86737,6,3,303339,303339,303342,0,3,3
86738,5,3,303344,303344,303347,0,3,2
86739,5,1,303349,303349,303350,0,1,2
86740,4,1,303353,303353,303354,0,1,3
86741,3,1,303356,303356,303357,0,1,2
86742,5,1,303361,303361,303362,0,1,4
86743,1,3,303362,303362,303365,0,3,0
86744,6,3,303368,303368,303371,0,3,3
86745,3,2,303371,303371,303373,0,2,0
86746,3,2,303374,303374,303376,0,2,1
86747,6,1,303380,303380,303381,0,1,4
86748,2,3,303382,303382,303385,0,3,1
86749,5,2,303387,303387,303389,0,2,2
86750,1,3,303388,303389,303392,1,4,0
86751,5,3,303393,303393,303396,0,3,1
86752,3,3,303396,303396,303399,0,3,0
86753,3,2,303399,303399,303401,0,2,0
86754,6,1,303405,303405,303406,0,1,4
86755,5,3,303410,303410,303413,0,3,4
86756,1,1,303411,303413,303414,2,3,0
86757,6,1,303417,303417,303418,0,1,3
86758,3,3,303420,303420,303423,0,3,2
86759,4,1,303424,303424,303425,0,1,1
86760,6,1,303430,303430,303431,0,1,5
86761,3,1,303433,303433,303434,0,1,2
86762,1,3,303434,303434,303437,0,3,0
86763,6,3,303440,303440,303443,0,3,3
86764,4,2,303444,303444,303446,0,2,1
86765,4,2,303448,303448,303450,0,2,2
86766,6,2,303454,303454,303456,0,2,4
86767,6,3,303460,303460,303463,0,3,4
86768,3,1,303463,303463,303464,0,1,0
86769,6,2,303469,303469,303471,0,2,5
86770,3,1,303472,303472,303473,0,1,1
86771,4,3,303476,303476,303479,0,3,3
86772,3,1,303479,303479,303480,0,1,0
86773,2,1,303481,303481,303482,0,1,1
86774,6,3,303487,303487,303490,0,3,5
86775,6,3,303493,303493,303496,0,3,3
86776,4,3,303497,303497,303500,0,3,1
86777,4,3,303501,303501,303504,0,3,1
86778,2,2,303503,303504,303506,1,3,0
86779,3,2,303506,303506,303508,0,2,0
86780,3,1,303509,303509,303510,0,1,1
86781,5,3,303514,303514,303517,0,3,4
86782,5,1,303519,303519,303520,0,1,2
86783,2,3,303521,303521,303524,0,3,1
86784,6,3,303527,303527,303530,0,3,3
86785,1,1,303528,303530,303531,2,3,0
86786,6,1,303534,303534,303535,0,1,3
86787,1,3,303535,303535,303538,0,3,0
86788,4,1,303539,303539,303540,0,1,1
86789,1,2,303540,303540,303542,0,2,0
86790,2,2,303542,303542,303544,0,2,0
86791,2,2,303544,303544,303546,0,2,0
86792,6,2,303550,303550,303552,0,2,4
86793,6,3,303556,303556,303559,0,3,4
86794,4,2,303560,303560,303562,0,2,1
86795,1,2,303561,303562,303564,1,3,0
86796,3,1,303564,303564,303565,0,1,0
86797,3,2,303567,303567,303569,0,2,2
86798,4,2,303571,303571,303573,0,2,2
86799,3,2,303574,303574,303576,0,2,1
86800,2,1,303576,303576,303577,0,1,0
86801,4,3,303580,303580,303583,0,3,3
86802,4,1,303584,303584,303585,0,1,1
86803,1,2,303585,303585,303587,0,2,0
86804,2,2,303587,303587,303589,0,2,0
86805,3,3,303590,303590,303593,0,3,1
86806,3,1,303593,303593,303594,0,1,0
86807,2,3,303595,303595,303598,0,3,1
86808,1,3,303596,303598,303601,2,5,0
86809,2,2,303598,303601,303603,3,5,0
86810,3,2,303601,303603,303605,2,4,0
86811,6,1,303607,303607,303608,0,1,2
86812,4,3,303611,303611,303614,0,3,3
86813,1,2,303612,303614,303616,2,4,0
86814,6,3,303618,303618,303621,0,3,2
86815,6,1,303624,303624,303625,0,1,3
86816,6,1,303630,303630,303631,0,1,5
86817,5,2,303635,303635,303637,0,2,4
86818,1,2,303636,303637,303639,1,3,0
86819,3,2,303639,303639,303641,0,2,0
86820,2,3,303641,303641,303644,0,3,0
86821,6,1,303647,303647,303648,0,1,3
86822,5,3,303652,303652,303655,0,3,4
86823,1,3,303653,303655,303658,2,5,0
86824,1,1,303654,303658,303659,4,5,0
86825,5,2,303659,303659,303661,0,2,0
86826,6,3,303665,303665,303668,0,3,4
86827,3,1,303668,303668,303669,0,1,0
86828,5,3,303673,303673,303676,0,3,4
86829,3,3,303676,303676,303679,0,3,0
86830,1,2,303677,303679,303681,2,4,0
86831,5,2,303682,303682,303684,0,2,1
86832,4,3,303686,303686,303689,0,3,2
86833,6,2,303692,303692,303694,0,2,3
86834,3,2,303695,303695,303697,0,2,1
86835,2,2,303697,303697,303699,0,2,0
86836,3,2,303700,303700,303702,0,2,1
86837,1,1,303701,303702,303703,1,2,0
86838,5,2,303706,303706,303708,0,2,3
86839,1,2,303707,303708,303710,1,3,0
86840,5,2,303712,303712,303714,0,2,2
86841,1,1,303713,303714,303715,1,2,0
86842,2,3,303715,303715,303718,0,3,0
86843,1,3,303716,303718,303721,2,5,0
86844,1,3,303717,303721,303724,4,7,0
86845,2,1,303719,303724,303725,5,6,0
86846,6,1,303725,303725,303726,0,1,0
86847,3,3,303728,303728,303731,0,3,2
86848,2,1,303730,303731,303732,1,2,0
86849,2,1,303732,303732,303733,0,1,0
86850,3,2,303735,303735,303737,0,2,2
86851,3,2,303738,303738,303740,0,2,1
86852,5,2,303743,303743,303745,0,2,3
86853,3,2,303746,303746,303748,0,2,1
86854,3,2,303749,303749,303751,0,2,1
86855,1,1,303750,303751,303752,1,2,0
86856,1,3,303751,303752,303755,1,4,0
86857,6,2,303757,303757,303759,0,2,2
86858,4,3,303761,303761,303764,0,3,2
86859,5,2,303766,303766,303768,0,2,2
86860,1,2,303767,303768,303770,1,3,0
86861,5,2,303772,303772,303774,0,2,2
86862,6,3,303778,303778,303781,0,3,4
86863,3,3,303781,303781,303784,0,3,0
86864,2,2,303783,303784,303786,1,3,0
86865,1,3,303784,303786,303789,2,5,0
86866,6,3,303790,303790,303793,0,3,1
86867,5,2,303795,303795,303797,0,2,2
86868,6,3,303801,303801,303804,0,3,4
86869,4,2,303805,303805,303807,0,2,1
86870,4,2,303809,303809,303811,0,2,2
86871,6,2,303815,303815,303817,0,2,4
86872,4,2,303819,303819,303821,0,2,2
86873,1,1,303820,303821,303822,1,2,0
86874,5,1,303825,303825,303826,0,1,3
86875,6,2,303831,303831,303833,0,2,5
86876,5,1,303836,303836,303837,0,1,3
86877,6,2,303842,303842,303844,0,2,5
86878,6,3,303848,303848,303851,0,3,4
86879,6,1,303854,303854,303855,0,1,3
86880,1,1,303855,303855,303856,0,1,0
86881,1,1,303856,303856,303857,0,1,0
86882,3,2,303859,303859,303861,0,2,2
86883,6,1,303865,303865,303866,0,1,4
86884,3,1,303868,303868,303869,0,1,2
86885,1,1,303869,303869,303870,0,1,0
86886,4,2,303873,303873,303875,0,2,3
86887,3,1,303876,303876,303877,0,1,1
86888,3,2,303879,303879,303881,0,2,2
86889,4,1,303883,303883,303884,0,1,2
86890,4,2,303887,303887,303889,0,2,3
86891,4,1,303891,303891,303892,0,1,2
86892,3,3,303894,303894,303897,0,3,2
86893,4,3,303898,303898,303901,0,3,1
86894,6,3,303904,303904,303907,0,3,3
86895,1,1,303905,303907,303908,2,3,0
86896,2,3,303907,303908,303911,1,4,0
86897,4,1,303911,303911,303912,0,1,0
86898,2,1,303913,303913,303914,0,1,1
86899,3,3,303916,303916,303919,0,3,2
86900,2,3,303918,303919,303922,1,4,0
86901,4,3,303922,303922,303925,0,3,0
86902,6,3,303928,303928,303931,0,3,3
86903,6,2,303934,303934,303936,0,2,3
86904,5,2,303939,303939,303941,0,2,3
86905,6,2,303945,303945,303947,0,2,4
86906,2,3,303947,303947,303950,0,3,0
86907,1,2,303948,303950,303952,2,4,0
86908,4,1,303952,303952,303953,0,1,0
86909,1,1,303953,303953,303954,0,1,0
86910,5,2,303958,303958,303960,0,2,4
86911,1,3,303959,303960,303963,1,4,0
86912,2,3,303961,303963,303966,2,5,0
86913,3,3,303964,303966,303969,2,5,0
86914,2,3,303966,303969,303972,3,6,0
86915,6,2,303972,303972,303974,0,2,0
86916,1,1,303973,303974,303975,1,2,0
86917,6,3,303979,303979,303982,0,3,4
86918,4,1,303983,303983,303984,0,1,1
86919,5,2,303988,303988,303990,0,2,4
86920,4,1,303992,303992,303993,0,1,2
86921,3,3,303995,303995,303998,0,3,2
86922,4,3,303999,303999,304002,0,3,1
86923,1,1,304000,304002,304003,2,3,0
86924,2,3,304002,304003,304006,1,4,0
86925,4,1,304006,304006,304007,0,1,0
86926,3,1,304009,304009,304010,0,1,2
86927,2,3,304011,304011,304014,0,3,1
86928,2,2,304013,304014,304016,1,3,0
86929,2,2,304015,304016,304018,1,3,0
86930,5,2,304020,304020,304022,0,2,2
86931,6,1,304026,304026,304027,0,1,4
86932,3,3,304029,304029,304032,0,3,2
86933,5,3,304034,304034,304037,0,3,2
86934,6,2,304040,304040,304042,0,2,3
86935,5,3,304045,304045,304048,0,3,3
86936,3,2,304048,304048,304050,0,2,0
86937,1,2,304049,304050,304052,1,3,0
86938,2,3,304051,304052,304055,1,4,0
86939,2,3,304053,304055,304058,2,5,0
86940,1,1,304054,304058,304059,4,5,0
86941,1,2,304055,304059,304061,4,6,0
86942,3,2,304058,304061,304063,3,5,0
86943,3,2,304061,304063,304065,2,4,0
86944,1,1,304062,304065,304066,3,4,0
86945,1,3,304063,304066,304069,3,6,0
86946,2,1,304065,304069,304070,4,5,0
86947,6,2,304071,304071,304073,0,2,1
86948,4,1,304075,304075,304076,0,1,2
86949,5,3,304080,304080,304083,0,3,4
86950,4,3,304084,304084,304087,0,3,1
86951,6,2,304090,304090,304092,0,2,3
86952,5,1,304095,304095,304096,0,1,3
86953,2,2,304097,304097,304099,0,2,1
86954,4,3,304101,304101,304104,0,3,2
86955,3,1,304104,304104,304105,0,1,0
86956,1,3,304105,304105,304108,0,3,0
86957,4,3,304109,304109,304112,0,3,1
86958,2,3,304111,304112,304115,1,4,0
86959,6,2,304117,304117,304119,0,2,2
86960,2,1,304119,304119,304120,0,1,0
86961,4,3,304123,304123,304126,0,3,3
86962,2,3,304125,304126,304129,1,4,0
86963,6,2,304131,304131,304133,0,2,2
86964,3,2,304134,304134,304136,0,2,1
86965,6,3,304140,304140,304143,0,3,4
86966,6,3,304146,304146,304149,0,3,3
86967,6,1,304152,304152,304153,0,1,3
86968,3,1,304155,304155,304156,0,1,2
86969,4,2,304159,304159,304161,0,2,3
86970,1,1,304160,304161,304162,1,2,0
86971,3,3,304163,304163,304166,0,3,1
86972,4,1,304167,304167,304168,0,1,1
86973,5,3,304172,304172,304175,0,3,4
86974,5,3,304177,304177,304180,0,3,2
86975,5,3,304182,304182,304185,0,3,2
86976,5,3,304187,304187,304190,0,3,2
86977,4,1,304191,304191,304192,0,1,1
86978,1,2,304192,304192,304194,0,2,0
86979,5,3,304197,304197,304200,0,3,3
86980,6,1,304203,304203,304204,0,1,3
86981,2,1,304205,304205,304206,0,1,1
86982,5,3,304210,304210,304213,0,3,4
86983,2,2,304212,304213,304215,1,3,0
86984,2,2,304214,304215,304217,1,3,0
86985,1,3,304215,304217,304220,2,5,0
86986,3,2,304218,304220,304222,2,4,0
86987,6,3,304224,304224,304227,0,3,2
86988,6,3,304230,304230,304233,0,3,3
86989,6,2,304236,304236,304238,0,2,3
86990,1,3,304237,304238,304241,1,4,0
86991,3,1,304240,304241,304242,1,2,0
86992,1,2,304241,304242,304244,1,3,0
86993,5,3,304246,304246,304249,0,3,2
86994,2,1,304248,304249,304250,1,2,0
86995,3,3,304251,304251,304254,0,3,1
86996,6,3,304257,304257,304260,0,3,3
86997,3,1,304260,304260,304261,0,1,0
86998,1,1,304261,304261,304262,0,1,0
86999,6,2,304267,304267,304269,0,2,5
87000,2,3,304269,304269,304272,0,3,0
87001,6,1,304275,304275,304276,0,1,3
87002,6,3,304281,304281,304284,0,3,5
87003,3,1,304284,304284,304285,0,1,0
87004,4,1,304288,304288,304289,0,1,3
87005,1,3,304289,304289,304292,0,3,0
87006,4,2,304293,304293,304295,0,2,1
87007,3,3,304296,304296,304299,0,3,1
87008,2,1,304298,304299,304300,1,2,0
87009,5,3,304303,304303,304306,0,3,3
87010,6,2,304309,304309,304311,0,2,3
87011,2,2,304311,304311,304313,0,2,0
87012,6,2,304317,304317,304319,0,2,4
87013,6,1,304323,304323,304324,0,1,4
87014,6,2,304329,304329,304331,0,2,5
87015,2,2,304331,304331,304333,0,2,0
87016,4,3,304335,304335,304338,0,3,2
87017,5,1,304340,304340,304341,0,1,2
87018,6,1,304346,304346,304347,0,1,5
87019,6,1,304352,304352,304353,0,1,5
87020,1,1,304353,304353,304354,0,1,0
87021,2,1,304355,304355,304356,0,1,1
87022,3,3,304358,304358,304361,0,3,2
87023,6,3,304364,304364,304367,0,3,3
87024,4,1,304368,304368,304369,0,1,1
87025,2,3,304370,304370,304373,0,3,1
87026,4,3,304374,304374,304377,0,3,1
87027,6,1,304380,304380,304381,0,1,3
87028,6,3,304386,304386,304389,0,3,5
87029,2,1,304388,304389,304390,1,2,0
87030,1,1,304389,304390,304391,1,2,0
87031,2,1,304391,304391,304392,0,1,0
87032,6,3,304397,304397,304400,0,3,5
87033,4,1,304401,304401,304402,0,1,1
87034,4,2,304405,304405,304407,0,2,3
87035,3,1,304408,304408,304409,0,1,1
87036,2,2,304410,304410,304412,0,2,1
87037,6,3,304416,304416,304419,0,3,4
87038,2,2,304418,304419,304421,1,3,0
87039,1,2,304419,304421,304423,2,4,0
87040,6,2,304425,304425,304427,0,2,2
87041,6,2,304431,304431,304433,0,2,4
87042,6,1,304437,304437,304438,0,1,4
87043,6,3,304443,304443,304446,0,3,5
87044,4,1,304447,304447,304448,0,1,1
87045,6,2,304453,304453,304455,0,2,5
87046,3,1,304456,304456,304457,0,1,1
87047,1,3,304457,304457,304460,0,3,0
87048,4,3,304461,304461,304464,0,3,1
87049,5,3,304466,304466,304469,0,3,2
87050,3,1,304469,304469,304470,0,1,0
87051,6,1,304475,304475,304476,0,1,5
87052,6,3,304481,304481,304484,0,3,5
87053,2,3,304483,304484,304487,1,4,0
87054,4,1,304487,304487,304488,0,1,0
87055,1,1,304488,304488,304489,0,1,0
87056,3,3,304491,304491,304494,0,3,2
87057,1,3,304492,304494,304497,2,5,0
87058,2,1,304494,304497,304498,3,4,0
87059,4,2,304498,304498,304500,0,2,0
87060,1,2,304499,304500,304502,1,3,0
87061,3,3,304502,304502,304505,0,3,0
87062,2,3,304504,304505,304508,1,4,0
87063,2,3,304506,304508,304511,2,5,0
87064,3,3,304509,304511,304514,2,5,0
87065,1,1,304510,304514,304515,4,5,0
87066,5,3,304515,304515,304518,0,3,0
87067,4,2,304519,304519,304521,0,2,1
87068,6,3,304525,304525,304528,0,3,4
87069,1,1,304526,304528,304529,2,3,0
87070,3,1,304529,304529,304530,0,1,0
87071,2,3,304531,304531,304534,0,3,1
87072,5,3,304536,304536,304539,0,3,2
87073,3,3,304539,304539,304542,0,3,0
87074,3,2,304542,304542,304544,0,2,0
87075,4,3,304546,304546,304549,0,3,2
87076,6,2,304552,304552,304554,0,2,3
87077,6,3,304558,304558,304561,0,3,4
87078,2,1,304560,304561,304562,1,2,0
87079,2,1,304562,304562,304563,0,1,0
87080,5,2,304567,304567,304569,0,2,4
87081,2,2,304569,304569,304571,0,2,0
87082,6,1,304575,304575,304576,0,1,4
87083,2,1,304577,304577,304578,0,1,1
87084,2,2,304579,304579,304581,0,2,1
87085,2,1,304581,304581,304582,0,1,0
87086,2,1,304583,304583,304584,0,1,1
87087,4,3,304587,304587,304590,0,3,3
87088,3,2,304590,304590,304592,0,2,0
87089,2,2,304592,304592,304594,0,2,0
87090,1,2,304593,304594,304596,1,3,0
87091,6,1,304599,304599,304600,0,1,3
87092,3,1,304602,304602,304603,0,1,2
87093,2,2,304604,304604,304606,0,2,1
87094,3,3,304607,304607,304610,0,3,1
87095,3,3,304610,304610,304613,0,3,0
87096,2,3,304612,304613,304616,1,4,0
87097,1,1,304613,304616,304617,3,4,0
87098,1,3,304614,304617,304620,3,6,0
87099,2,3,304616,304620,304623,4,7,0
87100,3,1,304619,304623,304624,4,5,0
87101,2,1,304621,304624,304625,3,4,0
87102,4,1,304625,304625,304626,0,1,0
87103,1,2,304626,304626,304628,0,2,0
87104,2,1,304628,304628,304629,0,1,0
87105,2,2,304630,304630,304632,0,2,1
87106,4,3,304634,304634,304637,0,3,2
87107,6,3,304640,304640,304643,0,3,3
87108,3,3,304643,304643,304646,0,3,0
87109,4,3,304647,304647,304650,0,3,1
87110,3,2,304650,304650,304652,0,2,0
87111,4,1,304654,304654,304655,0,1,2
87112,5,1,304659,304659,304660,0,1,4
87113,1,3,304660,304660,304663,0,3,0
87114,2,2,304662,304663,304665,1,3,0
87115,6,1,304668,304668,304669,0,1,3
87116,5,2,304673,304673,304675,0,2,4
87117,4,1,304677,304677,304678,0,1,2
87118,1,2,304678,304678,304680,0,2,0
87119,2,3,304680,304680,304683,0,3,0
87120,6,3,304686,304686,304689,0,3,3
87121,3,3,304689,304689,304692,0,3,0
87122,4,2,304693,304693,304695,0,2,1
87123,2,1,304695,304695,304696,0,1,0
87124,1,3,304696,304696,304699,0,3,0
87125,4,2,304700,304700,304702,0,2,1
87126,4,3,304704,304704,304707,0,3,2
87127,5,1,304709,304709,304710,0,1,2
87128,3,1,304712,304712,304713,0,1,2
87129,2,1,304714,304714,304715,0,1,1
87130,1,3,304715,304715,304718,0,3,0
87131,5,2,304720,304720,304722,0,2,2
87132,5,3,304725,304725,304728,0,3,3
87133,4,3,304729,304729,304732,0,3,1
87134,3,2,304732,304732,304734,0,2,0
87135,6,1,304738,304738,304739,0,1,4
87136,1,2,304739,304739,304741,0,2,0
87137,4,2,304743,304743,304745,0,2,2
87138,3,2,304746,304746,304748,0,2,1
87139,3,3,304749,304749,304752,0,3,1
87140,5,1,304754,304754,304755,0,1,2
87141,6,3,304760,304760,304763,0,3,5
87142,5,2,304765,304765,304767,0,2,2
87143,4,3,304769,304769,304772,0,3,2
87144,6,1,304775,304775,304776,0,1,3
87145,2,1,304777,304777,304778,0,1,1
87146,4,1,304781,304781,304782,0,1,3
87147,6,2,304787,304787,304789,0,2,5
87148,4,3,304791,304791,304794,0,3,2
87149,5,1,304796,304796,304797,0,1,2
87150,3,3,304799,304799,304802,0,3,2
87151,4,2,304803,304803,304805,0,2,1
87152,5,2,304808,304808,304810,0,2,3
87153,1,1,304809,304810,304811,1,2,0
87154,1,3,304810,304811,304814,1,4,0
87155,1,3,304811,304814,304817,3,6,0
87156,3,3,304814,304817,304820,3,6,0
87157,5,2,304819,304820,304822,1,3,0
87158,4,1,304823,304823,304824,0,1,1
87159,1,2,304824,304824,304826,0,2,0
87160,2,1,304826,304826,304827,0,1,0
87161,6,1,304832,304832,304833,0,1,5
87162,1,1,304833,304833,304834,0,1,0
87163,3,2,304836,304836,304838,0,2,2
87164,3,3,304839,304839,304842,0,3,1
87165,4,1,304843,304843,304844,0,1,1
87166,4,1,304847,304847,304848,0,1,3
87167,3,3,304850,304850,304853,0,3,2
87168,2,1,304852,304853,304854,1,2,0
87169,5,3,304857,304857,304860,0,3,3
87170,6,3,304863,304863,304866,0,3,3
87171,2,2,304865,304866,304868,1,3,0
87172,1,2,304866,304868,304870,2,4,0
87173,6,2,304872,304872,304874,0,2,2
87174,6,2,304878,304878,304880,0,2,4
87175,3,1,304881,304881,304882,0,1,1
87176,5,2,304886,304886,304888,0,2,4
87177,5,3,304891,304891,304894,0,3,3
87178,6,2,304897,304897,304899,0,2,3
87179,5,2,304902,304902,304904,0,2,3
87180,3,1,304905,304905,304906,0,1,1
87181,2,2,304907,304907,304909,0,2,1
87182,6,2,304913,304913,304915,0,2,4
87183,2,1,304915,304915,304916,0,1,0
87184,4,2,304919,304919,304921,0,2,3
87185,3,2,304922,304922,304924,0,2,1
87186,2,2,304924,304924,304926,0,2,0
87187,1,1,304925,304926,304927,1,2,0
87188,1,3,304926,304927,304930,1,4,0
87189,5,3,304931,304931,304934,0,3,1
87190,4,3,304935,304935,304938,0,3,1
87191,2,3,304937,304938,304941,1,4,0
87192,5,3,304942,304942,304945,0,3,1
87193,6,2,304948,304948,304950,0,2,3
87194,1,1,304949,304950,304951,1,2,0
87195,3,2,304952,304952,304954,0,2,1
87196,6,1,304958,304958,304959,0,1,4
87197,5,2,304963,304963,304965,0,2,4
87198,2,2,304965,304965,304967,0,2,0
87199,6,2,304971,304971,304973,0,2,4
87200,1,2,304972,304973,304975,1,3,0
87201,6,2,304978,304978,304980,0,2,3
87202,1,1,304979,304980,304981,1,2,0
87203,4,3,304983,304983,304986,0,3,2
87204,5,1,304988,304988,304989,0,1,2
87205,1,1,304989,304989,304990,0,1,0
87206,5,3,304994,304994,304997,0,3,4
87207,2,3,304996,304997,305000,1,4,0
87208,2,3,304998,305000,305003,2,5,0
87209,3,1,305001,305003,305004,2,3,0
87210,5,2,305006,305006,305008,0,2,2
87211,5,1,305011,305011,305012,0,1,3
87212,3,3,305014,305014,305017,0,3,2
87213,2,1,305016,305017,305018,1,2,0
87214,3,1,305019,305019,305020,0,1,1
87215,1,1,305020,305020,305021,0,1,0
87216,3,3,305023,305023,305026,0,3,2
87217,6,2,305029,305029,305031,0,2,3
87218,1,1,305030,305031,305032,1,2,0
87219,3,2,305033,305033,305035,0,2,1
87220,4,2,305037,305037,305039,0,2,2
87221,3,2,305040,305040,305042,0,2,1
87222,4,3,305044,305044,305047,0,3,2
87223,3,1,305047,305047,305048,0,1,0
87224,2,1,305049,305049,305050,0,1,1
87225,3,2,305052,305052,305054,0,2,2
87226,2,1,305054,305054,305055,0,1,0
87227,2,1,305056,305056,305057,0,1,1
87228,1,1,305057,305057,305058,0,1,0
87229,4,1,305061,305061,305062,0,1,3
87230,4,3,305065,305065,305068,0,3,3
87231,3,1,305068,305068,305069,0,1,0
87232,1,1,305069,305069,305070,0,1,0
87233,2,2,305071,305071,305073,0,2,1
87234,6,2,305077,305077,305079,0,2,4
87235,2,2,305079,305079,305081,0,2,0
87236,5,1,305084,305084,305085,0,1,3
87237,1,3,305085,305085,305088,0,3,0
87238,3,2,305088,305088,305090,0,2,0
87239,6,2,305094,305094,305096,0,2,4
87240,2,2,305096,305096,305098,0,2,0
87241,4,1,305100,305100,305101,0,1,2
87242,3,2,305103,305103,305105,0,2,2
87243,1,1,305104,305105,305106,1,2,0
87244,5,1,305109,305109,305110,0,1,3
87245,1,1,305110,305110,305111,0,1,0
87246,4,2,305114,305114,305116,0,2,3
87247,5,1,305119,305119,305120,0,1,3
87248,3,1,305122,305122,305123,0,1,2
87249,6,1,305128,305128,305129,0,1,5
87250,1,1,305129,305129,305130,0,1,0
87251,6,2,305135,305135,305137,0,2,5
87252,2,1,305137,305137,305138,0,1,0
87253,1,3,305138,305138,305141,0,3,0
87254,6,2,305144,305144,305146,0,2,3
87255,6,3,305150,305150,305153,0,3,4
87256,3,1,305153,305153,305154,0,1,0
87257,4,1,305157,305157,305158,0,1,3
87258,3,1,305160,305160,305161,0,1,2
87259,3,3,305163,305163,305166,0,3,2
87260,2,2,305165,305166,305168,1,3,0
87261,1,2,305166,305168,305170,2,4,0
87262,3,3,305169,305170,305173,1,4,0
87263,6,1,305175,305175,305176,0,1,2
87264,1,1,305176,305176,305177,0,1,0
87265,1,2,305177,305177,305179,0,2,0
87266,4,2,305181,305181,305183,0,2,2
87267,3,1,305184,305184,305185,0,1,1
87268,2,2,305186,305186,305188,0,2,1
87269,4,2,305190,305190,305192,0,2,2
87270,1,2,305191,305192,305194,1,3,0
87271,1,3,305192,305194,305197,2,5,0
87272,1,1,305193,305197,305198,4,5,0
87273,1,3,305194,305198,305201,4,7,0
87274,1,3,305195,305201,305204,6,9,0
87275,2,3,305197,305204,305207,7,10,0
87276,5,1,305202,305207,305208,5,6,0
87277,2,1,305204,305208,305209,4,5,0
87278,6,2,305210,305210,305212,0,2,1
87279,4,3,305214,305214,305217,0,3,2
87280,2,2,305216,305217,305219,1,3,0
87281,3,3,305219,305219,305222,0,3,0
87282,6,3,305225,305225,305228,0,3,3
87283,3,1,305228,305228,305229,0,1,0
87284,3,3,305231,305231,305234,0,3,2
87285,2,1,305233,305234,305235,1,2,0
87286,4,3,305237,305237,305240,0,3,2
87287,4,1,305241,305241,305242,0,1,1
87288,2,3,305243,305243,305246,0,3,1
87289,6,3,305249,305249,305252,0,3,3
87290,3,1,305252,305252,305253,0,1,0
87291,5,1,305257,305257,305258,0,1,4
87292,2,3,305259,305259,305262,0,3,1
87293,5,3,305264,305264,305267,0,3,2
87294,4,1,305268,305268,305269,0,1,1
87295,2,3,305270,305270,305273,0,3,1
87296,3,3,305273,305273,305276,0,3,0
87297,5,2,305278,305278,305280,0,2,2
87298,1,1,305279,305280,305281,1,2,0
87299,3,3,305282,305282,305285,0,3,1
87300,3,3,305285,305285,305288,0,3,0
87301,4,3,305289,305289,305292,0,3,1
87302,2,2,305291,305292,305294,1,3,0
87303,1,1,305292,305294,305295,2,3,0
87304,2,2,305294,305295,305297,1,3,0
87305,4,1,305298,305298,305299,0,1,1
87306,3,3,305301,305301,305304,0,3,2
87307,5,3,305306,305306,305309,0,3,2
87308,6,3,305312,305312,305315,0,3,3
87309,6,1,305318,305318,305319,0,1,3
87310,4,1,305322,305322,305323,0,1,3
87311,5,3,305327,305327,305330,0,3,4
87312,3,3,305330,305330,305333,0,3,0
87313,3,1,305333,305333,305334,0,1,0
87314,6,2,305339,305339,305341,0,2,5
87315,4,1,305343,305343,305344,0,1,2
87316,5,3,305348,305348,305351,0,3,4
87317,6,2,305354,305354,305356,0,2,3
87318,2,1,305356,305356,305357,0,1,0
87319,5,2,305361,305361,305363,0,2,4
87320,2,2,305363,305363,305365,0,2,0
87321,6,3,305369,305369,305372,0,3,4
87322,1,2,305370,305372,305374,2,4,0
87323,6,2,305376,305376,305378,0,2,2
87324,3,2,305379,305379,305381,0,2,1
87325,1,1,305380,305381,305382,1,2,0
87326,2,2,305382,305382,305384,0,2,0
87327,4,2,305386,305386,305388,0,2,2
87328,1,2,305387,305388,305390,1,3,0
87329,3,2,305390,305390,305392,0,2,0
87330,5,1,305395,305395,305396,0,1,3
87331,5,1,305400,305400,305401,0,1,4
87332,3,2,305403,305403,305405,0,2,2
87333,4,1,305407,305407,305408,0,1,2
87334,1,2,305408,305408,305410,0,2,0
87335,1,1,305409,305410,305411,1,2,0
87336,5,1,305414,305414,305415,0,1,3
87337,2,2,305416,305416,305418,0,2,1
87338,2,3,305418,305418,305421,0,3,0
87339,2,3,305420,305421,305424,1,4,0
87340,6,1,305426,305426,305427,0,1,2
87341,1,2,305427,305427,305429,0,2,0
87342,1,3,305428,305429,305432,1,4,0
87343,1,1,305429,305432,305433,3,4,0
87344,4,3,305433,305433,305436,0,3,0
87345,4,3,305437,305437,305440,0,3,1
87346,2,3,305439,305440,305443,1,4,0
87347,2,1,305441,305443,305444,2,3,0
87348,1,1,305442,305444,305445,2,3,0
87349,5,2,305447,305447,305449,0,2,2
87350,5,3,305452,305452,305455,0,3,3
87351,5,1,305457,305457,305458,0,1,2
87352,4,3,305461,305461,305464,0,3,3
87353,5,1,305466,305466,305467,0,1,2
87354,1,3,305467,305467,305470,0,3,0
87355,1,1,305468,305470,305471,2,3,0
87356,6,1,305474,305474,305475,0,1,3
87357,5,1,305479,305479,305480,0,1,4
87358,6,3,305485,305485,305488,0,3,5
87359,2,2,305487,305488,305490,1,3,0
87360,6,2,305493,305493,305495,0,2,3
87361,4,3,305497,305497,305500,0,3,2
87362,3,1,305500,305500,305501,0,1,0
87363,3,1,305503,305503,305504,0,1,2
87364,4,2,305507,305507,305509,0,2,3
87365,1,3,305508,305509,305512,1,4,0
87366,5,2,305513,305513,305515,0,2,1
87367,4,1,305517,305517,305518,0,1,2
87368,5,1,305522,305522,305523,0,1,4
87369,5,3,305527,305527,305530,0,3,4
87370,5,1,305532,305532,305533,0,1,2
87371,4,3,305536,305536,305539,0,3,3
87372,5,2,305541,305541,305543,0,2,2
87373,1,2,305542,305543,305545,1,3,0
87374,5,1,305547,305547,305548,0,1,2
87375,6,2,305553,305553,305555,0,2,5
87376,1,1,305554,305555,305556,1,2,0
87377,3,3,305557,305557,305560,0,3,1
87378,5,1,305562,305562,305563,0,1,2
87379,6,1,305568,305568,305569,0,1,5
87380,5,2,305573,305573,305575,0,2,4
87381,2,2,305575,305575,305577,0,2,0
87382,5,1,305580,305580,305581,0,1,3
87383,6,3,305586,305586,305589,0,3,5
87384,1,2,305587,305589,305591,2,4,0
87385,3,1,305590,305591,305592,1,2,0
87386,1,3,305591,305592,305595,1,4,0
87387,1,3,305592,305595,305598,3,6,0
87388,4,2,305596,305598,305600,2,4,0
87389,5,1,305601,305601,305602,0,1,1
87390,3,3,305604,305604,305607,0,3,2
87391,3,1,305607,305607,305608,0,1,0
87392,4,2,305611,305611,305613,0,2,3
87393,4,1,305615,305615,305616,0,1,2
87394,1,1,305616,305616,305617,0,1,0
87395,2,2,305618,305618,305620,0,2,1
87396,5,1,305623,305623,305624,0,1,3
87397,2,2,305625,305625,305627,0,2,1
87398,2,2,305627,305627,305629,0,2,0
87399,2,3,305629,305629,305632,0,3,0
87400,5,1,305634,305634,305635,0,1,2
87401,6,2,305640,305640,305642,0,2,5
87402,4,2,305644,305644,305646,0,2,2
87403,6,3,305650,305650,305653,0,3,4
87404,2,3,305652,305653,305656,1,4,0
87405,6,3,305658,305658,305661,0,3,2
87406,6,1,305664,305664,305665,0,1,3
87407,2,3,305666,305666,305669,0,3,1
87408,3,1,305669,305669,305670,0,1,0
87409,3,3,305672,305672,305675,0,3,2
87410,5,1,305677,305677,305678,0,1,2
87411,1,3,305678,305678,305681,0,3,0
87412,6,2,305684,305684,305686,0,2,3
87413,5,1,305689,305689,305690,0,1,3
87414,1,1,305690,305690,305691,0,1,0
87415,1,3,305691,305691,305694,0,3,0
87416,3,3,305694,305694,305697,0,3,0
87417,5,3,305699,305699,305702,0,3,2
87418,2,2,305701,305702,305704,1,3,0
87419,1,3,305702,305704,305707,2,5,0
87420,1,2,305703,305707,305709,4,6,0
87421,1,1,305704,305709,305710,5,6,0
87422,4,1,305708,305710,305711,2,3,0
87423,4,2,305712,305712,305714,0,2,1
87424,3,2,305715,305715,305717,0,2,1
87425,2,3,305717,305717,305720,0,3,0
87426,5,1,305722,305722,305723,0,1,2
87427,6,1,305728,305728,305729,0,1,5
87428,6,1,305734,305734,305735,0,1,5
87429,5,1,305739,305739,305740,0,1,4
87430,4,3,305743,305743,305746,0,3,3
87431,5,3,305748,305748,305751,0,3,2
87432,6,1,305754,305754,305755,0,1,3
87433,5,1,305759,305759,305760,0,1,4
87434,1,1,305760,305760,305761,0,1,0
87435,3,1,305763,305763,305764,0,1,2
87436,1,1,305764,305764,305765,0,1,0
87437,2,3,305766,305766,305769,0,3,1
87438,5,2,305771,305771,305773,0,2,2
87439,3,1,305774,305774,305775,0,1,1
87440,2,2,305776,305776,305778,0,2,1
87441,1,1,305777,305778,305779,1,2,0
87442,6,2,305783,305783,305785,0,2,4
87443,1,1,305784,305785,305786,1,2,0
87444,6,3,305790,305790,305793,0,3,4
87445,3,3,305793,305793,305796,0,3,0
87446,1,1,305794,305796,305797,2,3,0
87447,4,3,305798,305798,305801,0,3,1
87448,1,3,305799,305801,305804,2,5,0
87449,6,3,305805,305805,305808,0,3,1
87450,3,1,305808,305808,305809,0,1,0
87451,3,1,305811,305811,305812,0,1,2
87452,1,1,305812,305812,305813,0,1,0
87453,3,1,305815,305815,305816,0,1,2
87454,6,1,305821,305821,305822,0,1,5
87455,3,1,305824,305824,305825,0,1,2
87456,3,1,305827,305827,305828,0,1,2
87457,2,3,305829,305829,305832,0,3,1
87458,5,3,305834,305834,305837,0,3,2
87459,4,2,305838,305838,305840,0,2,1
87460,2,1,305840,305840,305841,0,1,0
87461,2,3,305842,305842,305845,0,3,1
87462,1,2,305843,305845,305847,2,4,0
87463,6,2,305849,305849,305851,0,2,2
87464,2,1,305851,305851,305852,0,1,0
87465,2,3,305853,305853,305856,0,3,1
87466,3,1,305856,305856,305857,0,1,0
87467,1,1,305857,305857,305858,0,1,0
87468,3,2,305860,305860,305862,0,2,2
87469,2,2,305862,305862,305864,0,2,0
87470,1,3,305863,305864,305867,1,4,0
87471,1,3,305864,305867,305870,3,6,0
87472,2,3,305866,305870,305873,4,7,0
87473,1,1,305867,305873,305874,6,7,0
87474,6,3,305873,305874,305877,1,4,0
87475,5,2,305878,305878,305880,0,2,1
87476,4,1,305882,305882,305883,0,1,2
87477,1,2,305883,305883,305885,0,2,0
87478,3,3,305886,305886,305889,0,3,1
87479,5,2,305891,305891,305893,0,2,2
87480,5,1,305896,305896,305897,0,1,3
87481,1,1,305897,305897,305898,0,1,0
87482,4,3,305901,305901,305904,0,3,3
87483,1,2,305902,305904,305906,2,4,0
87484,3,1,305905,305906,305907,1,2,0
87485,4,1,305909,305909,305910,0,1,2
87486,2,2,305911,305911,305913,0,2,1
87487,6,2,305917,305917,305919,0,2,4
87488,6,2,305923,305923,305925,0,2,4
87489,2,3,305925,305925,305928,0,3,0
87490,2,3,305927,305928,305931,1,4,0
87491,4,1,305931,305931,305932,0,1,0
87492,2,3,305933,305933,305936,0,3,1
87493,4,1,305937,305937,305938,0,1,1
87494,1,1,305938,305938,305939,0,1,0
87495,5,3,305943,305943,305946,0,3,4
87496,2,2,305945,305946,305948,1,3,0
87497,6,2,305951,305951,305953,0,2,3
87498,2,1,305953,305953,305954,0,1,0
87499,4,1,305957,305957,305958,0,1,3
87500,6,1,305963,305963,305964,0,1,5
87501,5,2,305968,305968,305970,0,2,4
87502,6,1,305974,305974,305975,0,1,4
87503,3,3,305977,305977,305980,0,3,2
87504,4,3,305981,305981,305984,0,3,1
87505,5,2,305986,305986,305988,0,2,2
87506,1,3,305987,305988,305991,1,4,0
87507,4,2,305991,305991,305993,0,2,0
87508,4,2,305995,305995,305997,0,2,2
87509,5,1,306000,306000,306001,0,1,3
87510,6,2,306006,306006,306008,0,2,5
87511,2,1,306008,306008,306009,0,1,0
87512,5,1,306013,306013,306014,0,1,4
87513,6,1,306019,306019,306020,0,1,5
87514,6,3,306025,306025,306028,0,3,5
87515,3,3,306028,306028,306031,0,3,0
87516,1,1,306029,306031,306032,2,3,0
87517,6,1,306035,306035,306036,0,1,3
87518,1,2,306036,306036,306038,0,2,0
87519,2,2,306038,306038,306040,0,2,0
87520,4,2,306042,306042,306044,0,2,2
87521,2,2,306044,306044,306046,0,2,0
87522,2,1,306046,306046,306047,0,1,0
87523,3,1,306049,306049,306050,0,1,2
87524,4,2,306053,306053,306055,0,2,3
87525,6,2,306059,306059,306061,0,2,4
87526,3,2,306062,306062,306064,0,2,1
87527,1,1,306063,306064,306065,1,2,0
87528,3,3,306066,306066,306069,0,3,1
87529,1,2,306067,306069,306071,2,4,0
87530,3,2,306070,306071,306073,1,3,0
87531,3,3,306073,306073,306076,0,3,0
87532,3,1,306076,306076,306077,0,1,0
87533,2,3,306078,306078,306081,0,3,1
87534,2,3,306080,306081,306084,1,4,0
87535,1,3,306081,306084,306087,3,6,0
87536,6,3,306087,306087,306090,0,3,0
87537,1,1,306088,306090,306091,2,3,0
87538,5,3,306093,306093,306096,0,3,2
87539,1,1,306094,306096,306097,2,3,0
87540,4,3,306098,306098,306101,0,3,1
87541,4,3,306102,306102,306105,0,3,1
87542,1,1,306103,306105,306106,2,3,0
87543,4,1,306107,306107,306108,0,1,1
87544,1,1,306108,306108,306109,0,1,0
87545,3,1,306111,306111,306112,0,1,2
87546,1,1,306112,306112,306113,0,1,0
87547,2,2,306114,306114,306116,0,2,1
87548,1,2,306115,306116,306118,1,3,0
87549,5,3,306120,306120,306123,0,3,2
87550,2,2,306122,306123,306125,1,3,0
87551,3,2,306125,306125,306127,0,2,0
87552,1,1,306126,306127,306128,1,2,0
87553,4,3,306130,306130,306133,0,3,2
87554,2,3,306132,306133,306136,1,4,0
87555,4,3,306136,306136,306139,0,3,0
87556,5,2,306141,306141,306143,0,2,2
87557,1,3,306142,306143,306146,1,4,0
87558,2,3,306144,306146,306149,2,5,0
87559,3,1,306147,306149,306150,2,3,0
87560,2,2,306149,306150,306152,1,3,0
87561,4,2,306153,306153,306155,0,2,1
87562,6,1,306159,306159,306160,0,1,4
87563,4,2,306163,306163,306165,0,2,3
87564,2,3,306165,306165,306168,0,3,0
87565,1,3,306166,306168,306171,2,5,0
87566,3,3,306169,306171,306174,2,5,0
87567,5,3,306174,306174,306177,0,3,0
87568,3,2,306177,306177,306179,0,2,0
87569,4,2,306181,306181,306183,0,2,2
87570,4,3,306185,306185,306188,0,3,2
87571,5,3,306190,306190,306193,0,3,2
87572,4,2,306194,306194,306196,0,2,1
87573,5,3,306199,306199,306202,0,3,3
87574,2,2,306201,306202,306204,1,3,0
87575,1,1,306202,306204,306205,2,3,0
87576,5,3,306207,306207,306210,0,3,2
87577,5,1,306212,306212,306213,0,1,2
87578,5,1,306217,306217,306218,0,1,4
87579,6,2,306223,306223,306225,0,2,5
87580,2,2,306225,306225,306227,0,2,0
87581,6,2,306231,306231,306233,0,2,4
87582,1,2,306232,306233,306235,1,3,0
87583,4,3,306236,306236,306239,0,3,1
87584,4,2,306240,306240,306242,0,2,1
87585,6,2,306246,306246,306248,0,2,4
87586,3,2,306249,306249,306251,0,2,1
87587,4,1,306253,306253,306254,0,1,2
87588,1,1,306254,306254,306255,0,1,0
87589,6,2,306260,306260,306262,0,2,5
87590,4,3,306264,306264,306267,0,3,2
87591,4,2,306268,306268,306270,0,2,1
87592,5,2,306273,306273,306275,0,2,3
87593,2,3,306275,306275,306278,0,3,0
87594,2,1,306277,306278,306279,1,2,0
87595,3,1,306280,306280,306281,0,1,1
87596,3,2,306283,306283,306285,0,2,2
87597,6,1,306289,306289,306290,0,1,4
87598,4,1,306293,306293,306294,0,1,3
87599,3,2,306296,306296,306298,0,2,2
87600,4,3,306300,306300,306303,0,3,2
87601,3,2,306303,306303,306305,0,2,0
87602,5,2,306308,306308,306310,0,2,3
87603,5,3,306313,306313,306316,0,3,3
87604,2,1,306315,306316,306317,1,2,0
87605,4,2,306319,306319,306321,0,2,2
87606,6,3,306325,306325,306328,0,3,4
87607,6,1,306331,306331,306332,0,1,3
87608,5,2,306336,306336,306338,0,2,4
87609,1,2,306337,306338,306340,1,3,0
87610,6,1,306343,306343,306344,0,1,3
87611,6,2,306349,306349,306351,0,2,5
87612,1,2,306350,306351,306353,1,3,0
87613,6,3,306356,306356,306359,0,3,3
87614,1,3,306357,306359,306362,2,5,0
87615,3,1,306360,306362,306363,2,3,0
87616,4,2,306364,306364,306366,0,2,1
87617,2,3,306366,306366,306369,0,3,0
87618,5,3,306371,306371,306374,0,3,2
87619,5,1,306376,306376,306377,0,1,2
87620,2,1,306378,306378,306379,0,1,1
87621,2,1,306380,306380,306381,0,1,1
87622,5,1,306385,306385,306386,0,1,4
87623,5,1,306390,306390,306391,0,1,4
87624,1,2,306391,306391,306393,0,2,0
87625,2,1,306393,306393,306394,0,1,0
87626,4,1,306397,306397,306398,0,1,3
87627,6,3,306403,306403,306406,0,3,5
87628,1,2,306404,306406,306408,2,4,0
87629,5,1,306409,306409,306410,0,1,1
87630,4,2,306413,306413,306415,0,2,3
87631,6,1,306419,306419,306420,0,1,4
87632,4,2,306423,306423,306425,0,2,3
87633,3,3,306426,306426,306429,0,3,1
87634,3,2,306429,306429,306431,0,2,0
87635,5,3,306434,306434,306437,0,3,3
87636,6,3,306440,306440,306443,0,3,3
87637,1,2,306441,306443,306445,2,4,0
87638,1,3,306442,306445,306448,3,6,0
87639,5,3,306447,306448,306451,1,4,0
87640,1,2,306448,306451,306453,3,5,0
87641,3,2,306451,306453,306455,2,4,0
87642,3,3,306454,306455,306458,1,4,0
87643,6,1,306460,306460,306461,0,1,2
87644,4,1,306464,306464,306465,0,1,3
87645,1,2,306465,306465,306467,0,2,0
87646,3,2,306468,306468,306470,0,2,1
87647,5,3,306473,306473,306476,0,3,3
87648,6,1,306479,306479,306480,0,1,3
87649,5,1,306484,306484,306485,0,1,4
87650,2,2,306486,306486,306488,0,2,1
87651,5,3,306491,306491,306494,0,3,3
87652,4,2,306495,306495,306497,0,2,1
87653,3,1,306498,306498,306499,0,1,1
87654,2,2,306500,306500,306502,0,2,1
87655,4,3,306504,306504,306507,0,3,2
87656,1,2,306505,306507,306509,2,4,0
87657,5,3,306510,306510,306513,0,3,1
87658,6,2,306516,306516,306518,0,2,3
87659,5,3,306521,306521,306524,0,3,3
87660,4,2,306525,306525,306527,0,2,1
87661,5,3,306530,306530,306533,0,3,3
87662,6,2,306536,306536,306538,0,2,3
87663,4,3,306540,306540,306543,0,3,2
87664,3,2,306543,306543,306545,0,2,0
87665,1,3,306544,306545,306548,1,4,0
87666,4,1,306548,306548,306549,0,1,0
87667,6,1,306554,306554,306555,0,1,5
87668,5,3,306559,306559,306562,0,3,4
87669,6,3,306565,306565,306568,0,3,3
87670,1,2,306566,306568,306570,2,4,0
87671,4,1,306570,306570,306571,0,1,0
87672,4,2,306574,306574,306576,0,2,3
87673,5,2,306579,306579,306581,0,2,3
87674,2,1,306581,306581,306582,0,1,0
87675,4,1,306585,306585,306586,0,1,3
87676,4,1,306589,306589,306590,0,1,3
87677,5,2,306594,306594,306596,0,2,4
87678,4,2,306598,306598,306600,0,2,2
87679,2,1,306600,306600,306601,0,1,0
87680,2,1,306602,306602,306603,0,1,1
87681,4,3,306606,306606,306609,0,3,3
87682,3,3,306609,306609,306612,0,3,0
87683,2,2,306611,306612,306614,1,3,0
87684,3,1,306614,306614,306615,0,1,0
87685,2,1,306616,306616,306617,0,1,1
87686,2,2,306618,306618,306620,0,2,1
87687,1,1,306619,306620,306621,1,2,0
87688,6,2,306625,306625,306627,0,2,4
87689,3,2,306628,306628,306630,0,2,1
87690,5,3,306633,306633,306636,0,3,3
87691,6,1,306639,306639,306640,0,1,3
87692,6,1,306645,306645,306646,0,1,5
87693,1,2,306646,306646,306648,0,2,0
87694,1,2,306647,306648,306650,1,3,0
87695,5,3,306652,306652,306655,0,3,2
87696,4,2,306656,306656,306658,0,2,1
87697,6,3,306662,306662,306665,0,3,4
87698,1,3,306663,306665,306668,2,5,0
87699,2,2,306665,306668,306670,3,5,0
87700,1,2,306666,306670,306672,4,6,0
87701,4,3,306670,306672,306675,2,5,0
87702,5,3,306675,306675,306678,0,3,0
87703,6,2,306681,306681,306683,0,2,3
87704,4,1,306685,306685,306686,0,1,2
87705,1,1,306686,306686,306687,0,1,0
87706,6,3,306692,306692,306695,0,3,5
87707,6,3,306698,306698,306701,0,3,3
87708,6,3,306704,306704,306707,0,3,3
87709,5,3,306709,306709,306712,0,3,2
87710,3,3,306712,306712,306715,0,3,0
87711,6,1,306718,306718,306719,0,1,3
87712,2,3,306720,306720,306723,0,3,1
87713,3,2,306723,306723,306725,0,2,0
87714,6,1,306729,306729,306730,0,1,4
87715,4,3,306733,306733,306736,0,3,3
87716,6,2,306739,306739,306741,0,2,3
87717,3,3,306742,306742,306745,0,3,1
87718,6,2,306748,306748,306750,0,2,3
87719,5,2,306753,306753,306755,0,2,3
87720,3,3,306756,306756,306759,0,3,1
87721,5,2,306761,306761,306763,0,2,2
87722,6,1,306767,306767,306768,0,1,4
87723,2,1,306769,306769,306770,0,1,1
87724,6,3,306775,306775,306778,0,3,5
87725,1,3,306776,306778,306781,2,5,0
87726,4,3,306780,306781,306784,1,4,0
87727,4,3,306784,306784,306787,0,3,0
87728,3,1,306787,306787,306788,0,1,0
87729,4,3,306791,306791,306794,0,3,3
87730,1,1,306792,306794,306795,2,3,0
87731,1,2,306793,306795,306797,2,4,0
87732,4,2,306797,306797,306799,0,2,0
87733,5,1,306802,306802,306803,0,1,3
87734,1,3,306803,306803,306806,0,3,0
87735,4,2,306807,306807,306809,0,2,1
87736,4,1,306811,306811,306812,0,1,2
87737,5,3,306816,306816,306819,0,3,4
87738,5,1,306821,306821,306822,0,1,2
87739,4,3,306825,306825,306828,0,3,3
87740,4,2,306829,306829,306831,0,2,1
87741,6,3,306835,306835,306838,0,3,4
87742,4,3,306839,306839,306842,0,3,1
87743,1,3,306840,306842,306845,2,5,0
87744,3,3,306843,306845,306848,2,5,0
87745,3,1,306846,306848,306849,2,3,0
87746,3,1,306849,306849,306850,0,1,0
87747,2,3,306851,306851,306854,0,3,1
87748,4,2,306855,306855,306857,0,2,1
87749,4,1,306859,306859,306860,0,1,2
87750,3,1,306862,306862,306863,0,1,2
87751,1,2,306863,306863,306865,0,2,0
87752,2,2,306865,306865,306867,0,2,0
87753,2,3,306867,306867,306870,0,3,0
87754,3,3,306870,306870,306873,0,3,0
87755,6,2,306876,306876,306878,0,2,3
87756,5,3,306881,306881,306884,0,3,3
87757,2,1,306883,306884,306885,1,2,0
87758,5,1,306888,306888,306889,0,1,3
87759,5,1,306893,306893,306894,0,1,4
87760,3,3,306896,306896,306899,0,3,2
87761,3,1,306899,306899,306900,0,1,0
87762,2,1,306901,306901,306902,0,1,1
87763,5,3,306906,306906,306909,0,3,4
87764,5,3,306911,306911,306914,0,3,2
87765,5,3,306916,306916,306919,0,3,2
87766,1,1,306917,306919,306920,2,3,0
87767,5,1,306922,306922,306923,0,1,2
87768,3,3,306925,306925,306928,0,3,2
87769,5,2,306930,306930,306932,0,2,2
87770,3,2,306933,306933,306935,0,2,1
87771,5,1,306938,306938,306939,0,1,3
87772,2,3,306940,306940,306943,0,3,1
87773,4,2,306944,306944,306946,0,2,1
87774,1,2,306945,306946,306948,1,3,0
87775,6,1,306951,306951,306952,0,1,3
87776,1,3,306952,306952,306955,0,3,0
87777,4,1,306956,306956,306957,0,1,1
87778,3,3,306959,306959,306962,0,3,2
87779,2,2,306961,306962,306964,1,3,0
87780,6,1,306967,306967,306968,0,1,3
87781,5,2,306972,306972,306974,0,2,4
87782,6,2,306978,306978,306980,0,2,4
87783,1,1,306979,306980,306981,1,2,0
87784,4,1,306983,306983,306984,0,1,2
87785,3,2,306986,306986,306988,0,2,2
87786,6,3,306992,306992,306995,0,3,4
87787,5,2,306997,306997,306999,0,2,2
87788,3,3,307000,307000,307003,0,3,1
87789,3,2,307003,307003,307005,0,2,0
87790,3,2,307006,307006,307008,0,2,1
87791,5,3,307011,307011,307014,0,3,3
87792,6,2,307017,307017,307019,0,2,3
87793,1,2,307018,307019,307021,1,3,0
87794,3,2,307021,307021,307023,0,2,0
87795,1,1,307022,307023,307024,1,2,0
87796,4,2,307026,307026,307028,0,2,2
87797,2,3,307028,307028,307031,0,3,0
87798,6,1,307034,307034,307035,0,1,3
87799,6,1,307040,307040,307041,0,1,5
87800,3,1,307043,307043,307044,0,1,2
87801,6,1,307049,307049,307050,0,1,5
87802,4,3,307053,307053,307056,0,3,3
87803,1,2,307054,307056,307058,2,4,0
87804,3,3,307057,307058,307061,1,4,0
87805,5,2,307062,307062,307064,0,2,1
87806,3,1,307065,307065,307066,0,1,1
87807,2,3,307067,307067,307070,0,3,1
87808,2,2,307069,307070,307072,1,3,0
87809,2,2,307071,307072,307074,1,3,0
87810,5,3,307076,307076,307079,0,3,2
87811,6,1,307082,307082,307083,0,1,3
87812,3,3,307085,307085,307088,0,3,2
87813,5,2,307090,307090,307092,0,2,2
87814,6,2,307096,307096,307098,0,2,4
87815,5,3,307101,307101,307104,0,3,3
87816,1,3,307102,307104,307107,2,5,0
87817,3,1,307105,307107,307108,2,3,0
87818,6,1,307111,307111,307112,0,1,3
87819,4,3,307115,307115,307118,0,3,3
87820,1,3,307116,307118,307121,2,5,0
87821,3,2,307119,307121,307123,2,4,0
87822,1,1,307120,307123,307124,3,4,0
87823,6,2,307126,307126,307128,0,2,2
87824,3,2,307129,307129,307131,0,2,1
87825,2,2,307131,307131,307133,0,2,0
87826,2,1,307133,307133,307134,0,1,0
87827,1,1,307134,307134,307135,0,1,0
87828,6,2,307140,307140,307142,0,2,5
87829,1,1,307141,307142,307143,1,2,0
87830,6,1,307147,307147,307148,0,1,4
87831,4,1,307151,307151,307152,0,1,3
87832,6,1,307157,307157,307158,0,1,5
87833,2,3,307159,307159,307162,0,3,1
87834,1,1,307160,307162,307163,2,3,0
87835,5,3,307165,307165,307168,0,3,2
87836,5,1,307170,307170,307171,0,1,2
87837,3,1,307173,307173,307174,0,1,2
87838,5,1,307178,307178,307179,0,1,4
87839,2,1,307180,307180,307181,0,1,1
87840,1,2,307181,307181,307183,0,2,0
87841,2,1,307183,307183,307184,0,1,0
87842,2,1,307185,307185,307186,0,1,1
87843,3,2,307188,307188,307190,0,2,2
87844,6,1,307194,307194,307195,0,1,4
87845,5,2,307199,307199,307201,0,2,4
87846,1,2,307200,307201,307203,1,3,0
87847,5,2,307205,307205,307207,0,2,2
87848,1,2,307206,307207,307209,1,3,0
87849,6,1,307212,307212,307213,0,1,3
87850,2,1,307214,307214,307215,0,1,1
87851,2,2,307216,307216,307218,0,2,1
87852,1,3,307217,307218,307221,1,4,0
87853,3,1,307220,307221,307222,1,2,0
87854,1,3,307221,307222,307225,1,4,0
87855,4,1,307225,307225,307226,0,1,0
87856,2,3,307227,307227,307230,0,3,1
87857,4,3,307231,307231,307234,0,3,1
87858,6,1,307237,307237,307238,0,1,3
87859,6,2,307243,307243,307245,0,2,5
87860,2,2,307245,307245,307247,0,2,0
87861,2,1,307247,307247,307248,0,1,0
87862,4,1,307251,307251,307252,0,1,3
87863,2,2,307253,307253,307255,0,2,1
87864,3,3,307256,307256,307259,0,3,1
87865,6,2,307262,307262,307264,0,2,3
87866,5,1,307267,307267,307268,0,1,3
87867,3,3,307270,307270,307273,0,3,2
87868,2,1,307272,307273,307274,1,2,0
87869,4,3,307276,307276,307279,0,3,2
87870,5,1,307281,307281,307282,0,1,2
87871,6,3,307287,307287,307290,0,3,5
87872,4,3,307291,307291,307294,0,3,1
87873,1,2,307292,307294,307296,2,4,0
87874,6,2,307298,307298,307300,0,2,2
87875,1,1,307299,307300,307301,1,2,0
87876,4,2,307303,307303,307305,0,2,2
87877,4,3,307307,307307,307310,0,3,2
87878,4,2,307311,307311,307313,0,2,1
87879,2,3,307313,307313,307316,0,3,0
87880,1,3,307314,307316,307319,2,5,0
87881,3,2,307317,307319,307321,2,4,0
87882,6,3,307323,307323,307326,0,3,2
87883,4,3,307327,307327,307330,0,3,1
87884,4,1,307331,307331,307332,0,1,1
87885,3,3,307334,307334,307337,0,3,2
87886,3,3,307337,307337,307340,0,3,0
87887,6,1,307343,307343,307344,0,1,3
87888,5,2,307348,307348,307350,0,2,4
87889,1,3,307349,307350,307353,1,4,0
87890,6,1,307355,307355,307356,0,1,2
87891,3,3,307358,307358,307361,0,3,2
87892,3,1,307361,307361,307362,0,1,0
87893,2,2,307363,307363,307365,0,2,1
87894,2,2,307365,307365,307367,0,2,0
87895,3,3,307368,307368,307371,0,3,1
87896,1,2,307369,307371,307373,2,4,0
87897,6,2,307375,307375,307377,0,2,2
87898,5,3,307380,307380,307383,0,3,3
87899,1,3,307381,307383,307386,2,5,0
87900,1,3,307382,307386,307389,4,7,0
87901,1,2,307383,307389,307391,6,8,0
87902,1,1,307384,307391,307392,7,8,0
87903,6,3,307390,307392,307395,2,5,0
87904,5,1,307395,307395,307396,0,1,0
87905,1,3,307396,307396,307399,0,3,0
87906,5,3,307401,307401,307404,0,3,2
87907,1,1,307402,307404,307405,2,3,0
87908,4,2,307406,307406,307408,0,2,1
87909,3,3,307409,307409,307412,0,3,1
87910,4,3,307413,307413,307416,0,3,1
87911,2,1,307415,307416,307417,1,2,0
87912,4,3,307419,307419,307422,0,3,2
87913,2,1,307421,307422,307423,1,2,0
87914,2,3,307423,307423,307426,0,3,0
87915,3,2,307426,307426,307428,0,2,0
87916,5,2,307431,307431,307433,0,2,3
87917,2,1,307433,307433,307434,0,1,0
87918,2,3,307435,307435,307438,0,3,1
87919,6,3,307441,307441,307444,0,3,3
87920,5,2,307446,307446,307448,0,2,2
87921,5,2,307451,307451,307453,0,2,3
87922,5,1,307456,307456,307457,0,1,3
87923,6,1,307462,307462,307463,0,1,5
87924,4,1,307466,307466,307467,0,1,3
87925,6,1,307472,307472,307473,0,1,5
87926,6,3,307478,307478,307481,0,3,5
87927,4,2,307482,307482,307484,0,2,1
87928,5,1,307487,307487,307488,0,1,3
87929,6,2,307493,307493,307495,0,2,5
87930,1,2,307494,307495,307497,1,3,0
87931,3,1,307497,307497,307498,0,1,0
87932,6,2,307503,307503,307505,0,2,5
87933,4,2,307507,307507,307509,0,2,2
87934,4,1,307511,307511,307512,0,1,2
87935,5,3,307516,307516,307519,0,3,4
87936,1,2,307517,307519,307521,2,4,0
87937,3,1,307520,307521,307522,1,2,0
87938,5,1,307525,307525,307526,0,1,3
87939,6,3,307531,307531,307534,0,3,5
87940,6,3,307537,307537,307540,0,3,3
87941,5,3,307542,307542,307545,0,3,2
87942,6,3,307548,307548,307551,0,3,3
87943,4,2,307552,307552,307554,0,2,1
87944,5,3,307557,307557,307560,0,3,3
87945,6,3,307563,307563,307566,0,3,3
87946,2,1,307565,307566,307567,1,2,0
87947,2,2,307567,307567,307569,0,2,0
87948,5,2,307572,307572,307574,0,2,3
87949,1,3,307573,307574,307577,1,4,0
87950,1,1,307574,307577,307578,3,4,0
87951,4,3,307578,307578,307581,0,3,0
87952,6,2,307584,307584,307586,0,2,3
87953,2,2,307586,307586,307588,0,2,0
87954,2,1,307588,307588,307589,0,1,0
87955,3,1,307591,307591,307592,0,1,2
87956,1,3,307592,307592,307595,0,3,0
87957,2,1,307594,307595,307596,1,2,0
87958,5,3,307599,307599,307602,0,3,3
87959,1,2,307600,307602,307604,2,4,0
87960,1,3,307601,307604,307607,3,6,0
87961,5,3,307606,307607,307610,1,4,0
87962,5,3,307611,307611,307614,0,3,1
87963,4,1,307615,307615,307616,0,1,1
87964,6,1,307621,307621,307622,0,1,5
87965,6,2,307627,307627,307629,0,2,5
87966,3,2,307630,307630,307632,0,2,1
87967,4,3,307634,307634,307637,0,3,2
87968,1,1,307635,307637,307638,2,3,0
87969,4,3,307639,307639,307642,0,3,1
87970,1,1,307640,307642,307643,2,3,0
87971,2,1,307642,307643,307644,1,2,0
87972,5,1,307647,307647,307648,0,1,3
87973,1,2,307648,307648,307650,0,2,0
87974,2,3,307650,307650,307653,0,3,0
87975,2,3,307652,307653,307656,1,4,0
87976,5,1,307657,307657,307658,0,1,1
87977,5,3,307662,307662,307665,0,3,4
87978,3,1,307665,307665,307666,0,1,0
87979,2,2,307667,307667,307669,0,2,1
87980,2,1,307669,307669,307670,0,1,0
87981,1,1,307670,307670,307671,0,1,0
87982,1,2,307671,307671,307673,0,2,0
87983,2,2,307673,307673,307675,0,2,0
87984,6,2,307679,307679,307681,0,2,4
87985,3,3,307682,307682,307685,0,3,1
87986,6,3,307688,307688,307691,0,3,3
87987,5,1,307693,307693,307694,0,1,2
87988,6,3,307699,307699,307702,0,3,5
87989,3,3,307702,307702,307705,0,3,0
87990,3,2,307705,307705,307707,0,2,0
87991,2,3,307707,307707,307710,0,3,0
87992,2,2,307709,307710,307712,1,3,0
87993,5,1,307714,307714,307715,0,1,2
87994,6,3,307720,307720,307723,0,3,5
87995,6,3,307726,307726,307729,0,3,3
87996,6,3,307732,307732,307735,0,3,3
87997,2,2,307734,307735,307737,1,3,0
87998,5,2,307739,307739,307741,0,2,2
87999,3,3,307742,307742,307745,0,3,1
88000,4,1,307746,307746,307747,0,1,1
88001,5,1,307751,307751,307752,0,1,4
88002,4,1,307755,307755,307756,0,1,3
88003,2,3,307757,307757,307760,0,3,1
88004,4,1,307761,307761,307762,0,1,1
88005,6,3,307767,307767,307770,0,3,5
88006,1,2,307768,307770,307772,2,4,0
88007,5,1,307773,307773,307774,0,1,1
88008,5,1,307778,307778,307779,0,1,4
88009,2,1,307780,307780,307781,0,1,1
88010,3,2,307783,307783,307785,0,2,2
88011,6,1,307789,307789,307790,0,1,4
88012,5,3,307794,307794,307797,0,3,4
88013,1,3,307795,307797,307800,2,5,0
88014,2,1,307797,307800,307801,3,4,0
88015,5,3,307802,307802,307805,0,3,1
88016,1,3,307803,307805,307808,2,5,0
88017,6,2,307809,307809,307811,0,2,1
88018,4,1,307813,307813,307814,0,1,2
88019,1,2,307814,307814,307816,0,2,0
88020,4,2,307818,307818,307820,0,2,2
88021,3,3,307821,307821,307824,0,3,1
88022,2,2,307823,307824,307826,1,3,0
88023,4,3,307827,307827,307830,0,3,1
88024,5,3,307832,307832,307835,0,3,2
88025,1,1,307833,307835,307836,2,3,0
88026,1,2,307834,307836,307838,2,4,0
88027,5,2,307839,307839,307841,0,2,1
88028,2,3,307841,307841,307844,0,3,0
88029,3,3,307844,307844,307847,0,3,0
88030,6,2,307850,307850,307852,0,2,3
88031,1,2,307851,307852,307854,1,3,0
88032,6,2,307857,307857,307859,0,2,3
88033,5,1,307862,307862,307863,0,1,3
88034,1,1,307863,307863,307864,0,1,0
88035,2,1,307865,307865,307866,0,1,1
88036,1,3,307866,307866,307869,0,3,0
88037,1,1,307867,307869,307870,2,3,0
88038,1,1,307868,307870,307871,2,3,0
88039,6,3,307874,307874,307877,0,3,3
88040,3,3,307877,307877,307880,0,3,0
88041,3,2,307880,307880,307882,0,2,0
88042,6,1,307886,307886,307887,0,1,4
88043,2,2,307888,307888,307890,0,2,1
88044,5,1,307893,307893,307894,0,1,3
88045,2,3,307895,307895,307898,0,3,1
88046,3,1,307898,307898,307899,0,1,0
88047,4,1,307902,307902,307903,0,1,3
88048,2,1,307904,307904,307905,0,1,1
88049,4,2,307908,307908,307910,0,2,3
88050,5,1,307913,307913,307914,0,1,3
88051,2,2,307915,307915,307917,0,2,1
88052,6,2,307921,307921,307923,0,2,4
88053,5,2,307926,307926,307928,0,2,3
88054,6,3,307932,307932,307935,0,3,4
88055,5,2,307937,307937,307939,0,2,2
88056,3,2,307940,307940,307942,0,2,1
88057,1,2,307941,307942,307944,1,3,0
88058,1,3,307942,307944,307947,2,5,0
88059,4,3,307946,307947,307950,1,4,0
88060,5,1,307951,307951,307952,0,1,1
88061,2,1,307953,307953,307954,0,1,1
88062,4,2,307957,307957,307959,0,2,3
88063,1,2,307958,307959,307961,1,3,0
88064,3,3,307961,307961,307964,0,3,0
88065,2,3,307963,307964,307967,1,4,0
88066,2,3,307965,307967,307970,2,5,0
88067,1,1,307966,307970,307971,4,5,0
88068,2,2,307968,307971,307973,3,5,0
88069,6,2,307974,307974,307976,0,2,1
88070,1,3,307975,307976,307979,1,4,0
88071,4,3,307979,307979,307982,0,3,0
88072,5,2,307984,307984,307986,0,2,2
88073,5,2,307989,307989,307991,0,2,3
88074,5,2,307994,307994,307996,0,2,3
88075,5,2,307999,307999,308001,0,2,3
88076,2,1,308001,308001,308002,0,1,0
88077,4,1,308005,308005,308006,0,1,3
88078,4,2,308009,308009,308011,0,2,3
88079,1,3,308010,308011,308014,1,4,0
88080,5,3,308015,308015,308018,0,3,1
88081,4,1,308019,308019,308020,0,1,1
88082,3,3,308022,308022,308025,0,3,2
88083,2,1,308024,308025,308026,1,2,0
88084,1,3,308025,308026,308029,1,4,0
88085,4,1,308029,308029,308030,0,1,0
88086,4,2,308033,308033,308035,0,2,3
88087,5,2,308038,308038,308040,0,2,3
88088,3,1,308041,308041,308042,0,1,1
88089,1,1,308042,308042,308043,0,1,0
88090,5,2,308047,308047,308049,0,2,4
88091,2,1,308049,308049,308050,0,1,0
88092,5,3,308054,308054,308057,0,3,4
88093,4,2,308058,308058,308060,0,2,1
88094,6,1,308064,308064,308065,0,1,4
88095,1,3,308065,308065,308068,0,3,0
88096,6,2,308071,308071,308073,0,2,3
88097,6,3,308077,308077,308080,0,3,4
88098,3,2,308080,308080,308082,0,2,0
88099,4,3,308084,308084,308087,0,3,2
88100,5,1,308089,308089,308090,0,1,2
88101,6,2,308095,308095,308097,0,2,5
88102,5,2,308100,308100,308102,0,2,3
88103,1,1,308101,308102,308103,1,2,0
88104,4,2,308105,308105,308107,0,2,2
88105,4,3,308109,308109,308112,0,3,2
88106,1,1,308110,308112,308113,2,3,0
88107,1,3,308111,308113,308116,2,5,0
88108,6,3,308117,308117,308120,0,3,1
88109,2,2,308119,308120,308122,1,3,0
88110,4,1,308123,308123,308124,0,1,1
88111,5,3,308128,308128,308131,0,3,4
88112,6,2,308134,308134,308136,0,2,3
88113,3,1,308137,308137,308138,0,1,1
88114,1,3,308138,308138,308141,0,3,0
88115,4,1,308142,308142,308143,0,1,1
88116,3,3,308145,308145,308148,0,3,2
88117,6,2,308151,308151,308153,0,2,3
88118,4,3,308155,308155,308158,0,3,2
88119,3,2,308158,308158,308160,0,2,0
88120,6,2,308164,308164,308166,0,2,4
88121,4,1,308168,308168,308169,0,1,2
88122,1,1,308169,308169,308170,0,1,0
88123,3,3,308172,308172,308175,0,3,2
88124,5,2,308177,308177,308179,0,2,2
88125,1,3,308178,308179,308182,1,4,0
88126,5,3,308183,308183,308186,0,3,1
88127,3,3,308186,308186,308189,0,3,0
88128,1,3,308187,308189,308192,2,5,0
88129,1,1,308188,308192,308193,4,5,0
88130,1,3,308189,308193,308196,4,7,0
88131,4,3,308193,308196,308199,3,6,0
88132,4,3,308197,308199,308202,2,5,0
88133,5,2,308202,308202,308204,0,2,0
88134,4,3,308206,308206,308209,0,3,2
88135,5,3,308211,308211,308214,0,3,2
88136,5,2,308216,308216,308218,0,2,2
88137,5,2,308221,308221,308223,0,2,3
88138,5,1,308226,308226,308227,0,1,3
88139,4,1,308230,308230,308231,0,1,3
88140,4,2,308234,308234,308236,0,2,3
88141,2,2,308236,308236,308238,0,2,0
88142,3,2,308239,308239,308241,0,2,1
88143,6,3,308245,308245,308248,0,3,4
88144,3,3,308248,308248,308251,0,3,0
88145,4,2,308252,308252,308254,0,2,1
88146,4,2,308256,308256,308258,0,2,2
88147,1,3,308257,308258,308261,1,4,0
88148,6,1,308263,308263,308264,0,1,2
88149,1,1,308264,308264,308265,0,1,0
88150,5,2,308269,308269,308271,0,2,4
88151,6,1,308275,308275,308276,0,1,4
88152,3,2,308278,308278,308280,0,2,2
88153,6,2,308284,308284,308286,0,2,4
88154,5,1,308289,308289,308290,0,1,3
88155,1,3,308290,308290,308293,0,3,0
88156,2,1,308292,308293,308294,1,2,0
88157,2,1,308294,308294,308295,0,1,0
88158,2,2,308296,308296,308298,0,2,1
88159,6,2,308302,308302,308304,0,2,4
88160,3,2,308305,308305,308307,0,2,1
88161,4,1,308309,308309,308310,0,1,2
88162,6,1,308315,308315,308316,0,1,5
88163,1,3,308316,308316,308319,0,3,0
88164,5,1,308321,308321,308322,0,1,2
88165,6,1,308327,308327,308328,0,1,5
88166,3,1,308330,308330,308331,0,1,2
88167,6,1,308336,308336,308337,0,1,5
88168,3,1,308339,308339,308340,0,1,2
88169,5,3,308344,308344,308347,0,3,4
88170,1,3,308345,308347,308350,2,5,0
88171,1,3,308346,308350,308353,4,7,0
88172,2,2,308348,308353,308355,5,7,0
88173,1,1,308349,308355,308356,6,7,0
88174,2,3,308351,308356,308359,5,8,0
88175,1,3,308352,308359,308362,7,10,0
88176,5,3,308357,308362,308365,5,8,0
88177,1,3,308358,308365,308368,7,10,0
88178,3,2,308361,308368,308370,7,9,0
88179,5,3,308366,308370,308373,4,7,0
88180,4,1,308370,308373,308374,3,4,0
88181,1,1,308371,308374,308375,3,4,0
88182,1,1,308372,308375,308376,3,4,0
88183,6,3,308378,308378,308381,0,3,2
88184,5,3,308383,308383,308386,0,3,2
88185,6,1,308389,308389,308390,0,1,3
88186,6,2,308395,308395,308397,0,2,5
88187,4,3,308399,308399,308402,0,3,2
88188,3,2,308402,308402,308404,0,2,0
88189,2,2,308404,308404,308406,0,2,0
88190,3,3,308407,308407,308410,0,3,1
88191,2,1,308409,308410,308411,1,2,0
88192,4,1,308413,308413,308414,0,1,2
88193,5,3,308418,308418,308421,0,3,4
88194,2,3,308420,308421,308424,1,4,0
88195,4,1,308424,308424,308425,0,1,0
88196,4,1,308428,308428,308429,0,1,3
88197,2,1,308430,308430,308431,0,1,1
88198,5,1,308435,308435,308436,0,1,4
88199,5,1,308440,308440,308441,0,1,4
88200,5,2,308445,308445,308447,0,2,4
88201,2,3,308447,308447,308450,0,3,0
88202,1,2,308448,308450,308452,2,4,0
88203,2,3,308450,308452,308455,2,5,0
88204,3,3,308453,308455,308458,2,5,0
88205,1,2,308454,308458,308460,4,6,0
88206,3,1,308457,308460,308461,3,4,0
88207,1,2,308458,308461,308463,3,5,0
88208,4,2,308462,308463,308465,1,3,0
88209,6,2,308468,308468,308470,0,2,3
88210,1,2,308469,308470,308472,1,3,0
88211,5,2,308474,308474,308476,0,2,2
88212,1,3,308475,308476,308479,1,4,0
88213,2,1,308477,308479,308480,2,3,0
88214,5,1,308482,308482,308483,0,1,2
88215,4,3,308486,308486,308489,0,3,3
88216,4,1,308490,308490,308491,0,1,1
88217,1,2,308491,308491,308493,0,2,0
88218,2,1,308493,308493,308494,0,1,0
88219,5,3,308498,308498,308501,0,3,4
88220,2,1,308500,308501,308502,1,2,0
88221,5,1,308505,308505,308506,0,1,3
88222,5,2,308510,308510,308512,0,2,4
88223,2,1,308512,308512,308513,0,1,0
88224,2,3,308514,308514,308517,0,3,1
88225,6,2,308520,308520,308522,0,2,3
88226,3,2,308523,308523,308525,0,2,1
88227,5,2,308528,308528,308530,0,2,3
88228,4,2,308532,308532,308534,0,2,2
88229,4,3,308536,308536,308539,0,3,2
88230,2,2,308538,308539,308541,1,3,0
88231,1,3,308539,308541,308544,2,5,0
88232,4,3,308543,308544,308547,1,4,0
88233,1,1,308544,308547,308548,3,4,0
88234,5,3,308549,308549,308552,0,3,1
88235,4,3,308553,308553,308556,0,3,1
88236,5,1,308558,308558,308559,0,1,2
88237,3,2,308561,308561,308563,0,2,2
88238,6,1,308567,308567,308568,0,1,4
88239,5,2,308572,308572,308574,0,2,4
88240,5,2,308577,308577,308579,0,2,3
88241,4,2,308581,308581,308583,0,2,2
88242,3,2,308584,308584,308586,0,2,1
88243,4,2,308588,308588,308590,0,2,2
88244,1,2,308589,308590,308592,1,3,0
88245,4,3,308593,308593,308596,0,3,1
88246,5,3,308598,308598,308601,0,3,2
88247,2,3,308600,308601,308604,1,4,0
88248,6,2,308606,308606,308608,0,2,2
88249,6,2,308612,308612,308614,0,2,4
88250,1,2,308613,308614,308616,1,3,0
88251,1,3,308614,308616,308619,2,5,0
88252,6,2,308620,308620,308622,0,2,1
88253,2,1,308622,308622,308623,0,1,0
88254,4,2,308626,308626,308628,0,2,3
88255,2,2,308628,308628,308630,0,2,0
88256,5,1,308633,308633,308634,0,1,3
88257,5,2,308638,308638,308640,0,2,4
88258,2,3,308640,308640,308643,0,3,0
88259,3,2,308643,308643,308645,0,2,0
88260,1,2,308644,308645,308647,1,3,0
88261,2,2,308646,308647,308649,1,3,0
88262,4,3,308650,308650,308653,0,3,1
88263,1,3,308651,308653,308656,2,5,0
88264,2,3,308653,308656,308659,3,6,0
88265,1,2,308654,308659,308661,5,7,0
88266,2,3,308656,308661,308664,5,8,0
88267,6,3,308662,308664,308667,2,5,0
88268,1,1,308663,308667,308668,4,5,0
88269,4,3,308667,308668,308671,1,4,0
88270,1,2,308668,308671,308673,3,5,0
88271,4,3,308672,308673,308676,1,4,0
88272,1,3,308673,308676,308679,3,6,0
88273,1,1,308674,308679,308680,5,6,0
88274,6,2,308680,308680,308682,0,2,0
88275,5,2,308685,308685,308687,0,2,3
88276,3,3,308688,308688,308691,0,3,1
88277,3,1,308691,308691,308692,0,1,0
88278,2,3,308693,308693,308696,0,3,1
88279,1,2,308694,308696,308698,2,4,0
88280,6,2,308700,308700,308702,0,2,2
88281,5,3,308705,308705,308708,0,3,3
88282,6,1,308711,308711,308712,0,1,3
88283,5,3,308716,308716,308719,0,3,4
88284,6,2,308722,308722,308724,0,2,3
88285,5,2,308727,308727,308729,0,2,3
88286,4,2,308731,308731,308733,0,2,2
88287,2,1,308733,308733,308734,0,1,0
88288,1,1,308734,308734,308735,0,1,0
88289,6,1,308740,308740,308741,0,1,5
88290,6,3,308746,308746,308749,0,3,5
88291,4,3,308750,308750,308753,0,3,1
88292,6,1,308756,308756,308757,0,1,3
88293,1,2,308757,308757,308759,0,2,0
88294,3,3,308760,308760,308763,0,3,1
88295,1,2,308761,308763,308765,2,4,0
88296,4,1,308765,308765,308766,0,1,0
88297,2,2,308767,308767,308769,0,2,1
88298,2,2,308769,308769,308771,0,2,0
88299,2,2,308771,308771,308773,0,2,0
88300,5,2,308776,308776,308778,0,2,3
88301,4,1,308780,308780,308781,0,1,2
88302,3,2,308783,308783,308785,0,2,2
88303,5,2,308788,308788,308790,0,2,3
88304,3,2,308791,308791,308793,0,2,1
88305,6,1,308797,308797,308798,0,1,4
88306,6,2,308803,308803,308805,0,2,5
88307,5,1,308808,308808,308809,0,1,3
88308,5,1,308813,308813,308814,0,1,4
88309,4,2,308817,308817,308819,0,2,3
88310,4,3,308821,308821,308824,0,3,2
88311,2,3,308823,308824,308827,1,4,0
88312,4,2,308827,308827,308829,0,2,0
88313,4,2,308831,308831,308833,0,2,2
88314,2,1,308833,308833,308834,0,1,0
88315,2,1,308835,308835,308836,0,1,1
88316,4,3,308839,308839,308842,0,3,3
88317,4,2,308843,308843,308845,0,2,1
88318,6,1,308849,308849,308850,0,1,4
88319,3,1,308852,308852,308853,0,1,2
88320,4,3,308856,308856,308859,0,3,3
88321,1,1,308857,308859,308860,2,3,0
88322,4,1,308861,308861,308862,0,1,1
88323,2,3,308863,308863,308866,0,3,1
88324,3,2,308866,308866,308868,0,2,0
88325,3,1,308869,308869,308870,0,1,1
88326,1,3,308870,308870,308873,0,3,0
88327,3,1,308873,308873,308874,0,1,0
88328,5,3,308878,308878,308881,0,3,4
88329,4,2,308882,308882,308884,0,2,1
88330,4,2,308886,308886,308888,0,2,2
88331,2,2,308888,308888,308890,0,2,0
88332,1,3,308889,308890,308893,1,4,0
88333,6,2,308895,308895,308897,0,2,2
88334,6,3,308901,308901,308904,0,3,4
88335,5,1,308906,308906,308907,0,1,2
88336,4,2,308910,308910,308912,0,2,3
88337,3,3,308913,308913,308916,0,3,1
88338,6,1,308919,308919,308920,0,1,3
88339,1,3,308920,308920,308923,0,3,0
88340,2,2,308922,308923,308925,1,3,0
88341,2,1,308924,308925,308926,1,2,0
88342,4,1,308928,308928,308929,0,1,2
88343,2,3,308930,308930,308933,0,3,1
88344,6,1,308936,308936,308937,0,1,3
88345,2,2,308938,308938,308940,0,2,1
88346,2,1,308940,308940,308941,0,1,0
88347,6,3,308946,308946,308949,0,3,5
88348,5,2,308951,308951,308953,0,2,2
88349,4,3,308955,308955,308958,0,3,2
88350,3,2,308958,308958,308960,0,2,0
88351,5,1,308963,308963,308964,0,1,3
88352,5,1,308968,308968,308969,0,1,4
88353,5,3,308973,308973,308976,0,3,4
88354,5,1,308978,308978,308979,0,1,2
88355,5,1,308983,308983,308984,0,1,4
88356,2,3,308985,308985,308988,0,3,1
88357,2,3,308987,308988,308991,1,4,0
88358,4,3,308991,308991,308994,0,3,0
88359,3,2,308994,308994,308996,0,2,0
88360,2,2,308996,308996,308998,0,2,0
88361,6,1,309002,309002,309003,0,1,4
88362,1,3,309003,309003,309006,0,3,0
88363,1,2,309004,309006,309008,2,4,0
88364,4,2,309008,309008,309010,0,2,0
88365,1,3,309009,309010,309013,1,4,0
88366,1,1,309010,309013,309014,3,4,0
88367,1,1,309011,309014,309015,3,4,0
88368,5,2,309016,309016,309018,0,2,1
88369,1,3,309017,309018,309021,1,4,0
88370,2,3,309019,309021,309024,2,5,0
88371,3,1,309022,309024,309025,2,3,0
88372,4,1,309026,309026,309027,0,1,1
88373,1,3,309027,309027,309030,0,3,0
88374,2,1,309029,309030,309031,1,2,0
88375,3,2,309032,309032,309034,0,2,1
88376,3,2,309035,309035,309037,0,2,1
88377,5,3,309040,309040,309043,0,3,3
88378,3,3,309043,309043,309046,0,3,0
88379,4,3,309047,309047,309050,0,3,1
88380,6,1,309053,309053,309054,0,1,3
88381,3,2,309056,309056,309058,0,2,2
88382,4,2,309060,309060,309062,0,2,2
88383,2,3,309062,309062,309065,0,3,0
88384,5,2,309067,309067,309069,0,2,2
88385,2,1,309069,309069,309070,0,1,0
88386,1,1,309070,309070,309071,0,1,0
88387,4,1,309074,309074,309075,0,1,3
88388,1,3,309075,309075,309078,0,3,0
88389,6,3,309081,309081,309084,0,3,3
88390,4,1,309085,309085,309086,0,1,1
88391,5,3,309090,309090,309093,0,3,4
88392,3,3,309093,309093,309096,0,3,0
88393,1,1,309094,309096,309097,2,3,0
88394,5,3,309099,309099,309102,0,3,2
88395,6,3,309105,309105,309108,0,3,3
88396,4,2,309109,309109,309111,0,2,1
88397,6,2,309115,309115,309117,0,2,4
88398,3,1,309118,309118,309119,0,1,1
88399,4,2,309122,309122,309124,0,2,3
88400,4,1,309126,309126,309127,0,1,2
88401,2,1,309128,309128,309129,0,1,1
88402,4,1,309132,309132,309133,0,1,3
88403,1,1,309133,309133,309134,0,1,0
88404,1,2,309134,309134,309136,0,2,0
88405,5,2,309139,309139,309141,0,2,3
88406,4,2,309143,309143,309145,0,2,2
88407,2,2,309145,309145,309147,0,2,0
88408,4,3,309149,309149,309152,0,3,2
88409,5,3,309154,309154,309157,0,3,2
88410,3,2,309157,309157,309159,0,2,0
88411,6,1,309163,309163,309164,0,1,4
88412,3,3,309166,309166,309169,0,3,2
88413,5,2,309171,309171,309173,0,2,2
88414,2,1,309173,309173,309174,0,1,0
88415,2,2,309175,309175,309177,0,2,1
88416,6,2,309181,309181,309183,0,2,4
88417,1,1,309182,309183,309184,1,2,0
88418,4,3,309186,309186,309189,0,3,2
88419,5,1,309191,309191,309192,0,1,2
88420,2,3,309193,309193,309196,0,3,1
88421,6,3,309199,309199,309202,0,3,3
88422,6,2,309205,309205,309207,0,2,3
88423,5,2,309210,309210,309212,0,2,3
88424,2,1,309212,309212,309213,0,1,0
88425,1,3,309213,309213,309216,0,3,0
88426,5,1,309218,309218,309219,0,1,2
88427,4,1,309222,309222,309223,0,1,3
88428,6,1,309228,309228,309229,0,1,5
88429,6,3,309234,309234,309237,0,3,5
88430,6,3,309240,309240,309243,0,3,3
88431,2,3,309242,309243,309246,1,4,0
88432,1,3,309243,309246,309249,3,6,0
88433,2,1,309245,309249,309250,4,5,0
88434,6,2,309251,309251,309253,0,2,1
88435,3,2,309254,309254,309256,0,2,1
88436,1,3,309255,309256,309259,1,4,0
88437,3,2,309258,309259,309261,1,3,0
88438,5,1,309263,309263,309264,0,1,2
88439,3,3,309266,309266,309269,0,3,2
88440,2,1,309268,309269,309270,1,2,0
88441,6,1,309274,309274,309275,0,1,4
88442,5,3,309279,309279,309282,0,3,4
88443,3,3,309282,309282,309285,0,3,0
88444,3,3,309285,309285,309288,0,3,0
88445,4,2,309289,309289,309291,0,2,1
88446,2,3,309291,309291,309294,0,3,0
88447,4,3,309295,309295,309298,0,3,1
88448,4,3,309299,309299,309302,0,3,1
88449,5,3,309304,309304,309307,0,3,2
88450,1,1,309305,309307,309308,2,3,0
88451,2,2,309307,309308,309310,1,3,0
88452,6,2,309313,309313,309315,0,2,3
88453,2,3,309315,309315,309318,0,3,0
88454,2,2,309317,309318,309320,1,3,0
88455,5,2,309322,309322,309324,0,2,2
88456,1,2,309323,309324,309326,1,3,0
88457,6,3,309329,309329,309332,0,3,3
88458,2,3,309331,309332,309335,1,4,0
88459,6,1,309337,309337,309338,0,1,2
88460,3,3,309340,309340,309343,0,3,2
88461,6,1,309346,309346,309347,0,1,3
88462,2,3,309348,309348,309351,0,3,1
88463,6,1,309354,309354,309355,0,1,3
88464,6,1,309360,309360,309361,0,1,5
88465,3,2,309363,309363,309365,0,2,2
88466,5,2,309368,309368,309370,0,2,3
88467,1,2,309369,309370,309372,1,3,0
88468,6,2,309375,309375,309377,0,2,3
88469,3,1,309378,309378,309379,0,1,1
88470,2,3,309380,309380,309383,0,3,1
88471,5,2,309385,309385,309387,0,2,2
88472,1,2,309386,309387,309389,1,3,0
88473,1,3,309387,309389,309392,2,5,0
88474,1,1,309388,309392,309393,4,5,0
88475,3,2,309391,309393,309395,2,4,0
88476,4,2,309395,309395,309397,0,2,0
88477,5,2,309400,309400,309402,0,2,3
88478,2,1,309402,309402,309403,0,1,0
88479,5,1,309407,309407,309408,0,1,4
88480,4,1,309411,309411,309412,0,1,3
88481,6,1,309417,309417,309418,0,1,5
88482,5,1,309422,309422,309423,0,1,4
88483,2,1,309424,309424,309425,0,1,1
88484,3,3,309427,309427,309430,0,3,2
88485,3,2,309430,309430,309432,0,2,0
88486,5,3,309435,309435,309438,0,3,3
88487,1,3,309436,309438,309441,2,5,0
88488,3,1,309439,309441,309442,2,3,0
88489,3,3,309442,309442,309445,0,3,0
88490,2,2,309444,309445,309447,1,3,0
88491,4,1,309448,309448,309449,0,1,1
88492,6,3,309454,309454,309457,0,3,5
88493,2,3,309456,309457,309460,1,4,0
88494,1,3,309457,309460,309463,3,6,0
88495,4,2,309461,309463,309465,2,4,0
88496,3,3,309464,309465,309468,1,4,0
88497,6,2,309470,309470,309472,0,2,2
88498,1,1,309471,309472,309473,1,2,0
88499,3,3,309474,309474,309477,0,3,1
88500,2,1,309476,309477,309478,1,2,0
88501,5,3,309481,309481,309484,0,3,3
88502,3,3,309484,309484,309487,0,3,0
88503,1,3,309485,309487,309490,2,5,0
88504,6,2,309491,309491,309493,0,2,1
88505,4,1,309495,309495,309496,0,1,2
88506,6,1,309501,309501,309502,0,1,5
88507,3,3,309504,309504,309507,0,3,2
88508,3,2,309507,309507,309509,0,2,0
88509,4,3,309511,309511,309514,0,3,2
88510,5,2,309516,309516,309518,0,2,2
88511,2,1,309518,309518,309519,0,1,0
88512,6,1,309524,309524,309525,0,1,5
88513,1,2,309525,309525,309527,0,2,0
88514,2,1,309527,309527,309528,0,1,0
88515,2,1,309529,309529,309530,0,1,1
88516,2,1,309531,309531,309532,0,1,1
88517,1,3,309532,309532,309535,0,3,0
88518,2,1,309534,309535,309536,1,2,0
88519,3,3,309537,309537,309540,0,3,1
88520,4,1,309541,309541,309542,0,1,1
88521,2,1,309543,309543,309544,0,1,1
88522,6,1,309549,309549,309550,0,1,5
88523,4,2,309553,309553,309555,0,2,3
88524,3,1,309556,309556,309557,0,1,1
88525,5,2,309561,309561,309563,0,2,4
88526,3,2,309564,309564,309566,0,2,1
88527,6,2,309570,309570,309572,0,2,4
88528,4,1,309574,309574,309575,0,1,2
88529,4,1,309578,309578,309579,0,1,3
88530,3,3,309581,309581,309584,0,3,2
88531,5,2,309586,309586,309588,0,2,2
88532,1,1,309587,309588,309589,1,2,0
88533,4,1,309591,309591,309592,0,1,2
88534,3,1,309594,309594,309595,0,1,2
88535,1,1,309595,309595,309596,0,1,0
88536,4,3,309599,309599,309602,0,3,3
88537,6,3,309605,309605,309608,0,3,3
88538,3,3,309608,309608,309611,0,3,0
88539,5,2,309613,309613,309615,0,2,2
88540,2,3,309615,309615,309618,0,3,0
88541,1,2,309616,309618,309620,2,4,0
88542,1,2,309617,309620,309622,3,5,0
88543,2,2,309619,309622,309624,3,5,0
88544,5,1,309624,309624,309625,0,1,0
88545,6,1,309630,309630,309631,0,1,5
88546,2,3,309632,309632,309635,0,3,1
88547,1,2,309633,309635,309637,2,4,0
88548,2,1,309635,309637,309638,2,3,0
88549,4,3,309639,309639,309642,0,3,1
88550,4,3,309643,309643,309646,0,3,1
88551,1,2,309644,309646,309648,2,4,0
88552,4,2,309648,309648,309650,0,2,0
88553,6,2,309654,309654,309656,0,2,4
88554,2,2,309656,309656,309658,0,2,0
88555,1,3,309657,309658,309661,1,4,0
88556,6,1,309663,309663,309664,0,1,2
88557,3,1,309666,309666,309667,0,1,2
88558,3,1,309669,309669,309670,0,1,2
88559,4,2,309673,309673,309675,0,2,3
88560,1,3,309674,309675,309678,1,4,0
88561,1,2,309675,309678,309680,3,5,0
88562,2,3,309677,309680,309683,3,6,0
88563,1,2,309678,309683,309685,5,7,0
88564,2,2,309680,309685,309687,5,7,0
88565,6,1,309686,309687,309688,1,2,0
88566,3,3,309689,309689,309692,0,3,1
88567,6,3,309695,309695,309698,0,3,3
88568,3,2,309698,309698,309700,0,2,0
88569,5,1,309703,309703,309704,0,1,3
88570,2,3,309705,309705,309708,0,3,1
88571,1,3,309706,309708,309711,2,5,0
88572,3,3,309709,309711,309714,2,5,0
88573,4,3,309713,309714,309717,1,4,0
88574,2,3,309715,309717,309720,2,5,0
88575,1,3,309716,309720,309723,4,7,0
88576,1,2,309717,309723,309725,6,8,0
88577,6,1,309723,309725,309726,2,3,0
88578,1,2,309724,309726,309728,2,4,0
88579,3,3,309727,309728,309731,1,4,0
88580,1,1,309728,309731,309732,3,4,0
88581,6,2,309734,309734,309736,0,2,2
88582,1,1,309735,309736,309737,1,2,0
88583,6,3,309741,309741,309744,0,3,4
88584,2,2,309743,309744,309746,1,3,0
88585,6,1,309749,309749,309750,0,1,3
88586,4,2,309753,309753,309755,0,2,3
88587,5,1,309758,309758,309759,0,1,3
88588,4,2,309762,309762,309764,0,2,3
88589,1,1,309763,309764,309765,1,2,0
88590,5,1,309768,309768,309769,0,1,3
88591,5,3,309773,309773,309776,0,3,4
88592,6,3,309779,309779,309782,0,3,3
88593,4,1,309783,309783,309784,0,1,1
88594,5,1,309788,309788,309789,0,1,4
88595,5,2,309793,309793,309795,0,2,4
88596,4,2,309797,309797,309799,0,2,2
88597,5,1,309802,309802,309803,0,1,3
88598,5,3,309807,309807,309810,0,3,4
88599,2,2,309809,309810,309812,1,3,0
88600,5,2,309814,309814,309816,0,2,2
88601,1,3,309815,309816,309819,1,4,0
88602,1,3,309816,309819,309822,3,6,0
88603,3,1,309819,309822,309823,3,4,0
88604,1,2,309820,309823,309825,3,5,0
88605,4,3,309824,309825,309828,1,4,0
88606,3,3,309827,309828,309831,1,4,0
88607,4,2,309831,309831,309833,0,2,0
88608,6,1,309837,309837,309838,0,1,4
88609,5,2,309842,309842,309844,0,2,4
88610,6,3,309848,309848,309851,0,3,4
88611,2,3,309850,309851,309854,1,4,0
88612,1,3,309851,309854,309857,3,6,0
88613,1,1,309852,309857,309858,5,6,0
88614,5,3,309857,309858,309861,1,4,0
88615,6,2,309863,309863,309865,0,2,2
88616,5,1,309868,309868,309869,0,1,3
88617,6,3,309874,309874,309877,0,3,5
88618,3,1,309877,309877,309878,0,1,0
88619,1,1,309878,309878,309879,0,1,0
88620,3,3,309881,309881,309884,0,3,2
88621,4,1,309885,309885,309886,0,1,1
88622,3,2,309888,309888,309890,0,2,2
88623,1,1,309889,309890,309891,1,2,0
88624,3,2,309892,309892,309894,0,2,1
88625,5,2,309897,309897,309899,0,2,3
88626,3,2,309900,309900,309902,0,2,1
88627,5,1,309905,309905,309906,0,1,3
88628,2,2,309907,309907,309909,0,2,1
88629,2,2,309909,309909,309911,0,2,0
88630,2,2,309911,309911,309913,0,2,0
88631,4,3,309915,309915,309918,0,3,2
88632,4,3,309919,309919,309922,0,3,1
88633,3,1,309922,309922,309923,0,1,0
88634,1,1,309923,309923,309924,0,1,0
88635,5,1,309928,309928,309929,0,1,4
88636,1,3,309929,309929,309932,0,3,0
88637,6,3,309935,309935,309938,0,3,3
88638,5,3,309940,309940,309943,0,3,2
88639,1,1,309941,309943,309944,2,3,0
88640,4,3,309945,309945,309948,0,3,1
88641,6,1,309951,309951,309952,0,1,3
88642,3,2,309954,309954,309956,0,2,2
88643,1,3,309955,309956,309959,1,4,0
88644,2,1,309957,309959,309960,2,3,0
88645,5,2,309962,309962,309964,0,2,2
88646,1,3,309963,309964,309967,1,4,0
88647,4,3,309967,309967,309970,0,3,0
88648,1,2,309968,309970,309972,2,4,0
88649,6,2,309974,309974,309976,0,2,2
88650,6,3,309980,309980,309983,0,3,4
88651,4,2,309984,309984,309986,0,2,1
88652,1,3,309985,309986,309989,1,4,0
88653,2,2,309987,309989,309991,2,4,0
88654,3,2,309990,309991,309993,1,3,0
88655,6,2,309996,309996,309998,0,2,3
88656,2,2,309998,309998,310000,0,2,0
88657,1,2,309999,310000,310002,1,3,0
88658,5,3,310004,310004,310007,0,3,2
88659,3,2,310007,310007,310009,0,2,0
88660,1,2,310008,310009,310011,1,3,0
88661,2,3,310010,310011,310014,1,4,0
88662,3,2,310013,310014,310016,1,3,0
88663,6,3,310019,310019,310022,0,3,3
88664,1,2,310020,310022,310024,2,4,0
88665,6,2,310026,310026,310028,0,2,2
88666,1,3,310027,310028,310031,1,4,0
88667,4,2,310031,310031,310033,0,2,0
88668,4,2,310035,310035,310037,0,2,2
88669,3,3,310038,310038,310041,0,3,1
88670,3,1,310041,310041,310042,0,1,0
88671,6,1,310047,310047,310048,0,1,5
88672,2,2,310049,310049,310051,0,2,1
88673,2,1,310051,310051,310052,0,1,0
88674,2,1,310053,310053,310054,0,1,1
88675,1,1,310054,310054,310055,0,1,0
88676,5,1,310059,310059,310060,0,1,4
88677,3,3,310062,310062,310065,0,3,2
88678,1,2,310063,310065,310067,2,4,0
88679,1,2,310064,310067,310069,3,5,0
88680,6,2,310070,310070,310072,0,2,1
88681,1,2,310071,310072,310074,1,3,0
88682,6,1,310077,310077,310078,0,1,3
88683,4,1,310081,310081,310082,0,1,3
88684,5,3,310086,310086,310089,0,3,4
88685,2,1,310088,310089,310090,1,2,0
88686,2,2,310090,310090,310092,0,2,0
88687,5,3,310095,310095,310098,0,3,3
88688,6,3,310101,310101,310104,0,3,3
88689,5,1,310106,310106,310107,0,1,2
88690,1,1,310107,310107,310108,0,1,0
88691,3,3,310110,310110,310113,0,3,2
88692,3,3,310113,310113,310116,0,3,0
88693,4,1,310117,310117,310118,0,1,1
88694,1,1,310118,310118,310119,0,1,0
88695,6,2,310124,310124,310126,0,2,5
88696,1,2,310125,310126,310128,1,3,0
88697,1,3,310126,310128,310131,2,5,0
88698,4,1,310130,310131,310132,1,2,0
88699,6,1,310136,310136,310137,0,1,4
88700,4,3,310140,310140,310143,0,3,3
88701,1,1,310141,310143,310144,2,3,0
88702,6,2,310147,310147,310149,0,2,3
88703,2,3,310149,310149,310152,0,3,0
88704,6,2,310155,310155,310157,0,2,3
88705,5,3,310160,310160,310163,0,3,3
88706,2,3,310162,310163,310166,1,4,0
88707,6,3,310168,310168,310171,0,3,2
88708,1,1,310169,310171,310172,2,3,0
88709,2,2,310171,310172,310174,1,3,0
88710,3,1,310174,310174,310175,0,1,0
88711,6,1,310180,310180,310181,0,1,5
88712,6,2,310186,310186,310188,0,2,5
88713,2,3,310188,310188,310191,0,3,0
88714,3,3,310191,310191,310194,0,3,0
88715,4,1,310195,310195,310196,0,1,1
88716,2,1,310197,310197,310198,0,1,1
88717,6,1,310203,310203,310204,0,1,5
88718,5,2,310208,310208,310210,0,2,4
88719,3,1,310211,310211,310212,0,1,1
88720,3,1,310214,310214,310215,0,1,2
88721,3,1,310217,310217,310218,0,1,2
88722,6,1,310223,310223,310224,0,1,5
88723,1,1,310224,310224,310225,0,1,0
88724,4,1,310228,310228,310229,0,1,3
88725,3,2,310231,310231,310233,0,2,2
88726,1,2,310232,310233,310235,1,3,0
88727,6,3,310238,310238,310241,0,3,3
88728,2,2,310240,310241,310243,1,3,0
88729,1,3,310241,310243,310246,2,5,0
88730,2,1,310243,310246,310247,3,4,0
88731,1,3,310244,310247,310250,3,6,0
88732,4,3,310248,310250,310253,2,5,0
88733,4,1,310252,310253,310254,1,2,0
88734,6,1,310258,310258,310259,0,1,4
88735,4,1,310262,310262,310263,0,1,3
88736,4,3,310266,310266,310269,0,3,3
88737,4,3,310270,310270,310273,0,3,1
88738,5,1,310275,310275,310276,0,1,2
88739,2,3,310277,310277,310280,0,3,1
88740,2,3,310279,310280,310283,1,4,0
88741,2,1,310281,310283,310284,2,3,0
88742,5,1,310286,310286,310287,0,1,2
88743,5,3,310291,310291,310294,0,3,4
88744,4,2,310295,310295,310297,0,2,1
88745,3,3,310298,310298,310301,0,3,1
88746,3,1,310301,310301,310302,0,1,0
88747,6,1,310307,310307,310308,0,1,5
88748,5,2,310312,310312,310314,0,2,4
88749,6,3,310318,310318,310321,0,3,4
88750,1,2,310319,310321,310323,2,4,0
88751,5,1,310324,310324,310325,0,1,1
88752,2,2,310326,310326,310328,0,2,1
88753,3,2,310329,310329,310331,0,2,1
88754,5,2,310334,310334,310336,0,2,3
88755,4,2,310338,310338,310340,0,2,2
88756,6,2,310344,310344,310346,0,2,4
88757,3,2,310347,310347,310349,0,2,1
88758,6,3,310353,310353,310356,0,3,4
88759,3,3,310356,310356,310359,0,3,0
88760,4,1,310360,310360,310361,0,1,1
88761,3,1,310363,310363,310364,0,1,2
88762,2,3,310365,310365,310368,0,3,1
88763,2,3,310367,310368,310371,1,4,0
88764,4,3,310371,310371,310374,0,3,0
88765,5,1,310376,310376,310377,0,1,2
88766,6,3,310382,310382,310385,0,3,5
88767,2,1,310384,310385,310386,1,2,0
88768,1,1,310385,310386,310387,1,2,0
88769,4,3,310389,310389,310392,0,3,2
88770,4,1,310393,310393,310394,0,1,1
88771,5,2,310398,310398,310400,0,2,4
88772,5,2,310403,310403,310405,0,2,3
88773,5,2,310408,310408,310410,0,2,3
88774,5,2,310413,310413,310415,0,2,3
88775,5,1,310418,310418,310419,0,1,3
88776,5,2,310423,310423,310425,0,2,4
88777,2,1,310425,310425,310426,0,1,0
88778,1,2,310426,310426,310428,0,2,0
88779,3,2,310429,310429,310431,0,2,1
88780,2,3,310431,310431,310434,0,3,0
88781,1,1,310432,310434,310435,2,3,0
88782,4,2,310436,310436,310438,0,2,1
88783,3,3,310439,310439,310442,0,3,1
88784,6,1,310445,310445,310446,0,1,3
88785,4,3,310449,310449,310452,0,3,3
88786,4,3,310453,310453,310456,0,3,1
88787,1,3,310454,310456,310459,2,5,0
88788,1,2,310455,310459,310461,4,6,0
88789,3,1,310458,310461,310462,3,4,0
88790,2,3,310460,310462,310465,2,5,0
88791,1,1,310461,310465,310466,4,5,0
88792,5,3,310466,310466,310469,0,3,0
88793,3,3,310469,310469,310472,0,3,0
88794,5,2,310474,310474,310476,0,2,2
88795,1,1,310475,310476,310477,1,2,0
88796,2,1,310477,310477,310478,0,1,0
88797,2,2,310479,310479,310481,0,2,1
88798,5,2,310484,310484,310486,0,2,3
88799,4,1,310488,310488,310489,0,1,2
88800,4,1,310492,310492,310493,0,1,3
88801,5,1,310497,310497,310498,0,1,4
88802,6,2,310503,310503,310505,0,2,5
88803,1,1,310504,310505,310506,1,2,0
88804,4,1,310508,310508,310509,0,1,2
88805,2,3,310510,310510,310513,0,3,1
88806,1,1,310511,310513,310514,2,3,0
88807,1,3,310512,310514,310517,2,5,0
88808,2,1,310514,310517,310518,3,4,0
88809,4,1,310518,310518,310519,0,1,0
88810,2,3,310520,310520,310523,0,3,1
88811,3,1,310523,310523,310524,0,1,0
88812,1,2,310524,310524,310526,0,2,0
88813,6,2,310530,310530,310532,0,2,4
88814,6,3,310536,310536,310539,0,3,4
88815,3,3,310539,310539,310542,0,3,0
88816,3,2,310542,310542,310544,0,2,0
88817,6,1,310548,310548,310549,0,1,4
88818,4,1,310552,310552,310553,0,1,3
88819,6,3,310558,310558,310561,0,3,5
88820,1,2,310559,310561,310563,2,4,0
88821,1,3,310560,310563,310566,3,6,0
88822,6,3,310566,310566,310569,0,3,0
88823,4,2,310570,310570,310572,0,2,1
88824,3,3,310573,310573,310576,0,3,1
88825,5,3,310578,310578,310581,0,3,2
88826,5,1,310583,310583,310584,0,1,2
88827,1,3,310584,310584,310587,0,3,0
88828,6,3,310590,310590,310593,0,3,3
88829,6,1,310596,310596,310597,0,1,3
88830,3,2,310599,310599,310601,0,2,2
88831,2,1,310601,310601,310602,0,1,0
88832,3,3,310604,310604,310607,0,3,2
88833,3,3,310607,310607,310610,0,3,0
88834,3,2,310610,310610,310612,0,2,0
88835,6,2,310616,310616,310618,0,2,4
88836,1,2,310617,310618,310620,1,3,0
88837,4,2,310621,310621,310623,0,2,1
88838,3,2,310624,310624,310626,0,2,1
88839,4,3,310628,310628,310631,0,3,2
88840,4,2,310632,310632,310634,0,2,1
88841,1,1,310633,310634,310635,1,2,0
88842,3,3,310636,310636,310639,0,3,1
88843,3,2,310639,310639,310641,0,2,0
88844,6,1,310645,310645,310646,0,1,4
88845,6,2,310651,310651,310653,0,2,5
88846,3,1,310654,310654,310655,0,1,1
88847,5,3,310659,310659,310662,0,3,4
88848,3,3,310662,310662,310665,0,3,0
88849,2,1,310664,310665,310666,1,2,0
88850,3,3,310667,310667,310670,0,3,1
88851,4,2,310671,310671,310673,0,2,1
88852,6,1,310677,310677,310678,0,1,4
88853,2,1,310679,310679,310680,0,1,1
88854,5,2,310684,310684,310686,0,2,4
88855,2,2,310686,310686,310688,0,2,0
88856,1,3,310687,310688,310691,1,4,0
88857,4,2,310691,310691,310693,0,2,0
88858,2,2,310693,310693,310695,0,2,0
88859,3,1,310696,310696,310697,0,1,1
88860,1,2,310697,310697,310699,0,2,0
88861,1,1,310698,310699,310700,1,2,0
88862,6,3,310704,310704,310707,0,3,4
88863,3,2,310707,310707,310709,0,2,0
88864,6,3,310713,310713,310716,0,3,4
88865,1,3,310714,310716,310719,2,5,0
88866,4,3,310718,310719,310722,1,4,0
88867,1,3,310719,310722,310725,3,6,0
88868,3,2,310722,310725,310727,3,5,0
88869,3,2,310725,310727,310729,2,4,0
88870,1,3,310726,310729,310732,3,6,0
88871,4,1,310730,310732,310733,2,3,0
88872,5,1,310735,310735,310736,0,1,2
88873,6,1,310741,310741,310742,0,1,5
88874,2,2,310743,310743,310745,0,2,1
88875,5,3,310748,310748,310751,0,3,3
88876,3,3,310751,310751,310754,0,3,0
88877,3,3,310754,310754,310757,0,3,0
88878,5,2,310759,310759,310761,0,2,2
88879,3,1,310762,310762,310763,0,1,1
88880,1,2,310763,310763,310765,0,2,0
88881,5,3,310768,310768,310771,0,3,3
88882,6,1,310774,310774,310775,0,1,3
88883,2,1,310776,310776,310777,0,1,1
88884,5,3,310781,310781,310784,0,3,4
88885,1,2,310782,310784,310786,2,4,0
88886,5,1,310787,310787,310788,0,1,1
88887,6,3,310793,310793,310796,0,3,5
88888,4,1,310797,310797,310798,0,1,1
88889,4,3,310801,310801,310804,0,3,3
88890,3,1,310804,310804,310805,0,1,0
88891,2,1,310806,310806,310807,0,1,1
88892,6,3,310812,310812,310815,0,3,5
88893,4,3,310816,310816,310819,0,3,1
88894,5,1,310821,310821,310822,0,1,2
88895,3,2,310824,310824,310826,0,2,2
88896,5,3,310829,310829,310832,0,3,3
88897,6,1,310835,310835,310836,0,1,3
88898,5,2,310840,310840,310842,0,2,4
88899,4,1,310844,310844,310845,0,1,2
88900,2,1,310846,310846,310847,0,1,1
88901,5,3,310851,310851,310854,0,3,4
88902,2,2,310853,310854,310856,1,3,0
88903,1,2,310854,310856,310858,2,4,0
88904,6,1,310860,310860,310861,0,1,2
88905,6,1,310866,310866,310867,0,1,5
88906,2,2,310868,310868,310870,0,2,1
88907,3,2,310871,310871,310873,0,2,1
88908,4,2,310875,310875,310877,0,2,2
88909,6,1,310881,310881,310882,0,1,4
88910,4,3,310885,310885,310888,0,3,3
88911,1,1,310886,310888,310889,2,3,0
88912,3,1,310889,310889,310890,0,1,0
88913,1,3,310890,310890,310893,0,3,0
88914,5,3,310895,310895,310898,0,3,2
88915,5,2,310900,310900,310902,0,2,2
88916,6,3,310906,310906,310909,0,3,4
88917,1,3,310907,310909,310912,2,5,0
88918,1,3,310908,310912,310915,4,7,0
88919,4,1,310912,310915,310916,3,4,0
88920,3,2,310915,310916,310918,1,3,0
88921,2,2,310917,310918,310920,1,3,0
88922,3,3,310920,310920,310923,0,3,0
88923,6,3,310926,310926,310929,0,3,3
88924,5,2,310931,310931,310933,0,2,2
88925,6,1,310937,310937,310938,0,1,4
88926,6,2,310943,310943,310945,0,2,5
88927,6,1,310949,310949,310950,0,1,4
88928,1,1,310950,310950,310951,0,1,0
88929,2,2,310952,310952,310954,0,2,1
88930,1,3,310953,310954,310957,1,4,0
88931,6,2,310959,310959,310961,0,2,2
88932,4,2,310963,310963,310965,0,2,2
88933,3,1,310966,310966,310967,0,1,1
88934,5,3,310971,310971,310974,0,3,4
88935,2,3,310973,310974,310977,1,4,0
88936,4,3,310977,310977,310980,0,3,0
88937,3,1,310980,310980,310981,0,1,0
88938,3,1,310983,310983,310984,0,1,2
88939,5,2,310988,310988,310990,0,2,4
88940,4,1,310992,310992,310993,0,1,2
88941,5,3,310997,310997,311000,0,3,4
88942,1,1,310998,311000,311001,2,3,0
88943,1,3,310999,311001,311004,2,5,0
88944,2,1,311001,311004,311005,3,4,0
88945,2,2,311003,311005,311007,2,4,0
88946,5,3,311008,311008,311011,0,3,1
88947,2,1,311010,311011,311012,1,2,0
88948,5,2,311015,311015,311017,0,2,3
88949,1,3,311016,311017,311020,1,4,0
88950,4,1,311020,311020,311021,0,1,0
88951,2,3,311022,311022,311025,0,3,1
88952,6,1,311028,311028,311029,0,1,3
88953,6,1,311034,311034,311035,0,1,5
88954,2,2,311036,311036,311038,0,2,1
88955,6,3,311042,311042,311045,0,3,4
88956,6,1,311048,311048,311049,0,1,3
88957,5,2,311053,311053,311055,0,2,4
88958,6,3,311059,311059,311062,0,3,4
88959,2,1,311061,311062,311063,1,2,0
88960,6,1,311067,311067,311068,0,1,4
88961,2,1,311069,311069,311070,0,1,1
88962,1,2,311070,311070,311072,0,2,0
88963,4,2,311074,311074,311076,0,2,2
88964,4,2,311078,311078,311080,0,2,2
88965,5,3,311083,311083,311086,0,3,3
88966,5,1,311088,311088,311089,0,1,2
88967,5,1,311093,311093,311094,0,1,4
88968,6,3,311099,311099,311102,0,3,5
88969,4,2,311103,311103,311105,0,2,1
88970,5,3,311108,311108,311111,0,3,3
88971,4,1,311112,311112,311113,0,1,1
88972,4,2,311116,311116,311118,0,2,3
88973,5,1,311121,311121,311122,0,1,3
88974,5,1,311126,311126,311127,0,1,4
88975,2,1,311128,311128,311129,0,1,1
88976,5,3,311133,311133,311136,0,3,4
88977,6,3,311139,311139,311142,0,3,3
88978,4,2,311143,311143,311145,0,2,1
88979,1,3,311144,311145,311148,1,4,0
88980,5,3,311149,311149,311152,0,3,1
88981,4,3,311153,311153,311156,0,3,1
88982,5,1,311158,311158,311159,0,1,2
88983,6,3,311164,311164,311167,0,3,5
88984,2,1,311166,311167,311168,1,2,0
88985,4,2,311170,311170,311172,0,2,2
88986,2,3,311172,311172,311175,0,3,0
88987,4,3,311176,311176,311179,0,3,1
88988,6,1,311182,311182,311183,0,1,3
88989,4,2,311186,311186,311188,0,2,3
88990,2,1,311188,311188,311189,0,1,0
88991,5,3,311193,311193,311196,0,3,4
88992,5,2,311198,311198,311200,0,2,2
88993,6,3,311204,311204,311207,0,3,4
88994,3,3,311207,311207,311210,0,3,0
88995,3,3,311210,311210,311213,0,3,0
88996,6,2,311216,311216,311218,0,2,3
88997,5,3,311221,311221,311224,0,3,3
88998,2,3,311223,311224,311227,1,4,0
88999,4,2,311227,311227,311229,0,2,0
89000,2,2,311229,311229,311231,0,2,0
89001,1,1,311230,311231,311232,1,2,0
89002,6,3,311236,311236,311239,0,3,4
89003,4,3,311240,311240,311243,0,3,1
89004,5,3,311245,311245,311248,0,3,2
89005,2,3,311247,311248,311251,1,4,0
89006,2,1,311249,311251,311252,2,3,0
89007,2,2,311251,311252,311254,1,3,0
89008,6,2,311257,311257,311259,0,2,3
89009,2,1,311259,311259,311260,0,1,0
89010,1,2,311260,311260,311262,0,2,0
89011,3,2,311263,311263,311265,0,2,1
89012,1,2,311264,311265,311267,1,3,0
89013,1,3,311265,311267,311270,2,5,0
89014,3,3,311268,311270,311273,2,5,0
89015,1,3,311269,311273,311276,4,7,0
89016,1,2,311270,311276,311278,6,8,0
89017,2,2,311272,311278,311280,6,8,0
89018,1,3,311273,311280,311283,7,10,0
89019,3,1,311276,311283,311284,7,8,0
89020,5,1,311281,311284,311285,3,4,0
89021,2,2,311283,311285,311287,2,4,0
89022,3,2,311286,311287,311289,1,3,0
89023,2,2,311288,311289,311291,1,3,0
89024,3,3,311291,311291,311294,0,3,0
89025,2,2,311293,311294,311296,1,3,0
89026,1,1,311294,311296,311297,2,3,0
89027,4,3,311298,311298,311301,0,3,1
89028,3,2,311301,311301,311303,0,2,0
89029,5,2,311306,311306,311308,0,2,3
89030,5,2,311311,311311,311313,0,2,3
89031,5,2,311316,311316,311318,0,2,3
89032,3,2,311319,311319,311321,0,2,1
89033,5,3,311324,311324,311327,0,3,3
89034,3,2,311327,311327,311329,0,2,0
89035,2,2,311329,311329,311331,0,2,0
89036,2,1,311331,311331,311332,0,1,0
89037,2,2,311333,311333,311335,0,2,1
89038,4,1,311337,311337,311338,0,1,2
89039,4,3,311341,311341,311344,0,3,3
89040,2,3,311343,311344,311347,1,4,0
89041,1,1,311344,311347,311348,3,4,0
89042,3,3,311347,311348,311351,1,4,0
89043,4,2,311351,311351,311353,0,2,0
89044,2,2,311353,311353,311355,0,2,0
89045,6,2,311359,311359,311361,0,2,4
89046,1,2,311360,311361,311363,1,3,0
89047,4,1,311364,311364,311365,0,1,1
89048,4,1,311368,311368,311369,0,1,3
89049,6,2,311374,311374,311376,0,2,5
89050,2,2,311376,311376,311378,0,2,0
89051,6,1,311382,311382,311383,0,1,4
89052,4,1,311386,311386,311387,0,1,3
89053,4,3,311390,311390,311393,0,3,3
89054,4,1,311394,311394,311395,0,1,1
89055,6,3,311400,311400,311403,0,3,5
89056,4,2,311404,311404,311406,0,2,1
89057,4,1,311408,311408,311409,0,1,2
89058,4,2,311412,311412,311414,0,2,3
89059,2,3,311414,311414,311417,0,3,0
89060,3,1,311417,311417,311418,0,1,0
89061,6,3,311423,311423,311426,0,3,5
89062,2,1,311425,311426,311427,1,2,0
89063,6,1,311431,311431,311432,0,1,4
89064,4,2,311435,311435,311437,0,2,3
89065,3,3,311438,311438,311441,0,3,1
89066,3,1,311441,311441,311442,0,1,0
89067,4,1,311445,311445,311446,0,1,3
89068,5,2,311450,311450,311452,0,2,4
89069,4,1,311454,311454,311455,0,1,2
89070,2,3,311456,311456,311459,0,3,1
89071,4,2,311460,311460,311462,0,2,1
89072,3,2,311463,311463,311465,0,2,1
89073,5,2,311468,311468,311470,0,2,3
89074,1,1,311469,311470,311471,1,2,0
89075,2,2,311471,311471,311473,0,2,0
89076,5,3,311476,311476,311479,0,3,3
89077,6,3,311482,311482,311485,0,3,3
89078,5,3,311487,311487,311490,0,3,2
89079,3,2,311490,311490,311492,0,2,0
89080,3,3,311493,311493,311496,0,3,1
89081,5,1,311498,311498,311499,0,1,2
89082,4,3,311502,311502,311505,0,3,3
89083,5,3,311507,311507,311510,0,3,2
89084,5,2,311512,311512,311514,0,2,2
89085,1,1,311513,311514,311515,1,2,0
89086,6,3,311519,311519,311522,0,3,4
89087,5,2,311524,311524,311526,0,2,2
89088,5,1,311529,311529,311530,0,1,3
89089,4,1,311533,311533,311534,0,1,3
89090,6,1,311539,311539,311540,0,1,5
89091,3,3,311542,311542,311545,0,3,2
89092,1,2,311543,311545,311547,2,4,0
89093,1,3,311544,311547,311550,3,6,0
89094,3,2,311547,311550,311552,3,5,0
89095,5,3,311552,311552,311555,0,3,0
89096,4,2,311556,311556,311558,0,2,1
89097,2,2,311558,311558,311560,0,2,0
89098,5,3,311563,311563,311566,0,3,3
89099,1,1,311564,311566,311567,2,3,0
89100,2,2,311566,311567,311569,1,3,0
89101,6,1,311572,311572,311573,0,1,3
89102,1,1,311573,311573,311574,0,1,0
89103,1,1,311574,311574,311575,0,1,0
89104,5,3,311579,311579,311582,0,3,4
89105,3,2,311582,311582,311584,0,2,0
89106,2,1,311584,311584,311585,0,1,0
89107,5,1,311589,311589,311590,0,1,4
89108,4,2,311593,311593,311595,0,2,3
89109,2,2,311595,311595,311597,0,2,0
89110,5,3,311600,311600,311603,0,3,3
89111,4,3,311604,311604,311607,0,3,1
89112,3,3,311607,311607,311610,0,3,0
89113,2,1,311609,311610,311611,1,2,0
89114,3,1,311612,311612,311613,0,1,1
89115,6,2,311618,311618,311620,0,2,5
89116,1,2,311619,311620,311622,1,3,0
89117,5,3,311624,311624,311627,0,3,2
89118,3,3,311627,311627,311630,0,3,0
89119,4,2,311631,311631,311633,0,2,1
89120,4,2,311635,311635,311637,0,2,2
89121,5,3,311640,311640,311643,0,3,3
89122,5,3,311645,311645,311648,0,3,2
89123,3,3,311648,311648,311651,0,3,0
89124,2,3,311650,311651,311654,1,4,0
89125,2,1,311652,311654,311655,2,3,0
89126,3,1,311655,311655,311656,0,1,0
89127,6,2,311661,311661,311663,0,2,5
89128,2,3,311663,311663,311666,0,3,0
89129,3,3,311666,311666,311669,0,3,0
89130,4,2,311670,311670,311672,0,2,1
89131,1,2,311671,311672,311674,1,3,0
89132,5,2,311676,311676,311678,0,2,2
89133,1,3,311677,311678,311681,1,4,0
89134,2,3,311679,311681,311684,2,5,0
89135,2,1,311681,311684,311685,3,4,0
89136,6,1,311687,311687,311688,0,1,2
89137,3,1,311690,311690,311691,0,1,2
89138,3,3,311693,311693,311696,0,3,2
89139,5,2,311698,311698,311700,0,2,2
89140,3,2,311701,311701,311703,0,2,1
89141,2,2,311703,311703,311705,0,2,0
89142,3,2,311706,311706,311708,0,2,1
89143,5,1,311711,311711,311712,0,1,3
89144,4,3,311715,311715,311718,0,3,3
89145,1,3,311716,311718,311721,2,5,0
89146,1,3,311717,311721,311724,4,7,0
89147,4,3,311721,311724,311727,3,6,0
89148,5,1,311726,311727,311728,1,2,0
89149,6,3,311732,311732,311735,0,3,4
89150,1,3,311733,311735,311738,2,5,0
89151,1,2,311734,311738,311740,4,6,0
89152,2,3,311736,311740,311743,4,7,0
89153,5,3,311741,311743,311746,2,5,0
89154,5,1,311746,311746,311747,0,1,0
89155,6,1,311752,311752,311753,0,1,5
89156,4,1,311756,311756,311757,0,1,3
89157,1,3,311757,311757,311760,0,3,0
89158,6,2,311763,311763,311765,0,2,3
89159,4,3,311767,311767,311770,0,3,2
89160,3,3,311770,311770,311773,0,3,0
89161,3,3,311773,311773,311776,0,3,0
89162,6,3,311779,311779,311782,0,3,3
89163,6,3,311785,311785,311788,0,3,3
89164,5,2,311790,311790,311792,0,2,2
89165,2,2,311792,311792,311794,0,2,0
89166,3,1,311795,311795,311796,0,1,1
89167,4,1,311799,311799,311800,0,1,3
89168,5,3,311804,311804,311807,0,3,4
89169,3,2,311807,311807,311809,0,2,0
89170,1,1,311808,311809,311810,1,2,0
89171,3,1,311811,311811,311812,0,1,1
89172,4,3,311815,311815,311818,0,3,3
89173,3,1,311818,311818,311819,0,1,0
89174,4,1,311822,311822,311823,0,1,3
89175,4,3,311826,311826,311829,0,3,3
89176,2,1,311828,311829,311830,1,2,0
89177,6,2,311834,311834,311836,0,2,4
89178,3,1,311837,311837,311838,0,1,1
89179,6,3,311843,311843,311846,0,3,5
89180,4,3,311847,311847,311850,0,3,1
89181,2,3,311849,311850,311853,1,4,0
89182,5,1,311854,311854,311855,0,1,1
89183,4,1,311858,311858,311859,0,1,3
89184,4,1,311862,311862,311863,0,1,3
89185,2,2,311864,311864,311866,0,2,1
89186,2,3,311866,311866,311869,0,3,0
89187,6,1,311872,311872,311873,0,1,3
89188,1,3,311873,311873,311876,0,3,0
89189,2,1,311875,311876,311877,1,2,0
89190,3,2,311878,311878,311880,0,2,1
89191,5,3,311883,311883,311886,0,3,3
89192,3,3,311886,311886,311889,0,3,0
89193,2,3,311888,311889,311892,1,4,0
89194,5,3,311893,311893,311896,0,3,1
89195,6,3,311899,311899,311902,0,3,3
89196,2,2,311901,311902,311904,1,3,0
89197,1,2,311902,311904,311906,2,4,0
89198,5,1,311907,311907,311908,0,1,1
89199,6,1,311913,311913,311914,0,1,5
89200,5,2,311918,311918,311920,0,2,4
89201,2,3,311920,311920,311923,0,3,0
89202,5,1,311925,311925,311926,0,1,2
89203,4,1,311929,311929,311930,0,1,3
89204,5,1,311934,311934,311935,0,1,4
89205,6,1,311940,311940,311941,0,1,5
89206,3,2,311943,311943,311945,0,2,2
89207,3,3,311946,311946,311949,0,3,1
89208,4,3,311950,311950,311953,0,3,1
89209,6,1,311956,311956,311957,0,1,3
89210,5,1,311961,311961,311962,0,1,4
89211,3,2,311964,311964,311966,0,2,2
89212,1,3,311965,311966,311969,1,4,0
89213,1,1,311966,311969,311970,3,4,0
89214,2,1,311968,311970,311971,2,3,0
89215,3,1,311971,311971,311972,0,1,0
89216,2,1,311973,311973,311974,0,1,1
89217,1,3,311974,311974,311977,0,3,0
89218,6,3,311980,311980,311983,0,3,3
89219,4,3,311984,311984,311987,0,3,1
89220,3,2,311987,311987,311989,0,2,0
89221,2,3,311989,311989,311992,0,3,0
89222,2,2,311991,311992,311994,1,3,0
89223,2,1,311993,311994,311995,1,2,0
89224,4,3,311997,311997,312000,0,3,2
89225,2,2,311999,312000,312002,1,3,0
89226,1,1,312000,312002,312003,2,3,0
89227,4,2,312004,312004,312006,0,2,1
89228,2,1,312006,312006,312007,0,1,0
89229,2,1,312008,312008,312009,0,1,1
89230,6,2,312014,312014,312016,0,2,5
89231,1,1,312015,312016,312017,1,2,0
89232,6,3,312021,312021,312024,0,3,4
89233,2,3,312023,312024,312027,1,4,0
89234,1,2,312024,312027,312029,3,5,0
89235,3,3,312027,312029,312032,2,5,0
89236,4,1,312031,312032,312033,1,2,0
89237,4,3,312035,312035,312038,0,3,2
89238,4,1,312039,312039,312040,0,1,1
89239,2,2,312041,312041,312043,0,2,1
89240,4,2,312045,312045,312047,0,2,2
89241,4,2,312049,312049,312051,0,2,2
89242,3,3,312052,312052,312055,0,3,1
89243,1,3,312053,312055,312058,2,5,0
89244,4,1,312057,312058,312059,1,2,0
89245,2,1,312059,312059,312060,0,1,0
89246,6,1,312065,312065,312066,0,1,5
89247,3,1,312068,312068,312069,0,1,2
89248,5,3,312073,312073,312076,0,3,4
89249,6,1,312079,312079,312080,0,1,3
89250,2,1,312081,312081,312082,0,1,1
89251,1,2,312082,312082,312084,0,2,0
89252,5,2,312087,312087,312089,0,2,3
89253,5,2,312092,312092,312094,0,2,3
89254,5,2,312097,312097,312099,0,2,3
89255,6,2,312103,312103,312105,0,2,4
89256,4,2,312107,312107,312109,0,2,2
89257,1,3,312108,312109,312112,1,4,0
89258,3,3,312111,312112,312115,1,4,0
89259,3,1,312114,312115,312116,1,2,0
89260,2,3,312116,312116,312119,0,3,0
89261,2,3,312118,312119,312122,1,4,0
89262,6,1,312124,312124,312125,0,1,2
89263,5,3,312129,312129,312132,0,3,4
89264,4,3,312133,312133,312136,0,3,1
89265,3,3,312136,312136,312139,0,3,0
89266,1,1,312137,312139,312140,2,3,0
89267,3,2,312140,312140,312142,0,2,0
89268,6,1,312146,312146,312147,0,1,4
89269,1,3,312147,312147,312150,0,3,0
89270,5,3,312152,312152,312155,0,3,2
89271,4,2,312156,312156,312158,0,2,1
89272,3,2,312159,312159,312161,0,2,1
89273,2,1,312161,312161,312162,0,1,0
89274,6,3,312167,312167,312170,0,3,5
89275,2,1,312169,312170,312171,1,2,0
89276,4,3,312173,312173,312176,0,3,2
89277,1,2,312174,312176,312178,2,4,0
89278,2,1,312176,312178,312179,2,3,0
89279,1,3,312177,312179,312182,2,5,0
89280,5,1,312182,312182,312183,0,1,0
89281,3,3,312185,312185,312188,0,3,2
89282,3,3,312188,312188,312191,0,3,0
89283,6,3,312194,312194,312197,0,3,3
89284,6,3,312200,312200,312203,0,3,3
89285,5,3,312205,312205,312208,0,3,2
89286,2,3,312207,312208,312211,1,4,0
89287,6,3,312213,312213,312216,0,3,2
89288,6,2,312219,312219,312221,0,2,3
89289,4,1,312223,312223,312224,0,1,2
89290,5,2,312228,312228,312230,0,2,4
89291,1,3,312229,312230,312233,1,4,0
89292,4,3,312233,312233,312236,0,3,0
89293,4,1,312237,312237,312238,0,1,1
89294,4,2,312241,312241,312243,0,2,3
89295,1,2,312242,312243,312245,1,3,0
89296,4,1,312246,312246,312247,0,1,1
89297,4,1,312250,312250,312251,0,1,3
89298,2,3,312252,312252,312255,0,3,1
89299,5,2,312257,312257,312259,0,2,2
89300,5,3,312262,312262,312265,0,3,3
89301,2,2,312264,312265,312267,1,3,0
89302,3,1,312267,312267,312268,0,1,0
89303,1,1,312268,312268,312269,0,1,0
89304,4,3,312272,312272,312275,0,3,3
89305,4,1,312276,312276,312277,0,1,1
89306,1,1,312277,312277,312278,0,1,0
89307,6,1,312283,312283,312284,0,1,5
89308,5,2,312288,312288,312290,0,2,4
89309,5,3,312293,312293,312296,0,3,3
89310,6,2,312299,312299,312301,0,2,3
89311,2,2,312301,312301,312303,0,2,0
89312,2,2,312303,312303,312305,0,2,0
89313,3,2,312306,312306,312308,0,2,1
89314,3,1,312309,312309,312310,0,1,1
89315,3,1,312312,312312,312313,0,1,2
89316,6,3,312318,312318,312321,0,3,5
89317,3,2,312321,312321,312323,0,2,0
89318,2,2,312323,312323,312325,0,2,0
89319,5,1,312328,312328,312329,0,1,3
89320,1,3,312329,312329,312332,0,3,0
89321,1,1,312330,312332,312333,2,3,0
89322,1,1,312331,312333,312334,2,3,0
89323,2,3,312333,312334,312337,1,4,0
89324,1,3,312334,312337,312340,3,6,0
89325,2,3,312336,312340,312343,4,7,0
89326,3,3,312339,312343,312346,4,7,0
89327,3,1,312342,312346,312347,4,5,0
89328,3,1,312345,312347,312348,2,3,0
89329,4,3,312349,312349,312352,0,3,1
89330,2,1,312351,312352,312353,1,2,0
89331,1,3,312352,312353,312356,1,4,0
89332,2,2,312354,312356,312358,2,4,0
89333,2,3,312356,312358,312361,2,5,0
89334,3,3,312359,312361,312364,2,5,0
89335,1,2,312360,312364,312366,4,6,0
89336,2,2,312362,312366,312368,4,6,0
89337,2,2,312364,312368,312370,4,6,0
89338,2,3,312366,312370,312373,4,7,0
89339,3,2,312369,312373,312375,4,6,0
89340,2,3,312371,312375,312378,4,7,0
89341,4,3,312375,312378,312381,3,6,0
89342,1,1,312376,312381,312382,5,6,0
89343,4,1,312380,312382,312383,2,3,0
89344,4,3,312384,312384,312387,0,3,1
89345,2,2,312386,312387,312389,1,3,0
89346,2,3,312388,312389,312392,1,4,0
89347,4,1,312392,312392,312393,0,1,0
89348,2,2,312394,312394,312396,0,2,1
89349,6,1,312400,312400,312401,0,1,4
89350,4,2,312404,312404,312406,0,2,3
89351,5,3,312409,312409,312412,0,3,3
89352,2,2,312411,312412,312414,1,3,0
89353,2,3,312413,312414,312417,1,4,0
89354,1,1,312414,312417,312418,3,4,0
89355,3,2,312417,312418,312420,1,3,0
89356,5,2,312422,312422,312424,0,2,2
89357,6,1,312428,312428,312429,0,1,4
89358,3,2,312431,312431,312433,0,2,2
89359,2,3,312433,312433,312436,0,3,0
89360,4,1,312437,312437,312438,0,1,1
89361,2,3,312439,312439,312442,0,3,1
89362,3,3,312442,312442,312445,0,3,0
89363,6,3,312448,312448,312451,0,3,3
89364,2,3,312450,312451,312454,1,4,0
89365,5,1,312455,312455,312456,0,1,1
89366,3,3,312458,312458,312461,0,3,2
89367,4,1,312462,312462,312463,0,1,1
89368,6,3,312468,312468,312471,0,3,5
89369,6,2,312474,312474,312476,0,2,3
89370,5,2,312479,312479,312481,0,2,3
89371,4,3,312483,312483,312486,0,3,2
89372,1,1,312484,312486,312487,2,3,0
89373,3,1,312487,312487,312488,0,1,0
89374,4,1,312491,312491,312492,0,1,3
89375,6,2,312497,312497,312499,0,2,5
89376,6,2,312503,312503,312505,0,2,4
89377,5,2,312508,312508,312510,0,2,3
89378,2,1,312510,312510,312511,0,1,0
89379,2,2,312512,312512,312514,0,2,1
89380,3,1,312515,312515,312516,0,1,1
89381,2,1,312517,312517,312518,0,1,1
89382,6,3,312523,312523,312526,0,3,5
89383,3,3,312526,312526,312529,0,3,0
89384,3,3,312529,312529,312532,0,3,0
89385,4,2,312533,312533,312535,0,2,1
89386,6,1,312539,312539,312540,0,1,4
89387,4,3,312543,312543,312546,0,3,3
89388,5,2,312548,312548,312550,0,2,2
89389,1,3,312549,312550,312553,1,4,0
89390,6,2,312555,312555,312557,0,2,2
89391,6,1,312561,312561,312562,0,1,4
89392,3,2,312564,312564,312566,0,2,2
89393,1,2,312565,312566,312568,1,3,0
89394,1,3,312566,312568,312571,2,5,0
89395,4,3,312570,312571,312574,1,4,0
89396,2,2,312572,312574,312576,2,4,0
89397,5,2,312577,312577,312579,0,2,1
89398,1,1,312578,312579,312580,1,2,0
89399,1,2,312579,312580,312582,1,3,0
89400,4,1,312583,312583,312584,0,1,1
89401,3,1,312586,312586,312587,0,1,2
89402,3,1,312589,312589,312590,0,1,2
89403,2,3,312591,312591,312594,0,3,1
89404,5,2,312596,312596,312598,0,2,2
89405,1,2,312597,312598,312600,1,3,0
89406,1,3,312598,312600,312603,2,5,0
89407,6,1,312604,312604,312605,0,1,1
89408,3,1,312607,312607,312608,0,1,2
89409,1,1,312608,312608,312609,0,1,0
89410,2,3,312610,312610,312613,0,3,1
89411,1,2,312611,312613,312615,2,4,0
89412,5,1,312616,312616,312617,0,1,1
89413,1,1,312617,312617,312618,0,1,0
89414,5,3,312622,312622,312625,0,3,4
89415,6,3,312628,312628,312631,0,3,3
89416,4,3,312632,312632,312635,0,3,1
89417,3,1,312635,312635,312636,0,1,0
89418,1,2,312636,312636,312638,0,2,0
89419,4,3,312640,312640,312643,0,3,2
89420,3,2,312643,312643,312645,0,2,0
89421,4,1,312647,312647,312648,0,1,2
89422,3,2,312650,312650,312652,0,2,2
89423,5,1,312655,312655,312656,0,1,3
89424,3,2,312658,312658,312660,0,2,2
89425,6,3,312664,312664,312667,0,3,4
89426,5,1,312669,312669,312670,0,1,2
89427,3,1,312672,312672,312673,0,1,2
89428,4,1,312676,312676,312677,0,1,3
89429,3,1,312679,312679,312680,0,1,2
89430,3,1,312682,312682,312683,0,1,2
89431,3,1,312685,312685,312686,0,1,2
89432,4,1,312689,312689,312690,0,1,3
89433,1,3,312690,312690,312693,0,3,0
89434,2,2,312692,312693,312695,1,3,0
89435,2,3,312694,312695,312698,1,4,0
89436,2,2,312696,312698,312700,2,4,0
89437,3,2,312699,312700,312702,1,3,0
89438,5,3,312704,312704,312707,0,3,2
89439,4,3,312708,312708,312711,0,3,1
89440,6,1,312714,312714,312715,0,1,3
89441,5,1,312719,312719,312720,0,1,4
89442,3,1,312722,312722,312723,0,1,2
89443,2,3,312724,312724,312727,0,3,1
89444,1,2,312725,312727,312729,2,4,0
89445,3,3,312728,312729,312732,1,4,0
89446,5,2,312733,312733,312735,0,2,1
89447,4,1,312737,312737,312738,0,1,2
89448,6,3,312743,312743,312746,0,3,5
89449,6,1,312749,312749,312750,0,1,3
89450,4,3,312753,312753,312756,0,3,3
89451,3,2,312756,312756,312758,0,2,0
89452,6,2,312762,312762,312764,0,2,4
89453,2,2,312764,312764,312766,0,2,0
89454,2,1,312766,312766,312767,0,1,0
89455,3,1,312769,312769,312770,0,1,2
89456,3,1,312772,312772,312773,0,1,2
89457,2,2,312774,312774,312776,0,2,1
89458,4,2,312778,312778,312780,0,2,2
89459,2,1,312780,312780,312781,0,1,0
89460,4,2,312784,312784,312786,0,2,3
89461,2,2,312786,312786,312788,0,2,0
89462,2,2,312788,312788,312790,0,2,0
89463,1,2,312789,312790,312792,1,3,0
89464,2,2,312791,312792,312794,1,3,0
89465,2,3,312793,312794,312797,1,4,0
89466,4,2,312797,312797,312799,0,2,0
89467,3,2,312800,312800,312802,0,2,1
89468,4,2,312804,312804,312806,0,2,2
89469,1,3,312805,312806,312809,1,4,0
89470,3,3,312808,312809,312812,1,4,0
89471,5,3,312813,312813,312816,0,3,1
89472,2,3,312815,312816,312819,1,4,0
89473,3,2,312818,312819,312821,1,3,0
89474,5,3,312823,312823,312826,0,3,2
89475,6,1,312829,312829,312830,0,1,3
89476,6,2,312835,312835,312837,0,2,5
89477,6,2,312841,312841,312843,0,2,4
89478,1,1,312842,312843,312844,1,2,0
89479,1,3,312843,312844,312847,1,4,0
89480,5,2,312848,312848,312850,0,2,1
89481,4,3,312852,312852,312855,0,3,2
89482,5,3,312857,312857,312860,0,3,2
89483,5,2,312862,312862,312864,0,2,2
89484,4,3,312866,312866,312869,0,3,2
89485,4,1,312870,312870,312871,0,1,1
89486,1,2,312871,312871,312873,0,2,0
89487,2,1,312873,312873,312874,0,1,0
89488,6,1,312879,312879,312880,0,1,5
89489,6,3,312885,312885,312888,0,3,5
89490,3,3,312888,312888,312891,0,3,0
89491,6,3,312894,312894,312897,0,3,3
89492,1,2,312895,312897,312899,2,4,0
89493,3,2,312898,312899,312901,1,3,0
89494,3,3,312901,312901,312904,0,3,0
89495,4,1,312905,312905,312906,0,1,1
89496,6,3,312911,312911,312914,0,3,5
89497,2,3,312913,312914,312917,1,4,0
89498,6,2,312919,312919,312921,0,2,2
89499,1,1,312920,312921,312922,1,2,0
89500,4,1,312924,312924,312925,0,1,2
89501,6,2,312930,312930,312932,0,2,5
89502,3,2,312933,312933,312935,0,2,1
89503,2,1,312935,312935,312936,0,1,0
89504,6,1,312941,312941,312942,0,1,5
89505,5,1,312946,312946,312947,0,1,4
89506,2,1,312948,312948,312949,0,1,1
89507,5,1,312953,312953,312954,0,1,4
89508,4,2,312957,312957,312959,0,2,3
89509,4,2,312961,312961,312963,0,2,2
89510,4,3,312965,312965,312968,0,3,2
89511,2,1,312967,312968,312969,1,2,0
89512,3,2,312970,312970,312972,0,2,1
89513,6,3,312976,312976,312979,0,3,4
89514,5,3,312981,312981,312984,0,3,2
89515,1,2,312982,312984,312986,2,4,0
89516,2,3,312984,312986,312989,2,5,0
89517,2,1,312986,312989,312990,3,4,0
89518,1,1,312987,312990,312991,3,4,0
89519,3,1,312990,312991,312992,1,2,0
89520,1,1,312991,312992,312993,1,2,0
89521,6,2,312997,312997,312999,0,2,4
89522,6,2,313003,313003,313005,0,2,4
89523,4,2,313007,313007,313009,0,2,2
89524,3,1,313010,313010,313011,0,1,1
89525,6,2,313016,313016,313018,0,2,5
89526,3,3,313019,313019,313022,0,3,1
89527,1,2,313020,313022,313024,2,4,0
89528,4,2,313024,313024,313026,0,2,0
89529,3,2,313027,313027,313029,0,2,1
89530,4,3,313031,313031,313034,0,3,2
89531,5,2,313036,313036,313038,0,2,2
89532,6,2,313042,313042,313044,0,2,4
89533,3,2,313045,313045,313047,0,2,1
89534,2,3,313047,313047,313050,0,3,0
89535,1,1,313048,313050,313051,2,3,0
89536,4,1,313052,313052,313053,0,1,1
89537,2,3,313054,313054,313057,0,3,1
89538,6,2,313060,313060,313062,0,2,3
89539,4,2,313064,313064,313066,0,2,2
89540,4,3,313068,313068,313071,0,3,2
89541,4,1,313072,313072,313073,0,1,1
89542,2,2,313074,313074,313076,0,2,1
89543,6,1,313080,313080,313081,0,1,4
89544,1,3,313081,313081,313084,0,3,0
89545,2,2,313083,313084,313086,1,3,0
89546,1,3,313084,313086,313089,2,5,0
89547,1,2,313085,313089,313091,4,6,0
89548,5,2,313090,313091,313093,1,3,0
89549,1,3,313091,313093,313096,2,5,0
89550,2,3,313093,313096,313099,3,6,0
89551,5,1,313098,313099,313100,1,2,0
89552,3,3,313101,313101,313104,0,3,1
89553,3,1,313104,313104,313105,0,1,0
89554,1,1,313105,313105,313106,0,1,0
89555,1,1,313106,313106,313107,0,1,0
89556,2,1,313108,313108,313109,0,1,1
89557,5,3,313113,313113,313116,0,3,4
89558,2,3,313115,313116,313119,1,4,0
89559,4,1,313119,313119,313120,0,1,0
89560,5,3,313124,313124,313127,0,3,4
89561,2,2,313126,313127,313129,1,3,0
89562,6,3,313132,313132,313135,0,3,3
89563,5,3,313137,313137,313140,0,3,2
89564,5,3,313142,313142,313145,0,3,2
89565,3,1,313145,313145,313146,0,1,0
89566,5,3,313150,313150,313153,0,3,4
89567,1,1,313151,313153,313154,2,3,0
89568,3,2,313154,313154,313156,0,2,0
89569,4,2,313158,313158,313160,0,2,2
89570,4,1,313162,313162,313163,0,1,2
89571,6,1,313168,313168,313169,0,1,5
89572,2,3,313170,313170,313173,0,3,1
89573,5,2,313175,313175,313177,0,2,2
89574,2,1,313177,313177,313178,0,1,0
89575,6,2,313183,313183,313185,0,2,5
89576,6,1,313189,313189,313190,0,1,4
89577,5,3,313194,313194,313197,0,3,4
89578,2,3,313196,313197,313200,1,4,0
89579,1,3,313197,313200,313203,3,6,0
89580,3,1,313200,313203,313204,3,4,0
89581,4,3,313204,313204,313207,0,3,0
89582,2,3,313206,313207,313210,1,4,0
89583,5,3,313211,313211,313214,0,3,1
89584,2,1,313213,313214,313215,1,2,0
89585,6,3,313219,313219,313222,0,3,4
89586,6,2,313225,313225,313227,0,2,3
89587,3,1,313228,313228,313229,0,1,1
89588,1,1,313229,313229,313230,0,1,0
89589,4,2,313233,313233,313235,0,2,3
89590,3,2,313236,313236,313238,0,2,1
89591,3,1,313239,313239,313240,0,1,1
89592,1,3,313240,313240,313243,0,3,0
89593,6,1,313246,313246,313247,0,1,3
89594,1,2,313247,313247,313249,0,2,0
89595,3,2,313250,313250,313252,0,2,1
89596,3,1,313253,313253,313254,0,1,1
89597,6,1,313259,313259,313260,0,1,5
89598,4,1,313263,313263,313264,0,1,3
89599,5,2,313268,313268,313270,0,2,4
89600,4,3,313272,313272,313275,0,3,2
89601,5,2,313277,313277,313279,0,2,2
89602,1,3,313278,313279,313282,1,4,0
89603,1,1,313279,313282,313283,3,4,0
89604,1,3,313280,313283,313286,3,6,0
89605,3,1,313283,313286,313287,3,4,0
89606,4,1,313287,313287,313288,0,1,0
89607,3,3,313290,313290,313293,0,3,2
89608,3,3,313293,313293,313296,0,3,0
89609,3,1,313296,313296,313297,0,1,0
89610,6,3,313302,313302,313305,0,3,5
89611,3,1,313305,313305,313306,0,1,0
89612,4,3,313309,313309,313312,0,3,3
89613,4,3,313313,313313,313316,0,3,1
89614,1,2,313314,313316,313318,2,4,0
89615,3,1,313317,313318,313319,1,2,0
89616,5,3,313322,313322,313325,0,3,3
89617,6,2,313328,313328,313330,0,2,3
89618,2,1,313330,313330,313331,0,1,0
89619,2,2,313332,313332,313334,0,2,1
89620,4,1,313336,313336,313337,0,1,2
89621,3,2,313339,313339,313341,0,2,2
89622,1,2,313340,313341,313343,1,3,0
89623,2,3,313342,313343,313346,1,4,0
89624,3,1,313345,313346,313347,1,2,0
89625,1,2,313346,313347,313349,1,3,0
89626,2,3,313348,313349,313352,1,4,0
89627,1,3,313349,313352,313355,3,6,0
89628,6,2,313355,313355,313357,0,2,0
89629,3,3,313358,313358,313361,0,3,1
89630,4,1,313362,313362,313363,0,1,1
89631,5,3,313367,313367,313370,0,3,4
89632,5,1,313372,313372,313373,0,1,2
89633,2,2,313374,313374,313376,0,2,1
89634,2,2,313376,313376,313378,0,2,0
89635,1,3,313377,313378,313381,1,4,0
89636,6,3,313383,313383,313386,0,3,2
89637,5,1,313388,313388,313389,0,1,2
89638,5,3,313393,313393,313396,0,3,4
89639,4,2,313397,313397,313399,0,2,1
89640,1,3,313398,313399,313402,1,4,0
89641,2,1,313400,313402,313403,2,3,0
89642,4,3,313404,313404,313407,0,3,1
89643,1,3,313405,313407,313410,2,5,0
89644,4,3,313409,313410,313413,1,4,0
89645,4,1,313413,313413,313414,0,1,0
89646,2,2,313415,313415,313417,0,2,1
89647,2,2,313417,313417,313419,0,2,0
89648,2,1,313419,313419,313420,0,1,0
89649,5,1,313424,313424,313425,0,1,4
89650,4,2,313428,313428,313430,0,2,3
89651,3,1,313431,313431,313432,0,1,1
89652,3,3,313434,313434,313437,0,3,2
89653,5,1,313439,313439,313440,0,1,2
89654,6,3,313445,313445,313448,0,3,5
89655,5,3,313450,313450,313453,0,3,2
89656,2,1,313452,313453,313454,1,2,0
89657,4,2,313456,313456,313458,0,2,2
89658,5,3,313461,313461,313464,0,3,3
89659,1,2,313462,313464,313466,2,4,0
89660,6,2,313468,313468,313470,0,2,2
89661,6,1,313474,313474,313475,0,1,4
89662,1,3,313475,313475,313478,0,3,0
89663,1,3,313476,313478,313481,2,5,0
89664,2,3,313478,313481,313484,3,6,0
89665,4,3,313482,313484,313487,2,5,0
89666,5,1,313487,313487,313488,0,1,0
89667,5,1,313492,313492,313493,0,1,4
89668,1,2,313493,313493,313495,0,2,0
89669,6,3,313499,313499,313502,0,3,4
89670,2,1,313501,313502,313503,1,2,0
89671,5,3,313506,313506,313509,0,3,3
89672,2,1,313508,313509,313510,1,2,0
89673,1,2,313509,313510,313512,1,3,0
89674,2,3,313511,313512,313515,1,4,0
89675,5,3,313516,313516,313519,0,3,1
89676,2,1,313518,313519,313520,1,2,0
89677,5,1,313523,313523,313524,0,1,3
89678,6,3,313529,313529,313532,0,3,5
89679,3,1,313532,313532,313533,0,1,0
89680,4,1,313536,313536,313537,0,1,3
89681,6,3,313542,313542,313545,0,3,5
89682,4,2,313546,313546,313548,0,2,1
89683,5,2,313551,313551,313553,0,2,3
89684,1,1,313552,313553,313554,1,2,0
89685,4,3,313556,313556,313559,0,3,2
89686,3,3,313559,313559,313562,0,3,0
89687,5,1,313564,313564,313565,0,1,2
89688,6,2,313570,313570,313572,0,2,5
89689,5,3,313575,313575,313578,0,3,3
89690,5,1,313580,313580,313581,0,1,2
89691,3,2,313583,313583,313585,0,2,2
89692,6,2,313589,313589,313591,0,2,4
89693,6,2,313595,313595,313597,0,2,4
89694,1,3,313596,313597,313600,1,4,0
89695,5,2,313601,313601,313603,0,2,1
89696,5,1,313606,313606,313607,0,1,3
89697,5,3,313611,313611,313614,0,3,4
89698,1,3,313612,313614,313617,2,5,0
89699,3,2,313615,313617,313619,2,4,0
89700,4,3,313619,313619,313622,0,3,0
89701,3,2,313622,313622,313624,0,2,0
89702,6,3,313628,313628,313631,0,3,4
89703,4,2,313632,313632,313634,0,2,1
89704,5,1,313637,313637,313638,0,1,3
89705,4,1,313641,313641,313642,0,1,3
89706,3,1,313644,313644,313645,0,1,2
89707,2,1,313646,313646,313647,0,1,1
89708,3,3,313649,313649,313652,0,3,2
89709,4,3,313653,313653,313656,0,3,1
89710,6,2,313659,313659,313661,0,2,3
89711,5,1,313664,313664,313665,0,1,3
89712,1,2,313665,313665,313667,0,2,0
89713,2,1,313667,313667,313668,0,1,0
89714,5,3,313672,313672,313675,0,3,4
89715,3,1,313675,313675,313676,0,1,0
89716,5,2,313680,313680,313682,0,2,4
89717,6,1,313686,313686,313687,0,1,4
89718,4,3,313690,313690,313693,0,3,3
89719,4,3,313694,313694,313697,0,3,1
89720,5,2,313699,313699,313701,0,2,2
89721,1,2,313700,313701,313703,1,3,0
89722,6,1,313706,313706,313707,0,1,3
89723,2,3,313708,313708,313711,0,3,1
89724,4,2,313712,313712,313714,0,2,1
89725,2,2,313714,313714,313716,0,2,0
89726,3,1,313717,313717,313718,0,1,1
89727,6,2,313723,313723,313725,0,2,5
89728,6,2,313729,313729,313731,0,2,4
89729,2,1,313731,313731,313732,0,1,0
89730,5,3,313736,313736,313739,0,3,4
89731,4,3,313740,313740,313743,0,3,1
89732,5,3,313745,313745,313748,0,3,2
89733,5,3,313750,313750,313753,0,3,2
89734,3,2,313753,313753,313755,0,2,0
89735,2,2,313755,313755,313757,0,2,0
89736,6,3,313761,313761,313764,0,3,4
89737,1,1,313762,313764,313765,2,3,0
89738,3,2,313765,313765,313767,0,2,0
89739,3,2,313768,313768,313770,0,2,1
89740,3,1,313771,313771,313772,0,1,1
89741,3,3,313774,313774,313777,0,3,2
89742,5,1,313779,313779,313780,0,1,2
89743,2,2,313781,313781,313783,0,2,1
89744,6,1,313787,313787,313788,0,1,4
89745,5,1,313792,313792,313793,0,1,4
89746,2,3,313794,313794,313797,0,3,1
89747,6,3,313800,313800,313803,0,3,3
89748,3,2,313803,313803,313805,0,2,0
89749,5,1,313808,313808,313809,0,1,3
89750,3,3,313811,313811,313814,0,3,2
89751,5,1,313816,313816,313817,0,1,2
89752,3,3,313819,313819,313822,0,3,2
89753,2,3,313821,313822,313825,1,4,0
89754,2,2,313823,313825,313827,2,4,0
89755,1,1,313824,313827,313828,3,4,0
89756,3,2,313827,313828,313830,1,3,0
89757,5,3,313832,313832,313835,0,3,2
89758,6,2,313838,313838,313840,0,2,3
89759,5,3,313843,313843,313846,0,3,3
89760,4,2,313847,313847,313849,0,2,1
89761,1,2,313848,313849,313851,1,3,0
89762,1,2,313849,313851,313853,2,4,0
89763,5,3,313854,313854,313857,0,3,1
89764,6,2,313860,313860,313862,0,2,3
89765,5,1,313865,313865,313866,0,1,3
89766,2,2,313867,313867,313869,0,2,1
89767,4,2,313871,313871,313873,0,2,2
89768,1,3,313872,313873,313876,1,4,0
89769,5,1,313877,313877,313878,0,1,1
89770,2,3,313879,313879,313882,0,3,1
89771,6,1,313885,313885,313886,0,1,3
89772,3,3,313888,313888,313891,0,3,2
89773,4,1,313892,313892,313893,0,1,1
89774,6,1,313898,313898,313899,0,1,5
89775,3,3,313901,313901,313904,0,3,2
89776,1,1,313902,313904,313905,2,3,0
89777,6,3,313908,313908,313911,0,3,3
89778,1,3,313909,313911,313914,2,5,0
89779,5,1,313914,313914,313915,0,1,0
89780,5,2,313919,313919,313921,0,2,4
89781,2,1,313921,313921,313922,0,1,0
89782,1,3,313922,313922,313925,0,3,0
89783,2,1,313924,313925,313926,1,2,0
89784,5,3,313929,313929,313932,0,3,3
89785,3,1,313932,313932,313933,0,1,0
89786,3,1,313935,313935,313936,0,1,2
89787,1,3,313936,313936,313939,0,3,0
89788,6,2,313942,313942,313944,0,2,3
89789,4,1,313946,313946,313947,0,1,2
89790,1,2,313947,313947,313949,0,2,0
89791,1,2,313948,313949,313951,1,3,0
89792,6,3,313954,313954,313957,0,3,3
89793,6,3,313960,313960,313963,0,3,3
89794,6,2,313966,313966,313968,0,2,3
89795,4,1,313970,313970,313971,0,1,2
89796,4,1,313974,313974,313975,0,1,3
89797,4,2,313978,313978,313980,0,2,3
89798,5,3,313983,313983,313986,0,3,3
89799,3,3,313986,313986,313989,0,3,0
89800,5,1,313991,313991,313992,0,1,2
89801,6,2,313997,313997,313999,0,2,5
89802,3,1,314000,314000,314001,0,1,1
89803,3,2,314003,314003,314005,0,2,2
89804,3,3,314006,314006,314009,0,3,1
89805,4,1,314010,314010,314011,0,1,1
89806,3,1,314013,314013,314014,0,1,2
89807,6,2,314019,314019,314021,0,2,5
89808,5,3,314024,314024,314027,0,3,3
89809,1,2,314025,314027,314029,2,4,0
89810,1,1,314026,314029,314030,3,4,0
89811,3,1,314029,314030,314031,1,2,0
89812,5,1,314034,314034,314035,0,1,3
89813,6,1,314040,314040,314041,0,1,5
89814,4,3,314044,314044,314047,0,3,3
89815,3,2,314047,314047,314049,0,2,0
89816,3,1,314050,314050,314051,0,1,1
89817,1,3,314051,314051,314054,0,3,0
89818,1,2,314052,314054,314056,2,4,0
89819,6,2,314058,314058,314060,0,2,2
89820,3,1,314061,314061,314062,0,1,1
89821,5,1,314066,314066,314067,0,1,4
89822,2,2,314068,314068,314070,0,2,1
89823,1,3,314069,314070,314073,1,4,0
89824,4,3,314073,314073,314076,0,3,0
89825,4,2,314077,314077,314079,0,2,1
89826,5,1,314082,314082,314083,0,1,3
89827,2,1,314084,314084,314085,0,1,1
89828,2,2,314086,314086,314088,0,2,1
89829,6,2,314092,314092,314094,0,2,4
89830,3,2,314095,314095,314097,0,2,1
89831,1,1,314096,314097,314098,1,2,0
89832,6,1,314102,314102,314103,0,1,4
89833,4,3,314106,314106,314109,0,3,3
89834,3,3,314109,314109,314112,0,3,0
89835,4,1,314113,314113,314114,0,1,1
89836,2,2,314115,314115,314117,0,2,1
89837,3,3,314118,314118,314121,0,3,1
89838,6,3,314124,314124,314127,0,3,3
89839,6,2,314130,314130,314132,0,2,3
89840,3,3,314133,314133,314136,0,3,1
89841,5,1,314138,314138,314139,0,1,2
89842,2,2,314140,314140,314142,0,2,1
89843,3,3,314143,314143,314146,0,3,1
89844,2,3,314145,314146,314149,1,4,0
89845,2,2,314147,314149,314151,2,4,0
89846,3,1,314150,314151,314152,1,2,0
89847,3,3,314153,314153,314156,0,3,1
89848,2,2,314155,314156,314158,1,3,0
89849,3,1,314158,314158,314159,0,1,0
89850,3,2,314161,314161,314163,0,2,2
89851,1,3,314162,314163,314166,1,4,0
89852,4,3,314166,314166,314169,0,3,0
89853,6,1,314172,314172,314173,0,1,3
89854,6,1,314178,314178,314179,0,1,5
89855,3,3,314181,314181,314184,0,3,2
89856,1,3,314182,314184,314187,2,5,0
89857,2,1,314184,314187,314188,3,4,0
89858,4,1,314188,314188,314189,0,1,0
89859,1,3,314189,314189,314192,0,3,0
89860,4,3,314193,314193,314196,0,3,1
89861,6,3,314199,314199,314202,0,3,3
89862,5,2,314204,314204,314206,0,2,2
89863,6,2,314210,314210,314212,0,2,4
89864,2,2,314212,314212,314214,0,2,0
89865,2,2,314214,314214,314216,0,2,0
89866,4,2,314218,314218,314220,0,2,2
89867,1,3,314219,314220,314223,1,4,0
89868,6,2,314225,314225,314227,0,2,2
89869,4,1,314229,314229,314230,0,1,2
89870,4,1,314233,314233,314234,0,1,3
89871,4,3,314237,314237,314240,0,3,3
89872,4,3,314241,314241,314244,0,3,1
89873,6,3,314247,314247,314250,0,3,3
89874,6,2,314253,314253,314255,0,2,3
89875,4,1,314257,314257,314258,0,1,2
89876,3,2,314260,314260,314262,0,2,2
89877,3,1,314263,314263,314264,0,1,1
89878,1,2,314264,314264,314266,0,2,0
89879,4,1,314268,314268,314269,0,1,2
89880,2,3,314270,314270,314273,0,3,1
89881,4,2,314274,314274,314276,0,2,1
89882,4,3,314278,314278,314281,0,3,2
89883,4,3,314282,314282,314285,0,3,1
89884,1,2,314283,314285,314287,2,4,0
89885,2,2,314285,314287,314289,2,4,0
89886,4,2,314289,314289,314291,0,2,0
89887,4,2,314293,314293,314295,0,2,2
89888,3,2,314296,314296,314298,0,2,1
89889,1,3,314297,314298,314301,1,4,0
89890,5,2,314302,314302,314304,0,2,1
89891,3,2,314305,314305,314307,0,2,1
89892,2,3,314307,314307,314310,0,3,0
89893,6,2,314313,314313,314315,0,2,3
89894,1,2,314314,314315,314317,1,3,0
89895,1,2,314315,314317,314319,2,4,0
89896,5,2,314320,314320,314322,0,2,1
89897,4,3,314324,314324,314327,0,3,2
89898,3,2,314327,314327,314329,0,2,0
89899,3,2,314330,314330,314332,0,2,1
89900,3,1,314333,314333,314334,0,1,1
89901,5,1,314338,314338,314339,0,1,4
89902,6,2,314344,314344,314346,0,2,5
89903,1,3,314345,314346,314349,1,4,0
89904,6,3,314351,314351,314354,0,3,2
89905,3,2,314354,314354,314356,0,2,0
89906,2,3,314356,314356,314359,0,3,0
89907,1,1,314357,314359,314360,2,3,0
89908,1,1,314358,314360,314361,2,3,0
89909,5,3,314363,314363,314366,0,3,2
89910,2,3,314365,314366,314369,1,4,0
89911,1,1,314366,314369,314370,3,4,0
89912,2,2,314368,314370,314372,2,4,0
89913,5,3,314373,314373,314376,0,3,1
89914,3,3,314376,314376,314379,0,3,0
89915,6,3,314382,314382,314385,0,3,3
89916,4,3,314386,314386,314389,0,3,1
89917,1,3,314387,314389,314392,2,5,0
89918,5,3,314392,314392,314395,0,3,0
89919,4,2,314396,314396,314398,0,2,1
89920,1,3,314397,314398,314401,1,4,0
89921,1,2,314398,314401,314403,3,5,0
89922,5,1,314403,314403,314404,0,1,0
89923,6,1,314409,314409,314410,0,1,5
89924,2,1,314411,314411,314412,0,1,1
89925,4,3,314415,314415,314418,0,3,3
89926,6,3,314421,314421,314424,0,3,3
89927,6,1,314427,314427,314428,0,1,3
89928,3,1,314430,314430,314431,0,1,2
89929,2,1,314432,314432,314433,0,1,1
89930,6,3,314438,314438,314441,0,3,5
89931,6,2,314444,314444,314446,0,2,3
89932,1,2,314445,314446,314448,1,3,0
89933,2,3,314447,314448,314451,1,4,0
89934,3,3,314450,314451,314454,1,4,0
89935,5,3,314455,314455,314458,0,3,1
89936,1,1,314456,314458,314459,2,3,0
89937,5,2,314461,314461,314463,0,2,2
89938,1,2,314462,314463,314465,1,3,0
89939,5,3,314467,314467,314470,0,3,2
89940,5,1,314472,314472,314473,0,1,2
89941,6,1,314478,314478,314479,0,1,5
89942,6,3,314484,314484,314487,0,3,5
89943,6,3,314490,314490,314493,0,3,3
89944,2,1,314492,314493,314494,1,2,0
89945,3,1,314495,314495,314496,0,1,1
89946,2,2,314497,314497,314499,0,2,1
89947,2,1,314499,314499,314500,0,1,0
89948,3,2,314502,314502,314504,0,2,2
89949,3,1,314505,314505,314506,0,1,1
89950,3,1,314508,314508,314509,0,1,2
89951,3,2,314511,314511,314513,0,2,2
89952,4,1,314515,314515,314516,0,1,2
89953,4,1,314519,314519,314520,0,1,3
89954,2,1,314521,314521,314522,0,1,1
89955,3,3,314524,314524,314527,0,3,2
89956,1,3,314525,314527,314530,2,5,0
89957,3,1,314528,314530,314531,2,3,0
89958,3,1,314531,314531,314532,0,1,0
89959,5,3,314536,314536,314539,0,3,4
89960,2,1,314538,314539,314540,1,2,0
89961,3,2,314541,314541,314543,0,2,1
89962,4,3,314545,314545,314548,0,3,2
89963,4,1,314549,314549,314550,0,1,1
89964,4,3,314553,314553,314556,0,3,3
89965,5,3,314558,314558,314561,0,3,2
89966,3,1,314561,314561,314562,0,1,0
89967,4,1,314565,314565,314566,0,1,3
89968,5,1,314570,314570,314571,0,1,4
89969,3,3,314573,314573,314576,0,3,2
89970,5,1,314578,314578,314579,0,1,2
89971,1,2,314579,314579,314581,0,2,0
89972,4,2,314583,314583,314585,0,2,2
89973,1,3,314584,314585,314588,1,4,0
89974,2,3,314586,314588,314591,2,5,0
89975,6,3,314592,314592,314595,0,3,1
89976,4,2,314596,314596,314598,0,2,1
89977,5,1,314601,314601,314602,0,1,3
89978,2,1,314603,314603,314604,0,1,1
89979,1,1,314604,314604,314605,0,1,0
89980,5,1,314609,314609,314610,0,1,4
89981,4,2,314613,314613,314615,0,2,3
89982,5,1,314618,314618,314619,0,1,3
89983,4,3,314622,314622,314625,0,3,3
89984,5,3,314627,314627,314630,0,3,2
89985,4,1,314631,314631,314632,0,1,1
89986,6,1,314637,314637,314638,0,1,5
89987,6,3,314643,314643,314646,0,3,5
89988,4,1,314647,314647,314648,0,1,1
89989,3,2,314650,314650,314652,0,2,2
89990,5,1,314655,314655,314656,0,1,3
89991,5,1,314660,314660,314661,0,1,4
89992,1,1,314661,314661,314662,0,1,0
89993,6,2,314667,314667,314669,0,2,5
89994,1,2,314668,314669,314671,1,3,0
89995,4,1,314672,314672,314673,0,1,1
89996,1,1,314673,314673,314674,0,1,0
89997,6,3,314679,314679,314682,0,3,5
89998,6,1,314685,314685,314686,0,1,3
89999,1,1,314686,314686,314687,0,1,0
90000,2,1,314688,314688,314689,0,1,1
90001,6,2,314694,314694,314696,0,2,5
90002,4,3,314698,314698,314701,0,3,2
90003,3,3,314701,314701,314704,0,3,0
90004,1,3,314702,314704,314707,2,5,0
90005,4,1,314706,314707,314708,1,2,0
90006,2,3,314708,314708,314711,0,3,0
90007,1,3,314709,314711,314714,2,5,0
90008,6,2,314715,314715,314717,0,2,1
90009,6,1,314721,314721,314722,0,1,4
90010,2,2,314723,314723,314725,0,2,1
90011,2,1,314725,314725,314726,0,1,0
90012,3,3,314728,314728,314731,0,3,2
90013,2,1,314730,314731,314732,1,2,0
90014,4,3,314734,314734,314737,0,3,2
90015,6,2,314740,314740,314742,0,2,3
90016,3,1,314743,314743,314744,0,1,1
90017,4,3,314747,314747,314750,0,3,3
90018,3,2,314750,314750,314752,0,2,0
90019,4,1,314754,314754,314755,0,1,2
90020,4,3,314758,314758,314761,0,3,3
90021,4,1,314762,314762,314763,0,1,1
90022,5,2,314767,314767,314769,0,2,4
90023,6,1,314773,314773,314774,0,1,4
90024,3,2,314776,314776,314778,0,2,2
90025,5,2,314781,314781,314783,0,2,3
90026,5,2,314786,314786,314788,0,2,3
90027,1,1,314787,314788,314789,1,2,0
90028,3,1,314790,314790,314791,0,1,1
90029,5,1,314795,314795,314796,0,1,4
90030,6,3,314801,314801,314804,0,3,5
90031,5,1,314806,314806,314807,0,1,2
90032,6,2,314812,314812,314814,0,2,5
90033,1,2,314813,314814,314816,1,3,0
90034,3,2,314816,314816,314818,0,2,0
90035,3,2,314819,314819,314821,0,2,1
90036,2,3,314821,314821,314824,0,3,0
90037,4,3,314825,314825,314828,0,3,1
90038,2,3,314827,314828,314831,1,4,0
90039,2,2,314829,314831,314833,2,4,0
90040,3,3,314832,314833,314836,1,4,0
90041,2,1,314834,314836,314837,2,3,0
90042,5,1,314839,314839,314840,0,1,2
90043,5,2,314844,314844,314846,0,2,4
90044,3,2,314847,314847,314849,0,2,1
90045,3,2,314850,314850,314852,0,2,1
90046,3,1,314853,314853,314854,0,1,1
90047,2,1,314855,314855,314856,0,1,1
90048,1,2,314856,314856,314858,0,2,0
90049,2,3,314858,314858,314861,0,3,0
90050,3,3,314861,314861,314864,0,3,0
90051,4,3,314865,314865,314868,0,3,1
90052,4,2,314869,314869,314871,0,2,1
90053,1,2,314870,314871,314873,1,3,0
90054,3,3,314873,314873,314876,0,3,0
90055,2,3,314875,314876,314879,1,4,0
90056,4,3,314879,314879,314882,0,3,0
90057,2,3,314881,314882,314885,1,4,0
90058,1,1,314882,314885,314886,3,4,0
90059,3,2,314885,314886,314888,1,3,0
90060,5,3,314890,314890,314893,0,3,2
90061,2,2,314892,314893,314895,1,3,0
90062,4,1,314896,314896,314897,0,1,1
90063,3,2,314899,314899,314901,0,2,2
90064,6,3,314905,314905,314908,0,3,4
90065,6,2,314911,314911,314913,0,2,3
90066,2,3,314913,314913,314916,0,3,0
90067,5,1,314918,314918,314919,0,1,2
90068,3,2,314921,314921,314923,0,2,2
90069,1,1,314922,314923,314924,1,2,0
90070,3,2,314925,314925,314927,0,2,1
90071,2,2,314927,314927,314929,0,2,0
90072,2,3,314929,314929,314932,0,3,0
90073,1,2,314930,314932,314934,2,4,0
90074,5,3,314935,314935,314938,0,3,1
90075,3,1,314938,314938,314939,0,1,0
90076,2,2,314940,314940,314942,0,2,1
90077,4,3,314944,314944,314947,0,3,2
90078,4,1,314948,314948,314949,0,1,1
90079,2,1,314950,314950,314951,0,1,1
90080,5,1,314955,314955,314956,0,1,4
90081,2,3,314957,314957,314960,0,3,1
90082,3,3,314960,314960,314963,0,3,0
90083,4,2,314964,314964,314966,0,2,1
90084,3,3,314967,314967,314970,0,3,1
90085,4,2,314971,314971,314973,0,2,1
90086,3,2,314974,314974,314976,0,2,1
90087,5,2,314979,314979,314981,0,2,3
90088,2,1,314981,314981,314982,0,1,0
90089,5,2,314986,314986,314988,0,2,4
90090,6,1,314992,314992,314993,0,1,4
90091,4,2,314996,314996,314998,0,2,3
90092,6,3,315002,315002,315005,0,3,4
90093,2,3,315004,315005,315008,1,4,0
90094,4,3,315008,315008,315011,0,3,0
90095,6,3,315014,315014,315017,0,3,3
90096,2,3,315016,315017,315020,1,4,0
90097,3,2,315019,315020,315022,1,3,0
90098,2,1,315021,315022,315023,1,2,0
90099,3,1,315024,315024,315025,0,1,1
90100,5,3,315029,315029,315032,0,3,4
90101,1,3,315030,315032,315035,2,5,0
90102,3,2,315033,315035,315037,2,4,0
90103,4,3,315037,315037,315040,0,3,0
90104,4,2,315041,315041,315043,0,2,1
90105,6,2,315047,315047,315049,0,2,4
90106,4,2,315051,315051,315053,0,2,2
90107,3,1,315054,315054,315055,0,1,1
90108,6,2,315060,315060,315062,0,2,5
90109,4,1,315064,315064,315065,0,1,2
90110,6,2,315070,315070,315072,0,2,5
90111,5,3,315075,315075,315078,0,3,3
90112,1,2,315076,315078,315080,2,4,0
90113,2,3,315078,315080,315083,2,5,0
90114,6,2,315084,315084,315086,0,2,1
90115,1,2,315085,315086,315088,1,3,0
90116,3,3,315088,315088,315091,0,3,0
90117,2,1,315090,315091,315092,1,2,0
90118,3,2,315093,315093,315095,0,2,1
90119,4,3,315097,315097,315100,0,3,2
90120,6,2,315103,315103,315105,0,2,3
90121,4,1,315107,315107,315108,0,1,2
90122,2,3,315109,315109,315112,0,3,1
90123,3,1,315112,315112,315113,0,1,0
90124,5,3,315117,315117,315120,0,3,4
90125,6,1,315123,315123,315124,0,1,3
90126,2,2,315125,315125,315127,0,2,1
90127,1,3,315126,315127,315130,1,4,0
90128,5,1,315131,315131,315132,0,1,1
90129,3,3,315134,315134,315137,0,3,2
90130,6,2,315140,315140,315142,0,2,3
90131,6,3,315146,315146,315149,0,3,4
90132,3,1,315149,315149,315150,0,1,0
90133,6,3,315155,315155,315158,0,3,5
90134,1,1,315156,315158,315159,2,3,0
90135,6,2,315162,315162,315164,0,2,3
90136,5,3,315167,315167,315170,0,3,3
90137,4,3,315171,315171,315174,0,3,1
90138,5,3,315176,315176,315179,0,3,2
90139,6,1,315182,315182,315183,0,1,3
90140,3,1,315185,315185,315186,0,1,2
90141,5,2,315190,315190,315192,0,2,4
90142,3,3,315193,315193,315196,0,3,1
90143,6,3,315199,315199,315202,0,3,3
90144,4,2,315203,315203,315205,0,2,1
90145,6,3,315209,315209,315212,0,3,4
90146,2,2,315211,315212,315214,1,3,0
90147,4,2,315215,315215,315217,0,2,1
90148,1,3,315216,315217,315220,1,4,0
90149,5,3,315221,315221,315224,0,3,1
90150,3,2,315224,315224,315226,0,2,0
90151,6,1,315230,315230,315231,0,1,4
90152,5,3,315235,315235,315238,0,3,4
90153,3,1,315238,315238,315239,0,1,0
90154,4,3,315242,315242,315245,0,3,3
90155,4,3,315246,315246,315249,0,3,1
90156,1,2,315247,315249,315251,2,4,0
90157,1,2,315248,315251,315253,3,5,0
90158,3,3,315251,315253,315256,2,5,0
90159,4,2,315255,315256,315258,1,3,0
90160,4,2,315259,315259,315261,0,2,1
90161,3,1,315262,315262,315263,0,1,1
90162,6,2,315268,315268,315270,0,2,5
90163,4,1,315272,315272,315273,0,1,2
90164,6,2,315278,315278,315280,0,2,5
90165,5,3,315283,315283,315286,0,3,3
90166,2,3,315285,315286,315289,1,4,0
90167,1,2,315286,315289,315291,3,5,0
90168,3,2,315289,315291,315293,2,4,0
90169,4,2,315293,315293,315295,0,2,0
90170,1,2,315294,315295,315297,1,3,0
90171,4,1,315298,315298,315299,0,1,1
90172,3,2,315301,315301,315303,0,2,2
90173,6,2,315307,315307,315309,0,2,4
90174,2,2,315309,315309,315311,0,2,0
90175,6,2,315315,315315,315317,0,2,4
90176,2,2,315317,315317,315319,0,2,0
90177,5,3,315322,315322,315325,0,3,3
90178,5,2,315327,315327,315329,0,2,2
90179,6,3,315333,315333,315336,0,3,4
90180,3,3,315336,315336,315339,0,3,0
90181,1,2,315337,315339,315341,2,4,0
90182,3,1,315340,315341,315342,1,2,0
90183,1,1,315341,315342,315343,1,2,0
90184,3,2,315344,315344,315346,0,2,1
90185,5,1,315349,315349,315350,0,1,3
90186,6,2,315355,315355,315357,0,2,5
90187,4,3,315359,315359,315362,0,3,2
90188,4,2,315363,315363,315365,0,2,1
90189,2,2,315365,315365,315367,0,2,0
90190,1,2,315366,315367,315369,1,3,0
90191,5,1,315371,315371,315372,0,1,2
90192,3,1,315374,315374,315375,0,1,2
90193,5,3,315379,315379,315382,0,3,4
90194,1,1,315380,315382,315383,2,3,0
90195,6,1,315386,315386,315387,0,1,3
90196,5,2,315391,315391,315393,0,2,4
90197,3,2,315394,315394,315396,0,2,1
90198,6,1,315400,315400,315401,0,1,4
90199,4,2,315404,315404,315406,0,2,3
90200,3,1,315407,315407,315408,0,1,1
90201,1,2,315408,315408,315410,0,2,0
90202,4,1,315412,315412,315413,0,1,2
90203,1,2,315413,315413,315415,0,2,0
90204,6,3,315419,315419,315422,0,3,4
90205,1,2,315420,315422,315424,2,4,0
90206,1,2,315421,315424,315426,3,5,0
90207,4,1,315425,315426,315427,1,2,0
90208,3,3,315428,315428,315431,0,3,1
90209,3,2,315431,315431,315433,0,2,0
90210,4,3,315435,315435,315438,0,3,2
90211,1,1,315436,315438,315439,2,3,0
90212,1,3,315437,315439,315442,2,5,0
90213,4,2,315441,315442,315444,1,3,0
90214,5,3,315446,315446,315449,0,3,2
90215,2,3,315448,315449,315452,1,4,0
90216,5,3,315453,315453,315456,0,3,1
90217,2,3,315455,315456,315459,1,4,0
90218,2,2,315457,315459,315461,2,4,0
90219,3,3,315460,315461,315464,1,4,0
90220,2,3,315462,315464,315467,2,5,0
90221,2,3,315464,315467,315470,3,6,0
90222,6,3,315470,315470,315473,0,3,0
90223,6,3,315476,315476,315479,0,3,3
90224,2,1,315478,315479,315480,1,2,0
90225,3,2,315481,315481,315483,0,2,1
90226,4,3,315485,315485,315488,0,3,2
90227,2,3,315487,315488,315491,1,4,0
90228,2,2,315489,315491,315493,2,4,0
90229,6,3,315495,315495,315498,0,3,2
90230,4,2,315499,315499,315501,0,2,1
90231,3,1,315502,315502,315503,0,1,1
90232,5,3,315507,315507,315510,0,3,4
90233,2,2,315509,315510,315512,1,3,0
90234,1,1,315510,315512,315513,2,3,0
90235,5,3,315515,315515,315518,0,3,2
90236,3,1,315518,315518,315519,0,1,0
90237,4,3,315522,315522,315525,0,3,3
90238,5,2,315527,315527,315529,0,2,2
90239,5,2,315532,315532,315534,0,2,3
90240,2,3,315534,315534,315537,0,3,0
90241,3,2,315537,315537,315539,0,2,0
90242,5,1,315542,315542,315543,0,1,3
90243,2,1,315544,315544,315545,0,1,1
90244,5,1,315549,315549,315550,0,1,4
90245,1,1,315550,315550,315551,0,1,0
90246,5,2,315555,315555,315557,0,2,4
90247,5,1,315560,315560,315561,0,1,3
90248,5,1,315565,315565,315566,0,1,4
90249,6,2,315571,315571,315573,0,2,5
90250,2,2,315573,315573,315575,0,2,0
90251,1,3,315574,315575,315578,1,4,0
90252,1,1,315575,315578,315579,3,4,0
90253,5,1,315580,315580,315581,0,1,1
90254,3,3,315583,315583,315586,0,3,2
90255,4,1,315587,315587,315588,0,1,1
90256,5,1,315592,315592,315593,0,1,4
90257,5,3,315597,315597,315600,0,3,4
90258,6,1,315603,315603,315604,0,1,3
90259,4,1,315607,315607,315608,0,1,3
90260,4,2,315611,315611,315613,0,2,3
90261,2,3,315613,315613,315616,0,3,0
90262,2,1,315615,315616,315617,1,2,0
90263,5,1,315620,315620,315621,0,1,3
90264,1,3,315621,315621,315624,0,3,0
90265,5,3,315626,315626,315629,0,3,2
90266,1,1,315627,315629,315630,2,3,0
90267,3,1,315630,315630,315631,0,1,0
90268,3,2,315633,315633,315635,0,2,2
90269,6,1,315639,315639,315640,0,1,4
90270,6,2,315645,315645,315647,0,2,5
90271,2,1,315647,315647,315648,0,1,0
90272,3,2,315650,315650,315652,0,2,2
90273,1,1,315651,315652,315653,1,2,0
90274,6,1,315657,315657,315658,0,1,4
90275,6,1,315663,315663,315664,0,1,5
90276,2,2,315665,315665,315667,0,2,1
90277,2,2,315667,315667,315669,0,2,0
90278,5,3,315672,315672,315675,0,3,3
90279,4,1,315676,315676,315677,0,1,1
90280,5,2,315681,315681,315683,0,2,4
90281,6,3,315687,315687,315690,0,3,4
90282,4,3,315691,315691,315694,0,3,1
90283,3,3,315694,315694,315697,0,3,0
90284,6,3,315700,315700,315703,0,3,3
90285,6,3,315706,315706,315709,0,3,3
90286,3,1,315709,315709,315710,0,1,0
90287,4,1,315713,315713,315714,0,1,3
90288,4,1,315717,315717,315718,0,1,3
90289,2,3,315719,315719,315722,0,3,1
90290,6,2,315725,315725,315727,0,2,3
90291,5,2,315730,315730,315732,0,2,3
90292,3,2,315733,315733,315735,0,2,1
90293,5,1,315738,315738,315739,0,1,3
90294,6,1,315744,315744,315745,0,1,5
90295,4,3,315748,315748,315751,0,3,3
90296,5,1,315753,315753,315754,0,1,2
90297,4,1,315757,315757,315758,0,1,3
90298,6,1,315763,315763,315764,0,1,5
90299,1,3,315764,315764,315767,0,3,0
90300,4,3,315768,315768,315771,0,3,1
90301,4,1,315772,315772,315773,0,1,1
90302,2,1,315774,315774,315775,0,1,1
90303,2,3,315776,315776,315779,0,3,1
90304,5,3,315781,315781,315784,0,3,2
90305,1,1,315782,315784,315785,2,3,0
90306,4,3,315786,315786,315789,0,3,1
90307,2,2,315788,315789,315791,1,3,0
90308,5,2,315793,315793,315795,0,2,2
90309,2,1,315795,315795,315796,0,1,0
90310,5,3,315800,315800,315803,0,3,4
90311,2,3,315802,315803,315806,1,4,0
90312,1,3,315803,315806,315809,3,6,0
90313,4,1,315807,315809,315810,2,3,0
90314,5,2,315812,315812,315814,0,2,2
90315,2,3,315814,315814,315817,0,3,0
90316,1,3,315815,315817,315820,2,5,0
90317,2,1,315817,315820,315821,3,4,0
90318,3,3,315820,315821,315824,1,4,0
90319,6,1,315826,315826,315827,0,1,2
90320,2,1,315828,315828,315829,0,1,1
90321,6,3,315834,315834,315837,0,3,5
90322,5,3,315839,315839,315842,0,3,2
90323,2,1,315841,315842,315843,1,2,0
90324,6,3,315847,315847,315850,0,3,4
90325,5,2,315852,315852,315854,0,2,2
90326,6,1,315858,315858,315859,0,1,4
90327,3,2,315861,315861,315863,0,2,2
90328,4,1,315865,315865,315866,0,1,2
90329,3,1,315868,315868,315869,0,1,2
90330,6,3,315874,315874,315877,0,3,5
90331,5,1,315879,315879,315880,0,1,2
90332,1,2,315880,315880,315882,0,2,0
90333,4,3,315884,315884,315887,0,3,2
90334,3,1,315887,315887,315888,0,1,0
90335,3,3,315890,315890,315893,0,3,2
90336,4,2,315894,315894,315896,0,2,1
90337,2,1,315896,315896,315897,0,1,0
90338,4,3,315900,315900,315903,0,3,3
90339,2,3,315902,315903,315906,1,4,0
90340,6,2,315908,315908,315910,0,2,2
90341,1,1,315909,315910,315911,1,2,0
90342,1,2,315910,315911,315913,1,3,0
90343,3,2,315913,315913,315915,0,2,0
90344,1,1,315914,315915,315916,1,2,0
90345,5,1,315919,315919,315920,0,1,3
90346,2,1,315921,315921,315922,0,1,1
90347,6,2,315927,315927,315929,0,2,5
90348,4,2,315931,315931,315933,0,2,2
90349,6,2,315937,315937,315939,0,2,4
90350,4,3,315941,315941,315944,0,3,2
90351,2,2,315943,315944,315946,1,3,0
90352,4,2,315947,315947,315949,0,2,1
90353,1,1,315948,315949,315950,1,2,0
90354,3,3,315951,315951,315954,0,3,1
90355,5,3,315956,315956,315959,0,3,2
90356,4,1,315960,315960,315961,0,1,1
90357,1,3,315961,315961,315964,0,3,0
90358,3,3,315964,315964,315967,0,3,0
90359,3,3,315967,315967,315970,0,3,0
90360,1,3,315968,315970,315973,2,5,0
90361,3,2,315971,315973,315975,2,4,0
90362,1,1,315972,315975,315976,3,4,0
90363,6,1,315978,315978,315979,0,1,2
90364,6,3,315984,315984,315987,0,3,5
90365,6,1,315990,315990,315991,0,1,3
90366,2,3,315992,315992,315995,0,3,1
90367,3,3,315995,315995,315998,0,3,0
90368,5,3,316000,316000,316003,0,3,2
90369,3,1,316003,316003,316004,0,1,0
90370,2,1,316005,316005,316006,0,1,1
90371,2,3,316007,316007,316010,0,3,1
90372,4,2,316011,316011,316013,0,2,1
90373,3,2,316014,316014,316016,0,2,1
90374,1,2,316015,316016,316018,1,3,0
90375,2,1,316017,316018,316019,1,2,0
90376,1,2,316018,316019,316021,1,3,0
90377,6,2,316024,316024,316026,0,2,3
90378,4,1,316028,316028,316029,0,1,2
90379,6,1,316034,316034,316035,0,1,5
90380,2,3,316036,316036,316039,0,3,1
90381,5,3,316041,316041,316044,0,3,2
90382,3,2,316044,316044,316046,0,2,0
90383,4,1,316048,316048,316049,0,1,2
90384,6,2,316054,316054,316056,0,2,5
90385,5,1,316059,316059,316060,0,1,3
90386,5,2,316064,316064,316066,0,2,4
90387,6,3,316070,316070,316073,0,3,4
90388,1,1,316071,316073,316074,2,3,0
90389,3,2,316074,316074,316076,0,2,0
90390,3,2,316077,316077,316079,0,2,1
90391,5,3,316082,316082,316085,0,3,3
90392,2,2,316084,316085,316087,1,3,0
90393,5,2,316089,316089,316091,0,2,2
90394,2,1,316091,316091,316092,0,1,0
90395,1,3,316092,316092,316095,0,3,0
90396,4,3,316096,316096,316099,0,3,1
90397,5,1,316101,316101,316102,0,1,2
90398,5,3,316106,316106,316109,0,3,4
90399,4,1,316110,316110,316111,0,1,1
90400,1,3,316111,316111,316114,0,3,0
90401,5,3,316116,316116,316119,0,3,2
90402,4,2,316120,316120,316122,0,2,1
90403,3,1,316123,316123,316124,0,1,1
90404,5,2,316128,316128,316130,0,2,4
90405,5,1,316133,316133,316134,0,1,3
90406,6,1,316139,316139,316140,0,1,5
90407,6,3,316145,316145,316148,0,3,5
90408,5,3,316150,316150,316153,0,3,2
90409,4,2,316154,316154,316156,0,2,1
90410,4,1,316158,316158,316159,0,1,2
90411,4,3,316162,316162,316165,0,3,3
90412,5,2,316167,316167,316169,0,2,2
90413,1,2,316168,316169,316171,1,3,0
90414,1,1,316169,316171,316172,2,3,0
90415,3,2,316172,316172,316174,0,2,0
90416,2,1,316174,316174,316175,0,1,0
90417,4,1,316178,316178,316179,0,1,3
90418,3,1,316181,316181,316182,0,1,2
90419,5,3,316186,316186,316189,0,3,4
90420,1,2,316187,316189,316191,2,4,0
90421,1,2,316188,316191,316193,3,5,0
90422,4,3,316192,316193,316196,1,4,0
90423,5,1,316197,316197,316198,0,1,1
90424,2,2,316199,316199,316201,0,2,1
90425,2,3,316201,316201,316204,0,3,0
90426,4,3,316205,316205,316208,0,3,1
90427,5,1,316210,316210,316211,0,1,2
90428,1,2,316211,316211,316213,0,2,0
90429,5,2,316216,316216,316218,0,2,3
90430,1,3,316217,316218,316221,1,4,0
90431,6,1,316223,316223,316224,0,1,2
90432,6,2,316229,316229,316231,0,2,5
90433,2,3,316231,316231,316234,0,3,0
90434,6,2,316237,316237,316239,0,2,3
90435,4,3,316241,316241,316244,0,3,2
90436,6,1,316247,316247,316248,0,1,3
90437,4,2,316251,316251,316253,0,2,3
90438,6,1,316257,316257,316258,0,1,4
90439,3,3,316260,316260,316263,0,3,2
90440,5,1,316265,316265,316266,0,1,2
90441,1,3,316266,316266,316269,0,3,0
90442,1,3,316267,316269,316272,2,5,0
90443,4,3,316271,316272,316275,1,4,0
90444,4,2,316275,316275,316277,0,2,0
90445,4,2,316279,316279,316281,0,2,2
90446,1,1,316280,316281,316282,1,2,0
90447,5,3,316285,316285,316288,0,3,3
90448,6,1,316291,316291,316292,0,1,3
90449,1,2,316292,316292,316294,0,2,0
90450,3,2,316295,316295,316297,0,2,1
90451,2,1,316297,316297,316298,0,1,0
90452,5,1,316302,316302,316303,0,1,4
90453,5,2,316307,316307,316309,0,2,4
90454,4,1,316311,316311,316312,0,1,2
90455,5,1,316316,316316,316317,0,1,4
90456,4,3,316320,316320,316323,0,3,3
90457,2,1,316322,316323,316324,1,2,0
90458,5,1,316327,316327,316328,0,1,3
90459,1,3,316328,316328,316331,0,3,0
90460,4,3,316332,316332,316335,0,3,1
90461,1,1,316333,316335,316336,2,3,0
90462,1,1,316334,316336,316337,2,3,0
90463,1,1,316335,316337,316338,2,3,0
90464,2,1,316337,316338,316339,1,2,0
90465,5,1,316342,316342,316343,0,1,3
90466,4,3,316346,316346,316349,0,3,3
90467,6,3,316352,316352,316355,0,3,3
90468,6,3,316358,316358,316361,0,3,3
90469,2,3,316360,316361,316364,1,4,0
90470,2,2,316362,316364,316366,2,4,0
90471,3,2,316365,316366,316368,1,3,0
90472,6,1,316371,316371,316372,0,1,3
90473,3,1,316374,316374,316375,0,1,2
90474,5,3,316379,316379,316382,0,3,4
90475,3,3,316382,316382,316385,0,3,0
90476,5,1,316387,316387,316388,0,1,2
90477,3,2,316390,316390,316392,0,2,2
90478,1,2,316391,316392,316394,1,3,0
90479,2,1,316393,316394,316395,1,2,0
90480,4,1,316397,316397,316398,0,1,2
90481,1,2,316398,316398,316400,0,2,0
90482,3,3,316401,316401,316404,0,3,1
90483,1,3,316402,316404,316407,2,5,0
90484,2,3,316404,316407,316410,3,6,0
90485,4,1,316408,316410,316411,2,3,0
90486,1,1,316409,316411,316412,2,3,0
90487,6,2,316415,316415,316417,0,2,3
90488,3,3,316418,316418,316421,0,3,1
90489,3,1,316421,316421,316422,0,1,0
90490,1,3,316422,316422,316425,0,3,0
90491,3,3,316425,316425,316428,0,3,0
90492,2,1,316427,316428,316429,1,2,0
90493,3,2,316430,316430,316432,0,2,1
90494,1,3,316431,316432,316435,1,4,0
90495,4,1,316435,316435,316436,0,1,0
90496,4,3,316439,316439,316442,0,3,3
90497,2,1,316441,316442,316443,1,2,0
90498,5,2,316446,316446,316448,0,2,3
90499,6,1,316452,316452,316453,0,1,4
90500,2,3,316454,316454,316457,0,3,1
90501,2,3,316456,316457,316460,1,4,0
90502,1,3,316457,316460,316463,3,6,0
90503,1,3,316458,316463,316466,5,8,0
90504,2,3,316460,316466,316469,6,9,0
90505,3,1,316463,316469,316470,6,7,0
90506,2,1,316465,316470,316471,5,6,0
90507,5,1,316470,316471,316472,1,2,0
90508,2,3,316472,316472,316475,0,3,0
90509,1,3,316473,316475,316478,2,5,0
90510,2,2,316475,316478,316480,3,5,0
90511,1,1,316476,316480,316481,4,5,0
90512,5,2,316481,316481,316483,0,2,0
90513,5,3,316486,316486,316489,0,3,3
90514,6,2,316492,316492,316494,0,2,3
90515,6,2,316498,316498,316500,0,2,4
90516,2,3,316500,316500,316503,0,3,0
90517,4,3,316504,316504,316507,0,3,1
90518,6,3,316510,316510,316513,0,3,3
90519,4,2,316514,316514,316516,0,2,1
90520,2,1,316516,316516,316517,0,1,0
90521,3,3,316519,316519,316522,0,3,2
90522,4,1,316523,316523,316524,0,1,1
90523,1,3,316524,316524,316527,0,3,0
90524,2,3,316526,316527,316530,1,4,0
90525,3,2,316529,316530,316532,1,3,0
90526,5,2,316534,316534,316536,0,2,2
90527,6,2,316540,316540,316542,0,2,4
90528,1,3,316541,316542,316545,1,4,0
90529,1,2,316542,316545,316547,3,5,0
90530,6,3,316548,316548,316551,0,3,1
90531,4,1,316552,316552,316553,0,1,1
90532,4,1,316556,316556,316557,0,1,3
90533,4,1,316560,316560,316561,0,1,3
90534,1,1,316561,316561,316562,0,1,0
90535,6,3,316567,316567,316570,0,3,5
90536,2,2,316569,316570,316572,1,3,0
90537,6,3,316575,316575,316578,0,3,3
90538,2,3,316577,316578,316581,1,4,0
90539,2,3,316579,316581,316584,2,5,0
90540,2,3,316581,316584,316587,3,6,0
90541,3,2,316584,316587,316589,3,5,0
90542,3,3,316587,316589,316592,2,5,0
90543,1,3,316588,316592,316595,4,7,0
90544,3,2,316591,316595,316597,4,6,0
90545,3,2,316594,316597,316599,3,5,0
90546,1,2,316595,316599,316601,4,6,0
90547,2,3,316597,316601,316604,4,7,0
90548,5,1,316602,316604,316605,2,3,0
90549,4,2,316606,316606,316608,0,2,1
90550,3,1,316609,316609,316610,0,1,1
90551,4,3,316613,316613,316616,0,3,3
90552,1,2,316614,316616,316618,2,4,0
90553,6,1,316620,316620,316621,0,1,2
90554,5,1,316625,316625,316626,0,1,4
90555,5,3,316630,316630,316633,0,3,4
90556,3,2,316633,316633,316635,0,2,0
90557,6,3,316639,316639,316642,0,3,4
90558,4,3,316643,316643,316646,0,3,1
90559,2,1,316645,316646,316647,1,2,0
90560,2,1,316647,316647,316648,0,1,0
90561,4,2,316651,316651,316653,0,2,3
90562,3,2,316654,316654,316656,0,2,1
90563,5,1,316659,316659,316660,0,1,3
90564,2,1,316661,316661,316662,0,1,1
90565,3,3,316664,316664,316667,0,3,2
90566,6,1,316670,316670,316671,0,1,3
90567,3,3,316673,316673,316676,0,3,2
90568,4,1,316677,316677,316678,0,1,1
90569,5,1,316682,316682,316683,0,1,4
90570,3,1,316685,316685,316686,0,1,2
90571,6,2,316691,316691,316693,0,2,5
90572,1,1,316692,316693,316694,1,2,0
90573,4,1,316696,316696,316697,0,1,2
90574,5,3,316701,316701,316704,0,3,4
90575,2,1,316703,316704,316705,1,2,0
90576,5,1,316708,316708,316709,0,1,3
90577,5,3,316713,316713,316716,0,3,4
90578,3,3,316716,316716,316719,0,3,0
90579,1,3,316717,316719,316722,2,5,0
90580,1,3,316718,316722,316725,4,7,0
90581,1,3,316719,316725,316728,6,9,0
90582,5,1,316724,316728,316729,4,5,0
90583,2,2,316726,316729,316731,3,5,0
90584,2,3,316728,316731,316734,3,6,0
90585,2,3,316730,316734,316737,4,7,0
90586,3,2,316733,316737,316739,4,6,0
90587,6,1,316739,316739,316740,0,1,0
90588,6,2,316745,316745,316747,0,2,5
90589,6,2,316751,316751,316753,0,2,4
90590,6,1,316757,316757,316758,0,1,4
90591,3,2,316760,316760,316762,0,2,2
90592,4,2,316764,316764,316766,0,2,2
90593,1,1,316765,316766,316767,1,2,0
90594,2,2,316767,316767,316769,0,2,0
90595,5,3,316772,316772,316775,0,3,3
90596,4,1,316776,316776,316777,0,1,1
90597,1,3,316777,316777,316780,0,3,0
90598,4,2,316781,316781,316783,0,2,1
90599,2,1,316783,316783,316784,0,1,0
90600,1,2,316784,316784,316786,0,2,0
90601,6,2,316790,316790,316792,0,2,4
90602,2,2,316792,316792,316794,0,2,0
90603,3,3,316795,316795,316798,0,3,1
90604,1,1,316796,316798,316799,2,3,0
90605,6,2,316802,316802,316804,0,2,3
90606,4,2,316806,316806,316808,0,2,2
90607,5,1,316811,316811,316812,0,1,3
90608,3,3,316814,316814,316817,0,3,2
90609,1,1,316815,316817,316818,2,3,0
90610,4,3,316819,316819,316822,0,3,1
90611,3,2,316822,316822,316824,0,2,0
90612,3,3,316825,316825,316828,0,3,1
90613,5,1,316830,316830,316831,0,1,2
90614,4,3,316834,316834,316837,0,3,3
90615,4,1,316838,316838,316839,0,1,1
90616,4,3,316842,316842,316845,0,3,3
90617,2,1,316844,316845,316846,1,2,0
90618,2,3,316846,316846,316849,0,3,0
90619,5,3,316851,316851,316854,0,3,2
90620,6,1,316857,316857,316858,0,1,3
90621,3,3,316860,316860,316863,0,3,2
90622,4,2,316864,316864,316866,0,2,1
90623,3,3,316867,316867,316870,0,3,1
90624,3,1,316870,316870,316871,0,1,0
90625,6,3,316876,316876,316879,0,3,5
90626,4,1,316880,316880,316881,0,1,1
90627,5,1,316885,316885,316886,0,1,4
90628,6,1,316891,316891,316892,0,1,5
90629,1,2,316892,316892,316894,0,2,0
90630,1,1,316893,316894,316895,1,2,0
90631,5,1,316898,316898,316899,0,1,3
90632,5,1,316903,316903,316904,0,1,4
90633,1,1,316904,316904,316905,0,1,0
90634,5,2,316909,316909,316911,0,2,4
90635,6,3,316915,316915,316918,0,3,4
90636,1,2,316916,316918,316920,2,4,0
90637,3,2,316919,316920,316922,1,3,0
90638,5,2,316924,316924,316926,0,2,2
90639,4,3,316928,316928,316931,0,3,2
90640,2,3,316930,316931,316934,1,4,0
90641,5,1,316935,316935,316936,0,1,1
90642,3,1,316938,316938,316939,0,1,2
90643,5,1,316943,316943,316944,0,1,4
90644,1,3,316944,316944,316947,0,3,0
90645,2,2,316946,316947,316949,1,3,0
90646,4,1,316950,316950,316951,0,1,1
90647,5,2,316955,316955,316957,0,2,4
90648,1,1,316956,316957,316958,1,2,0
90649,4,2,316960,316960,316962,0,2,2
90650,6,2,316966,316966,316968,0,2,4
90651,6,2,316972,316972,316974,0,2,4
90652,3,3,316975,316975,316978,0,3,1
90653,6,1,316981,316981,316982,0,1,3
90654,3,2,316984,316984,316986,0,2,2
90655,3,3,316987,316987,316990,0,3,1
90656,1,1,316988,316990,316991,2,3,0
90657,4,2,316992,316992,316994,0,2,1
90658,2,3,316994,316994,316997,0,3,0
90659,2,3,316996,316997,317000,1,4,0
90660,3,2,316999,317000,317002,1,3,0
90661,1,1,317000,317002,317003,2,3,0
90662,1,2,317001,317003,317005,2,4,0
90663,5,1,317006,317006,317007,0,1,1
90664,5,1,317011,317011,317012,0,1,4
90665,4,3,317015,317015,317018,0,3,3
90666,5,3,317020,317020,317023,0,3,2
90667,2,1,317022,317023,317024,1,2,0
90668,4,2,317026,317026,317028,0,2,2
90669,3,3,317029,317029,317032,0,3,1
90670,2,3,317031,317032,317035,1,4,0
90671,6,2,317037,317037,317039,0,2,2
90672,4,3,317041,317041,317044,0,3,2
90673,5,2,317046,317046,317048,0,2,2
90674,4,1,317050,317050,317051,0,1,2
90675,4,3,317054,317054,317057,0,3,3
90676,6,1,317060,317060,317061,0,1,3
90677,1,1,317061,317061,317062,0,1,0
90678,2,3,317063,317063,317066,0,3,1
90679,5,1,317068,317068,317069,0,1,2
90680,6,2,317074,317074,317076,0,2,5
90681,3,1,317077,317077,317078,0,1,1
90682,1,1,317078,317078,317079,0,1,0
90683,1,2,317079,317079,317081,0,2,0
90684,1,1,317080,317081,317082,1,2,0
90685,2,3,317082,317082,317085,0,3,0
90686,2,2,317084,317085,317087,1,3,0
90687,6,1,317090,317090,317091,0,1,3
90688,3,2,317093,317093,317095,0,2,2
90689,6,2,317099,317099,317101,0,2,4
90690,3,1,317102,317102,317103,0,1,1
90691,5,2,317107,317107,317109,0,2,4
90692,1,1,317108,317109,317110,1,2,0
90693,5,3,317113,317113,317116,0,3,3
90694,2,1,317115,317116,317117,1,2,0
90695,2,3,317117,317117,317120,0,3,0
90696,2,3,317119,317120,317123,1,4,0
90697,2,1,317121,317123,317124,2,3,0
90698,5,2,317126,317126,317128,0,2,2
90699,1,3,317127,317128,317131,1,4,0
90700,4,2,317131,317131,317133,0,2,0
90701,3,1,317134,317134,317135,0,1,1
90702,6,3,317140,317140,317143,0,3,5
90703,3,2,317143,317143,317145,0,2,0
90704,3,2,317146,317146,317148,0,2,1
90705,5,2,317151,317151,317153,0,2,3
90706,6,2,317157,317157,317159,0,2,4
90707,4,3,317161,317161,317164,0,3,2
90708,6,1,317167,317167,317168,0,1,3
90709,1,3,317168,317168,317171,0,3,0
90710,6,3,317174,317174,317177,0,3,3
90711,5,2,317179,317179,317181,0,2,2
90712,2,1,317181,317181,317182,0,1,0
90713,1,2,317182,317182,317184,0,2,0
90714,3,1,317185,317185,317186,0,1,1
90715,5,1,317190,317190,317191,0,1,4
90716,3,1,317193,317193,317194,0,1,2
90717,2,3,317195,317195,317198,0,3,1
90718,6,2,317201,317201,317203,0,2,3
90719,4,2,317205,317205,317207,0,2,2
90720,6,3,317211,317211,317214,0,3,4
90721,6,3,317217,317217,317220,0,3,3
90722,6,3,317223,317223,317226,0,3,3
90723,5,2,317228,317228,317230,0,2,2
90724,3,3,317231,317231,317234,0,3,1
90725,5,3,317236,317236,317239,0,3,2
90726,4,2,317240,317240,317242,0,2,1
90727,4,3,317244,317244,317247,0,3,2
90728,5,1,317249,317249,317250,0,1,2
90729,3,2,317252,317252,317254,0,2,2
90730,3,1,317255,317255,317256,0,1,1
90731,5,1,317260,317260,317261,0,1,4
90732,6,1,317266,317266,317267,0,1,5
90733,2,3,317268,317268,317271,0,3,1
90734,6,1,317274,317274,317275,0,1,3
90735,4,2,317278,317278,317280,0,2,3
90736,1,3,317279,317280,317283,1,4,0
90737,5,2,317284,317284,317286,0,2,1
90738,1,3,317285,317286,317289,1,4,0
90739,5,1,317290,317290,317291,0,1,1
90740,6,3,317296,317296,317299,0,3,5
90741,3,3,317299,317299,317302,0,3,0
90742,1,3,317300,317302,317305,2,5,0
90743,1,2,317301,317305,317307,4,6,0
90744,6,2,317307,317307,317309,0,2,0
90745,5,1,317312,317312,317313,0,1,3
90746,6,1,317318,317318,317319,0,1,5
90747,3,3,317321,317321,317324,0,3,2
90748,3,3,317324,317324,317327,0,3,0
90749,4,1,317328,317328,317329,0,1,1
90750,1,1,317329,317329,317330,0,1,0
90751,4,1,317333,317333,317334,0,1,3
90752,1,2,317334,317334,317336,0,2,0
90753,2,2,317336,317336,317338,0,2,0
90754,6,3,317342,317342,317345,0,3,4
90755,5,3,317347,317347,317350,0,3,2
90756,6,1,317353,317353,317354,0,1,3
90757,1,1,317354,317354,317355,0,1,0
90758,5,1,317359,317359,317360,0,1,4
90759,4,3,317363,317363,317366,0,3,3
90760,4,1,317367,317367,317368,0,1,1
90761,6,3,317373,317373,317376,0,3,5
90762,5,2,317378,317378,317380,0,2,2
90763,4,1,317382,317382,317383,0,1,2
90764,1,2,317383,317383,317385,0,2,0
90765,5,1,317388,317388,317389,0,1,3
90766,3,3,317391,317391,317394,0,3,2
90767,3,3,317394,317394,317397,0,3,0
90768,3,3,317397,317397,317400,0,3,0
90769,6,3,317403,317403,317406,0,3,3
90770,1,3,317404,317406,317409,2,5,0
90771,1,2,317405,317409,317411,4,6,0
90772,3,1,317408,317411,317412,3,4,0
90773,4,3,317412,317412,317415,0,3,0
90774,3,2,317415,317415,317417,0,2,0
90775,4,1,317419,317419,317420,0,1,2
90776,5,1,317424,317424,317425,0,1,4
90777,4,1,317428,317428,317429,0,1,3
90778,1,2,317429,317429,317431,0,2,0
90779,4,3,317433,317433,317436,0,3,2
90780,2,2,317435,317436,317438,1,3,0
90781,5,1,317440,317440,317441,0,1,2
90782,2,3,317442,317442,317445,0,3,1
90783,1,1,317443,317445,317446,2,3,0
90784,2,2,317445,317446,317448,1,3,0
90785,6,3,317451,317451,317454,0,3,3
90786,5,3,317456,317456,317459,0,3,2
90787,6,1,317462,317462,317463,0,1,3
90788,3,3,317465,317465,317468,0,3,2
90789,2,2,317467,317468,317470,1,3,0
90790,4,2,317471,317471,317473,0,2,1
90791,5,3,317476,317476,317479,0,3,3
90792,4,3,317480,317480,317483,0,3,1
90793,1,3,317481,317483,317486,2,5,0
90794,3,3,317484,317486,317489,2,5,0
90795,5,1,317489,317489,317490,0,1,0
90796,6,2,317495,317495,317497,0,2,5
90797,1,1,317496,317497,317498,1,2,0
90798,4,3,317500,317500,317503,0,3,2
90799,5,1,317505,317505,317506,0,1,2
90800,4,3,317509,317509,317512,0,3,3
90801,2,2,317511,317512,317514,1,3,0
90802,4,2,317515,317515,317517,0,2,1
90803,1,1,317516,317517,317518,1,2,0
90804,1,3,317517,317518,317521,1,4,0
90805,6,1,317523,317523,317524,0,1,2
90806,5,2,317528,317528,317530,0,2,4
90807,2,1,317530,317530,317531,0,1,0
90808,1,1,317531,317531,317532,0,1,0
90809,1,2,317532,317532,317534,0,2,0
90810,3,2,317535,317535,317537,0,2,1
90811,1,3,317536,317537,317540,1,4,0
90812,5,3,317541,317541,317544,0,3,1
90813,5,1,317546,317546,317547,0,1,2
90814,3,2,317549,317549,317551,0,2,2
90815,5,3,317554,317554,317557,0,3,3
90816,6,3,317560,317560,317563,0,3,3
90817,3,2,317563,317563,317565,0,2,0
90818,2,3,317565,317565,317568,0,3,0
90819,2,1,317567,317568,317569,1,2,0
90820,1,3,317568,317569,317572,1,4,0
90821,6,2,317574,317574,317576,0,2,2
90822,6,2,317580,317580,317582,0,2,4
90823,6,3,317586,317586,317589,0,3,4
90824,4,2,317590,317590,317592,0,2,1
90825,2,2,317592,317592,317594,0,2,0
90826,1,2,317593,317594,317596,1,3,0
90827,5,1,317598,317598,317599,0,1,2
90828,5,2,317603,317603,317605,0,2,4
90829,5,1,317608,317608,317609,0,1,3
90830,5,2,317613,317613,317615,0,2,4
90831,4,1,317617,317617,317618,0,1,2
90832,3,3,317620,317620,317623,0,3,2
90833,3,1,317623,317623,317624,0,1,0
90834,6,2,317629,317629,317631,0,2,5
90835,1,1,317630,317631,317632,1,2,0
90836,4,3,317634,317634,317637,0,3,2
90837,3,1,317637,317637,317638,0,1,0
90838,5,2,317642,317642,317644,0,2,4
90839,5,2,317647,317647,317649,0,2,3
90840,3,1,317650,317650,317651,0,1,1
90841,4,3,317654,317654,317657,0,3,3
90842,4,3,317658,317658,317661,0,3,1
90843,4,1,317662,317662,317663,0,1,1
90844,5,1,317667,317667,317668,0,1,4
90845,6,2,317673,317673,317675,0,2,5
90846,6,3,317679,317679,317682,0,3,4
90847,5,2,317684,317684,317686,0,2,2
90848,4,1,317688,317688,317689,0,1,2
90849,2,1,317690,317690,317691,0,1,1
90850,6,2,317696,317696,317698,0,2,5
90851,5,1,317701,317701,317702,0,1,3
90852,4,1,317705,317705,317706,0,1,3
90853,2,3,317707,317707,317710,0,3,1
90854,1,2,317708,317710,317712,2,4,0
90855,1,1,317709,317712,317713,3,4,0
90856,2,2,317711,317713,317715,2,4,0
90857,6,3,317717,317717,317720,0,3,2
90858,5,3,317722,317722,317725,0,3,2
90859,4,2,317726,317726,317728,0,2,1
90860,4,3,317730,317730,317733,0,3,2
90861,3,3,317733,317733,317736,0,3,0
90862,4,3,317737,317737,317740,0,3,1
90863,3,2,317740,317740,317742,0,2,0
90864,3,1,317743,317743,317744,0,1,1
90865,2,2,317745,317745,317747,0,2,1
90866,3,3,317748,317748,317751,0,3,1
90867,2,2,317750,317751,317753,1,3,0
90868,4,1,317754,317754,317755,0,1,1
90869,2,1,317756,317756,317757,0,1,1
90870,1,3,317757,317757,317760,0,3,0
90871,1,1,317758,317760,317761,2,3,0
90872,2,1,317760,317761,317762,1,2,0
90873,2,2,317762,317762,317764,0,2,0
90874,3,3,317765,317765,317768,0,3,1
90875,1,1,317766,317768,317769,2,3,0
90876,3,1,317769,317769,317770,0,1,0
90877,6,2,317775,317775,317777,0,2,5
90878,1,1,317776,317777,317778,1,2,0
90879,4,1,317780,317780,317781,0,1,2
90880,1,2,317781,317781,317783,0,2,0
90881,4,3,317785,317785,317788,0,3,2
90882,5,2,317790,317790,317792,0,2,2
90883,1,1,317791,317792,317793,1,2,0
90884,2,2,317793,317793,317795,0,2,0
90885,3,3,317796,317796,317799,0,3,1
90886,1,2,317797,317799,317801,2,4,0
90887,3,3,317800,317801,317804,1,4,0
90888,4,2,317804,317804,317806,0,2,0
90889,6,3,317810,317810,317813,0,3,4
90890,5,3,317815,317815,317818,0,3,2
90891,2,2,317817,317818,317820,1,3,0
90892,5,1,317822,317822,317823,0,1,2
90893,1,2,317823,317823,317825,0,2,0
90894,2,3,317825,317825,317828,0,3,0
90895,2,1,317827,317828,317829,1,2,0
90896,6,2,317833,317833,317835,0,2,4
90897,4,1,317837,317837,317838,0,1,2
90898,1,1,317838,317838,317839,0,1,0
90899,2,2,317840,317840,317842,0,2,1
90900,6,1,317846,317846,317847,0,1,4
90901,6,3,317852,317852,317855,0,3,5
90902,4,2,317856,317856,317858,0,2,1
90903,4,1,317860,317860,317861,0,1,2
90904,3,3,317863,317863,317866,0,3,2
90905,5,1,317868,317868,317869,0,1,2
90906,2,1,317870,317870,317871,0,1,1
90907,3,1,317873,317873,317874,0,1,2
90908,3,2,317876,317876,317878,0,2,2
90909,4,3,317880,317880,317883,0,3,2
90910,5,3,317885,317885,317888,0,3,2
90911,2,3,317887,317888,317891,1,4,0
90912,3,2,317890,317891,317893,1,3,0
90913,5,1,317895,317895,317896,0,1,2
90914,2,3,317897,317897,317900,0,3,1
90915,4,2,317901,317901,317903,0,2,1
90916,4,1,317905,317905,317906,0,1,2
90917,1,2,317906,317906,317908,0,2,0
90918,5,3,317911,317911,317914,0,3,3
90919,2,1,317913,317914,317915,1,2,0
90920,1,1,317914,317915,317916,1,2,0
90921,3,1,317917,317917,317918,0,1,1
90922,2,3,317919,317919,317922,0,3,1
90923,4,1,317923,317923,317924,0,1,1
90924,5,2,317928,317928,317930,0,2,4
90925,4,3,317932,317932,317935,0,3,2
90926,3,3,317935,317935,317938,0,3,0
90927,4,3,317939,317939,317942,0,3,1
90928,5,2,317944,317944,317946,0,2,2
90929,4,3,317948,317948,317951,0,3,2
90930,5,1,317953,317953,317954,0,1,2
90931,5,1,317958,317958,317959,0,1,4
90932,5,1,317963,317963,317964,0,1,4
90933,2,1,317965,317965,317966,0,1,1
90934,1,1,317966,317966,317967,0,1,0
90935,4,1,317970,317970,317971,0,1,3
90936,6,3,317976,317976,317979,0,3,5
90937,5,3,317981,317981,317984,0,3,2
90938,4,2,317985,317985,317987,0,2,1
90939,6,2,317991,317991,317993,0,2,4
90940,3,1,317994,317994,317995,0,1,1
90941,4,3,317998,317998,318001,0,3,3
90942,6,2,318004,318004,318006,0,2,3
90943,6,1,318010,318010,318011,0,1,4
90944,3,2,318013,318013,318015,0,2,2
90945,2,1,318015,318015,318016,0,1,0
90946,3,3,318018,318018,318021,0,3,2
90947,4,3,318022,318022,318025,0,3,1
90948,6,1,318028,318028,318029,0,1,3
90949,1,1,318029,318029,318030,0,1,0
90950,3,1,318032,318032,318033,0,1,2
90951,6,1,318038,318038,318039,0,1,5
90952,4,2,318042,318042,318044,0,2,3
90953,4,2,318046,318046,318048,0,2,2
90954,6,2,318052,318052,318054,0,2,4
90955,3,2,318055,318055,318057,0,2,1
90956,5,1,318060,318060,318061,0,1,3
90957,5,3,318065,318065,318068,0,3,4
90958,1,3,318066,318068,318071,2,5,0
90959,6,3,318072,318072,318075,0,3,1
90960,6,1,318078,318078,318079,0,1,3
90961,4,1,318082,318082,318083,0,1,3
90962,5,2,318087,318087,318089,0,2,4
90963,2,2,318089,318089,318091,0,2,0
90964,6,3,318095,318095,318098,0,3,4
90965,6,2,318101,318101,318103,0,2,3
90966,4,3,318105,318105,318108,0,3,2
90967,4,3,318109,318109,318112,0,3,1
90968,3,3,318112,318112,318115,0,3,0
90969,1,1,318113,318115,318116,2,3,0
90970,2,1,318115,318116,318117,1,2,0
90971,5,1,318120,318120,318121,0,1,3
90972,4,1,318124,318124,318125,0,1,3
90973,6,2,318130,318130,318132,0,2,5
90974,3,1,318133,318133,318134,0,1,1
90975,3,3,318136,318136,318139,0,3,2
90976,3,1,318139,318139,318140,0,1,0
90977,2,1,318141,318141,318142,0,1,1
90978,4,1,318145,318145,318146,0,1,3
90979,3,2,318148,318148,318150,0,2,2
90980,6,2,318154,318154,318156,0,2,4
90981,6,3,318160,318160,318163,0,3,4
90982,1,2,318161,318163,318165,2,4,0
90983,6,2,318167,318167,318169,0,2,2
90984,1,3,318168,318169,318172,1,4,0
90985,3,1,318171,318172,318173,1,2,0
90986,6,3,318177,318177,318180,0,3,4
90987,3,2,318180,318180,318182,0,2,0
90988,1,1,318181,318182,318183,1,2,0
90989,4,2,318185,318185,318187,0,2,2
90990,5,1,318190,318190,318191,0,1,3
90991,2,1,318192,318192,318193,0,1,1
90992,4,2,318196,318196,318198,0,2,3
90993,5,3,318201,318201,318204,0,3,3
90994,6,1,318207,318207,318208,0,1,3
90995,5,3,318212,318212,318215,0,3,4
90996,5,1,318217,318217,318218,0,1,2
90997,1,1,318218,318218,318219,0,1,0
90998,2,3,318220,318220,318223,0,3,1
90999,5,1,318225,318225,318226,0,1,2
91000,3,3,318228,318228,318231,0,3,2
91001,2,3,318230,318231,318234,1,4,0
91002,6,3,318236,318236,318239,0,3,2
91003,2,2,318238,318239,318241,1,3,0
91004,6,2,318244,318244,318246,0,2,3
91005,3,2,318247,318247,318249,0,2,1
91006,5,2,318252,318252,318254,0,2,3
91007,5,3,318257,318257,318260,0,3,3
91008,3,1,318260,318260,318261,0,1,0
91009,4,2,318264,318264,318266,0,2,3
91010,6,2,318270,318270,318272,0,2,4
91011,4,3,318274,318274,318277,0,3,2
91012,6,1,318280,318280,318281,0,1,3
91013,4,3,318284,318284,318287,0,3,3
91014,4,2,318288,318288,318290,0,2,1
91015,4,3,318292,318292,318295,0,3,2
91016,5,3,318297,318297,318300,0,3,2
91017,5,1,318302,318302,318303,0,1,2
91018,5,3,318307,318307,318310,0,3,4
91019,5,1,318312,318312,318313,0,1,2
91020,4,3,318316,318316,318319,0,3,3
91021,2,2,318318,318319,318321,1,3,0
91022,4,1,318322,318322,318323,0,1,1
91023,5,2,318327,318327,318329,0,2,4
91024,2,2,318329,318329,318331,0,2,0
91025,4,3,318333,318333,318336,0,3,2
91026,4,2,318337,318337,318339,0,2,1
91027,1,1,318338,318339,318340,1,2,0
91028,2,1,318340,318340,318341,0,1,0
91029,4,2,318344,318344,318346,0,2,3
91030,5,2,318349,318349,318351,0,2,3
91031,2,1,318351,318351,318352,0,1,0
91032,5,2,318356,318356,318358,0,2,4
91033,5,2,318361,318361,318363,0,2,3
91034,4,1,318365,318365,318366,0,1,2
91035,2,3,318367,318367,318370,0,3,1
91036,6,3,318373,318373,318376,0,3,3
91037,6,3,318379,318379,318382,0,3,3
91038,6,3,318385,318385,318388,0,3,3
91039,2,3,318387,318388,318391,1,4,0
91040,2,3,318389,318391,318394,2,5,0
91041,5,1,318394,318394,318395,0,1,0
91042,2,2,318396,318396,318398,0,2,1
91043,1,1,318397,318398,318399,1,2,0
91044,3,2,318400,318400,318402,0,2,1
91045,5,2,318405,318405,318407,0,2,3
91046,2,1,318407,318407,318408,0,1,0
91047,3,1,318410,318410,318411,0,1,2
91048,2,2,318412,318412,318414,0,2,1
91049,4,2,318416,318416,318418,0,2,2
91050,6,2,318422,318422,318424,0,2,4
91051,3,3,318425,318425,318428,0,3,1
91052,5,2,318430,318430,318432,0,2,2
91053,3,3,318433,318433,318436,0,3,1
91054,6,2,318439,318439,318441,0,2,3
91055,4,3,318443,318443,318446,0,3,2
91056,6,2,318449,318449,318451,0,2,3
91057,6,2,318455,318455,318457,0,2,4
91058,5,1,318460,318460,318461,0,1,3
91059,3,2,318463,318463,318465,0,2,2
91060,4,2,318467,318467,318469,0,2,2
91061,1,1,318468,318469,318470,1,2,0
91062,2,1,318470,318470,318471,0,1,0
91063,1,1,318471,318471,318472,0,1,0
91064,3,3,318474,318474,318477,0,3,2
91065,1,3,318475,318477,318480,2,5,0
91066,6,1,318481,318481,318482,0,1,1
91067,1,2,318482,318482,318484,0,2,0
91068,1,3,318483,318484,318487,1,4,0
91069,5,1,318488,318488,318489,0,1,1
91070,5,2,318493,318493,318495,0,2,4
91071,1,3,318494,318495,318498,1,4,0
91072,3,3,318497,318498,318501,1,4,0
91073,5,2,318502,318502,318504,0,2,1
91074,2,1,318504,318504,318505,0,1,0
91075,2,1,318506,318506,318507,0,1,1
91076,6,1,318512,318512,318513,0,1,5
91077,2,2,318514,318514,318516,0,2,1
91078,1,2,318515,318516,318518,1,3,0
91079,1,2,318516,318518,318520,2,4,0
91080,5,1,318521,318521,318522,0,1,1
91081,4,3,318525,318525,318528,0,3,3
91082,4,2,318529,318529,318531,0,2,1
91083,5,1,318534,318534,318535,0,1,3
91084,5,3,318539,318539,318542,0,3,4
91085,6,3,318545,318545,318548,0,3,3
91086,6,1,318551,318551,318552,0,1,3
91087,2,1,318553,318553,318554,0,1,1
91088,4,2,318557,318557,318559,0,2,3
91089,1,3,318558,318559,318562,1,4,0
91090,3,1,318561,318562,318563,1,2,0
91091,6,2,318567,318567,318569,0,2,4
91092,4,1,318571,318571,318572,0,1,2
91093,3,1,318574,318574,318575,0,1,2
91094,1,3,318575,318575,318578,0,3,0
91095,3,2,318578,318578,318580,0,2,0
91096,4,2,318582,318582,318584,0,2,2
91097,4,3,318586,318586,318589,0,3,2
91098,2,2,318588,318589,318591,1,3,0
91099,6,1,318594,318594,318595,0,1,3
91100,5,3,318599,318599,318602,0,3,4
91101,3,2,318602,318602,318604,0,2,0
91102,1,2,318603,318604,318606,1,3,0
91103,3,1,318606,318606,318607,0,1,0
91104,3,1,318609,318609,318610,0,1,2
91105,5,1,318614,318614,318615,0,1,4
91106,1,3,318615,318615,318618,0,3,0
91107,1,3,318616,318618,318621,2,5,0
91108,6,2,318622,318622,318624,0,2,1
91109,4,1,318626,318626,318627,0,1,2
91110,4,3,318630,318630,318633,0,3,3
91111,2,3,318632,318633,318636,1,4,0
91112,4,3,318636,318636,318639,0,3,0
91113,4,2,318640,318640,318642,0,2,1
91114,6,2,318646,318646,318648,0,2,4
91115,6,2,318652,318652,318654,0,2,4
91116,1,3,318653,318654,318657,1,4,0
91117,3,3,318656,318657,318660,1,4,0
91118,4,3,318660,318660,318663,0,3,0
91119,4,3,318664,318664,318667,0,3,1
91120,3,3,318667,318667,318670,0,3,0
91121,4,2,318671,318671,318673,0,2,1
91122,6,3,318677,318677,318680,0,3,4
91123,6,2,318683,318683,318685,0,2,3
91124,2,1,318685,318685,318686,0,1,0
91125,4,2,318689,318689,318691,0,2,3
91126,5,1,318694,318694,318695,0,1,3
91127,2,1,318696,318696,318697,0,1,1
91128,5,1,318701,318701,318702,0,1,4
91129,5,3,318706,318706,318709,0,3,4
91130,2,1,318708,318709,318710,1,2,0
91131,2,2,318710,318710,318712,0,2,0
91132,2,3,318712,318712,318715,0,3,0
91133,3,2,318715,318715,318717,0,2,0
91134,5,2,318720,318720,318722,0,2,3
91135,3,2,318723,318723,318725,0,2,1
91136,5,2,318728,318728,318730,0,2,3
91137,2,3,318730,318730,318733,0,3,0
91138,6,1,318736,318736,318737,0,1,3
91139,1,3,318737,318737,318740,0,3,0
91140,3,3,318740,318740,318743,0,3,0
91141,1,3,318741,318743,318746,2,5,0
91142,1,2,318742,318746,318748,4,6,0
91143,3,1,318745,318748,318749,3,4,0
91144,5,1,318750,318750,318751,0,1,1
91145,6,3,318756,318756,318759,0,3,5
91146,4,2,318760,318760,318762,0,2,1
91147,2,3,318762,318762,318765,0,3,0
91148,1,1,318763,318765,318766,2,3,0
91149,1,2,318764,318766,318768,2,4,0
91150,6,2,318770,318770,318772,0,2,2
91151,3,3,318773,318773,318776,0,3,1
91152,4,1,318777,318777,318778,0,1,1
91153,1,3,318778,318778,318781,0,3,0
91154,4,2,318782,318782,318784,0,2,1
91155,4,1,318786,318786,318787,0,1,2
91156,1,1,318787,318787,318788,0,1,0
91157,6,3,318793,318793,318796,0,3,5
91158,1,1,318794,318796,318797,2,3,0
91159,6,1,318800,318800,318801,0,1,3
91160,2,3,318802,318802,318805,0,3,1
91161,5,3,318807,318807,318810,0,3,2
91162,3,3,318810,318810,318813,0,3,0
91163,4,2,318814,318814,318816,0,2,1
91164,4,2,318818,318818,318820,0,2,2
91165,6,2,318824,318824,318826,0,2,4
91166,5,3,318829,318829,318832,0,3,3
91167,5,1,318834,318834,318835,0,1,2
91168,3,3,318837,318837,318840,0,3,2
91169,5,1,318842,318842,318843,0,1,2
91170,3,1,318845,318845,318846,0,1,2
91171,6,3,318851,318851,318854,0,3,5
91172,5,2,318856,318856,318858,0,2,2
91173,1,2,318857,318858,318860,1,3,0
91174,2,2,318859,318860,318862,1,3,0
91175,4,2,318863,318863,318865,0,2,1
91176,4,1,318867,318867,318868,0,1,2
91177,1,2,318868,318868,318870,0,2,0
91178,4,3,318872,318872,318875,0,3,2
91179,5,2,318877,318877,318879,0,2,2
91180,4,1,318881,318881,318882,0,1,2
91181,4,1,318885,318885,318886,0,1,3
91182,4,3,318889,318889,318892,0,3,3
91183,6,3,318895,318895,318898,0,3,3
91184,4,1,318899,318899,318900,0,1,1
91185,6,3,318905,318905,318908,0,3,5
91186,3,1,318908,318908,318909,0,1,0
91187,4,1,318912,318912,318913,0,1,3
91188,1,1,318913,318913,318914,0,1,0
91189,1,2,318914,318914,318916,0,2,0
91190,5,1,318919,318919,318920,0,1,3
91191,1,3,318920,318920,318923,0,3,0
91192,6,3,318926,318926,318929,0,3,3
91193,5,2,318931,318931,318933,0,2,2
91194,3,2,318934,318934,318936,0,2,1
91195,2,1,318936,318936,318937,0,1,0
91196,6,2,318942,318942,318944,0,2,5
91197,1,1,318943,318944,318945,1,2,0
91198,6,2,318949,318949,318951,0,2,4
91199,6,2,318955,318955,318957,0,2,4
91200,6,2,318961,318961,318963,0,2,4
91201,2,3,318963,318963,318966,0,3,0
91202,2,1,318965,318966,318967,1,2,0
91203,4,3,318969,318969,318972,0,3,2
91204,3,3,318972,318972,318975,0,3,0
91205,2,2,318974,318975,318977,1,3,0
91206,6,2,318980,318980,318982,0,2,3
91207,4,2,318984,318984,318986,0,2,2
91208,6,3,318990,318990,318993,0,3,4
91209,6,3,318996,318996,318999,0,3,3
91210,2,2,318998,318999,319001,1,3,0
91211,2,3,319000,319001,319004,1,4,0
91212,2,1,319002,319004,319005,2,3,0
91213,5,1,319007,319007,319008,0,1,2
91214,5,3,319012,319012,319015,0,3,4
91215,5,3,319017,319017,319020,0,3,2
91216,3,3,319020,319020,319023,0,3,0
91217,1,2,319021,319023,319025,2,4,0
91218,5,3,319026,319026,319029,0,3,1
91219,1,1,319027,319029,319030,2,3,0
91220,2,2,319029,319030,319032,1,3,0
91221,2,3,319031,319032,319035,1,4,0
91222,6,3,319037,319037,319040,0,3,2
91223,6,2,319043,319043,319045,0,2,3
91224,3,3,319046,319046,319049,0,3,1
91225,6,2,319052,319052,319054,0,2,3
91226,4,3,319056,319056,319059,0,3,2
91227,5,1,319061,319061,319062,0,1,2
91228,2,3,319063,319063,319066,0,3,1
91229,4,2,319067,319067,319069,0,2,1
91230,5,1,319072,319072,319073,0,1,3
91231,4,1,319076,319076,319077,0,1,3
91232,4,2,319080,319080,319082,0,2,3
91233,3,1,319083,319083,319084,0,1,1
91234,2,1,319085,319085,319086,0,1,1
91235,4,1,319089,319089,319090,0,1,3
91236,4,2,319093,319093,319095,0,2,3
91237,5,1,319098,319098,319099,0,1,3
91238,1,3,319099,319099,319102,0,3,0
91239,3,2,319102,319102,319104,0,2,0
91240,5,2,319107,319107,319109,0,2,3
91241,6,2,319113,319113,319115,0,2,4
91242,6,1,319119,319119,319120,0,1,4
91243,1,2,319120,319120,319122,0,2,0
91244,3,1,319123,319123,319124,0,1,1
91245,5,1,319128,319128,319129,0,1,4
91246,5,1,319133,319133,319134,0,1,4
91247,6,2,319139,319139,319141,0,2,5
91248,4,1,319143,319143,319144,0,1,2
91249,4,1,319147,319147,319148,0,1,3
91250,3,3,319150,319150,319153,0,3,2
91251,6,3,319156,319156,319159,0,3,3
91252,5,3,319161,319161,319164,0,3,2
91253,3,2,319164,319164,319166,0,2,0
91254,4,3,319168,319168,319171,0,3,2
91255,4,3,319172,319172,319175,0,3,1
91256,3,3,319175,319175,319178,0,3,0
91257,3,1,319178,319178,319179,0,1,0
91258,4,2,319182,319182,319184,0,2,3
91259,4,3,319186,319186,319189,0,3,2
91260,4,3,319190,319190,319193,0,3,1
91261,3,3,319193,319193,319196,0,3,0
91262,2,2,319195,319196,319198,1,3,0
91263,4,2,319199,319199,319201,0,2,1
91264,6,3,319205,319205,319208,0,3,4
91265,4,3,319209,319209,319212,0,3,1
91266,4,1,319213,319213,319214,0,1,1
91267,3,3,319216,319216,319219,0,3,2
91268,1,1,319217,319219,319220,2,3,0
91269,5,3,319222,319222,319225,0,3,2
91270,4,2,319226,319226,319228,0,2,1
91271,6,2,319232,319232,319234,0,2,4
91272,4,1,319236,319236,319237,0,1,2
91273,2,2,319238,319238,319240,0,2,1
91274,2,1,319240,319240,319241,0,1,0
91275,3,3,319243,319243,319246,0,3,2
91276,2,1,319245,319246,319247,1,2,0
91277,6,3,319251,319251,319254,0,3,4
91278,2,3,319253,319254,319257,1,4,0
91279,3,1,319256,319257,319258,1,2,0
91280,3,2,319259,319259,319261,0,2,1
91281,5,3,319264,319264,319267,0,3,3
91282,6,3,319270,319270,319273,0,3,3
91283,6,1,319276,319276,319277,0,1,3
91284,5,2,319281,319281,319283,0,2,4
91285,4,2,319285,319285,319287,0,2,2
91286,6,3,319291,319291,319294,0,3,4
91287,2,3,319293,319294,319297,1,4,0
91288,1,2,319294,319297,319299,3,5,0
91289,5,2,319299,319299,319301,0,2,0
91290,6,3,319305,319305,319308,0,3,4
91291,4,3,319309,319309,319312,0,3,1
91292,6,3,319315,319315,319318,0,3,3
91293,4,2,319319,319319,319321,0,2,1
91294,1,2,319320,319321,319323,1,3,0
91295,6,2,319326,319326,319328,0,2,3
91296,2,2,319328,319328,319330,0,2,0
91297,3,2,319331,319331,319333,0,2,1
91298,2,3,319333,319333,319336,0,3,0
91299,6,3,319339,319339,319342,0,3,3
91300,4,3,319343,319343,319346,0,3,1
91301,3,1,319346,319346,319347,0,1,0
91302,6,1,319352,319352,319353,0,1,5
91303,4,1,319356,319356,319357,0,1,3
91304,4,3,319360,319360,319363,0,3,3
91305,3,1,319363,319363,319364,0,1,0
91306,4,3,319367,319367,319370,0,3,3
91307,6,2,319373,319373,319375,0,2,3
91308,4,2,319377,319377,319379,0,2,2
91309,6,3,319383,319383,319386,0,3,4
91310,1,1,319384,319386,319387,2,3,0
91311,1,3,319385,319387,319390,2,5,0
91312,4,3,319389,319390,319393,1,4,0
91313,3,2,319392,319393,319395,1,3,0
91314,2,3,319394,319395,319398,1,4,0
91315,6,1,319400,319400,319401,0,1,2
91316,3,2,319403,319403,319405,0,2,2
91317,4,2,319407,319407,319409,0,2,2
91318,2,3,319409,319409,319412,0,3,0
91319,3,3,319412,319412,319415,0,3,0
91320,4,2,319416,319416,319418,0,2,1
91321,3,1,319419,319419,319420,0,1,1
91322,5,2,319424,319424,319426,0,2,4
91323,2,1,319426,319426,319427,0,1,0
91324,4,3,319430,319430,319433,0,3,3
91325,6,1,319436,319436,319437,0,1,3
91326,6,3,319442,319442,319445,0,3,5
91327,2,2,319444,319445,319447,1,3,0
91328,4,2,319448,319448,319450,0,2,1
91329,3,3,319451,319451,319454,0,3,1
91330,5,1,319456,319456,319457,0,1,2
91331,3,3,319459,319459,319462,0,3,2
91332,6,2,319465,319465,319467,0,2,3
91333,4,2,319469,319469,319471,0,2,2
91334,4,2,319473,319473,319475,0,2,2
91335,4,3,319477,319477,319480,0,3,2
91336,2,3,319479,319480,319483,1,4,0
91337,2,2,319481,319483,319485,2,4,0
91338,6,3,319487,319487,319490,0,3,2
91339,3,3,319490,319490,319493,0,3,0
91340,4,3,319494,319494,319497,0,3,1
91341,1,1,319495,319497,319498,2,3,0
91342,3,3,319498,319498,319501,0,3,0
91343,4,1,319502,319502,319503,0,1,1
91344,5,1,319507,319507,319508,0,1,4
91345,1,1,319508,319508,319509,0,1,0
91346,4,2,319512,319512,319514,0,2,3
91347,1,1,319513,319514,319515,1,2,0
91348,2,1,319515,319515,319516,0,1,0
91349,5,3,319520,319520,319523,0,3,4
91350,1,3,319521,319523,319526,2,5,0
91351,5,1,319526,319526,319527,0,1,0
91352,2,1,319528,319528,319529,0,1,1
91353,1,2,319529,319529,319531,0,2,0
91354,6,2,319535,319535,319537,0,2,4
91355,4,2,319539,319539,319541,0,2,2
91356,4,2,319543,319543,319545,0,2,2
91357,4,3,319547,319547,319550,0,3,2
91358,2,3,319549,319550,319553,1,4,0
91359,2,2,319551,319553,319555,2,4,0
91360,3,1,319554,319555,319556,1,2,0
91361,1,1,319555,319556,319557,1,2,0
91362,1,1,319556,319557,319558,1,2,0
91363,4,3,319560,319560,319563,0,3,2
91364,4,1,319564,319564,319565,0,1,1
91365,2,2,319566,319566,319568,0,2,1
91366,1,1,319567,319568,319569,1,2,0
91367,2,2,319569,319569,319571,0,2,0
91368,6,2,319575,319575,319577,0,2,4
91369,4,1,319579,319579,319580,0,1,2
91370,2,1,319581,319581,319582,0,1,1
91371,2,1,319583,319583,319584,0,1,1
91372,4,3,319587,319587,319590,0,3,3
91373,2,3,319589,319590,319593,1,4,0
91374,4,1,319593,319593,319594,0,1,0
91375,5,2,319598,319598,319600,0,2,4
91376,6,2,319604,319604,319606,0,2,4
91377,2,2,319606,319606,319608,0,2,0
91378,5,3,319611,319611,319614,0,3,3
91379,4,3,319615,319615,319618,0,3,1
91380,2,3,319617,319618,319621,1,4,0
91381,3,3,319620,319621,319624,1,4,0
91382,1,2,319621,319624,319626,3,5,0
91383,6,2,319627,319627,319629,0,2,1
91384,5,3,319632,319632,319635,0,3,3
91385,3,2,319635,319635,319637,0,2,0
91386,2,2,319637,319637,319639,0,2,0
91387,6,1,319643,319643,319644,0,1,4
91388,2,2,319645,319645,319647,0,2,1
91389,6,1,319651,319651,319652,0,1,4
91390,6,2,319657,319657,319659,0,2,5
91391,6,1,319663,319663,319664,0,1,4
91392,3,3,319666,319666,319669,0,3,2
91393,2,2,319668,319669,319671,1,3,0
91394,4,2,319672,319672,319674,0,2,1
91395,5,3,319677,319677,319680,0,3,3
91396,4,2,319681,319681,319683,0,2,1
91397,4,1,319685,319685,319686,0,1,2
91398,5,3,319690,319690,319693,0,3,4
91399,4,2,319694,319694,319696,0,2,1
91400,3,1,319697,319697,319698,0,1,1
91401,1,1,319698,319698,319699,0,1,0
91402,4,1,319702,319702,319703,0,1,3
91403,3,1,319705,319705,319706,0,1,2
91404,3,2,319708,319708,319710,0,2,2
91405,1,1,319709,319710,319711,1,2,0
91406,4,2,319713,319713,319715,0,2,2
91407,4,3,319717,319717,319720,0,3,2
91408,1,1,319718,319720,319721,2,3,0
91409,4,1,319722,319722,319723,0,1,1
91410,2,3,319724,319724,319727,0,3,1
91411,3,2,319727,319727,319729,0,2,0
91412,6,2,319733,319733,319735,0,2,4
91413,2,2,319735,319735,319737,0,2,0
91414,6,1,319741,319741,319742,0,1,4
91415,3,2,319744,319744,319746,0,2,2
91416,5,2,319749,319749,319751,0,2,3
91417,2,1,319751,319751,319752,0,1,0
91418,6,1,319757,319757,319758,0,1,5
91419,5,1,319762,319762,319763,0,1,4
91420,5,2,319767,319767,319769,0,2,4
91421,2,2,319769,319769,319771,0,2,0
91422,5,1,319774,319774,319775,0,1,3
91423,6,3,319780,319780,319783,0,3,5
91424,5,2,319785,319785,319787,0,2,2
91425,2,2,319787,319787,319789,0,2,0
91426,6,2,319793,319793,319795,0,2,4
91427,2,3,319795,319795,319798,0,3,0
91428,4,3,319799,319799,319802,0,3,1
91429,4,3,319803,319803,319806,0,3,1
91430,3,2,319806,319806,319808,0,2,0
91431,1,1,319807,319808,319809,1,2,0
91432,2,3,319809,319809,319812,0,3,0
91433,6,1,319815,319815,319816,0,1,3
91434,4,1,319819,319819,319820,0,1,3
91435,2,3,319821,319821,319824,0,3,1
91436,2,2,319823,319824,319826,1,3,0
91437,3,2,319826,319826,319828,0,2,0
91438,2,1,319828,319828,319829,0,1,0
91439,6,1,319834,319834,319835,0,1,5
91440,1,2,319835,319835,319837,0,2,0
91441,6,3,319841,319841,319844,0,3,4
91442,2,1,319843,319844,319845,1,2,0
91443,1,2,319844,319845,319847,1,3,0
91444,3,3,319847,319847,319850,0,3,0
91445,6,3,319853,319853,319856,0,3,3
91446,6,3,319859,319859,319862,0,3,3
91447,6,3,319865,319865,319868,0,3,3
91448,6,1,319871,319871,319872,0,1,3
91449,6,2,319877,319877,319879,0,2,5
91450,1,2,319878,319879,319881,1,3,0
91451,6,1,319884,319884,319885,0,1,3
91452,5,3,319889,319889,319892,0,3,4
91453,1,1,319890,319892,319893,2,3,0
91454,6,1,319896,319896,319897,0,1,3
91455,4,1,319900,319900,319901,0,1,3
91456,4,2,319904,319904,319906,0,2,3
91457,6,3,319910,319910,319913,0,3,4
91458,3,2,319913,319913,319915,0,2,0
91459,6,2,319919,319919,319921,0,2,4
91460,6,2,319925,319925,319927,0,2,4
91461,4,3,319929,319929,319932,0,3,2
91462,3,3,319932,319932,319935,0,3,0
91463,5,2,319937,319937,319939,0,2,2
91464,3,1,319940,319940,319941,0,1,1
91465,3,1,319943,319943,319944,0,1,2
91466,2,1,319945,319945,319946,0,1,1
91467,6,2,319951,319951,319953,0,2,5
91468,3,3,319954,319954,319957,0,3,1
91469,5,2,319959,319959,319961,0,2,2
91470,4,2,319963,319963,319965,0,2,2
91471,6,3,319969,319969,319972,0,3,4
91472,4,1,319973,319973,319974,0,1,1
91473,6,3,319979,319979,319982,0,3,5
91474,1,3,319980,319982,319985,2,5,0
91475,3,2,319983,319985,319987,2,4,0
91476,1,1,319984,319987,319988,3,4,0
91477,5,1,319989,319989,319990,0,1,1
91478,3,2,319992,319992,319994,0,2,2
91479,5,1,319997,319997,319998,0,1,3
91480,2,1,319999,319999,320000,0,1,1
91481,6,2,320005,320005,320007,0,2,5
91482,3,3,320008,320008,320011,0,3,1
91483,3,3,320011,320011,320014,0,3,0
91484,2,1,320013,320014,320015,1,2,0
91485,3,3,320016,320016,320019,0,3,1
91486,3,2,320019,320019,320021,0,2,0
91487,3,3,320022,320022,320025,0,3,1
91488,2,3,320024,320025,320028,1,4,0
91489,3,2,320027,320028,320030,1,3,0
91490,4,1,320031,320031,320032,0,1,1
91491,6,3,320037,320037,320040,0,3,5
91492,4,3,320041,320041,320044,0,3,1
91493,1,2,320042,320044,320046,2,4,0
91494,1,3,320043,320046,320049,3,6,0
91495,3,2,320046,320049,320051,3,5,0
91496,5,1,320051,320051,320052,0,1,0
91497,2,2,320053,320053,320055,0,2,1
91498,5,2,320058,320058,320060,0,2,3
91499,6,2,320064,320064,320066,0,2,4
91500,6,3,320070,320070,320073,0,3,4
91501,1,3,320071,320073,320076,2,5,0
91502,1,1,320072,320076,320077,4,5,0
91503,3,3,320075,320077,320080,2,5,0
91504,3,3,320078,320080,320083,2,5,0
91505,5,1,320083,320083,320084,0,1,0
91506,3,2,320086,320086,320088,0,2,2
91507,4,3,320090,320090,320093,0,3,2
91508,6,3,320096,320096,320099,0,3,3
91509,2,3,320098,320099,320102,1,4,0
91510,4,2,320102,320102,320104,0,2,0
91511,4,3,320106,320106,320109,0,3,2
91512,5,1,320111,320111,320112,0,1,2
91513,5,2,320116,320116,320118,0,2,4
91514,1,3,320117,320118,320121,1,4,0
91515,2,3,320119,320121,320124,2,5,0
91516,4,2,320123,320124,320126,1,3,0
91517,4,1,320127,320127,320128,0,1,1
91518,1,3,320128,320128,320131,0,3,0
91519,1,1,320129,320131,320132,2,3,0
91520,5,3,320134,320134,320137,0,3,2
91521,2,1,320136,320137,320138,1,2,0
91522,2,2,320138,320138,320140,0,2,0
91523,5,3,320143,320143,320146,0,3,3
91524,1,3,320144,320146,320149,2,5,0
91525,4,2,320148,320149,320151,1,3,0
91526,6,3,320154,320154,320157,0,3,3
91527,6,1,320160,320160,320161,0,1,3
91528,4,2,320164,320164,320166,0,2,3
91529,2,3,320166,320166,320169,0,3,0
91530,2,2,320168,320169,320171,1,3,0
91531,1,3,320169,320171,320174,2,5,0
91532,2,1,320171,320174,320175,3,4,0
91533,5,3,320176,320176,320179,0,3,1
91534,2,3,320178,320179,320182,1,4,0
91535,1,1,320179,320182,320183,3,4,0
91536,1,1,320180,320183,320184,3,4,0
91537,1,1,320181,320184,320185,3,4,0
91538,6,2,320187,320187,320189,0,2,2
91539,1,3,320188,320189,320192,1,4,0
91540,2,1,320190,320192,320193,2,3,0
91541,2,1,320192,320193,320194,1,2,0
91542,3,3,320195,320195,320198,0,3,1
91543,1,2,320196,320198,320200,2,4,0
91544,6,3,320202,320202,320205,0,3,2
91545,3,2,320205,320205,320207,0,2,0
91546,3,1,320208,320208,320209,0,1,1
91547,3,1,320211,320211,320212,0,1,2
91548,2,3,320213,320213,320216,0,3,1
91549,1,3,320214,320216,320219,2,5,0
91550,6,3,320220,320220,320223,0,3,1
91551,4,2,320224,320224,320226,0,2,1
91552,5,2,320229,320229,320231,0,2,3
91553,3,1,320232,320232,320233,0,1,1
91554,5,2,320237,320237,320239,0,2,4
91555,2,1,320239,320239,320240,0,1,0
91556,5,2,320244,320244,320246,0,2,4
91557,2,3,320246,320246,320249,0,3,0
91558,2,3,320248,320249,320252,1,4,0
91559,5,1,320253,320253,320254,0,1,1
91560,6,2,320259,320259,320261,0,2,5
91561,3,1,320262,320262,320263,0,1,1
91562,5,3,320267,320267,320270,0,3,4
91563,6,1,320273,320273,320274,0,1,3
91564,6,1,320279,320279,320280,0,1,5
91565,1,3,320280,320280,320283,0,3,0
91566,4,2,320284,320284,320286,0,2,1
91567,5,3,320289,320289,320292,0,3,3
91568,1,1,320290,320292,320293,2,3,0
91569,3,1,320293,320293,320294,0,1,0
91570,3,1,320296,320296,320297,0,1,2
91571,5,3,320301,320301,320304,0,3,4
91572,2,1,320303,320304,320305,1,2,0
91573,5,1,320308,320308,320309,0,1,3
91574,2,1,320310,320310,320311,0,1,1
91575,6,1,320316,320316,320317,0,1,5
91576,5,3,320321,320321,320324,0,3,4
91577,2,3,320323,320324,320327,1,4,0
91578,4,1,320327,320327,320328,0,1,0
91579,3,2,320330,320330,320332,0,2,2
91580,3,3,320333,320333,320336,0,3,1
91581,3,1,320336,320336,320337,0,1,0
91582,2,3,320338,320338,320341,0,3,1
91583,6,3,320344,320344,320347,0,3,3
91584,6,3,320350,320350,320353,0,3,3
91585,4,1,320354,320354,320355,0,1,1
91586,6,2,320360,320360,320362,0,2,5
91587,1,1,320361,320362,320363,1,2,0
91588,6,2,320367,320367,320369,0,2,4
91589,4,2,320371,320371,320373,0,2,2
91590,4,3,320375,320375,320378,0,3,2
91591,4,1,320379,320379,320380,0,1,1
91592,3,2,320382,320382,320384,0,2,2
91593,1,3,320383,320384,320387,1,4,0
91594,1,1,320384,320387,320388,3,4,0
91595,5,3,320389,320389,320392,0,3,1
91596,1,2,320390,320392,320394,2,4,0
91597,2,3,320392,320394,320397,2,5,0
91598,5,2,320397,320397,320399,0,2,0
91599,2,3,320399,320399,320402,0,3,0
91600,4,1,320403,320403,320404,0,1,1
91601,3,3,320406,320406,320409,0,3,2
91602,3,1,320409,320409,320410,0,1,0
91603,6,2,320415,320415,320417,0,2,5
91604,4,2,320419,320419,320421,0,2,2
91605,4,3,320423,320423,320426,0,3,2
91606,6,2,320429,320429,320431,0,2,3
91607,5,1,320434,320434,320435,0,1,3
91608,5,3,320439,320439,320442,0,3,4
91609,6,1,320445,320445,320446,0,1,3
91610,5,1,320450,320450,320451,0,1,4
91611,1,2,320451,320451,320453,0,2,0
91612,1,3,320452,320453,320456,1,4,0
91613,3,2,320455,320456,320458,1,3,0
91614,2,3,320457,320458,320461,1,4,0
91615,2,1,320459,320461,320462,2,3,0
91616,3,1,320462,320462,320463,0,1,0
91617,3,2,320465,320465,320467,0,2,2
91618,2,1,320467,320467,320468,0,1,0
91619,2,3,320469,320469,320472,0,3,1
91620,4,1,320473,320473,320474,0,1,1
91621,5,1,320478,320478,320479,0,1,4
91622,5,1,320483,320483,320484,0,1,4
91623,2,2,320485,320485,320487,0,2,1
91624,3,2,320488,320488,320490,0,2,1
91625,6,1,320494,320494,320495,0,1,4
91626,3,3,320497,320497,320500,0,3,2
91627,1,3,320498,320500,320503,2,5,0
91628,5,1,320503,320503,320504,0,1,0
91629,1,1,320504,320504,320505,0,1,0
91630,4,1,320508,320508,320509,0,1,3
91631,3,1,320511,320511,320512,0,1,2
91632,6,1,320517,320517,320518,0,1,5
91633,1,1,320518,320518,320519,0,1,0
91634,6,1,320524,320524,320525,0,1,5
91635,3,2,320527,320527,320529,0,2,2
91636,1,3,320528,320529,320532,1,4,0
91637,4,1,320532,320532,320533,0,1,0
91638,5,3,320537,320537,320540,0,3,4
91639,4,2,320541,320541,320543,0,2,1
91640,2,1,320543,320543,320544,0,1,0
91641,3,3,320546,320546,320549,0,3,2
91642,1,1,320547,320549,320550,2,3,0
91643,5,3,320552,320552,320555,0,3,2
91644,4,2,320556,320556,320558,0,2,1
91645,3,3,320559,320559,320562,0,3,1
91646,1,3,320560,320562,320565,2,5,0
91647,6,1,320566,320566,320567,0,1,1
91648,1,3,320567,320567,320570,0,3,0
91649,4,1,320571,320571,320572,0,1,1
91650,3,1,320574,320574,320575,0,1,2
91651,5,3,320579,320579,320582,0,3,4
91652,6,2,320585,320585,320587,0,2,3
91653,3,3,320588,320588,320591,0,3,1
91654,3,2,320591,320591,320593,0,2,0
91655,3,2,320594,320594,320596,0,2,1
91656,1,2,320595,320596,320598,1,3,0
91657,2,3,320597,320598,320601,1,4,0
91658,2,2,320599,320601,320603,2,4,0
91659,4,1,320603,320603,320604,0,1,0
91660,4,1,320607,320607,320608,0,1,3
91661,6,3,320613,320613,320616,0,3,5
91662,2,1,320615,320616,320617,1,2,0
91663,1,1,320616,320617,320618,1,2,0
91664,2,3,320618,320618,320621,0,3,0
91665,6,1,320624,320624,320625,0,1,3
91666,1,1,320625,320625,320626,0,1,0
91667,4,3,320629,320629,320632,0,3,3
91668,5,3,320634,320634,320637,0,3,2
91669,5,1,320639,320639,320640,0,1,2
91670,1,3,320640,320640,320643,0,3,0
91671,4,1,320644,320644,320645,0,1,1
91672,3,1,320647,320647,320648,0,1,2
91673,1,2,320648,320648,320650,0,2,0
91674,2,2,320650,320650,320652,0,2,0
91675,5,3,320655,320655,320658,0,3,3
91676,2,1,320657,320658,320659,1,2,0
91677,3,3,320660,320660,320663,0,3,1
91678,4,3,320664,320664,320667,0,3,1
91679,4,2,320668,320668,320670,0,2,1
91680,3,2,320671,320671,320673,0,2,1
91681,3,1,320674,320674,320675,0,1,1
91682,2,1,320676,320676,320677,0,1,1
91683,3,2,320679,320679,320681,0,2,2
91684,3,3,320682,320682,320685,0,3,1
91685,1,3,320683,320685,320688,2,5,0
91686,2,3,320685,320688,320691,3,6,0
91687,4,2,320689,320691,320693,2,4,0
91688,5,1,320694,320694,320695,0,1,1
91689,3,2,320697,320697,320699,0,2,2
91690,6,3,320703,320703,320706,0,3,4
91691,4,3,320707,320707,320710,0,3,1
91692,2,2,320709,320710,320712,1,3,0
91693,6,3,320715,320715,320718,0,3,3
91694,1,2,320716,320718,320720,2,4,0
91695,6,1,320722,320722,320723,0,1,2
91696,4,1,320726,320726,320727,0,1,3
91697,3,3,320729,320729,320732,0,3,2
91698,3,2,320732,320732,320734,0,2,0
91699,5,1,320737,320737,320738,0,1,3
91700,1,1,320738,320738,320739,0,1,0
91701,6,2,320744,320744,320746,0,2,5
91702,6,3,320750,320750,320753,0,3,4
91703,6,2,320756,320756,320758,0,2,3
91704,4,3,320760,320760,320763,0,3,2
91705,2,1,320762,320763,320764,1,2,0
91706,6,1,320768,320768,320769,0,1,4
91707,1,1,320769,320769,320770,0,1,0
91708,1,1,320770,320770,320771,0,1,0
91709,6,1,320776,320776,320777,0,1,5
91710,4,2,320780,320780,320782,0,2,3
91711,3,1,320783,320783,320784,0,1,1
91712,6,1,320789,320789,320790,0,1,5
91713,4,3,320793,320793,320796,0,3,3
91714,6,1,320799,320799,320800,0,1,3
91715,5,2,320804,320804,320806,0,2,4
91716,2,3,320806,320806,320809,0,3,0
91717,6,3,320812,320812,320815,0,3,3
91718,5,2,320817,320817,320819,0,2,2
91719,3,1,320820,320820,320821,0,1,1
91720,1,1,320821,320821,320822,0,1,0
91721,3,2,320824,320824,320826,0,2,2
91722,2,2,320826,320826,320828,0,2,0
91723,3,3,320829,320829,320832,0,3,1
91724,6,2,320835,320835,320837,0,2,3
91725,3,1,320838,320838,320839,0,1,1
91726,3,3,320841,320841,320844,0,3,2
91727,4,2,320845,320845,320847,0,2,1
91728,1,1,320846,320847,320848,1,2,0
91729,2,3,320848,320848,320851,0,3,0
91730,4,1,320852,320852,320853,0,1,1
91731,6,2,320858,320858,320860,0,2,5
91732,1,3,320859,320860,320863,1,4,0
91733,4,2,320863,320863,320865,0,2,0
91734,3,1,320866,320866,320867,0,1,1
91735,1,3,320867,320867,320870,0,3,0
91736,5,1,320872,320872,320873,0,1,2
91737,3,1,320875,320875,320876,0,1,2
91738,4,2,320879,320879,320881,0,2,3
91739,4,2,320883,320883,320885,0,2,2
91740,5,3,320888,320888,320891,0,3,3
91741,4,2,320892,320892,320894,0,2,1
91742,5,3,320897,320897,320900,0,3,3
91743,1,3,320898,320900,320903,2,5,0
91744,3,2,320901,320903,320905,2,4,0
91745,6,3,320907,320907,320910,0,3,2
91746,2,1,320909,320910,320911,1,2,0
91747,6,1,320915,320915,320916,0,1,4
91748,6,1,320921,320921,320922,0,1,5
91749,3,2,320924,320924,320926,0,2,2
91750,2,3,320926,320926,320929,0,3,0
91751,4,1,320930,320930,320931,0,1,1
91752,5,3,320935,320935,320938,0,3,4
91753,4,3,320939,320939,320942,0,3,1
91754,4,2,320943,320943,320945,0,2,1
91755,3,2,320946,320946,320948,0,2,1
91756,2,1,320948,320948,320949,0,1,0
91757,1,2,320949,320949,320951,0,2,0
91758,2,3,320951,320951,320954,0,3,0
91759,4,2,320955,320955,320957,0,2,1
91760,1,3,320956,320957,320960,1,4,0
91761,4,1,320960,320960,320961,0,1,0
91762,2,3,320962,320962,320965,0,3,1
91763,5,1,320967,320967,320968,0,1,2
91764,3,1,320970,320970,320971,0,1,2
91765,3,3,320973,320973,320976,0,3,2
91766,4,2,320977,320977,320979,0,2,1
91767,5,2,320982,320982,320984,0,2,3
91768,1,1,320983,320984,320985,1,2,0
91769,4,2,320987,320987,320989,0,2,2
91770,5,3,320992,320992,320995,0,3,3
91771,2,3,320994,320995,320998,1,4,0
91772,2,2,320996,320998,321000,2,4,0
91773,6,1,321002,321002,321003,0,1,2
91774,2,1,321004,321004,321005,0,1,1
91775,5,3,321009,321009,321012,0,3,4
91776,5,2,321014,321014,321016,0,2,2
91777,5,3,321019,321019,321022,0,3,3
91778,6,1,321025,321025,321026,0,1,3
91779,5,1,321030,321030,321031,0,1,4
91780,2,1,321032,321032,321033,0,1,1
91781,4,2,321036,321036,321038,0,2,3
91782,3,3,321039,321039,321042,0,3,1
91783,2,2,321041,321042,321044,1,3,0
91784,1,3,321042,321044,321047,2,5,0
91785,6,1,321048,321048,321049,0,1,1
91786,1,3,321049,321049,321052,0,3,0
91787,1,3,321050,321052,321055,2,5,0
91788,6,2,321056,321056,321058,0,2,1
91789,3,1,321059,321059,321060,0,1,1
91790,1,3,321060,321060,321063,0,3,0
91791,1,2,321061,321063,321065,2,4,0
91792,2,3,321063,321065,321068,2,5,0
91793,2,2,321065,321068,321070,3,5,0
91794,5,2,321070,321070,321072,0,2,0
91795,2,3,321072,321072,321075,0,3,0
91796,4,1,321076,321076,321077,0,1,1
91797,2,3,321078,321078,321081,0,3,1
91798,4,3,321082,321082,321085,0,3,1
91799,1,3,321083,321085,321088,2,5,0
91800,2,2,321085,321088,321090,3,5,0
91801,5,2,321090,321090,321092,0,2,0
91802,1,3,321091,321092,321095,1,4,0
91803,2,1,321093,321095,321096,2,3,0
91804,4,1,321097,321097,321098,0,1,1
91805,2,3,321099,321099,321102,0,3,1
91806,4,1,321103,321103,321104,0,1,1
91807,6,3,321109,321109,321112,0,3,5
91808,5,1,321114,321114,321115,0,1,2
91809,5,1,321119,321119,321120,0,1,4
91810,5,2,321124,321124,321126,0,2,4
91811,6,3,321130,321130,321133,0,3,4
91812,4,2,321134,321134,321136,0,2,1
91813,6,1,321140,321140,321141,0,1,4
91814,5,2,321145,321145,321147,0,2,4
91815,2,3,321147,321147,321150,0,3,0
91816,4,1,321151,321151,321152,0,1,1
91817,3,3,321154,321154,321157,0,3,2
91818,4,2,321158,321158,321160,0,2,1
91819,5,1,321163,321163,321164,0,1,3
91820,5,3,321168,321168,321171,0,3,4
91821,2,1,321170,321171,321172,1,2,0
91822,4,1,321174,321174,321175,0,1,2
91823,1,1,321175,321175,321176,0,1,0
91824,3,2,321178,321178,321180,0,2,2
91825,5,1,321183,321183,321184,0,1,3
91826,3,2,321186,321186,321188,0,2,2
91827,6,2,321192,321192,321194,0,2,4
91828,1,2,321193,321194,321196,1,3,0
91829,1,2,321194,321196,321198,2,4,0
91830,5,3,321199,321199,321202,0,3,1
91831,6,2,321205,321205,321207,0,2,3
91832,3,1,321208,321208,321209,0,1,1
91833,4,1,321212,321212,321213,0,1,3
91834,6,1,321218,321218,321219,0,1,5
91835,3,1,321221,321221,321222,0,1,2
91836,4,2,321225,321225,321227,0,2,3
91837,6,2,321231,321231,321233,0,2,4
91838,6,2,321237,321237,321239,0,2,4
91839,2,1,321239,321239,321240,0,1,0
91840,4,3,321243,321243,321246,0,3,3
91841,4,3,321247,321247,321250,0,3,1
91842,1,3,321248,321250,321253,2,5,0
91843,6,2,321254,321254,321256,0,2,1
91844,1,2,321255,321256,321258,1,3,0
91845,2,3,321257,321258,321261,1,4,0
91846,2,1,321259,321261,321262,2,3,0
91847,2,2,321261,321262,321264,1,3,0
91848,3,1,321264,321264,321265,0,1,0
91849,4,2,321268,321268,321270,0,2,3
91850,3,1,321271,321271,321272,0,1,1
91851,2,1,321273,321273,321274,0,1,1
91852,3,3,321276,321276,321279,0,3,2
91853,2,1,321278,321279,321280,1,2,0
91854,3,1,321281,321281,321282,0,1,1
91855,1,1,321282,321282,321283,0,1,0
91856,1,3,321283,321283,321286,0,3,0
91857,5,2,321288,321288,321290,0,2,2
91858,6,2,321294,321294,321296,0,2,4
91859,5,1,321299,321299,321300,0,1,3
91860,1,1,321300,321300,321301,0,1,0
91861,5,2,321305,321305,321307,0,2,4
91862,1,3,321306,321307,321310,1,4,0
91863,1,2,321307,321310,321312,3,5,0
91864,2,1,321309,321312,321313,3,4,0
91865,2,2,321311,321313,321315,2,4,0
91866,6,3,321317,321317,321320,0,3,2
91867,1,1,321318,321320,321321,2,3,0
91868,5,3,321323,321323,321326,0,3,2
91869,2,2,321325,321326,321328,1,3,0
91870,3,2,321328,321328,321330,0,2,0
91871,5,1,321333,321333,321334,0,1,3
91872,2,1,321335,321335,321336,0,1,1
91873,1,1,321336,321336,321337,0,1,0
91874,6,2,321342,321342,321344,0,2,5
91875,6,2,321348,321348,321350,0,2,4
91876,6,2,321354,321354,321356,0,2,4
91877,3,3,321357,321357,321360,0,3,1
91878,5,2,321362,321362,321364,0,2,2
91879,2,2,321364,321364,321366,0,2,0
91880,6,1,321370,321370,321371,0,1,4
91881,5,3,321375,321375,321378,0,3,4
91882,6,2,321381,321381,321383,0,2,3
91883,3,2,321384,321384,321386,0,2,1
91884,1,3,321385,321386,321389,1,4,0
91885,6,3,321391,321391,321394,0,3,2
91886,2,3,321393,321394,321397,1,4,0
91887,6,2,321399,321399,321401,0,2,2
91888,4,3,321403,321403,321406,0,3,2
91889,1,2,321404,321406,321408,2,4,0
91890,1,1,321405,321408,321409,3,4,0
91891,1,3,321406,321409,321412,3,6,0
91892,1,3,321407,321412,321415,5,8,0
91893,5,3,321412,321415,321418,3,6,0
91894,1,1,321413,321418,321419,5,6,0
91895,3,1,321416,321419,321420,3,4,0
91896,5,3,321421,321421,321424,0,3,1
91897,3,2,321424,321424,321426,0,2,0
91898,2,3,321426,321426,321429,0,3,0
91899,6,1,321432,321432,321433,0,1,3
91900,4,3,321436,321436,321439,0,3,3
91901,6,1,321442,321442,321443,0,1,3
91902,1,2,321443,321443,321445,0,2,0
91903,4,2,321447,321447,321449,0,2,2
91904,3,1,321450,321450,321451,0,1,1
91905,4,2,321454,321454,321456,0,2,3
91906,5,2,321459,321459,321461,0,2,3
91907,3,3,321462,321462,321465,0,3,1
91908,3,1,321465,321465,321466,0,1,0
91909,1,1,321466,321466,321467,0,1,0
91910,2,2,321468,321468,321470,0,2,1
91911,4,1,321472,321472,321473,0,1,2
91912,3,3,321475,321475,321478,0,3,2
91913,6,1,321481,321481,321482,0,1,3
91914,3,3,321484,321484,321487,0,3,2
91915,1,2,321485,321487,321489,2,4,0
91916,6,1,321491,321491,321492,0,1,2
91917,1,1,321492,321492,321493,0,1,0
91918,6,1,321498,321498,321499,0,1,5
91919,6,1,321504,321504,321505,0,1,5
91920,4,3,321508,321508,321511,0,3,3
91921,4,3,321512,321512,321515,0,3,1
91922,6,1,321518,321518,321519,0,1,3
91923,2,3,321520,321520,321523,0,3,1
91924,2,1,321522,321523,321524,1,2,0
91925,2,1,321524,321524,321525,0,1,0
91926,6,3,321530,321530,321533,0,3,5
91927,5,3,321535,321535,321538,0,3,2
91928,1,1,321536,321538,321539,2,3,0
91929,2,1,321538,321539,321540,1,2,0
91930,3,3,321541,321541,321544,0,3,1
91931,5,1,321546,321546,321547,0,1,2
91932,6,1,321552,321552,321553,0,1,5
91933,4,3,321556,321556,321559,0,3,3
91934,3,3,321559,321559,321562,0,3,0
91935,2,3,321561,321562,321565,1,4,0
91936,2,3,321563,321565,321568,2,5,0
91937,4,1,321567,321568,321569,1,2,0
91938,5,1,321572,321572,321573,0,1,3
91939,3,1,321575,321575,321576,0,1,2
91940,5,2,321580,321580,321582,0,2,4
91941,4,1,321584,321584,321585,0,1,2
91942,5,1,321589,321589,321590,0,1,4
91943,1,2,321590,321590,321592,0,2,0
91944,6,2,321596,321596,321598,0,2,4
91945,6,2,321602,321602,321604,0,2,4
91946,5,1,321607,321607,321608,0,1,3
91947,1,3,321608,321608,321611,0,3,0
91948,6,3,321614,321614,321617,0,3,3
91949,1,3,321615,321617,321620,2,5,0
91950,4,1,321619,321620,321621,1,2,0
91951,5,3,321624,321624,321627,0,3,3
91952,4,1,321628,321628,321629,0,1,1
91953,4,2,321632,321632,321634,0,2,3
91954,2,3,321634,321634,321637,0,3,0
91955,4,3,321638,321638,321641,0,3,1
91956,4,3,321642,321642,321645,0,3,1
91957,6,1,321648,321648,321649,0,1,3
91958,1,1,321649,321649,321650,0,1,0
91959,2,2,321651,321651,321653,0,2,1
91960,4,3,321655,321655,321658,0,3,2
91961,3,1,321658,321658,321659,0,1,0
91962,3,1,321661,321661,321662,0,1,2
91963,2,3,321663,321663,321666,0,3,1
91964,3,2,321666,321666,321668,0,2,0
91965,6,2,321672,321672,321674,0,2,4
91966,6,3,321678,321678,321681,0,3,4
91967,5,2,321683,321683,321685,0,2,2
91968,5,1,321688,321688,321689,0,1,3
91969,2,1,321690,321690,321691,0,1,1
91970,1,3,321691,321691,321694,0,3,0
91971,5,3,321696,321696,321699,0,3,2
91972,1,1,321697,321699,321700,2,3,0
91973,6,1,321703,321703,321704,0,1,3
91974,2,2,321705,321705,321707,0,2,1
91975,5,1,321710,321710,321711,0,1,3
91976,4,2,321714,321714,321716,0,2,3
91977,5,1,321719,321719,321720,0,1,3
91978,4,3,321723,321723,321726,0,3,3
91979,3,2,321726,321726,321728,0,2,0
91980,2,3,321728,321728,321731,0,3,0
91981,1,3,321729,321731,321734,2,5,0
91982,4,3,321733,321734,321737,1,4,0
91983,1,3,321734,321737,321740,3,6,0
91984,6,3,321740,321740,321743,0,3,0
91985,3,2,321743,321743,321745,0,2,0
91986,4,1,321747,321747,321748,0,1,2
91987,6,3,321753,321753,321756,0,3,5
91988,1,1,321754,321756,321757,2,3,0
91989,3,1,321757,321757,321758,0,1,0
91990,4,2,321761,321761,321763,0,2,3
91991,2,1,321763,321763,321764,0,1,0
91992,2,2,321765,321765,321767,0,2,1
91993,1,2,321766,321767,321769,1,3,0
91994,4,3,321770,321770,321773,0,3,1
91995,4,1,321774,321774,321775,0,1,1
91996,3,2,321777,321777,321779,0,2,2
91997,4,2,321781,321781,321783,0,2,2
91998,5,3,321786,321786,321789,0,3,3
91999,6,2,321792,321792,321794,0,2,3
92000,5,1,321797,321797,321798,0,1,3
92001,2,3,321799,321799,321802,0,3,1
92002,2,2,321801,321802,321804,1,3,0
92003,4,1,321805,321805,321806,0,1,1
92004,1,1,321806,321806,321807,0,1,0
92005,3,2,321809,321809,321811,0,2,2
92006,4,3,321813,321813,321816,0,3,2
92007,5,1,321818,321818,321819,0,1,2
92008,2,1,321820,321820,321821,0,1,1
92009,4,3,321824,321824,321827,0,3,3
92010,6,3,321830,321830,321833,0,3,3
92011,5,3,321835,321835,321838,0,3,2
92012,6,2,321841,321841,321843,0,2,3
92013,2,1,321843,321843,321844,0,1,0
92014,5,3,321848,321848,321851,0,3,4
92015,5,3,321853,321853,321856,0,3,2
92016,6,3,321859,321859,321862,0,3,3
92017,3,1,321862,321862,321863,0,1,0
92018,3,2,321865,321865,321867,0,2,2
92019,6,1,321871,321871,321872,0,1,4
92020,3,1,321874,321874,321875,0,1,2
92021,2,3,321876,321876,321879,0,3,1
92022,3,1,321879,321879,321880,0,1,0
92023,1,3,321880,321880,321883,0,3,0
92024,3,1,321883,321883,321884,0,1,0
92025,2,2,321885,321885,321887,0,2,1
92026,5,2,321890,321890,321892,0,2,3
92027,4,2,321894,321894,321896,0,2,2
92028,2,1,321896,321896,321897,0,1,0
92029,1,1,321897,321897,321898,0,1,0
92030,2,3,321899,321899,321902,0,3,1
92031,1,1,321900,321902,321903,2,3,0
92032,2,2,321902,321903,321905,1,3,0
92033,5,2,321907,321907,321909,0,2,2
92034,4,1,321911,321911,321912,0,1,2
92035,4,3,321915,321915,321918,0,3,3
92036,2,3,321917,321918,321921,1,4,0
92037,6,2,321923,321923,321925,0,2,2
92038,4,2,321927,321927,321929,0,2,2
92039,6,1,321933,321933,321934,0,1,4
92040,5,1,321938,321938,321939,0,1,4
92041,4,2,321942,321942,321944,0,2,3
92042,1,3,321943,321944,321947,1,4,0
92043,3,1,321946,321947,321948,1,2,0
92044,3,2,321949,321949,321951,0,2,1
92045,1,2,321950,321951,321953,1,3,0
92046,6,1,321956,321956,321957,0,1,3
92047,4,2,321960,321960,321962,0,2,3
92048,4,1,321964,321964,321965,0,1,2
92049,3,3,321967,321967,321970,0,3,2
92050,2,2,321969,321970,321972,1,3,0
92051,5,2,321974,321974,321976,0,2,2
92052,5,1,321979,321979,321980,0,1,3
92053,6,2,321985,321985,321987,0,2,5
92054,5,3,321990,321990,321993,0,3,3
92055,1,3,321991,321993,321996,2,5,0
92056,2,2,321993,321996,321998,3,5,0
92057,5,2,321998,321998,322000,0,2,0
92058,1,2,321999,322000,322002,1,3,0
92059,4,3,322003,322003,322006,0,3,1
92060,1,2,322004,322006,322008,2,4,0
92061,6,1,322010,322010,322011,0,1,2
92062,1,1,322011,322011,322012,0,1,0
92063,3,1,322014,322014,322015,0,1,2
92064,4,3,322018,322018,322021,0,3,3
92065,4,3,322022,322022,322025,0,3,1
92066,3,1,322025,322025,322026,0,1,0
92067,4,2,322029,322029,322031,0,2,3
92068,4,2,322033,322033,322035,0,2,2
92069,1,2,322034,322035,322037,1,3,0
92070,1,2,322035,322037,322039,2,4,0
92071,3,3,322038,322039,322042,1,4,0
92072,5,2,322043,322043,322045,0,2,1
92073,2,3,322045,322045,322048,0,3,0
92074,2,2,322047,322048,322050,1,3,0
92075,5,3,322052,322052,322055,0,3,2
92076,5,1,322057,322057,322058,0,1,2
92077,1,2,322058,322058,322060,0,2,0
92078,6,2,322064,322064,322066,0,2,4
92079,1,1,322065,322066,322067,1,2,0
92080,2,3,322067,322067,322070,0,3,0
92081,2,1,322069,322070,322071,1,2,0
92082,2,3,322071,322071,322074,0,3,0
92083,1,2,322072,322074,322076,2,4,0
92084,1,2,322073,322076,322078,3,5,0
92085,1,3,322074,322078,322081,4,7,0
92086,4,2,322078,322081,322083,3,5,0
92087,6,2,322084,322084,322086,0,2,1
92088,4,1,322088,322088,322089,0,1,2
92089,4,2,322092,322092,322094,0,2,3
92090,2,3,322094,322094,322097,0,3,0
92091,5,1,322099,322099,322100,0,1,2
92092,6,1,322105,322105,322106,0,1,5
92093,4,2,322109,322109,322111,0,2,3
92094,1,2,322110,322111,322113,1,3,0
92095,5,2,322115,322115,322117,0,2,2
92096,2,2,322117,322117,322119,0,2,0
92097,4,3,322121,322121,322124,0,3,2
92098,6,3,322127,322127,322130,0,3,3
92099,2,2,322129,322130,322132,1,3,0
92100,5,3,322134,322134,322137,0,3,2
92101,5,2,322139,322139,322141,0,2,2
92102,2,3,322141,322141,322144,0,3,0
92103,6,3,322147,322147,322150,0,3,3
92104,6,2,322153,322153,322155,0,2,3
92105,4,3,322157,322157,322160,0,3,2
92106,5,1,322162,322162,322163,0,1,2
92107,5,3,322167,322167,322170,0,3,4
92108,6,1,322173,322173,322174,0,1,3
92109,2,3,322175,322175,322178,0,3,1
92110,3,2,322178,322178,322180,0,2,0
92111,5,2,322183,322183,322185,0,2,3
92112,5,2,322188,322188,322190,0,2,3
92113,1,2,322189,322190,322192,1,3,0
92114,3,3,322192,322192,322195,0,3,0
92115,3,3,322195,322195,322198,0,3,0
92116,1,2,322196,322198,322200,2,4,0
92117,4,3,322200,322200,322203,0,3,0
92118,3,3,322203,322203,322206,0,3,0
92119,3,1,322206,322206,322207,0,1,0
92120,5,2,322211,322211,322213,0,2,4
92121,1,3,322212,322213,322216,1,4,0
92122,1,2,322213,322216,322218,3,5,0
92123,2,2,322215,322218,322220,3,5,0
92124,6,3,322221,322221,322224,0,3,1
92125,3,1,322224,322224,322225,0,1,0
92126,2,2,322226,322226,322228,0,2,1
92127,6,1,322232,322232,322233,0,1,4
92128,1,1,322233,322233,322234,0,1,0
92129,1,2,322234,322234,322236,0,2,0
92130,6,1,322240,322240,322241,0,1,4
92131,3,2,322243,322243,322245,0,2,2
92132,5,3,322248,322248,322251,0,3,3
92133,6,3,322254,322254,322257,0,3,3
92134,5,3,322259,322259,322262,0,3,2
92135,1,2,322260,322262,322264,2,4,0
92136,5,2,322265,322265,322267,0,2,1
92137,2,2,322267,322267,322269,0,2,0
92138,2,1,322269,322269,322270,0,1,0
92139,3,2,322272,322272,322274,0,2,2
92140,3,3,322275,322275,322278,0,3,1
92141,3,3,322278,322278,322281,0,3,0
92142,3,2,322281,322281,322283,0,2,0
92143,6,3,322287,322287,322290,0,3,4
92144,5,2,322292,322292,322294,0,2,2
92145,5,3,322297,322297,322300,0,3,3
92146,5,3,322302,322302,322305,0,3,2
92147,2,2,322304,322305,322307,1,3,0
92148,5,2,322309,322309,322311,0,2,2
92149,6,1,322315,322315,322316,0,1,4
92150,2,1,322317,322317,322318,0,1,1
92151,4,3,322321,322321,322324,0,3,3
92152,2,3,322323,322324,322327,1,4,0
92153,5,2,322328,322328,322330,0,2,1
92154,1,2,322329,322330,322332,1,3,0
92155,1,2,322330,322332,322334,2,4,0
92156,4,2,322334,322334,322336,0,2,0
92157,6,3,322340,322340,322343,0,3,4
92158,2,2,322342,322343,322345,1,3,0
92159,5,3,322347,322347,322350,0,3,2
92160,5,1,322352,322352,322353,0,1,2
92161,5,3,322357,322357,322360,0,3,4
92162,2,3,322359,322360,322363,1,4,0
92163,5,3,322364,322364,322367,0,3,1
92164,3,3,322367,322367,322370,0,3,0
92165,3,1,322370,322370,322371,0,1,0
92166,4,1,322374,322374,322375,0,1,3
92167,2,2,322376,322376,322378,0,2,1
92168,4,3,322380,322380,322383,0,3,2
92169,1,3,322381,322383,322386,2,5,0
92170,5,2,322386,322386,322388,0,2,0
92171,2,1,322388,322388,322389,0,1,0
92172,5,1,322393,322393,322394,0,1,4
92173,5,2,322398,322398,322400,0,2,4
92174,5,3,322403,322403,322406,0,3,3
92175,1,1,322404,322406,322407,2,3,0
92176,5,1,322409,322409,322410,0,1,2
92177,3,2,322412,322412,322414,0,2,2
92178,4,1,322416,322416,322417,0,1,2
92179,2,2,322418,322418,322420,0,2,1
92180,4,2,322422,322422,322424,0,2,2
92181,5,1,322427,322427,322428,0,1,3
92182,6,3,322433,322433,322436,0,3,5
92183,2,1,322435,322436,322437,1,2,0
92184,5,3,322440,322440,322443,0,3,3
92185,3,1,322443,322443,322444,0,1,0
92186,6,3,322449,322449,322452,0,3,5
92187,1,3,322450,322452,322455,2,5,0
92188,4,1,322454,322455,322456,1,2,0
92189,1,1,322455,322456,322457,1,2,0
92190,5,3,322460,322460,322463,0,3,3
92191,6,3,322466,322466,322469,0,3,3
92192,3,3,322469,322469,322472,0,3,0
92193,2,1,322471,322472,322473,1,2,0
92194,2,1,322473,322473,322474,0,1,0
92195,3,2,322476,322476,322478,0,2,2
92196,5,1,322481,322481,322482,0,1,3
92197,1,3,322482,322482,322485,0,3,0
92198,1,2,322483,322485,322487,2,4,0
92199,1,3,322484,322487,322490,3,6,0
92200,6,1,322490,322490,322491,0,1,0
92201,5,3,322495,322495,322498,0,3,4
92202,3,3,322498,322498,322501,0,3,0
92203,2,1,322500,322501,322502,1,2,0
92204,5,3,322505,322505,322508,0,3,3
92205,5,1,322510,322510,322511,0,1,2
92206,5,2,322515,322515,322517,0,2,4
92207,6,3,322521,322521,322524,0,3,4
92208,5,2,322526,322526,322528,0,2,2
92209,1,3,322527,322528,322531,1,4,0
92210,2,2,322529,322531,322533,2,4,0
92211,3,3,322532,322533,322536,1,4,0
92212,5,3,322537,322537,322540,0,3,1
92213,1,2,322538,322540,322542,2,4,0
92214,2,2,322540,322542,322544,2,4,0
92215,4,2,322544,322544,322546,0,2,0
92216,4,3,322548,322548,322551,0,3,2
92217,5,2,322553,322553,322555,0,2,2
92218,2,3,322555,322555,322558,0,3,0
92219,1,2,322556,322558,322560,2,4,0
92220,5,2,322561,322561,322563,0,2,1
92221,5,2,322566,322566,322568,0,2,3
92222,6,2,322572,322572,322574,0,2,4
92223,5,3,322577,322577,322580,0,3,3
92224,2,2,322579,322580,322582,1,3,0
92225,3,2,322582,322582,322584,0,2,0
92226,1,3,322583,322584,322587,1,4,0
92227,2,2,322585,322587,322589,2,4,0
92228,4,1,322589,322589,322590,0,1,0
92229,4,2,322593,322593,322595,0,2,3
92230,4,3,322597,322597,322600,0,3,2
92231,4,3,322601,322601,322604,0,3,1
92232,4,1,322605,322605,322606,0,1,1
92233,3,2,322608,322608,322610,0,2,2
92234,2,1,322610,322610,322611,0,1,0
92235,5,3,322615,322615,322618,0,3,4
92236,2,1,322617,322618,322619,1,2,0
92237,4,3,322621,322621,322624,0,3,2
92238,3,3,322624,322624,322627,0,3,0
92239,3,1,322627,322627,322628,0,1,0
92240,2,1,322629,322629,322630,0,1,1
92241,6,3,322635,322635,322638,0,3,5
92242,5,1,322640,322640,322641,0,1,2
92243,3,1,322643,322643,322644,0,1,2
92244,4,3,322647,322647,322650,0,3,3
92245,4,2,322651,322651,322653,0,2,1
92246,2,2,322653,322653,322655,0,2,0
92247,6,3,322659,322659,322662,0,3,4
92248,6,2,322665,322665,322667,0,2,3
92249,4,3,322669,322669,322672,0,3,2
92250,3,2,322672,322672,322674,0,2,0
92251,3,3,322675,322675,322678,0,3,1
92252,5,1,322680,322680,322681,0,1,2
92253,6,2,322686,322686,322688,0,2,5
92254,2,3,322688,322688,322691,0,3,0
92255,1,1,322689,322691,322692,2,3,0
92256,3,3,322692,322692,322695,0,3,0
92257,2,2,322694,322695,322697,1,3,0
92258,5,2,322699,322699,322701,0,2,2
92259,6,1,322705,322705,322706,0,1,4
92260,5,1,322710,322710,322711,0,1,4
92261,2,2,322712,322712,322714,0,2,1
92262,6,2,322718,322718,322720,0,2,4
92263,1,1,322719,322720,322721,1,2,0
92264,1,1,322720,322721,322722,1,2,0
92265,4,3,322724,322724,322727,0,3,2
92266,3,2,322727,322727,322729,0,2,0
92267,2,1,322729,322729,322730,0,1,0
92268,2,1,322731,322731,322732,0,1,1
92269,3,1,322734,322734,322735,0,1,2
92270,5,3,322739,322739,322742,0,3,4
92271,4,1,322743,322743,322744,0,1,1
92272,6,3,322749,322749,322752,0,3,5
92273,5,1,322754,322754,322755,0,1,2
92274,4,3,322758,322758,322761,0,3,3
92275,2,1,322760,322761,322762,1,2,0
92276,3,3,322763,322763,322766,0,3,1
92277,1,2,322764,322766,322768,2,4,0
92278,5,2,322769,322769,322771,0,2,1
92279,6,1,322775,322775,322776,0,1,4
92280,6,3,322781,322781,322784,0,3,5
92281,5,1,322786,322786,322787,0,1,2
92282,2,3,322788,322788,322791,0,3,1
92283,1,1,322789,322791,322792,2,3,0
92284,2,2,322791,322792,322794,1,3,0
92285,1,2,322792,322794,322796,2,4,0
92286,5,2,322797,322797,322799,0,2,1
92287,4,1,322801,322801,322802,0,1,2
92288,1,2,322802,322802,322804,0,2,0
92289,6,1,322808,322808,322809,0,1,4
92290,6,2,322814,322814,322816,0,2,5
92291,1,3,322815,322816,322819,1,4,0
92292,5,1,322820,322820,322821,0,1,1
92293,1,1,322821,322821,322822,0,1,0
92294,3,1,322824,322824,322825,0,1,2
92295,3,3,322827,322827,322830,0,3,2
92296,4,3,322831,322831,322834,0,3,1
92297,5,1,322836,322836,322837,0,1,2
92298,1,2,322837,322837,322839,0,2,0
92299,6,2,322843,322843,322845,0,2,4
92300,1,1,322844,322845,322846,1,2,0
92301,1,3,322845,322846,322849,1,4,0
92302,5,3,322850,322850,322853,0,3,1
92303,5,2,322855,322855,322857,0,2,2
92304,6,2,322861,322861,322863,0,2,4
92305,3,2,322864,322864,322866,0,2,1
92306,6,1,322870,322870,322871,0,1,4
92307,2,1,322872,322872,322873,0,1,1
92308,3,1,322875,322875,322876,0,1,2
92309,2,3,322877,322877,322880,0,3,1
92310,5,2,322882,322882,322884,0,2,2
92311,2,3,322884,322884,322887,0,3,0
92312,6,2,322890,322890,322892,0,2,3
92313,3,1,322893,322893,322894,0,1,1
92314,3,1,322896,322896,322897,0,1,2
92315,4,2,322900,322900,322902,0,2,3
92316,3,1,322903,322903,322904,0,1,1
92317,5,1,322908,322908,322909,0,1,4
92318,1,2,322909,322909,322911,0,2,0
92319,5,3,322914,322914,322917,0,3,3
92320,3,1,322917,322917,322918,0,1,0
92321,5,1,322922,322922,322923,0,1,4
92322,3,2,322925,322925,322927,0,2,2
92323,5,3,322930,322930,322933,0,3,3
92324,1,2,322931,322933,322935,2,4,0
92325,3,1,322934,322935,322936,1,2,0
92326,3,1,322937,322937,322938,0,1,1
92327,4,2,322941,322941,322943,0,2,3
92328,5,3,322946,322946,322949,0,3,3
92329,3,1,322949,322949,322950,0,1,0
92330,4,3,322953,322953,322956,0,3,3
92331,2,3,322955,322956,322959,1,4,0
92332,5,3,322960,322960,322963,0,3,1
92333,6,1,322966,322966,322967,0,1,3
92334,2,1,322968,322968,322969,0,1,1
92335,1,3,322969,322969,322972,0,3,0
92336,5,3,322974,322974,322977,0,3,2
92337,4,1,322978,322978,322979,0,1,1
92338,3,2,322981,322981,322983,0,2,2
92339,2,2,322983,322983,322985,0,2,0
92340,2,1,322985,322985,322986,0,1,0
92341,3,3,322988,322988,322991,0,3,2
92342,6,1,322994,322994,322995,0,1,3
92343,2,1,322996,322996,322997,0,1,1
92344,5,3,323001,323001,323004,0,3,4
92345,1,3,323002,323004,323007,2,5,0
92346,3,1,323005,323007,323008,2,3,0
92347,5,3,323010,323010,323013,0,3,2
92348,5,1,323015,323015,323016,0,1,2
92349,5,1,323020,323020,323021,0,1,4
92350,1,2,323021,323021,323023,0,2,0
92351,4,3,323025,323025,323028,0,3,2
92352,4,2,323029,323029,323031,0,2,1
92353,4,3,323033,323033,323036,0,3,2
92354,4,1,323037,323037,323038,0,1,1
92355,1,1,323038,323038,323039,0,1,0
92356,3,3,323041,323041,323044,0,3,2
92357,6,2,323047,323047,323049,0,2,3
92358,2,1,323049,323049,323050,0,1,0
92359,6,3,323055,323055,323058,0,3,5
92360,1,1,323056,323058,323059,2,3,0
92361,6,3,323062,323062,323065,0,3,3
92362,5,1,323067,323067,323068,0,1,2
92363,6,2,323073,323073,323075,0,2,5
92364,4,2,323077,323077,323079,0,2,2
92365,6,2,323083,323083,323085,0,2,4
92366,6,2,323089,323089,323091,0,2,4
92367,2,2,323091,323091,323093,0,2,0
92368,6,1,323097,323097,323098,0,1,4
92369,6,1,323103,323103,323104,0,1,5
92370,4,3,323107,323107,323110,0,3,3
92371,2,3,323109,323110,323113,1,4,0
92372,5,1,323114,323114,323115,0,1,1
92373,3,3,323117,323117,323120,0,3,2
92374,2,3,323119,323120,323123,1,4,0
92375,4,1,323123,323123,323124,0,1,0
92376,1,3,323124,323124,323127,0,3,0
92377,3,1,323127,323127,323128,0,1,0
92378,3,3,323130,323130,323133,0,3,2
92379,3,3,323133,323133,323136,0,3,0
92380,6,1,323139,323139,323140,0,1,3
92381,3,2,323142,323142,323144,0,2,2
92382,3,3,323145,323145,323148,0,3,1
92383,5,1,323150,323150,323151,0,1,2
92384,4,3,323154,323154,323157,0,3,3
92385,6,1,323160,323160,323161,0,1,3
92386,3,3,323163,323163,323166,0,3,2
92387,2,2,323165,323166,323168,1,3,0
92388,3,2,323168,323168,323170,0,2,0
92389,2,2,323170,323170,323172,0,2,0
92390,2,3,323172,323172,323175,0,3,0
92391,4,3,323176,323176,323179,0,3,1
92392,5,3,323181,323181,323184,0,3,2
92393,6,2,323187,323187,323189,0,2,3
92394,2,1,323189,323189,323190,0,1,0
92395,4,2,323193,323193,323195,0,2,3
92396,3,2,323196,323196,323198,0,2,1
92397,1,1,323197,323198,323199,1,2,0
92398,5,3,323202,323202,323205,0,3,3
92399,6,2,323208,323208,323210,0,2,3
92400,6,1,323214,323214,323215,0,1,4
92401,6,2,323220,323220,323222,0,2,5
92402,2,1,323222,323222,323223,0,1,0
92403,3,2,323225,323225,323227,0,2,2
92404,5,2,323230,323230,323232,0,2,3
92405,3,3,323233,323233,323236,0,3,1
92406,1,3,323234,323236,323239,2,5,0
92407,2,2,323236,323239,323241,3,5,0
92408,6,3,323242,323242,323245,0,3,1
92409,4,3,323246,323246,323249,0,3,1
92410,5,1,323251,323251,323252,0,1,2
92411,2,2,323253,323253,323255,0,2,1
92412,5,1,323258,323258,323259,0,1,3
92413,3,2,323261,323261,323263,0,2,2
92414,3,3,323264,323264,323267,0,3,1
92415,4,1,323268,323268,323269,0,1,1
92416,1,3,323269,323269,323272,0,3,0
92417,1,1,323270,323272,323273,2,3,0
92418,3,2,323273,323273,323275,0,2,0
92419,4,2,323277,323277,323279,0,2,2
92420,5,3,323282,323282,323285,0,3,3
92421,5,2,323287,323287,323289,0,2,2
92422,5,3,323292,323292,323295,0,3,3
92423,6,2,323298,323298,323300,0,2,3
92424,3,3,323301,323301,323304,0,3,1
92425,1,1,323302,323304,323305,2,3,0
92426,4,1,323306,323306,323307,0,1,1
92427,4,3,323310,323310,323313,0,3,3
92428,2,1,323312,323313,323314,1,2,0
92429,5,3,323317,323317,323320,0,3,3
92430,4,3,323321,323321,323324,0,3,1
92431,6,1,323327,323327,323328,0,1,3
92432,2,1,323329,323329,323330,0,1,1
92433,1,2,323330,323330,323332,0,2,0
92434,2,3,323332,323332,323335,0,3,0
92435,2,3,323334,323335,323338,1,4,0
92436,3,2,323337,323338,323340,1,3,0
92437,3,2,323340,323340,323342,0,2,0
92438,3,3,323343,323343,323346,0,3,1
92439,4,1,323347,323347,323348,0,1,1
92440,4,1,323351,323351,323352,0,1,3
92441,3,2,323354,323354,323356,0,2,2
92442,3,1,323357,323357,323358,0,1,1
92443,3,1,323360,323360,323361,0,1,2
92444,1,2,323361,323361,323363,0,2,0
92445,4,3,323365,323365,323368,0,3,2
92446,6,2,323371,323371,323373,0,2,3
92447,3,3,323374,323374,323377,0,3,1
92448,5,1,323379,323379,323380,0,1,2
92449,5,2,323384,323384,323386,0,2,4
92450,3,2,323387,323387,323389,0,2,1
92451,6,1,323393,323393,323394,0,1,4
92452,3,2,323396,323396,323398,0,2,2
92453,5,1,323401,323401,323402,0,1,3
92454,2,2,323403,323403,323405,0,2,1
92455,3,2,323406,323406,323408,0,2,1
92456,2,2,323408,323408,323410,0,2,0
92457,4,1,323412,323412,323413,0,1,2
92458,6,2,323418,323418,323420,0,2,5
92459,2,2,323420,323420,323422,0,2,0
92460,6,1,323426,323426,323427,0,1,4
92461,4,2,323430,323430,323432,0,2,3
92462,5,1,323435,323435,323436,0,1,3
92463,6,3,323441,323441,323444,0,3,5
92464,5,2,323446,323446,323448,0,2,2
92465,4,1,323450,323450,323451,0,1,2
92466,5,2,323455,323455,323457,0,2,4
92467,4,1,323459,323459,323460,0,1,2
92468,1,3,323460,323460,323463,0,3,0
92469,4,3,323464,323464,323467,0,3,1
92470,1,2,323465,323467,323469,2,4,0
92471,6,2,323471,323471,323473,0,2,2
92472,5,1,323476,323476,323477,0,1,3
92473,3,1,323479,323479,323480,0,1,2
92474,5,1,323484,323484,323485,0,1,4
92475,1,1,323485,323485,323486,0,1,0
92476,5,1,323490,323490,323491,0,1,4
92477,6,3,323496,323496,323499,0,3,5
92478,4,3,323500,323500,323503,0,3,1
92479,1,1,323501,323503,323504,2,3,0
92480,2,2,323503,323504,323506,1,3,0
92481,3,1,323506,323506,323507,0,1,0
92482,5,3,323511,323511,323514,0,3,4
92483,3,1,323514,323514,323515,0,1,0
92484,3,3,323517,323517,323520,0,3,2
92485,6,1,323523,323523,323524,0,1,3
92486,6,3,323529,323529,323532,0,3,5
92487,3,3,323532,323532,323535,0,3,0
92488,5,3,323537,323537,323540,0,3,2
92489,1,3,323538,323540,323543,2,5,0
92490,2,1,323540,323543,323544,3,4,0
92491,1,3,323541,323544,323547,3,6,0
92492,6,1,323547,323547,323548,0,1,0
92493,1,3,323548,323548,323551,0,3,0
92494,3,1,323551,323551,323552,0,1,0
92495,3,3,323554,323554,323557,0,3,2
92496,1,1,323555,323557,323558,2,3,0
92497,2,1,323557,323558,323559,1,2,0
92498,5,3,323562,323562,323565,0,3,3
92499,3,3,323565,323565,323568,0,3,0
92500,6,2,323571,323571,323573,0,2,3
92501,4,2,323575,323575,323577,0,2,2
92502,4,3,323579,323579,323582,0,3,2
92503,4,2,323583,323583,323585,0,2,1
92504,1,2,323584,323585,323587,1,3,0
92505,6,3,323590,323590,323593,0,3,3
92506,5,2,323595,323595,323597,0,2,2
92507,5,3,323600,323600,323603,0,3,3
92508,3,3,323603,323603,323606,0,3,0
92509,1,1,323604,323606,323607,2,3,0
92510,6,1,323610,323610,323611,0,1,3
92511,6,3,323616,323616,323619,0,3,5
92512,2,1,323618,323619,323620,1,2,0
92513,5,2,323623,323623,323625,0,2,3
92514,1,1,323624,323625,323626,1,2,0
92515,3,1,323627,323627,323628,0,1,1
92516,4,2,323631,323631,323633,0,2,3
92517,6,2,323637,323637,323639,0,2,4
92518,5,3,323642,323642,323645,0,3,3
92519,4,3,323646,323646,323649,0,3,1
92520,4,3,323650,323650,323653,0,3,1
92521,2,1,323652,323653,323654,1,2,0
92522,3,2,323655,323655,323657,0,2,1
92523,5,2,323660,323660,323662,0,2,3
92524,1,3,323661,323662,323665,1,4,0
92525,5,3,323666,323666,323669,0,3,1
92526,6,1,323672,323672,323673,0,1,3
92527,4,1,323676,323676,323677,0,1,3
92528,1,3,323677,323677,323680,0,3,0
92529,5,2,323682,323682,323684,0,2,2
92530,1,2,323683,323684,323686,1,3,0
92531,2,1,323685,323686,323687,1,2,0
92532,2,2,323687,323687,323689,0,2,0
92533,2,3,323689,323689,323692,0,3,0
92534,3,1,323692,323692,323693,0,1,0
92535,4,2,323696,323696,323698,0,2,3
92536,4,1,323700,323700,323701,0,1,2
92537,1,2,323701,323701,323703,0,2,0
92538,6,2,323707,323707,323709,0,2,4
92539,4,3,323711,323711,323714,0,3,2
92540,1,3,323712,323714,323717,2,5,0
92541,6,1,323718,323718,323719,0,1,1
92542,4,2,323722,323722,323724,0,2,3
92543,6,1,323728,323728,323729,0,1,4
92544,5,3,323733,323733,323736,0,3,4
92545,1,1,323734,323736,323737,2,3,0
92546,4,3,323738,323738,323741,0,3,1
92547,5,3,323743,323743,323746,0,3,2
92548,6,3,323749,323749,323752,0,3,3
92549,3,3,323752,323752,323755,0,3,0
92550,2,3,323754,323755,323758,1,4,0
92551,3,2,323757,323758,323760,1,3,0
92552,1,1,323758,323760,323761,2,3,0
92553,4,1,323762,323762,323763,0,1,1
92554,5,3,323767,323767,323770,0,3,4
92555,1,2,323768,323770,323772,2,4,0
92556,1,1,323769,323772,323773,3,4,0
92557,4,2,323773,323773,323775,0,2,0
92558,2,1,323775,323775,323776,0,1,0
92559,6,2,323781,323781,323783,0,2,5
92560,2,1,323783,323783,323784,0,1,0
92561,1,2,323784,323784,323786,0,2,0
92562,3,1,323787,323787,323788,0,1,1
92563,3,2,323790,323790,323792,0,2,2
92564,3,2,323793,323793,323795,0,2,1
92565,2,3,323795,323795,323798,0,3,0
92566,3,1,323798,323798,323799,0,1,0
92567,6,2,323804,323804,323806,0,2,5
92568,4,1,323808,323808,323809,0,1,2
92569,2,3,323810,323810,323813,0,3,1
92570,4,3,323814,323814,323817,0,3,1
92571,2,3,323816,323817,323820,1,4,0
92572,5,3,323821,323821,323824,0,3,1
92573,3,2,323824,323824,323826,0,2,0
92574,1,3,323825,323826,323829,1,4,0
92575,4,2,323829,323829,323831,0,2,0
92576,6,3,323835,323835,323838,0,3,4
92577,3,2,323838,323838,323840,0,2,0
92578,1,2,323839,323840,323842,1,3,0
92579,1,2,323840,323842,323844,2,4,0
92580,1,3,323841,323844,323847,3,6,0
92581,5,3,323846,323847,323850,1,4,0
92582,5,1,323851,323851,323852,0,1,1
92583,2,1,323853,323853,323854,0,1,1
92584,3,1,323856,323856,323857,0,1,2
92585,6,2,323862,323862,323864,0,2,5
92586,1,1,323863,323864,323865,1,2,0
92587,1,1,323864,323865,323866,1,2,0
92588,5,3,323869,323869,323872,0,3,3
92589,1,3,323870,323872,323875,2,5,0
92590,2,2,323872,323875,323877,3,5,0
92591,1,3,323873,323877,323880,4,7,0
92592,6,2,323879,323880,323882,1,3,0
92593,4,2,323883,323883,323885,0,2,1
92594,5,1,323888,323888,323889,0,1,3
92595,3,2,323891,323891,323893,0,2,2
92596,4,3,323895,323895,323898,0,3,2
92597,3,1,323898,323898,323899,0,1,0
92598,5,2,323903,323903,323905,0,2,4
92599,5,2,323908,323908,323910,0,2,3
92600,2,3,323910,323910,323913,0,3,0
92601,2,2,323912,323913,323915,1,3,0
92602,6,1,323918,323918,323919,0,1,3
92603,5,3,323923,323923,323926,0,3,4
92604,3,3,323926,323926,323929,0,3,0
92605,4,3,323930,323930,323933,0,3,1
92606,1,2,323931,323933,323935,2,4,0
92607,6,1,323937,323937,323938,0,1,2
92608,1,1,323938,323938,323939,0,1,0
92609,6,1,323944,323944,323945,0,1,5
92610,6,1,323950,323950,323951,0,1,5
92611,6,3,323956,323956,323959,0,3,5
92612,1,3,323957,323959,323962,2,5,0
92613,3,3,323960,323962,323965,2,5,0
92614,2,3,323962,323965,323968,3,6,0
92615,6,1,323968,323968,323969,0,1,0
92616,5,2,323973,323973,323975,0,2,4
92617,3,1,323976,323976,323977,0,1,1
92618,2,2,323978,323978,323980,0,2,1
92619,3,2,323981,323981,323983,0,2,1
92620,1,2,323982,323983,323985,1,3,0
92621,6,2,323988,323988,323990,0,2,3
92622,4,3,323992,323992,323995,0,3,2
92623,2,2,323994,323995,323997,1,3,0
92624,2,3,323996,323997,324000,1,4,0
92625,4,3,324000,324000,324003,0,3,0
92626,2,3,324002,324003,324006,1,4,0
92627,4,3,324006,324006,324009,0,3,0
92628,6,1,324012,324012,324013,0,1,3
92629,1,3,324013,324013,324016,0,3,0
92630,3,3,324016,324016,324019,0,3,0
92631,1,3,324017,324019,324022,2,5,0
92632,3,1,324020,324022,324023,2,3,0
92633,2,3,324022,324023,324026,1,4,0
92634,3,2,324025,324026,324028,1,3,0
92635,3,1,324028,324028,324029,0,1,0
92636,5,2,324033,324033,324035,0,2,4
92637,4,1,324037,324037,324038,0,1,2
92638,1,3,324038,324038,324041,0,3,0
92639,5,3,324043,324043,324046,0,3,2
92640,4,2,324047,324047,324049,0,2,1
92641,1,2,324048,324049,324051,1,3,0
92642,3,1,324051,324051,324052,0,1,0
92643,6,1,324057,324057,324058,0,1,5
92644,6,2,324063,324063,324065,0,2,5
92645,5,1,324068,324068,324069,0,1,3
92646,3,3,324071,324071,324074,0,3,2
92647,2,2,324073,324074,324076,1,3,0
92648,4,2,324077,324077,324079,0,2,1
92649,2,1,324079,324079,324080,0,1,0
92650,1,1,324080,324080,324081,0,1,0
92651,3,3,324083,324083,324086,0,3,2
92652,1,1,324084,324086,324087,2,3,0
92653,6,1,324090,324090,324091,0,1,3
92654,4,1,324094,324094,324095,0,1,3
92655,3,2,324097,324097,324099,0,2,2
92656,4,1,324101,324101,324102,0,1,2
92657,6,2,324107,324107,324109,0,2,5
92658,4,1,324111,324111,324112,0,1,2
92659,4,2,324115,324115,324117,0,2,3
92660,5,2,324120,324120,324122,0,2,3
92661,4,2,324124,324124,324126,0,2,2
92662,3,3,324127,324127,324130,0,3,1
92663,4,1,324131,324131,324132,0,1,1
92664,3,3,324134,324134,324137,0,3,2
92665,1,1,324135,324137,324138,2,3,0
92666,6,2,324141,324141,324143,0,2,3
92667,3,3,324144,324144,324147,0,3,1
92668,1,1,324145,324147,324148,2,3,0
92669,1,2,324146,324148,324150,2,4,0
92670,6,3,324152,324152,324155,0,3,2
92671,5,1,324157,324157,324158,0,1,2
92672,1,1,324158,324158,324159,0,1,0
92673,4,2,324162,324162,324164,0,2,3
92674,1,1,324163,324164,324165,1,2,0
92675,5,3,324168,324168,324171,0,3,3
92676,1,1,324169,324171,324172,2,3,0
92677,1,2,324170,324172,324174,2,4,0
92678,4,2,324174,324174,324176,0,2,0
92679,2,2,324176,324176,324178,0,2,0
92680,5,2,324181,324181,324183,0,2,3
92681,1,3,324182,324183,324186,1,4,0
92682,6,3,324188,324188,324191,0,3,2
92683,4,3,324192,324192,324195,0,3,1
92684,5,1,324197,324197,324198,0,1,2
92685,3,3,324200,324200,324203,0,3,2
92686,2,2,324202,324203,324205,1,3,0
92687,6,1,324208,324208,324209,0,1,3
92688,3,2,324211,324211,324213,0,2,2
92689,6,3,324217,324217,324220,0,3,4
92690,6,2,324223,324223,324225,0,2,3
92691,2,2,324225,324225,324227,0,2,0
92692,6,2,324231,324231,324233,0,2,4
92693,1,3,324232,324233,324236,1,4,0
92694,6,1,324238,324238,324239,0,1,2
92695,1,2,324239,324239,324241,0,2,0
92696,4,3,324243,324243,324246,0,3,2
92697,2,2,324245,324246,324248,1,3,0
92698,5,3,324250,324250,324253,0,3,2
92699,4,3,324254,324254,324257,0,3,1
92700,6,3,324260,324260,324263,0,3,3
92701,4,1,324264,324264,324265,0,1,1
92702,6,2,324270,324270,324272,0,2,5
92703,4,3,324274,324274,324277,0,3,2
92704,2,3,324276,324277,324280,1,4,0
92705,1,2,324277,324280,324282,3,5,0
92706,3,1,324280,324282,324283,2,3,0
92707,6,2,324286,324286,324288,0,2,3
92708,2,1,324288,324288,324289,0,1,0
92709,2,3,324290,324290,324293,0,3,1
92710,1,1,324291,324293,324294,2,3,0
92711,1,2,324292,324294,324296,2,4,0
92712,6,2,324298,324298,324300,0,2,2
92713,5,1,324303,324303,324304,0,1,3
92714,2,1,324305,324305,324306,0,1,1
92715,5,3,324310,324310,324313,0,3,4
92716,3,3,324313,324313,324316,0,3,0
92717,6,1,324319,324319,324320,0,1,3
92718,5,2,324324,324324,324326,0,2,4
92719,3,1,324327,324327,324328,0,1,1
92720,2,3,324329,324329,324332,0,3,1
92721,3,1,324332,324332,324333,0,1,0
92722,1,3,324333,324333,324336,0,3,0
92723,5,2,324338,324338,324340,0,2,2
92724,4,3,324342,324342,324345,0,3,2
92725,6,2,324348,324348,324350,0,2,3
92726,5,3,324353,324353,324356,0,3,3
92727,1,2,324354,324356,324358,2,4,0
92728,1,2,324355,324358,324360,3,5,0
92729,4,3,324359,324360,324363,1,4,0
92730,3,2,324362,324363,324365,1,3,0
92731,6,3,324368,324368,324371,0,3,3
92732,5,3,324373,324373,324376,0,3,2
92733,5,1,324378,324378,324379,0,1,2
92734,4,2,324382,324382,324384,0,2,3
92735,2,2,324384,324384,324386,0,2,0
92736,2,2,324386,324386,324388,0,2,0
92737,5,2,324391,324391,324393,0,2,3
92738,6,3,324397,324397,324400,0,3,4
92739,4,2,324401,324401,324403,0,2,1
92740,5,2,324406,324406,324408,0,2,3
92741,5,3,324411,324411,324414,0,3,3
92742,4,2,324415,324415,324417,0,2,1
92743,4,2,324419,324419,324421,0,2,2
92744,5,1,324424,324424,324425,0,1,3
92745,1,3,324425,324425,324428,0,3,0
92746,3,2,324428,324428,324430,0,2,0
92747,6,3,324434,324434,324437,0,3,4
92748,6,3,324440,324440,324443,0,3,3
92749,4,2,324444,324444,324446,0,2,1
92750,5,2,324449,324449,324451,0,2,3
92751,5,1,324454,324454,324455,0,1,3
92752,6,2,324460,324460,324462,0,2,5
92753,1,1,324461,324462,324463,1,2,0
92754,2,3,324463,324463,324466,0,3,0
92755,1,3,324464,324466,324469,2,5,0
92756,4,2,324468,324469,324471,1,3,0
92757,1,2,324469,324471,324473,2,4,0
92758,6,3,324475,324475,324478,0,3,2
92759,5,1,324480,324480,324481,0,1,2
92760,2,2,324482,324482,324484,0,2,1
92761,6,1,324488,324488,324489,0,1,4
92762,5,3,324493,324493,324496,0,3,4
92763,2,1,324495,324496,324497,1,2,0
92764,4,3,324499,324499,324502,0,3,2
92765,5,1,324504,324504,324505,0,1,2
92766,5,1,324509,324509,324510,0,1,4
92767,2,1,324511,324511,324512,0,1,1
92768,4,2,324515,324515,324517,0,2,3
92769,3,1,324518,324518,324519,0,1,1
92770,5,1,324523,324523,324524,0,1,4
92771,4,1,324527,324527,324528,0,1,3
92772,5,3,324532,324532,324535,0,3,4
92773,1,3,324533,324535,324538,2,5,0
92774,2,2,324535,324538,324540,3,5,0
92775,2,2,324537,324540,324542,3,5,0
92776,2,2,324539,324542,324544,3,5,0
92777,1,3,324540,324544,324547,4,7,0
92778,4,3,324544,324547,324550,3,6,0
92779,4,2,324548,324550,324552,2,4,0
92780,4,1,324552,324552,324553,0,1,0
92781,6,1,324558,324558,324559,0,1,5
92782,5,2,324563,324563,324565,0,2,4
92783,6,2,324569,324569,324571,0,2,4
92784,6,1,324575,324575,324576,0,1,4
92785,1,1,324576,324576,324577,0,1,0
92786,1,2,324577,324577,324579,0,2,0
92787,2,3,324579,324579,324582,0,3,0
92788,3,1,324582,324582,324583,0,1,0
92789,6,3,324588,324588,324591,0,3,5
92790,1,2,324589,324591,324593,2,4,0
92791,5,2,324594,324594,324596,0,2,1
92792,3,2,324597,324597,324599,0,2,1
92793,3,1,324600,324600,324601,0,1,1
92794,1,2,324601,324601,324603,0,2,0
92795,2,1,324603,324603,324604,0,1,0
92796,1,1,324604,324604,324605,0,1,0
92797,4,2,324608,324608,324610,0,2,3
92798,3,1,324611,324611,324612,0,1,1
92799,1,3,324612,324612,324615,0,3,0
92800,6,2,324618,324618,324620,0,2,3
92801,6,3,324624,324624,324627,0,3,4
92802,5,3,324629,324629,324632,0,3,2
92803,2,3,324631,324632,324635,1,4,0
92804,3,2,324634,324635,324637,1,3,0
92805,3,3,324637,324637,324640,0,3,0
92806,6,2,324643,324643,324645,0,2,3
92807,2,3,324645,324645,324648,0,3,0
92808,2,3,324647,324648,324651,1,4,0
92809,4,3,324651,324651,324654,0,3,0
92810,3,3,324654,324654,324657,0,3,0
92811,3,2,324657,324657,324659,0,2,0
92812,6,2,324663,324663,324665,0,2,4
92813,6,1,324669,324669,324670,0,1,4
92814,2,2,324671,324671,324673,0,2,1
92815,6,2,324677,324677,324679,0,2,4
92816,4,2,324681,324681,324683,0,2,2
92817,6,2,324687,324687,324689,0,2,4
92818,2,1,324689,324689,324690,0,1,0
92819,4,2,324693,324693,324695,0,2,3
92820,3,1,324696,324696,324697,0,1,1
92821,1,3,324697,324697,324700,0,3,0
92822,6,2,324703,324703,324705,0,2,3
92823,6,1,324709,324709,324710,0,1,4
92824,2,2,324711,324711,324713,0,2,1
92825,3,3,324714,324714,324717,0,3,1
92826,4,2,324718,324718,324720,0,2,1
92827,5,1,324723,324723,324724,0,1,3
92828,3,2,324726,324726,324728,0,2,2
92829,2,3,324728,324728,324731,0,3,0
92830,1,1,324729,324731,324732,2,3,0
92831,4,1,324733,324733,324734,0,1,1
92832,3,1,324736,324736,324737,0,1,2
92833,1,3,324737,324737,324740,0,3,0
92834,4,3,324741,324741,324744,0,3,1
92835,6,1,324747,324747,324748,0,1,3
92836,2,2,324749,324749,324751,0,2,1
92837,1,1,324750,324751,324752,1,2,0
92838,3,2,324753,324753,324755,0,2,1
92839,1,1,324754,324755,324756,1,2,0
92840,2,3,324756,324756,324759,0,3,0
92841,1,1,324757,324759,324760,2,3,0
92842,4,2,324761,324761,324763,0,2,1
92843,2,1,324763,324763,324764,0,1,0
92844,3,1,324766,324766,324767,0,1,2
92845,3,1,324769,324769,324770,0,1,2
92846,4,3,324773,324773,324776,0,3,3
92847,6,2,324779,324779,324781,0,2,3
92848,3,1,324782,324782,324783,0,1,1
92849,6,3,324788,324788,324791,0,3,5
92850,2,3,324790,324791,324794,1,4,0
92851,3,3,324793,324794,324797,1,4,0
92852,6,3,324799,324799,324802,0,3,2
92853,6,1,324805,324805,324806,0,1,3
92854,2,1,324807,324807,324808,0,1,1
92855,4,1,324811,324811,324812,0,1,3
92856,3,1,324814,324814,324815,0,1,2
92857,2,3,324816,324816,324819,0,3,1
92858,6,3,324822,324822,324825,0,3,3
92859,1,1,324823,324825,324826,2,3,0
92860,6,3,324829,324829,324832,0,3,3
92861,5,2,324834,324834,324836,0,2,2
92862,1,1,324835,324836,324837,1,2,0
92863,2,1,324837,324837,324838,0,1,0
92864,4,3,324841,324841,324844,0,3,3
92865,5,1,324846,324846,324847,0,1,2
92866,4,3,324850,324850,324853,0,3,3
92867,4,3,324854,324854,324857,0,3,1
92868,6,1,324860,324860,324861,0,1,3
92869,1,1,324861,324861,324862,0,1,0
92870,1,1,324862,324862,324863,0,1,0
92871,6,3,324868,324868,324871,0,3,5
92872,5,1,324873,324873,324874,0,1,2
92873,3,3,324876,324876,324879,0,3,2
92874,6,1,324882,324882,324883,0,1,3
92875,5,2,324887,324887,324889,0,2,4
92876,4,1,324891,324891,324892,0,1,2
92877,5,1,324896,324896,324897,0,1,4
92878,4,3,324900,324900,324903,0,3,3
92879,3,3,324903,324903,324906,0,3,0
92880,4,2,324907,324907,324909,0,2,1
92881,5,2,324912,324912,324914,0,2,3
92882,2,2,324914,324914,324916,0,2,0
92883,3,1,324917,324917,324918,0,1,1
92884,4,1,324921,324921,324922,0,1,3
92885,5,1,324926,324926,324927,0,1,4
92886,2,1,324928,324928,324929,0,1,1
92887,4,3,324932,324932,324935,0,3,3
92888,3,3,324935,324935,324938,0,3,0
92889,5,1,324940,324940,324941,0,1,2
92890,5,1,324945,324945,324946,0,1,4
92891,3,1,324948,324948,324949,0,1,2
92892,2,3,324950,324950,324953,0,3,1
92893,3,3,324953,324953,324956,0,3,0
92894,3,3,324956,324956,324959,0,3,0
92895,6,1,324962,324962,324963,0,1,3
92896,2,2,324964,324964,324966,0,2,1
92897,6,1,324970,324970,324971,0,1,4
92898,3,2,324973,324973,324975,0,2,2
92899,1,1,324974,324975,324976,1,2,0
92900,6,1,324980,324980,324981,0,1,4
92901,2,2,324982,324982,324984,0,2,1
92902,4,3,324986,324986,324989,0,3,2
92903,6,1,324992,324992,324993,0,1,3
92904,3,1,324995,324995,324996,0,1,2
92905,6,2,325001,325001,325003,0,2,5
92906,2,3,325003,325003,325006,0,3,0
92907,6,1,325009,325009,325010,0,1,3
92908,6,2,325015,325015,325017,0,2,5
92909,2,1,325017,325017,325018,0,1,0
92910,3,2,325020,325020,325022,0,2,2
92911,1,2,325021,325022,325024,1,3,0
92912,2,1,325023,325024,325025,1,2,0
92913,6,2,325029,325029,325031,0,2,4
92914,1,1,325030,325031,325032,1,2,0
92915,4,1,325034,325034,325035,0,1,2
92916,4,1,325038,325038,325039,0,1,3
92917,5,3,325043,325043,325046,0,3,4
92918,2,3,325045,325046,325049,1,4,0
92919,1,2,325046,325049,325051,3,5,0
92920,5,1,325051,325051,325052,0,1,0
92921,2,2,325053,325053,325055,0,2,1
92922,6,1,325059,325059,325060,0,1,4
92923,2,2,325061,325061,325063,0,2,1
92924,2,3,325063,325063,325066,0,3,0
92925,5,3,325068,325068,325071,0,3,2
92926,6,2,325074,325074,325076,0,2,3
92927,6,2,325080,325080,325082,0,2,4
92928,6,2,325086,325086,325088,0,2,4
92929,1,2,325087,325088,325090,1,3,0
92930,4,1,325091,325091,325092,0,1,1
92931,5,3,325096,325096,325099,0,3,4
92932,1,1,325097,325099,325100,2,3,0
92933,6,3,325103,325103,325106,0,3,3
92934,4,3,325107,325107,325110,0,3,1
92935,2,2,325109,325110,325112,1,3,0
92936,3,3,325112,325112,325115,0,3,0
92937,6,1,325118,325118,325119,0,1,3
92938,2,1,325120,325120,325121,0,1,1
92939,4,3,325124,325124,325127,0,3,3
92940,5,3,325129,325129,325132,0,3,2
92941,2,2,325131,325132,325134,1,3,0
92942,5,1,325136,325136,325137,0,1,2
92943,5,1,325141,325141,325142,0,1,4
92944,2,3,325143,325143,325146,0,3,1
92945,3,1,325146,325146,325147,0,1,0
92946,3,2,325149,325149,325151,0,2,2
92947,2,1,325151,325151,325152,0,1,0
92948,5,1,325156,325156,325157,0,1,4
92949,4,1,325160,325160,325161,0,1,3
92950,3,2,325163,325163,325165,0,2,2
92951,5,2,325168,325168,325170,0,2,3
92952,3,2,325171,325171,325173,0,2,1
92953,2,1,325173,325173,325174,0,1,0
92954,1,1,325174,325174,325175,0,1,0
92955,3,3,325177,325177,325180,0,3,2
92956,6,1,325183,325183,325184,0,1,3
92957,6,2,325189,325189,325191,0,2,5
92958,2,1,325191,325191,325192,0,1,0
92959,1,1,325192,325192,325193,0,1,0
92960,3,2,325195,325195,325197,0,2,2
92961,4,3,325199,325199,325202,0,3,2
92962,3,1,325202,325202,325203,0,1,0
92963,3,3,325205,325205,325208,0,3,2
92964,1,3,325206,325208,325211,2,5,0
92965,5,3,325211,325211,325214,0,3,0
92966,6,2,325217,325217,325219,0,2,3
92967,6,3,325223,325223,325226,0,3,4
92968,3,3,325226,325226,325229,0,3,0
92969,6,3,325232,325232,325235,0,3,3
92970,6,3,325238,325238,325241,0,3,3
92971,2,1,325240,325241,325242,1,2,0
92972,5,3,325245,325245,325248,0,3,3
92973,1,2,325246,325248,325250,2,4,0
92974,4,1,325250,325250,325251,0,1,0
92975,6,2,325256,325256,325258,0,2,5
92976,6,2,325262,325262,325264,0,2,4
92977,5,3,325267,325267,325270,0,3,3
92978,1,3,325268,325270,325273,2,5,0
92979,3,2,325271,325273,325275,2,4,0
92980,6,1,325277,325277,325278,0,1,2
92981,4,3,325281,325281,325284,0,3,3
92982,1,2,325282,325284,325286,2,4,0
92983,6,2,325288,325288,325290,0,2,2
92984,2,2,325290,325290,325292,0,2,0
92985,5,1,325295,325295,325296,0,1,3
92986,3,1,325298,325298,325299,0,1,2
92987,1,1,325299,325299,325300,0,1,0
92988,1,3,325300,325300,325303,0,3,0
92989,5,1,325305,325305,325306,0,1,2
92990,1,1,325306,325306,325307,0,1,0
92991,4,1,325310,325310,325311,0,1,3
92992,3,2,325313,325313,325315,0,2,2
92993,4,1,325317,325317,325318,0,1,2
92994,5,2,325322,325322,325324,0,2,4
92995,1,3,325323,325324,325327,1,4,0
92996,1,1,325324,325327,325328,3,4,0
92997,6,2,325330,325330,325332,0,2,2
92998,1,3,325331,325332,325335,1,4,0
92999,3,1,325334,325335,325336,1,2,0
93000,3,1,325337,325337,325338,0,1,1
93001,6,3,325343,325343,325346,0,3,5
93002,1,3,325344,325346,325349,2,5,0
93003,3,3,325347,325349,325352,2,5,0
93004,5,1,325352,325352,325353,0,1,0
93005,2,1,325354,325354,325355,0,1,1
93006,6,1,325360,325360,325361,0,1,5
93007,1,1,325361,325361,325362,0,1,0
93008,1,1,325362,325362,325363,0,1,0
93009,4,1,325366,325366,325367,0,1,3
93010,5,2,325371,325371,325373,0,2,4
93011,3,3,325374,325374,325377,0,3,1
93012,4,3,325378,325378,325381,0,3,1
93013,4,3,325382,325382,325385,0,3,1
93014,1,2,325383,325385,325387,2,4,0
93015,3,3,325386,325387,325390,1,4,0
93016,2,2,325388,325390,325392,2,4,0
93017,2,3,325390,325392,325395,2,5,0
93018,1,3,325391,325395,325398,4,7,0
93019,1,3,325392,325398,325401,6,9,0
93020,6,3,325398,325401,325404,3,6,0
93021,3,3,325401,325404,325407,3,6,0
93022,5,2,325406,325407,325409,1,3,0
93023,1,3,325407,325409,325412,2,5,0
93024,3,3,325410,325412,325415,2,5,0
93025,3,3,325413,325415,325418,2,5,0
93026,2,2,325415,325418,325420,3,5,0
93027,6,2,325421,325421,325423,0,2,1
93028,1,3,325422,325423,325426,1,4,0
93029,1,1,325423,325426,325427,3,4,0
93030,5,3,325428,325428,325431,0,3,1
93031,2,3,325430,325431,325434,1,4,0
93032,4,2,325434,325434,325436,0,2,0
93033,4,1,325438,325438,325439,0,1,2
93034,5,2,325443,325443,325445,0,2,4
93035,5,2,325448,325448,325450,0,2,3
93036,4,3,325452,325452,325455,0,3,2
93037,6,2,325458,325458,325460,0,2,3
93038,1,2,325459,325460,325462,1,3,0
93039,3,2,325462,325462,325464,0,2,0
93040,2,2,325464,325464,325466,0,2,0
93041,5,2,325469,325469,325471,0,2,3
93042,2,3,325471,325471,325474,0,3,0
93043,2,2,325473,325474,325476,1,3,0
93044,6,1,325479,325479,325480,0,1,3
93045,4,2,325483,325483,325485,0,2,3
93046,1,3,325484,325485,325488,1,4,0
93047,1,2,325485,325488,325490,3,5,0
93048,3,1,325488,325490,325491,2,3,0
93049,4,3,325492,325492,325495,0,3,1
93050,3,3,325495,325495,325498,0,3,0
93051,3,3,325498,325498,325501,0,3,0
93052,3,3,325501,325501,325504,0,3,0
93053,5,2,325506,325506,325508,0,2,2
93054,2,3,325508,325508,325511,0,3,0
93055,2,3,325510,325511,325514,1,4,0
93056,3,1,325513,325514,325515,1,2,0
93057,2,3,325515,325515,325518,0,3,0
93058,5,2,325520,325520,325522,0,2,2
93059,3,3,325523,325523,325526,0,3,1
93060,2,3,325525,325526,325529,1,4,0
93061,1,3,325526,325529,325532,3,6,0
93062,2,3,325528,325532,325535,4,7,0
93063,4,2,325532,325535,325537,3,5,0
93064,4,3,325536,325537,325540,1,4,0
93065,3,1,325539,325540,325541,1,2,0
93066,6,3,325545,325545,325548,0,3,4
93067,6,2,325551,325551,325553,0,2,3
93068,2,3,325553,325553,325556,0,3,0
93069,3,2,325556,325556,325558,0,2,0
93070,5,1,325561,325561,325562,0,1,3
93071,3,3,325564,325564,325567,0,3,2
93072,3,1,325567,325567,325568,0,1,0
93073,6,3,325573,325573,325576,0,3,5
93074,5,2,325578,325578,325580,0,2,2
93075,1,2,325579,325580,325582,1,3,0
93076,6,3,325585,325585,325588,0,3,3
93077,1,2,325586,325588,325590,2,4,0
93078,2,1,325588,325590,325591,2,3,0
93079,1,3,325589,325591,325594,2,5,0
93080,2,2,325591,325594,325596,3,5,0
93081,1,3,325592,325596,325599,4,7,0
93082,4,2,325596,325599,325601,3,5,0
93083,2,3,325598,325601,325604,3,6,0
93084,1,3,325599,325604,325607,5,8,0
93085,2,2,325601,325607,325609,6,8,0
93086,2,3,325603,325609,325612,6,9,0
93087,1,2,325604,325612,325614,8,10,0
93088,6,1,325610,325614,325615,4,5,0
93089,2,3,325612,325615,325618,3,6,0
93090,3,3,325615,325618,325621,3,6,0
93091,6,1,325621,325621,325622,0,1,0
93092,1,3,325622,325622,325625,0,3,0
93093,6,3,325628,325628,325631,0,3,3
93094,6,2,325634,325634,325636,0,2,3
93095,6,2,325640,325640,325642,0,2,4
93096,5,2,325645,325645,325647,0,2,3
93097,3,1,325648,325648,325649,0,1,1
93098,6,1,325654,325654,325655,0,1,5
93099,4,3,325658,325658,325661,0,3,3
93100,6,1,325664,325664,325665,0,1,3
93101,2,2,325666,325666,325668,0,2,1
93102,6,3,325672,325672,325675,0,3,4
93103,4,1,325676,325676,325677,0,1,1
93104,4,1,325680,325680,325681,0,1,3
93105,3,1,325683,325683,325684,0,1,2
93106,3,3,325686,325686,325689,0,3,2
93107,5,1,325691,325691,325692,0,1,2
93108,2,2,325693,325693,325695,0,2,1
93109,5,3,325698,325698,325701,0,3,3
93110,1,1,325699,325701,325702,2,3,0
93111,2,3,325701,325702,325705,1,4,0
93112,4,3,325705,325705,325708,0,3,0
93113,2,2,325707,325708,325710,1,3,0
93114,1,1,325708,325710,325711,2,3,0
93115,6,3,325714,325714,325717,0,3,3
93116,3,1,325717,325717,325718,0,1,0
93117,2,3,325719,325719,325722,0,3,1
93118,3,3,325722,325722,325725,0,3,0
93119,5,1,325727,325727,325728,0,1,2
93120,2,2,325729,325729,325731,0,2,1
93121,3,3,325732,325732,325735,0,3,1
93122,6,1,325738,325738,325739,0,1,3
93123,5,2,325743,325743,325745,0,2,4
93124,6,3,325749,325749,325752,0,3,4
93125,3,1,325752,325752,325753,0,1,0
93126,6,1,325758,325758,325759,0,1,5
93127,1,2,325759,325759,325761,0,2,0
93128,4,3,325763,325763,325766,0,3,2
93129,1,1,325764,325766,325767,2,3,0
93130,5,2,325769,325769,325771,0,2,2
93131,4,1,325773,325773,325774,0,1,2
93132,2,3,325775,325775,325778,0,3,1
93133,1,2,325776,325778,325780,2,4,0
93134,6,1,325782,325782,325783,0,1,2
93135,4,1,325786,325786,325787,0,1,3
93136,5,3,325791,325791,325794,0,3,4
93137,1,3,325792,325794,325797,2,5,0
93138,1,3,325793,325797,325800,4,7,0
93139,4,3,325797,325800,325803,3,6,0
93140,4,2,325801,325803,325805,2,4,0
93141,5,2,325806,325806,325808,0,2,1
93142,4,3,325810,325810,325813,0,3,2
93143,2,1,325812,325813,325814,1,2,0
93144,6,2,325818,325818,325820,0,2,4
93145,4,1,325822,325822,325823,0,1,2
93146,2,1,325824,325824,325825,0,1,1
93147,4,2,325828,325828,325830,0,2,3
93148,3,2,325831,325831,325833,0,2,1
93149,3,2,325834,325834,325836,0,2,1
93150,1,1,325835,325836,325837,1,2,0
93151,6,1,325841,325841,325842,0,1,4
93152,3,3,325844,325844,325847,0,3,2
93153,6,3,325850,325850,325853,0,3,3
93154,6,3,325856,325856,325859,0,3,3
93155,3,2,325859,325859,325861,0,2,0
93156,5,3,325864,325864,325867,0,3,3
93157,4,1,325868,325868,325869,0,1,1
93158,3,2,325871,325871,325873,0,2,2
93159,1,2,325872,325873,325875,1,3,0
93160,1,3,325873,325875,325878,2,5,0
93161,1,1,325874,325878,325879,4,5,0
93162,1,3,325875,325879,325882,4,7,0
93163,6,1,325881,325882,325883,1,2,0
93164,4,2,325885,325885,325887,0,2,2
93165,2,1,325887,325887,325888,0,1,0
93166,3,1,325890,325890,325891,0,1,2
93167,4,2,325894,325894,325896,0,2,3
93168,6,2,325900,325900,325902,0,2,4
93169,1,2,325901,325902,325904,1,3,0
93170,5,2,325906,325906,325908,0,2,2
93171,1,2,325907,325908,325910,1,3,0
93172,1,2,325908,325910,325912,2,4,0
93173,5,3,325913,325913,325916,0,3,1
93174,1,3,325914,325916,325919,2,5,0
93175,6,1,325920,325920,325921,0,1,1
93176,1,2,325921,325921,325923,0,2,0
93177,1,2,325922,325923,325925,1,3,0
93178,1,2,325923,325925,325927,2,4,0
93179,3,1,325926,325927,325928,1,2,0
93180,1,2,325927,325928,325930,1,3,0
93181,6,1,325933,325933,325934,0,1,3
93182,2,2,325935,325935,325937,0,2,1
93183,2,1,325937,325937,325938,0,1,0
93184,2,1,325939,325939,325940,0,1,1
93185,6,2,325945,325945,325947,0,2,5
93186,3,3,325948,325948,325951,0,3,1
93187,4,1,325952,325952,325953,0,1,1
93188,5,2,325957,325957,325959,0,2,4
93189,4,1,325961,325961,325962,0,1,2
93190,5,2,325966,325966,325968,0,2,4
93191,1,2,325967,325968,325970,1,3,0
93192,6,2,325973,325973,325975,0,2,3
93193,5,2,325978,325978,325980,0,2,3
93194,4,3,325982,325982,325985,0,3,2
93195,5,2,325987,325987,325989,0,2,2
93196,1,1,325988,325989,325990,1,2,0
93197,1,1,325989,325990,325991,1,2,0
93198,3,2,325992,325992,325994,0,2,1
93199,5,2,325997,325997,325999,0,2,3
93200,1,1,325998,325999,326000,1,2,0
93201,2,2,326000,326000,326002,0,2,0
93202,5,2,326005,326005,326007,0,2,3
93203,1,1,326006,326007,326008,1,2,0
93204,4,3,326010,326010,326013,0,3,2
93205,3,3,326013,326013,326016,0,3,0
93206,4,2,326017,326017,326019,0,2,1
93207,2,2,326019,326019,326021,0,2,0
93208,5,1,326024,326024,326025,0,1,3
93209,6,2,326030,326030,326032,0,2,5
93210,2,2,326032,326032,326034,0,2,0
93211,6,1,326038,326038,326039,0,1,4
93212,1,1,326039,326039,326040,0,1,0
93213,5,2,326044,326044,326046,0,2,4
93214,4,2,326048,326048,326050,0,2,2
93215,6,1,326054,326054,326055,0,1,4
93216,1,3,326055,326055,326058,0,3,0
93217,2,2,326057,326058,326060,1,3,0
93218,2,3,326059,326060,326063,1,4,0
93219,3,1,326062,326063,326064,1,2,0
93220,3,1,326065,326065,326066,0,1,1
93221,6,1,326071,326071,326072,0,1,5
93222,1,2,326072,326072,326074,0,2,0
93223,4,2,326076,326076,326078,0,2,2
93224,6,2,326082,326082,326084,0,2,4
93225,6,3,326088,326088,326091,0,3,4
93226,1,3,326089,326091,326094,2,5,0
93227,3,3,326092,326094,326097,2,5,0
93228,3,2,326095,326097,326099,2,4,0
93229,5,1,326100,326100,326101,0,1,1
93230,6,3,326106,326106,326109,0,3,5
93231,2,2,326108,326109,326111,1,3,0
93232,4,1,326112,326112,326113,0,1,1
93233,5,2,326117,326117,326119,0,2,4
93234,5,2,326122,326122,326124,0,2,3
93235,1,1,326123,326124,326125,1,2,0
93236,6,2,326129,326129,326131,0,2,4
93237,2,2,326131,326131,326133,0,2,0
93238,5,3,326136,326136,326139,0,3,3
93239,4,3,326140,326140,326143,0,3,1
93240,5,1,326145,326145,326146,0,1,2
93241,5,2,326150,326150,326152,0,2,4
93242,4,1,326154,326154,326155,0,1,2
93243,1,1,326155,326155,326156,0,1,0
93244,2,1,326157,326157,326158,0,1,1
93245,1,1,326158,326158,326159,0,1,0
93246,5,2,326163,326163,326165,0,2,4
93247,5,1,326168,326168,326169,0,1,3
93248,1,2,326169,326169,326171,0,2,0
93249,3,1,326172,326172,326173,0,1,1
93250,4,1,326176,326176,326177,0,1,3
93251,1,1,326177,326177,326178,0,1,0
93252,1,3,326178,326178,326181,0,3,0
93253,4,2,326182,326182,326184,0,2,1
93254,6,2,326188,326188,326190,0,2,4
93255,2,3,326190,326190,326193,0,3,0
93256,3,1,326193,326193,326194,0,1,0
93257,2,2,326195,326195,326197,0,2,1
93258,3,3,326198,326198,326201,0,3,1
93259,3,1,326201,326201,326202,0,1,0
93260,3,3,326204,326204,326207,0,3,2
93261,1,3,326205,326207,326210,2,5,0
93262,4,2,326209,326210,326212,1,3,0
93263,4,1,326213,326213,326214,0,1,1
93264,3,1,326216,326216,326217,0,1,2
93265,3,3,326219,326219,326222,0,3,2
93266,6,1,326225,326225,326226,0,1,3
93267,3,1,326228,326228,326229,0,1,2
93268,2,2,326230,326230,326232,0,2,1
93269,5,2,326235,326235,326237,0,2,3
93270,3,1,326238,326238,326239,0,1,1
93271,5,1,326243,326243,326244,0,1,4
93272,2,1,326245,326245,326246,0,1,1
93273,1,2,326246,326246,326248,0,2,0
93274,4,2,326250,326250,326252,0,2,2
93275,4,2,326254,326254,326256,0,2,2
93276,4,2,326258,326258,326260,0,2,2
93277,4,2,326262,326262,326264,0,2,2
93278,3,1,326265,326265,326266,0,1,1
93279,4,1,326269,326269,326270,0,1,3
93280,5,1,326274,326274,326275,0,1,4
93281,5,3,326279,326279,326282,0,3,4
93282,5,2,326284,326284,326286,0,2,2
93283,5,2,326289,326289,326291,0,2,3
93284,5,1,326294,326294,326295,0,1,3
93285,3,2,326297,326297,326299,0,2,2
93286,1,3,326298,326299,326302,1,4,0
93287,3,2,326301,326302,326304,1,3,0
93288,3,2,326304,326304,326306,0,2,0
93289,3,1,326307,326307,326308,0,1,1
93290,6,3,326313,326313,326316,0,3,5
93291,4,1,326317,326317,326318,0,1,1
93292,5,1,326322,326322,326323,0,1,4
93293,5,1,326327,326327,326328,0,1,4
93294,4,3,326331,326331,326334,0,3,3
93295,3,3,326334,326334,326337,0,3,0
93296,1,2,326335,326337,326339,2,4,0
93297,6,1,326341,326341,326342,0,1,2
93298,6,3,326347,326347,326350,0,3,5
93299,5,1,326352,326352,326353,0,1,2
93300,4,3,326356,326356,326359,0,3,3
93301,1,1,326357,326359,326360,2,3,0
93302,3,3,326360,326360,326363,0,3,0
93303,5,1,326365,326365,326366,0,1,2
93304,1,3,326366,326366,326369,0,3,0
93305,4,3,326370,326370,326373,0,3,1
93306,3,1,326373,326373,326374,0,1,0
93307,2,2,326375,326375,326377,0,2,1
93308,5,1,326380,326380,326381,0,1,3
93309,4,2,326384,326384,326386,0,2,3
93310,1,2,326385,326386,326388,1,3,0
93311,1,1,326386,326388,326389,2,3,0
93312,6,3,326392,326392,326395,0,3,3
93313,1,2,326393,326395,326397,2,4,0
93314,5,2,326398,326398,326400,0,2,1
93315,5,3,326403,326403,326406,0,3,3
93316,3,1,326406,326406,326407,0,1,0
93317,6,1,326412,326412,326413,0,1,5
93318,4,2,326416,326416,326418,0,2,3
93319,1,3,326417,326418,326421,1,4,0
93320,1,1,326418,326421,326422,3,4,0
93321,4,1,326422,326422,326423,0,1,0
93322,1,2,326423,326423,326425,0,2,0
93323,2,1,326425,326425,326426,0,1,0
93324,6,3,326431,326431,326434,0,3,5
93325,1,3,326432,326434,326437,2,5,0
93326,5,3,326437,326437,326440,0,3,0
93327,5,3,326442,326442,326445,0,3,2
93328,5,1,326447,326447,326448,0,1,2
93329,6,1,326453,326453,326454,0,1,5
93330,4,2,326457,326457,326459,0,2,3
93331,3,3,326460,326460,326463,0,3,1
93332,2,1,326462,326463,326464,1,2,0
93333,3,1,326465,326465,326466,0,1,1
93334,6,3,326471,326471,326474,0,3,5
93335,5,2,326476,326476,326478,0,2,2
93336,2,3,326478,326478,326481,0,3,0
93337,4,2,326482,326482,326484,0,2,1
93338,2,1,326484,326484,326485,0,1,0
93339,2,3,326486,326486,326489,0,3,1
93340,3,1,326489,326489,326490,0,1,0
93341,3,1,326492,326492,326493,0,1,2
93342,1,3,326493,326493,326496,0,3,0
93343,4,2,326497,326497,326499,0,2,1
93344,3,2,326500,326500,326502,0,2,1
93345,5,1,326505,326505,326506,0,1,3
93346,2,1,326507,326507,326508,0,1,1
93347,2,3,326509,326509,326512,0,3,1
93348,3,2,326512,326512,326514,0,2,0
93349,3,3,326515,326515,326518,0,3,1
93350,6,2,326521,326521,326523,0,2,3
93351,4,2,326525,326525,326527,0,2,2
93352,5,1,326530,326530,326531,0,1,3
93353,4,1,326534,326534,326535,0,1,3
93354,3,1,326537,326537,326538,0,1,2
93355,6,3,326543,326543,326546,0,3,5
93356,5,3,326548,326548,326551,0,3,2
93357,3,3,326551,326551,326554,0,3,0
93358,2,2,326553,326554,326556,1,3,0
93359,5,3,326558,326558,326561,0,3,2
93360,2,1,326560,326561,326562,1,2,0
93361,4,1,326564,326564,326565,0,1,2
93362,4,2,326568,326568,326570,0,2,3
93363,6,2,326574,326574,326576,0,2,4
93364,1,2,326575,326576,326578,1,3,0
93365,5,2,326580,326580,326582,0,2,2
93366,3,1,326583,326583,326584,0,1,1
93367,3,3,326586,326586,326589,0,3,2
93368,1,2,326587,326589,326591,2,4,0
93369,1,1,326588,326591,326592,3,4,0
93370,3,1,326591,326592,326593,1,2,0
93371,4,2,326595,326595,326597,0,2,2
93372,2,2,326597,326597,326599,0,2,0
93373,3,3,326600,326600,326603,0,3,1
93374,5,3,326605,326605,326608,0,3,2
93375,2,3,326607,326608,326611,1,4,0
93376,3,2,326610,326611,326613,1,3,0
93377,2,1,326612,326613,326614,1,2,0
93378,3,2,326615,326615,326617,0,2,1
93379,6,1,326621,326621,326622,0,1,4
93380,3,3,326624,326624,326627,0,3,2
93381,2,1,326626,326627,326628,1,2,0
93382,3,2,326629,326629,326631,0,2,1
93383,5,3,326634,326634,326637,0,3,3
93384,4,3,326638,326638,326641,0,3,1
93385,4,1,326642,326642,326643,0,1,1
93386,1,3,326643,326643,326646,0,3,0
93387,3,2,326646,326646,326648,0,2,0
93388,3,2,326649,326649,326651,0,2,1
93389,6,1,326655,326655,326656,0,1,4
93390,5,3,326660,326660,326663,0,3,4
93391,2,3,326662,326663,326666,1,4,0
93392,6,1,326668,326668,326669,0,1,2
93393,3,1,326671,326671,326672,0,1,2
93394,1,1,326672,326672,326673,0,1,0
93395,1,1,326673,326673,326674,0,1,0
93396,4,1,326677,326677,326678,0,1,3
93397,6,1,326683,326683,326684,0,1,5
93398,4,1,326687,326687,326688,0,1,3
93399,4,3,326691,326691,326694,0,3,3
93400,3,2,326694,326694,326696,0,2,0
93401,2,2,326696,326696,326698,0,2,0
93402,6,3,326702,326702,326705,0,3,4
93403,2,1,326704,326705,326706,1,2,0
93404,3,2,326707,326707,326709,0,2,1
93405,6,1,326713,326713,326714,0,1,4
93406,3,3,326716,326716,326719,0,3,2
93407,5,3,326721,326721,326724,0,3,2
93408,1,2,326722,326724,326726,2,4,0
93409,1,2,326723,326726,326728,3,5,0
93410,6,3,326729,326729,326732,0,3,1
93411,3,1,326732,326732,326733,0,1,0
93412,5,1,326737,326737,326738,0,1,4
93413,3,1,326740,326740,326741,0,1,2
93414,3,2,326743,326743,326745,0,2,2
93415,6,1,326749,326749,326750,0,1,4
93416,2,3,326751,326751,326754,0,3,1
93417,2,2,326753,326754,326756,1,3,0
93418,6,1,326759,326759,326760,0,1,3
93419,5,1,326764,326764,326765,0,1,4
93420,4,2,326768,326768,326770,0,2,3
93421,5,3,326773,326773,326776,0,3,3
93422,5,1,326778,326778,326779,0,1,2
93423,2,2,326780,326780,326782,0,2,1
93424,1,3,326781,326782,326785,1,4,0
93425,4,2,326785,326785,326787,0,2,0
93426,6,2,326791,326791,326793,0,2,4
93427,1,2,326792,326793,326795,1,3,0
93428,5,2,326797,326797,326799,0,2,2
93429,3,2,326800,326800,326802,0,2,1
93430,2,3,326802,326802,326805,0,3,0
93431,2,3,326804,326805,326808,1,4,0
93432,6,3,326810,326810,326813,0,3,2
93433,2,3,326812,326813,326816,1,4,0
93434,1,3,326813,326816,326819,3,6,0
93435,5,3,326818,326819,326822,1,4,0
93436,6,2,326824,326824,326826,0,2,2
93437,4,2,326828,326828,326830,0,2,2
93438,4,1,326832,326832,326833,0,1,2
93439,3,2,326835,326835,326837,0,2,2
93440,4,3,326839,326839,326842,0,3,2
93441,5,3,326844,326844,326847,0,3,2
93442,6,2,326850,326850,326852,0,2,3
93443,2,2,326852,326852,326854,0,2,0
93444,4,2,326856,326856,326858,0,2,2
93445,3,1,326859,326859,326860,0,1,1
93446,1,1,326860,326860,326861,0,1,0
93447,3,1,326863,326863,326864,0,1,2
93448,2,1,326865,326865,326866,0,1,1
93449,4,3,326869,326869,326872,0,3,3
93450,6,3,326875,326875,326878,0,3,3
93451,1,3,326876,326878,326881,2,5,0
93452,5,2,326881,326881,326883,0,2,0
93453,3,3,326884,326884,326887,0,3,1
93454,1,1,326885,326887,326888,2,3,0
93455,4,1,326889,326889,326890,0,1,1
93456,6,3,326895,326895,326898,0,3,5
93457,4,1,326899,326899,326900,0,1,1
93458,4,1,326903,326903,326904,0,1,3
93459,5,2,326908,326908,326910,0,2,4
93460,1,2,326909,326910,326912,1,3,0
93461,4,3,326913,326913,326916,0,3,1
93462,6,3,326919,326919,326922,0,3,3
93463,6,2,326925,326925,326927,0,2,3
93464,5,1,326930,326930,326931,0,1,3
93465,6,1,326936,326936,326937,0,1,5
93466,3,1,326939,326939,326940,0,1,2
93467,6,3,326945,326945,326948,0,3,5
93468,3,1,326948,326948,326949,0,1,0
93469,1,3,326949,326949,326952,0,3,0
93470,6,3,326955,326955,326958,0,3,3
93471,6,3,326961,326961,326964,0,3,3
93472,4,1,326965,326965,326966,0,1,1
93473,3,3,326968,326968,326971,0,3,2
93474,6,1,326974,326974,326975,0,1,3
93475,4,1,326978,326978,326979,0,1,3
93476,3,2,326981,326981,326983,0,2,2
93477,3,2,326984,326984,326986,0,2,1
93478,1,1,326985,326986,326987,1,2,0
93479,5,3,326990,326990,326993,0,3,3
93480,3,1,326993,326993,326994,0,1,0
93481,1,3,326994,326994,326997,0,3,0
93482,2,1,326996,326997,326998,1,2,0
93483,6,2,327002,327002,327004,0,2,4
93484,6,2,327008,327008,327010,0,2,4
93485,6,2,327014,327014,327016,0,2,4
93486,3,2,327017,327017,327019,0,2,1
93487,2,3,327019,327019,327022,0,3,0
93488,6,1,327025,327025,327026,0,1,3
93489,1,2,327026,327026,327028,0,2,0
93490,3,1,327029,327029,327030,0,1,1
93491,1,3,327030,327030,327033,0,3,0
93492,4,2,327034,327034,327036,0,2,1
93493,5,1,327039,327039,327040,0,1,3
93494,4,1,327043,327043,327044,0,1,3
93495,3,1,327046,327046,327047,0,1,2
93496,6,3,327052,327052,327055,0,3,5
93497,3,3,327055,327055,327058,0,3,0
93498,6,1,327061,327061,327062,0,1,3
93499,4,2,327065,327065,327067,0,2,3
93500,2,1,327067,327067,327068,0,1,0
93501,5,3,327072,327072,327075,0,3,4
93502,4,1,327076,327076,327077,0,1,1
93503,1,3,327077,327077,327080,0,3,0
93504,3,3,327080,327080,327083,0,3,0
93505,2,2,327082,327083,327085,1,3,0
93506,2,3,327084,327085,327088,1,4,0
93507,4,3,327088,327088,327091,0,3,0
93508,6,3,327094,327094,327097,0,3,3
93509,3,2,327097,327097,327099,0,2,0
93510,4,3,327101,327101,327104,0,3,2
93511,2,2,327103,327104,327106,1,3,0
93512,1,1,327104,327106,327107,2,3,0
93513,6,2,327110,327110,327112,0,2,3
93514,2,2,327112,327112,327114,0,2,0
93515,3,3,327115,327115,327118,0,3,1
93516,5,1,327120,327120,327121,0,1,2
93517,6,2,327126,327126,327128,0,2,5
93518,3,1,327129,327129,327130,0,1,1
93519,5,2,327134,327134,327136,0,2,4
93520,6,1,327140,327140,327141,0,1,4
93521,1,1,327141,327141,327142,0,1,0
93522,4,1,327145,327145,327146,0,1,3
93523,3,3,327148,327148,327151,0,3,2
93524,5,1,327153,327153,327154,0,1,2
93525,1,1,327154,327154,327155,0,1,0
93526,5,2,327159,327159,327161,0,2,4
93527,2,3,327161,327161,327164,0,3,0
93528,3,1,327164,327164,327165,0,1,0
93529,2,3,327166,327166,327169,0,3,1
93530,3,1,327169,327169,327170,0,1,0
93531,5,2,327174,327174,327176,0,2,4
93532,4,3,327178,327178,327181,0,3,2
93533,6,1,327184,327184,327185,0,1,3
93534,2,3,327186,327186,327189,0,3,1
93535,4,2,327190,327190,327192,0,2,1
93536,5,3,327195,327195,327198,0,3,3
93537,5,2,327200,327200,327202,0,2,2
93538,6,3,327206,327206,327209,0,3,4
93539,3,2,327209,327209,327211,0,2,0
93540,4,2,327213,327213,327215,0,2,2
93541,3,1,327216,327216,327217,0,1,1
93542,1,1,327217,327217,327218,0,1,0
93543,6,3,327223,327223,327226,0,3,5
93544,2,2,327225,327226,327228,1,3,0
93545,3,1,327228,327228,327229,0,1,0
93546,1,1,327229,327229,327230,0,1,0
93547,3,2,327232,327232,327234,0,2,2
93548,3,2,327235,327235,327237,0,2,1
93549,6,3,327241,327241,327244,0,3,4
93550,6,2,327247,327247,327249,0,2,3
93551,4,2,327251,327251,327253,0,2,2
93552,3,3,327254,327254,327257,0,3,1
93553,4,2,327258,327258,327260,0,2,1
93554,6,2,327264,327264,327266,0,2,4
93555,4,1,327268,327268,327269,0,1,2
93556,6,2,327274,327274,327276,0,2,5
93557,3,1,327277,327277,327278,0,1,1
93558,2,1,327279,327279,327280,0,1,1
93559,5,2,327284,327284,327286,0,2,4
93560,4,3,327288,327288,327291,0,3,2
93561,3,2,327291,327291,327293,0,2,0
93562,2,1,327293,327293,327294,0,1,0
93563,3,1,327296,327296,327297,0,1,2
93564,2,1,327298,327298,327299,0,1,1
93565,6,3,327304,327304,327307,0,3,5
93566,5,3,327309,327309,327312,0,3,2
93567,4,1,327313,327313,327314,0,1,1
93568,3,1,327316,327316,327317,0,1,2
93569,2,2,327318,327318,327320,0,2,1
93570,4,2,327322,327322,327324,0,2,2
93571,2,2,327324,327324,327326,0,2,0
93572,5,1,327329,327329,327330,0,1,3
93573,3,1,327332,327332,327333,0,1,2
93574,2,2,327334,327334,327336,0,2,1
93575,6,1,327340,327340,327341,0,1,4
93576,2,2,327342,327342,327344,0,2,1
93577,1,2,327343,327344,327346,1,3,0
93578,6,1,327349,327349,327350,0,1,3
93579,1,2,327350,327350,327352,0,2,0
93580,3,3,327353,327353,327356,0,3,1
93581,3,1,327356,327356,327357,0,1,0
93582,5,1,327361,327361,327362,0,1,4
93583,6,1,327367,327367,327368,0,1,5
93584,1,1,327368,327368,327369,0,1,0
93585,2,3,327370,327370,327373,0,3,1
93586,3,3,327373,327373,327376,0,3,0
93587,3,1,327376,327376,327377,0,1,0
93588,4,2,327380,327380,327382,0,2,3
93589,4,2,327384,327384,327386,0,2,2
93590,2,2,327386,327386,327388,0,2,0
93591,1,1,327387,327388,327389,1,2,0
93592,6,3,327393,327393,327396,0,3,4
93593,6,3,327399,327399,327402,0,3,3
93594,2,1,327401,327402,327403,1,2,0
93595,4,1,327405,327405,327406,0,1,2
93596,3,3,327408,327408,327411,0,3,2
93597,5,3,327413,327413,327416,0,3,2
93598,2,1,327415,327416,327417,1,2,0
93599,4,1,327419,327419,327420,0,1,2
93600,1,2,327420,327420,327422,0,2,0
93601,2,2,327422,327422,327424,0,2,0
93602,5,2,327427,327427,327429,0,2,3
93603,1,3,327428,327429,327432,1,4,0
93604,3,2,327431,327432,327434,1,3,0
93605,3,1,327434,327434,327435,0,1,0
93606,6,2,327440,327440,327442,0,2,5
93607,3,1,327443,327443,327444,0,1,1
93608,1,3,327444,327444,327447,0,3,0
93609,4,2,327448,327448,327450,0,2,1
93610,4,1,327452,327452,327453,0,1,2
93611,6,2,327458,327458,327460,0,2,5
93612,6,2,327464,327464,327466,0,2,4
93613,3,2,327467,327467,327469,0,2,1
93614,1,2,327468,327469,327471,1,3,0
93615,4,1,327472,327472,327473,0,1,1
93616,5,1,327477,327477,327478,0,1,4
93617,6,3,327483,327483,327486,0,3,5
93618,6,2,327489,327489,327491,0,2,3
93619,2,1,327491,327491,327492,0,1,0
93620,6,1,327497,327497,327498,0,1,5
93621,1,1,327498,327498,327499,0,1,0
93622,1,1,327499,327499,327500,0,1,0
93623,3,2,327502,327502,327504,0,2,2
93624,1,3,327503,327504,327507,1,4,0
93625,2,2,327505,327507,327509,2,4,0
93626,5,3,327510,327510,327513,0,3,1
93627,2,2,327512,327513,327515,1,3,0
93628,5,3,327517,327517,327520,0,3,2
93629,6,1,327523,327523,327524,0,1,3
93630,6,1,327529,327529,327530,0,1,5
93631,5,2,327534,327534,327536,0,2,4
93632,4,3,327538,327538,327541,0,3,2
93633,5,3,327543,327543,327546,0,3,2
93634,1,1,327544,327546,327547,2,3,0
93635,5,2,327549,327549,327551,0,2,2
93636,4,2,327553,327553,327555,0,2,2
93637,5,3,327558,327558,327561,0,3,3
93638,3,3,327561,327561,327564,0,3,0
93639,3,1,327564,327564,327565,0,1,0
93640,2,1,327566,327566,327567,0,1,1
93641,5,2,327571,327571,327573,0,2,4
93642,5,1,327576,327576,327577,0,1,3
93643,1,2,327577,327577,327579,0,2,0
93644,5,1,327582,327582,327583,0,1,3
93645,1,1,327583,327583,327584,0,1,0
93646,6,1,327589,327589,327590,0,1,5
93647,6,3,327595,327595,327598,0,3,5
93648,1,1,327596,327598,327599,2,3,0
93649,1,1,327597,327599,327600,2,3,0
93650,2,3,327599,327600,327603,1,4,0
93651,5,1,327604,327604,327605,0,1,1
93652,1,2,327605,327605,327607,0,2,0
93653,3,3,327608,327608,327611,0,3,1
93654,4,1,327612,327612,327613,0,1,1
93655,2,3,327614,327614,327617,0,3,1
93656,5,1,327619,327619,327620,0,1,2
93657,5,2,327624,327624,327626,0,2,4
93658,2,1,327626,327626,327627,0,1,0
93659,3,1,327629,327629,327630,0,1,2
93660,1,2,327630,327630,327632,0,2,0
93661,4,3,327634,327634,327637,0,3,2
93662,2,3,327636,327637,327640,1,4,0
93663,3,2,327639,327640,327642,1,3,0
93664,3,1,327642,327642,327643,0,1,0
93665,2,2,327644,327644,327646,0,2,1
93666,5,2,327649,327649,327651,0,2,3
93667,4,2,327653,327653,327655,0,2,2
93668,3,2,327656,327656,327658,0,2,1
93669,6,1,327662,327662,327663,0,1,4
93670,4,2,327666,327666,327668,0,2,3
93671,3,1,327669,327669,327670,0,1,1
93672,1,2,327670,327670,327672,0,2,0
93673,3,1,327673,327673,327674,0,1,1
93674,6,2,327679,327679,327681,0,2,5
93675,6,2,327685,327685,327687,0,2,4
93676,2,3,327687,327687,327690,0,3,0
93677,2,3,327689,327690,327693,1,4,0
93678,5,3,327694,327694,327697,0,3,1
93679,5,2,327699,327699,327701,0,2,2
93680,4,3,327703,327703,327706,0,3,2
93681,4,3,327707,327707,327710,0,3,1
93682,3,3,327710,327710,327713,0,3,0
93683,3,3,327713,327713,327716,0,3,0
93684,4,1,327717,327717,327718,0,1,1
93685,3,3,327720,327720,327723,0,3,2
93686,1,2,327721,327723,327725,2,4,0
93687,1,3,327722,327725,327728,3,6,0
93688,6,2,327728,327728,327730,0,2,0
93689,4,2,327732,327732,327734,0,2,2
93690,3,2,327735,327735,327737,0,2,1
93691,6,2,327741,327741,327743,0,2,4
93692,1,3,327742,327743,327746,1,4,0
93693,1,1,327743,327746,327747,3,4,0
93694,5,2,327748,327748,327750,0,2,1
93695,5,2,327753,327753,327755,0,2,3
93696,6,1,327759,327759,327760,0,1,4
93697,5,1,327764,327764,327765,0,1,4
93698,4,2,327768,327768,327770,0,2,3
93699,1,3,327769,327770,327773,1,4,0
93700,1,3,327770,327773,327776,3,6,0
93701,1,1,327771,327776,327777,5,6,0
93702,3,2,327774,327777,327779,3,5,0
93703,6,2,327780,327780,327782,0,2,1
93704,5,2,327785,327785,327787,0,2,3
93705,5,2,327790,327790,327792,0,2,3
93706,3,3,327793,327793,327796,0,3,1
93707,2,1,327795,327796,327797,1,2,0
93708,4,2,327799,327799,327801,0,2,2
93709,2,3,327801,327801,327804,0,3,0
93710,3,1,327804,327804,327805,0,1,0
93711,4,3,327808,327808,327811,0,3,3
93712,6,2,327814,327814,327816,0,2,3
93713,4,1,327818,327818,327819,0,1,2
93714,3,3,327821,327821,327824,0,3,2
93715,6,2,327827,327827,327829,0,2,3
93716,4,1,327831,327831,327832,0,1,2
93717,3,2,327834,327834,327836,0,2,2
93718,5,1,327839,327839,327840,0,1,3
93719,5,3,327844,327844,327847,0,3,4
93720,1,3,327845,327847,327850,2,5,0
93721,1,1,327846,327850,327851,4,5,0
93722,3,1,327849,327851,327852,2,3,0
93723,6,3,327855,327855,327858,0,3,3
93724,2,3,327857,327858,327861,1,4,0
93725,6,3,327863,327863,327866,0,3,2
93726,5,2,327868,327868,327870,0,2,2
93727,2,3,327870,327870,327873,0,3,0
93728,3,2,327873,327873,327875,0,2,0
93729,6,3,327879,327879,327882,0,3,4
93730,4,3,327883,327883,327886,0,3,1
93731,5,1,327888,327888,327889,0,1,2
93732,1,1,327889,327889,327890,0,1,0
93733,1,1,327890,327890,327891,0,1,0
93734,3,1,327893,327893,327894,0,1,2
93735,3,1,327896,327896,327897,0,1,2
93736,5,3,327901,327901,327904,0,3,4
93737,4,2,327905,327905,327907,0,2,1
93738,3,2,327908,327908,327910,0,2,1
93739,4,3,327912,327912,327915,0,3,2
93740,3,1,327915,327915,327916,0,1,0
93741,4,2,327919,327919,327921,0,2,3
93742,2,3,327921,327921,327924,0,3,0
93743,1,1,327922,327924,327925,2,3,0
93744,6,3,327928,327928,327931,0,3,3
93745,2,1,327930,327931,327932,1,2,0
93746,2,1,327932,327932,327933,0,1,0
93747,4,3,327936,327936,327939,0,3,3
93748,5,3,327941,327941,327944,0,3,2
93749,5,3,327946,327946,327949,0,3,2
93750,3,1,327949,327949,327950,0,1,0
93751,5,1,327954,327954,327955,0,1,4
93752,1,1,327955,327955,327956,0,1,0
93753,6,3,327961,327961,327964,0,3,5
93754,3,2,327964,327964,327966,0,2,0
93755,4,3,327968,327968,327971,0,3,2
93756,5,1,327973,327973,327974,0,1,2
93757,3,1,327976,327976,327977,0,1,2
93758,2,1,327978,327978,327979,0,1,1
93759,3,3,327981,327981,327984,0,3,2
93760,6,3,327987,327987,327990,0,3,3
93761,2,3,327989,327990,327993,1,4,0
93762,6,3,327995,327995,327998,0,3,2
93763,3,1,327998,327998,327999,0,1,0
93764,1,1,327999,327999,328000,0,1,0
93765,2,1,328001,328001,328002,0,1,1
93766,6,3,328007,328007,328010,0,3,5
93767,5,1,328012,328012,328013,0,1,2
93768,2,2,328014,328014,328016,0,2,1
93769,6,2,328020,328020,328022,0,2,4
93770,4,1,328024,328024,328025,0,1,2
93771,4,2,328028,328028,328030,0,2,3
93772,2,2,328030,328030,328032,0,2,0
93773,6,2,328036,328036,328038,0,2,4
93774,5,3,328041,328041,328044,0,3,3
93775,6,1,328047,328047,328048,0,1,3
93776,3,3,328050,328050,328053,0,3,2
93777,3,3,328053,328053,328056,0,3,0
93778,1,3,328054,328056,328059,2,5,0
93779,5,2,328059,328059,328061,0,2,0
93780,3,3,328062,328062,328065,0,3,1
93781,6,2,328068,328068,328070,0,2,3
93782,4,2,328072,328072,328074,0,2,2
93783,5,1,328077,328077,328078,0,1,3
93784,4,1,328081,328081,328082,0,1,3
93785,5,3,328086,328086,328089,0,3,4
93786,3,1,328089,328089,328090,0,1,0
93787,2,2,328091,328091,328093,0,2,1
93788,3,1,328094,328094,328095,0,1,1
93789,3,3,328097,328097,328100,0,3,2
93790,2,3,328099,328100,328103,1,4,0
93791,2,2,328101,328103,328105,2,4,0
93792,5,1,328106,328106,328107,0,1,1
93793,6,3,328112,328112,328115,0,3,5
93794,3,1,328115,328115,328116,0,1,0
93795,2,1,328117,328117,328118,0,1,1
93796,1,3,328118,328118,328121,0,3,0
93797,4,3,328122,328122,328125,0,3,1
93798,1,3,328123,328125,328128,2,5,0
93799,1,3,328124,328128,328131,4,7,0
93800,3,3,328127,328131,328134,4,7,0
93801,1,3,328128,328134,328137,6,9,0
93802,6,1,328134,328137,328138,3,4,0
93803,1,3,328135,328138,328141,3,6,0
93804,6,3,328141,328141,328144,0,3,0
93805,3,2,328144,328144,328146,0,2,0
93806,1,1,328145,328146,328147,1,2,0
93807,3,1,328148,328148,328149,0,1,1
93808,6,1,328154,328154,328155,0,1,5
93809,2,1,328156,328156,328157,0,1,1
93810,6,3,328162,328162,328165,0,3,5
93811,6,2,328168,328168,328170,0,2,3
93812,5,1,328173,328173,328174,0,1,3
93813,3,3,328176,328176,328179,0,3,2
93814,2,3,328178,328179,328182,1,4,0
93815,6,2,328184,328184,328186,0,2,2
93816,2,3,328186,328186,328189,0,3,0
93817,1,3,328187,328189,328192,2,5,0
93818,3,1,328190,328192,328193,2,3,0
93819,1,2,328191,328193,328195,2,4,0
93820,1,2,328192,328195,328197,3,5,0
93821,1,2,328193,328197,328199,4,6,0
93822,2,3,328195,328199,328202,4,7,0
93823,2,3,328197,328202,328205,5,8,0
93824,1,3,328198,328205,328208,7,10,0
93825,4,3,328202,328208,328211,6,9,0
93826,6,3,328208,328211,328214,3,6,0
93827,5,2,328213,328214,328216,1,3,0
93828,1,3,328214,328216,328219,2,5,0
93829,3,2,328217,328219,328221,2,4,0
93830,3,2,328220,328221,328223,1,3,0
93831,5,1,328225,328225,328226,0,1,2
93832,5,3,328230,328230,328233,0,3,4
93833,5,2,328235,328235,328237,0,2,2
93834,1,1,328236,328237,328238,1,2,0
93835,1,1,328237,328238,328239,1,2,0
93836,5,2,328242,328242,328244,0,2,3
93837,4,2,328246,328246,328248,0,2,2
93838,6,2,328252,328252,328254,0,2,4
93839,6,1,328258,328258,328259,0,1,4
93840,2,3,328260,328260,328263,0,3,1
93841,4,2,328264,328264,328266,0,2,1
93842,5,2,328269,328269,328271,0,2,3
93843,1,2,328270,328271,328273,1,3,0
93844,1,3,328271,328273,328276,2,5,0
93845,1,2,328272,328276,328278,4,6,0
93846,3,3,328275,328278,328281,3,6,0
93847,4,2,328279,328281,328283,2,4,0
93848,6,2,328285,328285,328287,0,2,2
93849,2,1,328287,328287,328288,0,1,0
93850,3,1,328290,328290,328291,0,1,2
93851,6,3,328296,328296,328299,0,3,5
93852,5,3,328301,328301,328304,0,3,2
93853,6,3,328307,328307,328310,0,3,3
93854,6,3,328313,328313,328316,0,3,3
93855,1,3,328314,328316,328319,2,5,0
93856,1,2,328315,328319,328321,4,6,0
93857,3,3,328318,328321,328324,3,6,0
93858,5,2,328323,328324,328326,1,3,0
93859,2,2,328325,328326,328328,1,3,0
93860,4,3,328329,328329,328332,0,3,1
93861,2,1,328331,328332,328333,1,2,0
93862,3,1,328334,328334,328335,0,1,1
93863,3,1,328337,328337,328338,0,1,2
93864,6,1,328343,328343,328344,0,1,5
93865,5,2,328348,328348,328350,0,2,4
93866,3,1,328351,328351,328352,0,1,1
93867,3,3,328354,328354,328357,0,3,2
93868,6,2,328360,328360,328362,0,2,3
93869,6,2,328366,328366,328368,0,2,4
93870,4,1,328370,328370,328371,0,1,2
93871,5,3,328375,328375,328378,0,3,4
93872,6,2,328381,328381,328383,0,2,3
93873,4,1,328385,328385,328386,0,1,2
93874,6,2,328391,328391,328393,0,2,5
93875,6,2,328397,328397,328399,0,2,4
93876,4,2,328401,328401,328403,0,2,2
93877,2,3,328403,328403,328406,0,3,0
93878,5,3,328408,328408,328411,0,3,2
93879,1,3,328409,328411,328414,2,5,0
93880,4,2,328413,328414,328416,1,3,0
93881,2,1,328415,328416,328417,1,2,0
93882,3,1,328418,328418,328419,0,1,1
93883,3,3,328421,328421,328424,0,3,2
93884,1,2,328422,328424,328426,2,4,0
93885,4,1,328426,328426,328427,0,1,0
93886,6,2,328432,328432,328434,0,2,5
93887,1,1,328433,328434,328435,1,2,0
93888,4,1,328437,328437,328438,0,1,2
93889,1,1,328438,328438,328439,0,1,0
93890,2,2,328440,328440,328442,0,2,1
93891,6,2,328446,328446,328448,0,2,4
93892,2,3,328448,328448,328451,0,3,0
93893,4,3,328452,328452,328455,0,3,1
93894,3,1,328455,328455,328456,0,1,0
93895,5,3,328460,328460,328463,0,3,4
93896,1,1,328461,328463,328464,2,3,0
93897,5,3,328466,328466,328469,0,3,2
93898,6,1,328472,328472,328473,0,1,3
93899,3,2,328475,328475,328477,0,2,2
93900,1,3,328476,328477,328480,1,4,0
93901,2,2,328478,328480,328482,2,4,0
93902,6,2,328484,328484,328486,0,2,2
93903,5,3,328489,328489,328492,0,3,3
93904,2,3,328491,328492,328495,1,4,0
93905,3,3,328494,328495,328498,1,4,0
93906,3,3,328497,328498,328501,1,4,0
93907,4,1,328501,328501,328502,0,1,0
93908,3,1,328504,328504,328505,0,1,2
93909,3,2,328507,328507,328509,0,2,2
93910,6,1,328513,328513,328514,0,1,4
93911,5,3,328518,328518,328521,0,3,4
93912,2,2,328520,328521,328523,1,3,0
93913,6,3,328526,328526,328529,0,3,3
93914,2,1,328528,328529,328530,1,2,0
93915,6,1,328534,328534,328535,0,1,4
93916,2,3,328536,328536,328539,0,3,1
93917,2,2,328538,328539,328541,1,3,0
93918,5,2,328543,328543,328545,0,2,2
93919,1,2,328544,328545,328547,1,3,0
93920,3,2,328547,328547,328549,0,2,0
93921,4,3,328551,328551,328554,0,3,2
93922,2,1,328553,328554,328555,1,2,0
93923,1,2,328554,328555,328557,1,3,0
93924,4,2,328558,328558,328560,0,2,1
93925,5,2,328563,328563,328565,0,2,3
93926,2,1,328565,328565,328566,0,1,0
93927,6,3,328571,328571,328574,0,3,5
93928,4,2,328575,328575,328577,0,2,1
93929,6,1,328581,328581,328582,0,1,4
93930,5,3,328586,328586,328589,0,3,4
93931,5,3,328591,328591,328594,0,3,2
93932,5,3,328596,328596,328599,0,3,2
93933,4,2,328600,328600,328602,0,2,1
93934,3,3,328603,328603,328606,0,3,1
93935,1,3,328604,328606,328609,2,5,0
93936,2,3,328606,328609,328612,3,6,0
93937,1,3,328607,328612,328615,5,8,0
93938,4,2,328611,328615,328617,4,6,0
93939,6,2,328617,328617,328619,0,2,0
93940,4,2,328621,328621,328623,0,2,2
93941,1,2,328622,328623,328625,1,3,0
93942,1,1,328623,328625,328626,2,3,0
93943,3,3,328626,328626,328629,0,3,0
93944,6,3,328632,328632,328635,0,3,3
93945,6,2,328638,328638,328640,0,2,3
93946,5,1,328643,328643,328644,0,1,3
93947,5,1,328648,328648,328649,0,1,4
93948,5,3,328653,328653,328656,0,3,4
93949,6,1,328659,328659,328660,0,1,3
93950,5,3,328664,328664,328667,0,3,4
93951,6,2,328670,328670,328672,0,2,3
93952,4,2,328674,328674,328676,0,2,2
93953,2,2,328676,328676,328678,0,2,0
93954,5,1,328681,328681,328682,0,1,3
93955,3,1,328684,328684,328685,0,1,2
93956,4,2,328688,328688,328690,0,2,3
93957,1,1,328689,328690,328691,1,2,0
93958,6,1,328695,328695,328696,0,1,4
93959,1,3,328696,328696,328699,0,3,0
93960,5,1,328701,328701,328702,0,1,2
93961,3,2,328704,328704,328706,0,2,2
93962,3,3,328707,328707,328710,0,3,1
93963,2,3,328709,328710,328713,1,4,0
93964,6,3,328715,328715,328718,0,3,2
93965,4,3,328719,328719,328722,0,3,1
93966,5,1,328724,328724,328725,0,1,2
93967,4,1,328728,328728,328729,0,1,3
93968,4,1,328732,328732,328733,0,1,3
93969,1,2,328733,328733,328735,0,2,0
93970,2,2,328735,328735,328737,0,2,0
93971,1,2,328736,328737,328739,1,3,0
93972,5,1,328741,328741,328742,0,1,2
93973,5,1,328746,328746,328747,0,1,4
93974,1,1,328747,328747,328748,0,1,0
93975,4,3,328751,328751,328754,0,3,3
93976,1,1,328752,328754,328755,2,3,0
93977,3,2,328755,328755,328757,0,2,0
93978,3,2,328758,328758,328760,0,2,1
93979,2,3,328760,328760,328763,0,3,0
93980,3,3,328763,328763,328766,0,3,0
93981,5,3,328768,328768,328771,0,3,2
93982,2,3,328770,328771,328774,1,4,0
93983,2,2,328772,328774,328776,2,4,0
93984,6,2,328778,328778,328780,0,2,2
93985,5,2,328783,328783,328785,0,2,3
93986,6,2,328789,328789,328791,0,2,4
93987,1,3,328790,328791,328794,1,4,0
93988,4,1,328794,328794,328795,0,1,0
93989,1,1,328795,328795,328796,0,1,0
93990,3,3,328798,328798,328801,0,3,2
93991,3,2,328801,328801,328803,0,2,0
93992,3,2,328804,328804,328806,0,2,1
93993,4,2,328808,328808,328810,0,2,2
93994,5,1,328813,328813,328814,0,1,3
93995,1,3,328814,328814,328817,0,3,0
93996,1,2,328815,328817,328819,2,4,0
93997,4,3,328819,328819,328822,0,3,0
93998,6,2,328825,328825,328827,0,2,3
93999,2,3,328827,328827,328830,0,3,0
94000,5,1,328832,328832,328833,0,1,2
94001,4,1,328836,328836,328837,0,1,3
94002,6,1,328842,328842,328843,0,1,5
94003,3,2,328845,328845,328847,0,2,2
94004,4,3,328849,328849,328852,0,3,2
94005,4,2,328853,328853,328855,0,2,1
94006,6,3,328859,328859,328862,0,3,4
94007,6,1,328865,328865,328866,0,1,3
94008,3,1,328868,328868,328869,0,1,2
94009,3,2,328871,328871,328873,0,2,2
94010,2,2,328873,328873,328875,0,2,0
94011,6,3,328879,328879,328882,0,3,4
94012,3,3,328882,328882,328885,0,3,0
94013,6,1,328888,328888,328889,0,1,3
94014,3,3,328891,328891,328894,0,3,2
94015,1,3,328892,328894,328897,2,5,0
94016,3,3,328895,328897,328900,2,5,0
94017,2,2,328897,328900,328902,3,5,0
94018,3,1,328900,328902,328903,2,3,0
94019,5,1,328905,328905,328906,0,1,2
94020,4,2,328909,328909,328911,0,2,3
94021,3,3,328912,328912,328915,0,3,1
94022,5,2,328917,328917,328919,0,2,2
94023,3,1,328920,328920,328921,0,1,1
94024,1,2,328921,328921,328923,0,2,0
94025,2,3,328923,328923,328926,0,3,0
94026,2,3,328925,328926,328929,1,4,0
94027,6,2,328931,328931,328933,0,2,2
94028,5,2,328936,328936,328938,0,2,3
94029,2,1,328938,328938,328939,0,1,0
94030,2,2,328940,328940,328942,0,2,1
94031,4,1,328944,328944,328945,0,1,2
94032,4,2,328948,328948,328950,0,2,3
94033,5,2,328953,328953,328955,0,2,3
94034,3,2,328956,328956,328958,0,2,1
94035,4,2,328960,328960,328962,0,2,2
94036,3,2,328963,328963,328965,0,2,1
94037,1,1,328964,328965,328966,1,2,0
94038,4,2,328968,328968,328970,0,2,2
94039,3,3,328971,328971,328974,0,3,1
94040,2,3,328973,328974,328977,1,4,0
94041,6,1,328979,328979,328980,0,1,2
94042,6,3,328985,328985,328988,0,3,5
94043,2,2,328987,328988,328990,1,3,0
94044,5,2,328992,328992,328994,0,2,2
94045,3,3,328995,328995,328998,0,3,1
94046,4,2,328999,328999,329001,0,2,1
94047,5,1,329004,329004,329005,0,1,3
94048,2,1,329006,329006,329007,0,1,1
94049,4,2,329010,329010,329012,0,2,3
94050,4,3,329014,329014,329017,0,3,2
94051,2,1,329016,329017,329018,1,2,0
94052,4,1,329020,329020,329021,0,1,2
94053,4,2,329024,329024,329026,0,2,3
94054,1,2,329025,329026,329028,1,3,0
94055,4,1,329029,329029,329030,0,1,1
94056,1,2,329030,329030,329032,0,2,0
94057,2,3,329032,329032,329035,0,3,0
94058,2,2,329034,329035,329037,1,3,0
94059,3,1,329037,329037,329038,0,1,0
94060,4,2,329041,329041,329043,0,2,3
94061,4,1,329045,329045,329046,0,1,2
94062,5,1,329050,329050,329051,0,1,4
94063,4,3,329054,329054,329057,0,3,3
94064,4,2,329058,329058,329060,0,2,1
94065,4,3,329062,329062,329065,0,3,2
94066,5,2,329067,329067,329069,0,2,2
94067,3,2,329070,329070,329072,0,2,1
94068,2,1,329072,329072,329073,0,1,0
94069,3,2,329075,329075,329077,0,2,2
94070,1,2,329076,329077,329079,1,3,0
94071,1,2,329077,329079,329081,2,4,0
94072,4,3,329081,329081,329084,0,3,0
94073,5,3,329086,329086,329089,0,3,2
94074,5,3,329091,329091,329094,0,3,2
94075,3,3,329094,329094,329097,0,3,0
94076,6,2,329100,329100,329102,0,2,3
94077,6,1,329106,329106,329107,0,1,4
94078,6,2,329112,329112,329114,0,2,5
94079,2,2,329114,329114,329116,0,2,0
94080,2,3,329116,329116,329119,0,3,0
94081,5,3,329121,329121,329124,0,3,2
94082,3,2,329124,329124,329126,0,2,0
94083,3,1,329127,329127,329128,0,1,1
94084,1,2,329128,329128,329130,0,2,0
94085,2,2,329130,329130,329132,0,2,0
94086,2,3,329132,329132,329135,0,3,0
94087,4,2,329136,329136,329138,0,2,1
94088,5,2,329141,329141,329143,0,2,3
94089,3,2,329144,329144,329146,0,2,1
94090,3,3,329147,329147,329150,0,3,1
94091,4,2,329151,329151,329153,0,2,1
94092,2,2,329153,329153,329155,0,2,0
94093,3,2,329156,329156,329158,0,2,1
94094,2,2,329158,329158,329160,0,2,0
94095,1,3,329159,329160,329163,1,4,0
94096,3,1,329162,329163,329164,1,2,0
94097,5,2,329167,329167,329169,0,2,3
94098,4,3,329171,329171,329174,0,3,2
94099,3,2,329174,329174,329176,0,2,0
94100,4,1,329178,329178,329179,0,1,2
94101,6,2,329184,329184,329186,0,2,5
94102,6,1,329190,329190,329191,0,1,4
94103,4,3,329194,329194,329197,0,3,3
94104,6,1,329200,329200,329201,0,1,3
94105,3,3,329203,329203,329206,0,3,2
94106,5,1,329208,329208,329209,0,1,2
94107,3,2,329211,329211,329213,0,2,2
94108,6,3,329217,329217,329220,0,3,4
94109,4,3,329221,329221,329224,0,3,1
94110,2,3,329223,329224,329227,1,4,0
94111,1,2,329224,329227,329229,3,5,0
94112,5,1,329229,329229,329230,0,1,0
94113,1,1,329230,329230,329231,0,1,0
94114,3,2,329233,329233,329235,0,2,2
94115,6,2,329239,329239,329241,0,2,4
94116,6,3,329245,329245,329248,0,3,4
94117,6,1,329251,329251,329252,0,1,3
94118,2,1,329253,329253,329254,0,1,1
94119,5,1,329258,329258,329259,0,1,4
94120,6,3,329264,329264,329267,0,3,5
94121,3,2,329267,329267,329269,0,2,0
94122,3,3,329270,329270,329273,0,3,1
94123,6,1,329276,329276,329277,0,1,3
94124,6,3,329282,329282,329285,0,3,5
94125,3,2,329285,329285,329287,0,2,0
94126,2,3,329287,329287,329290,0,3,0
94127,3,1,329290,329290,329291,0,1,0
94128,6,1,329296,329296,329297,0,1,5
94129,6,2,329302,329302,329304,0,2,5
94130,1,1,329303,329304,329305,1,2,0
94131,1,3,329304,329305,329308,1,4,0
94132,2,2,329306,329308,329310,2,4,0
94133,6,2,329312,329312,329314,0,2,2
94134,2,2,329314,329314,329316,0,2,0
94135,1,1,329315,329316,329317,1,2,0
94136,1,3,329316,329317,329320,1,4,0
94137,2,3,329318,329320,329323,2,5,0
94138,4,2,329322,329323,329325,1,3,0
94139,5,1,329327,329327,329328,0,1,2
94140,2,1,329329,329329,329330,0,1,1
94141,4,3,329333,329333,329336,0,3,3
94142,1,3,329334,329336,329339,2,5,0
94143,4,2,329338,329339,329341,1,3,0
94144,1,2,329339,329341,329343,2,4,0
94145,5,2,329344,329344,329346,0,2,1
94146,2,1,329346,329346,329347,0,1,0
94147,1,1,329347,329347,329348,0,1,0
94148,4,2,329351,329351,329353,0,2,3
94149,3,1,329354,329354,329355,0,1,1
94150,3,1,329357,329357,329358,0,1,2
94151,3,2,329360,329360,329362,0,2,2
94152,6,3,329366,329366,329369,0,3,4
94153,2,2,329368,329369,329371,1,3,0
94154,4,2,329372,329372,329374,0,2,1
94155,4,3,329376,329376,329379,0,3,2
94156,2,2,329378,329379,329381,1,3,0
94157,6,3,329384,329384,329387,0,3,3
94158,5,1,329389,329389,329390,0,1,2
94159,6,3,329395,329395,329398,0,3,5
94160,5,3,329400,329400,329403,0,3,2
94161,2,1,329402,329403,329404,1,2,0
94162,6,3,329408,329408,329411,0,3,4
94163,2,2,329410,329411,329413,1,3,0
94164,4,2,329414,329414,329416,0,2,1
94165,6,1,329420,329420,329421,0,1,4
94166,5,2,329425,329425,329427,0,2,4
94167,1,1,329426,329427,329428,1,2,0
94168,1,2,329427,329428,329430,1,3,0
94169,5,1,329432,329432,329433,0,1,2
94170,4,2,329436,329436,329438,0,2,3
94171,2,2,329438,329438,329440,0,2,0
94172,2,2,329440,329440,329442,0,2,0
94173,4,1,329444,329444,329445,0,1,2
94174,1,1,329445,329445,329446,0,1,0
94175,6,2,329451,329451,329453,0,2,5
94176,1,3,329452,329453,329456,1,4,0
94177,3,3,329455,329456,329459,1,4,0
94178,3,3,329458,329459,329462,1,4,0
94179,4,2,329462,329462,329464,0,2,0
94180,3,3,329465,329465,329468,0,3,1
94181,6,1,329471,329471,329472,0,1,3
94182,2,3,329473,329473,329476,0,3,1
94183,2,2,329475,329476,329478,1,3,0
94184,2,1,329477,329478,329479,1,2,0
94185,5,1,329482,329482,329483,0,1,3
94186,4,1,329486,329486,329487,0,1,3
94187,4,3,329490,329490,329493,0,3,3
94188,5,3,329495,329495,329498,0,3,2
94189,1,1,329496,329498,329499,2,3,0
94190,2,2,329498,329499,329501,1,3,0
94191,5,2,329503,329503,329505,0,2,2
94192,4,1,329507,329507,329508,0,1,2
94193,3,3,329510,329510,329513,0,3,2
94194,3,2,329513,329513,329515,0,2,0
94195,5,2,329518,329518,329520,0,2,3
94196,2,2,329520,329520,329522,0,2,0
94197,1,3,329521,329522,329525,1,4,0
94198,5,2,329526,329526,329528,0,2,1
94199,1,2,329527,329528,329530,1,3,0
94200,3,2,329530,329530,329532,0,2,0
94201,2,1,329532,329532,329533,0,1,0
94202,4,3,329536,329536,329539,0,3,3
94203,6,1,329542,329542,329543,0,1,3
94204,4,2,329546,329546,329548,0,2,3
94205,5,1,329551,329551,329552,0,1,3
94206,6,2,329557,329557,329559,0,2,5
94207,5,1,329562,329562,329563,0,1,3
94208,1,1,329563,329563,329564,0,1,0
94209,2,2,329565,329565,329567,0,2,1
94210,3,3,329568,329568,329571,0,3,1
94211,2,3,329570,329571,329574,1,4,0
94212,5,2,329575,329575,329577,0,2,1
94213,3,3,329578,329578,329581,0,3,1
94214,5,3,329583,329583,329586,0,3,2
94215,4,2,329587,329587,329589,0,2,1
94216,6,1,329593,329593,329594,0,1,4
94217,2,1,329595,329595,329596,0,1,1
94218,4,3,329599,329599,329602,0,3,3
94219,2,2,329601,329602,329604,1,3,0
94220,6,2,329607,329607,329609,0,2,3
94221,4,2,329611,329611,329613,0,2,2
94222,3,1,329614,329614,329615,0,1,1
94223,2,3,329616,329616,329619,0,3,1
94224,2,3,329618,329619,329622,1,4,0
94225,2,1,329620,329622,329623,2,3,0
94226,4,1,329624,329624,329625,0,1,1
94227,3,2,329627,329627,329629,0,2,2
94228,5,3,329632,329632,329635,0,3,3
94229,3,2,329635,329635,329637,0,2,0
94230,2,1,329637,329637,329638,0,1,0
94231,6,1,329643,329643,329644,0,1,5
94232,1,1,329644,329644,329645,0,1,0
94233,3,2,329647,329647,329649,0,2,2
94234,4,1,329651,329651,329652,0,1,2
94235,6,3,329657,329657,329660,0,3,5
94236,3,2,329660,329660,329662,0,2,0
94237,5,2,329665,329665,329667,0,2,3
94238,3,2,329668,329668,329670,0,2,1
94239,5,2,329673,329673,329675,0,2,3
94240,6,2,329679,329679,329681,0,2,4
94241,3,1,329682,329682,329683,0,1,1
94242,5,1,329687,329687,329688,0,1,4
94243,2,1,329689,329689,329690,0,1,1
94244,3,2,329692,329692,329694,0,2,2
94245,3,3,329695,329695,329698,0,3,1
94246,6,2,329701,329701,329703,0,2,3
94247,1,3,329702,329703,329706,1,4,0
94248,6,1,329708,329708,329709,0,1,2
94249,1,3,329709,329709,329712,0,3,0
94250,5,2,329714,329714,329716,0,2,2
94251,1,2,329715,329716,329718,1,3,0
94252,4,3,329719,329719,329722,0,3,1
94253,2,3,329721,329722,329725,1,4,0
94254,2,3,329723,329725,329728,2,5,0
94255,3,1,329726,329728,329729,2,3,0
94256,5,2,329731,329731,329733,0,2,2
94257,1,3,329732,329733,329736,1,4,0
94258,3,1,329735,329736,329737,1,2,0
94259,6,2,329741,329741,329743,0,2,4
94260,1,2,329742,329743,329745,1,3,0
94261,5,1,329747,329747,329748,0,1,2
94262,4,1,329751,329751,329752,0,1,3
94263,5,3,329756,329756,329759,0,3,4
94264,1,2,329757,329759,329761,2,4,0
94265,1,1,329758,329761,329762,3,4,0
94266,1,3,329759,329762,329765,3,6,0
94267,2,2,329761,329765,329767,4,6,0
94268,2,1,329763,329767,329768,4,5,0
94269,2,2,329765,329768,329770,3,5,0
94270,3,1,329768,329770,329771,2,3,0
94271,5,1,329773,329773,329774,0,1,2
94272,1,2,329774,329774,329776,0,2,0
94273,5,3,329779,329779,329782,0,3,3
94274,6,3,329785,329785,329788,0,3,3
94275,2,2,329787,329788,329790,1,3,0
94276,4,3,329791,329791,329794,0,3,1
94277,1,1,329792,329794,329795,2,3,0
94278,4,3,329796,329796,329799,0,3,1
94279,4,2,329800,329800,329802,0,2,1
94280,2,1,329802,329802,329803,0,1,0
94281,2,2,329804,329804,329806,0,2,1
94282,3,1,329807,329807,329808,0,1,1
94283,4,2,329811,329811,329813,0,2,3
94284,1,3,329812,329813,329816,1,4,0
94285,5,1,329817,329817,329818,0,1,1
94286,3,1,329820,329820,329821,0,1,2
94287,2,3,329822,329822,329825,0,3,1
94288,3,1,329825,329825,329826,0,1,0
94289,3,1,329828,329828,329829,0,1,2
94290,4,2,329832,329832,329834,0,2,3
94291,2,3,329834,329834,329837,0,3,0
94292,5,3,329839,329839,329842,0,3,2
94293,1,3,329840,329842,329845,2,5,0
94294,6,3,329846,329846,329849,0,3,1
94295,2,3,329848,329849,329852,1,4,0
94296,6,1,329854,329854,329855,0,1,2
94297,3,1,329857,329857,329858,0,1,2
94298,1,2,329858,329858,329860,0,2,0
94299,5,3,329863,329863,329866,0,3,3
94300,3,3,329866,329866,329869,0,3,0
94301,2,3,329868,329869,329872,1,4,0
94302,3,2,329871,329872,329874,1,3,0
94303,3,3,329874,329874,329877,0,3,0
94304,2,3,329876,329877,329880,1,4,0
94305,5,1,329881,329881,329882,0,1,1
94306,5,1,329886,329886,329887,0,1,4
94307,4,1,329890,329890,329891,0,1,3
94308,4,2,329894,329894,329896,0,2,3
94309,1,1,329895,329896,329897,1,2,0
94310,6,2,329901,329901,329903,0,2,4
94311,1,3,329902,329903,329906,1,4,0
94312,4,1,329906,329906,329907,0,1,0
94313,2,1,329908,329908,329909,0,1,1
94314,5,3,329913,329913,329916,0,3,4
94315,2,1,329915,329916,329917,1,2,0
94316,5,2,329920,329920,329922,0,2,3
94317,6,3,329926,329926,329929,0,3,4
94318,2,3,329928,329929,329932,1,4,0
94319,3,1,329931,329932,329933,1,2,0
94320,1,3,329932,329933,329936,1,4,0
94321,2,2,329934,329936,329938,2,4,0
94322,5,2,329939,329939,329941,0,2,1
94323,1,3,329940,329941,329944,1,4,0
94324,3,1,329943,329944,329945,1,2,0
94325,6,1,329949,329949,329950,0,1,4
94326,3,1,329952,329952,329953,0,1,2
94327,2,2,329954,329954,329956,0,2,1
94328,5,3,329959,329959,329962,0,3,3
94329,3,2,329962,329962,329964,0,2,0
94330,2,3,329964,329964,329967,0,3,0
94331,4,2,329968,329968,329970,0,2,1
94332,3,2,329971,329971,329973,0,2,1
94333,1,2,329972,329973,329975,1,3,0
94334,3,3,329975,329975,329978,0,3,0
94335,2,3,329977,329978,329981,1,4,0
94336,6,3,329983,329983,329986,0,3,2
94337,6,2,329989,329989,329991,0,2,3
94338,3,2,329992,329992,329994,0,2,1
94339,5,2,329997,329997,329999,0,2,3
94340,5,3,330002,330002,330005,0,3,3
94341,6,1,330008,330008,330009,0,1,3
94342,6,1,330014,330014,330015,0,1,5
94343,4,1,330018,330018,330019,0,1,3
94344,1,2,330019,330019,330021,0,2,0
94345,2,1,330021,330021,330022,0,1,0
94346,1,2,330022,330022,330024,0,2,0
94347,4,1,330026,330026,330027,0,1,2
94348,5,3,330031,330031,330034,0,3,4
94349,2,2,330033,330034,330036,1,3,0
94350,5,3,330038,330038,330041,0,3,2
94351,3,3,330041,330041,330044,0,3,0
94352,6,2,330047,330047,330049,0,2,3
94353,3,3,330050,330050,330053,0,3,1
94354,6,1,330056,330056,330057,0,1,3
94355,2,2,330058,330058,330060,0,2,1
94356,6,2,330064,330064,330066,0,2,4
94357,5,3,330069,330069,330072,0,3,3
94358,2,2,330071,330072,330074,1,3,0
94359,4,3,330075,330075,330078,0,3,1
94360,1,2,330076,330078,330080,2,4,0
94361,5,3,330081,330081,330084,0,3,1
94362,5,2,330086,330086,330088,0,2,2
94363,3,3,330089,330089,330092,0,3,1
94364,5,1,330094,330094,330095,0,1,2
94365,3,1,330097,330097,330098,0,1,2
94366,5,3,330102,330102,330105,0,3,4
94367,6,3,330108,330108,330111,0,3,3
94368,5,1,330113,330113,330114,0,1,2
94369,3,3,330116,330116,330119,0,3,2
94370,6,1,330122,330122,330123,0,1,3
94371,4,3,330126,330126,330129,0,3,3
94372,6,3,330132,330132,330135,0,3,3
94373,3,3,330135,330135,330138,0,3,0
94374,2,2,330137,330138,330140,1,3,0
94375,4,3,330141,330141,330144,0,3,1
94376,4,2,330145,330145,330147,0,2,1
94377,6,3,330151,330151,330154,0,3,4
94378,2,2,330153,330154,330156,1,3,0
94379,5,1,330158,330158,330159,0,1,2
94380,2,1,330160,330160,330161,0,1,1
94381,3,1,330163,330163,330164,0,1,2
94382,4,3,330167,330167,330170,0,3,3
94383,6,3,330173,330173,330176,0,3,3
94384,4,3,330177,330177,330180,0,3,1
94385,2,2,330179,330180,330182,1,3,0
94386,6,3,330185,330185,330188,0,3,3
94387,2,2,330187,330188,330190,1,3,0
94388,1,1,330188,330190,330191,2,3,0
94389,4,2,330192,330192,330194,0,2,1
94390,1,3,330193,330194,330197,1,4,0
94391,4,1,330197,330197,330198,0,1,0
94392,2,3,330199,330199,330202,0,3,1
94393,4,2,330203,330203,330205,0,2,1
94394,5,2,330208,330208,330210,0,2,3
94395,2,1,330210,330210,330211,0,1,0
94396,5,2,330215,330215,330217,0,2,4
94397,6,2,330221,330221,330223,0,2,4
94398,6,1,330227,330227,330228,0,1,4
94399,4,1,330231,330231,330232,0,1,3
94400,5,1,330236,330236,330237,0,1,4
94401,3,1,330239,330239,330240,0,1,2
94402,5,2,330244,330244,330246,0,2,4
94403,2,1,330246,330246,330247,0,1,0
94404,2,2,330248,330248,330250,0,2,1
94405,1,2,330249,330250,330252,1,3,0
94406,2,1,330251,330252,330253,1,2,0
94407,4,3,330255,330255,330258,0,3,2
94408,2,1,330257,330258,330259,1,2,0
94409,1,3,330258,330259,330262,1,4,0
94410,5,3,330263,330263,330266,0,3,1
94411,4,1,330267,330267,330268,0,1,1
94412,1,2,330268,330268,330270,0,2,0
94413,4,3,330272,330272,330275,0,3,2
94414,3,2,330275,330275,330277,0,2,0
94415,3,2,330278,330278,330280,0,2,1
94416,4,3,330282,330282,330285,0,3,2
94417,5,1,330287,330287,330288,0,1,2
94418,2,1,330289,330289,330290,0,1,1
94419,5,3,330294,330294,330297,0,3,4
94420,3,1,330297,330297,330298,0,1,0
94421,6,1,330303,330303,330304,0,1,5
94422,5,1,330308,330308,330309,0,1,4
94423,4,3,330312,330312,330315,0,3,3
94424,6,2,330318,330318,330320,0,2,3
94425,1,1,330319,330320,330321,1,2,0
94426,6,2,330325,330325,330327,0,2,4
94427,1,1,330326,330327,330328,1,2,0
94428,3,1,330329,330329,330330,0,1,1
94429,6,3,330335,330335,330338,0,3,5
94430,1,3,330336,330338,330341,2,5,0
94431,1,2,330337,330341,330343,4,6,0
94432,4,1,330341,330343,330344,2,3,0
94433,5,1,330346,330346,330347,0,1,2
94434,6,3,330352,330352,330355,0,3,5
94435,2,2,330354,330355,330357,1,3,0
94436,6,1,330360,330360,330361,0,1,3
94437,1,1,330361,330361,330362,0,1,0
94438,1,1,330362,330362,330363,0,1,0
94439,1,3,330363,330363,330366,0,3,0
94440,5,3,330368,330368,330371,0,3,2
94441,3,1,330371,330371,330372,0,1,0
94442,5,3,330376,330376,330379,0,3,4
94443,1,3,330377,330379,330382,2,5,0
94444,4,2,330381,330382,330384,1,3,0
94445,5,3,330386,330386,330389,0,3,2
94446,5,1,330391,330391,330392,0,1,2
94447,1,1,330392,330392,330393,0,1,0
94448,5,3,330397,330397,330400,0,3,4
94449,3,3,330400,330400,330403,0,3,0
94450,1,1,330401,330403,330404,2,3,0
94451,3,2,330404,330404,330406,0,2,0
94452,2,2,330406,330406,330408,0,2,0
94453,5,2,330411,330411,330413,0,2,3
94454,2,3,330413,330413,330416,0,3,0
94455,2,3,330415,330416,330419,1,4,0
94456,4,1,330419,330419,330420,0,1,0
94457,3,1,330422,330422,330423,0,1,2
94458,3,3,330425,330425,330428,0,3,2
94459,2,3,330427,330428,330431,1,4,0
94460,3,3,330430,330431,330434,1,4,0
94461,4,3,330434,330434,330437,0,3,0
94462,1,2,330435,330437,330439,2,4,0
94463,2,1,330437,330439,330440,2,3,0
94464,2,2,330439,330440,330442,1,3,0
94465,5,1,330444,330444,330445,0,1,2
94466,1,1,330445,330445,330446,0,1,0
94467,5,2,330450,330450,330452,0,2,4
94468,1,3,330451,330452,330455,1,4,0
94469,6,1,330457,330457,330458,0,1,2
94470,6,3,330463,330463,330466,0,3,5
94471,3,3,330466,330466,330469,0,3,0
94472,1,1,330467,330469,330470,2,3,0
94473,6,1,330473,330473,330474,0,1,3
94474,1,1,330474,330474,330475,0,1,0
94475,6,1,330480,330480,330481,0,1,5
94476,3,2,330483,330483,330485,0,2,2
94477,1,1,330484,330485,330486,1,2,0
94478,5,3,330489,330489,330492,0,3,3
94479,1,3,330490,330492,330495,2,5,0
94480,4,2,330494,330495,330497,1,3,0
94481,2,1,330496,330497,330498,1,2,0
94482,5,3,330501,330501,330504,0,3,3
94483,4,3,330505,330505,330508,0,3,1
94484,1,2,330506,330508,330510,2,4,0
94485,4,2,330510,330510,330512,0,2,0
94486,5,3,330515,330515,330518,0,3,3
94487,2,2,330517,330518,330520,1,3,0
94488,2,3,330519,330520,330523,1,4,0
94489,5,1,330524,330524,330525,0,1,1
94490,1,1,330525,330525,330526,0,1,0
94491,1,1,330526,330526,330527,0,1,0
94492,1,2,330527,330527,330529,0,2,0
94493,1,3,330528,330529,330532,1,4,0
94494,6,3,330534,330534,330537,0,3,2
94495,5,3,330539,330539,330542,0,3,2
94496,4,2,330543,330543,330545,0,2,1
94497,3,2,330546,330546,330548,0,2,1
94498,3,2,330549,330549,330551,0,2,1
94499,4,2,330553,330553,330555,0,2,2
94500,1,3,330554,330555,330558,1,4,0
94501,6,1,330560,330560,330561,0,1,2
94502,1,2,330561,330561,330563,0,2,0
94503,5,1,330566,330566,330567,0,1,3
94504,1,1,330567,330567,330568,0,1,0
94505,3,2,330570,330570,330572,0,2,2
94506,4,1,330574,330574,330575,0,1,2
94507,5,1,330579,330579,330580,0,1,4
94508,6,1,330585,330585,330586,0,1,5
94509,3,3,330588,330588,330591,0,3,2
94510,3,1,330591,330591,330592,0,1,0
94511,6,2,330597,330597,330599,0,2,5
94512,6,1,330603,330603,330604,0,1,4
94513,5,3,330608,330608,330611,0,3,4
94514,3,2,330611,330611,330613,0,2,0
94515,4,1,330615,330615,330616,0,1,2
94516,6,1,330621,330621,330622,0,1,5
94517,2,3,330623,330623,330626,0,3,1
94518,1,3,330624,330626,330629,2,5,0
94519,5,3,330629,330629,330632,0,3,0
94520,6,3,330635,330635,330638,0,3,3
94521,1,1,330636,330638,330639,2,3,0
94522,6,2,330642,330642,330644,0,2,3
94523,4,2,330646,330646,330648,0,2,2
94524,2,3,330648,330648,330651,0,3,0
94525,2,3,330650,330651,330654,1,4,0
94526,1,3,330651,330654,330657,3,6,0
94527,5,2,330656,330657,330659,1,3,0
94528,4,1,330660,330660,330661,0,1,1
94529,4,1,330664,330664,330665,0,1,3
94530,3,3,330667,330667,330670,0,3,2
94531,3,1,330670,330670,330671,0,1,0
94532,6,1,330676,330676,330677,0,1,5
94533,6,1,330682,330682,330683,0,1,5
94534,3,2,330685,330685,330687,0,2,2
94535,3,2,330688,330688,330690,0,2,1
94536,5,1,330693,330693,330694,0,1,3
94537,5,2,330698,330698,330700,0,2,4
94538,6,2,330704,330704,330706,0,2,4
94539,4,1,330708,330708,330709,0,1,2
94540,3,1,330711,330711,330712,0,1,2
94541,3,1,330714,330714,330715,0,1,2
94542,4,2,330718,330718,330720,0,2,3
94543,2,2,330720,330720,330722,0,2,0
94544,4,1,330724,330724,330725,0,1,2
94545,3,1,330727,330727,330728,0,1,2
94546,2,3,330729,330729,330732,0,3,1
94547,1,2,330730,330732,330734,2,4,0
94548,1,1,330731,330734,330735,3,4,0
94549,5,2,330736,330736,330738,0,2,1
94550,6,3,330742,330742,330745,0,3,4
94551,4,3,330746,330746,330749,0,3,1
94552,6,1,330752,330752,330753,0,1,3
94553,3,2,330755,330755,330757,0,2,2
94554,5,1,330760,330760,330761,0,1,3
94555,4,1,330764,330764,330765,0,1,3
94556,6,1,330770,330770,330771,0,1,5
94557,5,2,330775,330775,330777,0,2,4
94558,4,2,330779,330779,330781,0,2,2
94559,4,2,330783,330783,330785,0,2,2
94560,2,1,330785,330785,330786,0,1,0
94561,2,1,330787,330787,330788,0,1,1
94562,6,1,330793,330793,330794,0,1,5
94563,5,3,330798,330798,330801,0,3,4
94564,2,2,330800,330801,330803,1,3,0
94565,1,3,330801,330803,330806,2,5,0
94566,6,1,330807,330807,330808,0,1,1
94567,4,2,330811,330811,330813,0,2,3
94568,5,2,330816,330816,330818,0,2,3
94569,2,3,330818,330818,330821,0,3,0
94570,2,2,330820,330821,330823,1,3,0
94571,4,3,330824,330824,330827,0,3,1
94572,3,2,330827,330827,330829,0,2,0
94573,5,2,330832,330832,330834,0,2,3
94574,3,3,330835,330835,330838,0,3,1
94575,4,3,330839,330839,330842,0,3,1
94576,5,3,330844,330844,330847,0,3,2
94577,2,1,330846,330847,330848,1,2,0
94578,3,2,330849,330849,330851,0,2,1
94579,4,2,330853,330853,330855,0,2,2
94580,1,2,330854,330855,330857,1,3,0
94581,2,2,330856,330857,330859,1,3,0
94582,3,2,330859,330859,330861,0,2,0
94583,2,1,330861,330861,330862,0,1,0
94584,4,1,330865,330865,330866,0,1,3
94585,4,2,330869,330869,330871,0,2,3
94586,2,1,330871,330871,330872,0,1,0
94587,3,2,330874,330874,330876,0,2,2
94588,2,3,330876,330876,330879,0,3,0
94589,3,2,330879,330879,330881,0,2,0
94590,3,1,330882,330882,330883,0,1,1
94591,4,2,330886,330886,330888,0,2,3
94592,6,3,330892,330892,330895,0,3,4
94593,3,1,330895,330895,330896,0,1,0
94594,4,2,330899,330899,330901,0,2,3
94595,5,3,330904,330904,330907,0,3,3
94596,6,2,330910,330910,330912,0,2,3
94597,5,2,330915,330915,330917,0,2,3
94598,1,1,330916,330917,330918,1,2,0
94599,1,2,330917,330918,330920,1,3,0
94600,2,2,330919,330920,330922,1,3,0
94601,6,2,330925,330925,330927,0,2,3
94602,1,1,330926,330927,330928,1,2,0
94603,2,3,330928,330928,330931,0,3,0
94604,3,2,330931,330931,330933,0,2,0
94605,5,3,330936,330936,330939,0,3,3
94606,1,1,330937,330939,330940,2,3,0
94607,2,2,330939,330940,330942,1,3,0
94608,4,2,330943,330943,330945,0,2,1
94609,4,3,330947,330947,330950,0,3,2
94610,4,1,330951,330951,330952,0,1,1
94611,6,2,330957,330957,330959,0,2,5
94612,5,1,330962,330962,330963,0,1,3
94613,2,1,330964,330964,330965,0,1,1
94614,6,2,330970,330970,330972,0,2,5
94615,1,3,330971,330972,330975,1,4,0
94616,2,3,330973,330975,330978,2,5,0
94617,3,2,330976,330978,330980,2,4,0
94618,6,3,330982,330982,330985,0,3,2
94619,2,3,330984,330985,330988,1,4,0
94620,5,2,330989,330989,330991,0,2,1
94621,4,1,330993,330993,330994,0,1,2
94622,1,2,330994,330994,330996,0,2,0
94623,3,1,330997,330997,330998,0,1,1
94624,1,3,330998,330998,331001,0,3,0
94625,2,3,331000,331001,331004,1,4,0
94626,5,3,331005,331005,331008,0,3,1
94627,5,3,331010,331010,331013,0,3,2
94628,6,3,331016,331016,331019,0,3,3
94629,4,1,331020,331020,331021,0,1,1
94630,6,3,331026,331026,331029,0,3,5
94631,3,1,331029,331029,331030,0,1,0
94632,1,2,331030,331030,331032,0,2,0
94633,4,1,331034,331034,331035,0,1,2
94634,2,1,331036,331036,331037,0,1,1
94635,6,3,331042,331042,331045,0,3,5
94636,5,2,331047,331047,331049,0,2,2
94637,4,2,331051,331051,331053,0,2,2
94638,2,3,331053,331053,331056,0,3,0
94639,1,1,331054,331056,331057,2,3,0
94640,6,1,331060,331060,331061,0,1,3
94641,6,1,331066,331066,331067,0,1,5
94642,2,1,331068,331068,331069,0,1,1
94643,5,3,331073,331073,331076,0,3,4
94644,6,2,331079,331079,331081,0,2,3
94645,6,2,331085,331085,331087,0,2,4
94646,6,3,331091,331091,331094,0,3,4
94647,6,3,331097,331097,331100,0,3,3
94648,5,2,331102,331102,331104,0,2,2
94649,1,1,331103,331104,331105,1,2,0
94650,3,3,331106,331106,331109,0,3,1
94651,1,2,331107,331109,331111,2,4,0
94652,6,1,331113,331113,331114,0,1,2
94653,3,2,331116,331116,331118,0,2,2
94654,6,2,331122,331122,331124,0,2,4
94655,6,1,331128,331128,331129,0,1,4
94656,1,1,331129,331129,331130,0,1,0
94657,3,3,331132,331132,331135,0,3,2
94658,5,3,331137,331137,331140,0,3,2
94659,2,1,331139,331140,331141,1,2,0
94660,6,1,331145,331145,331146,0,1,4
94661,3,1,331148,331148,331149,0,1,2
94662,5,2,331153,331153,331155,0,2,4
94663,1,1,331154,331155,331156,1,2,0
94664,2,2,331156,331156,331158,0,2,0
94665,6,3,331162,331162,331165,0,3,4
94666,1,1,331163,331165,331166,2,3,0
94667,6,3,331169,331169,331172,0,3,3
94668,5,2,331174,331174,331176,0,2,2
94669,1,2,331175,331176,331178,1,3,0
94670,1,2,331176,331178,331180,2,4,0
94671,3,1,331179,331180,331181,1,2,0
94672,5,1,331184,331184,331185,0,1,3
94673,3,2,331187,331187,331189,0,2,2
94674,6,3,331193,331193,331196,0,3,4
94675,6,3,331199,331199,331202,0,3,3
94676,3,3,331202,331202,331205,0,3,0
94677,3,1,331205,331205,331206,0,1,0
94678,1,3,331206,331206,331209,0,3,0
94679,6,3,331212,331212,331215,0,3,3
94680,2,1,331214,331215,331216,1,2,0
94681,6,2,331220,331220,331222,0,2,4
94682,4,2,331224,331224,331226,0,2,2
94683,1,2,331225,331226,331228,1,3,0
94684,2,3,331227,331228,331231,1,4,0
94685,1,2,331228,331231,331233,3,5,0
94686,4,3,331232,331233,331236,1,4,0
94687,5,3,331237,331237,331240,0,3,1
94688,4,2,331241,331241,331243,0,2,1
94689,5,2,331246,331246,331248,0,2,3
94690,2,2,331248,331248,331250,0,2,0
94691,1,1,331249,331250,331251,1,2,0
94692,2,1,331251,331251,331252,0,1,0
94693,2,3,331253,331253,331256,0,3,1
94694,4,2,331257,331257,331259,0,2,1
94695,2,2,331259,331259,331261,0,2,0
94696,5,3,331264,331264,331267,0,3,3
94697,3,1,331267,331267,331268,0,1,0
94698,1,1,331268,331268,331269,0,1,0
94699,6,1,331274,331274,331275,0,1,5
94700,6,3,331280,331280,331283,0,3,5
94701,5,3,331285,331285,331288,0,3,2
94702,1,1,331286,331288,331289,2,3,0
94703,1,2,331287,331289,331291,2,4,0
94704,5,1,331292,331292,331293,0,1,1
94705,1,3,331293,331293,331296,0,3,0
94706,1,2,331294,331296,331298,2,4,0
94707,6,3,331300,331300,331303,0,3,2
94708,1,2,331301,331303,331305,2,4,0
94709,2,3,331303,331305,331308,2,5,0
94710,3,3,331306,331308,331311,2,5,0
94711,6,1,331312,331312,331313,0,1,1
94712,2,1,331314,331314,331315,0,1,1
94713,4,2,331318,331318,331320,0,2,3
94714,2,3,331320,331320,331323,0,3,0
94715,1,3,331321,331323,331326,2,5,0
94716,1,1,331322,331326,331327,4,5,0
94717,3,1,331325,331327,331328,2,3,0
94718,6,2,331331,331331,331333,0,2,3
94719,2,1,331333,331333,331334,0,1,0
94720,1,3,331334,331334,331337,0,3,0
94721,1,1,331335,331337,331338,2,3,0
94722,4,3,331339,331339,331342,0,3,1
94723,6,3,331345,331345,331348,0,3,3
94724,6,2,331351,331351,331353,0,2,3
94725,3,2,331354,331354,331356,0,2,1
94726,5,2,331359,331359,331361,0,2,3
94727,3,3,331362,331362,331365,0,3,1
94728,4,1,331366,331366,331367,0,1,1
94729,5,3,331371,331371,331374,0,3,4
94730,6,1,331377,331377,331378,0,1,3
94731,2,2,331379,331379,331381,0,2,1
94732,5,3,331384,331384,331387,0,3,3
94733,3,2,331387,331387,331389,0,2,0
94734,3,1,331390,331390,331391,0,1,1
94735,5,2,331395,331395,331397,0,2,4
94736,5,3,331400,331400,331403,0,3,3
94737,4,2,331404,331404,331406,0,2,1
94738,5,3,331409,331409,331412,0,3,3
94739,5,1,331414,331414,331415,0,1,2
94740,2,2,331416,331416,331418,0,2,1
94741,6,3,331422,331422,331425,0,3,4
94742,4,2,331426,331426,331428,0,2,1
94743,5,2,331431,331431,331433,0,2,3
94744,1,3,331432,331433,331436,1,4,0
94745,1,2,331433,331436,331438,3,5,0
94746,2,1,331435,331438,331439,3,4,0
94747,4,2,331439,331439,331441,0,2,0
94748,5,3,331444,331444,331447,0,3,3
94749,2,1,331446,331447,331448,1,2,0
94750,5,1,331451,331451,331452,0,1,3
94751,5,2,331456,331456,331458,0,2,4
94752,1,3,331457,331458,331461,1,4,0
94753,2,3,331459,331461,331464,2,5,0
94754,6,3,331465,331465,331468,0,3,1
94755,2,1,331467,331468,331469,1,2,0
94756,2,1,331469,331469,331470,0,1,0
94757,6,2,331475,331475,331477,0,2,5
94758,5,2,331480,331480,331482,0,2,3
94759,3,2,331483,331483,331485,0,2,1
94760,5,3,331488,331488,331491,0,3,3
94761,2,1,331490,331491,331492,1,2,0
94762,1,2,331491,331492,331494,1,3,0
94763,1,1,331492,331494,331495,2,3,0
94764,3,2,331495,331495,331497,0,2,0
94765,6,3,331501,331501,331504,0,3,4
94766,2,1,331503,331504,331505,1,2,0
94767,5,1,331508,331508,331509,0,1,3
94768,5,1,331513,331513,331514,0,1,4
94769,6,1,331519,331519,331520,0,1,5
94770,3,3,331522,331522,331525,0,3,2
94771,1,3,331523,331525,331528,2,5,0
94772,3,2,331526,331528,331530,2,4,0
94773,1,1,331527,331530,331531,3,4,0
94774,3,2,331530,331531,331533,1,3,0
94775,1,1,331531,331533,331534,2,3,0
94776,5,3,331536,331536,331539,0,3,2
94777,5,3,331541,331541,331544,0,3,2
94778,6,2,331547,331547,331549,0,2,3
94779,1,2,331548,331549,331551,1,3,0
94780,1,2,331549,331551,331553,2,4,0
94781,6,3,331555,331555,331558,0,3,2
94782,2,3,331557,331558,331561,1,4,0
94783,6,2,331563,331563,331565,0,2,2
94784,2,1,331565,331565,331566,0,1,0
94785,3,2,331568,331568,331570,0,2,2
94786,4,2,331572,331572,331574,0,2,2
94787,6,3,331578,331578,331581,0,3,4
94788,6,1,331584,331584,331585,0,1,3
94789,6,1,331590,331590,331591,0,1,5
94790,3,1,331593,331593,331594,0,1,2
94791,3,2,331596,331596,331598,0,2,2
94792,5,1,331601,331601,331602,0,1,3
94793,5,3,331606,331606,331609,0,3,4
94794,4,2,331610,331610,331612,0,2,1
94795,4,1,331614,331614,331615,0,1,2
94796,5,2,331619,331619,331621,0,2,4
94797,2,3,331621,331621,331624,0,3,0
94798,2,2,331623,331624,331626,1,3,0
94799,3,2,331626,331626,331628,0,2,0
94800,2,3,331628,331628,331631,0,3,0
94801,3,2,331631,331631,331633,0,2,0
94802,6,3,331637,331637,331640,0,3,4
94803,4,2,331641,331641,331643,0,2,1
94804,1,1,331642,331643,331644,1,2,0
94805,3,2,331645,331645,331647,0,2,1
94806,5,1,331650,331650,331651,0,1,3
94807,6,2,331656,331656,331658,0,2,5
94808,3,2,331659,331659,331661,0,2,1
94809,3,1,331662,331662,331663,0,1,1
94810,2,3,331664,331664,331667,0,3,1
94811,1,2,331665,331667,331669,2,4,0
94812,1,2,331666,331669,331671,3,5,0
94813,4,2,331670,331671,331673,1,3,0
94814,2,3,331672,331673,331676,1,4,0
94815,3,1,331675,331676,331677,1,2,0
94816,6,2,331681,331681,331683,0,2,4
94817,3,1,331684,331684,331685,0,1,1
94818,4,1,331688,331688,331689,0,1,3
94819,1,3,331689,331689,331692,0,3,0
94820,4,2,331693,331693,331695,0,2,1
94821,1,1,331694,331695,331696,1,2,0
94822,1,1,331695,331696,331697,1,2,0
94823,5,2,331700,331700,331702,0,2,3
94824,2,2,331702,331702,331704,0,2,0
94825,4,2,331706,331706,331708,0,2,2
94826,6,3,331712,331712,331715,0,3,4
94827,4,1,331716,331716,331717,0,1,1
94828,2,2,331718,331718,331720,0,2,1
94829,6,3,331724,331724,331727,0,3,4
94830,4,3,331728,331728,331731,0,3,1
94831,1,3,331729,331731,331734,2,5,0
94832,3,3,331732,331734,331737,2,5,0
94833,3,2,331735,331737,331739,2,4,0
94834,5,2,331740,331740,331742,0,2,1
94835,3,3,331743,331743,331746,0,3,1
94836,2,1,331745,331746,331747,1,2,0
94837,5,2,331750,331750,331752,0,2,3
94838,4,3,331754,331754,331757,0,3,2
94839,1,3,331755,331757,331760,2,5,0
94840,3,3,331758,331760,331763,2,5,0
94841,5,2,331763,331763,331765,0,2,0
94842,1,2,331764,331765,331767,1,3,0
94843,2,3,331766,331767,331770,1,4,0
94844,6,3,331772,331772,331775,0,3,2
94845,6,2,331778,331778,331780,0,2,3
94846,1,2,331779,331780,331782,1,3,0
94847,6,2,331785,331785,331787,0,2,3
94848,6,2,331791,331791,331793,0,2,4
94849,6,2,331797,331797,331799,0,2,4
94850,6,2,331803,331803,331805,0,2,4
94851,5,2,331808,331808,331810,0,2,3
94852,2,2,331810,331810,331812,0,2,0
94853,6,2,331816,331816,331818,0,2,4
94854,2,1,331818,331818,331819,0,1,0
94855,2,3,331820,331820,331823,0,3,1
94856,1,3,331821,331823,331826,2,5,0
94857,2,1,331823,331826,331827,3,4,0
94858,2,1,331825,331827,331828,2,3,0
94859,5,3,331830,331830,331833,0,3,2
94860,4,3,331834,331834,331837,0,3,1
94861,5,1,331839,331839,331840,0,1,2
94862,3,2,331842,331842,331844,0,2,2
94863,5,3,331847,331847,331850,0,3,3
94864,1,1,331848,331850,331851,2,3,0
94865,5,1,331853,331853,331854,0,1,2
94866,1,3,331854,331854,331857,0,3,0
94867,1,3,331855,331857,331860,2,5,0
94868,6,1,331861,331861,331862,0,1,1
94869,6,2,331867,331867,331869,0,2,5
94870,1,1,331868,331869,331870,1,2,0
94871,3,2,331871,331871,331873,0,2,1
94872,2,3,331873,331873,331876,0,3,0
94873,3,3,331876,331876,331879,0,3,0
94874,1,3,331877,331879,331882,2,5,0
94875,2,3,331879,331882,331885,3,6,0
94876,1,3,331880,331885,331888,5,8,0
94877,4,2,331884,331888,331890,4,6,0
94878,5,3,331889,331890,331893,1,4,0
94879,5,2,331894,331894,331896,0,2,1
94880,2,1,331896,331896,331897,0,1,0
94881,6,2,331902,331902,331904,0,2,5
94882,3,1,331905,331905,331906,0,1,1
94883,3,1,331908,331908,331909,0,1,2
94884,3,2,331911,331911,331913,0,2,2
94885,5,1,331916,331916,331917,0,1,3
94886,1,2,331917,331917,331919,0,2,0
94887,6,3,331923,331923,331926,0,3,4
94888,4,2,331927,331927,331929,0,2,1
94889,5,3,331932,331932,331935,0,3,3
94890,5,2,331937,331937,331939,0,2,2
94891,1,3,331938,331939,331942,1,4,0
94892,4,1,331942,331942,331943,0,1,0
94893,1,2,331943,331943,331945,0,2,0
94894,3,3,331946,331946,331949,0,3,1
94895,3,3,331949,331949,331952,0,3,0
94896,1,2,331950,331952,331954,2,4,0
94897,1,2,331951,331954,331956,3,5,0
94898,5,3,331956,331956,331959,0,3,0
94899,6,1,331962,331962,331963,0,1,3
94900,4,2,331966,331966,331968,0,2,3
94901,3,3,331969,331969,331972,0,3,1
94902,1,2,331970,331972,331974,2,4,0
94903,4,1,331974,331974,331975,0,1,0
94904,4,1,331978,331978,331979,0,1,3
94905,4,1,331982,331982,331983,0,1,3
94906,1,1,331983,331983,331984,0,1,0
94907,1,1,331984,331984,331985,0,1,0
94908,5,2,331989,331989,331991,0,2,4
94909,2,2,331991,331991,331993,0,2,0
94910,2,3,331993,331993,331996,0,3,0
94911,2,1,331995,331996,331997,1,2,0
94912,6,3,332001,332001,332004,0,3,4
94913,1,1,332002,332004,332005,2,3,0
94914,3,2,332005,332005,332007,0,2,0
94915,3,1,332008,332008,332009,0,1,1
94916,6,3,332014,332014,332017,0,3,5
94917,6,1,332020,332020,332021,0,1,3
94918,4,1,332024,332024,332025,0,1,3
94919,6,1,332030,332030,332031,0,1,5
94920,3,3,332033,332033,332036,0,3,2
94921,1,1,332034,332036,332037,2,3,0
94922,2,1,332036,332037,332038,1,2,0
94923,2,3,332038,332038,332041,0,3,0
94924,1,3,332039,332041,332044,2,5,0
94925,2,3,332041,332044,332047,3,6,0
94926,3,1,332044,332047,332048,3,4,0
94927,1,1,332045,332048,332049,3,4,0
94928,2,2,332047,332049,332051,2,4,0
94929,3,2,332050,332051,332053,1,3,0
94930,2,3,332052,332053,332056,1,4,0
94931,4,2,332056,332056,332058,0,2,0
94932,3,3,332059,332059,332062,0,3,1
94933,5,2,332064,332064,332066,0,2,2
94934,6,2,332070,332070,332072,0,2,4
94935,1,3,332071,332072,332075,1,4,0
94936,6,1,332077,332077,332078,0,1,2
94937,3,3,332080,332080,332083,0,3,2
94938,4,3,332084,332084,332087,0,3,1
94939,4,1,332088,332088,332089,0,1,1
94940,6,3,332094,332094,332097,0,3,5
94941,1,1,332095,332097,332098,2,3,0
94942,1,2,332096,332098,332100,2,4,0
94943,6,1,332102,332102,332103,0,1,2
94944,5,2,332107,332107,332109,0,2,4
94945,3,3,332110,332110,332113,0,3,1
94946,5,2,332115,332115,332117,0,2,2
94947,1,3,332116,332117,332120,1,4,0
94948,2,1,332118,332120,332121,2,3,0
94949,6,2,332124,332124,332126,0,2,3
94950,4,2,332128,332128,332130,0,2,2
94951,5,2,332133,332133,332135,0,2,3
94952,2,2,332135,332135,332137,0,2,0
94953,4,3,332139,332139,332142,0,3,2
94954,2,1,332141,332142,332143,1,2,0
94955,1,1,332142,332143,332144,1,2,0
94956,2,3,332144,332144,332147,0,3,0
94957,6,1,332150,332150,332151,0,1,3
94958,4,1,332154,332154,332155,0,1,3
94959,1,3,332155,332155,332158,0,3,0
94960,4,1,332159,332159,332160,0,1,1
94961,3,2,332162,332162,332164,0,2,2
94962,1,1,332163,332164,332165,1,2,0
94963,6,1,332169,332169,332170,0,1,4
94964,3,1,332172,332172,332173,0,1,2
94965,1,3,332173,332173,332176,0,3,0
94966,2,1,332175,332176,332177,1,2,0
94967,6,3,332181,332181,332184,0,3,4
94968,6,3,332187,332187,332190,0,3,3
94969,5,1,332192,332192,332193,0,1,2
94970,6,1,332198,332198,332199,0,1,5
94971,1,3,332199,332199,332202,0,3,0
94972,1,2,332200,332202,332204,2,4,0
94973,3,2,332203,332204,332206,1,3,0
94974,4,1,332207,332207,332208,0,1,1
94975,6,1,332213,332213,332214,0,1,5
94976,4,2,332217,332217,332219,0,2,3
94977,4,2,332221,332221,332223,0,2,2
94978,4,1,332225,332225,332226,0,1,2
94979,3,1,332228,332228,332229,0,1,2
94980,1,1,332229,332229,332230,0,1,0
94981,3,1,332232,332232,332233,0,1,2
94982,6,2,332238,332238,332240,0,2,5
94983,5,1,332243,332243,332244,0,1,3
94984,6,3,332249,332249,332252,0,3,5
94985,6,3,332255,332255,332258,0,3,3
94986,5,3,332260,332260,332263,0,3,2
94987,6,1,332266,332266,332267,0,1,3
94988,6,1,332272,332272,332273,0,1,5
94989,2,1,332274,332274,332275,0,1,1
94990,3,2,332277,332277,332279,0,2,2
94991,1,2,332278,332279,332281,1,3,0
94992,2,2,332280,332281,332283,1,3,0
94993,2,1,332282,332283,332284,1,2,0
94994,5,2,332287,332287,332289,0,2,3
94995,6,3,332293,332293,332296,0,3,4
94996,5,2,332298,332298,332300,0,2,2
94997,3,2,332301,332301,332303,0,2,1
94998,5,3,332306,332306,332309,0,3,3
94999,2,3,332308,332309,332312,1,4,0
95000,5,1,332313,332313,332314,0,1,1
95001,2,2,332315,332315,332317,0,2,1
95002,6,1,332321,332321,332322,0,1,4
95003,5,3,332326,332326,332329,0,3,4
95004,2,2,332328,332329,332331,1,3,0
95005,4,1,332332,332332,332333,0,1,1
95006,5,2,332337,332337,332339,0,2,4
95007,5,2,332342,332342,332344,0,2,3
95008,4,3,332346,332346,332349,0,3,2
95009,3,1,332349,332349,332350,0,1,0
95010,3,1,332352,332352,332353,0,1,2
95011,2,2,332354,332354,332356,0,2,1
95012,1,3,332355,332356,332359,1,4,0
95013,4,2,332359,332359,332361,0,2,0
95014,6,3,332365,332365,332368,0,3,4
95015,2,1,332367,332368,332369,1,2,0
95016,4,1,332371,332371,332372,0,1,2
95017,5,3,332376,332376,332379,0,3,4
95018,6,2,332382,332382,332384,0,2,3
95019,3,1,332385,332385,332386,0,1,1
95020,6,1,332391,332391,332392,0,1,5
95021,6,1,332397,332397,332398,0,1,5
95022,4,1,332401,332401,332402,0,1,3
95023,6,3,332407,332407,332410,0,3,5
95024,4,2,332411,332411,332413,0,2,1
95025,3,3,332414,332414,332417,0,3,1
95026,1,1,332415,332417,332418,2,3,0
95027,3,1,332418,332418,332419,0,1,0
95028,1,2,332419,332419,332421,0,2,0
95029,6,3,332425,332425,332428,0,3,4
95030,4,2,332429,332429,332431,0,2,1
95031,1,3,332430,332431,332434,1,4,0
95032,2,2,332432,332434,332436,2,4,0
95033,1,2,332433,332436,332438,3,5,0
95034,4,2,332437,332438,332440,1,3,0
95035,6,1,332443,332443,332444,0,1,3
95036,4,1,332447,332447,332448,0,1,3
95037,6,3,332453,332453,332456,0,3,5
95038,6,2,332459,332459,332461,0,2,3
95039,2,1,332461,332461,332462,0,1,0
95040,6,3,332467,332467,332470,0,3,5
95041,4,3,332471,332471,332474,0,3,1
95042,3,2,332474,332474,332476,0,2,0
95043,4,1,332478,332478,332479,0,1,2
95044,4,2,332482,332482,332484,0,2,3
95045,4,2,332486,332486,332488,0,2,2
95046,4,2,332490,332490,332492,0,2,2
95047,3,1,332493,332493,332494,0,1,1
95048,3,2,332496,332496,332498,0,2,2
95049,3,1,332499,332499,332500,0,1,1
95050,2,1,332501,332501,332502,0,1,1
95051,3,1,332504,332504,332505,0,1,2
95052,4,3,332508,332508,332511,0,3,3
95053,1,2,332509,332511,332513,2,4,0
95054,2,1,332511,332513,332514,2,3,0
95055,5,3,332516,332516,332519,0,3,2
95056,6,1,332522,332522,332523,0,1,3
95057,1,2,332523,332523,332525,0,2,0
95058,3,1,332526,332526,332527,0,1,1
95059,6,3,332532,332532,332535,0,3,5
95060,1,3,332533,332535,332538,2,5,0
95061,4,2,332537,332538,332540,1,3,0
95062,5,1,332542,332542,332543,0,1,2
95063,5,3,332547,332547,332550,0,3,4
95064,5,1,332552,332552,332553,0,1,2
95065,5,1,332557,332557,332558,0,1,4
95066,5,1,332562,332562,332563,0,1,4
95067,6,3,332568,332568,332571,0,3,5
95068,4,2,332572,332572,332574,0,2,1
95069,2,3,332574,332574,332577,0,3,0
95070,1,2,332575,332577,332579,2,4,0
95071,4,1,332579,332579,332580,0,1,0
95072,5,2,332584,332584,332586,0,2,4
95073,4,1,332588,332588,332589,0,1,2
95074,1,3,332589,332589,332592,0,3,0
95075,5,1,332594,332594,332595,0,1,2
95076,3,2,332597,332597,332599,0,2,2
95077,3,2,332600,332600,332602,0,2,1
95078,5,2,332605,332605,332607,0,2,3
95079,4,1,332609,332609,332610,0,1,2
95080,2,3,332611,332611,332614,0,3,1
95081,1,2,332612,332614,332616,2,4,0
95082,3,1,332615,332616,332617,1,2,0
95083,1,3,332616,332617,332620,1,4,0
95084,6,2,332622,332622,332624,0,2,2
95085,2,1,332624,332624,332625,0,1,0
95086,1,2,332625,332625,332627,0,2,0
95087,3,2,332628,332628,332630,0,2,1
95088,4,1,332632,332632,332633,0,1,2
95089,6,2,332638,332638,332640,0,2,5
95090,1,2,332639,332640,332642,1,3,0
95091,1,1,332640,332642,332643,2,3,0
95092,5,1,332645,332645,332646,0,1,2
95093,2,1,332647,332647,332648,0,1,1
95094,2,3,332649,332649,332652,0,3,1
95095,5,2,332654,332654,332656,0,2,2
95096,2,3,332656,332656,332659,0,3,0
95097,1,2,332657,332659,332661,2,4,0
95098,2,3,332659,332661,332664,2,5,0
95099,5,2,332664,332664,332666,0,2,0
95100,6,3,332670,332670,332673,0,3,4
95101,3,3,332673,332673,332676,0,3,0
95102,3,3,332676,332676,332679,0,3,0
95103,1,1,332677,332679,332680,2,3,0
95104,3,1,332680,332680,332681,0,1,0
95105,2,3,332682,332682,332685,0,3,1
95106,4,1,332686,332686,332687,0,1,1
95107,1,3,332687,332687,332690,0,3,0
95108,3,3,332690,332690,332693,0,3,0
95109,2,2,332692,332693,332695,1,3,0
95110,4,2,332696,332696,332698,0,2,1
95111,1,1,332697,332698,332699,1,2,0
95112,3,3,332700,332700,332703,0,3,1
95113,4,1,332704,332704,332705,0,1,1
95114,2,2,332706,332706,332708,0,2,1
95115,5,2,332711,332711,332713,0,2,3
95116,2,1,332713,332713,332714,0,1,0
95117,1,3,332714,332714,332717,0,3,0
95118,2,3,332716,332717,332720,1,4,0
95119,5,3,332721,332721,332724,0,3,1
95120,4,3,332725,332725,332728,0,3,1
95121,6,3,332731,332731,332734,0,3,3
95122,1,2,332732,332734,332736,2,4,0
95123,2,1,332734,332736,332737,2,3,0
95124,6,1,332740,332740,332741,0,1,3
95125,6,3,332746,332746,332749,0,3,5
95126,3,3,332749,332749,332752,0,3,0
95127,5,3,332754,332754,332757,0,3,2
95128,5,2,332759,332759,332761,0,2,2
95129,1,3,332760,332761,332764,1,4,0
95130,2,3,332762,332764,332767,2,5,0
95131,5,3,332767,332767,332770,0,3,0
95132,1,2,332768,332770,332772,2,4,0
95133,1,1,332769,332772,332773,3,4,0
95134,6,3,332775,332775,332778,0,3,2
95135,3,2,332778,332778,332780,0,2,0
95136,1,1,332779,332780,332781,1,2,0
95137,5,3,332784,332784,332787,0,3,3
95138,2,1,332786,332787,332788,1,2,0
95139,3,1,332789,332789,332790,0,1,1
95140,1,3,332790,332790,332793,0,3,0
95141,2,3,332792,332793,332796,1,4,0
95142,3,2,332795,332796,332798,1,3,0
95143,2,3,332797,332798,332801,1,4,0
95144,4,3,332801,332801,332804,0,3,0
95145,5,2,332806,332806,332808,0,2,2
95146,2,1,332808,332808,332809,0,1,0
95147,3,3,332811,332811,332814,0,3,2
95148,2,1,332813,332814,332815,1,2,0
95149,2,3,332815,332815,332818,0,3,0
95150,4,1,332819,332819,332820,0,1,1
95151,2,1,332821,332821,332822,0,1,1
95152,3,2,332824,332824,332826,0,2,2
95153,4,2,332828,332828,332830,0,2,2
95154,4,3,332832,332832,332835,0,3,2
95155,5,2,332837,332837,332839,0,2,2
95156,5,2,332842,332842,332844,0,2,3
95157,1,1,332843,332844,332845,1,2,0
95158,2,1,332845,332845,332846,0,1,0
95159,3,1,332848,332848,332849,0,1,2
95160,6,3,332854,332854,332857,0,3,5
95161,4,1,332858,332858,332859,0,1,1
95162,2,2,332860,332860,332862,0,2,1
95163,3,3,332863,332863,332866,0,3,1
95164,1,2,332864,332866,332868,2,4,0
95165,5,3,332869,332869,332872,0,3,1
95166,5,1,332874,332874,332875,0,1,2
95167,2,2,332876,332876,332878,0,2,1
95168,4,2,332880,332880,332882,0,2,2
95169,3,3,332883,332883,332886,0,3,1
95170,1,2,332884,332886,332888,2,4,0
95171,3,2,332887,332888,332890,1,3,0
95172,1,1,332888,332890,332891,2,3,0
95173,5,1,332893,332893,332894,0,1,2
95174,3,2,332896,332896,332898,0,2,2
95175,1,1,332897,332898,332899,1,2,0
95176,2,1,332899,332899,332900,0,1,0
95177,5,1,332904,332904,332905,0,1,4
95178,1,3,332905,332905,332908,0,3,0
95179,1,3,332906,332908,332911,2,5,0
95180,1,3,332907,332911,332914,4,7,0
95181,2,2,332909,332914,332916,5,7,0
95182,3,2,332912,332916,332918,4,6,0
95183,2,1,332914,332918,332919,4,5,0
95184,2,2,332916,332919,332921,3,5,0
95185,4,1,332920,332921,332922,1,2,0
95186,1,2,332921,332922,332924,1,3,0
95187,1,2,332922,332924,332926,2,4,0
95188,3,1,332925,332926,332927,1,2,0
95189,6,3,332931,332931,332934,0,3,4
95190,6,3,332937,332937,332940,0,3,3
95191,4,2,332941,332941,332943,0,2,1
95192,6,3,332947,332947,332950,0,3,4
95193,5,3,332952,332952,332955,0,3,2
95194,1,3,332953,332955,332958,2,5,0
95195,6,2,332959,332959,332961,0,2,1
95196,1,2,332960,332961,332963,1,3,0
95197,5,1,332965,332965,332966,0,1,2
95198,6,1,332971,332971,332972,0,1,5
95199,1,2,332972,332972,332974,0,2,0
95200,4,1,332976,332976,332977,0,1,2
95201,1,1,332977,332977,332978,0,1,0
95202,1,3,332978,332978,332981,0,3,0
95203,1,1,332979,332981,332982,2,3,0
95204,4,2,332983,332983,332985,0,2,1
95205,6,3,332989,332989,332992,0,3,4
95206,4,2,332993,332993,332995,0,2,1
95207,4,2,332997,332997,332999,0,2,2
95208,4,1,333001,333001,333002,0,1,2
95209,6,1,333007,333007,333008,0,1,5
95210,6,3,333013,333013,333016,0,3,5
95211,6,1,333019,333019,333020,0,1,3
95212,2,2,333021,333021,333023,0,2,1
95213,3,3,333024,333024,333027,0,3,1
95214,4,2,333028,333028,333030,0,2,1
95215,1,3,333029,333030,333033,1,4,0
95216,5,2,333034,333034,333036,0,2,1
95217,1,2,333035,333036,333038,1,3,0
95218,1,1,333036,333038,333039,2,3,0
95219,2,2,333038,333039,333041,1,3,0
95220,5,1,333043,333043,333044,0,1,2
95221,2,1,333045,333045,333046,0,1,1
95222,4,2,333049,333049,333051,0,2,3
95223,3,2,333052,333052,333054,0,2,1
95224,4,3,333056,333056,333059,0,3,2
95225,2,2,333058,333059,333061,1,3,0
95226,2,3,333060,333061,333064,1,4,0
95227,4,3,333064,333064,333067,0,3,0
95228,2,1,333066,333067,333068,1,2,0
95229,1,1,333067,333068,333069,1,2,0
95230,1,3,333068,333069,333072,1,4,0
95231,3,3,333071,333072,333075,1,4,0
95232,3,2,333074,333075,333077,1,3,0
95233,1,1,333075,333077,333078,2,3,0
95234,4,1,333079,333079,333080,0,1,1
95235,5,3,333084,333084,333087,0,3,4
95236,3,2,333087,333087,333089,0,2,0
95237,5,3,333092,333092,333095,0,3,3
95238,2,3,333094,333095,333098,1,4,0
95239,3,1,333097,333098,333099,1,2,0
95240,4,3,333101,333101,333104,0,3,2
95241,6,1,333107,333107,333108,0,1,3
95242,3,1,333110,333110,333111,0,1,2
95243,1,2,333111,333111,333113,0,2,0
95244,6,2,333117,333117,333119,0,2,4
95245,6,1,333123,333123,333124,0,1,4
95246,6,1,333129,333129,333130,0,1,5
95247,3,1,333132,333132,333133,0,1,2
95248,2,3,333134,333134,333137,0,3,1
95249,1,1,333135,333137,333138,2,3,0
95250,4,2,333139,333139,333141,0,2,1
95251,6,1,333145,333145,333146,0,1,4
95252,4,2,333149,333149,333151,0,2,3
95253,2,3,333151,333151,333154,0,3,0
95254,3,1,333154,333154,333155,0,1,0
95255,3,3,333157,333157,333160,0,3,2
95256,5,2,333162,333162,333164,0,2,2
95257,2,3,333164,333164,333167,0,3,0
95258,2,3,333166,333167,333170,1,4,0
95259,1,2,333167,333170,333172,3,5,0
95260,1,3,333168,333172,333175,4,7,0
95261,4,1,333172,333175,333176,3,4,0
95262,2,2,333174,333176,333178,2,4,0
95263,3,1,333177,333178,333179,1,2,0
95264,1,2,333178,333179,333181,1,3,0
95265,2,1,333180,333181,333182,1,2,0
95266,5,3,333185,333185,333188,0,3,3
95267,2,1,333187,333188,333189,1,2,0
95268,4,2,333191,333191,333193,0,2,2
95269,3,3,333194,333194,333197,0,3,1
95270,2,3,333196,333197,333200,1,4,0
95271,5,1,333201,333201,333202,0,1,1
95272,2,3,333203,333203,333206,0,3,1
95273,4,3,333207,333207,333210,0,3,1
95274,1,2,333208,333210,333212,2,4,0
95275,5,2,333213,333213,333215,0,2,1
95276,2,1,333215,333215,333216,0,1,0
95277,6,2,333221,333221,333223,0,2,5
95278,5,2,333226,333226,333228,0,2,3
95279,1,3,333227,333228,333231,1,4,0
95280,6,1,333233,333233,333234,0,1,2
95281,3,2,333236,333236,333238,0,2,2
95282,4,3,333240,333240,333243,0,3,2
95283,5,1,333245,333245,333246,0,1,2
95284,2,3,333247,333247,333250,0,3,1
95285,1,3,333248,333250,333253,2,5,0
95286,6,3,333254,333254,333257,0,3,1
95287,3,3,333257,333257,333260,0,3,0
95288,2,2,333259,333260,333262,1,3,0
95289,6,1,333265,333265,333266,0,1,3
95290,5,2,333270,333270,333272,0,2,4
95291,1,1,333271,333272,333273,1,2,0
95292,1,3,333272,333273,333276,1,4,0
95293,1,1,333273,333276,333277,3,4,0
95294,5,3,333278,333278,333281,0,3,1
95295,2,1,333280,333281,333282,1,2,0
95296,6,1,333286,333286,333287,0,1,4
95297,2,1,333288,333288,333289,0,1,1
95298,6,3,333294,333294,333297,0,3,5
95299,4,1,333298,333298,333299,0,1,1
95300,1,2,333299,333299,333301,0,2,0
95301,5,2,333304,333304,333306,0,2,3
95302,6,1,333310,333310,333311,0,1,4
95303,2,3,333312,333312,333315,0,3,1
95304,4,3,333316,333316,333319,0,3,1
95305,5,1,333321,333321,333322,0,1,2
95306,4,1,333325,333325,333326,0,1,3
95307,6,3,333331,333331,333334,0,3,5
95308,6,2,333337,333337,333339,0,2,3
95309,5,2,333342,333342,333344,0,2,3
95310,1,1,333343,333344,333345,1,2,0
95311,2,2,333345,333345,333347,0,2,0
95312,5,1,333350,333350,333351,0,1,3
95313,3,1,333353,333353,333354,0,1,2
95314,2,3,333355,333355,333358,0,3,1
95315,1,3,333356,333358,333361,2,5,0
95316,4,2,333360,333361,333363,1,3,0
95317,6,2,333366,333366,333368,0,2,3
95318,3,1,333369,333369,333370,0,1,1
95319,6,1,333375,333375,333376,0,1,5
95320,2,2,333377,333377,333379,0,2,1
95321,1,1,333378,333379,333380,1,2,0
95322,3,1,333381,333381,333382,0,1,1
95323,5,3,333386,333386,333389,0,3,4
95324,6,1,333392,333392,333393,0,1,3
95325,3,1,333395,333395,333396,0,1,2
95326,6,2,333401,333401,333403,0,2,5
95327,5,2,333406,333406,333408,0,2,3
95328,1,3,333407,333408,333411,1,4,0
95329,6,1,333413,333413,333414,0,1,2
95330,2,2,333415,333415,333417,0,2,1
95331,3,2,333418,333418,333420,0,2,1
95332,5,3,333423,333423,333426,0,3,3
95333,5,1,333428,333428,333429,0,1,2
95334,3,2,333431,333431,333433,0,2,2
95335,2,1,333433,333433,333434,0,1,0
95336,1,2,333434,333434,333436,0,2,0
95337,1,2,333435,333436,333438,1,3,0
95338,2,2,333437,333438,333440,1,3,0
95339,2,1,333439,333440,333441,1,2,0
95340,6,3,333445,333445,333448,0,3,4
95341,6,2,333451,333451,333453,0,2,3
95342,5,1,333456,333456,333457,0,1,3
95343,4,3,333460,333460,333463,0,3,3
95344,6,1,333466,333466,333467,0,1,3
95345,3,1,333469,333469,333470,0,1,2
95346,5,3,333474,333474,333477,0,3,4
95347,4,1,333478,333478,333479,0,1,1
95348,5,1,333483,333483,333484,0,1,4
95349,1,1,333484,333484,333485,0,1,0
95350,3,2,333487,333487,333489,0,2,2
95351,2,2,333489,333489,333491,0,2,0
95352,1,3,333490,333491,333494,1,4,0
95353,2,3,333492,333494,333497,2,5,0
95354,2,3,333494,333497,333500,3,6,0
95355,3,2,333497,333500,333502,3,5,0
95356,2,3,333499,333502,333505,3,6,0
95357,5,3,333504,333505,333508,1,4,0
95358,3,3,333507,333508,333511,1,4,0
95359,2,3,333509,333511,333514,2,5,0
95360,4,2,333513,333514,333516,1,3,0
95361,5,1,333518,333518,333519,0,1,2
95362,6,2,333524,333524,333526,0,2,5
95363,6,1,333530,333530,333531,0,1,4
95364,4,3,333534,333534,333537,0,3,3
95365,3,1,333537,333537,333538,0,1,0
95366,1,1,333538,333538,333539,0,1,0
95367,5,1,333543,333543,333544,0,1,4
95368,3,1,333546,333546,333547,0,1,2
95369,2,2,333548,333548,333550,0,2,1
95370,4,2,333552,333552,333554,0,2,2
95371,2,1,333554,333554,333555,0,1,0
95372,1,1,333555,333555,333556,0,1,0
95373,2,2,333557,333557,333559,0,2,1
95374,3,3,333560,333560,333563,0,3,1
95375,3,3,333563,333563,333566,0,3,0
95376,2,1,333565,333566,333567,1,2,0
95377,4,3,333569,333569,333572,0,3,2
95378,2,1,333571,333572,333573,1,2,0
95379,1,3,333572,333573,333576,1,4,0
95380,3,2,333575,333576,333578,1,3,0
95381,2,3,333577,333578,333581,1,4,0
95382,6,1,333583,333583,333584,0,1,2
95383,4,3,333587,333587,333590,0,3,3
95384,1,2,333588,333590,333592,2,4,0
95385,2,2,333590,333592,333594,2,4,0
95386,4,1,333594,333594,333595,0,1,0
95387,5,3,333599,333599,333602,0,3,4
95388,5,2,333604,333604,333606,0,2,2
95389,1,1,333605,333606,333607,1,2,0
95390,3,1,333608,333608,333609,0,1,1
95391,2,3,333610,333610,333613,0,3,1
95392,1,3,333611,333613,333616,2,5,0
95393,2,1,333613,333616,333617,3,4,0
95394,2,1,333615,333617,333618,2,3,0
95395,3,3,333618,333618,333621,0,3,0
95396,4,2,333622,333622,333624,0,2,1
95397,5,1,333627,333627,333628,0,1,3
95398,1,1,333628,333628,333629,0,1,0
95399,3,1,333631,333631,333632,0,1,2
95400,1,2,333632,333632,333634,0,2,0
95401,2,3,333634,333634,333637,0,3,0
95402,6,3,333640,333640,333643,0,3,3
95403,6,3,333646,333646,333649,0,3,3
95404,5,3,333651,333651,333654,0,3,2
95405,3,2,333654,333654,333656,0,2,0
95406,5,3,333659,333659,333662,0,3,3
95407,2,2,333661,333662,333664,1,3,0
95408,4,2,333665,333665,333667,0,2,1
95409,3,3,333668,333668,333671,0,3,1
95410,5,1,333673,333673,333674,0,1,2
95411,3,2,333676,333676,333678,0,2,2
95412,4,3,333680,333680,333683,0,3,2
95413,2,1,333682,333683,333684,1,2,0
95414,2,2,333684,333684,333686,0,2,0
95415,2,1,333686,333686,333687,0,1,0
95416,2,2,333688,333688,333690,0,2,1
95417,1,2,333689,333690,333692,1,3,0
95418,6,2,333695,333695,333697,0,2,3
95419,1,3,333696,333697,333700,1,4,0
95420,4,1,333700,333700,333701,0,1,0
95421,4,1,333704,333704,333705,0,1,3
95422,4,1,333708,333708,333709,0,1,3
95423,3,1,333711,333711,333712,0,1,2
95424,6,2,333717,333717,333719,0,2,5
95425,4,2,333721,333721,333723,0,2,2
95426,5,3,333726,333726,333729,0,3,3
95427,4,2,333730,333730,333732,0,2,1
95428,2,1,333732,333732,333733,0,1,0
95429,5,1,333737,333737,333738,0,1,4
95430,5,3,333742,333742,333745,0,3,4
95431,2,3,333744,333745,333748,1,4,0
95432,3,3,333747,333748,333751,1,4,0
95433,3,1,333750,333751,333752,1,2,0
95434,5,3,333755,333755,333758,0,3,3
95435,2,3,333757,333758,333761,1,4,0
95436,1,3,333758,333761,333764,3,6,0
95437,1,3,333759,333764,333767,5,8,0
95438,2,2,333761,333767,333769,6,8,0
95439,6,3,333767,333769,333772,2,5,0
95440,2,2,333769,333772,333774,3,5,0
95441,2,3,333771,333774,333777,3,6,0
95442,2,2,333773,333777,333779,4,6,0
95443,6,2,333779,333779,333781,0,2,0
95444,4,1,333783,333783,333784,0,1,2
95445,3,2,333786,333786,333788,0,2,2
95446,1,2,333787,333788,333790,1,3,0
95447,1,2,333788,333790,333792,2,4,0
95448,3,3,333791,333792,333795,1,4,0
95449,2,1,333793,333795,333796,2,3,0
95450,1,1,333794,333796,333797,2,3,0
95451,2,1,333796,333797,333798,1,2,0
95452,1,3,333797,333798,333801,1,4,0
95453,2,3,333799,333801,333804,2,5,0
95454,4,3,333803,333804,333807,1,4,0
95455,6,2,333809,333809,333811,0,2,2
95456,2,2,333811,333811,333813,0,2,0
95457,5,1,333816,333816,333817,0,1,3
95458,3,2,333819,333819,333821,0,2,2
95459,6,1,333825,333825,333826,0,1,4
95460,3,3,333828,333828,333831,0,3,2
95461,2,2,333830,333831,333833,1,3,0
95462,4,3,333834,333834,333837,0,3,1
95463,2,1,333836,333837,333838,1,2,0
95464,1,1,333837,333838,333839,1,2,0
95465,1,1,333838,333839,333840,1,2,0
95466,5,1,333843,333843,333844,0,1,3
95467,4,1,333847,333847,333848,0,1,3
95468,3,3,333850,333850,333853,0,3,2
95469,5,2,333855,333855,333857,0,2,2
95470,5,2,333860,333860,333862,0,2,3
95471,1,3,333861,333862,333865,1,4,0
95472,6,1,333867,333867,333868,0,1,2
95473,2,1,333869,333869,333870,0,1,1
95474,1,1,333870,333870,333871,0,1,0
95475,1,1,333871,333871,333872,0,1,0
95476,3,3,333874,333874,333877,0,3,2
95477,5,1,333879,333879,333880,0,1,2
95478,3,2,333882,333882,333884,0,2,2
95479,5,3,333887,333887,333890,0,3,3
95480,3,2,333890,333890,333892,0,2,0
95481,3,3,333893,333893,333896,0,3,1
95482,2,2,333895,333896,333898,1,3,0
95483,2,2,333897,333898,333900,1,3,0
95484,2,2,333899,333900,333902,1,3,0
95485,6,2,333905,333905,333907,0,2,3
95486,6,2,333911,333911,333913,0,2,4
95487,2,1,333913,333913,333914,0,1,0
95488,6,2,333919,333919,333921,0,2,5
95489,2,1,333921,333921,333922,0,1,0
95490,6,2,333927,333927,333929,0,2,5
95491,2,1,333929,333929,333930,0,1,0
95492,2,1,333931,333931,333932,0,1,1
95493,2,3,333933,333933,333936,0,3,1
95494,3,2,333936,333936,333938,0,2,0
95495,4,1,333940,333940,333941,0,1,2
95496,6,3,333946,333946,333949,0,3,5
95497,6,2,333952,333952,333954,0,2,3
95498,6,1,333958,333958,333959,0,1,4
95499,4,2,333962,333962,333964,0,2,3
95500,4,1,333966,333966,333967,0,1,2
95501,5,1,333971,333971,333972,0,1,4
95502,3,3,333974,333974,333977,0,3,2
95503,2,1,333976,333977,333978,1,2,0
95504,5,2,333981,333981,333983,0,2,3
95505,2,3,333983,333983,333986,0,3,0
95506,3,3,333986,333986,333989,0,3,0
95507,4,1,333990,333990,333991,0,1,1
95508,4,1,333994,333994,333995,0,1,3
95509,4,2,333998,333998,334000,0,2,3
95510,3,1,334001,334001,334002,0,1,1
95511,5,1,334006,334006,334007,0,1,4
95512,5,1,334011,334011,334012,0,1,4
95513,5,1,334016,334016,334017,0,1,4
95514,5,1,334021,334021,334022,0,1,4
95515,2,2,334023,334023,334025,0,2,1
95516,1,3,334024,334025,334028,1,4,0
95517,2,2,334026,334028,334030,2,4,0
95518,3,2,334029,334030,334032,1,3,0
95519,5,2,334034,334034,334036,0,2,2
95520,5,2,334039,334039,334041,0,2,3
95521,2,1,334041,334041,334042,0,1,0
95522,5,3,334046,334046,334049,0,3,4
95523,6,2,334052,334052,334054,0,2,3
95524,1,2,334053,334054,334056,1,3,0
95525,6,2,334059,334059,334061,0,2,3
95526,3,3,334062,334062,334065,0,3,1
95527,4,3,334066,334066,334069,0,3,1
95528,3,1,334069,334069,334070,0,1,0
95529,6,1,334075,334075,334076,0,1,5
95530,6,2,334081,334081,334083,0,2,5
95531,3,1,334084,334084,334085,0,1,1
95532,4,2,334088,334088,334090,0,2,3
95533,4,2,334092,334092,334094,0,2,2
95534,4,1,334096,334096,334097,0,1,2
95535,3,3,334099,334099,334102,0,3,2
95536,1,2,334100,334102,334104,2,4,0
95537,2,2,334102,334104,334106,2,4,0
95538,2,1,334104,334106,334107,2,3,0
95539,1,3,334105,334107,334110,2,5,0
95540,3,3,334108,334110,334113,2,5,0
95541,4,2,334112,334113,334115,1,3,0
95542,1,1,334113,334115,334116,2,3,0
95543,5,3,334118,334118,334121,0,3,2
95544,2,2,334120,334121,334123,1,3,0
95545,3,1,334123,334123,334124,0,1,0
95546,4,2,334127,334127,334129,0,2,3
95547,1,3,334128,334129,334132,1,4,0
95548,2,2,334130,334132,334134,2,4,0
95549,6,3,334136,334136,334139,0,3,2
95550,6,2,334142,334142,334144,0,2,3
95551,6,2,334148,334148,334150,0,2,4
95552,5,3,334153,334153,334156,0,3,3
95553,5,3,334158,334158,334161,0,3,2
95554,4,2,334162,334162,334164,0,2,1
95555,4,2,334166,334166,334168,0,2,2
95556,2,3,334168,334168,334171,0,3,0
95557,6,3,334174,334174,334177,0,3,3
95558,4,3,334178,334178,334181,0,3,1
95559,2,3,334180,334181,334184,1,4,0
95560,4,2,334184,334184,334186,0,2,0
95561,1,1,334185,334186,334187,1,2,0
95562,2,1,334187,334187,334188,0,1,0
95563,1,3,334188,334188,334191,0,3,0
95564,3,1,334191,334191,334192,0,1,0
95565,2,3,334193,334193,334196,0,3,1
95566,4,3,334197,334197,334200,0,3,1
95567,1,2,334198,334200,334202,2,4,0
95568,3,1,334201,334202,334203,1,2,0
95569,2,3,334203,334203,334206,0,3,0
95570,3,1,334206,334206,334207,0,1,0
95571,5,2,334211,334211,334213,0,2,4
95572,2,2,334213,334213,334215,0,2,0
95573,3,3,334216,334216,334219,0,3,1
95574,2,2,334218,334219,334221,1,3,0
95575,6,2,334224,334224,334226,0,2,3
95576,2,2,334226,334226,334228,0,2,0
95577,2,1,334228,334228,334229,0,1,0
95578,2,1,334230,334230,334231,0,1,1
95579,6,3,334236,334236,334239,0,3,5
95580,5,1,334241,334241,334242,0,1,2
95581,4,3,334245,334245,334248,0,3,3
95582,1,2,334246,334248,334250,2,4,0
95583,4,2,334250,334250,334252,0,2,0
95584,1,1,334251,334252,334253,1,2,0
95585,1,3,334252,334253,334256,1,4,0
95586,3,1,334255,334256,334257,1,2,0
95587,1,1,334256,334257,334258,1,2,0
95588,5,2,334261,334261,334263,0,2,3
95589,1,1,334262,334263,334264,1,2,0
95590,3,3,334265,334265,334268,0,3,1
95591,5,1,334270,334270,334271,0,1,2
95592,6,2,334276,334276,334278,0,2,5
95593,2,2,334278,334278,334280,0,2,0
95594,3,1,334281,334281,334282,0,1,1
95595,3,1,334284,334284,334285,0,1,2
95596,6,2,334290,334290,334292,0,2,5
95597,3,2,334293,334293,334295,0,2,1
95598,6,2,334299,334299,334301,0,2,4
95599,1,2,334300,334301,334303,1,3,0
95600,2,1,334302,334303,334304,1,2,0
95601,3,1,334305,334305,334306,0,1,1
95602,1,2,334306,334306,334308,0,2,0
95603,1,2,334307,334308,334310,1,3,0
95604,6,1,334313,334313,334314,0,1,3
95605,4,2,334317,334317,334319,0,2,3
95606,1,2,334318,334319,334321,1,3,0
95607,4,2,334322,334322,334324,0,2,1
95608,4,1,334326,334326,334327,0,1,2
95609,2,1,334328,334328,334329,0,1,1
95610,3,3,334331,334331,334334,0,3,2
95611,3,3,334334,334334,334337,0,3,0
95612,4,3,334338,334338,334341,0,3,1
95613,3,3,334341,334341,334344,0,3,0
95614,3,1,334344,334344,334345,0,1,0
95615,3,1,334347,334347,334348,0,1,2
95616,2,3,334349,334349,334352,0,3,1
95617,3,2,334352,334352,334354,0,2,0
95618,6,2,334358,334358,334360,0,2,4
95619,1,1,334359,334360,334361,1,2,0
95620,5,2,334364,334364,334366,0,2,3
95621,2,2,334366,334366,334368,0,2,0
95622,2,2,334368,334368,334370,0,2,0
95623,6,3,334374,334374,334377,0,3,4
95624,2,2,334376,334377,334379,1,3,0
95625,4,3,334380,334380,334383,0,3,1
95626,5,3,334385,334385,334388,0,3,2
95627,1,1,334386,334388,334389,2,3,0
95628,6,1,334392,334392,334393,0,1,3
95629,2,2,334394,334394,334396,0,2,1
95630,2,1,334396,334396,334397,0,1,0
95631,6,1,334402,334402,334403,0,1,5
95632,5,2,334407,334407,334409,0,2,4
95633,2,1,334409,334409,334410,0,1,0
95634,2,3,334411,334411,334414,0,3,1
95635,1,2,334412,334414,334416,2,4,0
95636,5,1,334417,334417,334418,0,1,1
95637,5,2,334422,334422,334424,0,2,4
95638,1,2,334423,334424,334426,1,3,0
95639,6,1,334429,334429,334430,0,1,3
95640,6,3,334435,334435,334438,0,3,5
95641,1,2,334436,334438,334440,2,4,0
95642,2,1,334438,334440,334441,2,3,0
95643,4,3,334442,334442,334445,0,3,1
95644,6,1,334448,334448,334449,0,1,3
95645,5,1,334453,334453,334454,0,1,4
95646,5,1,334458,334458,334459,0,1,4
95647,4,3,334462,334462,334465,0,3,3
95648,2,1,334464,334465,334466,1,2,0
95649,5,2,334469,334469,334471,0,2,3
95650,6,2,334475,334475,334477,0,2,4
95651,1,3,334476,334477,334480,1,4,0
95652,3,2,334479,334480,334482,1,3,0
95653,5,2,334484,334484,334486,0,2,2
95654,4,3,334488,334488,334491,0,3,2
95655,4,3,334492,334492,334495,0,3,1
95656,5,1,334497,334497,334498,0,1,2
95657,6,1,334503,334503,334504,0,1,5
95658,1,1,334504,334504,334505,0,1,0
95659,2,1,334506,334506,334507,0,1,1
95660,4,1,334510,334510,334511,0,1,3
95661,6,1,334516,334516,334517,0,1,5
95662,6,3,334522,334522,334525,0,3,5
95663,4,2,334526,334526,334528,0,2,1
95664,1,3,334527,334528,334531,1,4,0
95665,2,1,334529,334531,334532,2,3,0
95666,6,2,334535,334535,334537,0,2,3
95667,2,2,334537,334537,334539,0,2,0
95668,6,2,334543,334543,334545,0,2,4
95669,1,2,334544,334545,334547,1,3,0
95670,1,3,334545,334547,334550,2,5,0
95671,1,2,334546,334550,334552,4,6,0
95672,6,1,334552,334552,334553,0,1,0
95673,5,1,334557,334557,334558,0,1,4
95674,4,1,334561,334561,334562,0,1,3
95675,4,3,334565,334565,334568,0,3,3
95676,5,2,334570,334570,334572,0,2,2
95677,3,2,334573,334573,334575,0,2,1
95678,6,1,334579,334579,334580,0,1,4
95679,1,2,334580,334580,334582,0,2,0
95680,4,3,334584,334584,334587,0,3,2
95681,4,3,334588,334588,334591,0,3,1
95682,4,3,334592,334592,334595,0,3,1
95683,4,3,334596,334596,334599,0,3,1
95684,5,1,334601,334601,334602,0,1,2
95685,2,1,334603,334603,334604,0,1,1
95686,5,3,334608,334608,334611,0,3,4
95687,1,3,334609,334611,334614,2,5,0
95688,6,3,334615,334615,334618,0,3,1
95689,1,1,334616,334618,334619,2,3,0
95690,6,3,334622,334622,334625,0,3,3
95691,4,2,334626,334626,334628,0,2,1
95692,2,3,334628,334628,334631,0,3,0
95693,3,2,334631,334631,334633,0,2,0
95694,2,2,334633,334633,334635,0,2,0
95695,2,1,334635,334635,334636,0,1,0
95696,1,1,334636,334636,334637,0,1,0
95697,1,3,334637,334637,334640,0,3,0
95698,5,3,334642,334642,334645,0,3,2
95699,5,1,334647,334647,334648,0,1,2
95700,1,2,334648,334648,334650,0,2,0
95701,4,2,334652,334652,334654,0,2,2
95702,2,3,334654,334654,334657,0,3,0
95703,3,3,334657,334657,334660,0,3,0
95704,4,2,334661,334661,334663,0,2,1
95705,4,1,334665,334665,334666,0,1,2
95706,5,1,334670,334670,334671,0,1,4
95707,6,3,334676,334676,334679,0,3,5
95708,6,2,334682,334682,334684,0,2,3
95709,5,1,334687,334687,334688,0,1,3
95710,5,1,334692,334692,334693,0,1,4
95711,5,3,334697,334697,334700,0,3,4
95712,3,3,334700,334700,334703,0,3,0
95713,5,2,334705,334705,334707,0,2,2
95714,1,3,334706,334707,334710,1,4,0
95715,6,1,334712,334712,334713,0,1,2
95716,1,2,334713,334713,334715,0,2,0
95717,5,3,334718,334718,334721,0,3,3
95718,6,2,334724,334724,334726,0,2,3
95719,4,1,334728,334728,334729,0,1,2
95720,2,1,334730,334730,334731,0,1,1
95721,1,1,334731,334731,334732,0,1,0
95722,3,3,334734,334734,334737,0,3,2
95723,5,2,334739,334739,334741,0,2,2
95724,1,3,334740,334741,334744,1,4,0
95725,4,2,334744,334744,334746,0,2,0
95726,1,3,334745,334746,334749,1,4,0
95727,4,3,334749,334749,334752,0,3,0
95728,5,1,334754,334754,334755,0,1,2
95729,2,2,334756,334756,334758,0,2,1
95730,4,1,334760,334760,334761,0,1,2
95731,6,3,334766,334766,334769,0,3,5
95732,6,2,334772,334772,334774,0,2,3
95733,4,3,334776,334776,334779,0,3,2
95734,4,1,334780,334780,334781,0,1,1
95735,3,2,334783,334783,334785,0,2,2
95736,1,2,334784,334785,334787,1,3,0
95737,5,2,334789,334789,334791,0,2,2
95738,3,2,334792,334792,334794,0,2,1
95739,5,2,334797,334797,334799,0,2,3
95740,6,2,334803,334803,334805,0,2,4
95741,6,3,334809,334809,334812,0,3,4
95742,6,3,334815,334815,334818,0,3,3
95743,2,1,334817,334818,334819,1,2,0
95744,5,2,334822,334822,334824,0,2,3
95745,4,1,334826,334826,334827,0,1,2
95746,1,1,334827,334827,334828,0,1,0
95747,4,3,334831,334831,334834,0,3,3
95748,4,1,334835,334835,334836,0,1,1
95749,2,2,334837,334837,334839,0,2,1
95750,1,1,334838,334839,334840,1,2,0
95751,6,3,334844,334844,334847,0,3,4
95752,1,1,334845,334847,334848,2,3,0
95753,2,2,334847,334848,334850,1,3,0
95754,3,2,334850,334850,334852,0,2,0
95755,4,2,334854,334854,334856,0,2,2
95756,1,3,334855,334856,334859,1,4,0
95757,1,1,334856,334859,334860,3,4,0
95758,5,1,334861,334861,334862,0,1,1
95759,1,2,334862,334862,334864,0,2,0
95760,3,3,334865,334865,334868,0,3,1
95761,5,2,334870,334870,334872,0,2,2
95762,3,2,334873,334873,334875,0,2,1
95763,6,2,334879,334879,334881,0,2,4
95764,2,2,334881,334881,334883,0,2,0
95765,4,1,334885,334885,334886,0,1,2
95766,6,2,334891,334891,334893,0,2,5
95767,3,2,334894,334894,334896,0,2,1
95768,4,2,334898,334898,334900,0,2,2
95769,5,2,334903,334903,334905,0,2,3
95770,3,1,334906,334906,334907,0,1,1
95771,3,1,334909,334909,334910,0,1,2
95772,1,2,334910,334910,334912,0,2,0
95773,6,2,334916,334916,334918,0,2,4
95774,3,3,334919,334919,334922,0,3,1
95775,5,3,334924,334924,334927,0,3,2
95776,2,2,334926,334927,334929,1,3,0
95777,5,3,334931,334931,334934,0,3,2
95778,2,1,334933,334934,334935,1,2,0
95779,1,1,334934,334935,334936,1,2,0
95780,5,1,334939,334939,334940,0,1,3
95781,6,1,334945,334945,334946,0,1,5
95782,2,3,334947,334947,334950,0,3,1
95783,5,3,334952,334952,334955,0,3,2
95784,3,1,334955,334955,334956,0,1,0
95785,1,3,334956,334956,334959,0,3,0
95786,6,3,334962,334962,334965,0,3,3
95787,6,1,334968,334968,334969,0,1,3
95788,1,1,334969,334969,334970,0,1,0
95789,4,2,334973,334973,334975,0,2,3
95790,5,2,334978,334978,334980,0,2,3
95791,6,1,334984,334984,334985,0,1,4
95792,6,2,334990,334990,334992,0,2,5
95793,2,3,334992,334992,334995,0,3,0
95794,5,1,334997,334997,334998,0,1,2
95795,1,3,334998,334998,335001,0,3,0
95796,6,3,335004,335004,335007,0,3,3
95797,5,1,335009,335009,335010,0,1,2
95798,3,1,335012,335012,335013,0,1,2
95799,6,1,335018,335018,335019,0,1,5
95800,6,2,335024,335024,335026,0,2,5
95801,2,1,335026,335026,335027,0,1,0
95802,5,2,335031,335031,335033,0,2,4
95803,4,1,335035,335035,335036,0,1,2
95804,3,2,335038,335038,335040,0,2,2
95805,5,1,335043,335043,335044,0,1,3
95806,2,2,335045,335045,335047,0,2,1
95807,2,3,335047,335047,335050,0,3,0
95808,6,2,335053,335053,335055,0,2,3
95809,1,3,335054,335055,335058,1,4,0
95810,5,3,335059,335059,335062,0,3,1
95811,2,1,335061,335062,335063,1,2,0
95812,6,3,335067,335067,335070,0,3,4
95813,6,2,335073,335073,335075,0,2,3
95814,3,2,335076,335076,335078,0,2,1
95815,3,3,335079,335079,335082,0,3,1
95816,4,3,335083,335083,335086,0,3,1
95817,2,3,335085,335086,335089,1,4,0
95818,3,3,335088,335089,335092,1,4,0
95819,3,3,335091,335092,335095,1,4,0
95820,1,1,335092,335095,335096,3,4,0
95821,3,1,335095,335096,335097,1,2,0
95822,3,1,335098,335098,335099,0,1,1
95823,1,1,335099,335099,335100,0,1,0
95824,4,2,335103,335103,335105,0,2,3
95825,2,2,335105,335105,335107,0,2,0
95826,3,1,335108,335108,335109,0,1,1
95827,2,2,335110,335110,335112,0,2,1
95828,3,1,335113,335113,335114,0,1,1
95829,4,2,335117,335117,335119,0,2,3
95830,4,2,335121,335121,335123,0,2,2
95831,5,2,335126,335126,335128,0,2,3
95832,6,2,335132,335132,335134,0,2,4
95833,4,1,335136,335136,335137,0,1,2
95834,4,1,335140,335140,335141,0,1,3
95835,3,3,335143,335143,335146,0,3,2
95836,3,2,335146,335146,335148,0,2,0
95837,2,2,335148,335148,335150,0,2,0
95838,6,3,335154,335154,335157,0,3,4
95839,2,3,335156,335157,335160,1,4,0
95840,6,1,335162,335162,335163,0,1,2
95841,1,3,335163,335163,335166,0,3,0
95842,3,3,335166,335166,335169,0,3,0
95843,2,2,335168,335169,335171,1,3,0
95844,1,2,335169,335171,335173,2,4,0
95845,3,1,335172,335173,335174,1,2,0
95846,1,1,335173,335174,335175,1,2,0
95847,4,3,335177,335177,335180,0,3,2
95848,2,3,335179,335180,335183,1,4,0
95849,4,1,335183,335183,335184,0,1,0
95850,3,2,335186,335186,335188,0,2,2
95851,1,1,335187,335188,335189,1,2,0
95852,4,2,335191,335191,335193,0,2,2
95853,6,1,335197,335197,335198,0,1,4
95854,5,2,335202,335202,335204,0,2,4
95855,5,1,335207,335207,335208,0,1,3
95856,6,2,335213,335213,335215,0,2,5
95857,1,3,335214,335215,335218,1,4,0
95858,3,3,335217,335218,335221,1,4,0
95859,1,1,335218,335221,335222,3,4,0
95860,1,3,335219,335222,335225,3,6,0
95861,5,1,335224,335225,335226,1,2,0
95862,1,3,335225,335226,335229,1,4,0
95863,1,2,335226,335229,335231,3,5,0
95864,1,2,335227,335231,335233,4,6,0
95865,2,1,335229,335233,335234,4,5,0
95866,6,3,335235,335235,335238,0,3,1
95867,5,1,335240,335240,335241,0,1,2
95868,1,1,335241,335241,335242,0,1,0
95869,2,2,335243,335243,335245,0,2,1
95870,4,3,335247,335247,335250,0,3,2
95871,3,3,335250,335250,335253,0,3,0
95872,5,3,335255,335255,335258,0,3,2
95873,3,2,335258,335258,335260,0,2,0
95874,1,1,335259,335260,335261,1,2,0
95875,6,1,335265,335265,335266,0,1,4
95876,6,2,335271,335271,335273,0,2,5
95877,3,2,335274,335274,335276,0,2,1
95878,6,3,335280,335280,335283,0,3,4
95879,2,3,335282,335283,335286,1,4,0
95880,6,3,335288,335288,335291,0,3,2
95881,3,2,335291,335291,335293,0,2,0
95882,2,2,335293,335293,335295,0,2,0
95883,3,2,335296,335296,335298,0,2,1
95884,6,3,335302,335302,335305,0,3,4
95885,2,1,335304,335305,335306,1,2,0
95886,6,3,335310,335310,335313,0,3,4
95887,5,3,335315,335315,335318,0,3,2
95888,1,2,335316,335318,335320,2,4,0
95889,3,2,335319,335320,335322,1,3,0
95890,1,1,335320,335322,335323,2,3,0
95891,1,3,335321,335323,335326,2,5,0
95892,1,2,335322,335326,335328,4,6,0
95893,2,3,335324,335328,335331,4,7,0
95894,1,2,335325,335331,335333,6,8,0
95895,3,2,335328,335333,335335,5,7,0
95896,3,1,335331,335335,335336,4,5,0
95897,5,2,335336,335336,335338,0,2,0
95898,5,1,335341,335341,335342,0,1,3
95899,6,2,335347,335347,335349,0,2,5
95900,1,3,335348,335349,335352,1,4,0
95901,2,1,335350,335352,335353,2,3,0
95902,4,3,335354,335354,335357,0,3,1
95903,1,1,335355,335357,335358,2,3,0
95904,3,1,335358,335358,335359,0,1,0
95905,4,3,335362,335362,335365,0,3,3
95906,4,2,335366,335366,335368,0,2,1
95907,2,1,335368,335368,335369,0,1,0
95908,6,1,335374,335374,335375,0,1,5
95909,6,2,335380,335380,335382,0,2,5
95910,1,3,335381,335382,335385,1,4,0
95911,1,3,335382,335385,335388,3,6,0
95912,1,3,335383,335388,335391,5,8,0
95913,3,2,335386,335391,335393,5,7,0
95914,6,3,335392,335393,335396,1,4,0
95915,5,1,335397,335397,335398,0,1,1
95916,6,3,335403,335403,335406,0,3,5
95917,3,3,335406,335406,335409,0,3,0
95918,5,3,335411,335411,335414,0,3,2
95919,3,2,335414,335414,335416,0,2,0
95920,5,1,335419,335419,335420,0,1,3
95921,5,2,335424,335424,335426,0,2,4
95922,1,1,335425,335426,335427,1,2,0
95923,1,1,335426,335427,335428,1,2,0
95924,2,1,335428,335428,335429,0,1,0
95925,3,3,335431,335431,335434,0,3,2
95926,2,2,335433,335434,335436,1,3,0
95927,2,1,335435,335436,335437,1,2,0
95928,2,2,335437,335437,335439,0,2,0
95929,2,1,335439,335439,335440,0,1,0
95930,5,3,335444,335444,335447,0,3,4
95931,4,2,335448,335448,335450,0,2,1
95932,1,3,335449,335450,335453,1,4,0
95933,1,2,335450,335453,335455,3,5,0
95934,3,2,335453,335455,335457,2,4,0
95935,6,1,335459,335459,335460,0,1,2
95936,5,3,335464,335464,335467,0,3,4
95937,2,1,335466,335467,335468,1,2,0
95938,6,2,335472,335472,335474,0,2,4
95939,4,2,335476,335476,335478,0,2,2
95940,5,1,335481,335481,335482,0,1,3
95941,6,1,335487,335487,335488,0,1,5
95942,2,2,335489,335489,335491,0,2,1
95943,3,1,335492,335492,335493,0,1,1
95944,1,3,335493,335493,335496,0,3,0
95945,2,3,335495,335496,335499,1,4,0
95946,2,3,335497,335499,335502,2,5,0
95947,1,3,335498,335502,335505,4,7,0
95948,4,3,335502,335505,335508,3,6,0
95949,3,2,335505,335508,335510,3,5,0
95950,1,2,335506,335510,335512,4,6,0
95951,5,2,335511,335512,335514,1,3,0
95952,4,3,335515,335515,335518,0,3,1
95953,1,1,335516,335518,335519,2,3,0
95954,4,2,335520,335520,335522,0,2,1
95955,6,2,335526,335526,335528,0,2,4
95956,4,1,335530,335530,335531,0,1,2
95957,2,2,335532,335532,335534,0,2,1
95958,6,3,335538,335538,335541,0,3,4
95959,1,1,335539,335541,335542,2,3,0
95960,1,3,335540,335542,335545,2,5,0
95961,1,3,335541,335545,335548,4,7,0
95962,1,1,335542,335548,335549,6,7,0
95963,3,2,335545,335549,335551,4,6,0
95964,1,3,335546,335551,335554,5,8,0
95965,2,3,335548,335554,335557,6,9,0
95966,6,2,335554,335557,335559,3,5,0
95967,1,2,335555,335559,335561,4,6,0
95968,1,3,335556,335561,335564,5,8,0
95969,6,1,335562,335564,335565,2,3,0
95970,1,3,335563,335565,335568,2,5,0
95971,5,1,335568,335568,335569,0,1,0
95972,5,2,335573,335573,335575,0,2,4
95973,6,2,335579,335579,335581,0,2,4
95974,3,3,335582,335582,335585,0,3,1
95975,3,2,335585,335585,335587,0,2,0
95976,5,3,335590,335590,335593,0,3,3
95977,6,3,335596,335596,335599,0,3,3
95978,3,3,335599,335599,335602,0,3,0
95979,5,1,335604,335604,335605,0,1,2
95980,1,1,335605,335605,335606,0,1,0
95981,1,1,335606,335606,335607,0,1,0
95982,1,3,335607,335607,335610,0,3,0
95983,6,1,335613,335613,335614,0,1,3
95984,4,2,335617,335617,335619,0,2,3
95985,5,1,335622,335622,335623,0,1,3
95986,4,2,335626,335626,335628,0,2,3
95987,4,2,335630,335630,335632,0,2,2
95988,6,1,335636,335636,335637,0,1,4
95989,6,2,335642,335642,335644,0,2,5
95990,1,3,335643,335644,335647,1,4,0
95991,6,1,335649,335649,335650,0,1,2
95992,5,1,335654,335654,335655,0,1,4
95993,2,2,335656,335656,335658,0,2,1
95994,2,1,335658,335658,335659,0,1,0
95995,5,1,335663,335663,335664,0,1,4
95996,6,3,335669,335669,335672,0,3,5
95997,6,2,335675,335675,335677,0,2,3
95998,1,2,335676,335677,335679,1,3,0
95999,4,3,335680,335680,335683,0,3,1
96000,6,3,335686,335686,335689,0,3,3
96001,1,1,335687,335689,335690,2,3,0
96002,6,1,335693,335693,335694,0,1,3
96003,1,3,335694,335694,335697,0,3,0
96004,3,1,335697,335697,335698,0,1,0
96005,6,3,335703,335703,335706,0,3,5
96006,4,2,335707,335707,335709,0,2,1
96007,4,2,335711,335711,335713,0,2,2
96008,4,1,335715,335715,335716,0,1,2
96009,5,2,335720,335720,335722,0,2,4
96010,6,3,335726,335726,335729,0,3,4
96011,5,3,335731,335731,335734,0,3,2
96012,5,1,335736,335736,335737,0,1,2
96013,4,3,335740,335740,335743,0,3,3
96014,4,1,335744,335744,335745,0,1,1
96015,4,2,335748,335748,335750,0,2,3
96016,2,3,335750,335750,335753,0,3,0
96017,1,3,335751,335753,335756,2,5,0
96018,5,3,335756,335756,335759,0,3,0
96019,4,1,335760,335760,335761,0,1,1
96020,4,3,335764,335764,335767,0,3,3
96021,3,2,335767,335767,335769,0,2,0
96022,1,3,335768,335769,335772,1,4,0
96023,4,1,335772,335772,335773,0,1,0
96024,4,3,335776,335776,335779,0,3,3
96025,1,1,335777,335779,335780,2,3,0
96026,2,1,335779,335780,335781,1,2,0
96027,4,3,335783,335783,335786,0,3,2
96028,2,2,335785,335786,335788,1,3,0
96029,4,2,335789,335789,335791,0,2,1
96030,1,1,335790,335791,335792,1,2,0
96031,5,2,335795,335795,335797,0,2,3
96032,5,2,335800,335800,335802,0,2,3
96033,6,2,335806,335806,335808,0,2,4
96034,4,2,335810,335810,335812,0,2,2
96035,4,3,335814,335814,335817,0,3,2
96036,1,3,335815,335817,335820,2,5,0
96037,6,3,335821,335821,335824,0,3,1
96038,5,1,335826,335826,335827,0,1,2
96039,2,2,335828,335828,335830,0,2,1
96040,5,2,335833,335833,335835,0,2,3
96041,2,3,335835,335835,335838,0,3,0
96042,5,1,335840,335840,335841,0,1,2
96043,2,2,335842,335842,335844,0,2,1
96044,6,2,335848,335848,335850,0,2,4
96045,4,2,335852,335852,335854,0,2,2
96046,3,2,335855,335855,335857,0,2,1
96047,6,3,335861,335861,335864,0,3,4
96048,6,2,335867,335867,335869,0,2,3
96049,3,1,335870,335870,335871,0,1,1
96050,3,1,335873,335873,335874,0,1,2
96051,1,3,335874,335874,335877,0,3,0
96052,5,2,335879,335879,335881,0,2,2
96053,6,1,335885,335885,335886,0,1,4
96054,1,3,335886,335886,335889,0,3,0
96055,5,3,335891,335891,335894,0,3,2
96056,3,2,335894,335894,335896,0,2,0
96057,3,3,335897,335897,335900,0,3,1
96058,5,1,335902,335902,335903,0,1,2
96059,2,1,335904,335904,335905,0,1,1
96060,2,1,335906,335906,335907,0,1,1
96061,2,2,335908,335908,335910,0,2,1
96062,4,1,335912,335912,335913,0,1,2
96063,3,2,335915,335915,335917,0,2,2
96064,6,1,335921,335921,335922,0,1,4
96065,4,1,335925,335925,335926,0,1,3
96066,4,2,335929,335929,335931,0,2,3
96067,5,2,335934,335934,335936,0,2,3
96068,3,3,335937,335937,335940,0,3,1
96069,3,3,335940,335940,335943,0,3,0
96070,4,1,335944,335944,335945,0,1,1
96071,1,1,335945,335945,335946,0,1,0
96072,4,1,335949,335949,335950,0,1,3
96073,1,3,335950,335950,335953,0,3,0
96074,4,1,335954,335954,335955,0,1,1
96075,5,3,335959,335959,335962,0,3,4
96076,2,1,335961,335962,335963,1,2,0
96077,3,1,335964,335964,335965,0,1,1
96078,4,2,335968,335968,335970,0,2,3
96079,5,1,335973,335973,335974,0,1,3
96080,2,3,335975,335975,335978,0,3,1
96081,5,1,335980,335980,335981,0,1,2
96082,4,2,335984,335984,335986,0,2,3
96083,3,3,335987,335987,335990,0,3,1
96084,3,3,335990,335990,335993,0,3,0
96085,3,1,335993,335993,335994,0,1,0
96086,2,1,335995,335995,335996,0,1,1
96087,1,2,335996,335996,335998,0,2,0
96088,4,3,336000,336000,336003,0,3,2
96089,5,2,336005,336005,336007,0,2,2
96090,2,2,336007,336007,336009,0,2,0
96091,2,3,336009,336009,336012,0,3,0
96092,3,3,336012,336012,336015,0,3,0
96093,3,2,336015,336015,336017,0,2,0
96094,2,2,336017,336017,336019,0,2,0
96095,2,3,336019,336019,336022,0,3,0
96096,1,3,336020,336022,336025,2,5,0
96097,1,1,336021,336025,336026,4,5,0
96098,1,3,336022,336026,336029,4,7,0
96099,6,2,336028,336029,336031,1,3,0
96100,4,2,336032,336032,336034,0,2,1
96101,1,2,336033,336034,336036,1,3,0
96102,3,3,336036,336036,336039,0,3,0
96103,1,3,336037,336039,336042,2,5,0
96104,6,3,336043,336043,336046,0,3,1
96105,3,2,336046,336046,336048,0,2,0
96106,1,3,336047,336048,336051,1,4,0
96107,6,2,336053,336053,336055,0,2,2
96108,3,1,336056,336056,336057,0,1,1
96109,5,3,336061,336061,336064,0,3,4
96110,3,1,336064,336064,336065,0,1,0
96111,5,2,336069,336069,336071,0,2,4
96112,6,3,336075,336075,336078,0,3,4
96113,5,2,336080,336080,336082,0,2,2
96114,2,3,336082,336082,336085,0,3,0
96115,4,2,336086,336086,336088,0,2,1
96116,2,2,336088,336088,336090,0,2,0
96117,3,1,336091,336091,336092,0,1,1
96118,3,3,336094,336094,336097,0,3,2
96119,3,3,336097,336097,336100,0,3,0
96120,2,2,336099,336100,336102,1,3,0
96121,3,1,336102,336102,336103,0,1,0
96122,4,1,336106,336106,336107,0,1,3
96123,5,3,336111,336111,336114,0,3,4
96124,1,3,336112,336114,336117,2,5,0
96125,5,2,336117,336117,336119,0,2,0
96126,2,1,336119,336119,336120,0,1,0
96127,6,3,336125,336125,336128,0,3,5
96128,6,2,336131,336131,336133,0,2,3
96129,5,3,336136,336136,336139,0,3,3
96130,5,3,336141,336141,336144,0,3,2
96131,4,3,336145,336145,336148,0,3,1
96132,3,2,336148,336148,336150,0,2,0
96133,1,1,336149,336150,336151,1,2,0
96134,2,1,336151,336151,336152,0,1,0
96135,4,3,336155,336155,336158,0,3,3
96136,4,1,336159,336159,336160,0,1,1
96137,1,1,336160,336160,336161,0,1,0
96138,6,2,336166,336166,336168,0,2,5
96139,4,1,336170,336170,336171,0,1,2
96140,1,2,336171,336171,336173,0,2,0
96141,6,3,336177,336177,336180,0,3,4
96142,6,3,336183,336183,336186,0,3,3
96143,1,2,336184,336186,336188,2,4,0
96144,1,3,336185,336188,336191,3,6,0
96145,6,2,336191,336191,336193,0,2,0
96146,4,1,336195,336195,336196,0,1,2
96147,2,1,336197,336197,336198,0,1,1
96148,3,2,336200,336200,336202,0,2,2
96149,2,1,336202,336202,336203,0,1,0
96150,4,2,336206,336206,336208,0,2,3
96151,2,2,336208,336208,336210,0,2,0
96152,2,3,336210,336210,336213,0,3,0
96153,5,2,336215,336215,336217,0,2,2
96154,6,2,336221,336221,336223,0,2,4
96155,2,3,336223,336223,336226,0,3,0
96156,3,3,336226,336226,336229,0,3,0
96157,6,3,336232,336232,336235,0,3,3
96158,6,2,336238,336238,336240,0,2,3
96159,3,3,336241,336241,336244,0,3,1
96160,2,2,336243,336244,336246,1,3,0
96161,6,2,336249,336249,336251,0,2,3
96162,2,2,336251,336251,336253,0,2,0
96163,2,3,336253,336253,336256,0,3,0
96164,2,1,336255,336256,336257,1,2,0
96165,3,1,336258,336258,336259,0,1,1
96166,5,2,336263,336263,336265,0,2,4
96167,1,2,336264,336265,336267,1,3,0
96168,2,1,336266,336267,336268,1,2,0
96169,5,1,336271,336271,336272,0,1,3
96170,5,1,336276,336276,336277,0,1,4
96171,1,1,336277,336277,336278,0,1,0
96172,4,2,336281,336281,336283,0,2,3
96173,4,1,336285,336285,336286,0,1,2
96174,4,2,336289,336289,336291,0,2,3
96175,2,2,336291,336291,336293,0,2,0
96176,1,1,336292,336293,336294,1,2,0
96177,3,2,336295,336295,336297,0,2,1
96178,2,2,336297,336297,336299,0,2,0
96179,6,3,336303,336303,336306,0,3,4
96180,5,2,336308,336308,336310,0,2,2
96181,6,3,336314,336314,336317,0,3,4
96182,5,2,336319,336319,336321,0,2,2
96183,3,1,336322,336322,336323,0,1,1
96184,4,2,336326,336326,336328,0,2,3
96185,2,2,336328,336328,336330,0,2,0
96186,3,2,336331,336331,336333,0,2,1
96187,3,2,336334,336334,336336,0,2,1
96188,5,1,336339,336339,336340,0,1,3
96189,4,1,336343,336343,336344,0,1,3
96190,1,2,336344,336344,336346,0,2,0
96191,2,1,336346,336346,336347,0,1,0
96192,6,3,336352,336352,336355,0,3,5
96193,5,2,336357,336357,336359,0,2,2
96194,2,1,336359,336359,336360,0,1,0
96195,2,1,336361,336361,336362,0,1,1
96196,1,3,336362,336362,336365,0,3,0
96197,1,2,336363,336365,336367,2,4,0
96198,2,2,336365,336367,336369,2,4,0
96199,2,2,336367,336369,336371,2,4,0
96200,6,3,336373,336373,336376,0,3,2
96201,6,3,336379,336379,336382,0,3,3
96202,2,2,336381,336382,336384,1,3,0
96203,6,1,336387,336387,336388,0,1,3
96204,4,3,336391,336391,336394,0,3,3
96205,4,3,336395,336395,336398,0,3,1
96206,2,1,336397,336398,336399,1,2,0
96207,1,3,336398,336399,336402,1,4,0
96208,3,3,336401,336402,336405,1,4,0
96209,3,1,336404,336405,336406,1,2,0
96210,4,1,336408,336408,336409,0,1,2
96211,4,1,336412,336412,336413,0,1,3
96212,1,1,336413,336413,336414,0,1,0
96213,3,2,336416,336416,336418,0,2,2
96214,1,2,336417,336418,336420,1,3,0
96215,6,3,336423,336423,336426,0,3,3
96216,1,3,336424,336426,336429,2,5,0
96217,3,3,336427,336429,336432,2,5,0
96218,1,2,336428,336432,336434,4,6,0
96219,3,3,336431,336434,336437,3,6,0
96220,5,2,336436,336437,336439,1,3,0
96221,2,1,336438,336439,336440,1,2,0
96222,4,3,336442,336442,336445,0,3,2
96223,1,1,336443,336445,336446,2,3,0
96224,6,1,336449,336449,336450,0,1,3
96225,5,3,336454,336454,336457,0,3,4
96226,5,2,336459,336459,336461,0,2,2
96227,4,2,336463,336463,336465,0,2,2
96228,4,3,336467,336467,336470,0,3,2
96229,2,2,336469,336470,336472,1,3,0
96230,2,3,336471,336472,336475,1,4,0
96231,4,2,336475,336475,336477,0,2,0
96232,3,3,336478,336478,336481,0,3,1
96233,6,2,336484,336484,336486,0,2,3
96234,2,1,336486,336486,336487,0,1,0
96235,4,3,336490,336490,336493,0,3,3
96236,5,2,336495,336495,336497,0,2,2
96237,4,3,336499,336499,336502,0,3,2
96238,2,1,336501,336502,336503,1,2,0
96239,3,1,336504,336504,336505,0,1,1
96240,4,3,336508,336508,336511,0,3,3
96241,4,2,336512,336512,336514,0,2,1
96242,3,2,336515,336515,336517,0,2,1
96243,3,1,336518,336518,336519,0,1,1
96244,2,1,336520,336520,336521,0,1,1
96245,3,3,336523,336523,336526,0,3,2
96246,3,2,336526,336526,336528,0,2,0
96247,5,2,336531,336531,336533,0,2,3
96248,4,3,336535,336535,336538,0,3,2
96249,2,1,336537,336538,336539,1,2,0
96250,4,2,336541,336541,336543,0,2,2
96251,1,1,336542,336543,336544,1,2,0
96252,1,3,336543,336544,336547,1,4,0
96253,5,2,336548,336548,336550,0,2,1
96254,2,2,336550,336550,336552,0,2,0
96255,3,3,336553,336553,336556,0,3,1
96256,6,2,336559,336559,336561,0,2,3
96257,4,1,336563,336563,336564,0,1,2
96258,1,3,336564,336564,336567,0,3,0
96259,1,2,336565,336567,336569,2,4,0
96260,3,3,336568,336569,336572,1,4,0
96261,2,3,336570,336572,336575,2,5,0
96262,1,2,336571,336575,336577,4,6,0
96263,1,1,336572,336577,336578,5,6,0
96264,1,3,336573,336578,336581,5,8,0
96265,6,2,336579,336581,336583,2,4,0
96266,4,1,336583,336583,336584,0,1,0
96267,1,3,336584,336584,336587,0,3,0
96268,6,1,336590,336590,336591,0,1,3
96269,5,3,336595,336595,336598,0,3,4
96270,5,3,336600,336600,336603,0,3,2
96271,2,3,336602,336603,336606,1,4,0
96272,2,2,336604,336606,336608,2,4,0
96273,4,1,336608,336608,336609,0,1,0
96274,6,2,336614,336614,336616,0,2,5
96275,6,1,336620,336620,336621,0,1,4
96276,4,3,336624,336624,336627,0,3,3
96277,2,1,336626,336627,336628,1,2,0
96278,2,2,336628,336628,336630,0,2,0
96279,6,2,336634,336634,336636,0,2,4
96280,6,3,336640,336640,336643,0,3,4
96281,4,2,336644,336644,336646,0,2,1
96282,2,2,336646,336646,336648,0,2,0
96283,1,3,336647,336648,336651,1,4,0
96284,3,1,336650,336651,336652,1,2,0
96285,1,3,336651,336652,336655,1,4,0
96286,1,1,336652,336655,336656,3,4,0
96287,3,2,336655,336656,336658,1,3,0
96288,4,1,336659,336659,336660,0,1,1
96289,4,2,336663,336663,336665,0,2,3
96290,5,1,336668,336668,336669,0,1,3
96291,6,3,336674,336674,336677,0,3,5
96292,5,2,336679,336679,336681,0,2,2
96293,2,2,336681,336681,336683,0,2,0
96294,2,2,336683,336683,336685,0,2,0
96295,3,2,336686,336686,336688,0,2,1
96296,3,2,336689,336689,336691,0,2,1
96297,4,3,336693,336693,336696,0,3,2
96298,1,1,336694,336696,336697,2,3,0
96299,2,1,336696,336697,336698,1,2,0
96300,2,3,336698,336698,336701,0,3,0
96301,5,2,336703,336703,336705,0,2,2
96302,5,2,336708,336708,336710,0,2,3
96303,3,3,336711,336711,336714,0,3,1
96304,3,2,336714,336714,336716,0,2,0
96305,4,2,336718,336718,336720,0,2,2
96306,1,1,336719,336720,336721,1,2,0
96307,5,2,336724,336724,336726,0,2,3
96308,5,3,336729,336729,336732,0,3,3
96309,4,3,336733,336733,336736,0,3,1
96310,2,1,336735,336736,336737,1,2,0
96311,3,3,336738,336738,336741,0,3,1
96312,3,1,336741,336741,336742,0,1,0
96313,3,1,336744,336744,336745,0,1,2
96314,2,3,336746,336746,336749,0,3,1
96315,3,1,336749,336749,336750,0,1,0
96316,6,1,336755,336755,336756,0,1,5
96317,5,2,336760,336760,336762,0,2,4
96318,2,2,336762,336762,336764,0,2,0
96319,1,3,336763,336764,336767,1,4,0
96320,6,2,336769,336769,336771,0,2,2
96321,5,3,336774,336774,336777,0,3,3
96322,5,3,336779,336779,336782,0,3,2
96323,6,3,336785,336785,336788,0,3,3
96324,4,1,336789,336789,336790,0,1,1
96325,4,2,336793,336793,336795,0,2,3
96326,1,1,336794,336795,336796,1,2,0
96327,3,1,336797,336797,336798,0,1,1
96328,3,1,336800,336800,336801,0,1,2
96329,2,2,336802,336802,336804,0,2,1
96330,5,1,336807,336807,336808,0,1,3
96331,1,3,336808,336808,336811,0,3,0
96332,5,2,336813,336813,336815,0,2,2
96333,1,1,336814,336815,336816,1,2,0
96334,3,2,336817,336817,336819,0,2,1
96335,2,1,336819,336819,336820,0,1,0
96336,3,1,336822,336822,336823,0,1,2
96337,1,3,336823,336823,336826,0,3,0
96338,3,3,336826,336826,336829,0,3,0
96339,3,2,336829,336829,336831,0,2,0
96340,2,3,336831,336831,336834,0,3,0
96341,1,3,336832,336834,336837,2,5,0
96342,4,2,336836,336837,336839,1,3,0
96343,2,2,336838,336839,336841,1,3,0
96344,5,2,336843,336843,336845,0,2,2
96345,1,2,336844,336845,336847,1,3,0
96346,5,2,336849,336849,336851,0,2,2
96347,3,3,336852,336852,336855,0,3,1
96348,5,2,336857,336857,336859,0,2,2
96349,3,3,336860,336860,336863,0,3,1
96350,6,3,336866,336866,336869,0,3,3
96351,4,1,336870,336870,336871,0,1,1
96352,3,2,336873,336873,336875,0,2,2
96353,3,3,336876,336876,336879,0,3,1
96354,3,3,336879,336879,336882,0,3,0
96355,6,3,336885,336885,336888,0,3,3
96356,2,1,336887,336888,336889,1,2,0
96357,5,3,336892,336892,336895,0,3,3
96358,5,3,336897,336897,336900,0,3,2
96359,6,3,336903,336903,336906,0,3,3
96360,2,2,336905,336906,336908,1,3,0
96361,4,2,336909,336909,336911,0,2,1
96362,3,1,336912,336912,336913,0,1,1
96363,6,2,336918,336918,336920,0,2,5
96364,5,2,336923,336923,336925,0,2,3
96365,6,3,336929,336929,336932,0,3,4
96366,6,2,336935,336935,336937,0,2,3
96367,3,2,336938,336938,336940,0,2,1
96368,5,2,336943,336943,336945,0,2,3
96369,3,2,336946,336946,336948,0,2,1
96370,2,2,336948,336948,336950,0,2,0
96371,4,3,336952,336952,336955,0,3,2
96372,6,1,336958,336958,336959,0,1,3
96373,1,2,336959,336959,336961,0,2,0
96374,3,2,336962,336962,336964,0,2,1
96375,3,2,336965,336965,336967,0,2,1
96376,3,1,336968,336968,336969,0,1,1
96377,6,2,336974,336974,336976,0,2,5
96378,6,1,336980,336980,336981,0,1,4
96379,5,3,336985,336985,336988,0,3,4
96380,2,1,336987,336988,336989,1,2,0
96381,5,3,336992,336992,336995,0,3,3
96382,4,2,336996,336996,336998,0,2,1
96383,6,1,337002,337002,337003,0,1,4
96384,2,3,337004,337004,337007,0,3,1
96385,6,1,337010,337010,337011,0,1,3
96386,5,3,337015,337015,337018,0,3,4
96387,1,1,337016,337018,337019,2,3,0
96388,2,2,337018,337019,337021,1,3,0
96389,6,3,337024,337024,337027,0,3,3
96390,5,2,337029,337029,337031,0,2,2
96391,5,1,337034,337034,337035,0,1,3
96392,2,1,337036,337036,337037,0,1,1
96393,2,3,337038,337038,337041,0,3,1
96394,4,2,337042,337042,337044,0,2,1
96395,2,3,337044,337044,337047,0,3,0
96396,5,2,337049,337049,337051,0,2,2
96397,2,2,337051,337051,337053,0,2,0
96398,2,3,337053,337053,337056,0,3,0
96399,2,1,337055,337056,337057,1,2,0
96400,1,1,337056,337057,337058,1,2,0
96401,6,2,337062,337062,337064,0,2,4
96402,1,3,337063,337064,337067,1,4,0
96403,2,3,337065,337067,337070,2,5,0
96404,1,2,337066,337070,337072,4,6,0
96405,1,1,337067,337072,337073,5,6,0
96406,5,1,337072,337073,337074,1,2,0
96407,2,2,337074,337074,337076,0,2,0
96408,2,2,337076,337076,337078,0,2,0
96409,2,1,337078,337078,337079,0,1,0
96410,5,3,337083,337083,337086,0,3,4
96411,3,1,337086,337086,337087,0,1,0
96412,6,1,337092,337092,337093,0,1,5
96413,5,3,337097,337097,337100,0,3,4
96414,5,1,337102,337102,337103,0,1,2
96415,4,3,337106,337106,337109,0,3,3
96416,6,3,337112,337112,337115,0,3,3
96417,6,1,337118,337118,337119,0,1,3
96418,2,1,337120,337120,337121,0,1,1
96419,6,3,337126,337126,337129,0,3,5
96420,2,3,337128,337129,337132,1,4,0
96421,2,3,337130,337132,337135,2,5,0
96422,6,1,337136,337136,337137,0,1,1
96423,2,1,337138,337138,337139,0,1,1
96424,1,1,337139,337139,337140,0,1,0
96425,6,2,337145,337145,337147,0,2,5
96426,3,3,337148,337148,337151,0,3,1
96427,1,2,337149,337151,337153,2,4,0
96428,1,3,337150,337153,337156,3,6,0
96429,4,2,337154,337156,337158,2,4,0
96430,6,1,337160,337160,337161,0,1,2
96431,5,3,337165,337165,337168,0,3,4
96432,5,3,337170,337170,337173,0,3,2
96433,5,3,337175,337175,337178,0,3,2
96434,1,3,337176,337178,337181,2,5,0
96435,4,1,337180,337181,337182,1,2,0
96436,5,1,337185,337185,337186,0,1,3
96437,5,3,337190,337190,337193,0,3,4
96438,4,1,337194,337194,337195,0,1,1
96439,3,2,337197,337197,337199,0,2,2
96440,3,3,337200,337200,337203,0,3,1
96441,1,1,337201,337203,337204,2,3,0
96442,3,1,337204,337204,337205,0,1,0
96443,3,1,337207,337207,337208,0,1,2
96444,3,3,337210,337210,337213,0,3,2
96445,4,3,337214,337214,337217,0,3,1
96446,6,3,337220,337220,337223,0,3,3
96447,2,3,337222,337223,337226,1,4,0
96448,2,2,337224,337226,337228,2,4,0
96449,3,2,337227,337228,337230,1,3,0
96450,5,3,337232,337232,337235,0,3,2
96451,4,2,337236,337236,337238,0,2,1
96452,3,3,337239,337239,337242,0,3,1
96453,1,1,337240,337242,337243,2,3,0
96454,6,3,337246,337246,337249,0,3,3
96455,6,1,337252,337252,337253,0,1,3
96456,2,1,337254,337254,337255,0,1,1
96457,4,1,337258,337258,337259,0,1,3
96458,4,2,337262,337262,337264,0,2,3
96459,5,2,337267,337267,337269,0,2,3
96460,4,3,337271,337271,337274,0,3,2
96461,1,3,337272,337274,337277,2,5,0
96462,1,2,337273,337277,337279,4,6,0
96463,4,1,337277,337279,337280,2,3,0
96464,4,3,337281,337281,337284,0,3,1
96465,5,3,337286,337286,337289,0,3,2
96466,5,3,337291,337291,337294,0,3,2
96467,3,2,337294,337294,337296,0,2,0
96468,5,3,337299,337299,337302,0,3,3
96469,2,2,337301,337302,337304,1,3,0
96470,4,2,337305,337305,337307,0,2,1
96471,5,3,337310,337310,337313,0,3,3
96472,1,3,337311,337313,337316,2,5,0
96473,5,3,337316,337316,337319,0,3,0
96474,5,2,337321,337321,337323,0,2,2
96475,5,3,337326,337326,337329,0,3,3
96476,4,1,337330,337330,337331,0,1,1
96477,1,3,337331,337331,337334,0,3,0
96478,3,2,337334,337334,337336,0,2,0
96479,5,3,337339,337339,337342,0,3,3
96480,1,2,337340,337342,337344,2,4,0
96481,1,3,337341,337344,337347,3,6,0
96482,2,3,337343,337347,337350,4,7,0
96483,3,1,337346,337350,337351,4,5,0
96484,5,2,337351,337351,337353,0,2,0
96485,5,2,337356,337356,337358,0,2,3
96486,4,2,337360,337360,337362,0,2,2
96487,2,2,337362,337362,337364,0,2,0
96488,6,1,337368,337368,337369,0,1,4
96489,3,1,337371,337371,337372,0,1,2
96490,1,3,337372,337372,337375,0,3,0
96491,5,1,337377,337377,337378,0,1,2
96492,5,3,337382,337382,337385,0,3,4
96493,2,1,337384,337385,337386,1,2,0
96494,4,1,337388,337388,337389,0,1,2
96495,3,1,337391,337391,337392,0,1,2
96496,4,3,337395,337395,337398,0,3,3
96497,3,3,337398,337398,337401,0,3,0
96498,2,1,337400,337401,337402,1,2,0
96499,4,2,337404,337404,337406,0,2,2
96500,2,1,337406,337406,337407,0,1,0
96501,5,3,337411,337411,337414,0,3,4
96502,1,2,337412,337414,337416,2,4,0
96503,3,3,337415,337416,337419,1,4,0
96504,6,2,337421,337421,337423,0,2,2
96505,5,1,337426,337426,337427,0,1,3
96506,3,2,337429,337429,337431,0,2,2
96507,2,3,337431,337431,337434,0,3,0
96508,1,1,337432,337434,337435,2,3,0
96509,2,2,337434,337435,337437,1,3,0
96510,5,1,337439,337439,337440,0,1,2
96511,4,3,337443,337443,337446,0,3,3
96512,5,1,337448,337448,337449,0,1,2
96513,2,3,337450,337450,337453,0,3,1
96514,5,3,337455,337455,337458,0,3,2
96515,6,3,337461,337461,337464,0,3,3
96516,5,3,337466,337466,337469,0,3,2
96517,1,2,337467,337469,337471,2,4,0
96518,5,1,337472,337472,337473,0,1,1
96519,2,1,337474,337474,337475,0,1,1
96520,6,2,337480,337480,337482,0,2,5
96521,6,2,337486,337486,337488,0,2,4
96522,3,2,337489,337489,337491,0,2,1
96523,5,1,337494,337494,337495,0,1,3
96524,6,2,337500,337500,337502,0,2,5
96525,4,3,337504,337504,337507,0,3,2
96526,3,1,337507,337507,337508,0,1,0
96527,5,1,337512,337512,337513,0,1,4
96528,3,3,337515,337515,337518,0,3,2
96529,2,3,337517,337518,337521,1,4,0
96530,2,1,337519,337521,337522,2,3,0
96531,2,2,337521,337522,337524,1,3,0
96532,6,3,337527,337527,337530,0,3,3
96533,6,2,337533,337533,337535,0,2,3
96534,4,2,337537,337537,337539,0,2,2
96535,3,1,337540,337540,337541,0,1,1
96536,1,2,337541,337541,337543,0,2,0
96537,6,1,337547,337547,337548,0,1,4
96538,4,1,337551,337551,337552,0,1,3
96539,3,2,337554,337554,337556,0,2,2
96540,5,3,337559,337559,337562,0,3,3
96541,4,3,337563,337563,337566,0,3,1
96542,2,2,337565,337566,337568,1,3,0
96543,2,2,337567,337568,337570,1,3,0
96544,3,2,337570,337570,337572,0,2,0
96545,6,1,337576,337576,337577,0,1,4
96546,2,3,337578,337578,337581,0,3,1
96547,6,1,337584,337584,337585,0,1,3
96548,2,1,337586,337586,337587,0,1,1
96549,1,2,337587,337587,337589,0,2,0
96550,1,3,337588,337589,337592,1,4,0
96551,3,3,337591,337592,337595,1,4,0
96552,2,3,337593,337595,337598,2,5,0
96553,5,2,337598,337598,337600,0,2,0
96554,5,3,337603,337603,337606,0,3,3
96555,3,2,337606,337606,337608,0,2,0
96556,1,1,337607,337608,337609,1,2,0
96557,5,2,337612,337612,337614,0,2,3
96558,3,1,337615,337615,337616,0,1,1
96559,4,3,337619,337619,337622,0,3,3
96560,6,1,337625,337625,337626,0,1,3
96561,2,2,337627,337627,337629,0,2,1
96562,1,3,337628,337629,337632,1,4,0
96563,3,2,337631,337632,337634,1,3,0
96564,6,2,337637,337637,337639,0,2,3
96565,1,1,337638,337639,337640,1,2,0
96566,6,3,337644,337644,337647,0,3,4
96567,2,2,337646,337647,337649,1,3,0
96568,2,3,337648,337649,337652,1,4,0
96569,2,1,337650,337652,337653,2,3,0
96570,4,1,337654,337654,337655,0,1,1
96571,1,1,337655,337655,337656,0,1,0
96572,3,2,337658,337658,337660,0,2,2
96573,5,1,337663,337663,337664,0,1,3
96574,6,2,337669,337669,337671,0,2,5
96575,4,2,337673,337673,337675,0,2,2
96576,2,2,337675,337675,337677,0,2,0
96577,1,1,337676,337677,337678,1,2,0
96578,4,1,337680,337680,337681,0,1,2
96579,2,3,337682,337682,337685,0,3,1
96580,5,3,337687,337687,337690,0,3,2
96581,3,3,337690,337690,337693,0,3,0
96582,5,2,337695,337695,337697,0,2,2
96583,4,2,337699,337699,337701,0,2,2
96584,4,1,337703,337703,337704,0,1,2
96585,2,2,337705,337705,337707,0,2,1
96586,3,3,337708,337708,337711,0,3,1
96587,4,3,337712,337712,337715,0,3,1
96588,6,3,337718,337718,337721,0,3,3
96589,1,2,337719,337721,337723,2,4,0
96590,1,2,337720,337723,337725,3,5,0
96591,5,1,337725,337725,337726,0,1,0
96592,5,1,337730,337730,337731,0,1,4
96593,1,2,337731,337731,337733,0,2,0
96594,1,3,337732,337733,337736,1,4,0
96595,1,3,337733,337736,337739,3,6,0
96596,2,1,337735,337739,337740,4,5,0
96597,2,1,337737,337740,337741,3,4,0
96598,1,2,337738,337741,337743,3,5,0
96599,6,3,337744,337744,337747,0,3,1
96600,2,1,337746,337747,337748,1,2,0
96601,5,3,337751,337751,337754,0,3,3
96602,3,1,337754,337754,337755,0,1,0
96603,6,2,337760,337760,337762,0,2,5
96604,1,3,337761,337762,337765,1,4,0
96605,6,1,337767,337767,337768,0,1,2
96606,1,2,337768,337768,337770,0,2,0
96607,4,3,337772,337772,337775,0,3,2
96608,5,3,337777,337777,337780,0,3,2
96609,6,1,337783,337783,337784,0,1,3
96610,4,2,337787,337787,337789,0,2,3
96611,3,1,337790,337790,337791,0,1,1
96612,3,3,337793,337793,337796,0,3,2
96613,3,1,337796,337796,337797,0,1,0
96614,3,1,337799,337799,337800,0,1,2
96615,1,1,337800,337800,337801,0,1,0
96616,6,1,337806,337806,337807,0,1,5
96617,2,3,337808,337808,337811,0,3,1
96618,5,2,337813,337813,337815,0,2,2
96619,2,3,337815,337815,337818,0,3,0
96620,2,2,337817,337818,337820,1,3,0
96621,1,2,337818,337820,337822,2,4,0
96622,3,1,337821,337822,337823,1,2,0
96623,6,3,337827,337827,337830,0,3,4
96624,1,1,337828,337830,337831,2,3,0
96625,2,2,337830,337831,337833,1,3,0
96626,4,1,337834,337834,337835,0,1,1
96627,1,2,337835,337835,337837,0,2,0
96628,6,2,337841,337841,337843,0,2,4
96629,1,2,337842,337843,337845,1,3,0
96630,3,2,337845,337845,337847,0,2,0
96631,5,2,337850,337850,337852,0,2,3
96632,1,1,337851,337852,337853,1,2,0
96633,6,2,337857,337857,337859,0,2,4
96634,4,1,337861,337861,337862,0,1,2
96635,6,2,337867,337867,337869,0,2,5
96636,6,2,337873,337873,337875,0,2,4
96637,3,2,337876,337876,337878,0,2,1
96638,3,3,337879,337879,337882,0,3,1
96639,4,1,337883,337883,337884,0,1,1
96640,3,1,337886,337886,337887,0,1,2
96641,1,3,337887,337887,337890,0,3,0
96642,5,2,337892,337892,337894,0,2,2
96643,2,2,337894,337894,337896,0,2,0
96644,2,3,337896,337896,337899,0,3,0
96645,5,2,337901,337901,337903,0,2,2
96646,6,2,337907,337907,337909,0,2,4
96647,5,1,337912,337912,337913,0,1,3
96648,5,2,337917,337917,337919,0,2,4
96649,4,2,337921,337921,337923,0,2,2
96650,3,3,337924,337924,337927,0,3,1
96651,1,3,337925,337927,337930,2,5,0
96652,3,3,337928,337930,337933,2,5,0
96653,5,2,337933,337933,337935,0,2,0
96654,3,3,337936,337936,337939,0,3,1
96655,2,2,337938,337939,337941,1,3,0
96656,4,3,337942,337942,337945,0,3,1
96657,6,1,337948,337948,337949,0,1,3
96658,2,2,337950,337950,337952,0,2,1
96659,2,3,337952,337952,337955,0,3,0
96660,1,3,337953,337955,337958,2,5,0
96661,6,3,337959,337959,337962,0,3,1
96662,2,3,337961,337962,337965,1,4,0
96663,4,1,337965,337965,337966,0,1,0
96664,4,3,337969,337969,337972,0,3,3
96665,4,1,337973,337973,337974,0,1,1
96666,1,2,337974,337974,337976,0,2,0
96667,5,1,337979,337979,337980,0,1,3
96668,4,3,337983,337983,337986,0,3,3
96669,1,3,337984,337986,337989,2,5,0
96670,2,1,337986,337989,337990,3,4,0
96671,1,1,337987,337990,337991,3,4,0
96672,4,2,337991,337991,337993,0,2,0
96673,2,1,337993,337993,337994,0,1,0
96674,6,2,337999,337999,338001,0,2,5
96675,5,3,338004,338004,338007,0,3,3
96676,6,1,338010,338010,338011,0,1,3
96677,3,3,338013,338013,338016,0,3,2
96678,6,1,338019,338019,338020,0,1,3
96679,5,2,338024,338024,338026,0,2,4
96680,4,2,338028,338028,338030,0,2,2
96681,4,1,338032,338032,338033,0,1,2
96682,2,2,338034,338034,338036,0,2,1
96683,6,2,338040,338040,338042,0,2,4
96684,2,2,338042,338042,338044,0,2,0
96685,4,3,338046,338046,338049,0,3,2
96686,5,3,338051,338051,338054,0,3,2
96687,1,1,338052,338054,338055,2,3,0
96688,5,2,338057,338057,338059,0,2,2
96689,6,3,338063,338063,338066,0,3,4
96690,6,3,338069,338069,338072,0,3,3
96691,3,3,338072,338072,338075,0,3,0
96692,4,3,338076,338076,338079,0,3,1
96693,1,2,338077,338079,338081,2,4,0
96694,4,3,338081,338081,338084,0,3,0
96695,5,1,338086,338086,338087,0,1,2
96696,5,3,338091,338091,338094,0,3,4
96697,4,3,338095,338095,338098,0,3,1
96698,1,2,338096,338098,338100,2,4,0
96699,2,1,338098,338100,338101,2,3,0
96700,4,3,338102,338102,338105,0,3,1
96701,4,1,338106,338106,338107,0,1,1
96702,2,2,338108,338108,338110,0,2,1
96703,3,1,338111,338111,338112,0,1,1
96704,1,3,338112,338112,338115,0,3,0
96705,4,1,338116,338116,338117,0,1,1
96706,3,3,338119,338119,338122,0,3,2
96707,1,2,338120,338122,338124,2,4,0
96708,4,1,338124,338124,338125,0,1,0
96709,1,3,338125,338125,338128,0,3,0
96710,6,1,338131,338131,338132,0,1,3
96711,5,1,338136,338136,338137,0,1,4
96712,1,1,338137,338137,338138,0,1,0
96713,2,1,338139,338139,338140,0,1,1
96714,2,2,338141,338141,338143,0,2,1
96715,2,3,338143,338143,338146,0,3,0
96716,4,2,338147,338147,338149,0,2,1
96717,3,3,338150,338150,338153,0,3,1
96718,2,1,338152,338153,338154,1,2,0
96719,6,3,338158,338158,338161,0,3,4
96720,5,3,338163,338163,338166,0,3,2
96721,2,2,338165,338166,338168,1,3,0
96722,5,3,338170,338170,338173,0,3,2
96723,1,3,338171,338173,338176,2,5,0
96724,6,1,338177,338177,338178,0,1,1
96725,1,1,338178,338178,338179,0,1,0
96726,2,1,338180,338180,338181,0,1,1
96727,5,1,338185,338185,338186,0,1,4
96728,4,3,338189,338189,338192,0,3,3
96729,4,2,338193,338193,338195,0,2,1
96730,4,1,338197,338197,338198,0,1,2
96731,6,2,338203,338203,338205,0,2,5
96732,4,1,338207,338207,338208,0,1,2
96733,5,1,338212,338212,338213,0,1,4
96734,1,3,338213,338213,338216,0,3,0
96735,1,3,338214,338216,338219,2,5,0
96736,1,2,338215,338219,338221,4,6,0
96737,2,2,338217,338221,338223,4,6,0
96738,2,3,338219,338223,338226,4,7,0
96739,4,3,338223,338226,338229,3,6,0
96740,2,3,338225,338229,338232,4,7,0
96741,1,3,338226,338232,338235,6,9,0
96742,2,2,338228,338235,338237,7,9,0
96743,1,3,338229,338237,338240,8,11,0
96744,4,2,338233,338240,338242,7,9,0
96745,1,2,338234,338242,338244,8,10,0
96746,2,1,338236,338244,338245,8,9,0
96747,1,2,338237,338245,338247,8,10,0
96748,4,1,338241,338247,338248,6,7,0
96749,1,2,338242,338248,338250,6,8,0
96750,2,2,338244,338250,338252,6,8,0
96751,4,2,338248,338252,338254,4,6,0
96752,4,1,338252,338254,338255,2,3,0
96753,2,2,338254,338255,338257,1,3,0
96754,2,3,338256,338257,338260,1,4,0
96755,4,3,338260,338260,338263,0,3,0
96756,2,3,338262,338263,338266,1,4,0
96757,4,1,338266,338266,338267,0,1,0
96758,2,3,338268,338268,338271,0,3,1
96759,1,1,338269,338271,338272,2,3,0
96760,6,2,338275,338275,338277,0,2,3
96761,2,1,338277,338277,338278,0,1,0
96762,2,1,338279,338279,338280,0,1,1
96763,4,2,338283,338283,338285,0,2,3
96764,5,2,338288,338288,338290,0,2,3
96765,4,3,338292,338292,338295,0,3,2
96766,3,2,338295,338295,338297,0,2,0
96767,1,1,338296,338297,338298,1,2,0
96768,6,2,338302,338302,338304,0,2,4
96769,5,3,338307,338307,338310,0,3,3
96770,1,3,338308,338310,338313,2,5,0
96771,3,3,338311,338313,338316,2,5,0
96772,6,1,338317,338317,338318,0,1,1
96773,6,2,338323,338323,338325,0,2,5
96774,1,1,338324,338325,338326,1,2,0
96775,6,3,338330,338330,338333,0,3,4
96776,6,1,338336,338336,338337,0,1,3
96777,5,3,338341,338341,338344,0,3,4
96778,1,3,338342,338344,338347,2,5,0
96779,2,3,338344,338347,338350,3,6,0
96780,4,2,338348,338350,338352,2,4,0
96781,2,2,338350,338352,338354,2,4,0
96782,6,1,338356,338356,338357,0,1,2
96783,5,1,338361,338361,338362,0,1,4
96784,6,2,338367,338367,338369,0,2,5
96785,2,2,338369,338369,338371,0,2,0
96786,3,1,338372,338372,338373,0,1,1
96787,4,2,338376,338376,338378,0,2,3
96788,1,3,338377,338378,338381,1,4,0
96789,1,1,338378,338381,338382,3,4,0
96790,2,3,338380,338382,338385,2,5,0
96791,3,1,338383,338385,338386,2,3,0
96792,5,1,338388,338388,338389,0,1,2
96793,1,2,338389,338389,338391,0,2,0
96794,6,3,338395,338395,338398,0,3,4
96795,1,1,338396,338398,338399,2,3,0
96796,4,3,338400,338400,338403,0,3,1
96797,2,2,338402,338403,338405,1,3,0
96798,3,3,338405,338405,338408,0,3,0
96799,2,2,338407,338408,338410,1,3,0
96800,5,1,338412,338412,338413,0,1,2
96801,1,1,338413,338413,338414,0,1,0
96802,3,1,338416,338416,338417,0,1,2
96803,5,3,338421,338421,338424,0,3,4
96804,1,3,338422,338424,338427,2,5,0
96805,2,1,338424,338427,338428,3,4,0
96806,6,3,338430,338430,338433,0,3,2
96807,3,3,338433,338433,338436,0,3,0
96808,2,2,338435,338436,338438,1,3,0
96809,3,1,338438,338438,338439,0,1,0
96810,6,1,338444,338444,338445,0,1,5
96811,2,2,338446,338446,338448,0,2,1
96812,5,2,338451,338451,338453,0,2,3
96813,4,3,338455,338455,338458,0,3,2
96814,3,1,338458,338458,338459,0,1,0
96815,3,1,338461,338461,338462,0,1,2
96816,3,2,338464,338464,338466,0,2,2
96817,3,1,338467,338467,338468,0,1,1
96818,6,2,338473,338473,338475,0,2,5
96819,1,1,338474,338475,338476,1,2,0
96820,5,1,338479,338479,338480,0,1,3
96821,1,1,338480,338480,338481,0,1,0
96822,1,3,338481,338481,338484,0,3,0
96823,4,1,338485,338485,338486,0,1,1
96824,3,3,338488,338488,338491,0,3,2
96825,5,1,338493,338493,338494,0,1,2
96826,1,1,338494,338494,338495,0,1,0
96827,6,3,338500,338500,338503,0,3,5
96828,6,3,338506,338506,338509,0,3,3
96829,3,3,338509,338509,338512,0,3,0
96830,4,2,338513,338513,338515,0,2,1
96831,2,3,338515,338515,338518,0,3,0
96832,1,1,338516,338518,338519,2,3,0
96833,6,2,338522,338522,338524,0,2,3
96834,4,1,338526,338526,338527,0,1,2
96835,3,2,338529,338529,338531,0,2,2
96836,3,3,338532,338532,338535,0,3,1
96837,5,2,338537,338537,338539,0,2,2
96838,6,2,338543,338543,338545,0,2,4
96839,4,1,338547,338547,338548,0,1,2
96840,3,3,338550,338550,338553,0,3,2
96841,1,2,338551,338553,338555,2,4,0
96842,4,1,338555,338555,338556,0,1,0
96843,6,3,338561,338561,338564,0,3,5
96844,2,2,338563,338564,338566,1,3,0
96845,5,2,338568,338568,338570,0,2,2
96846,3,3,338571,338571,338574,0,3,1
96847,3,3,338574,338574,338577,0,3,0
96848,3,3,338577,338577,338580,0,3,0
96849,6,2,338583,338583,338585,0,2,3
96850,4,3,338587,338587,338590,0,3,2
96851,4,2,338591,338591,338593,0,2,1
96852,1,3,338592,338593,338596,1,4,0
96853,2,1,338594,338596,338597,2,3,0
96854,4,1,338598,338598,338599,0,1,1
96855,5,1,338603,338603,338604,0,1,4
96856,4,2,338607,338607,338609,0,2,3
96857,1,1,338608,338609,338610,1,2,0
96858,4,3,338612,338612,338615,0,3,2
96859,4,1,338616,338616,338617,0,1,1
96860,6,3,338622,338622,338625,0,3,5
96861,1,2,338623,338625,338627,2,4,0
96862,1,3,338624,338627,338630,3,6,0
96863,2,1,338626,338630,338631,4,5,0
96864,1,3,338627,338631,338634,4,7,0
96865,5,3,338632,338634,338637,2,5,0
96866,6,1,338638,338638,338639,0,1,1
96867,6,1,338644,338644,338645,0,1,5
96868,1,2,338645,338645,338647,0,2,0
96869,5,2,338650,338650,338652,0,2,3
96870,1,3,338651,338652,338655,1,4,0
96871,1,2,338652,338655,338657,3,5,0
96872,1,2,338653,338657,338659,4,6,0
96873,5,3,338658,338659,338662,1,4,0
96874,4,3,338662,338662,338665,0,3,0
96875,2,1,338664,338665,338666,1,2,0
96876,4,3,338668,338668,338671,0,3,2
96877,1,3,338669,338671,338674,2,5,0
96878,2,2,338671,338674,338676,3,5,0
96879,4,3,338675,338676,338679,1,4,0
96880,6,3,338681,338681,338684,0,3,2
96881,3,1,338684,338684,338685,0,1,0
96882,4,3,338688,338688,338691,0,3,3
96883,3,1,338691,338691,338692,0,1,0
96884,2,1,338693,338693,338694,0,1,1
96885,6,2,338699,338699,338701,0,2,5
96886,1,2,338700,338701,338703,1,3,0
96887,5,1,338705,338705,338706,0,1,2
96888,6,2,338711,338711,338713,0,2,5
96889,5,2,338716,338716,338718,0,2,3
96890,1,1,338717,338718,338719,1,2,0
96891,1,3,338718,338719,338722,1,4,0
96892,1,3,338719,338722,338725,3,6,0
96893,1,1,338720,338725,338726,5,6,0
96894,4,3,338724,338726,338729,2,5,0
96895,1,3,338725,338729,338732,4,7,0
96896,5,1,338730,338732,338733,2,3,0
96897,1,1,338731,338733,338734,2,3,0
96898,3,1,338734,338734,338735,0,1,0
96899,2,3,338736,338736,338739,0,3,1
96900,6,3,338742,338742,338745,0,3,3
96901,1,2,338743,338745,338747,2,4,0
96902,1,3,338744,338747,338750,3,6,0
96903,6,2,338750,338750,338752,0,2,0
96904,1,3,338751,338752,338755,1,4,0
96905,1,2,338752,338755,338757,3,5,0
96906,2,2,338754,338757,338759,3,5,0
96907,2,1,338756,338759,338760,3,4,0
96908,2,1,338758,338760,338761,2,3,0
96909,1,2,338759,338761,338763,2,4,0
96910,3,1,338762,338763,338764,1,2,0
96911,2,2,338764,338764,338766,0,2,0
96912,4,1,338768,338768,338769,0,1,2
96913,3,2,338771,338771,338773,0,2,2
96914,4,1,338775,338775,338776,0,1,2
96915,5,2,338780,338780,338782,0,2,4
96916,3,2,338783,338783,338785,0,2,1
96917,2,1,338785,338785,338786,0,1,0
96918,5,1,338790,338790,338791,0,1,4
96919,2,1,338792,338792,338793,0,1,1
96920,4,1,338796,338796,338797,0,1,3
96921,2,2,338798,338798,338800,0,2,1
96922,1,1,338799,338800,338801,1,2,0
96923,4,2,338803,338803,338805,0,2,2
96924,2,1,338805,338805,338806,0,1,0
96925,3,3,338808,338808,338811,0,3,2
96926,2,2,338810,338811,338813,1,3,0
96927,4,1,338814,338814,338815,0,1,1
96928,4,2,338818,338818,338820,0,2,3
96929,6,2,338824,338824,338826,0,2,4
96930,6,1,338830,338830,338831,0,1,4
96931,6,3,338836,338836,338839,0,3,5
96932,4,3,338840,338840,338843,0,3,1
96933,6,3,338846,338846,338849,0,3,3
96934,2,2,338848,338849,338851,1,3,0
96935,1,2,338849,338851,338853,2,4,0
96936,5,1,338854,338854,338855,0,1,1
96937,5,1,338859,338859,338860,0,1,4
96938,4,1,338863,338863,338864,0,1,3
96939,2,1,338865,338865,338866,0,1,1
96940,4,1,338869,338869,338870,0,1,3
96941,4,2,338873,338873,338875,0,2,3
96942,5,1,338878,338878,338879,0,1,3
96943,4,2,338882,338882,338884,0,2,3
96944,4,1,338886,338886,338887,0,1,2
96945,1,2,338887,338887,338889,0,2,0
96946,5,2,338892,338892,338894,0,2,3
96947,6,3,338898,338898,338901,0,3,4
96948,2,3,338900,338901,338904,1,4,0
96949,1,1,338901,338904,338905,3,4,0
96950,2,2,338903,338905,338907,2,4,0
96951,2,2,338905,338907,338909,2,4,0
96952,3,1,338908,338909,338910,1,2,0
96953,4,3,338912,338912,338915,0,3,2
96954,6,3,338918,338918,338921,0,3,3
96955,3,1,338921,338921,338922,0,1,0
96956,1,1,338922,338922,338923,0,1,0
96957,1,3,338923,338923,338926,0,3,0
96958,1,3,338924,338926,338929,2,5,0
96959,6,3,338930,338930,338933,0,3,1
96960,5,2,338935,338935,338937,0,2,2
96961,6,1,338941,338941,338942,0,1,4
96962,4,3,338945,338945,338948,0,3,3
96963,6,2,338951,338951,338953,0,2,3
96964,2,1,338953,338953,338954,0,1,0
96965,5,3,338958,338958,338961,0,3,4
96966,3,1,338961,338961,338962,0,1,0
96967,1,3,338962,338962,338965,0,3,0
96968,1,1,338963,338965,338966,2,3,0
96969,2,1,338965,338966,338967,1,2,0
96970,5,3,338970,338970,338973,0,3,3
96971,4,2,338974,338974,338976,0,2,1
96972,5,1,338979,338979,338980,0,1,3
96973,1,1,338980,338980,338981,0,1,0
96974,3,1,338983,338983,338984,0,1,2
96975,1,1,338984,338984,338985,0,1,0
96976,5,1,338989,338989,338990,0,1,4
96977,5,2,338994,338994,338996,0,2,4
96978,3,1,338997,338997,338998,0,1,1
96979,2,1,338999,338999,339000,0,1,1
96980,4,3,339003,339003,339006,0,3,3
96981,6,2,339009,339009,339011,0,2,3
96982,6,2,339015,339015,339017,0,2,4
96983,5,3,339020,339020,339023,0,3,3
96984,5,2,339025,339025,339027,0,2,2
96985,2,2,339027,339027,339029,0,2,0
96986,5,2,339032,339032,339034,0,2,3
96987,1,1,339033,339034,339035,1,2,0
96988,5,1,339038,339038,339039,0,1,3
96989,1,2,339039,339039,339041,0,2,0
96990,2,1,339041,339041,339042,0,1,0
96991,2,2,339043,339043,339045,0,2,1
96992,6,2,339049,339049,339051,0,2,4
96993,2,1,339051,339051,339052,0,1,0
96994,2,3,339053,339053,339056,0,3,1
96995,6,1,339059,339059,339060,0,1,3
96996,1,3,339060,339060,339063,0,3,0
96997,3,2,339063,339063,339065,0,2,0
96998,3,3,339066,339066,339069,0,3,1
96999,1,2,339067,339069,339071,2,4,0
97000,4,3,339071,339071,339074,0,3,0
97001,6,1,339077,339077,339078,0,1,3
97002,2,2,339079,339079,339081,0,2,1
97003,3,3,339082,339082,339085,0,3,1
97004,1,1,339083,339085,339086,2,3,0
97005,5,1,339088,339088,339089,0,1,2
97006,1,2,339089,339089,339091,0,2,0
97007,6,1,339095,339095,339096,0,1,4
97008,2,1,339097,339097,339098,0,1,1
97009,5,2,339102,339102,339104,0,2,4
97010,4,2,339106,339106,339108,0,2,2
97011,1,2,339107,339108,339110,1,3,0
97012,1,2,339108,339110,339112,2,4,0
97013,5,2,339113,339113,339115,0,2,1
97014,5,2,339118,339118,339120,0,2,3
97015,2,3,339120,339120,339123,0,3,0
97016,2,2,339122,339123,339125,1,3,0
97017,5,3,339127,339127,339130,0,3,2
97018,4,2,339131,339131,339133,0,2,1
97019,5,2,339136,339136,339138,0,2,3
97020,1,1,339137,339138,339139,1,2,0
97021,1,3,339138,339139,339142,1,4,0
97022,3,3,339141,339142,339145,1,4,0
97023,6,3,339147,339147,339150,0,3,2
97024,2,3,339149,339150,339153,1,4,0
97025,1,3,339150,339153,339156,3,6,0
97026,1,3,339151,339156,339159,5,8,0
97027,4,1,339155,339159,339160,4,5,0
97028,3,1,339158,339160,339161,2,3,0
97029,4,2,339162,339162,339164,0,2,1
97030,6,3,339168,339168,339171,0,3,4
97031,6,2,339174,339174,339176,0,2,3
97032,2,3,339176,339176,339179,0,3,0
97033,1,1,339177,339179,339180,2,3,0
97034,3,2,339180,339180,339182,0,2,0
97035,3,2,339183,339183,339185,0,2,1
97036,1,3,339184,339185,339188,1,4,0
97037,2,3,339186,339188,339191,2,5,0
97038,3,1,339189,339191,339192,2,3,0
97039,4,2,339193,339193,339195,0,2,1
97040,6,3,339199,339199,339202,0,3,4
97041,1,3,339200,339202,339205,2,5,0
97042,2,2,339202,339205,339207,3,5,0
97043,1,1,339203,339207,339208,4,5,0
97044,4,2,339207,339208,339210,1,3,0
97045,5,2,339212,339212,339214,0,2,2
97046,6,1,339218,339218,339219,0,1,4
97047,6,3,339224,339224,339227,0,3,5
97048,5,2,339229,339229,339231,0,2,2
97049,6,1,339235,339235,339236,0,1,4
97050,5,3,339240,339240,339243,0,3,4
97051,6,1,339246,339246,339247,0,1,3
97052,6,3,339252,339252,339255,0,3,5
97053,5,3,339257,339257,339260,0,3,2
97054,3,2,339260,339260,339262,0,2,0
97055,6,1,339266,339266,339267,0,1,4
97056,4,2,339270,339270,339272,0,2,3
97057,1,3,339271,339272,339275,1,4,0
97058,1,2,339272,339275,339277,3,5,0
97059,4,3,339276,339277,339280,1,4,0
97060,1,3,339277,339280,339283,3,6,0
97061,2,1,339279,339283,339284,4,5,0
97062,6,1,339285,339285,339286,0,1,1
97063,5,3,339290,339290,339293,0,3,4
97064,4,2,339294,339294,339296,0,2,1
97065,5,1,339299,339299,339300,0,1,3
97066,6,2,339305,339305,339307,0,2,5
97067,2,3,339307,339307,339310,0,3,0
97068,1,3,339308,339310,339313,2,5,0
97069,5,3,339313,339313,339316,0,3,0
97070,6,3,339319,339319,339322,0,3,3
97071,5,1,339324,339324,339325,0,1,2
97072,5,1,339329,339329,339330,0,1,4
97073,5,1,339334,339334,339335,0,1,4
97074,6,1,339340,339340,339341,0,1,5
97075,1,3,339341,339341,339344,0,3,0
97076,1,3,339342,339344,339347,2,5,0
97077,6,3,339348,339348,339351,0,3,1
97078,4,2,339352,339352,339354,0,2,1
97079,2,2,339354,339354,339356,0,2,0
97080,2,3,339356,339356,339359,0,3,0
97081,5,3,339361,339361,339364,0,3,2
97082,5,1,339366,339366,339367,0,1,2
97083,1,2,339367,339367,339369,0,2,0
97084,4,2,339371,339371,339373,0,2,2
97085,6,2,339377,339377,339379,0,2,4
97086,5,2,339382,339382,339384,0,2,3
97087,2,1,339384,339384,339385,0,1,0
97088,4,1,339388,339388,339389,0,1,3
97089,2,1,339390,339390,339391,0,1,1
97090,2,1,339392,339392,339393,0,1,1
97091,3,2,339395,339395,339397,0,2,2
97092,4,3,339399,339399,339402,0,3,2
97093,5,2,339404,339404,339406,0,2,2
97094,4,2,339408,339408,339410,0,2,2
97095,3,1,339411,339411,339412,0,1,1
97096,5,2,339416,339416,339418,0,2,4
97097,4,2,339420,339420,339422,0,2,2
97098,5,3,339425,339425,339428,0,3,3
97099,2,1,339427,339428,339429,1,2,0
97100,6,1,339433,339433,339434,0,1,4
97101,6,2,339439,339439,339441,0,2,5
97102,2,1,339441,339441,339442,0,1,0
97103,1,3,339442,339442,339445,0,3,0
97104,2,1,339444,339445,339446,1,2,0
97105,6,1,339450,339450,339451,0,1,4
97106,4,3,339454,339454,339457,0,3,3
97107,6,3,339460,339460,339463,0,3,3
97108,3,2,339463,339463,339465,0,2,0
97109,1,3,339464,339465,339468,1,4,0
97110,4,3,339468,339468,339471,0,3,0
97111,6,1,339474,339474,339475,0,1,3
97112,1,2,339475,339475,339477,0,2,0
97113,2,1,339477,339477,339478,0,1,0
97114,3,2,339480,339480,339482,0,2,2
97115,1,3,339481,339482,339485,1,4,0
97116,4,2,339485,339485,339487,0,2,0
97117,5,3,339490,339490,339493,0,3,3
97118,5,1,339495,339495,339496,0,1,2
97119,3,3,339498,339498,339501,0,3,2
97120,2,1,339500,339501,339502,1,2,0
97121,6,3,339506,339506,339509,0,3,4
97122,5,2,339511,339511,339513,0,2,2
97123,6,3,339517,339517,339520,0,3,4
97124,5,1,339522,339522,339523,0,1,2
97125,5,1,339527,339527,339528,0,1,4
97126,3,2,339530,339530,339532,0,2,2
97127,6,1,339536,339536,339537,0,1,4
97128,2,2,339538,339538,339540,0,2,1
97129,6,1,339544,339544,339545,0,1,4
97130,1,3,339545,339545,339548,0,3,0
97131,6,3,339551,339551,339554,0,3,3
97132,6,2,339557,339557,339559,0,2,3
97133,4,3,339561,339561,339564,0,3,2
97134,2,1,339563,339564,339565,1,2,0
97135,3,2,339566,339566,339568,0,2,1
97136,2,2,339568,339568,339570,0,2,0
97137,6,2,339574,339574,339576,0,2,4
97138,4,2,339578,339578,339580,0,2,2
97139,1,2,339579,339580,339582,1,3,0
97140,4,1,339583,339583,339584,0,1,1
97141,5,3,339588,339588,339591,0,3,4
97142,5,3,339593,339593,339596,0,3,2
97143,6,1,339599,339599,339600,0,1,3
97144,5,3,339604,339604,339607,0,3,4
97145,5,3,339609,339609,339612,0,3,2
97146,5,3,339614,339614,339617,0,3,2
97147,3,1,339617,339617,339618,0,1,0
97148,3,1,339620,339620,339621,0,1,2
97149,1,2,339621,339621,339623,0,2,0
97150,5,2,339626,339626,339628,0,2,3
97151,1,1,339627,339628,339629,1,2,0
97152,1,2,339628,339629,339631,1,3,0
97153,2,3,339630,339631,339634,1,4,0
97154,3,1,339633,339634,339635,1,2,0
97155,1,3,339634,339635,339638,1,4,0
97156,5,3,339639,339639,339642,0,3,1
97157,4,1,339643,339643,339644,0,1,1
97158,4,3,339647,339647,339650,0,3,3
97159,2,3,339649,339650,339653,1,4,0
97160,4,2,339653,339653,339655,0,2,0
97161,1,2,339654,339655,339657,1,3,0
97162,5,3,339659,339659,339662,0,3,2
97163,3,1,339662,339662,339663,0,1,0
97164,2,3,339664,339664,339667,0,3,1
97165,5,3,339669,339669,339672,0,3,2
97166,2,1,339671,339672,339673,1,2,0
97167,6,1,339677,339677,339678,0,1,4
97168,5,3,339682,339682,339685,0,3,4
97169,5,1,339687,339687,339688,0,1,2
97170,5,2,339692,339692,339694,0,2,4
97171,3,2,339695,339695,339697,0,2,1
97172,5,3,339700,339700,339703,0,3,3
97173,5,3,339705,339705,339708,0,3,2
97174,1,1,339706,339708,339709,2,3,0
97175,5,1,339711,339711,339712,0,1,2
97176,6,3,339717,339717,339720,0,3,5
97177,2,2,339719,339720,339722,1,3,0
97178,5,2,339724,339724,339726,0,2,2
97179,1,2,339725,339726,339728,1,3,0
97180,1,2,339726,339728,339730,2,4,0
97181,3,3,339729,339730,339733,1,4,0
97182,2,3,339731,339733,339736,2,5,0
97183,3,3,339734,339736,339739,2,5,0
97184,3,3,339737,339739,339742,2,5,0
97185,3,2,339740,339742,339744,2,4,0
97186,6,2,339746,339746,339748,0,2,2
97187,3,2,339749,339749,339751,0,2,1
97188,3,3,339752,339752,339755,0,3,1
97189,3,2,339755,339755,339757,0,2,0
97190,3,3,339758,339758,339761,0,3,1
97191,4,1,339762,339762,339763,0,1,1
97192,3,3,339765,339765,339768,0,3,2
97193,5,3,339770,339770,339773,0,3,2
97194,4,3,339774,339774,339777,0,3,1
97195,6,2,339780,339780,339782,0,2,3
97196,1,1,339781,339782,339783,1,2,0
97197,2,1,339783,339783,339784,0,1,0
97198,3,2,339786,339786,339788,0,2,2
97199,5,3,339791,339791,339794,0,3,3
97200,6,2,339797,339797,339799,0,2,3
97201,2,1,339799,339799,339800,0,1,0
97202,5,1,339804,339804,339805,0,1,4
97203,6,2,339810,339810,339812,0,2,5
97204,4,3,339814,339814,339817,0,3,2
97205,2,3,339816,339817,339820,1,4,0
97206,1,1,339817,339820,339821,3,4,0
97207,4,2,339821,339821,339823,0,2,0
97208,2,2,339823,339823,339825,0,2,0
97209,2,1,339825,339825,339826,0,1,0
97210,3,1,339828,339828,339829,0,1,2
97211,6,3,339834,339834,339837,0,3,5
97212,2,1,339836,339837,339838,1,2,0
97213,4,3,339840,339840,339843,0,3,2
97214,4,3,339844,339844,339847,0,3,1
97215,3,1,339847,339847,339848,0,1,0
97216,2,1,339849,339849,339850,0,1,1
97217,6,2,339855,339855,339857,0,2,5
97218,3,3,339858,339858,339861,0,3,1
97219,2,2,339860,339861,339863,1,3,0
97220,6,3,339866,339866,339869,0,3,3
97221,5,1,339871,339871,339872,0,1,2
97222,2,3,339873,339873,339876,0,3,1
97223,6,2,339879,339879,339881,0,2,3
97224,5,1,339884,339884,339885,0,1,3
97225,1,1,339885,339885,339886,0,1,0
97226,6,2,339891,339891,339893,0,2,5
97227,6,3,339897,339897,339900,0,3,4
97228,2,1,339899,339900,339901,1,2,0
97229,4,2,339903,339903,339905,0,2,2
97230,3,3,339906,339906,339909,0,3,1
97231,3,2,339909,339909,339911,0,2,0
97232,3,2,339912,339912,339914,0,2,1
97233,6,2,339918,339918,339920,0,2,4
97234,6,1,339924,339924,339925,0,1,4
97235,2,2,339926,339926,339928,0,2,1
97236,2,1,339928,339928,339929,0,1,0
97237,3,1,339931,339931,339932,0,1,2
97238,5,1,339936,339936,339937,0,1,4
97239,6,2,339942,339942,339944,0,2,5
97240,3,3,339945,339945,339948,0,3,1
97241,5,2,339950,339950,339952,0,2,2
97242,2,1,339952,339952,339953,0,1,0
97243,5,1,339957,339957,339958,0,1,4
97244,1,2,339958,339958,339960,0,2,0
97245,1,1,339959,339960,339961,1,2,0
97246,1,1,339960,339961,339962,1,2,0
97247,2,1,339962,339962,339963,0,1,0
97248,2,2,339964,339964,339966,0,2,1
97249,2,1,339966,339966,339967,0,1,0
97250,4,1,339970,339970,339971,0,1,3
97251,1,2,339971,339971,339973,0,2,0
97252,5,2,339976,339976,339978,0,2,3
97253,1,1,339977,339978,339979,1,2,0
97254,4,3,339981,339981,339984,0,3,2
97255,5,1,339986,339986,339987,0,1,2
97256,5,1,339991,339991,339992,0,1,4
97257,5,1,339996,339996,339997,0,1,4
97258,4,2,340000,340000,340002,0,2,3
97259,2,1,340002,340002,340003,0,1,0
97260,1,2,340003,340003,340005,0,2,0
97261,1,2,340004,340005,340007,1,3,0
97262,6,2,340010,340010,340012,0,2,3
97263,5,3,340015,340015,340018,0,3,3
97264,2,1,340017,340018,340019,1,2,0
97265,1,3,340018,340019,340022,1,4,0
97266,1,2,340019,340022,340024,3,5,0
97267,1,3,340020,340024,340027,4,7,0
97268,6,1,340026,340027,340028,1,2,0
97269,4,3,340030,340030,340033,0,3,2
97270,1,2,340031,340033,340035,2,4,0
97271,3,2,340034,340035,340037,1,3,0
97272,4,1,340038,340038,340039,0,1,1
97273,3,2,340041,340041,340043,0,2,2
97274,6,3,340047,340047,340050,0,3,4
97275,3,3,340050,340050,340053,0,3,0
97276,1,1,340051,340053,340054,2,3,0
97277,6,2,340057,340057,340059,0,2,3
97278,1,1,340058,340059,340060,1,2,0
97279,3,1,340061,340061,340062,0,1,1
97280,4,1,340065,340065,340066,0,1,3
97281,6,3,340071,340071,340074,0,3,5
97282,2,2,340073,340074,340076,1,3,0
97283,2,3,340075,340076,340079,1,4,0
97284,6,3,340081,340081,340084,0,3,2
97285,4,1,340085,340085,340086,0,1,1
97286,5,3,340090,340090,340093,0,3,4
97287,1,2,340091,340093,340095,2,4,0
97288,4,2,340095,340095,340097,0,2,0
97289,1,1,340096,340097,340098,1,2,0
97290,6,1,340102,340102,340103,0,1,4
97291,3,1,340105,340105,340106,0,1,2
97292,6,3,340111,340111,340114,0,3,5
97293,6,3,340117,340117,340120,0,3,3
97294,4,1,340121,340121,340122,0,1,1
97295,5,2,340126,340126,340128,0,2,4
97296,6,1,340132,340132,340133,0,1,4
97297,1,1,340133,340133,340134,0,1,0
97298,4,1,340137,340137,340138,0,1,3
97299,2,1,340139,340139,340140,0,1,1
97300,3,3,340142,340142,340145,0,3,2
97301,2,2,340144,340145,340147,1,3,0
97302,1,1,340145,340147,340148,2,3,0
97303,5,2,340150,340150,340152,0,2,2
97304,6,1,340156,340156,340157,0,1,4
97305,4,3,340160,340160,340163,0,3,3
97306,2,2,340162,340163,340165,1,3,0
97307,1,3,340163,340165,340168,2,5,0
97308,1,1,340164,340168,340169,4,5,0
97309,2,3,340166,340169,340172,3,6,0
97310,5,3,340171,340172,340175,1,4,0
97311,5,3,340176,340176,340179,0,3,1
97312,1,2,340177,340179,340181,2,4,0
97313,1,3,340178,340181,340184,3,6,0
97314,4,3,340182,340184,340187,2,5,0
97315,1,1,340183,340187,340188,4,5,0
97316,5,3,340188,340188,340191,0,3,0
97317,2,3,340190,340191,340194,1,4,0
97318,1,1,340191,340194,340195,3,4,0
97319,5,3,340196,340196,340199,0,3,1
97320,3,1,340199,340199,340200,0,1,0
97321,6,2,340205,340205,340207,0,2,5
97322,4,3,340209,340209,340212,0,3,2
97323,1,1,340210,340212,340213,2,3,0
97324,3,1,340213,340213,340214,0,1,0
97325,1,3,340214,340214,340217,0,3,0
97326,6,3,340220,340220,340223,0,3,3
97327,5,3,340225,340225,340228,0,3,2
97328,4,2,340229,340229,340231,0,2,1
97329,1,3,340230,340231,340234,1,4,0
97330,3,2,340233,340234,340236,1,3,0
97331,4,1,340237,340237,340238,0,1,1
97332,3,2,340240,340240,340242,0,2,2
97333,3,2,340243,340243,340245,0,2,1
97334,1,3,340244,340245,340248,1,4,0
97335,4,2,340248,340248,340250,0,2,0
97336,5,1,340253,340253,340254,0,1,3
97337,4,3,340257,340257,340260,0,3,3
97338,5,3,340262,340262,340265,0,3,2
97339,6,2,340268,340268,340270,0,2,3
97340,2,3,340270,340270,340273,0,3,0
97341,5,3,340275,340275,340278,0,3,2
97342,6,3,340281,340281,340284,0,3,3
97343,2,1,340283,340284,340285,1,2,0
97344,6,2,340289,340289,340291,0,2,4
97345,3,3,340292,340292,340295,0,3,1
97346,6,3,340298,340298,340301,0,3,3
97347,6,3,340304,340304,340307,0,3,3
97348,6,2,340310,340310,340312,0,2,3
97349,4,1,340314,340314,340315,0,1,2
97350,2,1,340316,340316,340317,0,1,1
97351,6,3,340322,340322,340325,0,3,5
97352,2,2,340324,340325,340327,1,3,0
97353,6,2,340330,340330,340332,0,2,3
97354,4,3,340334,340334,340337,0,3,2
97355,3,1,340337,340337,340338,0,1,0
97356,2,3,340339,340339,340342,0,3,1
97357,6,1,340345,340345,340346,0,1,3
97358,2,1,340347,340347,340348,0,1,1
97359,3,1,340350,340350,340351,0,1,2
97360,3,3,340353,340353,340356,0,3,2
97361,4,2,340357,340357,340359,0,2,1
97362,5,3,340362,340362,340365,0,3,3
97363,6,1,340368,340368,340369,0,1,3
97364,3,3,340371,340371,340374,0,3,2
97365,4,1,340375,340375,340376,0,1,1
97366,5,2,340380,340380,340382,0,2,4
97367,6,2,340386,340386,340388,0,2,4
97368,1,2,340387,340388,340390,1,3,0
97369,6,2,340393,340393,340395,0,2,3
97370,5,3,340398,340398,340401,0,3,3
97371,1,3,340399,340401,340404,2,5,0
97372,6,2,340405,340405,340407,0,2,1
97373,1,3,340406,340407,340410,1,4,0
97374,3,2,340409,340410,340412,1,3,0
97375,5,2,340414,340414,340416,0,2,2
97376,3,3,340417,340417,340420,0,3,1
97377,2,3,340419,340420,340423,1,4,0
97378,1,3,340420,340423,340426,3,6,0
97379,3,1,340423,340426,340427,3,4,0
97380,5,3,340428,340428,340431,0,3,1
97381,4,2,340432,340432,340434,0,2,1
97382,1,1,340433,340434,340435,1,2,0
97383,3,2,340436,340436,340438,0,2,1
97384,6,1,340442,340442,340443,0,1,4
97385,6,3,340448,340448,340451,0,3,5
97386,4,2,340452,340452,340454,0,2,1
97387,3,1,340455,340455,340456,0,1,1
97388,6,1,340461,340461,340462,0,1,5
97389,5,2,340466,340466,340468,0,2,4
97390,5,1,340471,340471,340472,0,1,3
97391,4,2,340475,340475,340477,0,2,3
97392,2,1,340477,340477,340478,0,1,0
97393,1,3,340478,340478,340481,0,3,0
97394,1,2,340479,340481,340483,2,4,0
97395,6,2,340485,340485,340487,0,2,2
97396,3,2,340488,340488,340490,0,2,1
97397,4,1,340492,340492,340493,0,1,2
97398,4,3,340496,340496,340499,0,3,3
97399,1,3,340497,340499,340502,2,5,0
97400,5,1,340502,340502,340503,0,1,0
97401,5,2,340507,340507,340509,0,2,4
97402,4,3,340511,340511,340514,0,3,2
97403,5,1,340516,340516,340517,0,1,2
97404,5,2,340521,340521,340523,0,2,4
97405,5,1,340526,340526,340527,0,1,3
97406,2,2,340528,340528,340530,0,2,1
97407,5,1,340533,340533,340534,0,1,3
97408,5,3,340538,340538,340541,0,3,4
97409,5,1,340543,340543,340544,0,1,2
97410,3,1,340546,340546,340547,0,1,2
97411,5,3,340551,340551,340554,0,3,4
97412,5,2,340556,340556,340558,0,2,2
97413,2,2,340558,340558,340560,0,2,0
97414,3,2,340561,340561,340563,0,2,1
97415,2,1,340563,340563,340564,0,1,0
97416,2,3,340565,340565,340568,0,3,1
97417,1,3,340566,340568,340571,2,5,0
97418,2,3,340568,340571,340574,3,6,0
97419,2,2,340570,340574,340576,4,6,0
97420,6,3,340576,340576,340579,0,3,0
97421,3,2,340579,340579,340581,0,2,0
97422,5,2,340584,340584,340586,0,2,3
97423,3,2,340587,340587,340589,0,2,1
97424,5,2,340592,340592,340594,0,2,3
97425,3,2,340595,340595,340597,0,2,1
97426,6,3,340601,340601,340604,0,3,4
97427,2,3,340603,340604,340607,1,4,0
97428,4,1,340607,340607,340608,0,1,0
97429,4,2,340611,340611,340613,0,2,3
97430,6,3,340617,340617,340620,0,3,4
97431,3,1,340620,340620,340621,0,1,0
97432,6,1,340626,340626,340627,0,1,5
97433,3,3,340629,340629,340632,0,3,2
97434,2,3,340631,340632,340635,1,4,0
97435,6,1,340637,340637,340638,0,1,2
97436,2,2,340639,340639,340641,0,2,1
97437,4,2,340643,340643,340645,0,2,2
97438,3,3,340646,340646,340649,0,3,1
97439,5,3,340651,340651,340654,0,3,2
97440,1,2,340652,340654,340656,2,4,0
97441,2,2,340654,340656,340658,2,4,0
97442,1,1,340655,340658,340659,3,4,0
97443,4,1,340659,340659,340660,0,1,0
97444,5,2,340664,340664,340666,0,2,4
97445,3,2,340667,340667,340669,0,2,1
97446,5,2,340672,340672,340674,0,2,3
97447,4,1,340676,340676,340677,0,1,2
97448,4,1,340680,340680,340681,0,1,3
97449,3,2,340683,340683,340685,0,2,2
97450,2,1,340685,340685,340686,0,1,0
97451,4,2,340689,340689,340691,0,2,3
97452,2,1,340691,340691,340692,0,1,0
97453,1,1,340692,340692,340693,0,1,0
97454,5,3,340697,340697,340700,0,3,4
97455,4,3,340701,340701,340704,0,3,1
97456,1,1,340702,340704,340705,2,3,0
97457,4,3,340706,340706,340709,0,3,1
97458,1,1,340707,340709,340710,2,3,0
97459,2,2,340709,340710,340712,1,3,0
97460,3,1,340712,340712,340713,0,1,0
97461,6,2,340718,340718,340720,0,2,5
97462,2,1,340720,340720,340721,0,1,0
97463,2,3,340722,340722,340725,0,3,1
97464,6,2,340728,340728,340730,0,2,3
97465,2,1,340730,340730,340731,0,1,0
97466,6,3,340736,340736,340739,0,3,5
97467,4,1,340740,340740,340741,0,1,1
97468,3,3,340743,340743,340746,0,3,2
97469,3,2,340746,340746,340748,0,2,0
97470,1,2,340747,340748,340750,1,3,0
97471,6,3,340753,340753,340756,0,3,3
97472,4,2,340757,340757,340759,0,2,1
97473,2,3,340759,340759,340762,0,3,0
97474,5,3,340764,340764,340767,0,3,2
97475,4,1,340768,340768,340769,0,1,1
97476,5,1,340773,340773,340774,0,1,4
97477,4,1,340777,340777,340778,0,1,3
97478,2,3,340779,340779,340782,0,3,1
97479,1,2,340780,340782,340784,2,4,0
97480,1,1,340781,340784,340785,3,4,0
97481,3,2,340784,340785,340787,1,3,0
97482,6,3,340790,340790,340793,0,3,3
97483,4,1,340794,340794,340795,0,1,1
97484,2,2,340796,340796,340798,0,2,1
97485,2,3,340798,340798,340801,0,3,0
97486,3,3,340801,340801,340804,0,3,0
97487,3,3,340804,340804,340807,0,3,0
97488,2,3,340806,340807,340810,1,4,0
97489,1,1,340807,340810,340811,3,4,0
97490,1,2,340808,340811,340813,3,5,0
97491,2,2,340810,340813,340815,3,5,0
97492,4,1,340814,340815,340816,1,2,0
97493,6,1,340820,340820,340821,0,1,4
97494,4,3,340824,340824,340827,0,3,3
97495,4,1,340828,340828,340829,0,1,1
97496,3,2,340831,340831,340833,0,2,2
97497,6,2,340837,340837,340839,0,2,4
97498,3,3,340840,340840,340843,0,3,1
97499,2,3,340842,340843,340846,1,4,0
97500,2,3,340844,340846,340849,2,5,0
97501,1,3,340845,340849,340852,4,7,0
97502,2,3,340847,340852,340855,5,8,0
97503,3,2,340850,340855,340857,5,7,0
97504,5,3,340855,340857,340860,2,5,0
97505,3,1,340858,340860,340861,2,3,0
97506,3,2,340861,340861,340863,0,2,0
97507,2,2,340863,340863,340865,0,2,0
97508,5,2,340868,340868,340870,0,2,3
97509,4,1,340872,340872,340873,0,1,2
97510,3,3,340875,340875,340878,0,3,2
97511,2,2,340877,340878,340880,1,3,0
97512,4,1,340881,340881,340882,0,1,1
97513,1,1,340882,340882,340883,0,1,0
97514,6,1,340888,340888,340889,0,1,5
97515,4,1,340892,340892,340893,0,1,3
97516,3,1,340895,340895,340896,0,1,2
97517,4,2,340899,340899,340901,0,2,3
97518,3,1,340902,340902,340903,0,1,1
97519,4,2,340906,340906,340908,0,2,3
97520,2,2,340908,340908,340910,0,2,0
97521,3,2,340911,340911,340913,0,2,1
97522,4,1,340915,340915,340916,0,1,2
97523,1,3,340916,340916,340919,0,3,0
97524,2,2,340918,340919,340921,1,3,0
97525,6,1,340924,340924,340925,0,1,3
97526,6,1,340930,340930,340931,0,1,5
97527,5,3,340935,340935,340938,0,3,4
97528,4,2,340939,340939,340941,0,2,1
97529,2,1,340941,340941,340942,0,1,0
97530,4,3,340945,340945,340948,0,3,3
97531,2,1,340947,340948,340949,1,2,0
97532,3,3,340950,340950,340953,0,3,1
97533,1,1,340951,340953,340954,2,3,0
97534,2,2,340953,340954,340956,1,3,0
97535,2,1,340955,340956,340957,1,2,0
97536,3,3,340958,340958,340961,0,3,1
97537,2,2,340960,340961,340963,1,3,0
97538,4,3,340964,340964,340967,0,3,1
97539,3,2,340967,340967,340969,0,2,0
97540,1,1,340968,340969,340970,1,2,0
97541,3,3,340971,340971,340974,0,3,1
97542,5,3,340976,340976,340979,0,3,2
97543,1,2,340977,340979,340981,2,4,0
97544,4,3,340981,340981,340984,0,3,0
97545,2,2,340983,340984,340986,1,3,0
97546,4,3,340987,340987,340990,0,3,1
97547,4,1,340991,340991,340992,0,1,1
97548,4,2,340995,340995,340997,0,2,3
97549,5,1,341000,341000,341001,0,1,3
97550,2,3,341002,341002,341005,0,3,1
97551,1,3,341003,341005,341008,2,5,0
97552,6,2,341009,341009,341011,0,2,1
97553,1,3,341010,341011,341014,1,4,0
97554,4,2,341014,341014,341016,0,2,0
97555,3,1,341017,341017,341018,0,1,1
97556,6,2,341023,341023,341025,0,2,5
97557,6,2,341029,341029,341031,0,2,4
97558,3,3,341032,341032,341035,0,3,1
97559,4,2,341036,341036,341038,0,2,1
97560,2,2,341038,341038,341040,0,2,0
97561,1,1,341039,341040,341041,1,2,0
97562,6,2,341045,341045,341047,0,2,4
97563,4,2,341049,341049,341051,0,2,2
97564,5,2,341054,341054,341056,0,2,3
97565,5,2,341059,341059,341061,0,2,3
97566,5,2,341064,341064,341066,0,2,3
97567,6,3,341070,341070,341073,0,3,4
97568,1,1,341071,341073,341074,2,3,0
97569,3,1,341074,341074,341075,0,1,0
97570,3,1,341077,341077,341078,0,1,2
97571,3,3,341080,341080,341083,0,3,2
97572,5,1,341085,341085,341086,0,1,2
97573,6,2,341091,341091,341093,0,2,5
97574,5,2,341096,341096,341098,0,2,3
97575,1,2,341097,341098,341100,1,3,0
97576,2,2,341099,341100,341102,1,3,0
97577,4,1,341103,341103,341104,0,1,1
97578,1,2,341104,341104,341106,0,2,0
97579,5,1,341109,341109,341110,0,1,3
97580,4,2,341113,341113,341115,0,2,3
97581,3,1,341116,341116,341117,0,1,1
97582,3,2,341119,341119,341121,0,2,2
97583,3,2,341122,341122,341124,0,2,1
97584,6,2,341128,341128,341130,0,2,4
97585,5,1,341133,341133,341134,0,1,3
97586,6,2,341139,341139,341141,0,2,5
97587,4,1,341143,341143,341144,0,1,2
97588,4,1,341147,341147,341148,0,1,3
97589,3,3,341150,341150,341153,0,3,2
97590,5,2,341155,341155,341157,0,2,2
97591,2,1,341157,341157,341158,0,1,0
97592,4,3,341161,341161,341164,0,3,3
97593,6,1,341167,341167,341168,0,1,3
97594,3,1,341170,341170,341171,0,1,2
97595,1,2,341171,341171,341173,0,2,0
97596,3,1,341174,341174,341175,0,1,1
97597,3,3,341177,341177,341180,0,3,2
97598,4,3,341181,341181,341184,0,3,1
97599,3,1,341184,341184,341185,0,1,0
97600,4,2,341188,341188,341190,0,2,3
97601,6,2,341194,341194,341196,0,2,4
97602,2,1,341196,341196,341197,0,1,0
97603,1,3,341197,341197,341200,0,3,0
97604,4,1,341201,341201,341202,0,1,1
97605,2,1,341203,341203,341204,0,1,1
97606,3,3,341206,341206,341209,0,3,2
97607,3,3,341209,341209,341212,0,3,0
97608,3,2,341212,341212,341214,0,2,0
97609,1,3,341213,341214,341217,1,4,0
97610,4,2,341217,341217,341219,0,2,0
97611,6,2,341223,341223,341225,0,2,4
97612,1,3,341224,341225,341228,1,4,0
97613,1,1,341225,341228,341229,3,4,0
97614,6,3,341231,341231,341234,0,3,2
97615,6,2,341237,341237,341239,0,2,3
97616,2,3,341239,341239,341242,0,3,0
97617,6,1,341245,341245,341246,0,1,3
97618,2,3,341247,341247,341250,0,3,1
97619,2,3,341249,341250,341253,1,4,0
97620,1,1,341250,341253,341254,3,4,0
97621,2,1,341252,341254,341255,2,3,0
97622,5,1,341257,341257,341258,0,1,2
97623,3,2,341260,341260,341262,0,2,2
97624,6,2,341266,341266,341268,0,2,4
97625,3,3,341269,341269,341272,0,3,1
97626,2,2,341271,341272,341274,1,3,0
97627,1,1,341272,341274,341275,2,3,0
97628,6,2,341278,341278,341280,0,2,3
97629,5,2,341283,341283,341285,0,2,3
97630,6,2,341289,341289,341291,0,2,4
97631,3,2,341292,341292,341294,0,2,1
97632,4,2,341296,341296,341298,0,2,2
97633,4,2,341300,341300,341302,0,2,2
97634,3,3,341303,341303,341306,0,3,1
97635,1,1,341304,341306,341307,2,3,0
97636,1,2,341305,341307,341309,2,4,0
97637,1,1,341306,341309,341310,3,4,0
97638,4,2,341310,341310,341312,0,2,0
97639,5,3,341315,341315,341318,0,3,3
97640,1,1,341316,341318,341319,2,3,0
97641,5,2,341321,341321,341323,0,2,2
97642,6,2,341327,341327,341329,0,2,4
97643,2,2,341329,341329,341331,0,2,0
97644,6,1,341335,341335,341336,0,1,4
97645,3,3,341338,341338,341341,0,3,2
97646,2,1,341340,341341,341342,1,2,0
97647,4,1,341344,341344,341345,0,1,2
97648,1,1,341345,341345,341346,0,1,0
97649,4,3,341349,341349,341352,0,3,3
97650,4,2,341353,341353,341355,0,2,1
97651,1,1,341354,341355,341356,1,2,0
97652,5,3,341359,341359,341362,0,3,3
97653,2,3,341361,341362,341365,1,4,0
97654,3,2,341364,341365,341367,1,3,0
97655,5,3,341369,341369,341372,0,3,2
97656,3,3,341372,341372,341375,0,3,0
97657,3,1,341375,341375,341376,0,1,0
97658,2,2,341377,341377,341379,0,2,1
97659,6,3,341383,341383,341386,0,3,4
97660,6,2,341389,341389,341391,0,2,3
97661,2,3,341391,341391,341394,0,3,0
97662,5,2,341396,341396,341398,0,2,2
97663,2,1,341398,341398,341399,0,1,0
97664,6,3,341404,341404,341407,0,3,5
97665,3,1,341407,341407,341408,0,1,0
97666,3,2,341410,341410,341412,0,2,2
97667,4,1,341414,341414,341415,0,1,2
97668,3,1,341417,341417,341418,0,1,2
97669,5,1,341422,341422,341423,0,1,4
97670,6,3,341428,341428,341431,0,3,5
97671,1,3,341429,341431,341434,2,5,0
97672,6,3,341435,341435,341438,0,3,1
97673,4,2,341439,341439,341441,0,2,1
97674,4,1,341443,341443,341444,0,1,2
97675,3,3,341446,341446,341449,0,3,2
97676,2,2,341448,341449,341451,1,3,0
97677,3,3,341451,341451,341454,0,3,0
97678,3,1,341454,341454,341455,0,1,0
97679,3,3,341457,341457,341460,0,3,2
97680,6,1,341463,341463,341464,0,1,3
97681,2,2,341465,341465,341467,0,2,1
97682,4,1,341469,341469,341470,0,1,2
97683,4,2,341473,341473,341475,0,2,3
97684,4,2,341477,341477,341479,0,2,2
97685,6,1,341483,341483,341484,0,1,4
97686,3,1,341486,341486,341487,0,1,2
97687,3,1,341489,341489,341490,0,1,2
97688,6,1,341495,341495,341496,0,1,5
97689,6,3,341501,341501,341504,0,3,5
97690,2,2,341503,341504,341506,1,3,0
97691,3,3,341506,341506,341509,0,3,0
97692,3,3,341509,341509,341512,0,3,0
97693,2,1,341511,341512,341513,1,2,0
97694,6,1,341517,341517,341518,0,1,4
97695,4,2,341521,341521,341523,0,2,3
97696,6,3,341527,341527,341530,0,3,4
97697,2,3,341529,341530,341533,1,4,0
97698,4,3,341533,341533,341536,0,3,0
97699,4,1,341537,341537,341538,0,1,1
97700,3,3,341540,341540,341543,0,3,2
97701,3,1,341543,341543,341544,0,1,0
97702,6,2,341549,341549,341551,0,2,5
97703,1,1,341550,341551,341552,1,2,0
97704,1,2,341551,341552,341554,1,3,0
97705,6,1,341557,341557,341558,0,1,3
97706,2,3,341559,341559,341562,0,3,1
97707,4,2,341563,341563,341565,0,2,1
97708,2,3,341565,341565,341568,0,3,0
97709,3,2,341568,341568,341570,0,2,0
97710,2,2,341570,341570,341572,0,2,0
97711,6,2,341576,341576,341578,0,2,4
97712,4,1,341580,341580,341581,0,1,2
97713,6,1,341586,341586,341587,0,1,5
97714,5,2,341591,341591,341593,0,2,4
97715,1,2,341592,341593,341595,1,3,0
97716,5,3,341597,341597,341600,0,3,2
97717,3,1,341600,341600,341601,0,1,0
97718,2,2,341602,341602,341604,0,2,1
97719,2,3,341604,341604,341607,0,3,0
97720,6,2,341610,341610,341612,0,2,3
97721,2,2,341612,341612,341614,0,2,0
97722,4,3,341616,341616,341619,0,3,2
97723,3,3,341619,341619,341622,0,3,0
97724,5,3,341624,341624,341627,0,3,2
97725,3,3,341627,341627,341630,0,3,0
97726,1,1,341628,341630,341631,2,3,0
97727,3,2,341631,341631,341633,0,2,0
97728,3,3,341634,341634,341637,0,3,1
97729,3,1,341637,341637,341638,0,1,0
97730,2,3,341639,341639,341642,0,3,1
97731,1,2,341640,341642,341644,2,4,0
97732,3,3,341643,341644,341647,1,4,0
97733,6,2,341649,341649,341651,0,2,2
97734,4,2,341653,341653,341655,0,2,2
97735,2,1,341655,341655,341656,0,1,0
97736,5,3,341660,341660,341663,0,3,4
97737,5,2,341665,341665,341667,0,2,2
97738,3,3,341668,341668,341671,0,3,1
97739,5,1,341673,341673,341674,0,1,2
97740,1,3,341674,341674,341677,0,3,0
97741,2,1,341676,341677,341678,1,2,0
97742,6,1,341682,341682,341683,0,1,4
97743,6,3,341688,341688,341691,0,3,5
97744,1,2,341689,341691,341693,2,4,0
97745,5,2,341694,341694,341696,0,2,1
97746,6,2,341700,341700,341702,0,2,4
97747,4,3,341704,341704,341707,0,3,2
97748,6,3,341710,341710,341713,0,3,3
97749,3,2,341713,341713,341715,0,2,0
97750,5,1,341718,341718,341719,0,1,3
97751,1,3,341719,341719,341722,0,3,0
97752,5,3,341724,341724,341727,0,3,2
97753,5,2,341729,341729,341731,0,2,2
97754,5,1,341734,341734,341735,0,1,3
97755,4,1,341738,341738,341739,0,1,3
97756,1,2,341739,341739,341741,0,2,0
97757,4,3,341743,341743,341746,0,3,2
97758,1,3,341744,341746,341749,2,5,0
97759,2,3,341746,341749,341752,3,6,0
97760,6,3,341752,341752,341755,0,3,0
97761,2,1,341754,341755,341756,1,2,0
97762,6,2,341760,341760,341762,0,2,4
97763,5,1,341765,341765,341766,0,1,3
97764,4,2,341769,341769,341771,0,2,3
97765,5,2,341774,341774,341776,0,2,3
97766,5,2,341779,341779,341781,0,2,3
97767,3,2,341782,341782,341784,0,2,1
97768,5,3,341787,341787,341790,0,3,3
97769,6,3,341793,341793,341796,0,3,3
97770,1,1,341794,341796,341797,2,3,0
97771,6,2,341800,341800,341802,0,2,3
97772,1,3,341801,341802,341805,1,4,0
97773,2,2,341803,341805,341807,2,4,0
97774,5,2,341808,341808,341810,0,2,1
97775,5,2,341813,341813,341815,0,2,3
97776,4,2,341817,341817,341819,0,2,2
97777,3,3,341820,341820,341823,0,3,1
97778,6,3,341826,341826,341829,0,3,3
97779,4,3,341830,341830,341833,0,3,1
97780,3,1,341833,341833,341834,0,1,0
97781,5,1,341838,341838,341839,0,1,4
97782,2,2,341840,341840,341842,0,2,1
97783,5,3,341845,341845,341848,0,3,3
97784,1,3,341846,341848,341851,2,5,0
97785,3,2,341849,341851,341853,2,4,0
97786,2,3,341851,341853,341856,2,5,0
97787,6,2,341857,341857,341859,0,2,1
97788,6,3,341863,341863,341866,0,3,4
97789,3,3,341866,341866,341869,0,3,0
97790,5,1,341871,341871,341872,0,1,2
97791,6,1,341877,341877,341878,0,1,5
97792,5,2,341882,341882,341884,0,2,4
97793,1,2,341883,341884,341886,1,3,0
97794,1,3,341884,341886,341889,2,5,0
97795,5,1,341889,341889,341890,0,1,0
97796,3,2,341892,341892,341894,0,2,2
97797,3,2,341895,341895,341897,0,2,1
97798,6,2,341901,341901,341903,0,2,4
97799,1,1,341902,341903,341904,1,2,0
97800,1,3,341903,341904,341907,1,4,0
97801,5,3,341908,341908,341911,0,3,1
97802,6,1,341914,341914,341915,0,1,3
97803,1,2,341915,341915,341917,0,2,0
97804,4,2,341919,341919,341921,0,2,2
97805,1,2,341920,341921,341923,1,3,0
97806,4,2,341924,341924,341926,0,2,1
97807,6,3,341930,341930,341933,0,3,4
97808,3,3,341933,341933,341936,0,3,0
97809,5,3,341938,341938,341941,0,3,2
97810,3,1,341941,341941,341942,0,1,0
97811,3,3,341944,341944,341947,0,3,2
97812,1,2,341945,341947,341949,2,4,0
97813,1,2,341946,341949,341951,3,5,0
97814,1,1,341947,341951,341952,4,5,0
97815,6,2,341953,341953,341955,0,2,1
97816,5,2,341958,341958,341960,0,2,3
97817,4,3,341962,341962,341965,0,3,2
97818,5,2,341967,341967,341969,0,2,2
97819,5,3,341972,341972,341975,0,3,3
97820,4,3,341976,341976,341979,0,3,1
97821,5,3,341981,341981,341984,0,3,2
97822,6,1,341987,341987,341988,0,1,3
97823,2,3,341989,341989,341992,0,3,1
97824,5,3,341994,341994,341997,0,3,2
97825,4,3,341998,341998,342001,0,3,1
97826,3,3,342001,342001,342004,0,3,0
97827,3,2,342004,342004,342006,0,2,0
97828,1,1,342005,342006,342007,1,2,0
97829,6,2,342011,342011,342013,0,2,4
97830,1,2,342012,342013,342015,1,3,0
97831,5,1,342017,342017,342018,0,1,2
97832,1,1,342018,342018,342019,0,1,0
97833,4,1,342022,342022,342023,0,1,3
97834,5,3,342027,342027,342030,0,3,4
97835,6,3,342033,342033,342036,0,3,3
97836,6,2,342039,342039,342041,0,2,3
97837,2,1,342041,342041,342042,0,1,0
97838,5,3,342046,342046,342049,0,3,4
97839,3,1,342049,342049,342050,0,1,0
97840,5,1,342054,342054,342055,0,1,4
97841,3,2,342057,342057,342059,0,2,2
97842,6,3,342063,342063,342066,0,3,4
97843,1,2,342064,342066,342068,2,4,0
97844,2,2,342066,342068,342070,2,4,0
97845,5,2,342071,342071,342073,0,2,1
97846,5,1,342076,342076,342077,0,1,3
97847,2,1,342078,342078,342079,0,1,1
97848,2,2,342080,342080,342082,0,2,1
97849,4,3,342084,342084,342087,0,3,2
97850,5,3,342089,342089,342092,0,3,2
97851,6,1,342095,342095,342096,0,1,3
97852,1,3,342096,342096,342099,0,3,0
97853,4,1,342100,342100,342101,0,1,1
97854,5,1,342105,342105,342106,0,1,4
97855,1,1,342106,342106,342107,0,1,0
97856,1,2,342107,342107,342109,0,2,0
97857,5,3,342112,342112,342115,0,3,3
97858,5,2,342117,342117,342119,0,2,2
97859,6,2,342123,342123,342125,0,2,4
97860,2,3,342125,342125,342128,0,3,0
97861,4,3,342129,342129,342132,0,3,1
97862,3,3,342132,342132,342135,0,3,0
97863,5,1,342137,342137,342138,0,1,2
97864,2,1,342139,342139,342140,0,1,1
97865,6,3,342145,342145,342148,0,3,5
97866,5,3,342150,342150,342153,0,3,2
97867,3,3,342153,342153,342156,0,3,0
97868,6,2,342159,342159,342161,0,2,3
97869,4,1,342163,342163,342164,0,1,2
97870,6,1,342169,342169,342170,0,1,5
97871,3,1,342172,342172,342173,0,1,2
97872,3,3,342175,342175,342178,0,3,2
97873,4,2,342179,342179,342181,0,2,1
97874,2,2,342181,342181,342183,0,2,0
97875,6,2,342187,342187,342189,0,2,4
97876,3,1,342190,342190,342191,0,1,1
97877,5,2,342195,342195,342197,0,2,4
97878,2,2,342197,342197,342199,0,2,0
97879,3,3,342200,342200,342203,0,3,1
97880,2,2,342202,342203,342205,1,3,0
97881,1,1,342203,342205,342206,2,3,0
97882,4,2,342207,342207,342209,0,2,1
97883,4,3,342211,342211,342214,0,3,2
97884,4,3,342215,342215,342218,0,3,1
97885,2,1,342217,342218,342219,1,2,0
97886,3,1,342220,342220,342221,0,1,1
97887,2,1,342222,342222,342223,0,1,1
97888,2,2,342224,342224,342226,0,2,1
97889,4,2,342228,342228,342230,0,2,2
97890,3,2,342231,342231,342233,0,2,1
97891,5,2,342236,342236,342238,0,2,3
97892,2,2,342238,342238,342240,0,2,0
97893,1,1,342239,342240,342241,1,2,0
97894,3,3,342242,342242,342245,0,3,1
97895,2,1,342244,342245,342246,1,2,0
97896,1,3,342245,342246,342249,1,4,0
97897,2,2,342247,342249,342251,2,4,0
97898,2,3,342249,342251,342254,2,5,0
97899,6,1,342255,342255,342256,0,1,1
97900,5,2,342260,342260,342262,0,2,4
97901,2,2,342262,342262,342264,0,2,0
97902,3,3,342265,342265,342268,0,3,1
97903,2,3,342267,342268,342271,1,4,0
97904,2,2,342269,342271,342273,2,4,0
97905,4,2,342273,342273,342275,0,2,0
97906,1,2,342274,342275,342277,1,3,0
97907,1,1,342275,342277,342278,2,3,0
97908,6,1,342281,342281,342282,0,1,3
97909,3,2,342284,342284,342286,0,2,2
97910,5,1,342289,342289,342290,0,1,3
97911,2,2,342291,342291,342293,0,2,1
97912,6,1,342297,342297,342298,0,1,4
97913,5,1,342302,342302,342303,0,1,4
97914,5,3,342307,342307,342310,0,3,4
97915,6,1,342313,342313,342314,0,1,3
97916,4,2,342317,342317,342319,0,2,3
97917,1,2,342318,342319,342321,1,3,0
97918,2,2,342320,342321,342323,1,3,0
97919,1,2,342321,342323,342325,2,4,0
97920,5,1,342326,342326,342327,0,1,1
97921,2,3,342328,342328,342331,0,3,1
97922,3,1,342331,342331,342332,0,1,0
97923,1,2,342332,342332,342334,0,2,0
97924,2,3,342334,342334,342337,0,3,0
97925,5,2,342339,342339,342341,0,2,2
97926,6,2,342345,342345,342347,0,2,4
97927,5,1,342350,342350,342351,0,1,3
97928,6,2,342356,342356,342358,0,2,5
97929,2,2,342358,342358,342360,0,2,0
97930,6,1,342364,342364,342365,0,1,4
97931,3,2,342367,342367,342369,0,2,2
97932,4,2,342371,342371,342373,0,2,2
97933,3,2,342374,342374,342376,0,2,1
97934,4,3,342378,342378,342381,0,3,2
97935,2,3,342380,342381,342384,1,4,0
97936,6,1,342386,342386,342387,0,1,2
97937,3,3,342389,342389,342392,0,3,2
97938,4,3,342393,342393,342396,0,3,1
97939,6,1,342399,342399,342400,0,1,3
97940,2,1,342401,342401,342402,0,1,1
97941,1,3,342402,342402,342405,0,3,0
97942,2,2,342404,342405,342407,1,3,0
97943,4,1,342408,342408,342409,0,1,1
97944,1,3,342409,342409,342412,0,3,0
97945,3,3,342412,342412,342415,0,3,0
97946,4,1,342416,342416,342417,0,1,1
97947,4,3,342420,342420,342423,0,3,3
97948,2,1,342422,342423,342424,1,2,0
97949,4,3,342426,342426,342429,0,3,2
97950,1,1,342427,342429,342430,2,3,0
97951,6,1,342433,342433,342434,0,1,3
97952,6,1,342439,342439,342440,0,1,5
97953,5,2,342444,342444,342446,0,2,4
97954,1,3,342445,342446,342449,1,4,0
97955,3,2,342448,342449,342451,1,3,0
97956,2,3,342450,342451,342454,1,4,0
97957,3,1,342453,342454,342455,1,2,0
97958,2,2,342455,342455,342457,0,2,0
97959,1,2,342456,342457,342459,1,3,0
97960,5,1,342461,342461,342462,0,1,2
97961,3,1,342464,342464,342465,0,1,2
97962,6,3,342470,342470,342473,0,3,5
97963,3,3,342473,342473,342476,0,3,0
97964,1,2,342474,342476,342478,2,4,0
97965,4,3,342478,342478,342481,0,3,0
97966,4,2,342482,342482,342484,0,2,1
97967,2,1,342484,342484,342485,0,1,0
97968,5,1,342489,342489,342490,0,1,4
97969,4,1,342493,342493,342494,0,1,3
97970,3,2,342496,342496,342498,0,2,2
97971,6,1,342502,342502,342503,0,1,4
97972,6,3,342508,342508,342511,0,3,5
97973,1,1,342509,342511,342512,2,3,0
97974,1,2,342510,342512,342514,2,4,0
97975,3,3,342513,342514,342517,1,4,0
97976,1,1,342514,342517,342518,3,4,0
97977,6,2,342520,342520,342522,0,2,2
97978,5,1,342525,342525,342526,0,1,3
97979,2,3,342527,342527,342530,0,3,1
97980,6,1,342533,342533,342534,0,1,3
97981,3,2,342536,342536,342538,0,2,2
97982,4,1,342540,342540,342541,0,1,2
97983,4,1,342544,342544,342545,0,1,3
97984,6,2,342550,342550,342552,0,2,5
97985,3,3,342553,342553,342556,0,3,1
97986,4,1,342557,342557,342558,0,1,1
97987,3,1,342560,342560,342561,0,1,2
97988,3,1,342563,342563,342564,0,1,2
97989,2,1,342565,342565,342566,0,1,1
97990,3,2,342568,342568,342570,0,2,2
97991,2,2,342570,342570,342572,0,2,0
97992,6,2,342576,342576,342578,0,2,4
97993,1,3,342577,342578,342581,1,4,0
97994,6,1,342583,342583,342584,0,1,2
97995,4,3,342587,342587,342590,0,3,3
97996,1,1,342588,342590,342591,2,3,0
97997,1,3,342589,342591,342594,2,5,0
97998,5,1,342594,342594,342595,0,1,0
97999,6,2,342600,342600,342602,0,2,5
98000,3,1,342603,342603,342604,0,1,1
98001,2,1,342605,342605,342606,0,1,1
98002,3,3,342608,342608,342611,0,3,2
98003,1,2,342609,342611,342613,2,4,0
98004,1,1,342610,342613,342614,3,4,0
98005,5,3,342615,342615,342618,0,3,1
98006,6,2,342621,342621,342623,0,2,3
98007,1,1,342622,342623,342624,1,2,0
98008,6,2,342628,342628,342630,0,2,4
98009,6,1,342634,342634,342635,0,1,4
98010,2,2,342636,342636,342638,0,2,1
98011,4,1,342640,342640,342641,0,1,2
98012,1,1,342641,342641,342642,0,1,0
98013,6,3,342647,342647,342650,0,3,5
98014,3,3,342650,342650,342653,0,3,0
98015,3,3,342653,342653,342656,0,3,0
98016,2,1,342655,342656,342657,1,2,0
98017,2,1,342657,342657,342658,0,1,0
98018,3,3,342660,342660,342663,0,3,2
98019,1,2,342661,342663,342665,2,4,0
98020,4,1,342665,342665,342666,0,1,0
98021,5,2,342670,342670,342672,0,2,4
98022,2,2,342672,342672,342674,0,2,0
98023,3,3,342675,342675,342678,0,3,1
98024,5,2,342680,342680,342682,0,2,2
98025,2,2,342682,342682,342684,0,2,0
98026,5,2,342687,342687,342689,0,2,3
98027,6,1,342693,342693,342694,0,1,4
98028,4,2,342697,342697,342699,0,2,3
98029,5,2,342702,342702,342704,0,2,3
98030,2,3,342704,342704,342707,0,3,0
98031,5,2,342709,342709,342711,0,2,2
98032,3,3,342712,342712,342715,0,3,1
98033,2,3,342714,342715,342718,1,4,0
98034,2,1,342716,342718,342719,2,3,0
98035,1,1,342717,342719,342720,2,3,0
98036,6,3,342723,342723,342726,0,3,3
98037,5,2,342728,342728,342730,0,2,2
98038,3,1,342731,342731,342732,0,1,1
98039,3,2,342734,342734,342736,0,2,2
98040,2,2,342736,342736,342738,0,2,0
98041,3,2,342739,342739,342741,0,2,1
98042,1,3,342740,342741,342744,1,4,0
98043,1,1,342741,342744,342745,3,4,0
98044,2,1,342743,342745,342746,2,3,0
98045,1,2,342744,342746,342748,2,4,0
98046,5,1,342749,342749,342750,0,1,1
98047,4,2,342753,342753,342755,0,2,3
98048,6,2,342759,342759,342761,0,2,4
98049,3,2,342762,342762,342764,0,2,1
98050,2,1,342764,342764,342765,0,1,0
98051,5,2,342769,342769,342771,0,2,4
98052,3,3,342772,342772,342775,0,3,1
98053,6,2,342778,342778,342780,0,2,3
98054,1,2,342779,342780,342782,1,3,0
98055,5,2,342784,342784,342786,0,2,2
98056,6,3,342790,342790,342793,0,3,4
98057,3,2,342793,342793,342795,0,2,0
98058,5,2,342798,342798,342800,0,2,3
98059,3,1,342801,342801,342802,0,1,1
98060,3,2,342804,342804,342806,0,2,2
98061,6,2,342810,342810,342812,0,2,4
98062,3,2,342813,342813,342815,0,2,1
98063,5,3,342818,342818,342821,0,3,3
98064,2,1,342820,342821,342822,1,2,0
98065,1,1,342821,342822,342823,1,2,0
98066,6,3,342827,342827,342830,0,3,4
98067,4,3,342831,342831,342834,0,3,1
98068,6,1,342837,342837,342838,0,1,3
98069,1,3,342838,342838,342841,0,3,0
98070,4,1,342842,342842,342843,0,1,1
98071,5,1,342847,342847,342848,0,1,4
98072,2,1,342849,342849,342850,0,1,1
98073,5,2,342854,342854,342856,0,2,4
98074,1,2,342855,342856,342858,1,3,0
98075,3,3,342858,342858,342861,0,3,0
98076,5,2,342863,342863,342865,0,2,2
98077,1,2,342864,342865,342867,1,3,0
98078,3,2,342867,342867,342869,0,2,0
98079,3,1,342870,342870,342871,0,1,1
98080,4,2,342874,342874,342876,0,2,3
98081,1,2,342875,342876,342878,1,3,0
98082,6,3,342881,342881,342884,0,3,3
98083,4,1,342885,342885,342886,0,1,1
98084,3,3,342888,342888,342891,0,3,2
98085,4,1,342892,342892,342893,0,1,1
98086,1,1,342893,342893,342894,0,1,0
98087,3,1,342896,342896,342897,0,1,2
98088,5,1,342901,342901,342902,0,1,4
98089,3,3,342904,342904,342907,0,3,2
98090,4,2,342908,342908,342910,0,2,1
98091,4,2,342912,342912,342914,0,2,2
98092,4,1,342916,342916,342917,0,1,2
98093,3,1,342919,342919,342920,0,1,2
98094,2,1,342921,342921,342922,0,1,1
98095,2,3,342923,342923,342926,0,3,1
98096,5,2,342928,342928,342930,0,2,2
98097,2,2,342930,342930,342932,0,2,0
98098,6,1,342936,342936,342937,0,1,4
98099,3,1,342939,342939,342940,0,1,2
98100,6,2,342945,342945,342947,0,2,5
98101,2,3,342947,342947,342950,0,3,0
98102,1,1,342948,342950,342951,2,3,0
98103,6,1,342954,342954,342955,0,1,3
98104,2,1,342956,342956,342957,0,1,1
98105,3,1,342959,342959,342960,0,1,2
98106,6,3,342965,342965,342968,0,3,5
98107,4,3,342969,342969,342972,0,3,1
98108,3,1,342972,342972,342973,0,1,0
98109,3,3,342975,342975,342978,0,3,2
98110,3,3,342978,342978,342981,0,3,0
98111,6,1,342984,342984,342985,0,1,3
98112,3,3,342987,342987,342990,0,3,2
98113,6,2,342993,342993,342995,0,2,3
98114,1,2,342994,342995,342997,1,3,0
98115,5,3,342999,342999,343002,0,3,2
98116,5,3,343004,343004,343007,0,3,2
98117,4,3,343008,343008,343011,0,3,1
98118,5,3,343013,343013,343016,0,3,2
98119,6,3,343019,343019,343022,0,3,3
98120,1,1,343020,343022,343023,2,3,0
98121,2,3,343022,343023,343026,1,4,0
98122,1,3,343023,343026,343029,3,6,0
98123,3,3,343026,343029,343032,3,6,0
98124,4,3,343030,343032,343035,2,5,0
98125,2,1,343032,343035,343036,3,4,0
98126,5,3,343037,343037,343040,0,3,1
98127,5,2,343042,343042,343044,0,2,2
98128,6,2,343048,343048,343050,0,2,4
98129,3,1,343051,343051,343052,0,1,1
98130,5,2,343056,343056,343058,0,2,4
98131,5,2,343061,343061,343063,0,2,3
98132,5,2,343066,343066,343068,0,2,3
98133,3,3,343069,343069,343072,0,3,1
98134,1,1,343070,343072,343073,2,3,0
98135,6,1,343076,343076,343077,0,1,3
98136,2,1,343078,343078,343079,0,1,1
98137,5,1,343083,343083,343084,0,1,4
98138,5,3,343088,343088,343091,0,3,4
98139,5,3,343093,343093,343096,0,3,2
98140,3,1,343096,343096,343097,0,1,0
98141,2,3,343098,343098,343101,0,3,1
98142,3,2,343101,343101,343103,0,2,0
98143,1,1,343102,343103,343104,1,2,0
98144,5,2,343107,343107,343109,0,2,3
98145,3,3,343110,343110,343113,0,3,1
98146,3,2,343113,343113,343115,0,2,0
98147,6,2,343119,343119,343121,0,2,4
98148,3,1,343122,343122,343123,0,1,1
98149,1,2,343123,343123,343125,0,2,0
98150,1,3,343124,343125,343128,1,4,0
98151,3,2,343127,343128,343130,1,3,0
98152,5,1,343132,343132,343133,0,1,2
98153,6,2,343138,343138,343140,0,2,5
98154,6,2,343144,343144,343146,0,2,4
98155,2,3,343146,343146,343149,0,3,0
98156,3,1,343149,343149,343150,0,1,0
98157,4,2,343153,343153,343155,0,2,3
98158,1,3,343154,343155,343158,1,4,0
98159,6,3,343160,343160,343163,0,3,2
98160,4,3,343164,343164,343167,0,3,1
98161,5,2,343169,343169,343171,0,2,2
98162,3,2,343172,343172,343174,0,2,1
98163,6,2,343178,343178,343180,0,2,4
98164,1,1,343179,343180,343181,1,2,0
98165,5,3,343184,343184,343187,0,3,3
98166,5,1,343189,343189,343190,0,1,2
98167,3,3,343192,343192,343195,0,3,2
98168,1,2,343193,343195,343197,2,4,0
98169,5,1,343198,343198,343199,0,1,1
98170,4,3,343202,343202,343205,0,3,3
98171,1,2,343203,343205,343207,2,4,0
98172,2,3,343205,343207,343210,2,5,0
98173,2,1,343207,343210,343211,3,4,0
98174,4,3,343211,343211,343214,0,3,0
98175,4,3,343215,343215,343218,0,3,1
98176,1,2,343216,343218,343220,2,4,0
98177,5,3,343221,343221,343224,0,3,1
98178,3,2,343224,343224,343226,0,2,0
98179,6,2,343230,343230,343232,0,2,4
98180,4,2,343234,343234,343236,0,2,2
98181,3,1,343237,343237,343238,0,1,1
98182,4,3,343241,343241,343244,0,3,3
98183,2,2,343243,343244,343246,1,3,0
98184,2,1,343245,343246,343247,1,2,0
98185,3,2,343248,343248,343250,0,2,1
98186,5,3,343253,343253,343256,0,3,3
98187,5,2,343258,343258,343260,0,2,2
98188,2,1,343260,343260,343261,0,1,0
98189,3,2,343263,343263,343265,0,2,2
98190,6,3,343269,343269,343272,0,3,4
98191,2,1,343271,343272,343273,1,2,0
98192,6,3,343277,343277,343280,0,3,4
98193,4,3,343281,343281,343284,0,3,1
98194,1,3,343282,343284,343287,2,5,0
98195,4,3,343286,343287,343290,1,4,0
98196,4,3,343290,343290,343293,0,3,0
98197,6,3,343296,343296,343299,0,3,3
98198,6,2,343302,343302,343304,0,2,3
98199,6,2,343308,343308,343310,0,2,4
98200,1,1,343309,343310,343311,1,2,0
98201,3,3,343312,343312,343315,0,3,1
98202,3,1,343315,343315,343316,0,1,0
98203,5,1,343320,343320,343321,0,1,4
98204,5,2,343325,343325,343327,0,2,4
98205,6,3,343331,343331,343334,0,3,4
98206,3,1,343334,343334,343335,0,1,0
98207,5,2,343339,343339,343341,0,2,4
98208,2,3,343341,343341,343344,0,3,0
98209,6,3,343347,343347,343350,0,3,3
98210,6,1,343353,343353,343354,0,1,3
98211,3,2,343356,343356,343358,0,2,2
98212,6,2,343362,343362,343364,0,2,4
98213,1,2,343363,343364,343366,1,3,0
98214,6,1,343369,343369,343370,0,1,3
98215,5,3,343374,343374,343377,0,3,4
98216,2,2,343376,343377,343379,1,3,0
98217,5,2,343381,343381,343383,0,2,2
98218,1,3,343382,343383,343386,1,4,0
98219,5,2,343387,343387,343389,0,2,1
98220,6,2,343393,343393,343395,0,2,4
98221,1,3,343394,343395,343398,1,4,0
98222,6,1,343400,343400,343401,0,1,2
98223,1,2,343401,343401,343403,0,2,0
98224,2,3,343403,343403,343406,0,3,0
98225,2,1,343405,343406,343407,1,2,0
98226,5,3,343410,343410,343413,0,3,3
98227,4,3,343414,343414,343417,0,3,1
98228,3,3,343417,343417,343420,0,3,0
98229,2,1,343419,343420,343421,1,2,0
98230,1,2,343420,343421,343423,1,3,0
98231,6,1,343426,343426,343427,0,1,3
98232,3,3,343429,343429,343432,0,3,2
98233,4,2,343433,343433,343435,0,2,1
98234,1,2,343434,343435,343437,1,3,0
98235,6,1,343440,343440,343441,0,1,3
98236,3,1,343443,343443,343444,0,1,2
98237,3,3,343446,343446,343449,0,3,2
98238,2,2,343448,343449,343451,1,3,0
98239,6,1,343454,343454,343455,0,1,3
98240,4,1,343458,343458,343459,0,1,3
98241,2,1,343460,343460,343461,0,1,1
98242,1,1,343461,343461,343462,0,1,0
98243,4,1,343465,343465,343466,0,1,3
98244,6,2,343471,343471,343473,0,2,5
98245,5,1,343476,343476,343477,0,1,3
98246,1,1,343477,343477,343478,0,1,0
98247,4,3,343481,343481,343484,0,3,3
98248,5,1,343486,343486,343487,0,1,2
98249,2,2,343488,343488,343490,0,2,1
98250,1,1,343489,343490,343491,1,2,0
98251,1,2,343490,343491,343493,1,3,0
98252,2,2,343492,343493,343495,1,3,0
98253,6,2,343498,343498,343500,0,2,3
98254,3,1,343501,343501,343502,0,1,1
98255,6,3,343507,343507,343510,0,3,5
98256,4,3,343511,343511,343514,0,3,1
98257,5,3,343516,343516,343519,0,3,2
98258,2,1,343518,343519,343520,1,2,0
98259,2,2,343520,343520,343522,0,2,0
98260,5,3,343525,343525,343528,0,3,3
98261,5,2,343530,343530,343532,0,2,2
98262,2,1,343532,343532,343533,0,1,0
98263,4,3,343536,343536,343539,0,3,3
98264,3,3,343539,343539,343542,0,3,0
98265,4,2,343543,343543,343545,0,2,1
98266,4,1,343547,343547,343548,0,1,2
98267,3,1,343550,343550,343551,0,1,2
98268,5,1,343555,343555,343556,0,1,4
98269,3,2,343558,343558,343560,0,2,2
98270,2,2,343560,343560,343562,0,2,0
98271,1,2,343561,343562,343564,1,3,0
98272,2,2,343563,343564,343566,1,3,0
98273,6,1,343569,343569,343570,0,1,3
98274,6,2,343575,343575,343577,0,2,5
98275,6,3,343581,343581,343584,0,3,4
98276,3,1,343584,343584,343585,0,1,0
98277,3,2,343587,343587,343589,0,2,2
98278,6,1,343593,343593,343594,0,1,4
98279,1,1,343594,343594,343595,0,1,0
98280,6,2,343600,343600,343602,0,2,5
98281,5,3,343605,343605,343608,0,3,3
98282,4,3,343609,343609,343612,0,3,1
98283,5,1,343614,343614,343615,0,1,2
98284,5,1,343619,343619,343620,0,1,4
98285,2,3,343621,343621,343624,0,3,1
98286,1,1,343622,343624,343625,2,3,0
98287,6,3,343628,343628,343631,0,3,3
98288,2,1,343630,343631,343632,1,2,0
98289,4,3,343634,343634,343637,0,3,2
98290,4,2,343638,343638,343640,0,2,1
98291,6,3,343644,343644,343647,0,3,4
98292,2,2,343646,343647,343649,1,3,0
98293,3,1,343649,343649,343650,0,1,0
98294,5,1,343654,343654,343655,0,1,4
98295,6,1,343660,343660,343661,0,1,5
98296,4,2,343664,343664,343666,0,2,3
98297,1,2,343665,343666,343668,1,3,0
98298,1,3,343666,343668,343671,2,5,0
98299,1,3,343667,343671,343674,4,7,0
98300,4,3,343671,343674,343677,3,6,0
98301,3,1,343674,343677,343678,3,4,0
98302,4,2,343678,343678,343680,0,2,0
98303,6,1,343684,343684,343685,0,1,4
98304,4,1,343688,343688,343689,0,1,3
98305,4,2,343692,343692,343694,0,2,3
98306,3,3,343695,343695,343698,0,3,1
98307,4,1,343699,343699,343700,0,1,1
98308,4,1,343703,343703,343704,0,1,3
98309,2,2,343705,343705,343707,0,2,1
98310,4,1,343709,343709,343710,0,1,2
98311,2,3,343711,343711,343714,0,3,1
98312,2,3,343713,343714,343717,1,4,0
98313,6,2,343719,343719,343721,0,2,2
98314,4,3,343723,343723,343726,0,3,2
98315,1,2,343724,343726,343728,2,4,0
98316,3,3,343727,343728,343731,1,4,0
98317,4,3,343731,343731,343734,0,3,0
98318,4,2,343735,343735,343737,0,2,1
98319,4,2,343739,343739,343741,0,2,2
98320,3,2,343742,343742,343744,0,2,1
98321,5,2,343747,343747,343749,0,2,3
98322,6,3,343753,343753,343756,0,3,4
98323,3,3,343756,343756,343759,0,3,0
98324,4,2,343760,343760,343762,0,2,1
98325,4,1,343764,343764,343765,0,1,2
98326,1,1,343765,343765,343766,0,1,0
98327,2,1,343767,343767,343768,0,1,1
98328,2,2,343769,343769,343771,0,2,1
98329,4,2,343773,343773,343775,0,2,2
98330,5,2,343778,343778,343780,0,2,3
98331,6,2,343784,343784,343786,0,2,4
98332,6,2,343790,343790,343792,0,2,4
98333,2,2,343792,343792,343794,0,2,0
98334,2,3,343794,343794,343797,0,3,0
98335,3,1,343797,343797,343798,0,1,0
98336,4,3,343801,343801,343804,0,3,3
98337,5,3,343806,343806,343809,0,3,2
98338,2,2,343808,343809,343811,1,3,0
98339,3,1,343811,343811,343812,0,1,0
98340,6,1,343817,343817,343818,0,1,5
98341,5,3,343822,343822,343825,0,3,4
98342,1,1,343823,343825,343826,2,3,0
98343,2,2,343825,343826,343828,1,3,0
98344,3,3,343828,343828,343831,0,3,0
98345,3,2,343831,343831,343833,0,2,0
98346,5,3,343836,343836,343839,0,3,3
98347,4,1,343840,343840,343841,0,1,1
98348,6,1,343846,343846,343847,0,1,5
98349,1,3,343847,343847,343850,0,3,0
98350,2,2,343849,343850,343852,1,3,0
98351,5,1,343854,343854,343855,0,1,2
98352,2,1,343856,343856,343857,0,1,1
98353,2,1,343858,343858,343859,0,1,1
98354,2,2,343860,343860,343862,0,2,1
98355,6,2,343866,343866,343868,0,2,4
98356,6,3,343872,343872,343875,0,3,4
98357,2,3,343874,343875,343878,1,4,0
98358,6,3,343880,343880,343883,0,3,2
98359,4,2,343884,343884,343886,0,2,1
98360,4,1,343888,343888,343889,0,1,2
98361,4,3,343892,343892,343895,0,3,3
98362,4,2,343896,343896,343898,0,2,1
98363,2,1,343898,343898,343899,0,1,0
98364,2,2,343900,343900,343902,0,2,1
98365,6,1,343906,343906,343907,0,1,4
98366,2,1,343908,343908,343909,0,1,1
98367,1,3,343909,343909,343912,0,3,0
98368,2,2,343911,343912,343914,1,3,0
98369,2,3,343913,343914,343917,1,4,0
98370,5,2,343918,343918,343920,0,2,1
98371,3,2,343921,343921,343923,0,2,1
98372,5,1,343926,343926,343927,0,1,3
98373,5,2,343931,343931,343933,0,2,4
98374,6,2,343937,343937,343939,0,2,4
98375,1,1,343938,343939,343940,1,2,0
98376,1,2,343939,343940,343942,1,3,0
98377,4,2,343943,343943,343945,0,2,1
98378,3,3,343946,343946,343949,0,3,1
98379,2,2,343948,343949,343951,1,3,0
98380,4,2,343952,343952,343954,0,2,1
98381,2,2,343954,343954,343956,0,2,0
98382,2,2,343956,343956,343958,0,2,0
98383,2,2,343958,343958,343960,0,2,0
98384,2,2,343960,343960,343962,0,2,0
98385,2,2,343962,343962,343964,0,2,0
98386,2,3,343964,343964,343967,0,3,0
98387,5,1,343969,343969,343970,0,1,2
98388,5,3,343974,343974,343977,0,3,4
98389,2,1,343976,343977,343978,1,2,0
98390,3,1,343979,343979,343980,0,1,1
98391,1,2,343980,343980,343982,0,2,0
98392,1,3,343981,343982,343985,1,4,0
98393,5,1,343986,343986,343987,0,1,1
98394,5,2,343991,343991,343993,0,2,4
98395,4,3,343995,343995,343998,0,3,2
98396,4,2,343999,343999,344001,0,2,1
98397,4,3,344003,344003,344006,0,3,2
98398,2,2,344005,344006,344008,1,3,0
98399,2,3,344007,344008,344011,1,4,0
98400,2,3,344009,344011,344014,2,5,0
98401,6,2,344015,344015,344017,0,2,1
98402,4,2,344019,344019,344021,0,2,2
98403,5,2,344024,344024,344026,0,2,3
98404,6,1,344030,344030,344031,0,1,4
98405,4,2,344034,344034,344036,0,2,3
98406,6,2,344040,344040,344042,0,2,4
98407,3,2,344043,344043,344045,0,2,1
98408,3,2,344046,344046,344048,0,2,1
98409,3,2,344049,344049,344051,0,2,1
98410,6,1,344055,344055,344056,0,1,4
98411,2,2,344057,344057,344059,0,2,1
98412,2,1,344059,344059,344060,0,1,0
98413,1,3,344060,344060,344063,0,3,0
98414,5,1,344065,344065,344066,0,1,2
98415,2,3,344067,344067,344070,0,3,1
98416,1,2,344068,344070,344072,2,4,0
98417,5,2,344073,344073,344075,0,2,1
98418,6,2,344079,344079,344081,0,2,4
98419,6,3,344085,344085,344088,0,3,4
98420,2,1,344087,344088,344089,1,2,0
98421,5,1,344092,344092,344093,0,1,3
98422,2,3,344094,344094,344097,0,3,1
98423,4,2,344098,344098,344100,0,2,1
98424,3,2,344101,344101,344103,0,2,1
98425,4,2,344105,344105,344107,0,2,2
98426,6,2,344111,344111,344113,0,2,4
98427,2,1,344113,344113,344114,0,1,0
98428,4,3,344117,344117,344120,0,3,3
98429,1,2,344118,344120,344122,2,4,0
98430,1,2,344119,344122,344124,3,5,0
98431,4,2,344123,344124,344126,1,3,0
98432,5,2,344128,344128,344130,0,2,2
98433,3,3,344131,344131,344134,0,3,1
98434,3,1,344134,344134,344135,0,1,0
98435,4,3,344138,344138,344141,0,3,3
98436,5,3,344143,344143,344146,0,3,2
98437,1,1,344144,344146,344147,2,3,0
98438,1,3,344145,344147,344150,2,5,0
98439,4,1,344149,344150,344151,1,2,0
98440,1,2,344150,344151,344153,1,3,0
98441,4,2,344154,344154,344156,0,2,1
98442,2,2,344156,344156,344158,0,2,0
98443,2,3,344158,344158,344161,0,3,0
98444,3,2,344161,344161,344163,0,2,0
98445,6,1,344167,344167,344168,0,1,4
98446,2,2,344169,344169,344171,0,2,1
98447,1,2,344170,344171,344173,1,3,0
98448,5,3,344175,344175,344178,0,3,2
98449,3,2,344178,344178,344180,0,2,0
98450,6,1,344184,344184,344185,0,1,4
98451,3,1,344187,344187,344188,0,1,2
98452,1,2,344188,344188,344190,0,2,0
98453,1,1,344189,344190,344191,1,2,0
98454,2,1,344191,344191,344192,0,1,0
98455,4,3,344195,344195,344198,0,3,3
98456,4,1,344199,344199,344200,0,1,1
98457,2,2,344201,344201,344203,0,2,1
98458,3,3,344204,344204,344207,0,3,1
98459,2,1,344206,344207,344208,1,2,0
98460,4,1,344210,344210,344211,0,1,2
98461,6,3,344216,344216,344219,0,3,5
98462,6,3,344222,344222,344225,0,3,3
98463,3,3,344225,344225,344228,0,3,0
98464,2,2,344227,344228,344230,1,3,0
98465,5,2,344232,344232,344234,0,2,2
98466,6,1,344238,344238,344239,0,1,4
98467,6,2,344244,344244,344246,0,2,5
98468,4,3,344248,344248,344251,0,3,2
98469,6,1,344254,344254,344255,0,1,3
98470,5,1,344259,344259,344260,0,1,4
98471,1,2,344260,344260,344262,0,2,0
98472,3,2,344263,344263,344265,0,2,1
98473,5,2,344268,344268,344270,0,2,3
98474,2,2,344270,344270,344272,0,2,0
98475,3,3,344273,344273,344276,0,3,1
98476,2,3,344275,344276,344279,1,4,0
98477,2,3,344277,344279,344282,2,5,0
98478,2,3,344279,344282,344285,3,6,0
98479,2,3,344281,344285,344288,4,7,0
98480,2,2,344283,344288,344290,5,7,0
98481,3,3,344286,344290,344293,4,7,0
98482,3,2,344289,344293,344295,4,6,0
98483,6,2,344295,344295,344297,0,2,0
98484,2,2,344297,344297,344299,0,2,0
98485,5,1,344302,344302,344303,0,1,3
98486,6,3,344308,344308,344311,0,3,5
98487,5,3,344313,344313,344316,0,3,2
98488,2,1,344315,344316,344317,1,2,0
98489,2,2,344317,344317,344319,0,2,0
98490,6,3,344323,344323,344326,0,3,4
98491,1,1,344324,344326,344327,2,3,0
98492,5,3,344329,344329,344332,0,3,2
98493,4,3,344333,344333,344336,0,3,1
98494,6,3,344339,344339,344342,0,3,3
98495,6,3,344345,344345,344348,0,3,3
98496,6,3,344351,344351,344354,0,3,3
98497,1,1,344352,344354,344355,2,3,0
98498,1,3,344353,344355,344358,2,5,0
98499,5,2,344358,344358,344360,0,2,0
98500,6,2,344364,344364,344366,0,2,4
98501,2,3,344366,344366,344369,0,3,0
98502,5,2,344371,344371,344373,0,2,2
98503,3,1,344374,344374,344375,0,1,1
98504,1,2,344375,344375,344377,0,2,0
98505,5,2,344380,344380,344382,0,2,3
98506,3,1,344383,344383,344384,0,1,1
98507,2,3,344385,344385,344388,0,3,1
98508,6,2,344391,344391,344393,0,2,3
98509,3,2,344394,344394,344396,0,2,1
98510,3,1,344397,344397,344398,0,1,1
98511,6,2,344403,344403,344405,0,2,5
98512,5,2,344408,344408,344410,0,2,3
98513,5,1,344413,344413,344414,0,1,3
98514,2,1,344415,344415,344416,0,1,1
98515,3,1,344418,344418,344419,0,1,2
98516,3,3,344421,344421,344424,0,3,2
98517,6,2,344427,344427,344429,0,2,3
98518,3,1,344430,344430,344431,0,1,1
98519,1,3,344431,344431,344434,0,3,0
98520,3,3,344434,344434,344437,0,3,0
98521,5,2,344439,344439,344441,0,2,2
98522,4,3,344443,344443,344446,0,3,2
98523,4,3,344447,344447,344450,0,3,1
98524,2,2,344449,344450,344452,1,3,0
98525,2,2,344451,344452,344454,1,3,0
98526,2,3,344453,344454,344457,1,4,0
98527,2,3,344455,344457,344460,2,5,0
98528,4,2,344459,344460,344462,1,3,0
98529,6,1,344465,344465,344466,0,1,3
98530,5,1,344470,344470,344471,0,1,4
98531,1,3,344471,344471,344474,0,3,0
98532,1,2,344472,344474,344476,2,4,0
98533,4,2,344476,344476,344478,0,2,0
98534,1,2,344477,344478,344480,1,3,0
98535,6,2,344483,344483,344485,0,2,3
98536,4,3,344487,344487,344490,0,3,2
98537,3,3,344490,344490,344493,0,3,0
98538,1,1,344491,344493,344494,2,3,0
98539,4,1,344495,344495,344496,0,1,1
98540,6,1,344501,344501,344502,0,1,5
98541,3,2,344504,344504,344506,0,2,2
98542,4,2,344508,344508,344510,0,2,2
98543,5,2,344513,344513,344515,0,2,3
98544,1,1,344514,344515,344516,1,2,0
98545,5,3,344519,344519,344522,0,3,3
98546,6,2,344525,344525,344527,0,2,3
98547,4,1,344529,344529,344530,0,1,2
98548,6,2,344535,344535,344537,0,2,5
98549,5,2,344540,344540,344542,0,2,3
98550,5,3,344545,344545,344548,0,3,3
98551,1,1,344546,344548,344549,2,3,0
98552,2,2,344548,344549,344551,1,3,0
98553,3,3,344551,344551,344554,0,3,0
98554,3,3,344554,344554,344557,0,3,0
98555,3,1,344557,344557,344558,0,1,0
98556,6,2,344563,344563,344565,0,2,5
98557,4,2,344567,344567,344569,0,2,2
98558,3,2,344570,344570,344572,0,2,1
98559,5,2,344575,344575,344577,0,2,3
98560,1,2,344576,344577,344579,1,3,0
98561,3,1,344579,344579,344580,0,1,0
98562,2,1,344581,344581,344582,0,1,1
98563,5,3,344586,344586,344589,0,3,4
98564,1,3,344587,344589,344592,2,5,0
98565,6,1,344593,344593,344594,0,1,1
98566,3,2,344596,344596,344598,0,2,2
98567,3,3,344599,344599,344602,0,3,1
98568,6,1,344605,344605,344606,0,1,3
98569,5,2,344610,344610,344612,0,2,4
98570,5,3,344615,344615,344618,0,3,3
98571,5,2,344620,344620,344622,0,2,2
98572,5,2,344625,344625,344627,0,2,3
98573,1,1,344626,344627,344628,1,2,0
98574,1,2,344627,344628,344630,1,3,0
98575,2,3,344629,344630,344633,1,4,0
98576,6,1,344635,344635,344636,0,1,2
98577,1,2,344636,344636,344638,0,2,0
98578,2,2,344638,344638,344640,0,2,0
98579,2,3,344640,344640,344643,0,3,0
98580,4,2,344644,344644,344646,0,2,1
98581,2,1,344646,344646,344647,0,1,0
98582,3,1,344649,344649,344650,0,1,2
98583,3,1,344652,344652,344653,0,1,2
98584,5,3,344657,344657,344660,0,3,4
98585,5,3,344662,344662,344665,0,3,2
98586,1,2,344663,344665,344667,2,4,0
98587,6,2,344669,344669,344671,0,2,2
98588,2,3,344671,344671,344674,0,3,0
98589,2,1,344673,344674,344675,1,2,0
98590,6,2,344679,344679,344681,0,2,4
98591,4,2,344683,344683,344685,0,2,2
98592,5,2,344688,344688,344690,0,2,3
98593,5,1,344693,344693,344694,0,1,3
98594,1,2,344694,344694,344696,0,2,0
98595,1,3,344695,344696,344699,1,4,0
98596,1,1,344696,344699,344700,3,4,0
98597,1,1,344697,344700,344701,3,4,0
98598,2,3,344699,344701,344704,2,5,0
98599,2,3,344701,344704,344707,3,6,0
98600,1,2,344702,344707,344709,5,7,0
98601,3,1,344705,344709,344710,4,5,0
98602,1,1,344706,344710,344711,4,5,0
98603,1,1,344707,344711,344712,4,5,0
98604,6,2,344713,344713,344715,0,2,1
98605,1,1,344714,344715,344716,1,2,0
98606,4,3,344718,344718,344721,0,3,2
98607,4,3,344722,344722,344725,0,3,1
98608,1,2,344723,344725,344727,2,4,0
98609,1,2,344724,344727,344729,3,5,0
98610,1,1,344725,344729,344730,4,5,0
98611,3,1,344728,344730,344731,2,3,0
98612,1,3,344729,344731,344734,2,5,0
98613,1,3,344730,344734,344737,4,7,0
98614,6,2,344736,344737,344739,1,3,0
98615,5,2,344741,344741,344743,0,2,2
98616,1,3,344742,344743,344746,1,4,0
98617,6,3,344748,344748,344751,0,3,2
98618,5,1,344753,344753,344754,0,1,2
98619,3,3,344756,344756,344759,0,3,2
98620,2,3,344758,344759,344762,1,4,0
98621,1,2,344759,344762,344764,3,5,0
98622,5,2,344764,344764,344766,0,2,0
98623,4,1,344768,344768,344769,0,1,2
98624,5,1,344773,344773,344774,0,1,4
98625,1,2,344774,344774,344776,0,2,0
98626,6,3,344780,344780,344783,0,3,4
98627,6,3,344786,344786,344789,0,3,3
98628,2,2,344788,344789,344791,1,3,0
98629,4,1,344792,344792,344793,0,1,1
98630,1,1,344793,344793,344794,0,1,0
98631,3,2,344796,344796,344798,0,2,2
98632,6,3,344802,344802,344805,0,3,4
98633,3,3,344805,344805,344808,0,3,0
98634,3,2,344808,344808,344810,0,2,0
98635,4,2,344812,344812,344814,0,2,2
98636,5,1,344817,344817,344818,0,1,3
98637,2,1,344819,344819,344820,0,1,1
98638,5,2,344824,344824,344826,0,2,4
98639,5,3,344829,344829,344832,0,3,3
98640,2,3,344831,344832,344835,1,4,0
98641,4,3,344835,344835,344838,0,3,0
98642,2,3,344837,344838,344841,1,4,0
98643,2,1,344839,344841,344842,2,3,0
98644,1,2,344840,344842,344844,2,4,0
98645,2,1,344842,344844,344845,2,3,0
98646,3,1,344845,344845,344846,0,1,0
98647,4,3,344849,344849,344852,0,3,3
98648,2,2,344851,344852,344854,1,3,0
98649,1,2,344852,344854,344856,2,4,0
98650,3,3,344855,344856,344859,1,4,0
98651,2,2,344857,344859,344861,2,4,0
98652,1,1,344858,344861,344862,3,4,0
98653,4,2,344862,344862,344864,0,2,0
98654,3,2,344865,344865,344867,0,2,1
98655,4,1,344869,344869,344870,0,1,2
98656,3,2,344872,344872,344874,0,2,2
98657,3,3,344875,344875,344878,0,3,1
98658,6,2,344881,344881,344883,0,2,3
98659,4,2,344885,344885,344887,0,2,2
98660,3,2,344888,344888,344890,0,2,1
98661,1,1,344889,344890,344891,1,2,0
98662,6,3,344895,344895,344898,0,3,4
98663,4,1,344899,344899,344900,0,1,1
98664,4,3,344903,344903,344906,0,3,3
98665,1,3,344904,344906,344909,2,5,0
98666,4,2,344908,344909,344911,1,3,0
98667,2,1,344910,344911,344912,1,2,0
98668,4,1,344914,344914,344915,0,1,2
98669,3,1,344917,344917,344918,0,1,2
98670,4,1,344921,344921,344922,0,1,3
98671,1,1,344922,344922,344923,0,1,0
98672,4,1,344926,344926,344927,0,1,3
98673,4,2,344930,344930,344932,0,2,3
98674,1,2,344931,344932,344934,1,3,0
98675,1,3,344932,344934,344937,2,5,0
98676,1,1,344933,344937,344938,4,5,0
98677,1,1,344934,344938,344939,4,5,0
98678,6,1,344940,344940,344941,0,1,1
98679,4,1,344944,344944,344945,0,1,3
98680,3,1,344947,344947,344948,0,1,2
98681,4,3,344951,344951,344954,0,3,3
98682,4,1,344955,344955,344956,0,1,1
98683,5,3,344960,344960,344963,0,3,4
98684,4,3,344964,344964,344967,0,3,1
98685,6,3,344970,344970,344973,0,3,3
98686,6,1,344976,344976,344977,0,1,3
98687,4,3,344980,344980,344983,0,3,3
98688,1,3,344981,344983,344986,2,5,0
98689,2,3,344983,344986,344989,3,6,0
98690,5,2,344988,344989,344991,1,3,0
98691,6,2,344994,344994,344996,0,2,3
98692,6,3,345000,345000,345003,0,3,4
98693,1,1,345001,345003,345004,2,3,0
98694,5,2,345006,345006,345008,0,2,2
98695,5,1,345011,345011,345012,0,1,3
98696,1,1,345012,345012,345013,0,1,0
98697,5,3,345017,345017,345020,0,3,4
98698,1,3,345018,345020,345023,2,5,0
98699,4,2,345022,345023,345025,1,3,0
98700,4,3,345026,345026,345029,0,3,1
98701,4,1,345030,345030,345031,0,1,1
98702,4,3,345034,345034,345037,0,3,3
98703,3,3,345037,345037,345040,0,3,0
98704,5,3,345042,345042,345045,0,3,2
98705,2,3,345044,345045,345048,1,4,0
98706,6,2,345050,345050,345052,0,2,2
98707,2,3,345052,345052,345055,0,3,0
98708,5,1,345057,345057,345058,0,1,2
98709,3,1,345060,345060,345061,0,1,2
98710,4,2,345064,345064,345066,0,2,3
98711,1,2,345065,345066,345068,1,3,0
98712,1,3,345066,345068,345071,2,5,0
98713,6,1,345072,345072,345073,0,1,1
98714,6,1,345078,345078,345079,0,1,5
98715,2,1,345080,345080,345081,0,1,1
98716,6,1,345086,345086,345087,0,1,5
98717,5,2,345091,345091,345093,0,2,4
98718,6,3,345097,345097,345100,0,3,4
98719,1,2,345098,345100,345102,2,4,0
98720,6,1,345104,345104,345105,0,1,2
98721,3,3,345107,345107,345110,0,3,2
98722,3,1,345110,345110,345111,0,1,0
98723,3,1,345113,345113,345114,0,1,2
98724,6,3,345119,345119,345122,0,3,5
98725,1,3,345120,345122,345125,2,5,0
98726,3,3,345123,345125,345128,2,5,0
98727,3,2,345126,345128,345130,2,4,0
98728,4,1,345130,345130,345131,0,1,0
98729,4,2,345134,345134,345136,0,2,3
98730,2,3,345136,345136,345139,0,3,0
98731,6,3,345142,345142,345145,0,3,3
98732,5,3,345147,345147,345150,0,3,2
98733,3,2,345150,345150,345152,0,2,0
98734,5,2,345155,345155,345157,0,2,3
98735,5,1,345160,345160,345161,0,1,3
98736,1,2,345161,345161,345163,0,2,0
98737,1,2,345162,345163,345165,1,3,0
98738,2,1,345164,345165,345166,1,2,0
98739,4,3,345168,345168,345171,0,3,2
98740,3,1,345171,345171,345172,0,1,0
98741,2,1,345173,345173,345174,0,1,1
98742,3,2,345176,345176,345178,0,2,2
98743,5,3,345181,345181,345184,0,3,3
98744,6,1,345187,345187,345188,0,1,3
98745,3,1,345190,345190,345191,0,1,2
98746,1,1,345191,345191,345192,0,1,0
98747,5,3,345196,345196,345199,0,3,4
98748,3,2,345199,345199,345201,0,2,0
98749,6,3,345205,345205,345208,0,3,4
98750,6,2,345211,345211,345213,0,2,3
98751,2,1,345213,345213,345214,0,1,0
98752,4,1,345217,345217,345218,0,1,3
98753,2,3,345219,345219,345222,0,3,1
98754,5,2,345224,345224,345226,0,2,2
98755,5,2,345229,345229,345231,0,2,3
98756,6,2,345235,345235,345237,0,2,4
98757,1,2,345236,345237,345239,1,3,0
98758,2,1,345238,345239,345240,1,2,0
98759,2,1,345240,345240,345241,0,1,0
98760,5,1,345245,345245,345246,0,1,4
98761,3,1,345248,345248,345249,0,1,2
98762,2,3,345250,345250,345253,0,3,1
98763,1,1,345251,345253,345254,2,3,0
98764,3,1,345254,345254,345255,0,1,0
98765,1,2,345255,345255,345257,0,2,0
98766,5,3,345260,345260,345263,0,3,3
98767,3,2,345263,345263,345265,0,2,0
98768,1,3,345264,345265,345268,1,4,0
98769,4,2,345268,345268,345270,0,2,0
98770,3,2,345271,345271,345273,0,2,1
98771,6,2,345277,345277,345279,0,2,4
98772,5,1,345282,345282,345283,0,1,3
98773,4,3,345286,345286,345289,0,3,3
98774,3,1,345289,345289,345290,0,1,0
98775,5,1,345294,345294,345295,0,1,4
98776,2,1,345296,345296,345297,0,1,1
98777,3,3,345299,345299,345302,0,3,2
98778,2,2,345301,345302,345304,1,3,0
98779,3,2,345304,345304,345306,0,2,0
98780,6,1,345310,345310,345311,0,1,4
98781,1,2,345311,345311,345313,0,2,0
98782,6,3,345317,345317,345320,0,3,4
98783,1,1,345318,345320,345321,2,3,0
98784,2,1,345320,345321,345322,1,2,0
98785,1,3,345321,345322,345325,1,4,0
98786,4,1,345325,345325,345326,0,1,0
98787,2,2,345327,345327,345329,0,2,1
98788,5,2,345332,345332,345334,0,2,3
98789,3,3,345335,345335,345338,0,3,1
98790,1,1,345336,345338,345339,2,3,0
98791,6,3,345342,345342,345345,0,3,3
98792,6,1,345348,345348,345349,0,1,3
98793,1,1,345349,345349,345350,0,1,0
98794,1,2,345350,345350,345352,0,2,0
98795,4,1,345354,345354,345355,0,1,2
98796,5,2,345359,345359,345361,0,2,4
98797,3,2,345362,345362,345364,0,2,1
98798,3,1,345365,345365,345366,0,1,1
98799,6,2,345371,345371,345373,0,2,5
98800,3,2,345374,345374,345376,0,2,1
98801,1,2,345375,345376,345378,1,3,0
98802,1,3,345376,345378,345381,2,5,0
98803,3,3,345379,345381,345384,2,5,0
98804,1,2,345380,345384,345386,4,6,0
98805,4,3,345384,345386,345389,2,5,0
98806,2,2,345386,345389,345391,3,5,0
98807,2,3,345388,345391,345394,3,6,0
98808,6,3,345394,345394,345397,0,3,0
98809,1,1,345395,345397,345398,2,3,0
98810,5,2,345400,345400,345402,0,2,2
98811,5,1,345405,345405,345406,0,1,3
98812,2,2,345407,345407,345409,0,2,1
98813,4,1,345411,345411,345412,0,1,2
98814,3,3,345414,345414,345417,0,3,2
98815,6,1,345420,345420,345421,0,1,3
98816,6,2,345426,345426,345428,0,2,5
98817,3,3,345429,345429,345432,0,3,1
98818,3,2,345432,345432,345434,0,2,0
98819,5,1,345437,345437,345438,0,1,3
98820,6,1,345443,345443,345444,0,1,5
98821,6,2,345449,345449,345451,0,2,5
98822,2,2,345451,345451,345453,0,2,0
98823,6,1,345457,345457,345458,0,1,4
98824,3,2,345460,345460,345462,0,2,2
98825,1,2,345461,345462,345464,1,3,0
98826,3,2,345464,345464,345466,0,2,0
98827,1,1,345465,345466,345467,1,2,0
98828,3,1,345468,345468,345469,0,1,1
98829,5,2,345473,345473,345475,0,2,4
98830,3,2,345476,345476,345478,0,2,1
98831,3,2,345479,345479,345481,0,2,1
98832,5,1,345484,345484,345485,0,1,3
98833,4,2,345488,345488,345490,0,2,3
98834,6,3,345494,345494,345497,0,3,4
98835,6,3,345500,345500,345503,0,3,3
98836,2,3,345502,345503,345506,1,4,0
98837,5,3,345507,345507,345510,0,3,1
98838,1,2,345508,345510,345512,2,4,0
98839,2,1,345510,345512,345513,2,3,0
98840,1,2,345511,345513,345515,2,4,0
98841,6,2,345517,345517,345519,0,2,2
98842,4,2,345521,345521,345523,0,2,2
98843,3,1,345524,345524,345525,0,1,1
98844,3,2,345527,345527,345529,0,2,2
98845,1,2,345528,345529,345531,1,3,0
98846,2,1,345530,345531,345532,1,2,0
98847,2,1,345532,345532,345533,0,1,0
98848,2,3,345534,345534,345537,0,3,1
98849,6,3,345540,345540,345543,0,3,3
98850,5,3,345545,345545,345548,0,3,2
98851,2,2,345547,345548,345550,1,3,0
98852,6,1,345553,345553,345554,0,1,3
98853,1,3,345554,345554,345557,0,3,0
98854,2,2,345556,345557,345559,1,3,0
98855,2,2,345558,345559,345561,1,3,0
98856,1,3,345559,345561,345564,2,5,0
98857,2,2,345561,345564,345566,3,5,0
98858,5,1,345566,345566,345567,0,1,0
98859,1,3,345567,345567,345570,0,3,0
98860,5,3,345572,345572,345575,0,3,2
98861,3,1,345575,345575,345576,0,1,0
98862,4,1,345579,345579,345580,0,1,3
98863,5,2,345584,345584,345586,0,2,4
98864,3,3,345587,345587,345590,0,3,1
98865,4,1,345591,345591,345592,0,1,1
98866,6,3,345597,345597,345600,0,3,5
98867,6,3,345603,345603,345606,0,3,3
98868,2,3,345605,345606,345609,1,4,0
98869,1,2,345606,345609,345611,3,5,0
98870,3,3,345609,345611,345614,2,5,0
98871,3,1,345612,345614,345615,2,3,0
98872,2,2,345614,345615,345617,1,3,0
98873,3,2,345617,345617,345619,0,2,0
98874,3,2,345620,345620,345622,0,2,1
98875,6,1,345626,345626,345627,0,1,4
98876,3,2,345629,345629,345631,0,2,2
98877,5,1,345634,345634,345635,0,1,3
98878,5,2,345639,345639,345641,0,2,4
98879,1,2,345640,345641,345643,1,3,0
98880,6,2,345646,345646,345648,0,2,3
98881,1,2,345647,345648,345650,1,3,0
98882,2,2,345649,345650,345652,1,3,0
98883,3,2,345652,345652,345654,0,2,0
98884,5,3,345657,345657,345660,0,3,3
98885,3,3,345660,345660,345663,0,3,0
98886,6,2,345666,345666,345668,0,2,3
98887,4,2,345670,345670,345672,0,2,2
98888,6,1,345676,345676,345677,0,1,4
98889,3,2,345679,345679,345681,0,2,2
98890,4,2,345683,345683,345685,0,2,2
98891,4,2,345687,345687,345689,0,2,2
98892,6,3,345693,345693,345696,0,3,4
98893,3,2,345696,345696,345698,0,2,0
98894,6,2,345702,345702,345704,0,2,4
98895,1,2,345703,345704,345706,1,3,0
98896,2,1,345705,345706,345707,1,2,0
98897,4,3,345709,345709,345712,0,3,2
98898,4,2,345713,345713,345715,0,2,1
98899,1,3,345714,345715,345718,1,4,0
98900,3,1,345717,345718,345719,1,2,0
98901,4,1,345721,345721,345722,0,1,2
98902,1,3,345722,345722,345725,0,3,0
98903,3,3,345725,345725,345728,0,3,0
98904,4,1,345729,345729,345730,0,1,1
98905,4,3,345733,345733,345736,0,3,3
98906,2,2,345735,345736,345738,1,3,0
98907,1,1,345736,345738,345739,2,3,0
98908,3,3,345739,345739,345742,0,3,0
98909,6,1,345745,345745,345746,0,1,3
98910,3,1,345748,345748,345749,0,1,2
98911,5,1,345753,345753,345754,0,1,4
98912,2,1,345755,345755,345756,0,1,1
98913,1,2,345756,345756,345758,0,2,0
98914,2,1,345758,345758,345759,0,1,0
98915,5,3,345763,345763,345766,0,3,4
98916,1,2,345764,345766,345768,2,4,0
98917,3,1,345767,345768,345769,1,2,0
98918,5,1,345772,345772,345773,0,1,3
98919,2,1,345774,345774,345775,0,1,1
98920,5,2,345779,345779,345781,0,2,4
98921,2,2,345781,345781,345783,0,2,0
98922,5,3,345786,345786,345789,0,3,3
98923,5,1,345791,345791,345792,0,1,2
98924,5,2,345796,345796,345798,0,2,4
98925,2,2,345798,345798,345800,0,2,0
98926,5,2,345803,345803,345805,0,2,3
98927,2,1,345805,345805,345806,0,1,0
98928,5,3,345810,345810,345813,0,3,4
98929,6,2,345816,345816,345818,0,2,3
98930,3,3,345819,345819,345822,0,3,1
98931,2,3,345821,345822,345825,1,4,0
98932,1,3,345822,345825,345828,3,6,0
98933,2,1,345824,345828,345829,4,5,0
98934,5,3,345829,345829,345832,0,3,0
98935,1,2,345830,345832,345834,2,4,0
98936,3,3,345833,345834,345837,1,4,0
98937,6,2,345839,345839,345841,0,2,2
98938,5,1,345844,345844,345845,0,1,3
98939,6,2,345850,345850,345852,0,2,5
98940,4,3,345854,345854,345857,0,3,2
98941,6,1,345860,345860,345861,0,1,3
98942,4,1,345864,345864,345865,0,1,3
98943,2,1,345866,345866,345867,0,1,1
98944,5,2,345871,345871,345873,0,2,4
98945,5,3,345876,345876,345879,0,3,3
98946,5,2,345881,345881,345883,0,2,2
98947,2,1,345883,345883,345884,0,1,0
98948,2,1,345885,345885,345886,0,1,1
98949,4,3,345889,345889,345892,0,3,3
98950,3,2,345892,345892,345894,0,2,0
98951,4,1,345896,345896,345897,0,1,2
98952,2,3,345898,345898,345901,0,3,1
98953,5,1,345903,345903,345904,0,1,2
98954,6,3,345909,345909,345912,0,3,5
98955,4,1,345913,345913,345914,0,1,1
98956,5,2,345918,345918,345920,0,2,4
98957,3,3,345921,345921,345924,0,3,1
98958,3,2,345924,345924,345926,0,2,0
98959,1,1,345925,345926,345927,1,2,0
98960,5,1,345930,345930,345931,0,1,3
98961,3,1,345933,345933,345934,0,1,2
98962,3,1,345936,345936,345937,0,1,2
98963,5,3,345941,345941,345944,0,3,4
98964,5,2,345946,345946,345948,0,2,2
98965,3,3,345949,345949,345952,0,3,1
98966,4,3,345953,345953,345956,0,3,1
98967,3,3,345956,345956,345959,0,3,0
98968,1,1,345957,345959,345960,2,3,0
98969,3,2,345960,345960,345962,0,2,0
98970,4,2,345964,345964,345966,0,2,2
98971,3,2,345967,345967,345969,0,2,1
98972,4,1,345971,345971,345972,0,1,2
98973,1,2,345972,345972,345974,0,2,0
98974,5,3,345977,345977,345980,0,3,3
98975,3,2,345980,345980,345982,0,2,0
98976,5,2,345985,345985,345987,0,2,3
98977,3,3,345988,345988,345991,0,3,1
98978,4,1,345992,345992,345993,0,1,1
98979,3,2,345995,345995,345997,0,2,2
98980,4,2,345999,345999,346001,0,2,2
98981,2,3,346001,346001,346004,0,3,0
98982,2,1,346003,346004,346005,1,2,0
98983,6,1,346009,346009,346010,0,1,4
98984,6,1,346015,346015,346016,0,1,5
98985,4,1,346019,346019,346020,0,1,3
98986,1,1,346020,346020,346021,0,1,0
98987,3,3,346023,346023,346026,0,3,2
98988,5,3,346028,346028,346031,0,3,2
98989,1,1,346029,346031,346032,2,3,0
98990,2,3,346031,346032,346035,1,4,0
98991,3,2,346034,346035,346037,1,3,0
98992,1,3,346035,346037,346040,2,5,0
98993,1,3,346036,346040,346043,4,7,0
98994,6,2,346042,346043,346045,1,3,0
98995,6,3,346048,346048,346051,0,3,3
98996,6,3,346054,346054,346057,0,3,3
98997,6,1,346060,346060,346061,0,1,3
98998,2,2,346062,346062,346064,0,2,1
98999,6,3,346068,346068,346071,0,3,4
99000,6,3,346074,346074,346077,0,3,3
99001,4,3,346078,346078,346081,0,3,1
99002,5,3,346083,346083,346086,0,3,2
99003,1,1,346084,346086,346087,2,3,0
99004,1,3,346085,346087,346090,2,5,0
99005,2,3,346087,346090,346093,3,6,0
99006,2,3,346089,346093,346096,4,7,0
99007,4,3,346093,346096,346099,3,6,0
99008,3,2,346096,346099,346101,3,5,0
99009,4,1,346100,346101,346102,1,2,0
99010,6,1,346106,346106,346107,0,1,4
99011,4,1,346110,346110,346111,0,1,3
99012,1,1,346111,346111,346112,0,1,0
99013,1,2,346112,346112,346114,0,2,0
99014,3,2,346115,346115,346117,0,2,1
99015,6,1,346121,346121,346122,0,1,4
99016,5,3,346126,346126,346129,0,3,4
99017,5,3,346131,346131,346134,0,3,2
99018,5,2,346136,346136,346138,0,2,2
99019,5,1,346141,346141,346142,0,1,3
99020,4,1,346145,346145,346146,0,1,3
99021,6,1,346151,346151,346152,0,1,5
99022,6,3,346157,346157,346160,0,3,5
99023,1,1,346158,346160,346161,2,3,0
99024,2,2,346160,346161,346163,1,3,0
99025,1,3,346161,346163,346166,2,5,0
99026,1,1,346162,346166,346167,4,5,0
99027,1,3,346163,346167,346170,4,7,0
99028,4,1,346167,346170,346171,3,4,0
99029,3,3,346170,346171,346174,1,4,0
99030,3,2,346173,346174,346176,1,3,0
99031,5,2,346178,346178,346180,0,2,2
99032,2,2,346180,346180,346182,0,2,0
99033,5,3,346185,346185,346188,0,3,3
99034,1,1,346186,346188,346189,2,3,0
99035,2,3,346188,346189,346192,1,4,0
99036,2,1,346190,346192,346193,2,3,0
99037,1,3,346191,346193,346196,2,5,0
99038,4,2,346195,346196,346198,1,3,0
99039,2,2,346197,346198,346200,1,3,0
99040,3,2,346200,346200,346202,0,2,0
99041,4,3,346204,346204,346207,0,3,2
99042,6,1,346210,346210,346211,0,1,3
99043,2,3,346212,346212,346215,0,3,1
99044,1,3,346213,346215,346218,2,5,0
99045,1,2,346214,346218,346220,4,6,0
99046,1,2,346215,346220,346222,5,7,0
99047,5,2,346220,346222,346224,2,4,0
99048,5,2,346225,346225,346227,0,2,1
99049,2,2,346227,346227,346229,0,2,0
99050,1,1,346228,346229,346230,1,2,0
99051,4,3,346232,346232,346235,0,3,2
99052,1,1,346233,346235,346236,2,3,0
99053,2,1,346235,346236,346237,1,2,0
99054,4,2,346239,346239,346241,0,2,2
99055,2,2,346241,346241,346243,0,2,0
99056,5,2,346246,346246,346248,0,2,3
99057,5,1,346251,346251,346252,0,1,3
99058,3,2,346254,346254,346256,0,2,2
99059,6,1,346260,346260,346261,0,1,4
99060,6,3,346266,346266,346269,0,3,5
99061,2,1,346268,346269,346270,1,2,0
99062,1,2,346269,346270,346272,1,3,0
99063,1,2,346270,346272,346274,2,4,0
99064,2,3,346272,346274,346277,2,5,0
99065,3,1,346275,346277,346278,2,3,0
99066,1,2,346276,346278,346280,2,4,0
99067,1,3,346277,346280,346283,3,6,0
99068,3,1,346280,346283,346284,3,4,0
99069,6,2,346286,346286,346288,0,2,2
99070,3,1,346289,346289,346290,0,1,1
99071,5,3,346294,346294,346297,0,3,4
99072,5,2,346299,346299,346301,0,2,2
99073,1,2,346300,346301,346303,1,3,0
99074,5,2,346305,346305,346307,0,2,2
99075,6,2,346311,346311,346313,0,2,4
99076,4,2,346315,346315,346317,0,2,2
99077,1,1,346316,346317,346318,1,2,0
99078,5,3,346321,346321,346324,0,3,3
99079,6,2,346327,346327,346329,0,2,3
99080,6,2,346333,346333,346335,0,2,4
99081,3,3,346336,346336,346339,0,3,1
99082,2,1,346338,346339,346340,1,2,0
99083,1,3,346339,346340,346343,1,4,0
99084,5,1,346344,346344,346345,0,1,1
99085,5,2,346349,346349,346351,0,2,4
99086,6,1,346355,346355,346356,0,1,4
99087,3,1,346358,346358,346359,0,1,2
99088,5,1,346363,346363,346364,0,1,4
99089,5,3,346368,346368,346371,0,3,4
99090,1,3,346369,346371,346374,2,5,0
99091,2,1,346371,346374,346375,3,4,0
99092,3,2,346374,346375,346377,1,3,0
99093,4,3,346378,346378,346381,0,3,1
99094,4,1,346382,346382,346383,0,1,1
99095,3,3,346385,346385,346388,0,3,2
99096,5,3,346390,346390,346393,0,3,2
99097,5,1,346395,346395,346396,0,1,2
99098,3,3,346398,346398,346401,0,3,2
99099,1,1,346399,346401,346402,2,3,0
99100,5,1,346404,346404,346405,0,1,2
99101,6,1,346410,346410,346411,0,1,5
99102,2,2,346412,346412,346414,0,2,1
99103,1,3,346413,346414,346417,1,4,0
99104,3,2,346416,346417,346419,1,3,0
99105,5,2,346421,346421,346423,0,2,2
99106,1,3,346422,346423,346426,1,4,0
99107,5,2,346427,346427,346429,0,2,1
99108,6,1,346433,346433,346434,0,1,4
99109,6,2,346439,346439,346441,0,2,5
99110,4,2,346443,346443,346445,0,2,2
99111,4,3,346447,346447,346450,0,3,2
99112,3,3,346450,346450,346453,0,3,0
99113,6,3,346456,346456,346459,0,3,3
99114,1,1,346457,346459,346460,2,3,0
99115,2,2,346459,346460,346462,1,3,0
99116,1,3,346460,346462,346465,2,5,0
99117,3,3,346463,346465,346468,2,5,0
99118,2,2,346465,346468,346470,3,5,0
99119,6,1,346471,346471,346472,0,1,1
99120,3,2,346474,346474,346476,0,2,2
99121,4,3,346478,346478,346481,0,3,2
99122,6,1,346484,346484,346485,0,1,3
99123,6,1,346490,346490,346491,0,1,5
99124,4,2,346494,346494,346496,0,2,3
99125,4,3,346498,346498,346501,0,3,2
99126,1,2,346499,346501,346503,2,4,0
99127,3,3,346502,346503,346506,1,4,0
99128,2,2,346504,346506,346508,2,4,0
99129,3,1,346507,346508,346509,1,2,0
99130,5,2,346512,346512,346514,0,2,3
99131,2,1,346514,346514,346515,0,1,0
99132,3,3,346517,346517,346520,0,3,2
99133,6,2,346523,346523,346525,0,2,3
99134,5,2,346528,346528,346530,0,2,3
99135,4,2,346532,346532,346534,0,2,2
99136,2,2,346534,346534,346536,0,2,0
99137,4,1,346538,346538,346539,0,1,2
99138,6,1,346544,346544,346545,0,1,5
99139,1,2,346545,346545,346547,0,2,0
99140,4,2,346549,346549,346551,0,2,2
99141,5,2,346554,346554,346556,0,2,3
99142,5,3,346559,346559,346562,0,3,3
99143,4,1,346563,346563,346564,0,1,1
99144,2,1,346565,346565,346566,0,1,1
99145,2,3,346567,346567,346570,0,3,1
99146,3,1,346570,346570,346571,0,1,0
99147,5,3,346575,346575,346578,0,3,4
99148,1,2,346576,346578,346580,2,4,0
99149,6,3,346582,346582,346585,0,3,2
99150,6,1,346588,346588,346589,0,1,3
99151,3,2,346591,346591,346593,0,2,2
99152,3,2,346594,346594,346596,0,2,1
99153,4,2,346598,346598,346600,0,2,2
99154,2,2,346600,346600,346602,0,2,0
99155,5,2,346605,346605,346607,0,2,3
99156,2,3,346607,346607,346610,0,3,0
99157,6,3,346613,346613,346616,0,3,3
99158,4,1,346617,346617,346618,0,1,1
99159,1,3,346618,346618,346621,0,3,0
99160,4,2,346622,346622,346624,0,2,1
99161,3,2,346625,346625,346627,0,2,1
99162,4,3,346629,346629,346632,0,3,2
99163,2,1,346631,346632,346633,1,2,0
99164,6,1,346637,346637,346638,0,1,4
99165,4,3,346641,346641,346644,0,3,3
99166,5,2,346646,346646,346648,0,2,2
99167,2,2,346648,346648,346650,0,2,0
99168,3,1,346651,346651,346652,0,1,1
99169,4,3,346655,346655,346658,0,3,3
99170,2,2,346657,346658,346660,1,3,0
99171,2,3,346659,346660,346663,1,4,0
99172,1,2,346660,346663,346665,3,5,0
99173,4,1,346664,346665,346666,1,2,0
99174,1,2,346665,346666,346668,1,3,0
99175,1,3,346666,346668,346671,2,5,0
99176,4,2,346670,346671,346673,1,3,0
99177,4,2,346674,346674,346676,0,2,1
99178,2,1,346676,346676,346677,0,1,0
99179,1,2,346677,346677,346679,0,2,0
99180,4,2,346681,346681,346683,0,2,2
99181,3,3,346684,346684,346687,0,3,1
99182,2,1,346686,346687,346688,1,2,0
99183,5,2,346691,346691,346693,0,2,3
99184,1,2,346692,346693,346695,1,3,0
99185,4,2,346696,346696,346698,0,2,1
99186,6,2,346702,346702,346704,0,2,4
99187,2,3,346704,346704,346707,0,3,0
99188,3,1,346707,346707,346708,0,1,0
99189,5,1,346712,346712,346713,0,1,4
99190,2,2,346714,346714,346716,0,2,1
99191,2,1,346716,346716,346717,0,1,0
99192,3,2,346719,346719,346721,0,2,2
99193,4,3,346723,346723,346726,0,3,2
99194,4,3,346727,346727,346730,0,3,1
99195,5,2,346732,346732,346734,0,2,2
99196,4,3,346736,346736,346739,0,3,2
99197,2,2,346738,346739,346741,1,3,0
99198,4,2,346742,346742,346744,0,2,1
99199,5,2,346747,346747,346749,0,2,3
99200,2,3,346749,346749,346752,0,3,0
99201,5,3,346754,346754,346757,0,3,2
99202,6,3,346760,346760,346763,0,3,3
99203,1,2,346761,346763,346765,2,4,0
99204,2,1,346763,346765,346766,2,3,0
99205,5,1,346768,346768,346769,0,1,2
99206,1,3,346769,346769,346772,0,3,0
99207,6,3,346775,346775,346778,0,3,3
99208,4,3,346779,346779,346782,0,3,1
99209,3,3,346782,346782,346785,0,3,0
99210,2,1,346784,346785,346786,1,2,0
99211,5,3,346789,346789,346792,0,3,3
99212,2,3,346791,346792,346795,1,4,0
99213,6,3,346797,346797,346800,0,3,2
99214,1,1,346798,346800,346801,2,3,0
99215,6,1,346804,346804,346805,0,1,3
99216,2,3,346806,346806,346809,0,3,1
99217,2,3,346808,346809,346812,1,4,0
99218,2,2,346810,346812,346814,2,4,0
99219,5,1,346815,346815,346816,0,1,1
99220,2,3,346817,346817,346820,0,3,1
99221,1,2,346818,346820,346822,2,4,0
99222,1,3,346819,346822,346825,3,6,0
99223,5,3,346824,346825,346828,1,4,0
99224,4,3,346828,346828,346831,0,3,0
99225,6,3,346834,346834,346837,0,3,3
99226,6,1,346840,346840,346841,0,1,3
99227,1,1,346841,346841,346842,0,1,0
99228,3,1,346844,346844,346845,0,1,2
99229,6,2,346850,346850,346852,0,2,5
99230,4,3,346854,346854,346857,0,3,2
99231,5,1,346859,346859,346860,0,1,2
99232,3,3,346862,346862,346865,0,3,2
99233,1,3,346863,346865,346868,2,5,0
99234,1,1,346864,346868,346869,4,5,0
99235,4,2,346868,346869,346871,1,3,0
99236,2,2,346870,346871,346873,1,3,0
99237,6,2,346876,346876,346878,0,2,3
99238,4,1,346880,346880,346881,0,1,2
99239,1,1,346881,346881,346882,0,1,0
99240,1,2,346882,346882,346884,0,2,0
99241,6,1,346888,346888,346889,0,1,4
99242,6,2,346894,346894,346896,0,2,5
99243,1,2,346895,346896,346898,1,3,0
99244,6,2,346901,346901,346903,0,2,3
99245,1,2,346902,346903,346905,1,3,0
99246,4,1,346906,346906,346907,0,1,1
99247,1,1,346907,346907,346908,0,1,0
99248,2,3,346909,346909,346912,0,3,1
99249,1,1,346910,346912,346913,2,3,0
99250,4,2,346914,346914,346916,0,2,1
99251,5,3,346919,346919,346922,0,3,3
99252,2,3,346921,346922,346925,1,4,0
99253,3,3,346924,346925,346928,1,4,0
99254,5,2,346929,346929,346931,0,2,1
99255,2,3,346931,346931,346934,0,3,0
99256,4,3,346935,346935,346938,0,3,1
99257,6,3,346941,346941,346944,0,3,3
99258,6,3,346947,346947,346950,0,3,3
99259,4,2,346951,346951,346953,0,2,1
99260,2,3,346953,346953,346956,0,3,0
99261,6,1,346959,346959,346960,0,1,3
99262,6,1,346965,346965,346966,0,1,5
99263,4,2,346969,346969,346971,0,2,3
99264,3,2,346972,346972,346974,0,2,1
99265,2,3,346974,346974,346977,0,3,0
99266,5,1,346979,346979,346980,0,1,2
99267,1,2,346980,346980,346982,0,2,0
99268,1,2,346981,346982,346984,1,3,0
99269,4,2,346985,346985,346987,0,2,1
99270,1,2,346986,346987,346989,1,3,0
99271,5,1,346991,346991,346992,0,1,2
99272,5,2,346996,346996,346998,0,2,4
99273,1,1,346997,346998,346999,1,2,0
99274,2,2,346999,346999,347001,0,2,0
99275,4,2,347003,347003,347005,0,2,2
99276,2,1,347005,347005,347006,0,1,0
99277,3,2,347008,347008,347010,0,2,2
99278,6,3,347014,347014,347017,0,3,4
99279,6,1,347020,347020,347021,0,1,3
99280,4,2,347024,347024,347026,0,2,3
99281,4,3,347028,347028,347031,0,3,2
99282,6,3,347034,347034,347037,0,3,3
99283,5,2,347039,347039,347041,0,2,2
99284,1,2,347040,347041,347043,1,3,0
99285,1,3,347041,347043,347046,2,5,0
99286,5,1,347046,347046,347047,0,1,0
99287,3,2,347049,347049,347051,0,2,2
99288,3,1,347052,347052,347053,0,1,1
99289,4,3,347056,347056,347059,0,3,3
99290,5,1,347061,347061,347062,0,1,2
99291,5,3,347066,347066,347069,0,3,4
99292,6,2,347072,347072,347074,0,2,3
99293,5,2,347077,347077,347079,0,2,3
99294,4,2,347081,347081,347083,0,2,2
99295,4,3,347085,347085,347088,0,3,2
99296,6,1,347091,347091,347092,0,1,3
99297,3,1,347094,347094,347095,0,1,2
99298,2,2,347096,347096,347098,0,2,1
99299,5,1,347101,347101,347102,0,1,3
99300,5,1,347106,347106,347107,0,1,4
99301,2,3,347108,347108,347111,0,3,1
99302,2,1,347110,347111,347112,1,2,0
99303,2,3,347112,347112,347115,0,3,0
99304,1,2,347113,347115,347117,2,4,0
99305,3,2,347116,347117,347119,1,3,0
99306,6,2,347122,347122,347124,0,2,3
99307,1,2,347123,347124,347126,1,3,0
99308,5,2,347128,347128,347130,0,2,2
99309,6,2,347134,347134,347136,0,2,4
99310,5,1,347139,347139,347140,0,1,3
99311,3,3,347142,347142,347145,0,3,2
99312,4,1,347146,347146,347147,0,1,1
99313,5,3,347151,347151,347154,0,3,4
99314,6,1,347157,347157,347158,0,1,3
99315,3,1,347160,347160,347161,0,1,2
99316,2,1,347162,347162,347163,0,1,1
99317,5,1,347167,347167,347168,0,1,4
99318,6,2,347173,347173,347175,0,2,5
99319,5,2,347178,347178,347180,0,2,3
99320,2,3,347180,347180,347183,0,3,0
99321,6,3,347186,347186,347189,0,3,3
99322,6,2,347192,347192,347194,0,2,3
99323,2,2,347194,347194,347196,0,2,0
99324,3,3,347197,347197,347200,0,3,1
99325,1,1,347198,347200,347201,2,3,0
99326,2,3,347200,347201,347204,1,4,0
99327,5,3,347205,347205,347208,0,3,1
99328,1,1,347206,347208,347209,2,3,0
99329,2,1,347208,347209,347210,1,2,0
99330,6,1,347214,347214,347215,0,1,4
99331,6,2,347220,347220,347222,0,2,5
99332,3,1,347223,347223,347224,0,1,1
99333,1,1,347224,347224,347225,0,1,0
99334,2,2,347226,347226,347228,0,2,1
99335,3,1,347229,347229,347230,0,1,1
99336,4,2,347233,347233,347235,0,2,3
99337,2,1,347235,347235,347236,0,1,0
99338,4,2,347239,347239,347241,0,2,3
99339,1,1,347240,347241,347242,1,2,0
99340,5,3,347245,347245,347248,0,3,3
99341,6,2,347251,347251,347253,0,2,3
99342,1,2,347252,347253,347255,1,3,0
99343,5,2,347257,347257,347259,0,2,2
99344,5,3,347262,347262,347265,0,3,3
99345,2,2,347264,347265,347267,1,3,0
99346,5,2,347269,347269,347271,0,2,2
99347,6,1,347275,347275,347276,0,1,4
99348,5,1,347280,347280,347281,0,1,4
99349,2,2,347282,347282,347284,0,2,1
99350,5,2,347287,347287,347289,0,2,3
99351,1,1,347288,347289,347290,1,2,0
99352,5,2,347293,347293,347295,0,2,3
99353,5,2,347298,347298,347300,0,2,3
99354,3,2,347301,347301,347303,0,2,1
99355,6,1,347307,347307,347308,0,1,4
99356,1,1,347308,347308,347309,0,1,0
99357,4,1,347312,347312,347313,0,1,3
99358,3,3,347315,347315,347318,0,3,2
99359,4,3,347319,347319,347322,0,3,1
99360,5,2,347324,347324,347326,0,2,2
99361,4,1,347328,347328,347329,0,1,2
99362,5,2,347333,347333,347335,0,2,4
99363,5,1,347338,347338,347339,0,1,3
99364,5,2,347343,347343,347345,0,2,4
99365,1,3,347344,347345,347348,1,4,0
99366,1,3,347345,347348,347351,3,6,0
99367,3,2,347348,347351,347353,3,5,0
99368,3,1,347351,347353,347354,2,3,0
99369,2,3,347353,347354,347357,1,4,0
99370,5,3,347358,347358,347361,0,3,1
99371,4,3,347362,347362,347365,0,3,1
99372,6,1,347368,347368,347369,0,1,3
99373,2,2,347370,347370,347372,0,2,1
99374,3,3,347373,347373,347376,0,3,1
99375,3,2,347376,347376,347378,0,2,0
99376,4,3,347380,347380,347383,0,3,2
99377,6,1,347386,347386,347387,0,1,3
99378,5,1,347391,347391,347392,0,1,4
99379,3,1,347394,347394,347395,0,1,2
99380,1,3,347395,347395,347398,0,3,0
99381,3,3,347398,347398,347401,0,3,0
99382,5,1,347403,347403,347404,0,1,2
99383,6,1,347409,347409,347410,0,1,5
99384,1,2,347410,347410,347412,0,2,0
99385,1,1,347411,347412,347413,1,2,0
99386,3,3,347414,347414,347417,0,3,1
99387,3,1,347417,347417,347418,0,1,0
99388,2,3,347419,347419,347422,0,3,1
99389,4,1,347423,347423,347424,0,1,1
99390,2,3,347425,347425,347428,0,3,1
99391,4,3,347429,347429,347432,0,3,1
99392,3,1,347432,347432,347433,0,1,0
99393,5,2,347437,347437,347439,0,2,4
99394,1,3,347438,347439,347442,1,4,0
99395,2,2,347440,347442,347444,2,4,0
99396,5,1,347445,347445,347446,0,1,1
99397,4,3,347449,347449,347452,0,3,3
99398,5,1,347454,347454,347455,0,1,2
99399,4,2,347458,347458,347460,0,2,3
99400,3,1,347461,347461,347462,0,1,1
99401,1,2,347462,347462,347464,0,2,0
99402,2,2,347464,347464,347466,0,2,0
99403,5,1,347469,347469,347470,0,1,3
99404,1,1,347470,347470,347471,0,1,0
99405,6,3,347476,347476,347479,0,3,5
99406,6,3,347482,347482,347485,0,3,3
99407,1,3,347483,347485,347488,2,5,0
99408,3,2,347486,347488,347490,2,4,0
99409,2,1,347488,347490,347491,2,3,0
99410,5,1,347493,347493,347494,0,1,2
99411,5,1,347498,347498,347499,0,1,4
99412,6,3,347504,347504,347507,0,3,5
99413,2,2,347506,347507,347509,1,3,0
99414,6,3,347512,347512,347515,0,3,3
99415,4,1,347516,347516,347517,0,1,1
99416,6,3,347522,347522,347525,0,3,5
99417,2,3,347524,347525,347528,1,4,0
99418,3,3,347527,347528,347531,1,4,0
99419,6,3,347533,347533,347536,0,3,2
99420,1,2,347534,347536,347538,2,4,0
99421,1,3,347535,347538,347541,3,6,0
99422,5,2,347540,347541,347543,1,3,0
99423,1,3,347541,347543,347546,2,5,0
99424,1,2,347542,347546,347548,4,6,0
99425,2,3,347544,347548,347551,4,7,0
99426,2,1,347546,347551,347552,5,6,0
99427,5,2,347551,347552,347554,1,3,0
99428,5,2,347556,347556,347558,0,2,2
99429,6,3,347562,347562,347565,0,3,4
99430,5,3,347567,347567,347570,0,3,2
99431,5,2,347572,347572,347574,0,2,2
99432,6,1,347578,347578,347579,0,1,4
99433,2,1,347580,347580,347581,0,1,1
99434,6,2,347586,347586,347588,0,2,5
99435,2,1,347588,347588,347589,0,1,0
99436,4,2,347592,347592,347594,0,2,3
99437,6,2,347598,347598,347600,0,2,4
99438,2,2,347600,347600,347602,0,2,0
99439,1,3,347601,347602,347605,1,4,0
99440,3,2,347604,347605,347607,1,3,0
99441,2,2,347606,347607,347609,1,3,0
99442,1,3,347607,347609,347612,2,5,0
99443,1,3,347608,347612,347615,4,7,0
99444,6,1,347614,347615,347616,1,2,0
99445,1,1,347615,347616,347617,1,2,0
99446,3,1,347618,347618,347619,0,1,1
99447,1,3,347619,347619,347622,0,3,0
99448,1,3,347620,347622,347625,2,5,0
99449,4,1,347624,347625,347626,1,2,0
99450,6,2,347630,347630,347632,0,2,4
99451,2,2,347632,347632,347634,0,2,0
99452,4,3,347636,347636,347639,0,3,2
99453,5,1,347641,347641,347642,0,1,2
99454,4,3,347645,347645,347648,0,3,3
99455,4,1,347649,347649,347650,0,1,1
99456,1,3,347650,347650,347653,0,3,0
99457,5,2,347655,347655,347657,0,2,2
99458,3,3,347658,347658,347661,0,3,1
99459,1,3,347659,347661,347664,2,5,0
99460,2,3,347661,347664,347667,3,6,0
99461,3,3,347664,347667,347670,3,6,0
99462,6,3,347670,347670,347673,0,3,0
99463,4,3,347674,347674,347677,0,3,1
99464,1,1,347675,347677,347678,2,3,0
99465,3,2,347678,347678,347680,0,2,0
99466,5,2,347683,347683,347685,0,2,3
99467,4,1,347687,347687,347688,0,1,2
99468,5,2,347692,347692,347694,0,2,4
99469,2,1,347694,347694,347695,0,1,0
99470,2,1,347696,347696,347697,0,1,1
99471,6,2,347702,347702,347704,0,2,5
99472,3,2,347705,347705,347707,0,2,1
99473,3,2,347708,347708,347710,0,2,1
99474,1,1,347709,347710,347711,1,2,0
99475,3,2,347712,347712,347714,0,2,1
99476,2,3,347714,347714,347717,0,3,0
99477,1,2,347715,347717,347719,2,4,0
99478,3,3,347718,347719,347722,1,4,0
99479,6,3,347724,347724,347727,0,3,2
99480,3,2,347727,347727,347729,0,2,0
99481,6,3,347733,347733,347736,0,3,4
99482,4,2,347737,347737,347739,0,2,1
99483,3,3,347740,347740,347743,0,3,1
99484,3,2,347743,347743,347745,0,2,0
99485,6,2,347749,347749,347751,0,2,4
99486,2,2,347751,347751,347753,0,2,0
99487,6,3,347757,347757,347760,0,3,4
99488,2,2,347759,347760,347762,1,3,0
99489,5,1,347764,347764,347765,0,1,2
99490,4,3,347768,347768,347771,0,3,3
99491,3,1,347771,347771,347772,0,1,0
99492,5,2,347776,347776,347778,0,2,4
99493,2,1,347778,347778,347779,0,1,0
99494,1,2,347779,347779,347781,0,2,0
99495,3,1,347782,347782,347783,0,1,1
99496,1,3,347783,347783,347786,0,3,0
99497,2,3,347785,347786,347789,1,4,0
99498,5,2,347790,347790,347792,0,2,1
99499,4,3,347794,347794,347797,0,3,2
99500,5,1,347799,347799,347800,0,1,2
99501,2,1,347801,347801,347802,0,1,1
99502,5,2,347806,347806,347808,0,2,4
99503,2,2,347808,347808,347810,0,2,0
99504,2,1,347810,347810,347811,0,1,0
99505,5,3,347815,347815,347818,0,3,4
99506,5,3,347820,347820,347823,0,3,2
99507,6,2,347826,347826,347828,0,2,3
99508,5,1,347831,347831,347832,0,1,3
99509,1,1,347832,347832,347833,0,1,0
99510,1,1,347833,347833,347834,0,1,0
99511,1,1,347834,347834,347835,0,1,0
99512,2,2,347836,347836,347838,0,2,1
99513,5,3,347841,347841,347844,0,3,3
99514,1,2,347842,347844,347846,2,4,0
99515,3,2,347845,347846,347848,1,3,0
99516,2,1,347847,347848,347849,1,2,0
99517,2,3,347849,347849,347852,0,3,0
99518,2,3,347851,347852,347855,1,4,0
99519,5,2,347856,347856,347858,0,2,1
99520,2,3,347858,347858,347861,0,3,0
99521,1,1,347859,347861,347862,2,3,0
99522,5,1,347864,347864,347865,0,1,2
99523,1,2,347865,347865,347867,0,2,0
99524,1,3,347866,347867,347870,1,4,0
99525,6,3,347872,347872,347875,0,3,2
99526,6,3,347878,347878,347881,0,3,3
99527,1,1,347879,347881,347882,2,3,0
99528,1,2,347880,347882,347884,2,4,0
99529,5,2,347885,347885,347887,0,2,1
99530,2,2,347887,347887,347889,0,2,0
99531,5,3,347892,347892,347895,0,3,3
99532,6,3,347898,347898,347901,0,3,3
99533,2,2,347900,347901,347903,1,3,0
99534,4,1,347904,347904,347905,0,1,1
99535,2,2,347906,347906,347908,0,2,1
99536,4,2,347910,347910,347912,0,2,2
99537,1,1,347911,347912,347913,1,2,0
99538,2,3,347913,347913,347916,0,3,0
99539,4,1,347917,347917,347918,0,1,1
99540,4,3,347921,347921,347924,0,3,3
99541,5,2,347926,347926,347928,0,2,2
99542,2,3,347928,347928,347931,0,3,0
99543,4,1,347932,347932,347933,0,1,1
99544,1,1,347933,347933,347934,0,1,0
99545,3,2,347936,347936,347938,0,2,2
99546,6,2,347942,347942,347944,0,2,4
99547,5,1,347947,347947,347948,0,1,3
99548,1,3,347948,347948,347951,0,3,0
99549,1,3,347949,347951,347954,2,5,0
99550,6,2,347955,347955,347957,0,2,1
99551,4,1,347959,347959,347960,0,1,2
99552,1,2,347960,347960,347962,0,2,0
99553,2,1,347962,347962,347963,0,1,0
99554,3,3,347965,347965,347968,0,3,2
99555,4,3,347969,347969,347972,0,3,1
99556,3,2,347972,347972,347974,0,2,0
99557,4,1,347976,347976,347977,0,1,2
99558,5,2,347981,347981,347983,0,2,4
99559,5,3,347986,347986,347989,0,3,3
99560,6,3,347992,347992,347995,0,3,3
99561,4,3,347996,347996,347999,0,3,1
99562,3,2,347999,347999,348001,0,2,0
99563,3,3,348002,348002,348005,0,3,1
99564,2,1,348004,348005,348006,1,2,0
99565,4,2,348008,348008,348010,0,2,2
99566,5,3,348013,348013,348016,0,3,3
99567,4,2,348017,348017,348019,0,2,1
99568,1,2,348018,348019,348021,1,3,0
99569,3,1,348021,348021,348022,0,1,0
99570,3,2,348024,348024,348026,0,2,2
99571,4,2,348028,348028,348030,0,2,2
99572,1,3,348029,348030,348033,1,4,0
99573,6,1,348035,348035,348036,0,1,2
99574,4,2,348039,348039,348041,0,2,3
99575,6,3,348045,348045,348048,0,3,4
99576,4,3,348049,348049,348052,0,3,1
99577,3,3,348052,348052,348055,0,3,0
99578,5,3,348057,348057,348060,0,3,2
99579,1,3,348058,348060,348063,2,5,0
99580,5,1,348063,348063,348064,0,1,0
99581,6,2,348069,348069,348071,0,2,5
99582,3,3,348072,348072,348075,0,3,1
99583,2,1,348074,348075,348076,1,2,0
99584,3,1,348077,348077,348078,0,1,1
99585,3,2,348080,348080,348082,0,2,2
99586,6,2,348086,348086,348088,0,2,4
99587,2,3,348088,348088,348091,0,3,0
99588,2,3,348090,348091,348094,1,4,0
99589,1,2,348091,348094,348096,3,5,0
99590,1,3,348092,348096,348099,4,7,0
99591,4,3,348096,348099,348102,3,6,0
99592,2,2,348098,348102,348104,4,6,0
99593,6,2,348104,348104,348106,0,2,0
99594,6,3,348110,348110,348113,0,3,4
99595,3,1,348113,348113,348114,0,1,0
99596,2,3,348115,348115,348118,0,3,1
99597,5,1,348120,348120,348121,0,1,2
99598,1,1,348121,348121,348122,0,1,0
99599,5,2,348126,348126,348128,0,2,4
99600,2,1,348128,348128,348129,0,1,0
99601,1,1,348129,348129,348130,0,1,0
99602,5,2,348134,348134,348136,0,2,4
99603,2,2,348136,348136,348138,0,2,0
99604,5,3,348141,348141,348144,0,3,3
99605,5,3,348146,348146,348149,0,3,2
99606,6,2,348152,348152,348154,0,2,3
99607,5,2,348157,348157,348159,0,2,3
99608,4,3,348161,348161,348164,0,3,2
99609,3,2,348164,348164,348166,0,2,0
99610,6,2,348170,348170,348172,0,2,4
99611,1,2,348171,348172,348174,1,3,0
99612,1,1,348172,348174,348175,2,3,0
99613,4,2,348176,348176,348178,0,2,1
99614,3,1,348179,348179,348180,0,1,1
99615,1,3,348180,348180,348183,0,3,0
99616,3,3,348183,348183,348186,0,3,0
99617,5,2,348188,348188,348190,0,2,2
99618,4,1,348192,348192,348193,0,1,2
99619,3,2,348195,348195,348197,0,2,2
99620,1,2,348196,348197,348199,1,3,0
99621,3,2,348199,348199,348201,0,2,0
99622,2,2,348201,348201,348203,0,2,0
99623,2,1,348203,348203,348204,0,1,0
99624,5,2,348208,348208,348210,0,2,4
99625,3,2,348211,348211,348213,0,2,1
99626,5,2,348216,348216,348218,0,2,3
99627,1,1,348217,348218,348219,1,2,0
99628,2,1,348219,348219,348220,0,1,0
99629,6,3,348225,348225,348228,0,3,5
99630,1,2,348226,348228,348230,2,4,0
99631,4,3,348230,348230,348233,0,3,0
99632,4,3,348234,348234,348237,0,3,1
99633,3,1,348237,348237,348238,0,1,0
99634,6,3,348243,348243,348246,0,3,5
99635,3,3,348246,348246,348249,0,3,0
99636,3,3,348249,348249,348252,0,3,0
99637,1,2,348250,348252,348254,2,4,0
99638,5,1,348255,348255,348256,0,1,1
99639,5,2,348260,348260,348262,0,2,4
99640,4,3,348264,348264,348267,0,3,2
99641,1,3,348265,348267,348270,2,5,0
99642,6,1,348271,348271,348272,0,1,1
99643,2,2,348273,348273,348275,0,2,1
99644,1,3,348274,348275,348278,1,4,0
99645,6,1,348280,348280,348281,0,1,2
99646,4,2,348284,348284,348286,0,2,3
99647,4,2,348288,348288,348290,0,2,2
99648,2,1,348290,348290,348291,0,1,0
99649,1,2,348291,348291,348293,0,2,0
99650,2,3,348293,348293,348296,0,3,0
99651,1,3,348294,348296,348299,2,5,0
99652,6,1,348300,348300,348301,0,1,1
99653,1,3,348301,348301,348304,0,3,0
99654,2,3,348303,348304,348307,1,4,0
99655,6,3,348309,348309,348312,0,3,2
99656,2,3,348311,348312,348315,1,4,0
99657,2,2,348313,348315,348317,2,4,0
99658,1,1,348314,348317,348318,3,4,0
99659,4,2,348318,348318,348320,0,2,0
99660,3,3,348321,348321,348324,0,3,1
99661,5,3,348326,348326,348329,0,3,2
99662,1,3,348327,348329,348332,2,5,0
99663,6,2,348333,348333,348335,0,2,1
99664,3,2,348336,348336,348338,0,2,1
99665,4,1,348340,348340,348341,0,1,2
99666,3,1,348343,348343,348344,0,1,2
99667,6,1,348349,348349,348350,0,1,5
99668,3,2,348352,348352,348354,0,2,2
99669,4,1,348356,348356,348357,0,1,2
99670,3,2,348359,348359,348361,0,2,2
99671,1,1,348360,348361,348362,1,2,0
99672,1,1,348361,348362,348363,1,2,0
99673,3,1,348364,348364,348365,0,1,1
99674,1,2,348365,348365,348367,0,2,0
99675,5,3,348370,348370,348373,0,3,3
99676,3,3,348373,348373,348376,0,3,0
99677,2,2,348375,348376,348378,1,3,0
99678,5,1,348380,348380,348381,0,1,2
99679,5,1,348385,348385,348386,0,1,4
99680,2,2,348387,348387,348389,0,2,1
99681,2,3,348389,348389,348392,0,3,0
99682,2,1,348391,348392,348393,1,2,0
99683,2,3,348393,348393,348396,0,3,0
99684,1,3,348394,348396,348399,2,5,0
99685,1,2,348395,348399,348401,4,6,0
99686,4,3,348399,348401,348404,2,5,0
99687,3,1,348402,348404,348405,2,3,0
99688,4,1,348406,348406,348407,0,1,1
99689,3,1,348409,348409,348410,0,1,2
99690,2,3,348411,348411,348414,0,3,1
99691,3,3,348414,348414,348417,0,3,0
99692,5,3,348419,348419,348422,0,3,2
99693,6,2,348425,348425,348427,0,2,3
99694,2,2,348427,348427,348429,0,2,0
99695,2,2,348429,348429,348431,0,2,0
99696,1,2,348430,348431,348433,1,3,0
99697,4,3,348434,348434,348437,0,3,1
99698,1,1,348435,348437,348438,2,3,0
99699,1,2,348436,348438,348440,2,4,0
99700,3,1,348439,348440,348441,1,2,0
99701,2,2,348441,348441,348443,0,2,0
99702,3,3,348444,348444,348447,0,3,1
99703,4,2,348448,348448,348450,0,2,1
99704,4,1,348452,348452,348453,0,1,2
99705,5,3,348457,348457,348460,0,3,4
99706,3,1,348460,348460,348461,0,1,0
99707,2,3,348462,348462,348465,0,3,1
99708,2,3,348464,348465,348468,1,4,0
99709,5,1,348469,348469,348470,0,1,1
99710,6,1,348475,348475,348476,0,1,5
99711,4,1,348479,348479,348480,0,1,3
99712,5,3,348484,348484,348487,0,3,4
99713,5,1,348489,348489,348490,0,1,2
99714,1,2,348490,348490,348492,0,2,0
99715,3,2,348493,348493,348495,0,2,1
99716,6,1,348499,348499,348500,0,1,4
99717,3,1,348502,348502,348503,0,1,2
99718,1,2,348503,348503,348505,0,2,0
99719,5,3,348508,348508,348511,0,3,3
99720,1,3,348509,348511,348514,2,5,0
99721,6,1,348515,348515,348516,0,1,1
99722,4,2,348519,348519,348521,0,2,3
99723,1,3,348520,348521,348524,1,4,0
99724,4,3,348524,348524,348527,0,3,0
99725,4,3,348528,348528,348531,0,3,1
99726,4,3,348532,348532,348535,0,3,1
99727,3,2,348535,348535,348537,0,2,0
99728,4,3,348539,348539,348542,0,3,2
99729,3,3,348542,348542,348545,0,3,0
99730,2,1,348544,348545,348546,1,2,0
99731,4,1,348548,348548,348549,0,1,2
99732,1,2,348549,348549,348551,0,2,0
99733,2,3,348551,348551,348554,0,3,0
99734,6,3,348557,348557,348560,0,3,3
99735,6,1,348563,348563,348564,0,1,3
99736,1,3,348564,348564,348567,0,3,0
99737,4,1,348568,348568,348569,0,1,1
99738,4,2,348572,348572,348574,0,2,3
99739,1,1,348573,348574,348575,1,2,0
99740,6,2,348579,348579,348581,0,2,4
99741,5,1,348584,348584,348585,0,1,3
99742,3,3,348587,348587,348590,0,3,2
99743,5,2,348592,348592,348594,0,2,2
99744,6,3,348598,348598,348601,0,3,4
99745,1,2,348599,348601,348603,2,4,0
99746,6,1,348605,348605,348606,0,1,2
99747,3,1,348608,348608,348609,0,1,2
99748,6,1,348614,348614,348615,0,1,5
99749,5,1,348619,348619,348620,0,1,4
99750,6,1,348625,348625,348626,0,1,5
99751,1,1,348626,348626,348627,0,1,0
99752,6,1,348632,348632,348633,0,1,5
99753,5,3,348637,348637,348640,0,3,4
99754,5,2,348642,348642,348644,0,2,2
99755,5,2,348647,348647,348649,0,2,3
99756,4,2,348651,348651,348653,0,2,2
99757,4,3,348655,348655,348658,0,3,2
99758,2,3,348657,348658,348661,1,4,0
99759,5,3,348662,348662,348665,0,3,1
99760,2,3,348664,348665,348668,1,4,0
99761,3,2,348667,348668,348670,1,3,0
99762,2,2,348669,348670,348672,1,3,0
99763,5,3,348674,348674,348677,0,3,2
99764,5,1,348679,348679,348680,0,1,2
99765,6,2,348685,348685,348687,0,2,5
99766,2,3,348687,348687,348690,0,3,0
99767,5,3,348692,348692,348695,0,3,2
99768,5,3,348697,348697,348700,0,3,2
99769,6,1,348703,348703,348704,0,1,3
99770,6,3,348709,348709,348712,0,3,5
99771,1,3,348710,348712,348715,2,5,0
99772,2,2,348712,348715,348717,3,5,0
99773,1,1,348713,348717,348718,4,5,0
99774,2,2,348715,348718,348720,3,5,0
99775,2,3,348717,348720,348723,3,6,0
99776,4,1,348721,348723,348724,2,3,0
99777,6,3,348727,348727,348730,0,3,3
99778,3,1,348730,348730,348731,0,1,0
99779,6,1,348736,348736,348737,0,1,5
99780,4,2,348740,348740,348742,0,2,3
99781,3,1,348743,348743,348744,0,1,1
99782,4,3,348747,348747,348750,0,3,3
99783,6,1,348753,348753,348754,0,1,3
99784,5,1,348758,348758,348759,0,1,4
99785,3,2,348761,348761,348763,0,2,2
99786,4,3,348765,348765,348768,0,3,2
99787,4,2,348769,348769,348771,0,2,1
99788,2,1,348771,348771,348772,0,1,0
99789,6,3,348777,348777,348780,0,3,5
99790,2,2,348779,348780,348782,1,3,0
99791,4,1,348783,348783,348784,0,1,1
99792,5,3,348788,348788,348791,0,3,4
99793,1,3,348789,348791,348794,2,5,0
99794,4,3,348793,348794,348797,1,4,0
99795,3,3,348796,348797,348800,1,4,0
99796,6,2,348802,348802,348804,0,2,2
99797,5,2,348807,348807,348809,0,2,3
99798,6,2,348813,348813,348815,0,2,4
99799,2,3,348815,348815,348818,0,3,0
99800,6,2,348821,348821,348823,0,2,3
99801,5,1,348826,348826,348827,0,1,3
99802,1,1,348827,348827,348828,0,1,0
99803,1,3,348828,348828,348831,0,3,0
99804,6,1,348834,348834,348835,0,1,3
99805,2,3,348836,348836,348839,0,3,1
99806,1,3,348837,348839,348842,2,5,0
99807,1,3,348838,348842,348845,4,7,0
99808,3,2,348841,348845,348847,4,6,0
99809,5,3,348846,348847,348850,1,4,0
99810,2,2,348848,348850,348852,2,4,0
99811,4,1,348852,348852,348853,0,1,0
99812,3,2,348855,348855,348857,0,2,2
99813,3,3,348858,348858,348861,0,3,1
99814,6,3,348864,348864,348867,0,3,3
99815,4,3,348868,348868,348871,0,3,1
99816,6,3,348874,348874,348877,0,3,3
99817,1,1,348875,348877,348878,2,3,0
99818,3,3,348878,348878,348881,0,3,0
99819,6,3,348884,348884,348887,0,3,3
99820,2,1,348886,348887,348888,1,2,0
99821,6,2,348892,348892,348894,0,2,4
99822,3,1,348895,348895,348896,0,1,1
99823,3,3,348898,348898,348901,0,3,2
99824,5,1,348903,348903,348904,0,1,2
99825,3,3,348906,348906,348909,0,3,2
99826,5,2,348911,348911,348913,0,2,2
99827,6,3,348917,348917,348920,0,3,4
99828,4,3,348921,348921,348924,0,3,1
99829,4,2,348925,348925,348927,0,2,1
99830,3,1,348928,348928,348929,0,1,1
99831,3,2,348931,348931,348933,0,2,2
99832,6,1,348937,348937,348938,0,1,4
99833,2,3,348939,348939,348942,0,3,1
99834,4,2,348943,348943,348945,0,2,1
99835,2,2,348945,348945,348947,0,2,0
99836,6,3,348951,348951,348954,0,3,4
99837,2,1,348953,348954,348955,1,2,0
99838,5,3,348958,348958,348961,0,3,3
99839,3,2,348961,348961,348963,0,2,0
99840,5,3,348966,348966,348969,0,3,3
99841,2,2,348968,348969,348971,1,3,0
99842,3,2,348971,348971,348973,0,2,0
99843,1,3,348972,348973,348976,1,4,0
99844,3,2,348975,348976,348978,1,3,0
99845,1,3,348976,348978,348981,2,5,0
99846,3,1,348979,348981,348982,2,3,0
99847,5,2,348984,348984,348986,0,2,2
99848,6,2,348990,348990,348992,0,2,4
99849,4,3,348994,348994,348997,0,3,2
99850,6,1,349000,349000,349001,0,1,3
99851,2,2,349002,349002,349004,0,2,1
99852,2,3,349004,349004,349007,0,3,0
99853,6,3,349010,349010,349013,0,3,3
99854,3,2,349013,349013,349015,0,2,0
99855,1,1,349014,349015,349016,1,2,0
99856,5,2,349019,349019,349021,0,2,3
99857,2,1,349021,349021,349022,0,1,0
99858,3,3,349024,349024,349027,0,3,2
99859,5,3,349029,349029,349032,0,3,2
99860,4,1,349033,349033,349034,0,1,1
99861,6,1,349039,349039,349040,0,1,5
99862,4,2,349043,349043,349045,0,2,3
99863,2,1,349045,349045,349046,0,1,0
99864,2,2,349047,349047,349049,0,2,1
99865,1,1,349048,349049,349050,1,2,0
99866,4,3,349052,349052,349055,0,3,2
99867,6,3,349058,349058,349061,0,3,3
99868,4,2,349062,349062,349064,0,2,1
99869,1,3,349063,349064,349067,1,4,0
99870,3,3,349066,349067,349070,1,4,0
99871,2,1,349068,349070,349071,2,3,0
99872,5,1,349073,349073,349074,0,1,2
99873,1,2,349074,349074,349076,0,2,0
99874,2,3,349076,349076,349079,0,3,0
99875,5,3,349081,349081,349084,0,3,2
99876,1,1,349082,349084,349085,2,3,0
99877,6,1,349088,349088,349089,0,1,3
99878,3,2,349091,349091,349093,0,2,2
99879,3,1,349094,349094,349095,0,1,1
99880,1,1,349095,349095,349096,0,1,0
99881,6,2,349101,349101,349103,0,2,5
99882,4,2,349105,349105,349107,0,2,2
99883,4,1,349109,349109,349110,0,1,2
99884,4,2,349113,349113,349115,0,2,3
99885,6,3,349119,349119,349122,0,3,4
99886,6,1,349125,349125,349126,0,1,3
99887,2,3,349127,349127,349130,0,3,1
99888,4,1,349131,349131,349132,0,1,1
99889,6,1,349137,349137,349138,0,1,5
99890,3,3,349140,349140,349143,0,3,2
99891,6,2,349146,349146,349148,0,2,3
99892,6,3,349152,349152,349155,0,3,4
99893,6,2,349158,349158,349160,0,2,3
99894,6,3,349164,349164,349167,0,3,4
99895,2,3,349166,349167,349170,1,4,0
99896,2,3,349168,349170,349173,2,5,0
99897,4,2,349172,349173,349175,1,3,0
99898,6,2,349178,349178,349180,0,2,3
99899,4,1,349182,349182,349183,0,1,2
99900,2,1,349184,349184,349185,0,1,1
99901,2,3,349186,349186,349189,0,3,1
99902,6,1,349192,349192,349193,0,1,3
99903,3,1,349195,349195,349196,0,1,2
99904,1,1,349196,349196,349197,0,1,0
99905,1,1,349197,349197,349198,0,1,0
99906,4,2,349201,349201,349203,0,2,3
99907,6,3,349207,349207,349210,0,3,4
99908,6,3,349213,349213,349216,0,3,3
99909,3,1,349216,349216,349217,0,1,0
99910,5,3,349221,349221,349224,0,3,4
99911,3,2,349224,349224,349226,0,2,0
99912,5,2,349229,349229,349231,0,2,3
99913,3,2,349232,349232,349234,0,2,1
99914,1,2,349233,349234,349236,1,3,0
99915,4,2,349237,349237,349239,0,2,1
99916,1,3,349238,349239,349242,1,4,0
99917,2,1,349240,349242,349243,2,3,0
99918,3,3,349243,349243,349246,0,3,0
99919,3,1,349246,349246,349247,0,1,0
99920,6,2,349252,349252,349254,0,2,5
99921,1,3,349253,349254,349257,1,4,0
99922,2,3,349255,349257,349260,2,5,0
99923,5,2,349260,349260,349262,0,2,0
99924,1,1,349261,349262,349263,1,2,0
99925,1,2,349262,349263,349265,1,3,0
99926,3,1,349265,349265,349266,0,1,0
99927,6,1,349271,349271,349272,0,1,5
99928,2,1,349273,349273,349274,0,1,1
99929,2,1,349275,349275,349276,0,1,1
99930,1,1,349276,349276,349277,0,1,0
99931,3,2,349279,349279,349281,0,2,2
99932,1,2,349280,349281,349283,1,3,0
99933,6,1,349286,349286,349287,0,1,3
99934,4,2,349290,349290,349292,0,2,3
99935,5,1,349295,349295,349296,0,1,3
99936,6,3,349301,349301,349304,0,3,5
99937,6,3,349307,349307,349310,0,3,3
99938,4,1,349311,349311,349312,0,1,1
99939,2,3,349313,349313,349316,0,3,1
99940,4,2,349317,349317,349319,0,2,1
99941,1,3,349318,349319,349322,1,4,0
99942,2,2,349320,349322,349324,2,4,0
99943,4,2,349324,349324,349326,0,2,0
99944,6,2,349330,349330,349332,0,2,4
99945,6,2,349336,349336,349338,0,2,4
99946,1,3,349337,349338,349341,1,4,0
99947,6,3,349343,349343,349346,0,3,2
99948,1,2,349344,349346,349348,2,4,0
99949,5,2,349349,349349,349351,0,2,1
99950,1,2,349350,349351,349353,1,3,0
99951,6,2,349356,349356,349358,0,2,3
99952,6,2,349362,349362,349364,0,2,4
99953,3,2,349365,349365,349367,0,2,1
99954,5,2,349370,349370,349372,0,2,3
99955,4,1,349374,349374,349375,0,1,2
99956,3,2,349377,349377,349379,0,2,2
99957,3,3,349380,349380,349383,0,3,1
99958,3,2,349383,349383,349385,0,2,0
99959,1,2,349384,349385,349387,1,3,0
99960,3,2,349387,349387,349389,0,2,0
99961,2,1,349389,349389,349390,0,1,0
99962,3,1,349392,349392,349393,0,1,2
99963,4,3,349396,349396,349399,0,3,3
99964,6,3,349402,349402,349405,0,3,3
99965,4,2,349406,349406,349408,0,2,1
99966,4,2,349410,349410,349412,0,2,2
99967,4,1,349414,349414,349415,0,1,2
99968,5,1,349419,349419,349420,0,1,4
99969,1,2,349420,349420,349422,0,2,0
99970,5,2,349425,349425,349427,0,2,3
99971,6,2,349431,349431,349433,0,2,4
99972,3,2,349434,349434,349436,0,2,1
99973,3,2,349437,349437,349439,0,2,1
99974,5,2,349442,349442,349444,0,2,3
99975,3,2,349445,349445,349447,0,2,1
99976,4,2,349449,349449,349451,0,2,2
99977,2,3,349451,349451,349454,0,3,0
99978,6,3,349457,349457,349460,0,3,3
99979,5,2,349462,349462,349464,0,2,2
99980,5,3,349467,349467,349470,0,3,3
99981,4,2,349471,349471,349473,0,2,1
99982,3,1,349474,349474,349475,0,1,1
99983,3,2,349477,349477,349479,0,2,2
99984,1,3,349478,349479,349482,1,4,0
99985,4,3,349482,349482,349485,0,3,0
99986,2,2,349484,349485,349487,1,3,0
99987,4,3,349488,349488,349491,0,3,1
99988,5,1,349493,349493,349494,0,1,2
99989,3,1,349496,349496,349497,0,1,2
99990,1,1,349497,349497,349498,0,1,0
99991,2,3,349499,349499,349502,0,3,1
99992,4,3,349503,349503,349506,0,3,1
99993,3,1,349506,349506,349507,0,1,0
99994,5,2,349511,349511,349513,0,2,4
99995,2,3,349513,349513,349516,0,3,0
99996,4,3,349517,349517,349520,0,3,1
99997,2,3,349519,349520,349523,1,4,0
99998,2,2,349521,349523,349525,2,4,0
99999,2,1,349523,349525,349526,2,3,0
