,time_between,service_time,arrival_time,start_time,end_time,wait_time,system_time,idle_time
0,0,3,0,0,3,0,3,0
1,1,1,1,3,4,2,3,0
2,5,2,6,6,8,0,2,2
3,1,2,7,8,10,1,3,0
4,1,1,8,10,11,2,3,0
5,3,2,11,11,13,0,2,0
6,2,3,13,13,16,0,3,0
7,4,1,17,17,18,0,1,1
8,6,3,23,23,26,0,3,5
9,1,2,24,26,28,2,4,0
10,2,2,26,28,30,2,4,0
11,6,2,32,32,34,0,2,2
12,2,2,34,34,36,0,2,0
13,6,1,40,40,41,0,1,4
14,6,3,46,46,49,0,3,5
15,2,1,48,49,50,1,2,0
16,2,3,50,50,53,0,3,0
17,4,2,54,54,56,0,2,1
18,1,1,55,56,57,1,2,0
19,5,2,60,60,62,0,2,3
20,3,3,63,63,66,0,3,1
21,4,2,67,67,69,0,2,1
22,4,3,71,71,74,0,3,2
23,6,3,77,77,80,0,3,3
24,3,3,80,80,83,0,3,0
25,6,2,86,86,88,0,2,3
26,6,3,92,92,95,0,3,4
27,1,1,93,95,96,2,3,0
28,3,3,96,96,99,0,3,0
29,2,3,98,99,102,1,4,0
30,2,3,100,102,105,2,5,0
31,4,2,104,105,107,1,3,0
32,5,1,109,109,110,0,1,2
33,2,2,111,111,113,0,2,1
34,1,3,112,113,116,1,4,0
35,5,3,117,117,120,0,3,1
36,3,2,120,120,122,0,2,0
37,2,2,122,122,124,0,2,0
38,3,2,125,125,127,0,2,1
39,2,2,127,127,129,0,2,0
40,3,3,130,130,133,0,3,1
41,6,1,136,136,137,0,1,3
42,3,2,139,139,141,0,2,2
43,6,1,145,145,146,0,1,4
44,2,1,147,147,148,0,1,1
45,3,3,150,150,153,0,3,2
46,3,1,153,153,154,0,1,0
47,1,1,154,154,155,0,1,0
48,5,1,159,159,160,0,1,4
49,1,3,160,160,163,0,3,0
50,6,1,166,166,167,0,1,3
51,6,1,172,172,173,0,1,5
52,4,2,176,176,178,0,2,3
53,4,1,180,180,181,0,1,2
54,5,3,185,185,188,0,3,4
55,2,1,187,188,189,1,2,0
56,4,2,191,191,193,0,2,2
57,2,2,193,193,195,0,2,0
58,3,2,196,196,198,0,2,1
59,2,3,198,198,201,0,3,0
60,5,3,203,203,206,0,3,2
61,6,2,209,209,211,0,2,3
62,5,1,214,214,215,0,1,3
63,5,3,219,219,222,0,3,4
64,1,2,220,222,224,2,4,0
65,2,3,222,224,227,2,5,0
66,4,1,226,227,228,1,2,0
67,5,1,231,231,232,0,1,3
68,3,3,234,234,237,0,3,2
69,5,1,239,239,240,0,1,2
70,2,3,241,241,244,0,3,1
71,2,1,243,244,245,1,2,0
72,3,1,246,246,247,0,1,1
73,1,1,247,247,248,0,1,0
74,2,3,249,249,252,0,3,1
75,5,2,254,254,256,0,2,2
76,5,1,259,259,260,0,1,3
77,5,3,264,264,267,0,3,4
78,3,2,267,267,269,0,2,0
79,6,3,273,273,276,0,3,4
80,4,3,277,277,280,0,3,1
81,4,2,281,281,283,0,2,1
82,6,1,287,287,288,0,1,4
83,3,1,290,290,291,0,1,2
84,6,1,296,296,297,0,1,5
85,5,1,301,301,302,0,1,4
86,6,3,307,307,310,0,3,5
87,3,1,310,310,311,0,1,0
88,4,3,314,314,317,0,3,3
89,2,2,316,317,319,1,3,0
90,2,1,318,319,320,1,2,0
91,2,3,320,320,323,0,3,0
92,1,3,321,323,326,2,5,0
93,2,2,323,326,328,3,5,0
94,5,1,328,328,329,0,1,0
95,2,1,330,330,331,0,1,1
96,6,2,336,336,338,0,2,5
97,3,1,339,339,340,0,1,1
98,4,2,343,343,345,0,2,3
99,3,3,346,346,349,0,3,1
100,5,1,351,351,352,0,1,2
101,5,1,356,356,357,0,1,4
102,1,2,357,357,359,0,2,0
103,5,2,362,362,364,0,2,3
104,6,2,368,368,370,0,2,4
105,6,1,374,374,375,0,1,4
106,4,3,378,378,381,0,3,3
107,2,3,380,381,384,1,4,0
108,4,1,384,384,385,0,1,0
109,4,1,388,388,389,0,1,3
110,3,2,391,391,393,0,2,2
111,6,3,397,397,400,0,3,4
112,6,1,403,403,404,0,1,3
113,5,3,408,408,411,0,3,4
114,4,1,412,412,413,0,1,1
115,2,1,414,414,415,0,1,1
116,6,2,420,420,422,0,2,5
117,2,3,422,422,425,0,3,0
118,5,2,427,427,429,0,2,2
119,3,1,430,430,431,0,1,1
120,6,1,436,436,437,0,1,5
121,3,3,439,439,442,0,3,2
122,5,1,444,444,445,0,1,2
123,3,2,447,447,449,0,2,2
124,2,2,449,449,451,0,2,0
125,5,1,454,454,455,0,1,3
126,3,2,457,457,459,0,2,2
127,2,1,459,459,460,0,1,0
128,5,3,464,464,467,0,3,4
129,3,2,467,467,469,0,2,0
130,2,2,469,469,471,0,2,0
131,5,3,474,474,477,0,3,3
132,3,3,477,477,480,0,3,0
133,5,2,482,482,484,0,2,2
134,4,1,486,486,487,0,1,2
135,1,1,487,487,488,0,1,0
136,6,2,493,493,495,0,2,5
137,3,1,496,496,497,0,1,1
138,1,1,497,497,498,0,1,0
139,3,1,500,500,501,0,1,2
140,6,2,506,506,508,0,2,5
141,5,2,511,511,513,0,2,3
142,2,1,513,513,514,0,1,0
143,1,1,514,514,515,0,1,0
144,3,3,517,517,520,0,3,2
145,6,3,523,523,526,0,3,3
146,5,1,528,528,529,0,1,2
147,4,1,532,532,533,0,1,3
148,6,1,538,538,539,0,1,5
149,4,1,542,542,543,0,1,3
150,2,3,544,544,547,0,3,1
151,4,3,548,548,551,0,3,1
152,4,1,552,552,553,0,1,1
153,2,3,554,554,557,0,3,1
154,3,3,557,557,560,0,3,0
155,3,2,560,560,562,0,2,0
156,6,3,566,566,569,0,3,4
157,3,1,569,569,570,0,1,0
158,1,2,570,570,572,0,2,0
159,5,2,575,575,577,0,2,3
160,2,2,577,577,579,0,2,0
161,3,2,580,580,582,0,2,1
162,4,3,584,584,587,0,3,2
163,2,3,586,587,590,1,4,0
164,1,1,587,590,591,3,4,0
165,2,1,589,591,592,2,3,0
166,2,2,591,592,594,1,3,0
167,2,1,593,594,595,1,2,0
168,1,2,594,595,597,1,3,0
169,4,2,598,598,600,0,2,1
170,4,1,602,602,603,0,1,2
171,1,2,603,603,605,0,2,0
172,6,2,609,609,611,0,2,4
173,4,1,613,613,614,0,1,2
174,5,3,618,618,621,0,3,4
175,4,3,622,622,625,0,3,1
176,3,1,625,625,626,0,1,0
177,3,1,628,628,629,0,1,2
178,2,2,630,630,632,0,2,1
179,2,2,632,632,634,0,2,0
180,2,1,634,634,635,0,1,0
181,1,1,635,635,636,0,1,0
182,2,3,637,637,640,0,3,1
183,3,3,640,640,643,0,3,0
184,3,3,643,643,646,0,3,0
185,3,2,646,646,648,0,2,0
186,5,3,651,651,654,0,3,3
187,4,2,655,655,657,0,2,1
188,4,1,659,659,660,0,1,2
189,1,3,660,660,663,0,3,0
190,4,2,664,664,666,0,2,1
191,5,2,669,669,671,0,2,3
192,2,2,671,671,673,0,2,0
193,3,1,674,674,675,0,1,1
194,3,3,677,677,680,0,3,2
195,4,3,681,681,684,0,3,1
196,1,1,682,684,685,2,3,0
197,2,2,684,685,687,1,3,0
198,5,1,689,689,690,0,1,2
199,3,3,692,692,695,0,3,2
200,1,2,693,695,697,2,4,0
201,1,3,694,697,700,3,6,0
202,4,3,698,700,703,2,5,0
203,1,1,699,703,704,4,5,0
204,2,1,701,704,705,3,4,0
205,5,2,706,706,708,0,2,1
206,2,3,708,708,711,0,3,0
207,1,3,709,711,714,2,5,0
208,1,2,710,714,716,4,6,0
209,6,2,716,716,718,0,2,0
210,6,3,722,722,725,0,3,4
211,6,1,728,728,729,0,1,3
212,2,3,730,730,733,0,3,1
213,5,1,735,735,736,0,1,2
214,1,2,736,736,738,0,2,0
215,3,3,739,739,742,0,3,1
216,3,1,742,742,743,0,1,0
217,2,1,744,744,745,0,1,1
218,3,3,747,747,750,0,3,2
219,5,2,752,752,754,0,2,2
220,5,3,757,757,760,0,3,3
221,6,1,763,763,764,0,1,3
222,1,3,764,764,767,0,3,0
223,3,2,767,767,769,0,2,0
224,2,2,769,769,771,0,2,0
225,5,3,774,774,777,0,3,3
226,3,3,777,777,780,0,3,0
227,2,1,779,780,781,1,2,0
228,3,1,782,782,783,0,1,1
229,3,3,785,785,788,0,3,2
230,5,1,790,790,791,0,1,2
231,2,1,792,792,793,0,1,1
232,1,2,793,793,795,0,2,0
233,6,2,799,799,801,0,2,4
234,1,3,800,801,804,1,4,0
235,2,3,802,804,807,2,5,0
236,3,2,805,807,809,2,4,0
237,3,2,808,809,811,1,3,0
238,6,2,814,814,816,0,2,3
239,6,3,820,820,823,0,3,4
240,4,3,824,824,827,0,3,1
241,6,1,830,830,831,0,1,3
242,4,3,834,834,837,0,3,3
243,2,1,836,837,838,1,2,0
244,2,3,838,838,841,0,3,0
245,5,2,843,843,845,0,2,2
246,6,2,849,849,851,0,2,4
247,5,1,854,854,855,0,1,3
248,1,2,855,855,857,0,2,0
249,1,2,856,857,859,1,3,0
250,2,1,858,859,860,1,2,0
251,2,1,860,860,861,0,1,0
252,6,2,866,866,868,0,2,5
253,2,1,868,868,869,0,1,0
254,6,1,874,874,875,0,1,5
255,1,3,875,875,878,0,3,0
256,1,2,876,878,880,2,4,0
257,5,2,881,881,883,0,2,1
258,3,2,884,884,886,0,2,1
259,6,2,890,890,892,0,2,4
260,6,2,896,896,898,0,2,4
261,4,3,900,900,903,0,3,2
262,1,3,901,903,906,2,5,0
263,2,2,903,906,908,3,5,0
264,2,1,905,908,909,3,4,0
265,2,3,907,909,912,2,5,0
266,3,1,910,912,913,2,3,0
267,3,3,913,913,916,0,3,0
268,5,1,918,918,919,0,1,2
269,4,2,922,922,924,0,2,3
270,4,3,926,926,929,0,3,2
271,3,2,929,929,931,0,2,0
272,2,3,931,931,934,0,3,0
273,1,3,932,934,937,2,5,0
274,5,3,937,937,940,0,3,0
275,3,1,940,940,941,0,1,0
276,6,2,946,946,948,0,2,5
277,3,2,949,949,951,0,2,1
278,3,1,952,952,953,0,1,1
279,2,1,954,954,955,0,1,1
280,4,3,958,958,961,0,3,3
281,4,2,962,962,964,0,2,1
282,2,2,964,964,966,0,2,0
283,2,3,966,966,969,0,3,0
284,1,2,967,969,971,2,4,0
285,3,2,970,971,973,1,3,0
286,5,1,975,975,976,0,1,2
287,4,2,979,979,981,0,2,3
288,4,3,983,983,986,0,3,2
289,1,3,984,986,989,2,5,0
290,4,1,988,989,990,1,2,0
291,5,1,993,993,994,0,1,3
292,6,3,999,999,1002,0,3,5
293,1,1,1000,1002,1003,2,3,0
294,5,2,1005,1005,1007,0,2,2
295,3,1,1008,1008,1009,0,1,1
296,6,2,1014,1014,1016,0,2,5
297,6,3,1020,1020,1023,0,3,4
298,3,3,1023,1023,1026,0,3,0
299,5,3,1028,1028,1031,0,3,2
300,5,2,1033,1033,1035,0,2,2
301,1,3,1034,1035,1038,1,4,0
302,3,3,1037,1038,1041,1,4,0
303,5,2,1042,1042,1044,0,2,1
304,3,3,1045,1045,1048,0,3,1
305,2,3,1047,1048,1051,1,4,0
306,1,3,1048,1051,1054,3,6,0
307,2,3,1050,1054,1057,4,7,0
308,3,1,1053,1057,1058,4,5,0
309,2,1,1055,1058,1059,3,4,0
310,5,1,1060,1060,1061,0,1,1
311,4,1,1064,1064,1065,0,1,3
312,6,3,1070,1070,1073,0,3,5
313,6,2,1076,1076,1078,0,2,3
314,3,3,1079,1079,1082,0,3,1
315,4,1,1083,1083,1084,0,1,1
316,4,2,1087,1087,1089,0,2,3
317,5,1,1092,1092,1093,0,1,3
318,2,1,1094,1094,1095,0,1,1
319,4,2,1098,1098,1100,0,2,3
320,2,2,1100,1100,1102,0,2,0
321,2,1,1102,1102,1103,0,1,0
322,1,3,1103,1103,1106,0,3,0
323,2,1,1105,1106,1107,1,2,0
324,2,1,1107,1107,1108,0,1,0
325,4,1,1111,1111,1112,0,1,3
326,5,2,1116,1116,1118,0,2,4
327,5,2,1121,1121,1123,0,2,3
328,5,1,1126,1126,1127,0,1,3
329,2,3,1128,1128,1131,0,3,1
330,1,2,1129,1131,1133,2,4,0
331,6,1,1135,1135,1136,0,1,2
332,4,3,1139,1139,1142,0,3,3
333,2,3,1141,1142,1145,1,4,0
334,4,3,1145,1145,1148,0,3,0
335,6,2,1151,1151,1153,0,2,3
336,5,2,1156,1156,1158,0,2,3
337,1,3,1157,1158,1161,1,4,0
338,6,2,1163,1163,1165,0,2,2
339,3,1,1166,1166,1167,0,1,1
340,5,3,1171,1171,1174,0,3,4
341,4,2,1175,1175,1177,0,2,1
342,2,2,1177,1177,1179,0,2,0
343,4,1,1181,1181,1182,0,1,2
344,3,1,1184,1184,1185,0,1,2
345,5,3,1189,1189,1192,0,3,4
346,3,3,1192,1192,1195,0,3,0
347,5,2,1197,1197,1199,0,2,2
348,2,3,1199,1199,1202,0,3,0
349,4,3,1203,1203,1206,0,3,1
350,4,2,1207,1207,1209,0,2,1
351,3,2,1210,1210,1212,0,2,1
352,2,1,1212,1212,1213,0,1,0
353,5,3,1217,1217,1220,0,3,4
354,4,1,1221,1221,1222,0,1,1
355,2,1,1223,1223,1224,0,1,1
356,2,2,1225,1225,1227,0,2,1
357,6,1,1231,1231,1232,0,1,4
358,4,1,1235,1235,1236,0,1,3
359,6,3,1241,1241,1244,0,3,5
360,3,2,1244,1244,1246,0,2,0
361,1,1,1245,1246,1247,1,2,0
362,4,1,1249,1249,1250,0,1,2
363,3,2,1252,1252,1254,0,2,2
364,2,3,1254,1254,1257,0,3,0
365,6,1,1260,1260,1261,0,1,3
366,1,3,1261,1261,1264,0,3,0
367,2,2,1263,1264,1266,1,3,0
368,3,2,1266,1266,1268,0,2,0
369,4,3,1270,1270,1273,0,3,2
370,6,2,1276,1276,1278,0,2,3
371,4,3,1280,1280,1283,0,3,2
372,3,2,1283,1283,1285,0,2,0
373,1,1,1284,1285,1286,1,2,0
374,6,2,1290,1290,1292,0,2,4
375,4,3,1294,1294,1297,0,3,2
376,3,1,1297,1297,1298,0,1,0
377,4,1,1301,1301,1302,0,1,3
378,6,1,1307,1307,1308,0,1,5
379,1,3,1308,1308,1311,0,3,0
380,2,1,1310,1311,1312,1,2,0
381,3,1,1313,1313,1314,0,1,1
382,3,3,1316,1316,1319,0,3,2
383,1,1,1317,1319,1320,2,3,0
384,5,3,1322,1322,1325,0,3,2
385,2,3,1324,1325,1328,1,4,0
386,2,2,1326,1328,1330,2,4,0
387,3,1,1329,1330,1331,1,2,0
388,2,1,1331,1331,1332,0,1,0
389,5,1,1336,1336,1337,0,1,4
390,4,2,1340,1340,1342,0,2,3
391,6,2,1346,1346,1348,0,2,4
392,3,2,1349,1349,1351,0,2,1
393,6,2,1355,1355,1357,0,2,4
394,5,3,1360,1360,1363,0,3,3
395,6,3,1366,1366,1369,0,3,3
396,4,2,1370,1370,1372,0,2,1
397,2,2,1372,1372,1374,0,2,0
398,6,1,1378,1378,1379,0,1,4
399,4,2,1382,1382,1384,0,2,3
400,5,3,1387,1387,1390,0,3,3
401,4,2,1391,1391,1393,0,2,1
402,2,3,1393,1393,1396,0,3,0
403,1,1,1394,1396,1397,2,3,0
404,1,2,1395,1397,1399,2,4,0
405,3,1,1398,1399,1400,1,2,0
406,6,3,1404,1404,1407,0,3,4
407,1,3,1405,1407,1410,2,5,0
408,4,3,1409,1410,1413,1,4,0
409,2,2,1411,1413,1415,2,4,0
410,3,2,1414,1415,1417,1,3,0
411,6,1,1420,1420,1421,0,1,3
412,6,3,1426,1426,1429,0,3,5
413,2,3,1428,1429,1432,1,4,0
414,1,3,1429,1432,1435,3,6,0
415,3,2,1432,1435,1437,3,5,0
416,6,2,1438,1438,1440,0,2,1
417,6,1,1444,1444,1445,0,1,4
418,3,1,1447,1447,1448,0,1,2
419,6,1,1453,1453,1454,0,1,5
420,4,3,1457,1457,1460,0,3,3
421,1,2,1458,1460,1462,2,4,0
422,4,1,1462,1462,1463,0,1,0
423,2,1,1464,1464,1465,0,1,1
424,6,1,1470,1470,1471,0,1,5
425,4,2,1474,1474,1476,0,2,3
426,6,1,1480,1480,1481,0,1,4
427,5,3,1485,1485,1488,0,3,4
428,6,1,1491,1491,1492,0,1,3
429,6,2,1497,1497,1499,0,2,5
430,5,2,1502,1502,1504,0,2,3
431,6,2,1508,1508,1510,0,2,4
432,4,2,1512,1512,1514,0,2,2
433,3,1,1515,1515,1516,0,1,1
434,6,1,1521,1521,1522,0,1,5
435,6,2,1527,1527,1529,0,2,5
436,4,3,1531,1531,1534,0,3,2
437,4,3,1535,1535,1538,0,3,1
438,2,3,1537,1538,1541,1,4,0
439,3,1,1540,1541,1542,1,2,0
440,5,3,1545,1545,1548,0,3,3
441,1,3,1546,1548,1551,2,5,0
442,3,1,1549,1551,1552,2,3,0
443,1,1,1550,1552,1553,2,3,0
444,6,3,1556,1556,1559,0,3,3
445,3,1,1559,1559,1560,0,1,0
446,3,2,1562,1562,1564,0,2,2
447,2,1,1564,1564,1565,0,1,0
448,6,1,1570,1570,1571,0,1,5
449,6,2,1576,1576,1578,0,2,5
450,4,2,1580,1580,1582,0,2,2
451,4,3,1584,1584,1587,0,3,2
452,4,2,1588,1588,1590,0,2,1
453,3,3,1591,1591,1594,0,3,1
454,6,1,1597,1597,1598,0,1,3
455,2,3,1599,1599,1602,0,3,1
456,6,1,1605,1605,1606,0,1,3
457,5,3,1610,1610,1613,0,3,4
458,2,3,1612,1613,1616,1,4,0
459,1,3,1613,1616,1619,3,6,0
460,6,1,1619,1619,1620,0,1,0
461,2,2,1621,1621,1623,0,2,1
462,5,1,1626,1626,1627,0,1,3
463,2,1,1628,1628,1629,0,1,1
464,1,2,1629,1629,1631,0,2,0
465,3,1,1632,1632,1633,0,1,1
466,3,3,1635,1635,1638,0,3,2
467,2,2,1637,1638,1640,1,3,0
468,3,2,1640,1640,1642,0,2,0
469,1,3,1641,1642,1645,1,4,0
470,4,1,1645,1645,1646,0,1,0
471,3,2,1648,1648,1650,0,2,2
472,3,1,1651,1651,1652,0,1,1
473,5,3,1656,1656,1659,0,3,4
474,6,1,1662,1662,1663,0,1,3
475,2,1,1664,1664,1665,0,1,1
476,6,1,1670,1670,1671,0,1,5
477,1,2,1671,1671,1673,0,2,0
478,5,3,1676,1676,1679,0,3,3
479,3,2,1679,1679,1681,0,2,0
480,2,1,1681,1681,1682,0,1,0
481,1,1,1682,1682,1683,0,1,0
482,6,1,1688,1688,1689,0,1,5
483,5,1,1693,1693,1694,0,1,4
484,6,1,1699,1699,1700,0,1,5
485,6,1,1705,1705,1706,0,1,5
486,1,3,1706,1706,1709,0,3,0
487,6,3,1712,1712,1715,0,3,3
488,3,2,1715,1715,1717,0,2,0
489,2,3,1717,1717,1720,0,3,0
490,3,3,1720,1720,1723,0,3,0
491,4,1,1724,1724,1725,0,1,1
492,1,3,1725,1725,1728,0,3,0
493,6,3,1731,1731,1734,0,3,3
494,2,1,1733,1734,1735,1,2,0
495,4,1,1737,1737,1738,0,1,2
496,2,1,1739,1739,1740,0,1,1
497,5,3,1744,1744,1747,0,3,4
498,1,2,1745,1747,1749,2,4,0
499,5,1,1750,1750,1751,0,1,1
500,3,1,1753,1753,1754,0,1,2
501,5,3,1758,1758,1761,0,3,4
502,2,1,1760,1761,1762,1,2,0
503,2,1,1762,1762,1763,0,1,0
504,2,3,1764,1764,1767,0,3,1
505,3,1,1767,1767,1768,0,1,0
506,4,1,1771,1771,1772,0,1,3
507,4,2,1775,1775,1777,0,2,3
508,6,2,1781,1781,1783,0,2,4
509,3,2,1784,1784,1786,0,2,1
510,5,2,1789,1789,1791,0,2,3
511,2,1,1791,1791,1792,0,1,0
512,4,3,1795,1795,1798,0,3,3
513,1,2,1796,1798,1800,2,4,0
514,1,1,1797,1800,1801,3,4,0
515,6,2,1803,1803,1805,0,2,2
516,1,2,1804,1805,1807,1,3,0
517,2,2,1806,1807,1809,1,3,0
518,5,3,1811,1811,1814,0,3,2
519,5,2,1816,1816,1818,0,2,2
520,1,1,1817,1818,1819,1,2,0
521,2,3,1819,1819,1822,0,3,0
522,1,1,1820,1822,1823,2,3,0
523,5,2,1825,1825,1827,0,2,2
524,4,3,1829,1829,1832,0,3,2
525,5,1,1834,1834,1835,0,1,2
526,1,1,1835,1835,1836,0,1,0
527,4,3,1839,1839,1842,0,3,3
528,3,1,1842,1842,1843,0,1,0
529,5,2,1847,1847,1849,0,2,4
530,4,2,1851,1851,1853,0,2,2
531,6,1,1857,1857,1858,0,1,4
532,2,2,1859,1859,1861,0,2,1
533,2,3,1861,1861,1864,0,3,0
534,3,1,1864,1864,1865,0,1,0
535,4,2,1868,1868,1870,0,2,3
536,3,2,1871,1871,1873,0,2,1
537,1,2,1872,1873,1875,1,3,0
538,5,2,1877,1877,1879,0,2,2
539,2,1,1879,1879,1880,0,1,0
540,1,3,1880,1880,1883,0,3,0
541,1,3,1881,1883,1886,2,5,0
542,5,3,1886,1886,1889,0,3,0
543,6,2,1892,1892,1894,0,2,3
544,1,3,1893,1894,1897,1,4,0
545,6,2,1899,1899,1901,0,2,2
546,4,2,1903,1903,1905,0,2,2
547,3,3,1906,1906,1909,0,3,1
548,5,3,1911,1911,1914,0,3,2
549,4,3,1915,1915,1918,0,3,1
550,1,1,1916,1918,1919,2,3,0
551,6,1,1922,1922,1923,0,1,3
552,2,1,1924,1924,1925,0,1,1
553,2,1,1926,1926,1927,0,1,1
554,1,2,1927,1927,1929,0,2,0
555,6,2,1933,1933,1935,0,2,4
556,3,2,1936,1936,1938,0,2,1
557,1,1,1937,1938,1939,1,2,0
558,4,3,1941,1941,1944,0,3,2
559,1,1,1942,1944,1945,2,3,0
560,5,1,1947,1947,1948,0,1,2
561,5,3,1952,1952,1955,0,3,4
562,5,1,1957,1957,1958,0,1,2
563,2,1,1959,1959,1960,0,1,1
564,3,1,1962,1962,1963,0,1,2
565,6,2,1968,1968,1970,0,2,5
566,3,3,1971,1971,1974,0,3,1
567,6,3,1977,1977,1980,0,3,3
568,5,1,1982,1982,1983,0,1,2
569,5,2,1987,1987,1989,0,2,4
570,4,1,1991,1991,1992,0,1,2
571,6,3,1997,1997,2000,0,3,5
572,4,2,2001,2001,2003,0,2,1
573,3,1,2004,2004,2005,0,1,1
574,3,2,2007,2007,2009,0,2,2
575,1,3,2008,2009,2012,1,4,0
576,5,1,2013,2013,2014,0,1,1
577,1,1,2014,2014,2015,0,1,0
578,6,2,2020,2020,2022,0,2,5
579,6,1,2026,2026,2027,0,1,4
580,4,1,2030,2030,2031,0,1,3
581,2,3,2032,2032,2035,0,3,1
582,5,2,2037,2037,2039,0,2,2
583,4,2,2041,2041,2043,0,2,2
584,2,2,2043,2043,2045,0,2,0
585,2,3,2045,2045,2048,0,3,0
586,1,1,2046,2048,2049,2,3,0
587,6,1,2052,2052,2053,0,1,3
588,3,2,2055,2055,2057,0,2,2
589,4,2,2059,2059,2061,0,2,2
590,5,3,2064,2064,2067,0,3,3
591,5,2,2069,2069,2071,0,2,2
592,1,3,2070,2071,2074,1,4,0
593,3,3,2073,2074,2077,1,4,0
594,4,3,2077,2077,2080,0,3,0
595,1,3,2078,2080,2083,2,5,0
596,3,2,2081,2083,2085,2,4,0
597,1,2,2082,2085,2087,3,5,0
598,1,1,2083,2087,2088,4,5,0
599,2,3,2085,2088,2091,3,6,0
600,1,2,2086,2091,2093,5,7,0
601,1,2,2087,2093,2095,6,8,0
602,6,2,2093,2095,2097,2,4,0
603,2,3,2095,2097,2100,2,5,0
604,6,1,2101,2101,2102,0,1,1
605,3,1,2104,2104,2105,0,1,2
606,3,1,2107,2107,2108,0,1,2
607,4,2,2111,2111,2113,0,2,3
608,5,1,2116,2116,2117,0,1,3
609,2,2,2118,2118,2120,0,2,1
610,5,2,2123,2123,2125,0,2,3
611,1,1,2124,2125,2126,1,2,0
612,4,2,2128,2128,2130,0,2,2
613,5,1,2133,2133,2134,0,1,3
614,6,3,2139,2139,2142,0,3,5
615,1,1,2140,2142,2143,2,3,0
616,4,1,2144,2144,2145,0,1,1
617,5,2,2149,2149,2151,0,2,4
618,5,1,2154,2154,2155,0,1,3
619,1,1,2155,2155,2156,0,1,0
620,5,1,2160,2160,2161,0,1,4
621,2,1,2162,2162,2163,0,1,1
622,6,2,2168,2168,2170,0,2,5
623,5,1,2173,2173,2174,0,1,3
624,3,3,2176,2176,2179,0,3,2
625,2,2,2178,2179,2181,1,3,0
626,1,1,2179,2181,2182,2,3,0
627,5,3,2184,2184,2187,0,3,2
628,2,2,2186,2187,2189,1,3,0
629,4,1,2190,2190,2191,0,1,1
630,1,2,2191,2191,2193,0,2,0
631,5,3,2196,2196,2199,0,3,3
632,1,3,2197,2199,2202,2,5,0
633,6,2,2203,2203,2205,0,2,1
634,5,1,2208,2208,2209,0,1,3
635,2,2,2210,2210,2212,0,2,1
636,4,2,2214,2214,2216,0,2,2
637,1,1,2215,2216,2217,1,2,0
638,6,3,2221,2221,2224,0,3,4
639,6,2,2227,2227,2229,0,2,3
640,3,1,2230,2230,2231,0,1,1
641,4,1,2234,2234,2235,0,1,3
642,1,1,2235,2235,2236,0,1,0
643,4,3,2239,2239,2242,0,3,3
644,6,3,2245,2245,2248,0,3,3
645,5,1,2250,2250,2251,0,1,2
646,3,3,2253,2253,2256,0,3,2
647,3,3,2256,2256,2259,0,3,0
648,6,3,2262,2262,2265,0,3,3
649,5,3,2267,2267,2270,0,3,2
650,4,2,2271,2271,2273,0,2,1
651,4,2,2275,2275,2277,0,2,2
652,5,2,2280,2280,2282,0,2,3
653,5,1,2285,2285,2286,0,1,3
654,3,1,2288,2288,2289,0,1,2
655,5,2,2293,2293,2295,0,2,4
656,6,2,2299,2299,2301,0,2,4
657,4,3,2303,2303,2306,0,3,2
658,2,2,2305,2306,2308,1,3,0
659,6,2,2311,2311,2313,0,2,3
660,2,3,2313,2313,2316,0,3,0
661,5,3,2318,2318,2321,0,3,2
662,4,2,2322,2322,2324,0,2,1
663,6,1,2328,2328,2329,0,1,4
664,5,3,2333,2333,2336,0,3,4
665,5,2,2338,2338,2340,0,2,2
666,2,1,2340,2340,2341,0,1,0
667,6,3,2346,2346,2349,0,3,5
668,5,2,2351,2351,2353,0,2,2
669,4,1,2355,2355,2356,0,1,2
670,3,2,2358,2358,2360,0,2,2
671,4,3,2362,2362,2365,0,3,2
672,5,1,2367,2367,2368,0,1,2
673,3,3,2370,2370,2373,0,3,2
674,4,2,2374,2374,2376,0,2,1
675,6,1,2380,2380,2381,0,1,4
676,1,1,2381,2381,2382,0,1,0
677,6,1,2387,2387,2388,0,1,5
678,3,2,2390,2390,2392,0,2,2
679,1,3,2391,2392,2395,1,4,0
680,5,2,2396,2396,2398,0,2,1
681,4,2,2400,2400,2402,0,2,2
682,3,2,2403,2403,2405,0,2,1
683,1,2,2404,2405,2407,1,3,0
684,1,1,2405,2407,2408,2,3,0
685,4,1,2409,2409,2410,0,1,1
686,4,2,2413,2413,2415,0,2,3
687,2,1,2415,2415,2416,0,1,0
688,5,3,2420,2420,2423,0,3,4
689,6,1,2426,2426,2427,0,1,3
690,4,2,2430,2430,2432,0,2,3
691,4,3,2434,2434,2437,0,3,2
692,5,1,2439,2439,2440,0,1,2
693,5,2,2444,2444,2446,0,2,4
694,3,3,2447,2447,2450,0,3,1
695,6,3,2453,2453,2456,0,3,3
696,1,1,2454,2456,2457,2,3,0
697,3,2,2457,2457,2459,0,2,0
698,6,1,2463,2463,2464,0,1,4
699,2,2,2465,2465,2467,0,2,1
700,4,3,2469,2469,2472,0,3,2
701,3,3,2472,2472,2475,0,3,0
702,5,3,2477,2477,2480,0,3,2
703,2,3,2479,2480,2483,1,4,0
704,5,2,2484,2484,2486,0,2,1
705,5,2,2489,2489,2491,0,2,3
706,6,3,2495,2495,2498,0,3,4
707,3,1,2498,2498,2499,0,1,0
708,2,1,2500,2500,2501,0,1,1
709,6,2,2506,2506,2508,0,2,5
710,5,1,2511,2511,2512,0,1,3
711,6,2,2517,2517,2519,0,2,5
712,2,2,2519,2519,2521,0,2,0
713,6,3,2525,2525,2528,0,3,4
714,3,1,2528,2528,2529,0,1,0
715,5,1,2533,2533,2534,0,1,4
716,6,1,2539,2539,2540,0,1,5
717,4,3,2543,2543,2546,0,3,3
718,1,1,2544,2546,2547,2,3,0
719,3,3,2547,2547,2550,0,3,0
720,6,1,2553,2553,2554,0,1,3
721,3,1,2556,2556,2557,0,1,2
722,1,1,2557,2557,2558,0,1,0
723,1,3,2558,2558,2561,0,3,0
724,4,3,2562,2562,2565,0,3,1
725,1,3,2563,2565,2568,2,5,0
726,3,3,2566,2568,2571,2,5,0
727,1,3,2567,2571,2574,4,7,0
728,6,1,2573,2574,2575,1,2,0
729,1,3,2574,2575,2578,1,4,0
730,5,1,2579,2579,2580,0,1,1
731,4,3,2583,2583,2586,0,3,3
732,1,3,2584,2586,2589,2,5,0
733,2,1,2586,2589,2590,3,4,0
734,5,2,2591,2591,2593,0,2,1
735,2,3,2593,2593,2596,0,3,0
736,3,3,2596,2596,2599,0,3,0
737,2,2,2598,2599,2601,1,3,0
738,6,2,2604,2604,2606,0,2,3
739,4,3,2608,2608,2611,0,3,2
740,3,1,2611,2611,2612,0,1,0
741,6,1,2617,2617,2618,0,1,5
742,6,3,2623,2623,2626,0,3,5
743,2,1,2625,2626,2627,1,2,0
744,5,1,2630,2630,2631,0,1,3
745,2,3,2632,2632,2635,0,3,1
746,2,3,2634,2635,2638,1,4,0
747,3,3,2637,2638,2641,1,4,0
748,4,2,2641,2641,2643,0,2,0
749,1,1,2642,2643,2644,1,2,0
750,2,1,2644,2644,2645,0,1,0
751,6,2,2650,2650,2652,0,2,5
752,3,3,2653,2653,2656,0,3,1
753,2,2,2655,2656,2658,1,3,0
754,3,2,2658,2658,2660,0,2,0
755,5,1,2663,2663,2664,0,1,3
756,3,1,2666,2666,2667,0,1,2
757,2,3,2668,2668,2671,0,3,1
758,2,2,2670,2671,2673,1,3,0
759,6,3,2676,2676,2679,0,3,3
760,3,2,2679,2679,2681,0,2,0
761,2,3,2681,2681,2684,0,3,0
762,5,3,2686,2686,2689,0,3,2
763,4,2,2690,2690,2692,0,2,1
764,1,3,2691,2692,2695,1,4,0
765,6,3,2697,2697,2700,0,3,2
766,3,3,2700,2700,2703,0,3,0
767,2,2,2702,2703,2705,1,3,0
768,2,1,2704,2705,2706,1,2,0
769,2,3,2706,2706,2709,0,3,0
770,1,3,2707,2709,2712,2,5,0
771,4,3,2711,2712,2715,1,4,0
772,1,2,2712,2715,2717,3,5,0
773,6,1,2718,2718,2719,0,1,1
774,1,3,2719,2719,2722,0,3,0
775,5,2,2724,2724,2726,0,2,2
776,1,3,2725,2726,2729,1,4,0
777,5,3,2730,2730,2733,0,3,1
778,1,1,2731,2733,2734,2,3,0
779,4,1,2735,2735,2736,0,1,1
780,3,1,2738,2738,2739,0,1,2
781,5,3,2743,2743,2746,0,3,4
782,5,1,2748,2748,2749,0,1,2
783,6,1,2754,2754,2755,0,1,5
784,5,1,2759,2759,2760,0,1,4
785,6,3,2765,2765,2768,0,3,5
786,4,3,2769,2769,2772,0,3,1
787,3,3,2772,2772,2775,0,3,0
788,4,2,2776,2776,2778,0,2,1
789,6,3,2782,2782,2785,0,3,4
790,2,1,2784,2785,2786,1,2,0
791,3,1,2787,2787,2788,0,1,1
792,6,1,2793,2793,2794,0,1,5
793,1,2,2794,2794,2796,0,2,0
794,6,1,2800,2800,2801,0,1,4
795,2,3,2802,2802,2805,0,3,1
796,5,1,2807,2807,2808,0,1,2
797,4,2,2811,2811,2813,0,2,3
798,1,2,2812,2813,2815,1,3,0
799,6,3,2818,2818,2821,0,3,3
800,2,2,2820,2821,2823,1,3,0
801,5,2,2825,2825,2827,0,2,2
802,2,3,2827,2827,2830,0,3,0
803,1,1,2828,2830,2831,2,3,0
804,3,3,2831,2831,2834,0,3,0
805,4,2,2835,2835,2837,0,2,1
806,2,3,2837,2837,2840,0,3,0
807,5,3,2842,2842,2845,0,3,2
808,2,2,2844,2845,2847,1,3,0
809,3,2,2847,2847,2849,0,2,0
810,6,2,2853,2853,2855,0,2,4
811,3,2,2856,2856,2858,0,2,1
812,4,2,2860,2860,2862,0,2,2
813,6,3,2866,2866,2869,0,3,4
814,2,2,2868,2869,2871,1,3,0
815,1,2,2869,2871,2873,2,4,0
816,3,3,2872,2873,2876,1,4,0
817,1,2,2873,2876,2878,3,5,0
818,6,1,2879,2879,2880,0,1,1
819,5,1,2884,2884,2885,0,1,4
820,4,1,2888,2888,2889,0,1,3
821,4,1,2892,2892,2893,0,1,3
822,3,3,2895,2895,2898,0,3,2
823,1,3,2896,2898,2901,2,5,0
824,6,2,2902,2902,2904,0,2,1
825,3,3,2905,2905,2908,0,3,1
826,3,1,2908,2908,2909,0,1,0
827,1,3,2909,2909,2912,0,3,0
828,4,1,2913,2913,2914,0,1,1
829,3,2,2916,2916,2918,0,2,2
830,6,1,2922,2922,2923,0,1,4
831,3,3,2925,2925,2928,0,3,2
832,1,3,2926,2928,2931,2,5,0
833,6,1,2932,2932,2933,0,1,1
834,5,2,2937,2937,2939,0,2,4
835,1,1,2938,2939,2940,1,2,0
836,3,1,2941,2941,2942,0,1,1
837,3,1,2944,2944,2945,0,1,2
838,6,2,2950,2950,2952,0,2,5
839,4,3,2954,2954,2957,0,3,2
840,4,2,2958,2958,2960,0,2,1
841,5,1,2963,2963,2964,0,1,3
842,5,2,2968,2968,2970,0,2,4
843,6,2,2974,2974,2976,0,2,4
844,4,3,2978,2978,2981,0,3,2
845,4,3,2982,2982,2985,0,3,1
846,2,3,2984,2985,2988,1,4,0
847,2,1,2986,2988,2989,2,3,0
848,2,3,2988,2989,2992,1,4,0
849,4,1,2992,2992,2993,0,1,0
850,5,3,2997,2997,3000,0,3,4
851,5,1,3002,3002,3003,0,1,2
852,1,2,3003,3003,3005,0,2,0
853,5,3,3008,3008,3011,0,3,3
854,6,2,3014,3014,3016,0,2,3
855,3,2,3017,3017,3019,0,2,1
856,2,1,3019,3019,3020,0,1,0
857,1,3,3020,3020,3023,0,3,0
858,1,2,3021,3023,3025,2,4,0
859,2,3,3023,3025,3028,2,5,0
860,1,3,3024,3028,3031,4,7,0
861,6,1,3030,3031,3032,1,2,0
862,4,2,3034,3034,3036,0,2,2
863,1,1,3035,3036,3037,1,2,0
864,2,1,3037,3037,3038,0,1,0
865,5,1,3042,3042,3043,0,1,4
866,4,3,3046,3046,3049,0,3,3
867,6,3,3052,3052,3055,0,3,3
868,5,3,3057,3057,3060,0,3,2
869,2,2,3059,3060,3062,1,3,0
870,6,3,3065,3065,3068,0,3,3
871,4,1,3069,3069,3070,0,1,1
872,5,2,3074,3074,3076,0,2,4
873,5,1,3079,3079,3080,0,1,3
874,4,3,3083,3083,3086,0,3,3
875,5,1,3088,3088,3089,0,1,2
876,2,3,3090,3090,3093,0,3,1
877,1,2,3091,3093,3095,2,4,0
878,6,2,3097,3097,3099,0,2,2
879,3,2,3100,3100,3102,0,2,1
880,6,1,3106,3106,3107,0,1,4
881,4,3,3110,3110,3113,0,3,3
882,5,2,3115,3115,3117,0,2,2
883,4,1,3119,3119,3120,0,1,2
884,3,1,3122,3122,3123,0,1,2
885,4,1,3126,3126,3127,0,1,3
886,6,2,3132,3132,3134,0,2,5
887,6,2,3138,3138,3140,0,2,4
888,6,1,3144,3144,3145,0,1,4
889,1,3,3145,3145,3148,0,3,0
890,2,2,3147,3148,3150,1,3,0
891,2,2,3149,3150,3152,1,3,0
892,2,1,3151,3152,3153,1,2,0
893,4,3,3155,3155,3158,0,3,2
894,5,3,3160,3160,3163,0,3,2
895,2,1,3162,3163,3164,1,2,0
896,1,2,3163,3164,3166,1,3,0
897,4,2,3167,3167,3169,0,2,1
898,3,1,3170,3170,3171,0,1,1
899,4,1,3174,3174,3175,0,1,3
900,3,1,3177,3177,3178,0,1,2
901,1,2,3178,3178,3180,0,2,0
902,4,3,3182,3182,3185,0,3,2
903,1,2,3183,3185,3187,2,4,0
904,4,2,3187,3187,3189,0,2,0
905,4,1,3191,3191,3192,0,1,2
906,5,3,3196,3196,3199,0,3,4
907,4,1,3200,3200,3201,0,1,1
908,3,2,3203,3203,3205,0,2,2
909,1,3,3204,3205,3208,1,4,0
910,2,1,3206,3208,3209,2,3,0
911,5,2,3211,3211,3213,0,2,2
912,5,1,3216,3216,3217,0,1,3
913,2,2,3218,3218,3220,0,2,1
914,6,1,3224,3224,3225,0,1,4
915,4,1,3228,3228,3229,0,1,3
916,1,3,3229,3229,3232,0,3,0
917,5,3,3234,3234,3237,0,3,2
918,2,3,3236,3237,3240,1,4,0
919,4,2,3240,3240,3242,0,2,0
920,1,3,3241,3242,3245,1,4,0
921,1,1,3242,3245,3246,3,4,0
922,3,1,3245,3246,3247,1,2,0
923,2,2,3247,3247,3249,0,2,0
924,3,3,3250,3250,3253,0,3,1
925,2,2,3252,3253,3255,1,3,0
926,1,1,3253,3255,3256,2,3,0
927,2,1,3255,3256,3257,1,2,0
928,4,2,3259,3259,3261,0,2,2
929,2,1,3261,3261,3262,0,1,0
930,5,2,3266,3266,3268,0,2,4
931,5,3,3271,3271,3274,0,3,3
932,6,3,3277,3277,3280,0,3,3
933,2,3,3279,3280,3283,1,4,0
934,6,2,3285,3285,3287,0,2,2
935,2,3,3287,3287,3290,0,3,0
936,6,2,3293,3293,3295,0,2,3
937,1,1,3294,3295,3296,1,2,0
938,6,2,3300,3300,3302,0,2,4
939,6,3,3306,3306,3309,0,3,4
940,5,3,3311,3311,3314,0,3,2
941,4,3,3315,3315,3318,0,3,1
942,4,3,3319,3319,3322,0,3,1
943,2,3,3321,3322,3325,1,4,0
944,4,2,3325,3325,3327,0,2,0
945,6,3,3331,3331,3334,0,3,4
946,1,3,3332,3334,3337,2,5,0
947,6,2,3338,3338,3340,0,2,1
948,6,3,3344,3344,3347,0,3,4
949,3,3,3347,3347,3350,0,3,0
950,5,3,3352,3352,3355,0,3,2
951,1,2,3353,3355,3357,2,4,0
952,6,2,3359,3359,3361,0,2,2
953,6,3,3365,3365,3368,0,3,4
954,1,1,3366,3368,3369,2,3,0
955,1,1,3367,3369,3370,2,3,0
956,1,3,3368,3370,3373,2,5,0
957,3,1,3371,3373,3374,2,3,0
958,5,2,3376,3376,3378,0,2,2
959,6,3,3382,3382,3385,0,3,4
960,1,2,3383,3385,3387,2,4,0
961,3,2,3386,3387,3389,1,3,0
962,3,2,3389,3389,3391,0,2,0
963,2,2,3391,3391,3393,0,2,0
964,6,3,3397,3397,3400,0,3,4
965,1,1,3398,3400,3401,2,3,0
966,6,2,3404,3404,3406,0,2,3
967,3,1,3407,3407,3408,0,1,1
968,3,3,3410,3410,3413,0,3,2
969,1,1,3411,3413,3414,2,3,0
970,3,3,3414,3414,3417,0,3,0
971,3,3,3417,3417,3420,0,3,0
972,6,1,3423,3423,3424,0,1,3
973,6,1,3429,3429,3430,0,1,5
974,3,2,3432,3432,3434,0,2,2
975,1,1,3433,3434,3435,1,2,0
976,4,3,3437,3437,3440,0,3,2
977,5,1,3442,3442,3443,0,1,2
978,4,2,3446,3446,3448,0,2,3
979,2,2,3448,3448,3450,0,2,0
980,1,1,3449,3450,3451,1,2,0
981,5,2,3454,3454,3456,0,2,3
982,5,2,3459,3459,3461,0,2,3
983,4,2,3463,3463,3465,0,2,2
984,4,2,3467,3467,3469,0,2,2
985,2,3,3469,3469,3472,0,3,0
986,5,3,3474,3474,3477,0,3,2
987,6,1,3480,3480,3481,0,1,3
988,6,2,3486,3486,3488,0,2,5
989,4,1,3490,3490,3491,0,1,2
990,3,3,3493,3493,3496,0,3,2
991,5,2,3498,3498,3500,0,2,2
992,6,2,3504,3504,3506,0,2,4
993,6,3,3510,3510,3513,0,3,4
994,4,1,3514,3514,3515,0,1,1
995,2,1,3516,3516,3517,0,1,1
996,5,1,3521,3521,3522,0,1,4
997,5,2,3526,3526,3528,0,2,4
998,4,2,3530,3530,3532,0,2,2
999,4,2,3534,3534,3536,0,2,2
1000,1,1,3535,3536,3537,1,2,0
1001,6,2,3541,3541,3543,0,2,4
1002,6,3,3547,3547,3550,0,3,4
1003,5,1,3552,3552,3553,0,1,2
1004,5,1,3557,3557,3558,0,1,4
1005,4,3,3561,3561,3564,0,3,3
1006,6,2,3567,3567,3569,0,2,3
1007,3,2,3570,3570,3572,0,2,1
1008,6,1,3576,3576,3577,0,1,4
1009,4,1,3580,3580,3581,0,1,3
1010,6,3,3586,3586,3589,0,3,5
1011,5,3,3591,3591,3594,0,3,2
1012,3,1,3594,3594,3595,0,1,0
1013,6,1,3600,3600,3601,0,1,5
1014,6,1,3606,3606,3607,0,1,5
1015,6,1,3612,3612,3613,0,1,5
1016,5,3,3617,3617,3620,0,3,4
1017,1,1,3618,3620,3621,2,3,0
1018,1,1,3619,3621,3622,2,3,0
1019,3,1,3622,3622,3623,0,1,0
1020,2,3,3624,3624,3627,0,3,1
1021,5,2,3629,3629,3631,0,2,2
1022,1,1,3630,3631,3632,1,2,0
1023,3,3,3633,3633,3636,0,3,1
1024,6,3,3639,3639,3642,0,3,3
1025,1,2,3640,3642,3644,2,4,0
1026,1,2,3641,3644,3646,3,5,0
1027,4,3,3645,3646,3649,1,4,0
1028,6,3,3651,3651,3654,0,3,2
1029,1,1,3652,3654,3655,2,3,0
1030,3,2,3655,3655,3657,0,2,0
1031,4,1,3659,3659,3660,0,1,2
1032,4,1,3663,3663,3664,0,1,3
1033,6,1,3669,3669,3670,0,1,5
1034,3,2,3672,3672,3674,0,2,2
1035,4,2,3676,3676,3678,0,2,2
1036,3,3,3679,3679,3682,0,3,1
1037,3,3,3682,3682,3685,0,3,0
1038,4,2,3686,3686,3688,0,2,1
1039,1,1,3687,3688,3689,1,2,0
1040,5,2,3692,3692,3694,0,2,3
1041,5,2,3697,3697,3699,0,2,3
1042,1,1,3698,3699,3700,1,2,0
1043,4,1,3702,3702,3703,0,1,2
1044,4,2,3706,3706,3708,0,2,3
1045,2,2,3708,3708,3710,0,2,0
1046,2,1,3710,3710,3711,0,1,0
1047,4,2,3714,3714,3716,0,2,3
1048,5,3,3719,3719,3722,0,3,3
1049,1,2,3720,3722,3724,2,4,0
1050,5,2,3725,3725,3727,0,2,1
1051,4,2,3729,3729,3731,0,2,2
1052,5,2,3734,3734,3736,0,2,3
1053,1,2,3735,3736,3738,1,3,0
1054,2,2,3737,3738,3740,1,3,0
1055,2,2,3739,3740,3742,1,3,0
1056,3,3,3742,3742,3745,0,3,0
1057,6,3,3748,3748,3751,0,3,3
1058,3,2,3751,3751,3753,0,2,0
1059,1,1,3752,3753,3754,1,2,0
1060,6,2,3758,3758,3760,0,2,4
1061,3,1,3761,3761,3762,0,1,1
1062,2,1,3763,3763,3764,0,1,1
1063,1,1,3764,3764,3765,0,1,0
1064,1,3,3765,3765,3768,0,3,0
1065,6,3,3771,3771,3774,0,3,3
1066,6,3,3777,3777,3780,0,3,3
1067,3,2,3780,3780,3782,0,2,0
1068,5,1,3785,3785,3786,0,1,3
1069,4,3,3789,3789,3792,0,3,3
1070,1,2,3790,3792,3794,2,4,0
1071,1,2,3791,3794,3796,3,5,0
1072,6,2,3797,3797,3799,0,2,1
1073,1,3,3798,3799,3802,1,4,0
1074,6,3,3804,3804,3807,0,3,2
1075,5,2,3809,3809,3811,0,2,2
1076,1,2,3810,3811,3813,1,3,0
1077,3,1,3813,3813,3814,0,1,0
1078,3,3,3816,3816,3819,0,3,2
1079,6,2,3822,3822,3824,0,2,3
1080,5,1,3827,3827,3828,0,1,3
1081,1,3,3828,3828,3831,0,3,0
1082,4,3,3832,3832,3835,0,3,1
1083,4,1,3836,3836,3837,0,1,1
1084,2,3,3838,3838,3841,0,3,1
1085,3,3,3841,3841,3844,0,3,0
1086,6,1,3847,3847,3848,0,1,3
1087,2,3,3849,3849,3852,0,3,1
1088,5,1,3854,3854,3855,0,1,2
1089,6,2,3860,3860,3862,0,2,5
1090,3,2,3863,3863,3865,0,2,1
1091,5,3,3868,3868,3871,0,3,3
1092,4,2,3872,3872,3874,0,2,1
1093,6,1,3878,3878,3879,0,1,4
1094,2,1,3880,3880,3881,0,1,1
1095,2,1,3882,3882,3883,0,1,1
1096,6,2,3888,3888,3890,0,2,5
1097,2,2,3890,3890,3892,0,2,0
1098,5,3,3895,3895,3898,0,3,3
1099,5,1,3900,3900,3901,0,1,2
1100,1,2,3901,3901,3903,0,2,0
1101,2,2,3903,3903,3905,0,2,0
1102,3,1,3906,3906,3907,0,1,1
1103,3,3,3909,3909,3912,0,3,2
1104,4,3,3913,3913,3916,0,3,1
1105,4,3,3917,3917,3920,0,3,1
1106,5,2,3922,3922,3924,0,2,2
1107,1,3,3923,3924,3927,1,4,0
1108,5,2,3928,3928,3930,0,2,1
1109,5,3,3933,3933,3936,0,3,3
1110,6,1,3939,3939,3940,0,1,3
1111,4,1,3943,3943,3944,0,1,3
1112,1,1,3944,3944,3945,0,1,0
1113,5,1,3949,3949,3950,0,1,4
1114,3,2,3952,3952,3954,0,2,2
1115,6,2,3958,3958,3960,0,2,4
1116,3,2,3961,3961,3963,0,2,1
1117,6,3,3967,3967,3970,0,3,4
1118,5,3,3972,3972,3975,0,3,2
1119,2,2,3974,3975,3977,1,3,0
1120,5,1,3979,3979,3980,0,1,2
1121,1,2,3980,3980,3982,0,2,0
1122,6,2,3986,3986,3988,0,2,4
1123,1,3,3987,3988,3991,1,4,0
1124,3,3,3990,3991,3994,1,4,0
1125,6,3,3996,3996,3999,0,3,2
1126,5,3,4001,4001,4004,0,3,2
1127,4,3,4005,4005,4008,0,3,1
1128,4,2,4009,4009,4011,0,2,1
1129,1,3,4010,4011,4014,1,4,0
1130,4,2,4014,4014,4016,0,2,0
1131,1,2,4015,4016,4018,1,3,0
1132,4,3,4019,4019,4022,0,3,1
1133,1,2,4020,4022,4024,2,4,0
1134,3,2,4023,4024,4026,1,3,0
1135,2,2,4025,4026,4028,1,3,0
1136,4,2,4029,4029,4031,0,2,1
1137,4,3,4033,4033,4036,0,3,2
1138,3,2,4036,4036,4038,0,2,0
1139,4,2,4040,4040,4042,0,2,2
1140,3,3,4043,4043,4046,0,3,1
1141,4,1,4047,4047,4048,0,1,1
1142,2,3,4049,4049,4052,0,3,1
1143,6,3,4055,4055,4058,0,3,3
1144,5,1,4060,4060,4061,0,1,2
1145,4,3,4064,4064,4067,0,3,3
1146,5,1,4069,4069,4070,0,1,2
1147,1,3,4070,4070,4073,0,3,0
1148,5,1,4075,4075,4076,0,1,2
1149,1,2,4076,4076,4078,0,2,0
1150,3,1,4079,4079,4080,0,1,1
1151,5,1,4084,4084,4085,0,1,4
1152,3,1,4087,4087,4088,0,1,2
1153,4,2,4091,4091,4093,0,2,3
1154,4,3,4095,4095,4098,0,3,2
1155,5,2,4100,4100,4102,0,2,2
1156,1,2,4101,4102,4104,1,3,0
1157,2,3,4103,4104,4107,1,4,0
1158,4,1,4107,4107,4108,0,1,0
1159,3,3,4110,4110,4113,0,3,2
1160,1,1,4111,4113,4114,2,3,0
1161,6,3,4117,4117,4120,0,3,3
1162,4,1,4121,4121,4122,0,1,1
1163,6,2,4127,4127,4129,0,2,5
1164,3,1,4130,4130,4131,0,1,1
1165,1,1,4131,4131,4132,0,1,0
1166,6,3,4137,4137,4140,0,3,5
1167,6,2,4143,4143,4145,0,2,3
1168,3,2,4146,4146,4148,0,2,1
1169,5,3,4151,4151,4154,0,3,3
1170,4,3,4155,4155,4158,0,3,1
1171,3,1,4158,4158,4159,0,1,0
1172,4,3,4162,4162,4165,0,3,3
1173,3,2,4165,4165,4167,0,2,0
1174,4,3,4169,4169,4172,0,3,2
1175,5,2,4174,4174,4176,0,2,2
1176,5,2,4179,4179,4181,0,2,3
1177,3,1,4182,4182,4183,0,1,1
1178,4,1,4186,4186,4187,0,1,3
1179,4,1,4190,4190,4191,0,1,3
1180,3,2,4193,4193,4195,0,2,2
1181,1,1,4194,4195,4196,1,2,0
1182,5,2,4199,4199,4201,0,2,3
1183,3,2,4202,4202,4204,0,2,1
1184,2,2,4204,4204,4206,0,2,0
1185,6,3,4210,4210,4213,0,3,4
1186,2,2,4212,4213,4215,1,3,0
1187,3,2,4215,4215,4217,0,2,0
1188,1,1,4216,4217,4218,1,2,0
1189,2,1,4218,4218,4219,0,1,0
1190,4,2,4222,4222,4224,0,2,3
1191,4,2,4226,4226,4228,0,2,2
1192,4,1,4230,4230,4231,0,1,2
1193,1,1,4231,4231,4232,0,1,0
1194,2,3,4233,4233,4236,0,3,1
1195,4,2,4237,4237,4239,0,2,1
1196,6,1,4243,4243,4244,0,1,4
1197,6,1,4249,4249,4250,0,1,5
1198,1,3,4250,4250,4253,0,3,0
1199,2,2,4252,4253,4255,1,3,0
1200,6,3,4258,4258,4261,0,3,3
1201,1,1,4259,4261,4262,2,3,0
1202,6,2,4265,4265,4267,0,2,3
1203,3,1,4268,4268,4269,0,1,1
1204,3,1,4271,4271,4272,0,1,2
1205,5,2,4276,4276,4278,0,2,4
1206,5,3,4281,4281,4284,0,3,3
1207,2,1,4283,4284,4285,1,2,0
1208,1,3,4284,4285,4288,1,4,0
1209,1,3,4285,4288,4291,3,6,0
1210,1,2,4286,4291,4293,5,7,0
1211,4,2,4290,4293,4295,3,5,0
1212,4,1,4294,4295,4296,1,2,0
1213,1,3,4295,4296,4299,1,4,0
1214,3,3,4298,4299,4302,1,4,0
1215,3,1,4301,4302,4303,1,2,0
1216,4,3,4305,4305,4308,0,3,2
1217,2,3,4307,4308,4311,1,4,0
1218,5,1,4312,4312,4313,0,1,1
1219,6,2,4318,4318,4320,0,2,5
1220,6,2,4324,4324,4326,0,2,4
1221,6,1,4330,4330,4331,0,1,4
1222,6,1,4336,4336,4337,0,1,5
1223,5,2,4341,4341,4343,0,2,4
1224,1,3,4342,4343,4346,1,4,0
1225,3,1,4345,4346,4347,1,2,0
1226,2,1,4347,4347,4348,0,1,0
1227,1,2,4348,4348,4350,0,2,0
1228,5,1,4353,4353,4354,0,1,3
1229,4,3,4357,4357,4360,0,3,3
1230,2,3,4359,4360,4363,1,4,0
1231,6,1,4365,4365,4366,0,1,2
1232,4,3,4369,4369,4372,0,3,3
1233,3,1,4372,4372,4373,0,1,0
1234,3,2,4375,4375,4377,0,2,2
1235,3,1,4378,4378,4379,0,1,1
1236,3,1,4381,4381,4382,0,1,2
1237,1,3,4382,4382,4385,0,3,0
1238,2,1,4384,4385,4386,1,2,0
1239,2,1,4386,4386,4387,0,1,0
1240,1,1,4387,4387,4388,0,1,0
1241,5,1,4392,4392,4393,0,1,4
1242,6,1,4398,4398,4399,0,1,5
1243,2,1,4400,4400,4401,0,1,1
1244,1,3,4401,4401,4404,0,3,0
1245,1,1,4402,4404,4405,2,3,0
1246,2,1,4404,4405,4406,1,2,0
1247,4,2,4408,4408,4410,0,2,2
1248,3,2,4411,4411,4413,0,2,1
1249,3,2,4414,4414,4416,0,2,1
1250,5,3,4419,4419,4422,0,3,3
1251,6,2,4425,4425,4427,0,2,3
1252,2,1,4427,4427,4428,0,1,0
1253,1,3,4428,4428,4431,0,3,0
1254,1,3,4429,4431,4434,2,5,0
1255,3,1,4432,4434,4435,2,3,0
1256,1,3,4433,4435,4438,2,5,0
1257,5,2,4438,4438,4440,0,2,0
1258,6,1,4444,4444,4445,0,1,4
1259,5,1,4449,4449,4450,0,1,4
1260,4,3,4453,4453,4456,0,3,3
1261,4,3,4457,4457,4460,0,3,1
1262,2,3,4459,4460,4463,1,4,0
1263,4,2,4463,4463,4465,0,2,0
1264,3,2,4466,4466,4468,0,2,1
1265,1,3,4467,4468,4471,1,4,0
1266,3,2,4470,4471,4473,1,3,0
1267,4,3,4474,4474,4477,0,3,1
1268,3,3,4477,4477,4480,0,3,0
1269,1,3,4478,4480,4483,2,5,0
1270,4,3,4482,4483,4486,1,4,0
1271,3,2,4485,4486,4488,1,3,0
1272,2,3,4487,4488,4491,1,4,0
1273,6,1,4493,4493,4494,0,1,2
1274,3,1,4496,4496,4497,0,1,2
1275,6,2,4502,4502,4504,0,2,5
1276,5,3,4507,4507,4510,0,3,3
1277,1,1,4508,4510,4511,2,3,0
1278,5,3,4513,4513,4516,0,3,2
1279,4,3,4517,4517,4520,0,3,1
1280,4,1,4521,4521,4522,0,1,1
1281,2,1,4523,4523,4524,0,1,1
1282,4,1,4527,4527,4528,0,1,3
1283,3,1,4530,4530,4531,0,1,2
1284,2,2,4532,4532,4534,0,2,1
1285,1,2,4533,4534,4536,1,3,0
1286,3,1,4536,4536,4537,0,1,0
1287,5,3,4541,4541,4544,0,3,4
1288,6,1,4547,4547,4548,0,1,3
1289,2,2,4549,4549,4551,0,2,1
1290,3,3,4552,4552,4555,0,3,1
1291,4,3,4556,4556,4559,0,3,1
1292,2,1,4558,4559,4560,1,2,0
1293,3,3,4561,4561,4564,0,3,1
1294,6,3,4567,4567,4570,0,3,3
1295,3,2,4570,4570,4572,0,2,0
1296,4,2,4574,4574,4576,0,2,2
1297,1,2,4575,4576,4578,1,3,0
1298,5,1,4580,4580,4581,0,1,2
1299,2,2,4582,4582,4584,0,2,1
1300,2,1,4584,4584,4585,0,1,0
1301,2,3,4586,4586,4589,0,3,1
1302,3,3,4589,4589,4592,0,3,0
1303,3,1,4592,4592,4593,0,1,0
1304,3,2,4595,4595,4597,0,2,2
1305,4,3,4599,4599,4602,0,3,2
1306,4,1,4603,4603,4604,0,1,1
1307,6,3,4609,4609,4612,0,3,5
1308,1,1,4610,4612,4613,2,3,0
1309,5,1,4615,4615,4616,0,1,2
1310,1,1,4616,4616,4617,0,1,0
1311,4,2,4620,4620,4622,0,2,3
1312,1,1,4621,4622,4623,1,2,0
1313,2,3,4623,4623,4626,0,3,0
1314,5,1,4628,4628,4629,0,1,2
1315,2,3,4630,4630,4633,0,3,1
1316,5,3,4635,4635,4638,0,3,2
1317,2,3,4637,4638,4641,1,4,0
1318,1,3,4638,4641,4644,3,6,0
1319,3,2,4641,4644,4646,3,5,0
1320,2,1,4643,4646,4647,3,4,0
1321,2,3,4645,4647,4650,2,5,0
1322,6,3,4651,4651,4654,0,3,1
1323,1,1,4652,4654,4655,2,3,0
1324,2,2,4654,4655,4657,1,3,0
1325,5,1,4659,4659,4660,0,1,2
1326,1,1,4660,4660,4661,0,1,0
1327,5,1,4665,4665,4666,0,1,4
1328,1,3,4666,4666,4669,0,3,0
1329,4,2,4670,4670,4672,0,2,1
1330,1,3,4671,4672,4675,1,4,0
1331,1,1,4672,4675,4676,3,4,0
1332,1,1,4673,4676,4677,3,4,0
1333,4,1,4677,4677,4678,0,1,0
1334,2,1,4679,4679,4680,0,1,1
1335,5,3,4684,4684,4687,0,3,4
1336,3,1,4687,4687,4688,0,1,0
1337,3,2,4690,4690,4692,0,2,2
1338,1,2,4691,4692,4694,1,3,0
1339,2,2,4693,4694,4696,1,3,0
1340,4,2,4697,4697,4699,0,2,1
1341,5,1,4702,4702,4703,0,1,3
1342,3,3,4705,4705,4708,0,3,2
1343,1,1,4706,4708,4709,2,3,0
1344,5,1,4711,4711,4712,0,1,2
1345,3,3,4714,4714,4717,0,3,2
1346,6,3,4720,4720,4723,0,3,3
1347,2,2,4722,4723,4725,1,3,0
1348,3,2,4725,4725,4727,0,2,0
1349,1,2,4726,4727,4729,1,3,0
1350,3,1,4729,4729,4730,0,1,0
1351,5,2,4734,4734,4736,0,2,4
1352,4,3,4738,4738,4741,0,3,2
1353,4,1,4742,4742,4743,0,1,1
1354,5,2,4747,4747,4749,0,2,4
1355,6,3,4753,4753,4756,0,3,4
1356,1,1,4754,4756,4757,2,3,0
1357,4,2,4758,4758,4760,0,2,1
1358,3,2,4761,4761,4763,0,2,1
1359,2,3,4763,4763,4766,0,3,0
1360,5,2,4768,4768,4770,0,2,2
1361,5,1,4773,4773,4774,0,1,3
1362,4,3,4777,4777,4780,0,3,3
1363,1,3,4778,4780,4783,2,5,0
1364,6,1,4784,4784,4785,0,1,1
1365,3,2,4787,4787,4789,0,2,2
1366,4,1,4791,4791,4792,0,1,2
1367,6,3,4797,4797,4800,0,3,5
1368,5,2,4802,4802,4804,0,2,2
1369,5,2,4807,4807,4809,0,2,3
1370,6,1,4813,4813,4814,0,1,4
1371,4,1,4817,4817,4818,0,1,3
1372,2,1,4819,4819,4820,0,1,1
1373,1,2,4820,4820,4822,0,2,0
1374,3,3,4823,4823,4826,0,3,1
1375,1,1,4824,4826,4827,2,3,0
1376,5,3,4829,4829,4832,0,3,2
1377,6,1,4835,4835,4836,0,1,3
1378,1,1,4836,4836,4837,0,1,0
1379,3,2,4839,4839,4841,0,2,2
1380,2,2,4841,4841,4843,0,2,0
1381,1,3,4842,4843,4846,1,4,0
1382,2,3,4844,4846,4849,2,5,0
1383,3,3,4847,4849,4852,2,5,0
1384,3,2,4850,4852,4854,2,4,0
1385,4,1,4854,4854,4855,0,1,0
1386,5,3,4859,4859,4862,0,3,4
1387,5,3,4864,4864,4867,0,3,2
1388,2,3,4866,4867,4870,1,4,0
1389,3,2,4869,4870,4872,1,3,0
1390,1,3,4870,4872,4875,2,5,0
1391,2,2,4872,4875,4877,3,5,0
1392,2,2,4874,4877,4879,3,5,0
1393,4,1,4878,4879,4880,1,2,0
1394,1,2,4879,4880,4882,1,3,0
1395,1,3,4880,4882,4885,2,5,0
1396,3,1,4883,4885,4886,2,3,0
1397,1,1,4884,4886,4887,2,3,0
1398,6,3,4890,4890,4893,0,3,3
1399,6,2,4896,4896,4898,0,2,3
1400,6,1,4902,4902,4903,0,1,4
1401,2,3,4904,4904,4907,0,3,1
1402,1,1,4905,4907,4908,2,3,0
1403,4,2,4909,4909,4911,0,2,1
1404,4,2,4913,4913,4915,0,2,2
1405,5,3,4918,4918,4921,0,3,3
1406,1,2,4919,4921,4923,2,4,0
1407,4,2,4923,4923,4925,0,2,0
1408,5,2,4928,4928,4930,0,2,3
1409,3,3,4931,4931,4934,0,3,1
1410,4,3,4935,4935,4938,0,3,1
1411,4,3,4939,4939,4942,0,3,1
1412,6,1,4945,4945,4946,0,1,3
1413,6,1,4951,4951,4952,0,1,5
1414,6,2,4957,4957,4959,0,2,5
1415,4,3,4961,4961,4964,0,3,2
1416,6,2,4967,4967,4969,0,2,3
1417,1,2,4968,4969,4971,1,3,0
1418,3,2,4971,4971,4973,0,2,0
1419,6,3,4977,4977,4980,0,3,4
1420,1,3,4978,4980,4983,2,5,0
1421,5,3,4983,4983,4986,0,3,0
1422,6,1,4989,4989,4990,0,1,3
1423,2,1,4991,4991,4992,0,1,1
1424,2,3,4993,4993,4996,0,3,1
1425,6,2,4999,4999,5001,0,2,3
1426,5,3,5004,5004,5007,0,3,3
1427,2,2,5006,5007,5009,1,3,0
1428,4,3,5010,5010,5013,0,3,1
1429,2,3,5012,5013,5016,1,4,0
1430,4,2,5016,5016,5018,0,2,0
1431,1,3,5017,5018,5021,1,4,0
1432,2,2,5019,5021,5023,2,4,0
1433,1,3,5020,5023,5026,3,6,0
1434,4,1,5024,5026,5027,2,3,0
1435,2,2,5026,5027,5029,1,3,0
1436,5,1,5031,5031,5032,0,1,2
1437,2,1,5033,5033,5034,0,1,1
1438,4,3,5037,5037,5040,0,3,3
1439,4,3,5041,5041,5044,0,3,1
1440,1,3,5042,5044,5047,2,5,0
1441,5,2,5047,5047,5049,0,2,0
1442,2,1,5049,5049,5050,0,1,0
1443,4,2,5053,5053,5055,0,2,3
1444,3,2,5056,5056,5058,0,2,1
1445,3,2,5059,5059,5061,0,2,1
1446,5,2,5064,5064,5066,0,2,3
1447,4,3,5068,5068,5071,0,3,2
1448,4,1,5072,5072,5073,0,1,1
1449,2,2,5074,5074,5076,0,2,1
1450,4,2,5078,5078,5080,0,2,2
1451,4,1,5082,5082,5083,0,1,2
1452,1,2,5083,5083,5085,0,2,0
1453,6,3,5089,5089,5092,0,3,4
1454,4,1,5093,5093,5094,0,1,1
1455,1,2,5094,5094,5096,0,2,0
1456,6,2,5100,5100,5102,0,2,4
1457,5,1,5105,5105,5106,0,1,3
1458,5,2,5110,5110,5112,0,2,4
1459,5,3,5115,5115,5118,0,3,3
1460,4,3,5119,5119,5122,0,3,1
1461,3,2,5122,5122,5124,0,2,0
1462,4,2,5126,5126,5128,0,2,2
1463,2,2,5128,5128,5130,0,2,0
1464,2,1,5130,5130,5131,0,1,0
1465,5,1,5135,5135,5136,0,1,4
1466,5,3,5140,5140,5143,0,3,4
1467,4,2,5144,5144,5146,0,2,1
1468,4,3,5148,5148,5151,0,3,2
1469,5,3,5153,5153,5156,0,3,2
1470,2,2,5155,5156,5158,1,3,0
1471,4,3,5159,5159,5162,0,3,1
1472,5,1,5164,5164,5165,0,1,2
1473,4,2,5168,5168,5170,0,2,3
1474,6,1,5174,5174,5175,0,1,4
1475,6,3,5180,5180,5183,0,3,5
1476,1,1,5181,5183,5184,2,3,0
1477,5,3,5186,5186,5189,0,3,2
1478,5,3,5191,5191,5194,0,3,2
1479,4,3,5195,5195,5198,0,3,1
1480,5,3,5200,5200,5203,0,3,2
1481,5,2,5205,5205,5207,0,2,2
1482,3,1,5208,5208,5209,0,1,1
1483,1,1,5209,5209,5210,0,1,0
1484,4,2,5213,5213,5215,0,2,3
1485,4,3,5217,5217,5220,0,3,2
1486,2,1,5219,5220,5221,1,2,0
1487,2,1,5221,5221,5222,0,1,0
1488,2,3,5223,5223,5226,0,3,1
1489,3,1,5226,5226,5227,0,1,0
1490,2,2,5228,5228,5230,0,2,1
1491,3,1,5231,5231,5232,0,1,1
1492,2,1,5233,5233,5234,0,1,1
1493,4,3,5237,5237,5240,0,3,3
1494,5,2,5242,5242,5244,0,2,2
1495,2,2,5244,5244,5246,0,2,0
1496,2,2,5246,5246,5248,0,2,0
1497,4,1,5250,5250,5251,0,1,2
1498,6,2,5256,5256,5258,0,2,5
1499,1,3,5257,5258,5261,1,4,0
1500,2,2,5259,5261,5263,2,4,0
1501,1,2,5260,5263,5265,3,5,0
1502,2,1,5262,5265,5266,3,4,0
1503,6,1,5268,5268,5269,0,1,2
1504,2,1,5270,5270,5271,0,1,1
1505,2,3,5272,5272,5275,0,3,1
1506,3,1,5275,5275,5276,0,1,0
1507,2,3,5277,5277,5280,0,3,1
1508,5,3,5282,5282,5285,0,3,2
1509,5,1,5287,5287,5288,0,1,2
1510,4,1,5291,5291,5292,0,1,3
1511,4,2,5295,5295,5297,0,2,3
1512,5,3,5300,5300,5303,0,3,3
1513,1,3,5301,5303,5306,2,5,0
1514,2,1,5303,5306,5307,3,4,0
1515,1,2,5304,5307,5309,3,5,0
1516,2,3,5306,5309,5312,3,6,0
1517,2,1,5308,5312,5313,4,5,0
1518,6,2,5314,5314,5316,0,2,1
1519,1,3,5315,5316,5319,1,4,0
1520,6,2,5321,5321,5323,0,2,2
1521,2,2,5323,5323,5325,0,2,0
1522,6,1,5329,5329,5330,0,1,4
1523,1,1,5330,5330,5331,0,1,0
1524,4,3,5334,5334,5337,0,3,3
1525,4,1,5338,5338,5339,0,1,1
1526,6,2,5344,5344,5346,0,2,5
1527,5,2,5349,5349,5351,0,2,3
1528,6,2,5355,5355,5357,0,2,4
1529,5,3,5360,5360,5363,0,3,3
1530,2,3,5362,5363,5366,1,4,0
1531,1,2,5363,5366,5368,3,5,0
1532,3,2,5366,5368,5370,2,4,0
1533,2,3,5368,5370,5373,2,5,0
1534,5,2,5373,5373,5375,0,2,0
1535,5,1,5378,5378,5379,0,1,3
1536,4,3,5382,5382,5385,0,3,3
1537,4,3,5386,5386,5389,0,3,1
1538,3,2,5389,5389,5391,0,2,0
1539,2,3,5391,5391,5394,0,3,0
1540,2,2,5393,5394,5396,1,3,0
1541,3,3,5396,5396,5399,0,3,0
1542,2,2,5398,5399,5401,1,3,0
1543,4,2,5402,5402,5404,0,2,1
1544,3,2,5405,5405,5407,0,2,1
1545,3,3,5408,5408,5411,0,3,1
1546,6,3,5414,5414,5417,0,3,3
1547,6,2,5420,5420,5422,0,2,3
1548,2,1,5422,5422,5423,0,1,0
1549,2,1,5424,5424,5425,0,1,1
1550,1,1,5425,5425,5426,0,1,0
1551,2,2,5427,5427,5429,0,2,1
1552,5,2,5432,5432,5434,0,2,3
1553,5,1,5437,5437,5438,0,1,3
1554,2,1,5439,5439,5440,0,1,1
1555,6,2,5445,5445,5447,0,2,5
1556,1,3,5446,5447,5450,1,4,0
1557,1,1,5447,5450,5451,3,4,0
1558,5,3,5452,5452,5455,0,3,1
1559,6,2,5458,5458,5460,0,2,3
1560,1,2,5459,5460,5462,1,3,0
1561,2,2,5461,5462,5464,1,3,0
1562,1,2,5462,5464,5466,2,4,0
1563,6,1,5468,5468,5469,0,1,2
1564,6,1,5474,5474,5475,0,1,5
1565,3,2,5477,5477,5479,0,2,2
1566,4,1,5481,5481,5482,0,1,2
1567,1,3,5482,5482,5485,0,3,0
1568,5,1,5487,5487,5488,0,1,2
1569,4,2,5491,5491,5493,0,2,3
1570,3,2,5494,5494,5496,0,2,1
1571,4,1,5498,5498,5499,0,1,2
1572,3,3,5501,5501,5504,0,3,2
1573,1,1,5502,5504,5505,2,3,0
1574,6,2,5508,5508,5510,0,2,3
1575,6,3,5514,5514,5517,0,3,4
1576,6,2,5520,5520,5522,0,2,3
1577,4,3,5524,5524,5527,0,3,2
1578,4,2,5528,5528,5530,0,2,1
1579,5,1,5533,5533,5534,0,1,3
1580,2,1,5535,5535,5536,0,1,1
1581,1,2,5536,5536,5538,0,2,0
1582,1,2,5537,5538,5540,1,3,0
1583,3,2,5540,5540,5542,0,2,0
1584,2,3,5542,5542,5545,0,3,0
1585,3,3,5545,5545,5548,0,3,0
1586,6,2,5551,5551,5553,0,2,3
1587,2,2,5553,5553,5555,0,2,0
1588,3,2,5556,5556,5558,0,2,1
1589,1,2,5557,5558,5560,1,3,0
1590,6,2,5563,5563,5565,0,2,3
1591,5,2,5568,5568,5570,0,2,3
1592,1,2,5569,5570,5572,1,3,0
1593,2,2,5571,5572,5574,1,3,0
1594,1,1,5572,5574,5575,2,3,0
1595,4,2,5576,5576,5578,0,2,1
1596,1,2,5577,5578,5580,1,3,0
1597,2,1,5579,5580,5581,1,2,0
1598,2,1,5581,5581,5582,0,1,0
1599,6,3,5587,5587,5590,0,3,5
1600,4,3,5591,5591,5594,0,3,1
1601,4,1,5595,5595,5596,0,1,1
1602,4,2,5599,5599,5601,0,2,3
1603,5,1,5604,5604,5605,0,1,3
1604,5,3,5609,5609,5612,0,3,4
1605,6,1,5615,5615,5616,0,1,3
1606,4,3,5619,5619,5622,0,3,3
1607,5,2,5624,5624,5626,0,2,2
1608,6,2,5630,5630,5632,0,2,4
1609,2,1,5632,5632,5633,0,1,0
1610,3,3,5635,5635,5638,0,3,2
1611,2,1,5637,5638,5639,1,2,0
1612,6,3,5643,5643,5646,0,3,4
1613,5,2,5648,5648,5650,0,2,2
1614,4,3,5652,5652,5655,0,3,2
1615,6,2,5658,5658,5660,0,2,3
1616,6,3,5664,5664,5667,0,3,4
1617,3,3,5667,5667,5670,0,3,0
1618,1,2,5668,5670,5672,2,4,0
1619,2,1,5670,5672,5673,2,3,0
1620,4,3,5674,5674,5677,0,3,1
1621,2,2,5676,5677,5679,1,3,0
1622,1,1,5677,5679,5680,2,3,0
1623,1,2,5678,5680,5682,2,4,0
1624,2,1,5680,5682,5683,2,3,0
1625,3,3,5683,5683,5686,0,3,0
1626,4,2,5687,5687,5689,0,2,1
1627,1,2,5688,5689,5691,1,3,0
1628,2,1,5690,5691,5692,1,2,0
1629,5,1,5695,5695,5696,0,1,3
1630,2,2,5697,5697,5699,0,2,1
1631,3,3,5700,5700,5703,0,3,1
1632,6,3,5706,5706,5709,0,3,3
1633,3,2,5709,5709,5711,0,2,0
1634,3,1,5712,5712,5713,0,1,1
1635,2,2,5714,5714,5716,0,2,1
1636,4,2,5718,5718,5720,0,2,2
1637,3,1,5721,5721,5722,0,1,1
1638,5,2,5726,5726,5728,0,2,4
1639,1,2,5727,5728,5730,1,3,0
1640,5,2,5732,5732,5734,0,2,2
1641,2,1,5734,5734,5735,0,1,0
1642,4,1,5738,5738,5739,0,1,3
1643,6,3,5744,5744,5747,0,3,5
1644,2,2,5746,5747,5749,1,3,0
1645,6,3,5752,5752,5755,0,3,3
1646,4,1,5756,5756,5757,0,1,1
1647,1,3,5757,5757,5760,0,3,0
1648,6,1,5763,5763,5764,0,1,3
1649,1,3,5764,5764,5767,0,3,0
1650,5,2,5769,5769,5771,0,2,2
1651,6,2,5775,5775,5777,0,2,4
1652,2,1,5777,5777,5778,0,1,0
1653,1,1,5778,5778,5779,0,1,0
1654,6,1,5784,5784,5785,0,1,5
1655,3,3,5787,5787,5790,0,3,2
1656,4,2,5791,5791,5793,0,2,1
1657,2,2,5793,5793,5795,0,2,0
1658,4,2,5797,5797,5799,0,2,2
1659,6,1,5803,5803,5804,0,1,4
1660,6,2,5809,5809,5811,0,2,5
1661,2,1,5811,5811,5812,0,1,0
1662,1,2,5812,5812,5814,0,2,0
1663,1,1,5813,5814,5815,1,2,0
1664,3,2,5816,5816,5818,0,2,1
1665,1,3,5817,5818,5821,1,4,0
1666,1,3,5818,5821,5824,3,6,0
1667,2,1,5820,5824,5825,4,5,0
1668,6,3,5826,5826,5829,0,3,1
1669,2,3,5828,5829,5832,1,4,0
1670,4,3,5832,5832,5835,0,3,0
1671,5,1,5837,5837,5838,0,1,2
1672,1,1,5838,5838,5839,0,1,0
1673,4,3,5842,5842,5845,0,3,3
1674,5,3,5847,5847,5850,0,3,2
1675,1,1,5848,5850,5851,2,3,0
1676,5,2,5853,5853,5855,0,2,2
1677,5,2,5858,5858,5860,0,2,3
1678,2,3,5860,5860,5863,0,3,0
1679,4,2,5864,5864,5866,0,2,1
1680,2,1,5866,5866,5867,0,1,0
1681,1,1,5867,5867,5868,0,1,0
1682,6,3,5873,5873,5876,0,3,5
1683,1,3,5874,5876,5879,2,5,0
1684,4,2,5878,5879,5881,1,3,0
1685,4,3,5882,5882,5885,0,3,1
1686,1,3,5883,5885,5888,2,5,0
1687,2,1,5885,5888,5889,3,4,0
1688,4,2,5889,5889,5891,0,2,0
1689,6,3,5895,5895,5898,0,3,4
1690,5,1,5900,5900,5901,0,1,2
1691,5,2,5905,5905,5907,0,2,4
1692,3,2,5908,5908,5910,0,2,1
1693,5,2,5913,5913,5915,0,2,3
1694,2,3,5915,5915,5918,0,3,0
1695,3,2,5918,5918,5920,0,2,0
1696,2,2,5920,5920,5922,0,2,0
1697,5,1,5925,5925,5926,0,1,3
1698,5,1,5930,5930,5931,0,1,4
1699,2,2,5932,5932,5934,0,2,1
1700,1,1,5933,5934,5935,1,2,0
1701,6,3,5939,5939,5942,0,3,4
1702,4,1,5943,5943,5944,0,1,1
1703,5,3,5948,5948,5951,0,3,4
1704,1,3,5949,5951,5954,2,5,0
1705,2,2,5951,5954,5956,3,5,0
1706,5,1,5956,5956,5957,0,1,0
1707,1,2,5957,5957,5959,0,2,0
1708,2,1,5959,5959,5960,0,1,0
1709,3,1,5962,5962,5963,0,1,2
1710,5,2,5967,5967,5969,0,2,4
1711,3,1,5970,5970,5971,0,1,1
1712,1,3,5971,5971,5974,0,3,0
1713,3,2,5974,5974,5976,0,2,0
1714,2,2,5976,5976,5978,0,2,0
1715,5,3,5981,5981,5984,0,3,3
1716,2,2,5983,5984,5986,1,3,0
1717,1,2,5984,5986,5988,2,4,0
1718,3,3,5987,5988,5991,1,4,0
1719,5,1,5992,5992,5993,0,1,1
1720,1,3,5993,5993,5996,0,3,0
1721,1,2,5994,5996,5998,2,4,0
1722,1,2,5995,5998,6000,3,5,0
1723,3,2,5998,6000,6002,2,4,0
1724,3,1,6001,6002,6003,1,2,0
1725,2,2,6003,6003,6005,0,2,0
1726,6,1,6009,6009,6010,0,1,4
1727,5,2,6014,6014,6016,0,2,4
1728,6,3,6020,6020,6023,0,3,4
1729,5,3,6025,6025,6028,0,3,2
1730,6,1,6031,6031,6032,0,1,3
1731,6,2,6037,6037,6039,0,2,5
1732,6,3,6043,6043,6046,0,3,4
1733,6,2,6049,6049,6051,0,2,3
1734,1,2,6050,6051,6053,1,3,0
1735,2,2,6052,6053,6055,1,3,0
1736,5,1,6057,6057,6058,0,1,2
1737,1,1,6058,6058,6059,0,1,0
1738,4,2,6062,6062,6064,0,2,3
1739,5,1,6067,6067,6068,0,1,3
1740,1,1,6068,6068,6069,0,1,0
1741,2,1,6070,6070,6071,0,1,1
1742,5,1,6075,6075,6076,0,1,4
1743,2,3,6077,6077,6080,0,3,1
1744,2,1,6079,6080,6081,1,2,0
1745,3,2,6082,6082,6084,0,2,1
1746,5,1,6087,6087,6088,0,1,3
1747,2,1,6089,6089,6090,0,1,1
1748,4,1,6093,6093,6094,0,1,3
1749,4,3,6097,6097,6100,0,3,3
1750,5,1,6102,6102,6103,0,1,2
1751,3,1,6105,6105,6106,0,1,2
1752,1,1,6106,6106,6107,0,1,0
1753,3,1,6109,6109,6110,0,1,2
1754,4,1,6113,6113,6114,0,1,3
1755,2,3,6115,6115,6118,0,3,1
1756,5,1,6120,6120,6121,0,1,2
1757,1,1,6121,6121,6122,0,1,0
1758,2,2,6123,6123,6125,0,2,1
1759,6,1,6129,6129,6130,0,1,4
1760,1,1,6130,6130,6131,0,1,0
1761,5,2,6135,6135,6137,0,2,4
1762,5,2,6140,6140,6142,0,2,3
1763,3,3,6143,6143,6146,0,3,1
1764,6,1,6149,6149,6150,0,1,3
1765,5,2,6154,6154,6156,0,2,4
1766,6,1,6160,6160,6161,0,1,4
1767,6,3,6166,6166,6169,0,3,5
1768,4,3,6170,6170,6173,0,3,1
1769,4,2,6174,6174,6176,0,2,1
1770,6,3,6180,6180,6183,0,3,4
1771,3,1,6183,6183,6184,0,1,0
1772,4,1,6187,6187,6188,0,1,3
1773,4,2,6191,6191,6193,0,2,3
1774,6,3,6197,6197,6200,0,3,4
1775,3,3,6200,6200,6203,0,3,0
1776,1,1,6201,6203,6204,2,3,0
1777,1,2,6202,6204,6206,2,4,0
1778,4,3,6206,6206,6209,0,3,0
1779,1,1,6207,6209,6210,2,3,0
1780,1,3,6208,6210,6213,2,5,0
1781,5,2,6213,6213,6215,0,2,0
1782,3,3,6216,6216,6219,0,3,1
1783,6,1,6222,6222,6223,0,1,3
1784,1,1,6223,6223,6224,0,1,0
1785,6,2,6229,6229,6231,0,2,5
1786,4,1,6233,6233,6234,0,1,2
1787,3,2,6236,6236,6238,0,2,2
1788,4,1,6240,6240,6241,0,1,2
1789,2,2,6242,6242,6244,0,2,1
1790,3,3,6245,6245,6248,0,3,1
1791,1,2,6246,6248,6250,2,4,0
1792,1,1,6247,6250,6251,3,4,0
1793,4,1,6251,6251,6252,0,1,0
1794,5,3,6256,6256,6259,0,3,4
1795,4,3,6260,6260,6263,0,3,1
1796,4,3,6264,6264,6267,0,3,1
1797,3,3,6267,6267,6270,0,3,0
1798,2,1,6269,6270,6271,1,2,0
1799,2,1,6271,6271,6272,0,1,0
1800,4,2,6275,6275,6277,0,2,3
1801,2,2,6277,6277,6279,0,2,0
1802,1,3,6278,6279,6282,1,4,0
1803,2,3,6280,6282,6285,2,5,0
1804,1,3,6281,6285,6288,4,7,0
1805,4,1,6285,6288,6289,3,4,0
1806,5,3,6290,6290,6293,0,3,1
1807,3,2,6293,6293,6295,0,2,0
1808,4,1,6297,6297,6298,0,1,2
1809,5,3,6302,6302,6305,0,3,4
1810,6,2,6308,6308,6310,0,2,3
1811,4,1,6312,6312,6313,0,1,2
1812,1,1,6313,6313,6314,0,1,0
1813,2,2,6315,6315,6317,0,2,1
1814,3,1,6318,6318,6319,0,1,1
1815,5,3,6323,6323,6326,0,3,4
1816,1,2,6324,6326,6328,2,4,0
1817,5,3,6329,6329,6332,0,3,1
1818,3,1,6332,6332,6333,0,1,0
1819,6,1,6338,6338,6339,0,1,5
1820,4,1,6342,6342,6343,0,1,3
1821,3,3,6345,6345,6348,0,3,2
1822,2,2,6347,6348,6350,1,3,0
1823,2,1,6349,6350,6351,1,2,0
1824,5,1,6354,6354,6355,0,1,3
1825,4,3,6358,6358,6361,0,3,3
1826,1,3,6359,6361,6364,2,5,0
1827,5,3,6364,6364,6367,0,3,0
1828,4,1,6368,6368,6369,0,1,1
1829,2,3,6370,6370,6373,0,3,1
1830,4,2,6374,6374,6376,0,2,1
1831,5,1,6379,6379,6380,0,1,3
1832,3,1,6382,6382,6383,0,1,2
1833,1,1,6383,6383,6384,0,1,0
1834,4,3,6387,6387,6390,0,3,3
1835,2,3,6389,6390,6393,1,4,0
1836,2,1,6391,6393,6394,2,3,0
1837,4,3,6395,6395,6398,0,3,1
1838,1,1,6396,6398,6399,2,3,0
1839,2,3,6398,6399,6402,1,4,0
1840,4,3,6402,6402,6405,0,3,0
1841,6,1,6408,6408,6409,0,1,3
1842,4,2,6412,6412,6414,0,2,3
1843,2,1,6414,6414,6415,0,1,0
1844,1,2,6415,6415,6417,0,2,0
1845,3,2,6418,6418,6420,0,2,1
1846,2,2,6420,6420,6422,0,2,0
1847,5,3,6425,6425,6428,0,3,3
1848,1,3,6426,6428,6431,2,5,0
1849,3,1,6429,6431,6432,2,3,0
1850,4,1,6433,6433,6434,0,1,1
1851,2,3,6435,6435,6438,0,3,1
1852,2,3,6437,6438,6441,1,4,0
1853,4,3,6441,6441,6444,0,3,0
1854,2,2,6443,6444,6446,1,3,0
1855,1,3,6444,6446,6449,2,5,0
1856,2,3,6446,6449,6452,3,6,0
1857,3,1,6449,6452,6453,3,4,0
1858,2,3,6451,6453,6456,2,5,0
1859,5,2,6456,6456,6458,0,2,0
1860,6,1,6462,6462,6463,0,1,4
1861,1,2,6463,6463,6465,0,2,0
1862,5,3,6468,6468,6471,0,3,3
1863,3,2,6471,6471,6473,0,2,0
1864,1,2,6472,6473,6475,1,3,0
1865,4,3,6476,6476,6479,0,3,1
1866,4,3,6480,6480,6483,0,3,1
1867,5,1,6485,6485,6486,0,1,2
1868,1,2,6486,6486,6488,0,2,0
1869,4,1,6490,6490,6491,0,1,2
1870,2,3,6492,6492,6495,0,3,1
1871,6,1,6498,6498,6499,0,1,3
1872,5,1,6503,6503,6504,0,1,4
1873,1,1,6504,6504,6505,0,1,0
1874,2,1,6506,6506,6507,0,1,1
1875,3,1,6509,6509,6510,0,1,2
1876,3,1,6512,6512,6513,0,1,2
1877,3,2,6515,6515,6517,0,2,2
1878,3,1,6518,6518,6519,0,1,1
1879,5,2,6523,6523,6525,0,2,4
1880,5,1,6528,6528,6529,0,1,3
1881,4,3,6532,6532,6535,0,3,3
1882,6,1,6538,6538,6539,0,1,3
1883,1,2,6539,6539,6541,0,2,0
1884,2,1,6541,6541,6542,0,1,0
1885,2,1,6543,6543,6544,0,1,1
1886,5,3,6548,6548,6551,0,3,4
1887,4,2,6552,6552,6554,0,2,1
1888,2,3,6554,6554,6557,0,3,0
1889,1,2,6555,6557,6559,2,4,0
1890,5,3,6560,6560,6563,0,3,1
1891,6,1,6566,6566,6567,0,1,3
1892,2,2,6568,6568,6570,0,2,1
1893,5,2,6573,6573,6575,0,2,3
1894,5,2,6578,6578,6580,0,2,3
1895,5,2,6583,6583,6585,0,2,3
1896,2,1,6585,6585,6586,0,1,0
1897,1,2,6586,6586,6588,0,2,0
1898,4,3,6590,6590,6593,0,3,2
1899,4,3,6594,6594,6597,0,3,1
1900,2,3,6596,6597,6600,1,4,0
1901,4,1,6600,6600,6601,0,1,0
1902,3,1,6603,6603,6604,0,1,2
1903,1,2,6604,6604,6606,0,2,0
1904,5,2,6609,6609,6611,0,2,3
1905,6,1,6615,6615,6616,0,1,4
1906,2,3,6617,6617,6620,0,3,1
1907,3,3,6620,6620,6623,0,3,0
1908,5,3,6625,6625,6628,0,3,2
1909,4,3,6629,6629,6632,0,3,1
1910,1,1,6630,6632,6633,2,3,0
1911,3,1,6633,6633,6634,0,1,0
1912,2,3,6635,6635,6638,0,3,1
1913,4,2,6639,6639,6641,0,2,1
1914,2,1,6641,6641,6642,0,1,0
1915,2,2,6643,6643,6645,0,2,1
1916,4,1,6647,6647,6648,0,1,2
1917,4,3,6651,6651,6654,0,3,3
1918,1,3,6652,6654,6657,2,5,0
1919,3,2,6655,6657,6659,2,4,0
1920,4,3,6659,6659,6662,0,3,0
1921,2,3,6661,6662,6665,1,4,0
1922,1,1,6662,6665,6666,3,4,0
1923,6,1,6668,6668,6669,0,1,2
1924,2,2,6670,6670,6672,0,2,1
1925,5,3,6675,6675,6678,0,3,3
1926,6,2,6681,6681,6683,0,2,3
1927,5,1,6686,6686,6687,0,1,3
1928,3,3,6689,6689,6692,0,3,2
1929,5,2,6694,6694,6696,0,2,2
1930,5,2,6699,6699,6701,0,2,3
1931,1,2,6700,6701,6703,1,3,0
1932,6,3,6706,6706,6709,0,3,3
1933,5,2,6711,6711,6713,0,2,2
1934,5,1,6716,6716,6717,0,1,3
1935,4,3,6720,6720,6723,0,3,3
1936,4,3,6724,6724,6727,0,3,1
1937,6,2,6730,6730,6732,0,2,3
1938,2,2,6732,6732,6734,0,2,0
1939,2,2,6734,6734,6736,0,2,0
1940,3,1,6737,6737,6738,0,1,1
1941,2,3,6739,6739,6742,0,3,1
1942,2,1,6741,6742,6743,1,2,0
1943,3,1,6744,6744,6745,0,1,1
1944,1,2,6745,6745,6747,0,2,0
1945,2,3,6747,6747,6750,0,3,0
1946,5,1,6752,6752,6753,0,1,2
1947,4,1,6756,6756,6757,0,1,3
1948,3,3,6759,6759,6762,0,3,2
1949,5,3,6764,6764,6767,0,3,2
1950,5,1,6769,6769,6770,0,1,2
1951,6,3,6775,6775,6778,0,3,5
1952,2,2,6777,6778,6780,1,3,0
1953,4,3,6781,6781,6784,0,3,1
1954,4,1,6785,6785,6786,0,1,1
1955,3,3,6788,6788,6791,0,3,2
1956,5,3,6793,6793,6796,0,3,2
1957,4,2,6797,6797,6799,0,2,1
1958,5,1,6802,6802,6803,0,1,3
1959,3,3,6805,6805,6808,0,3,2
1960,6,2,6811,6811,6813,0,2,3
1961,5,2,6816,6816,6818,0,2,3
1962,4,2,6820,6820,6822,0,2,2
1963,1,1,6821,6822,6823,1,2,0
1964,6,2,6827,6827,6829,0,2,4
1965,3,1,6830,6830,6831,0,1,1
1966,2,2,6832,6832,6834,0,2,1
1967,2,3,6834,6834,6837,0,3,0
1968,2,2,6836,6837,6839,1,3,0
1969,6,2,6842,6842,6844,0,2,3
1970,4,3,6846,6846,6849,0,3,2
1971,3,3,6849,6849,6852,0,3,0
1972,1,1,6850,6852,6853,2,3,0
1973,4,2,6854,6854,6856,0,2,1
1974,4,2,6858,6858,6860,0,2,2
1975,6,1,6864,6864,6865,0,1,4
1976,5,3,6869,6869,6872,0,3,4
1977,4,3,6873,6873,6876,0,3,1
1978,2,1,6875,6876,6877,1,2,0
1979,1,2,6876,6877,6879,1,3,0
1980,6,1,6882,6882,6883,0,1,3
1981,3,3,6885,6885,6888,0,3,2
1982,2,3,6887,6888,6891,1,4,0
1983,6,1,6893,6893,6894,0,1,2
1984,3,3,6896,6896,6899,0,3,2
1985,3,3,6899,6899,6902,0,3,0
1986,4,3,6903,6903,6906,0,3,1
1987,6,1,6909,6909,6910,0,1,3
1988,3,3,6912,6912,6915,0,3,2
1989,2,2,6914,6915,6917,1,3,0
1990,6,1,6920,6920,6921,0,1,3
1991,2,3,6922,6922,6925,0,3,1
1992,1,2,6923,6925,6927,2,4,0
1993,2,1,6925,6927,6928,2,3,0
1994,1,3,6926,6928,6931,2,5,0
1995,1,3,6927,6931,6934,4,7,0
1996,4,1,6931,6934,6935,3,4,0
1997,3,3,6934,6935,6938,1,4,0
1998,2,1,6936,6938,6939,2,3,0
1999,6,2,6942,6942,6944,0,2,3
2000,4,3,6946,6946,6949,0,3,2
2001,4,2,6950,6950,6952,0,2,1
2002,1,2,6951,6952,6954,1,3,0
2003,5,1,6956,6956,6957,0,1,2
2004,3,3,6959,6959,6962,0,3,2
2005,6,2,6965,6965,6967,0,2,3
2006,4,1,6969,6969,6970,0,1,2
2007,4,1,6973,6973,6974,0,1,3
2008,4,2,6977,6977,6979,0,2,3
2009,4,3,6981,6981,6984,0,3,2
2010,6,3,6987,6987,6990,0,3,3
2011,5,3,6992,6992,6995,0,3,2
2012,4,2,6996,6996,6998,0,2,1
2013,6,2,7002,7002,7004,0,2,4
2014,1,1,7003,7004,7005,1,2,0
2015,2,3,7005,7005,7008,0,3,0
2016,4,1,7009,7009,7010,0,1,1
2017,2,2,7011,7011,7013,0,2,1
2018,6,2,7017,7017,7019,0,2,4
2019,3,3,7020,7020,7023,0,3,1
2020,5,3,7025,7025,7028,0,3,2
2021,1,2,7026,7028,7030,2,4,0
2022,4,1,7030,7030,7031,0,1,0
2023,6,1,7036,7036,7037,0,1,5
2024,1,1,7037,7037,7038,0,1,0
2025,2,1,7039,7039,7040,0,1,1
2026,5,3,7044,7044,7047,0,3,4
2027,6,2,7050,7050,7052,0,2,3
2028,6,1,7056,7056,7057,0,1,4
2029,4,3,7060,7060,7063,0,3,3
2030,3,1,7063,7063,7064,0,1,0
2031,4,1,7067,7067,7068,0,1,3
2032,3,2,7070,7070,7072,0,2,2
2033,2,1,7072,7072,7073,0,1,0
2034,2,3,7074,7074,7077,0,3,1
2035,1,2,7075,7077,7079,2,4,0
2036,3,3,7078,7079,7082,1,4,0
2037,4,2,7082,7082,7084,0,2,0
2038,3,2,7085,7085,7087,0,2,1
2039,1,2,7086,7087,7089,1,3,0
2040,1,1,7087,7089,7090,2,3,0
2041,3,2,7090,7090,7092,0,2,0
2042,4,1,7094,7094,7095,0,1,2
2043,1,1,7095,7095,7096,0,1,0
2044,4,1,7099,7099,7100,0,1,3
2045,4,3,7103,7103,7106,0,3,3
2046,2,1,7105,7106,7107,1,2,0
2047,2,1,7107,7107,7108,0,1,0
2048,3,1,7110,7110,7111,0,1,2
2049,1,2,7111,7111,7113,0,2,0
2050,6,1,7117,7117,7118,0,1,4
2051,4,1,7121,7121,7122,0,1,3
2052,3,1,7124,7124,7125,0,1,2
2053,2,1,7126,7126,7127,0,1,1
2054,3,1,7129,7129,7130,0,1,2
2055,4,3,7133,7133,7136,0,3,3
2056,4,3,7137,7137,7140,0,3,1
2057,6,1,7143,7143,7144,0,1,3
2058,2,3,7145,7145,7148,0,3,1
2059,4,2,7149,7149,7151,0,2,1
2060,5,2,7154,7154,7156,0,2,3
2061,3,1,7157,7157,7158,0,1,1
2062,6,3,7163,7163,7166,0,3,5
2063,1,3,7164,7166,7169,2,5,0
2064,2,2,7166,7169,7171,3,5,0
2065,2,1,7168,7171,7172,3,4,0
2066,2,3,7170,7172,7175,2,5,0
2067,1,3,7171,7175,7178,4,7,0
2068,3,1,7174,7178,7179,4,5,0
2069,4,3,7178,7179,7182,1,4,0
2070,4,2,7182,7182,7184,0,2,0
2071,6,1,7188,7188,7189,0,1,4
2072,2,3,7190,7190,7193,0,3,1
2073,6,3,7196,7196,7199,0,3,3
2074,5,1,7201,7201,7202,0,1,2
2075,3,2,7204,7204,7206,0,2,2
2076,3,3,7207,7207,7210,0,3,1
2077,6,2,7213,7213,7215,0,2,3
2078,1,3,7214,7215,7218,1,4,0
2079,6,3,7220,7220,7223,0,3,2
2080,2,2,7222,7223,7225,1,3,0
2081,2,1,7224,7225,7226,1,2,0
2082,2,3,7226,7226,7229,0,3,0
2083,6,1,7232,7232,7233,0,1,3
2084,5,3,7237,7237,7240,0,3,4
2085,2,3,7239,7240,7243,1,4,0
2086,5,2,7244,7244,7246,0,2,1
2087,5,3,7249,7249,7252,0,3,3
2088,4,1,7253,7253,7254,0,1,1
2089,3,3,7256,7256,7259,0,3,2
2090,6,1,7262,7262,7263,0,1,3
2091,5,1,7267,7267,7268,0,1,4
2092,4,2,7271,7271,7273,0,2,3
2093,2,2,7273,7273,7275,0,2,0
2094,1,2,7274,7275,7277,1,3,0
2095,4,2,7278,7278,7280,0,2,1
2096,1,1,7279,7280,7281,1,2,0
2097,1,1,7280,7281,7282,1,2,0
2098,5,2,7285,7285,7287,0,2,3
2099,5,2,7290,7290,7292,0,2,3
2100,1,3,7291,7292,7295,1,4,0
2101,6,1,7297,7297,7298,0,1,2
2102,3,2,7300,7300,7302,0,2,2
2103,3,1,7303,7303,7304,0,1,1
2104,2,1,7305,7305,7306,0,1,1
2105,3,2,7308,7308,7310,0,2,2
2106,5,1,7313,7313,7314,0,1,3
2107,4,2,7317,7317,7319,0,2,3
2108,5,1,7322,7322,7323,0,1,3
2109,3,2,7325,7325,7327,0,2,2
2110,4,2,7329,7329,7331,0,2,2
2111,2,2,7331,7331,7333,0,2,0
2112,4,2,7335,7335,7337,0,2,2
2113,6,3,7341,7341,7344,0,3,4
2114,1,3,7342,7344,7347,2,5,0
2115,5,3,7347,7347,7350,0,3,0
2116,1,3,7348,7350,7353,2,5,0
2117,5,3,7353,7353,7356,0,3,0
2118,2,3,7355,7356,7359,1,4,0
2119,5,3,7360,7360,7363,0,3,1
2120,6,3,7366,7366,7369,0,3,3
2121,1,3,7367,7369,7372,2,5,0
2122,4,3,7371,7372,7375,1,4,0
2123,4,2,7375,7375,7377,0,2,0
2124,1,2,7376,7377,7379,1,3,0
2125,1,2,7377,7379,7381,2,4,0
2126,1,3,7378,7381,7384,3,6,0
2127,5,1,7383,7384,7385,1,2,0
2128,2,3,7385,7385,7388,0,3,0
2129,5,3,7390,7390,7393,0,3,2
2130,3,2,7393,7393,7395,0,2,0
2131,4,2,7397,7397,7399,0,2,2
2132,2,3,7399,7399,7402,0,3,0
2133,4,2,7403,7403,7405,0,2,1
2134,5,3,7408,7408,7411,0,3,3
2135,1,2,7409,7411,7413,2,4,0
2136,1,3,7410,7413,7416,3,6,0
2137,2,2,7412,7416,7418,4,6,0
2138,5,3,7417,7418,7421,1,4,0
2139,1,2,7418,7421,7423,3,5,0
2140,6,1,7424,7424,7425,0,1,1
2141,4,2,7428,7428,7430,0,2,3
2142,3,3,7431,7431,7434,0,3,1
2143,4,2,7435,7435,7437,0,2,1
2144,6,1,7441,7441,7442,0,1,4
2145,1,3,7442,7442,7445,0,3,0
2146,1,3,7443,7445,7448,2,5,0
2147,4,3,7447,7448,7451,1,4,0
2148,5,1,7452,7452,7453,0,1,1
2149,2,2,7454,7454,7456,0,2,1
2150,3,1,7457,7457,7458,0,1,1
2151,4,3,7461,7461,7464,0,3,3
2152,5,3,7466,7466,7469,0,3,2
2153,2,2,7468,7469,7471,1,3,0
2154,3,1,7471,7471,7472,0,1,0
2155,5,2,7476,7476,7478,0,2,4
2156,4,1,7480,7480,7481,0,1,2
2157,5,2,7485,7485,7487,0,2,4
2158,4,3,7489,7489,7492,0,3,2
2159,6,3,7495,7495,7498,0,3,3
2160,2,3,7497,7498,7501,1,4,0
2161,4,2,7501,7501,7503,0,2,0
2162,3,3,7504,7504,7507,0,3,1
2163,1,2,7505,7507,7509,2,4,0
2164,1,3,7506,7509,7512,3,6,0
2165,4,2,7510,7512,7514,2,4,0
2166,3,3,7513,7514,7517,1,4,0
2167,2,3,7515,7517,7520,2,5,0
2168,5,1,7520,7520,7521,0,1,0
2169,4,2,7524,7524,7526,0,2,3
2170,6,1,7530,7530,7531,0,1,4
2171,2,2,7532,7532,7534,0,2,1
2172,6,3,7538,7538,7541,0,3,4
2173,6,2,7544,7544,7546,0,2,3
2174,3,1,7547,7547,7548,0,1,1
2175,2,3,7549,7549,7552,0,3,1
2176,5,1,7554,7554,7555,0,1,2
2177,2,2,7556,7556,7558,0,2,1
2178,4,2,7560,7560,7562,0,2,2
2179,4,3,7564,7564,7567,0,3,2
2180,6,3,7570,7570,7573,0,3,3
2181,5,1,7575,7575,7576,0,1,2
2182,4,3,7579,7579,7582,0,3,3
2183,4,3,7583,7583,7586,0,3,1
2184,5,3,7588,7588,7591,0,3,2
2185,5,2,7593,7593,7595,0,2,2
2186,3,3,7596,7596,7599,0,3,1
2187,2,2,7598,7599,7601,1,3,0
2188,2,1,7600,7601,7602,1,2,0
2189,4,1,7604,7604,7605,0,1,2
2190,5,3,7609,7609,7612,0,3,4
2191,5,3,7614,7614,7617,0,3,2
2192,3,3,7617,7617,7620,0,3,0
2193,2,2,7619,7620,7622,1,3,0
2194,4,1,7623,7623,7624,0,1,1
2195,4,3,7627,7627,7630,0,3,3
2196,2,2,7629,7630,7632,1,3,0
2197,2,1,7631,7632,7633,1,2,0
2198,2,2,7633,7633,7635,0,2,0
2199,3,1,7636,7636,7637,0,1,1
2200,3,2,7639,7639,7641,0,2,2
2201,5,1,7644,7644,7645,0,1,3
2202,4,2,7648,7648,7650,0,2,3
2203,2,2,7650,7650,7652,0,2,0
2204,5,1,7655,7655,7656,0,1,3
2205,3,3,7658,7658,7661,0,3,2
2206,6,1,7664,7664,7665,0,1,3
2207,3,1,7667,7667,7668,0,1,2
2208,6,2,7673,7673,7675,0,2,5
2209,1,1,7674,7675,7676,1,2,0
2210,6,3,7680,7680,7683,0,3,4
2211,1,2,7681,7683,7685,2,4,0
2212,4,3,7685,7685,7688,0,3,0
2213,3,2,7688,7688,7690,0,2,0
2214,6,3,7694,7694,7697,0,3,4
2215,3,2,7697,7697,7699,0,2,0
2216,6,1,7703,7703,7704,0,1,4
2217,1,3,7704,7704,7707,0,3,0
2218,4,2,7708,7708,7710,0,2,1
2219,3,1,7711,7711,7712,0,1,1
2220,6,1,7717,7717,7718,0,1,5
2221,2,3,7719,7719,7722,0,3,1
2222,5,2,7724,7724,7726,0,2,2
2223,2,3,7726,7726,7729,0,3,0
2224,4,3,7730,7730,7733,0,3,1
2225,1,2,7731,7733,7735,2,4,0
2226,2,3,7733,7735,7738,2,5,0
2227,2,3,7735,7738,7741,3,6,0
2228,6,3,7741,7741,7744,0,3,0
2229,6,2,7747,7747,7749,0,2,3
2230,2,3,7749,7749,7752,0,3,0
2231,2,3,7751,7752,7755,1,4,0
2232,6,1,7757,7757,7758,0,1,2
2233,1,3,7758,7758,7761,0,3,0
2234,4,3,7762,7762,7765,0,3,1
2235,2,2,7764,7765,7767,1,3,0
2236,4,3,7768,7768,7771,0,3,1
2237,4,1,7772,7772,7773,0,1,1
2238,4,3,7776,7776,7779,0,3,3
2239,6,3,7782,7782,7785,0,3,3
2240,2,1,7784,7785,7786,1,2,0
2241,1,3,7785,7786,7789,1,4,0
2242,2,3,7787,7789,7792,2,5,0
2243,2,3,7789,7792,7795,3,6,0
2244,4,3,7793,7795,7798,2,5,0
2245,1,2,7794,7798,7800,4,6,0
2246,3,2,7797,7800,7802,3,5,0
2247,1,2,7798,7802,7804,4,6,0
2248,1,3,7799,7804,7807,5,8,0
2249,4,1,7803,7807,7808,4,5,0
2250,5,1,7808,7808,7809,0,1,0
2251,2,2,7810,7810,7812,0,2,1
2252,3,3,7813,7813,7816,0,3,1
2253,4,3,7817,7817,7820,0,3,1
2254,6,2,7823,7823,7825,0,2,3
2255,5,3,7828,7828,7831,0,3,3
2256,1,1,7829,7831,7832,2,3,0
2257,3,3,7832,7832,7835,0,3,0
2258,2,2,7834,7835,7837,1,3,0
2259,5,1,7839,7839,7840,0,1,2
2260,3,3,7842,7842,7845,0,3,2
2261,1,1,7843,7845,7846,2,3,0
2262,3,1,7846,7846,7847,0,1,0
2263,5,1,7851,7851,7852,0,1,4
2264,6,1,7857,7857,7858,0,1,5
2265,5,1,7862,7862,7863,0,1,4
2266,6,2,7868,7868,7870,0,2,5
2267,6,2,7874,7874,7876,0,2,4
2268,1,3,7875,7876,7879,1,4,0
2269,5,2,7880,7880,7882,0,2,1
2270,3,3,7883,7883,7886,0,3,1
2271,6,2,7889,7889,7891,0,2,3
2272,3,2,7892,7892,7894,0,2,1
2273,6,3,7898,7898,7901,0,3,4
2274,5,2,7903,7903,7905,0,2,2
2275,4,3,7907,7907,7910,0,3,2
2276,6,2,7913,7913,7915,0,2,3
2277,5,1,7918,7918,7919,0,1,3
2278,2,3,7920,7920,7923,0,3,1
2279,5,3,7925,7925,7928,0,3,2
2280,1,3,7926,7928,7931,2,5,0
2281,1,2,7927,7931,7933,4,6,0
2282,4,3,7931,7933,7936,2,5,0
2283,1,2,7932,7936,7938,4,6,0
2284,3,3,7935,7938,7941,3,6,0
2285,4,3,7939,7941,7944,2,5,0
2286,1,2,7940,7944,7946,4,6,0
2287,2,2,7942,7946,7948,4,6,0
2288,4,3,7946,7948,7951,2,5,0
2289,1,2,7947,7951,7953,4,6,0
2290,3,3,7950,7953,7956,3,6,0
2291,5,2,7955,7956,7958,1,3,0
2292,3,2,7958,7958,7960,0,2,0
2293,1,2,7959,7960,7962,1,3,0
2294,2,3,7961,7962,7965,1,4,0
2295,3,2,7964,7965,7967,1,3,0
2296,5,3,7969,7969,7972,0,3,2
2297,2,2,7971,7972,7974,1,3,0
2298,5,3,7976,7976,7979,0,3,2
2299,3,3,7979,7979,7982,0,3,0
2300,1,2,7980,7982,7984,2,4,0
2301,4,3,7984,7984,7987,0,3,0
2302,5,1,7989,7989,7990,0,1,2
2303,5,3,7994,7994,7997,0,3,4
2304,2,3,7996,7997,8000,1,4,0
2305,4,1,8000,8000,8001,0,1,0
2306,2,1,8002,8002,8003,0,1,1
2307,2,1,8004,8004,8005,0,1,1
2308,2,1,8006,8006,8007,0,1,1
2309,4,2,8010,8010,8012,0,2,3
2310,2,2,8012,8012,8014,0,2,0
2311,6,1,8018,8018,8019,0,1,4
2312,5,3,8023,8023,8026,0,3,4
2313,1,3,8024,8026,8029,2,5,0
2314,6,2,8030,8030,8032,0,2,1
2315,5,3,8035,8035,8038,0,3,3
2316,6,2,8041,8041,8043,0,2,3
2317,5,1,8046,8046,8047,0,1,3
2318,3,1,8049,8049,8050,0,1,2
2319,2,3,8051,8051,8054,0,3,1
2320,4,2,8055,8055,8057,0,2,1
2321,2,1,8057,8057,8058,0,1,0
2322,5,3,8062,8062,8065,0,3,4
2323,2,3,8064,8065,8068,1,4,0
2324,4,3,8068,8068,8071,0,3,0
2325,3,3,8071,8071,8074,0,3,0
2326,1,2,8072,8074,8076,2,4,0
2327,2,3,8074,8076,8079,2,5,0
2328,5,2,8079,8079,8081,0,2,0
2329,1,3,8080,8081,8084,1,4,0
2330,3,1,8083,8084,8085,1,2,0
2331,6,1,8089,8089,8090,0,1,4
2332,1,2,8090,8090,8092,0,2,0
2333,1,1,8091,8092,8093,1,2,0
2334,3,1,8094,8094,8095,0,1,1
2335,6,3,8100,8100,8103,0,3,5
2336,1,2,8101,8103,8105,2,4,0
2337,3,2,8104,8105,8107,1,3,0
2338,6,3,8110,8110,8113,0,3,3
2339,3,1,8113,8113,8114,0,1,0
2340,2,2,8115,8115,8117,0,2,1
2341,4,3,8119,8119,8122,0,3,2
2342,4,1,8123,8123,8124,0,1,1
2343,4,2,8127,8127,8129,0,2,3
2344,1,2,8128,8129,8131,1,3,0
2345,1,3,8129,8131,8134,2,5,0
2346,2,3,8131,8134,8137,3,6,0
2347,3,3,8134,8137,8140,3,6,0
2348,2,1,8136,8140,8141,4,5,0
2349,3,1,8139,8141,8142,2,3,0
2350,5,2,8144,8144,8146,0,2,2
2351,3,1,8147,8147,8148,0,1,1
2352,4,2,8151,8151,8153,0,2,3
2353,2,2,8153,8153,8155,0,2,0
2354,2,2,8155,8155,8157,0,2,0
2355,4,1,8159,8159,8160,0,1,2
2356,1,1,8160,8160,8161,0,1,0
2357,2,3,8162,8162,8165,0,3,1
2358,6,3,8168,8168,8171,0,3,3
2359,1,3,8169,8171,8174,2,5,0
2360,6,3,8175,8175,8178,0,3,1
2361,1,3,8176,8178,8181,2,5,0
2362,5,2,8181,8181,8183,0,2,0
2363,3,1,8184,8184,8185,0,1,1
2364,3,1,8187,8187,8188,0,1,2
2365,2,1,8189,8189,8190,0,1,1
2366,1,1,8190,8190,8191,0,1,0
2367,1,1,8191,8191,8192,0,1,0
2368,3,2,8194,8194,8196,0,2,2
2369,1,1,8195,8196,8197,1,2,0
2370,4,2,8199,8199,8201,0,2,2
2371,1,3,8200,8201,8204,1,4,0
2372,6,3,8206,8206,8209,0,3,2
2373,3,2,8209,8209,8211,0,2,0
2374,3,1,8212,8212,8213,0,1,1
2375,6,3,8218,8218,8221,0,3,5
2376,2,1,8220,8221,8222,1,2,0
2377,2,1,8222,8222,8223,0,1,0
2378,1,1,8223,8223,8224,0,1,0
2379,1,1,8224,8224,8225,0,1,0
2380,6,3,8230,8230,8233,0,3,5
2381,2,3,8232,8233,8236,1,4,0
2382,4,1,8236,8236,8237,0,1,0
2383,1,3,8237,8237,8240,0,3,0
2384,4,2,8241,8241,8243,0,2,1
2385,1,1,8242,8243,8244,1,2,0
2386,4,3,8246,8246,8249,0,3,2
2387,2,2,8248,8249,8251,1,3,0
2388,4,1,8252,8252,8253,0,1,1
2389,5,2,8257,8257,8259,0,2,4
2390,6,1,8263,8263,8264,0,1,4
2391,1,3,8264,8264,8267,0,3,0
2392,6,1,8270,8270,8271,0,1,3
2393,5,2,8275,8275,8277,0,2,4
2394,6,1,8281,8281,8282,0,1,4
2395,6,3,8287,8287,8290,0,3,5
2396,6,1,8293,8293,8294,0,1,3
2397,1,1,8294,8294,8295,0,1,0
2398,6,3,8300,8300,8303,0,3,5
2399,6,1,8306,8306,8307,0,1,3
2400,2,2,8308,8308,8310,0,2,1
2401,5,1,8313,8313,8314,0,1,3
2402,5,1,8318,8318,8319,0,1,4
2403,6,2,8324,8324,8326,0,2,5
2404,4,3,8328,8328,8331,0,3,2
2405,1,2,8329,8331,8333,2,4,0
2406,6,1,8335,8335,8336,0,1,2
2407,1,2,8336,8336,8338,0,2,0
2408,1,3,8337,8338,8341,1,4,0
2409,2,1,8339,8341,8342,2,3,0
2410,4,3,8343,8343,8346,0,3,1
2411,2,3,8345,8346,8349,1,4,0
2412,1,3,8346,8349,8352,3,6,0
2413,1,3,8347,8352,8355,5,8,0
2414,6,2,8353,8355,8357,2,4,0
2415,1,3,8354,8357,8360,3,6,0
2416,1,2,8355,8360,8362,5,7,0
2417,1,3,8356,8362,8365,6,9,0
2418,5,2,8361,8365,8367,4,6,0
2419,4,1,8365,8367,8368,2,3,0
2420,3,1,8368,8368,8369,0,1,0
2421,5,1,8373,8373,8374,0,1,4
2422,3,2,8376,8376,8378,0,2,2
2423,5,2,8381,8381,8383,0,2,3
2424,5,2,8386,8386,8388,0,2,3
2425,4,3,8390,8390,8393,0,3,2
2426,3,1,8393,8393,8394,0,1,0
2427,6,1,8399,8399,8400,0,1,5
2428,4,2,8403,8403,8405,0,2,3
2429,5,2,8408,8408,8410,0,2,3
2430,3,3,8411,8411,8414,0,3,1
2431,5,2,8416,8416,8418,0,2,2
2432,6,2,8422,8422,8424,0,2,4
2433,3,3,8425,8425,8428,0,3,1
2434,1,3,8426,8428,8431,2,5,0
2435,3,1,8429,8431,8432,2,3,0
2436,3,3,8432,8432,8435,0,3,0
2437,3,2,8435,8435,8437,0,2,0
2438,6,3,8441,8441,8444,0,3,4
2439,4,3,8445,8445,8448,0,3,1
2440,2,2,8447,8448,8450,1,3,0
2441,5,1,8452,8452,8453,0,1,2
2442,4,1,8456,8456,8457,0,1,3
2443,4,1,8460,8460,8461,0,1,3
2444,3,3,8463,8463,8466,0,3,2
2445,5,2,8468,8468,8470,0,2,2
2446,6,3,8474,8474,8477,0,3,4
2447,1,1,8475,8477,8478,2,3,0
2448,4,2,8479,8479,8481,0,2,1
2449,1,2,8480,8481,8483,1,3,0
2450,2,1,8482,8483,8484,1,2,0
2451,6,1,8488,8488,8489,0,1,4
2452,1,2,8489,8489,8491,0,2,0
2453,1,2,8490,8491,8493,1,3,0
2454,3,2,8493,8493,8495,0,2,0
2455,1,2,8494,8495,8497,1,3,0
2456,1,1,8495,8497,8498,2,3,0
2457,3,2,8498,8498,8500,0,2,0
2458,6,2,8504,8504,8506,0,2,4
2459,5,3,8509,8509,8512,0,3,3
2460,2,3,8511,8512,8515,1,4,0
2461,5,1,8516,8516,8517,0,1,1
2462,5,1,8521,8521,8522,0,1,4
2463,5,3,8526,8526,8529,0,3,4
2464,2,1,8528,8529,8530,1,2,0
2465,5,1,8533,8533,8534,0,1,3
2466,2,1,8535,8535,8536,0,1,1
2467,4,3,8539,8539,8542,0,3,3
2468,3,3,8542,8542,8545,0,3,0
2469,3,3,8545,8545,8548,0,3,0
2470,4,2,8549,8549,8551,0,2,1
2471,1,1,8550,8551,8552,1,2,0
2472,4,2,8554,8554,8556,0,2,2
2473,2,2,8556,8556,8558,0,2,0
2474,6,2,8562,8562,8564,0,2,4
2475,3,2,8565,8565,8567,0,2,1
2476,1,3,8566,8567,8570,1,4,0
2477,6,1,8572,8572,8573,0,1,2
2478,4,2,8576,8576,8578,0,2,3
2479,5,3,8581,8581,8584,0,3,3
2480,3,1,8584,8584,8585,0,1,0
2481,2,2,8586,8586,8588,0,2,1
2482,6,3,8592,8592,8595,0,3,4
2483,4,1,8596,8596,8597,0,1,1
2484,5,2,8601,8601,8603,0,2,4
2485,5,3,8606,8606,8609,0,3,3
2486,3,2,8609,8609,8611,0,2,0
2487,6,2,8615,8615,8617,0,2,4
2488,3,3,8618,8618,8621,0,3,1
2489,2,1,8620,8621,8622,1,2,0
2490,1,2,8621,8622,8624,1,3,0
2491,2,3,8623,8624,8627,1,4,0
2492,5,1,8628,8628,8629,0,1,1
2493,1,3,8629,8629,8632,0,3,0
2494,2,2,8631,8632,8634,1,3,0
2495,1,2,8632,8634,8636,2,4,0
2496,1,3,8633,8636,8639,3,6,0
2497,5,3,8638,8639,8642,1,4,0
2498,1,3,8639,8642,8645,3,6,0
2499,5,3,8644,8645,8648,1,4,0
2500,4,3,8648,8648,8651,0,3,0
2501,5,1,8653,8653,8654,0,1,2
2502,6,2,8659,8659,8661,0,2,5
2503,5,2,8664,8664,8666,0,2,3
2504,3,2,8667,8667,8669,0,2,1
2505,4,3,8671,8671,8674,0,3,2
2506,2,2,8673,8674,8676,1,3,0
2507,4,1,8677,8677,8678,0,1,1
2508,2,3,8679,8679,8682,0,3,1
2509,1,1,8680,8682,8683,2,3,0
2510,2,3,8682,8683,8686,1,4,0
2511,4,1,8686,8686,8687,0,1,0
2512,4,3,8690,8690,8693,0,3,3
2513,2,1,8692,8693,8694,1,2,0
2514,6,1,8698,8698,8699,0,1,4
2515,5,1,8703,8703,8704,0,1,4
2516,1,1,8704,8704,8705,0,1,0
2517,5,2,8709,8709,8711,0,2,4
2518,2,1,8711,8711,8712,0,1,0
2519,6,2,8717,8717,8719,0,2,5
2520,6,3,8723,8723,8726,0,3,4
2521,4,1,8727,8727,8728,0,1,1
2522,1,3,8728,8728,8731,0,3,0
2523,4,1,8732,8732,8733,0,1,1
2524,4,3,8736,8736,8739,0,3,3
2525,5,1,8741,8741,8742,0,1,2
2526,6,1,8747,8747,8748,0,1,5
2527,5,1,8752,8752,8753,0,1,4
2528,1,3,8753,8753,8756,0,3,0
2529,1,3,8754,8756,8759,2,5,0
2530,2,1,8756,8759,8760,3,4,0
2531,5,2,8761,8761,8763,0,2,1
2532,5,2,8766,8766,8768,0,2,3
2533,3,3,8769,8769,8772,0,3,1
2534,1,2,8770,8772,8774,2,4,0
2535,1,3,8771,8774,8777,3,6,0
2536,4,3,8775,8777,8780,2,5,0
2537,1,1,8776,8780,8781,4,5,0
2538,3,3,8779,8781,8784,2,5,0
2539,6,3,8785,8785,8788,0,3,1
2540,6,3,8791,8791,8794,0,3,3
2541,5,3,8796,8796,8799,0,3,2
2542,1,2,8797,8799,8801,2,4,0
2543,5,2,8802,8802,8804,0,2,1
2544,3,1,8805,8805,8806,0,1,1
2545,2,3,8807,8807,8810,0,3,1
2546,5,3,8812,8812,8815,0,3,2
2547,2,3,8814,8815,8818,1,4,0
2548,2,2,8816,8818,8820,2,4,0
2549,2,1,8818,8820,8821,2,3,0
2550,2,2,8820,8821,8823,1,3,0
2551,6,3,8826,8826,8829,0,3,3
2552,4,1,8830,8830,8831,0,1,1
2553,5,3,8835,8835,8838,0,3,4
2554,3,1,8838,8838,8839,0,1,0
2555,4,2,8842,8842,8844,0,2,3
2556,1,2,8843,8844,8846,1,3,0
2557,3,3,8846,8846,8849,0,3,0
2558,2,2,8848,8849,8851,1,3,0
2559,3,3,8851,8851,8854,0,3,0
2560,2,3,8853,8854,8857,1,4,0
2561,5,2,8858,8858,8860,0,2,1
2562,1,1,8859,8860,8861,1,2,0
2563,6,2,8865,8865,8867,0,2,4
2564,5,3,8870,8870,8873,0,3,3
2565,5,2,8875,8875,8877,0,2,2
2566,6,3,8881,8881,8884,0,3,4
2567,6,2,8887,8887,8889,0,2,3
2568,3,2,8890,8890,8892,0,2,1
2569,3,2,8893,8893,8895,0,2,1
2570,6,2,8899,8899,8901,0,2,4
2571,1,2,8900,8901,8903,1,3,0
2572,3,3,8903,8903,8906,0,3,0
2573,2,2,8905,8906,8908,1,3,0
2574,1,1,8906,8908,8909,2,3,0
2575,2,3,8908,8909,8912,1,4,0
2576,2,3,8910,8912,8915,2,5,0
2577,5,1,8915,8915,8916,0,1,0
2578,1,1,8916,8916,8917,0,1,0
2579,4,3,8920,8920,8923,0,3,3
2580,4,1,8924,8924,8925,0,1,1
2581,3,3,8927,8927,8930,0,3,2
2582,6,1,8933,8933,8934,0,1,3
2583,2,1,8935,8935,8936,0,1,1
2584,2,1,8937,8937,8938,0,1,1
2585,4,3,8941,8941,8944,0,3,3
2586,2,3,8943,8944,8947,1,4,0
2587,5,3,8948,8948,8951,0,3,1
2588,2,3,8950,8951,8954,1,4,0
2589,3,2,8953,8954,8956,1,3,0
2590,3,2,8956,8956,8958,0,2,0
2591,5,3,8961,8961,8964,0,3,3
2592,4,2,8965,8965,8967,0,2,1
2593,1,2,8966,8967,8969,1,3,0
2594,3,3,8969,8969,8972,0,3,0
2595,5,2,8974,8974,8976,0,2,2
2596,2,1,8976,8976,8977,0,1,0
2597,2,3,8978,8978,8981,0,3,1
2598,5,1,8983,8983,8984,0,1,2
2599,3,2,8986,8986,8988,0,2,2
2600,6,1,8992,8992,8993,0,1,4
2601,2,2,8994,8994,8996,0,2,1
2602,1,2,8995,8996,8998,1,3,0
2603,2,2,8997,8998,9000,1,3,0
2604,4,3,9001,9001,9004,0,3,1
2605,6,1,9007,9007,9008,0,1,3
2606,5,1,9012,9012,9013,0,1,4
2607,2,1,9014,9014,9015,0,1,1
2608,3,3,9017,9017,9020,0,3,2
2609,1,3,9018,9020,9023,2,5,0
2610,4,3,9022,9023,9026,1,4,0
2611,5,2,9027,9027,9029,0,2,1
2612,2,1,9029,9029,9030,0,1,0
2613,5,1,9034,9034,9035,0,1,4
2614,2,1,9036,9036,9037,0,1,1
2615,6,1,9042,9042,9043,0,1,5
2616,1,2,9043,9043,9045,0,2,0
2617,6,3,9049,9049,9052,0,3,4
2618,2,1,9051,9052,9053,1,2,0
2619,5,1,9056,9056,9057,0,1,3
2620,3,1,9059,9059,9060,0,1,2
2621,5,1,9064,9064,9065,0,1,4
2622,1,2,9065,9065,9067,0,2,0
2623,6,2,9071,9071,9073,0,2,4
2624,2,2,9073,9073,9075,0,2,0
2625,1,1,9074,9075,9076,1,2,0
2626,6,1,9080,9080,9081,0,1,4
2627,5,1,9085,9085,9086,0,1,4
2628,4,1,9089,9089,9090,0,1,3
2629,5,3,9094,9094,9097,0,3,4
2630,2,1,9096,9097,9098,1,2,0
2631,4,2,9100,9100,9102,0,2,2
2632,5,2,9105,9105,9107,0,2,3
2633,2,1,9107,9107,9108,0,1,0
2634,3,2,9110,9110,9112,0,2,2
2635,3,2,9113,9113,9115,0,2,1
2636,5,3,9118,9118,9121,0,3,3
2637,1,2,9119,9121,9123,2,4,0
2638,2,1,9121,9123,9124,2,3,0
2639,5,3,9126,9126,9129,0,3,2
2640,5,1,9131,9131,9132,0,1,2
2641,6,3,9137,9137,9140,0,3,5
2642,4,2,9141,9141,9143,0,2,1
2643,4,3,9145,9145,9148,0,3,2
2644,4,1,9149,9149,9150,0,1,1
2645,5,3,9154,9154,9157,0,3,4
2646,6,1,9160,9160,9161,0,1,3
2647,1,2,9161,9161,9163,0,2,0
2648,5,1,9166,9166,9167,0,1,3
2649,3,2,9169,9169,9171,0,2,2
2650,2,1,9171,9171,9172,0,1,0
2651,1,2,9172,9172,9174,0,2,0
2652,6,1,9178,9178,9179,0,1,4
2653,4,1,9182,9182,9183,0,1,3
2654,3,3,9185,9185,9188,0,3,2
2655,1,1,9186,9188,9189,2,3,0
2656,4,2,9190,9190,9192,0,2,1
2657,2,3,9192,9192,9195,0,3,0
2658,1,1,9193,9195,9196,2,3,0
2659,3,1,9196,9196,9197,0,1,0
2660,6,3,9202,9202,9205,0,3,5
2661,3,3,9205,9205,9208,0,3,0
2662,6,3,9211,9211,9214,0,3,3
2663,3,3,9214,9214,9217,0,3,0
2664,2,1,9216,9217,9218,1,2,0
2665,6,3,9222,9222,9225,0,3,4
2666,6,3,9228,9228,9231,0,3,3
2667,4,1,9232,9232,9233,0,1,1
2668,6,3,9238,9238,9241,0,3,5
2669,1,1,9239,9241,9242,2,3,0
2670,2,1,9241,9242,9243,1,2,0
2671,1,1,9242,9243,9244,1,2,0
2672,6,3,9248,9248,9251,0,3,4
2673,4,2,9252,9252,9254,0,2,1
2674,6,1,9258,9258,9259,0,1,4
2675,1,3,9259,9259,9262,0,3,0
2676,4,3,9263,9263,9266,0,3,1
2677,4,1,9267,9267,9268,0,1,1
2678,4,3,9271,9271,9274,0,3,3
2679,2,3,9273,9274,9277,1,4,0
2680,4,3,9277,9277,9280,0,3,0
2681,3,1,9280,9280,9281,0,1,0
2682,2,2,9282,9282,9284,0,2,1
2683,3,1,9285,9285,9286,0,1,1
2684,2,3,9287,9287,9290,0,3,1
2685,4,2,9291,9291,9293,0,2,1
2686,3,3,9294,9294,9297,0,3,1
2687,4,2,9298,9298,9300,0,2,1
2688,3,3,9301,9301,9304,0,3,1
2689,4,3,9305,9305,9308,0,3,1
2690,6,2,9311,9311,9313,0,2,3
2691,3,3,9314,9314,9317,0,3,1
2692,6,2,9320,9320,9322,0,2,3
2693,1,2,9321,9322,9324,1,3,0
2694,6,2,9327,9327,9329,0,2,3
2695,6,3,9333,9333,9336,0,3,4
2696,3,2,9336,9336,9338,0,2,0
2697,5,3,9341,9341,9344,0,3,3
2698,2,2,9343,9344,9346,1,3,0
2699,4,1,9347,9347,9348,0,1,1
2700,4,2,9351,9351,9353,0,2,3
2701,5,2,9356,9356,9358,0,2,3
2702,3,2,9359,9359,9361,0,2,1
2703,3,1,9362,9362,9363,0,1,1
2704,6,3,9368,9368,9371,0,3,5
2705,2,1,9370,9371,9372,1,2,0
2706,4,3,9374,9374,9377,0,3,2
2707,5,2,9379,9379,9381,0,2,2
2708,4,3,9383,9383,9386,0,3,2
2709,2,2,9385,9386,9388,1,3,0
2710,2,1,9387,9388,9389,1,2,0
2711,2,3,9389,9389,9392,0,3,0
2712,5,3,9394,9394,9397,0,3,2
2713,2,3,9396,9397,9400,1,4,0
2714,3,3,9399,9400,9403,1,4,0
2715,6,2,9405,9405,9407,0,2,2
2716,2,2,9407,9407,9409,0,2,0
2717,3,1,9410,9410,9411,0,1,1
2718,2,3,9412,9412,9415,0,3,1
2719,4,1,9416,9416,9417,0,1,1
2720,1,3,9417,9417,9420,0,3,0
2721,4,1,9421,9421,9422,0,1,1
2722,1,1,9422,9422,9423,0,1,0
2723,6,3,9428,9428,9431,0,3,5
2724,6,3,9434,9434,9437,0,3,3
2725,1,2,9435,9437,9439,2,4,0
2726,6,1,9441,9441,9442,0,1,2
2727,6,2,9447,9447,9449,0,2,5
2728,5,2,9452,9452,9454,0,2,3
2729,6,2,9458,9458,9460,0,2,4
2730,6,2,9464,9464,9466,0,2,4
2731,4,1,9468,9468,9469,0,1,2
2732,6,2,9474,9474,9476,0,2,5
2733,2,2,9476,9476,9478,0,2,0
2734,4,1,9480,9480,9481,0,1,2
2735,1,3,9481,9481,9484,0,3,0
2736,2,1,9483,9484,9485,1,2,0
2737,5,1,9488,9488,9489,0,1,3
2738,4,1,9492,9492,9493,0,1,3
2739,5,3,9497,9497,9500,0,3,4
2740,6,3,9503,9503,9506,0,3,3
2741,3,1,9506,9506,9507,0,1,0
2742,3,1,9509,9509,9510,0,1,2
2743,1,3,9510,9510,9513,0,3,0
2744,3,1,9513,9513,9514,0,1,0
2745,4,2,9517,9517,9519,0,2,3
2746,2,1,9519,9519,9520,0,1,0
2747,4,3,9523,9523,9526,0,3,3
2748,5,1,9528,9528,9529,0,1,2
2749,5,3,9533,9533,9536,0,3,4
2750,5,1,9538,9538,9539,0,1,2
2751,3,1,9541,9541,9542,0,1,2
2752,6,2,9547,9547,9549,0,2,5
2753,2,2,9549,9549,9551,0,2,0
2754,2,1,9551,9551,9552,0,1,0
2755,2,2,9553,9553,9555,0,2,1
2756,6,2,9559,9559,9561,0,2,4
2757,6,1,9565,9565,9566,0,1,4
2758,1,1,9566,9566,9567,0,1,0
2759,3,1,9569,9569,9570,0,1,2
2760,2,1,9571,9571,9572,0,1,1
2761,6,2,9577,9577,9579,0,2,5
2762,1,3,9578,9579,9582,1,4,0
2763,4,2,9582,9582,9584,0,2,0
2764,2,2,9584,9584,9586,0,2,0
2765,3,1,9587,9587,9588,0,1,1
2766,2,3,9589,9589,9592,0,3,1
2767,5,3,9594,9594,9597,0,3,2
2768,2,1,9596,9597,9598,1,2,0
2769,1,2,9597,9598,9600,1,3,0
2770,1,3,9598,9600,9603,2,5,0
2771,6,2,9604,9604,9606,0,2,1
2772,3,3,9607,9607,9610,0,3,1
2773,2,2,9609,9610,9612,1,3,0
2774,1,2,9610,9612,9614,2,4,0
2775,6,2,9616,9616,9618,0,2,2
2776,3,1,9619,9619,9620,0,1,1
2777,4,3,9623,9623,9626,0,3,3
2778,2,3,9625,9626,9629,1,4,0
2779,2,3,9627,9629,9632,2,5,0
2780,3,1,9630,9632,9633,2,3,0
2781,2,3,9632,9633,9636,1,4,0
2782,6,3,9638,9638,9641,0,3,2
2783,2,3,9640,9641,9644,1,4,0
2784,5,3,9645,9645,9648,0,3,1
2785,3,2,9648,9648,9650,0,2,0
2786,2,2,9650,9650,9652,0,2,0
2787,3,1,9653,9653,9654,0,1,1
2788,2,3,9655,9655,9658,0,3,1
2789,2,1,9657,9658,9659,1,2,0
2790,6,1,9663,9663,9664,0,1,4
2791,3,1,9666,9666,9667,0,1,2
2792,5,1,9671,9671,9672,0,1,4
2793,3,3,9674,9674,9677,0,3,2
2794,2,2,9676,9677,9679,1,3,0
2795,5,1,9681,9681,9682,0,1,2
2796,1,1,9682,9682,9683,0,1,0
2797,3,1,9685,9685,9686,0,1,2
2798,5,3,9690,9690,9693,0,3,4
2799,3,2,9693,9693,9695,0,2,0
2800,2,2,9695,9695,9697,0,2,0
2801,6,2,9701,9701,9703,0,2,4
2802,4,3,9705,9705,9708,0,3,2
2803,5,3,9710,9710,9713,0,3,2
2804,5,2,9715,9715,9717,0,2,2
2805,6,2,9721,9721,9723,0,2,4
2806,3,3,9724,9724,9727,0,3,1
2807,4,2,9728,9728,9730,0,2,1
2808,1,3,9729,9730,9733,1,4,0
2809,4,1,9733,9733,9734,0,1,0
2810,5,3,9738,9738,9741,0,3,4
2811,1,2,9739,9741,9743,2,4,0
2812,5,3,9744,9744,9747,0,3,1
2813,5,2,9749,9749,9751,0,2,2
2814,2,3,9751,9751,9754,0,3,0
2815,4,1,9755,9755,9756,0,1,1
2816,5,1,9760,9760,9761,0,1,4
2817,4,1,9764,9764,9765,0,1,3
2818,5,2,9769,9769,9771,0,2,4
2819,3,3,9772,9772,9775,0,3,1
2820,6,3,9778,9778,9781,0,3,3
2821,6,3,9784,9784,9787,0,3,3
2822,2,2,9786,9787,9789,1,3,0
2823,5,1,9791,9791,9792,0,1,2
2824,3,3,9794,9794,9797,0,3,2
2825,1,1,9795,9797,9798,2,3,0
2826,3,2,9798,9798,9800,0,2,0
2827,3,3,9801,9801,9804,0,3,1
2828,4,2,9805,9805,9807,0,2,1
2829,3,2,9808,9808,9810,0,2,1
2830,1,2,9809,9810,9812,1,3,0
2831,4,3,9813,9813,9816,0,3,1
2832,2,2,9815,9816,9818,1,3,0
2833,3,2,9818,9818,9820,0,2,0
2834,2,3,9820,9820,9823,0,3,0
2835,1,3,9821,9823,9826,2,5,0
2836,4,3,9825,9826,9829,1,4,0
2837,6,2,9831,9831,9833,0,2,2
2838,2,1,9833,9833,9834,0,1,0
2839,2,3,9835,9835,9838,0,3,1
2840,2,3,9837,9838,9841,1,4,0
2841,1,1,9838,9841,9842,3,4,0
2842,6,1,9844,9844,9845,0,1,2
2843,1,3,9845,9845,9848,0,3,0
2844,2,1,9847,9848,9849,1,2,0
2845,3,2,9850,9850,9852,0,2,1
2846,6,2,9856,9856,9858,0,2,4
2847,5,1,9861,9861,9862,0,1,3
2848,1,3,9862,9862,9865,0,3,0
2849,3,3,9865,9865,9868,0,3,0
2850,2,2,9867,9868,9870,1,3,0
2851,1,2,9868,9870,9872,2,4,0
2852,2,1,9870,9872,9873,2,3,0
2853,1,1,9871,9873,9874,2,3,0
2854,4,2,9875,9875,9877,0,2,1
2855,2,2,9877,9877,9879,0,2,0
2856,3,3,9880,9880,9883,0,3,1
2857,6,1,9886,9886,9887,0,1,3
2858,5,2,9891,9891,9893,0,2,4
2859,1,2,9892,9893,9895,1,3,0
2860,5,1,9897,9897,9898,0,1,2
2861,6,3,9903,9903,9906,0,3,5
2862,6,1,9909,9909,9910,0,1,3
2863,5,1,9914,9914,9915,0,1,4
2864,5,3,9919,9919,9922,0,3,4
2865,3,1,9922,9922,9923,0,1,0
2866,4,2,9926,9926,9928,0,2,3
2867,2,2,9928,9928,9930,0,2,0
2868,4,1,9932,9932,9933,0,1,2
2869,5,1,9937,9937,9938,0,1,4
2870,3,3,9940,9940,9943,0,3,2
2871,2,3,9942,9943,9946,1,4,0
2872,1,3,9943,9946,9949,3,6,0
2873,6,3,9949,9949,9952,0,3,0
2874,5,2,9954,9954,9956,0,2,2
2875,1,3,9955,9956,9959,1,4,0
2876,2,2,9957,9959,9961,2,4,0
2877,6,1,9963,9963,9964,0,1,2
2878,3,1,9966,9966,9967,0,1,2
2879,1,3,9967,9967,9970,0,3,0
2880,2,2,9969,9970,9972,1,3,0
2881,3,1,9972,9972,9973,0,1,0
2882,6,2,9978,9978,9980,0,2,5
2883,5,2,9983,9983,9985,0,2,3
2884,3,3,9986,9986,9989,0,3,1
2885,6,3,9992,9992,9995,0,3,3
2886,3,2,9995,9995,9997,0,2,0
2887,6,2,10001,10001,10003,0,2,4
2888,3,1,10004,10004,10005,0,1,1
2889,5,3,10009,10009,10012,0,3,4
2890,5,1,10014,10014,10015,0,1,2
2891,1,1,10015,10015,10016,0,1,0
2892,3,2,10018,10018,10020,0,2,2
2893,6,3,10024,10024,10027,0,3,4
2894,6,3,10030,10030,10033,0,3,3
2895,2,1,10032,10033,10034,1,2,0
2896,2,2,10034,10034,10036,0,2,0
2897,2,2,10036,10036,10038,0,2,0
2898,6,1,10042,10042,10043,0,1,4
2899,1,2,10043,10043,10045,0,2,0
2900,3,3,10046,10046,10049,0,3,1
2901,4,1,10050,10050,10051,0,1,1
2902,5,2,10055,10055,10057,0,2,4
2903,4,2,10059,10059,10061,0,2,2
2904,5,1,10064,10064,10065,0,1,3
2905,6,3,10070,10070,10073,0,3,5
2906,6,2,10076,10076,10078,0,2,3
2907,3,2,10079,10079,10081,0,2,1
2908,6,2,10085,10085,10087,0,2,4
2909,2,3,10087,10087,10090,0,3,0
2910,2,3,10089,10090,10093,1,4,0
2911,5,3,10094,10094,10097,0,3,1
2912,3,2,10097,10097,10099,0,2,0
2913,3,2,10100,10100,10102,0,2,1
2914,2,3,10102,10102,10105,0,3,0
2915,5,3,10107,10107,10110,0,3,2
2916,1,1,10108,10110,10111,2,3,0
2917,5,3,10113,10113,10116,0,3,2
2918,3,1,10116,10116,10117,0,1,0
2919,2,2,10118,10118,10120,0,2,1
2920,4,2,10122,10122,10124,0,2,2
2921,1,1,10123,10124,10125,1,2,0
2922,1,2,10124,10125,10127,1,3,0
2923,1,3,10125,10127,10130,2,5,0
2924,1,1,10126,10130,10131,4,5,0
2925,3,3,10129,10131,10134,2,5,0
2926,3,1,10132,10134,10135,2,3,0
2927,1,2,10133,10135,10137,2,4,0
2928,5,1,10138,10138,10139,0,1,1
2929,2,2,10140,10140,10142,0,2,1
2930,4,2,10144,10144,10146,0,2,2
2931,5,3,10149,10149,10152,0,3,3
2932,4,1,10153,10153,10154,0,1,1
2933,6,1,10159,10159,10160,0,1,5
2934,2,3,10161,10161,10164,0,3,1
2935,1,3,10162,10164,10167,2,5,0
2936,6,2,10168,10168,10170,0,2,1
2937,3,1,10171,10171,10172,0,1,1
2938,1,2,10172,10172,10174,0,2,0
2939,3,2,10175,10175,10177,0,2,1
2940,4,3,10179,10179,10182,0,3,2
2941,4,3,10183,10183,10186,0,3,1
2942,1,3,10184,10186,10189,2,5,0
2943,4,3,10188,10189,10192,1,4,0
2944,3,1,10191,10192,10193,1,2,0
2945,3,1,10194,10194,10195,0,1,1
2946,2,1,10196,10196,10197,0,1,1
2947,1,1,10197,10197,10198,0,1,0
2948,4,2,10201,10201,10203,0,2,3
2949,2,1,10203,10203,10204,0,1,0
2950,3,3,10206,10206,10209,0,3,2
2951,4,2,10210,10210,10212,0,2,1
2952,4,1,10214,10214,10215,0,1,2
2953,5,1,10219,10219,10220,0,1,4
2954,5,2,10224,10224,10226,0,2,4
2955,5,2,10229,10229,10231,0,2,3
2956,4,3,10233,10233,10236,0,3,2
2957,6,2,10239,10239,10241,0,2,3
2958,6,1,10245,10245,10246,0,1,4
2959,6,3,10251,10251,10254,0,3,5
2960,5,1,10256,10256,10257,0,1,2
2961,6,3,10262,10262,10265,0,3,5
2962,4,1,10266,10266,10267,0,1,1
2963,2,3,10268,10268,10271,0,3,1
2964,5,1,10273,10273,10274,0,1,2
2965,1,3,10274,10274,10277,0,3,0
2966,6,1,10280,10280,10281,0,1,3
2967,1,3,10281,10281,10284,0,3,0
2968,1,2,10282,10284,10286,2,4,0
2969,1,2,10283,10286,10288,3,5,0
2970,2,3,10285,10288,10291,3,6,0
2971,5,2,10290,10291,10293,1,3,0
2972,5,1,10295,10295,10296,0,1,2
2973,2,1,10297,10297,10298,0,1,1
2974,2,2,10299,10299,10301,0,2,1
2975,5,2,10304,10304,10306,0,2,3
2976,1,2,10305,10306,10308,1,3,0
2977,3,2,10308,10308,10310,0,2,0
2978,3,3,10311,10311,10314,0,3,1
2979,3,2,10314,10314,10316,0,2,0
2980,3,3,10317,10317,10320,0,3,1
2981,3,2,10320,10320,10322,0,2,0
2982,1,2,10321,10322,10324,1,3,0
2983,2,3,10323,10324,10327,1,4,0
2984,3,3,10326,10327,10330,1,4,0
2985,1,2,10327,10330,10332,3,5,0
2986,1,1,10328,10332,10333,4,5,0
2987,6,1,10334,10334,10335,0,1,1
2988,4,2,10338,10338,10340,0,2,3
2989,3,3,10341,10341,10344,0,3,1
2990,2,1,10343,10344,10345,1,2,0
2991,5,3,10348,10348,10351,0,3,3
2992,3,2,10351,10351,10353,0,2,0
2993,1,1,10352,10353,10354,1,2,0
2994,5,1,10357,10357,10358,0,1,3
2995,3,2,10360,10360,10362,0,2,2
2996,4,1,10364,10364,10365,0,1,2
2997,4,1,10368,10368,10369,0,1,3
2998,1,2,10369,10369,10371,0,2,0
2999,2,1,10371,10371,10372,0,1,0
3000,5,2,10376,10376,10378,0,2,4
3001,3,3,10379,10379,10382,0,3,1
3002,1,3,10380,10382,10385,2,5,0
3003,4,1,10384,10385,10386,1,2,0
3004,4,3,10388,10388,10391,0,3,2
3005,3,2,10391,10391,10393,0,2,0
3006,3,3,10394,10394,10397,0,3,1
3007,3,3,10397,10397,10400,0,3,0
3008,6,2,10403,10403,10405,0,2,3
3009,3,1,10406,10406,10407,0,1,1
3010,3,3,10409,10409,10412,0,3,2
3011,3,2,10412,10412,10414,0,2,0
3012,5,3,10417,10417,10420,0,3,3
3013,4,2,10421,10421,10423,0,2,1
3014,6,2,10427,10427,10429,0,2,4
3015,6,1,10433,10433,10434,0,1,4
3016,5,1,10438,10438,10439,0,1,4
3017,3,3,10441,10441,10444,0,3,2
3018,5,2,10446,10446,10448,0,2,2
3019,5,1,10451,10451,10452,0,1,3
3020,6,1,10457,10457,10458,0,1,5
3021,3,3,10460,10460,10463,0,3,2
3022,6,1,10466,10466,10467,0,1,3
3023,2,1,10468,10468,10469,0,1,1
3024,4,2,10472,10472,10474,0,2,3
3025,5,2,10477,10477,10479,0,2,3
3026,5,2,10482,10482,10484,0,2,3
3027,4,1,10486,10486,10487,0,1,2
3028,2,1,10488,10488,10489,0,1,1
3029,4,1,10492,10492,10493,0,1,3
3030,2,3,10494,10494,10497,0,3,1
3031,6,2,10500,10500,10502,0,2,3
3032,6,2,10506,10506,10508,0,2,4
3033,6,2,10512,10512,10514,0,2,4
3034,5,3,10517,10517,10520,0,3,3
3035,2,2,10519,10520,10522,1,3,0
3036,6,1,10525,10525,10526,0,1,3
3037,4,3,10529,10529,10532,0,3,3
3038,3,1,10532,10532,10533,0,1,0
3039,5,1,10537,10537,10538,0,1,4
3040,2,2,10539,10539,10541,0,2,1
3041,6,1,10545,10545,10546,0,1,4
3042,5,2,10550,10550,10552,0,2,4
3043,4,2,10554,10554,10556,0,2,2
3044,5,1,10559,10559,10560,0,1,3
3045,1,3,10560,10560,10563,0,3,0
3046,5,1,10565,10565,10566,0,1,2
3047,5,3,10570,10570,10573,0,3,4
3048,6,1,10576,10576,10577,0,1,3
3049,6,3,10582,10582,10585,0,3,5
3050,2,1,10584,10585,10586,1,2,0
3051,3,3,10587,10587,10590,0,3,1
3052,5,1,10592,10592,10593,0,1,2
3053,2,1,10594,10594,10595,0,1,1
3054,5,2,10599,10599,10601,0,2,4
3055,3,1,10602,10602,10603,0,1,1
3056,1,2,10603,10603,10605,0,2,0
3057,2,1,10605,10605,10606,0,1,0
3058,4,2,10609,10609,10611,0,2,3
3059,1,2,10610,10611,10613,1,3,0
3060,3,2,10613,10613,10615,0,2,0
3061,5,1,10618,10618,10619,0,1,3
3062,5,1,10623,10623,10624,0,1,4
3063,3,1,10626,10626,10627,0,1,2
3064,3,1,10629,10629,10630,0,1,2
3065,5,3,10634,10634,10637,0,3,4
3066,4,2,10638,10638,10640,0,2,1
3067,2,1,10640,10640,10641,0,1,0
3068,1,2,10641,10641,10643,0,2,0
3069,2,2,10643,10643,10645,0,2,0
3070,4,3,10647,10647,10650,0,3,2
3071,3,1,10650,10650,10651,0,1,0
3072,4,3,10654,10654,10657,0,3,3
3073,2,1,10656,10657,10658,1,2,0
3074,6,2,10662,10662,10664,0,2,4
3075,2,2,10664,10664,10666,0,2,0
3076,3,2,10667,10667,10669,0,2,1
3077,3,3,10670,10670,10673,0,3,1
3078,4,1,10674,10674,10675,0,1,1
3079,2,2,10676,10676,10678,0,2,1
3080,2,2,10678,10678,10680,0,2,0
3081,6,3,10684,10684,10687,0,3,4
3082,2,3,10686,10687,10690,1,4,0
3083,3,2,10689,10690,10692,1,3,0
3084,5,3,10694,10694,10697,0,3,2
3085,2,2,10696,10697,10699,1,3,0
3086,1,1,10697,10699,10700,2,3,0
3087,3,2,10700,10700,10702,0,2,0
3088,1,1,10701,10702,10703,1,2,0
3089,4,1,10705,10705,10706,0,1,2
3090,4,1,10709,10709,10710,0,1,3
3091,2,2,10711,10711,10713,0,2,1
3092,6,1,10717,10717,10718,0,1,4
3093,5,3,10722,10722,10725,0,3,4
3094,3,3,10725,10725,10728,0,3,0
3095,3,3,10728,10728,10731,0,3,0
3096,5,1,10733,10733,10734,0,1,2
3097,2,3,10735,10735,10738,0,3,1
3098,6,3,10741,10741,10744,0,3,3
3099,4,2,10745,10745,10747,0,2,1
3100,1,2,10746,10747,10749,1,3,0
3101,4,1,10750,10750,10751,0,1,1
3102,3,3,10753,10753,10756,0,3,2
3103,5,1,10758,10758,10759,0,1,2
3104,5,3,10763,10763,10766,0,3,4
3105,3,2,10766,10766,10768,0,2,0
3106,1,2,10767,10768,10770,1,3,0
3107,5,2,10772,10772,10774,0,2,2
3108,6,3,10778,10778,10781,0,3,4
3109,1,1,10779,10781,10782,2,3,0
3110,5,3,10784,10784,10787,0,3,2
3111,5,2,10789,10789,10791,0,2,2
3112,6,2,10795,10795,10797,0,2,4
3113,1,2,10796,10797,10799,1,3,0
3114,2,2,10798,10799,10801,1,3,0
3115,5,2,10803,10803,10805,0,2,2
3116,1,2,10804,10805,10807,1,3,0
3117,2,2,10806,10807,10809,1,3,0
3118,1,2,10807,10809,10811,2,4,0
3119,6,2,10813,10813,10815,0,2,2
3120,2,1,10815,10815,10816,0,1,0
3121,1,2,10816,10816,10818,0,2,0
3122,1,1,10817,10818,10819,1,2,0
3123,6,2,10823,10823,10825,0,2,4
3124,2,3,10825,10825,10828,0,3,0
3125,6,3,10831,10831,10834,0,3,3
3126,3,1,10834,10834,10835,0,1,0
3127,2,3,10836,10836,10839,0,3,1
3128,1,2,10837,10839,10841,2,4,0
3129,1,2,10838,10841,10843,3,5,0
3130,1,1,10839,10843,10844,4,5,0
3131,4,2,10843,10844,10846,1,3,0
3132,4,1,10847,10847,10848,0,1,1
3133,3,2,10850,10850,10852,0,2,2
3134,1,1,10851,10852,10853,1,2,0
3135,2,2,10853,10853,10855,0,2,0
3136,2,3,10855,10855,10858,0,3,0
3137,6,3,10861,10861,10864,0,3,3
3138,3,2,10864,10864,10866,0,2,0
3139,2,1,10866,10866,10867,0,1,0
3140,6,1,10872,10872,10873,0,1,5
3141,6,3,10878,10878,10881,0,3,5
3142,4,2,10882,10882,10884,0,2,1
3143,5,3,10887,10887,10890,0,3,3
3144,2,3,10889,10890,10893,1,4,0
3145,5,2,10894,10894,10896,0,2,1
3146,1,2,10895,10896,10898,1,3,0
3147,6,1,10901,10901,10902,0,1,3
3148,1,1,10902,10902,10903,0,1,0
3149,5,2,10907,10907,10909,0,2,4
3150,5,2,10912,10912,10914,0,2,3
3151,1,1,10913,10914,10915,1,2,0
3152,6,2,10919,10919,10921,0,2,4
3153,5,2,10924,10924,10926,0,2,3
3154,6,1,10930,10930,10931,0,1,4
3155,4,1,10934,10934,10935,0,1,3
3156,2,1,10936,10936,10937,0,1,1
3157,6,3,10942,10942,10945,0,3,5
3158,2,1,10944,10945,10946,1,2,0
3159,4,3,10948,10948,10951,0,3,2
3160,1,2,10949,10951,10953,2,4,0
3161,3,2,10952,10953,10955,1,3,0
3162,3,2,10955,10955,10957,0,2,0
3163,6,3,10961,10961,10964,0,3,4
3164,1,1,10962,10964,10965,2,3,0
3165,4,3,10966,10966,10969,0,3,1
3166,2,2,10968,10969,10971,1,3,0
3167,2,3,10970,10971,10974,1,4,0
3168,2,3,10972,10974,10977,2,5,0
3169,1,2,10973,10977,10979,4,6,0
3170,5,3,10978,10979,10982,1,4,0
3171,1,1,10979,10982,10983,3,4,0
3172,4,1,10983,10983,10984,0,1,0
3173,5,3,10988,10988,10991,0,3,4
3174,4,3,10992,10992,10995,0,3,1
3175,4,3,10996,10996,10999,0,3,1
3176,3,2,10999,10999,11001,0,2,0
3177,3,3,11002,11002,11005,0,3,1
3178,2,1,11004,11005,11006,1,2,0
3179,5,3,11009,11009,11012,0,3,3
3180,3,2,11012,11012,11014,0,2,0
3181,6,1,11018,11018,11019,0,1,4
3182,1,3,11019,11019,11022,0,3,0
3183,4,2,11023,11023,11025,0,2,1
3184,2,2,11025,11025,11027,0,2,0
3185,5,3,11030,11030,11033,0,3,3
3186,6,2,11036,11036,11038,0,2,3
3187,2,2,11038,11038,11040,0,2,0
3188,3,1,11041,11041,11042,0,1,1
3189,2,3,11043,11043,11046,0,3,1
3190,5,2,11048,11048,11050,0,2,2
3191,2,2,11050,11050,11052,0,2,0
3192,2,2,11052,11052,11054,0,2,0
3193,6,1,11058,11058,11059,0,1,4
3194,2,1,11060,11060,11061,0,1,1
3195,4,2,11064,11064,11066,0,2,3
3196,2,2,11066,11066,11068,0,2,0
3197,2,2,11068,11068,11070,0,2,0
3198,6,3,11074,11074,11077,0,3,4
3199,5,1,11079,11079,11080,0,1,2
3200,1,2,11080,11080,11082,0,2,0
3201,6,2,11086,11086,11088,0,2,4
3202,1,1,11087,11088,11089,1,2,0
3203,2,3,11089,11089,11092,0,3,0
3204,5,2,11094,11094,11096,0,2,2
3205,3,3,11097,11097,11100,0,3,1
3206,5,2,11102,11102,11104,0,2,2
3207,5,2,11107,11107,11109,0,2,3
3208,4,2,11111,11111,11113,0,2,2
3209,5,2,11116,11116,11118,0,2,3
3210,5,2,11121,11121,11123,0,2,3
3211,5,3,11126,11126,11129,0,3,3
3212,6,2,11132,11132,11134,0,2,3
3213,5,3,11137,11137,11140,0,3,3
3214,4,3,11141,11141,11144,0,3,1
3215,6,3,11147,11147,11150,0,3,3
3216,2,3,11149,11150,11153,1,4,0
3217,5,3,11154,11154,11157,0,3,1
3218,3,2,11157,11157,11159,0,2,0
3219,4,1,11161,11161,11162,0,1,2
3220,4,3,11165,11165,11168,0,3,3
3221,2,2,11167,11168,11170,1,3,0
3222,1,3,11168,11170,11173,2,5,0
3223,4,3,11172,11173,11176,1,4,0
3224,3,2,11175,11176,11178,1,3,0
3225,1,2,11176,11178,11180,2,4,0
3226,6,3,11182,11182,11185,0,3,2
3227,1,2,11183,11185,11187,2,4,0
3228,5,1,11188,11188,11189,0,1,1
3229,4,2,11192,11192,11194,0,2,3
3230,2,1,11194,11194,11195,0,1,0
3231,6,1,11200,11200,11201,0,1,5
3232,1,2,11201,11201,11203,0,2,0
3233,4,3,11205,11205,11208,0,3,2
3234,6,1,11211,11211,11212,0,1,3
3235,6,1,11217,11217,11218,0,1,5
3236,5,2,11222,11222,11224,0,2,4
3237,1,3,11223,11224,11227,1,4,0
3238,4,3,11227,11227,11230,0,3,0
3239,6,3,11233,11233,11236,0,3,3
3240,1,2,11234,11236,11238,2,4,0
3241,3,2,11237,11238,11240,1,3,0
3242,1,2,11238,11240,11242,2,4,0
3243,2,1,11240,11242,11243,2,3,0
3244,1,3,11241,11243,11246,2,5,0
3245,6,2,11247,11247,11249,0,2,1
3246,1,3,11248,11249,11252,1,4,0
3247,1,1,11249,11252,11253,3,4,0
3248,2,3,11251,11253,11256,2,5,0
3249,1,3,11252,11256,11259,4,7,0
3250,2,3,11254,11259,11262,5,8,0
3251,2,2,11256,11262,11264,6,8,0
3252,1,1,11257,11264,11265,7,8,0
3253,3,1,11260,11265,11266,5,6,0
3254,4,2,11264,11266,11268,2,4,0
3255,2,2,11266,11268,11270,2,4,0
3256,3,3,11269,11270,11273,1,4,0
3257,2,2,11271,11273,11275,2,4,0
3258,3,3,11274,11275,11278,1,4,0
3259,6,1,11280,11280,11281,0,1,2
3260,4,1,11284,11284,11285,0,1,3
3261,4,3,11288,11288,11291,0,3,3
3262,3,2,11291,11291,11293,0,2,0
3263,6,3,11297,11297,11300,0,3,4
3264,5,1,11302,11302,11303,0,1,2
3265,4,1,11306,11306,11307,0,1,3
3266,5,3,11311,11311,11314,0,3,4
3267,2,3,11313,11314,11317,1,4,0
3268,4,1,11317,11317,11318,0,1,0
3269,5,1,11322,11322,11323,0,1,4
3270,3,2,11325,11325,11327,0,2,2
3271,2,2,11327,11327,11329,0,2,0
3272,1,2,11328,11329,11331,1,3,0
3273,2,1,11330,11331,11332,1,2,0
3274,5,3,11335,11335,11338,0,3,3
3275,5,1,11340,11340,11341,0,1,2
3276,4,1,11344,11344,11345,0,1,3
3277,4,3,11348,11348,11351,0,3,3
3278,1,3,11349,11351,11354,2,5,0
3279,1,3,11350,11354,11357,4,7,0
3280,2,1,11352,11357,11358,5,6,0
3281,6,3,11358,11358,11361,0,3,0
3282,5,1,11363,11363,11364,0,1,2
3283,2,2,11365,11365,11367,0,2,1
3284,2,2,11367,11367,11369,0,2,0
3285,6,3,11373,11373,11376,0,3,4
3286,5,1,11378,11378,11379,0,1,2
3287,2,1,11380,11380,11381,0,1,1
3288,6,2,11386,11386,11388,0,2,5
3289,4,2,11390,11390,11392,0,2,2
3290,1,1,11391,11392,11393,1,2,0
3291,1,3,11392,11393,11396,1,4,0
3292,5,3,11397,11397,11400,0,3,1
3293,5,3,11402,11402,11405,0,3,2
3294,1,3,11403,11405,11408,2,5,0
3295,2,2,11405,11408,11410,3,5,0
3296,1,3,11406,11410,11413,4,7,0
3297,2,2,11408,11413,11415,5,7,0
3298,3,3,11411,11415,11418,4,7,0
3299,3,2,11414,11418,11420,4,6,0
3300,5,1,11419,11420,11421,1,2,0
3301,6,2,11425,11425,11427,0,2,4
3302,5,3,11430,11430,11433,0,3,3
3303,4,1,11434,11434,11435,0,1,1
3304,2,3,11436,11436,11439,0,3,1
3305,6,1,11442,11442,11443,0,1,3
3306,5,2,11447,11447,11449,0,2,4
3307,5,3,11452,11452,11455,0,3,3
3308,3,2,11455,11455,11457,0,2,0
3309,5,1,11460,11460,11461,0,1,3
3310,5,1,11465,11465,11466,0,1,4
3311,2,3,11467,11467,11470,0,3,1
3312,5,2,11472,11472,11474,0,2,2
3313,1,1,11473,11474,11475,1,2,0
3314,1,3,11474,11475,11478,1,4,0
3315,4,1,11478,11478,11479,0,1,0
3316,6,1,11484,11484,11485,0,1,5
3317,4,3,11488,11488,11491,0,3,3
3318,6,2,11494,11494,11496,0,2,3
3319,3,2,11497,11497,11499,0,2,1
3320,4,3,11501,11501,11504,0,3,2
3321,4,3,11505,11505,11508,0,3,1
3322,4,3,11509,11509,11512,0,3,1
3323,4,3,11513,11513,11516,0,3,1
3324,1,2,11514,11516,11518,2,4,0
3325,1,3,11515,11518,11521,3,6,0
3326,2,1,11517,11521,11522,4,5,0
3327,2,3,11519,11522,11525,3,6,0
3328,1,3,11520,11525,11528,5,8,0
3329,2,1,11522,11528,11529,6,7,0
3330,3,3,11525,11529,11532,4,7,0
3331,3,3,11528,11532,11535,4,7,0
3332,1,3,11529,11535,11538,6,9,0
3333,4,3,11533,11538,11541,5,8,0
3334,2,3,11535,11541,11544,6,9,0
3335,5,2,11540,11544,11546,4,6,0
3336,1,3,11541,11546,11549,5,8,0
3337,3,3,11544,11549,11552,5,8,0
3338,4,1,11548,11552,11553,4,5,0
3339,2,2,11550,11553,11555,3,5,0
3340,6,1,11556,11556,11557,0,1,1
3341,5,2,11561,11561,11563,0,2,4
3342,2,2,11563,11563,11565,0,2,0
3343,2,1,11565,11565,11566,0,1,0
3344,5,3,11570,11570,11573,0,3,4
3345,2,2,11572,11573,11575,1,3,0
3346,6,2,11578,11578,11580,0,2,3
3347,2,1,11580,11580,11581,0,1,0
3348,5,3,11585,11585,11588,0,3,4
3349,4,1,11589,11589,11590,0,1,1
3350,2,3,11591,11591,11594,0,3,1
3351,3,3,11594,11594,11597,0,3,0
3352,1,2,11595,11597,11599,2,4,0
3353,5,2,11600,11600,11602,0,2,1
3354,4,2,11604,11604,11606,0,2,2
3355,6,1,11610,11610,11611,0,1,4
3356,3,1,11613,11613,11614,0,1,2
3357,3,3,11616,11616,11619,0,3,2
3358,4,1,11620,11620,11621,0,1,1
3359,4,1,11624,11624,11625,0,1,3
3360,5,2,11629,11629,11631,0,2,4
3361,4,2,11633,11633,11635,0,2,2
3362,1,3,11634,11635,11638,1,4,0
3363,6,3,11640,11640,11643,0,3,2
3364,4,1,11644,11644,11645,0,1,1
3365,3,1,11647,11647,11648,0,1,2
3366,6,1,11653,11653,11654,0,1,5
3367,4,3,11657,11657,11660,0,3,3
3368,4,2,11661,11661,11663,0,2,1
3369,2,2,11663,11663,11665,0,2,0
3370,2,2,11665,11665,11667,0,2,0
3371,3,1,11668,11668,11669,0,1,1
3372,3,1,11671,11671,11672,0,1,2
3373,4,2,11675,11675,11677,0,2,3
3374,2,1,11677,11677,11678,0,1,0
3375,1,1,11678,11678,11679,0,1,0
3376,2,3,11680,11680,11683,0,3,1
3377,1,1,11681,11683,11684,2,3,0
3378,4,3,11685,11685,11688,0,3,1
3379,1,2,11686,11688,11690,2,4,0
3380,6,2,11692,11692,11694,0,2,2
3381,5,2,11697,11697,11699,0,2,3
3382,4,3,11701,11701,11704,0,3,2
3383,6,1,11707,11707,11708,0,1,3
3384,2,3,11709,11709,11712,0,3,1
3385,1,2,11710,11712,11714,2,4,0
3386,6,1,11716,11716,11717,0,1,2
3387,4,2,11720,11720,11722,0,2,3
3388,1,2,11721,11722,11724,1,3,0
3389,5,3,11726,11726,11729,0,3,2
3390,5,2,11731,11731,11733,0,2,2
3391,4,1,11735,11735,11736,0,1,2
3392,3,2,11738,11738,11740,0,2,2
3393,3,1,11741,11741,11742,0,1,1
3394,1,2,11742,11742,11744,0,2,0
3395,6,3,11748,11748,11751,0,3,4
3396,1,2,11749,11751,11753,2,4,0
3397,1,1,11750,11753,11754,3,4,0
3398,6,2,11756,11756,11758,0,2,2
3399,1,1,11757,11758,11759,1,2,0
3400,5,2,11762,11762,11764,0,2,3
3401,5,3,11767,11767,11770,0,3,3
3402,5,2,11772,11772,11774,0,2,2
3403,5,1,11777,11777,11778,0,1,3
3404,6,1,11783,11783,11784,0,1,5
3405,5,2,11788,11788,11790,0,2,4
3406,6,1,11794,11794,11795,0,1,4
3407,1,1,11795,11795,11796,0,1,0
3408,1,1,11796,11796,11797,0,1,0
3409,5,3,11801,11801,11804,0,3,4
3410,2,2,11803,11804,11806,1,3,0
3411,3,1,11806,11806,11807,0,1,0
3412,6,1,11812,11812,11813,0,1,5
3413,3,3,11815,11815,11818,0,3,2
3414,3,3,11818,11818,11821,0,3,0
3415,5,1,11823,11823,11824,0,1,2
3416,1,1,11824,11824,11825,0,1,0
3417,6,1,11830,11830,11831,0,1,5
3418,2,1,11832,11832,11833,0,1,1
3419,6,1,11838,11838,11839,0,1,5
3420,6,1,11844,11844,11845,0,1,5
3421,4,3,11848,11848,11851,0,3,3
3422,2,2,11850,11851,11853,1,3,0
3423,5,1,11855,11855,11856,0,1,2
3424,3,3,11858,11858,11861,0,3,2
3425,6,1,11864,11864,11865,0,1,3
3426,1,2,11865,11865,11867,0,2,0
3427,1,2,11866,11867,11869,1,3,0
3428,6,3,11872,11872,11875,0,3,3
3429,2,2,11874,11875,11877,1,3,0
3430,3,3,11877,11877,11880,0,3,0
3431,4,2,11881,11881,11883,0,2,1
3432,5,1,11886,11886,11887,0,1,3
3433,4,3,11890,11890,11893,0,3,3
3434,5,2,11895,11895,11897,0,2,2
3435,6,2,11901,11901,11903,0,2,4
3436,4,3,11905,11905,11908,0,3,2
3437,5,1,11910,11910,11911,0,1,2
3438,5,3,11915,11915,11918,0,3,4
3439,5,3,11920,11920,11923,0,3,2
3440,3,1,11923,11923,11924,0,1,0
3441,1,3,11924,11924,11927,0,3,0
3442,6,3,11930,11930,11933,0,3,3
3443,4,2,11934,11934,11936,0,2,1
3444,3,2,11937,11937,11939,0,2,1
3445,5,2,11942,11942,11944,0,2,3
3446,6,2,11948,11948,11950,0,2,4
3447,3,2,11951,11951,11953,0,2,1
3448,4,2,11955,11955,11957,0,2,2
3449,6,3,11961,11961,11964,0,3,4
3450,4,3,11965,11965,11968,0,3,1
3451,4,3,11969,11969,11972,0,3,1
3452,2,2,11971,11972,11974,1,3,0
3453,3,3,11974,11974,11977,0,3,0
3454,4,1,11978,11978,11979,0,1,1
3455,5,3,11983,11983,11986,0,3,4
3456,5,1,11988,11988,11989,0,1,2
3457,4,1,11992,11992,11993,0,1,3
3458,2,1,11994,11994,11995,0,1,1
3459,4,3,11998,11998,12001,0,3,3
3460,6,2,12004,12004,12006,0,2,3
3461,2,2,12006,12006,12008,0,2,0
3462,2,1,12008,12008,12009,0,1,0
3463,3,2,12011,12011,12013,0,2,2
3464,1,2,12012,12013,12015,1,3,0
3465,4,2,12016,12016,12018,0,2,1
3466,5,2,12021,12021,12023,0,2,3
3467,6,2,12027,12027,12029,0,2,4
3468,3,1,12030,12030,12031,0,1,1
3469,4,2,12034,12034,12036,0,2,3
3470,2,2,12036,12036,12038,0,2,0
3471,6,3,12042,12042,12045,0,3,4
3472,1,1,12043,12045,12046,2,3,0
3473,5,2,12048,12048,12050,0,2,2
3474,5,1,12053,12053,12054,0,1,3
3475,1,2,12054,12054,12056,0,2,0
3476,2,3,12056,12056,12059,0,3,0
3477,6,2,12062,12062,12064,0,2,3
3478,2,1,12064,12064,12065,0,1,0
3479,4,1,12068,12068,12069,0,1,3
3480,3,1,12071,12071,12072,0,1,2
3481,6,3,12077,12077,12080,0,3,5
3482,3,3,12080,12080,12083,0,3,0
3483,4,2,12084,12084,12086,0,2,1
3484,5,3,12089,12089,12092,0,3,3
3485,5,3,12094,12094,12097,0,3,2
3486,4,3,12098,12098,12101,0,3,1
3487,1,1,12099,12101,12102,2,3,0
3488,6,2,12105,12105,12107,0,2,3
3489,5,1,12110,12110,12111,0,1,3
3490,4,1,12114,12114,12115,0,1,3
3491,5,3,12119,12119,12122,0,3,4
3492,4,1,12123,12123,12124,0,1,1
3493,1,1,12124,12124,12125,0,1,0
3494,5,1,12129,12129,12130,0,1,4
3495,1,2,12130,12130,12132,0,2,0
3496,2,2,12132,12132,12134,0,2,0
3497,6,3,12138,12138,12141,0,3,4
3498,2,3,12140,12141,12144,1,4,0
3499,3,1,12143,12144,12145,1,2,0
3500,6,2,12149,12149,12151,0,2,4
3501,3,2,12152,12152,12154,0,2,1
3502,3,2,12155,12155,12157,0,2,1
3503,3,2,12158,12158,12160,0,2,1
3504,5,2,12163,12163,12165,0,2,3
3505,5,3,12168,12168,12171,0,3,3
3506,1,3,12169,12171,12174,2,5,0
3507,2,3,12171,12174,12177,3,6,0
3508,4,3,12175,12177,12180,2,5,0
3509,4,2,12179,12180,12182,1,3,0
3510,4,2,12183,12183,12185,0,2,1
3511,2,3,12185,12185,12188,0,3,0
3512,4,3,12189,12189,12192,0,3,1
3513,4,1,12193,12193,12194,0,1,1
3514,3,2,12196,12196,12198,0,2,2
3515,5,1,12201,12201,12202,0,1,3
3516,5,2,12206,12206,12208,0,2,4
3517,6,1,12212,12212,12213,0,1,4
3518,2,2,12214,12214,12216,0,2,1
3519,4,1,12218,12218,12219,0,1,2
3520,6,3,12224,12224,12227,0,3,5
3521,6,1,12230,12230,12231,0,1,3
3522,6,3,12236,12236,12239,0,3,5
3523,1,2,12237,12239,12241,2,4,0
3524,3,2,12240,12241,12243,1,3,0
3525,5,1,12245,12245,12246,0,1,2
3526,5,2,12250,12250,12252,0,2,4
3527,6,2,12256,12256,12258,0,2,4
3528,1,2,12257,12258,12260,1,3,0
3529,1,3,12258,12260,12263,2,5,0
3530,2,3,12260,12263,12266,3,6,0
3531,4,3,12264,12266,12269,2,5,0
3532,5,2,12269,12269,12271,0,2,0
3533,1,2,12270,12271,12273,1,3,0
3534,2,3,12272,12273,12276,1,4,0
3535,3,3,12275,12276,12279,1,4,0
3536,3,1,12278,12279,12280,1,2,0
3537,5,1,12283,12283,12284,0,1,3
3538,4,2,12287,12287,12289,0,2,3
3539,6,3,12293,12293,12296,0,3,4
3540,3,3,12296,12296,12299,0,3,0
3541,3,2,12299,12299,12301,0,2,0
3542,5,2,12304,12304,12306,0,2,3
3543,6,1,12310,12310,12311,0,1,4
3544,5,1,12315,12315,12316,0,1,4
3545,6,1,12321,12321,12322,0,1,5
3546,1,2,12322,12322,12324,0,2,0
3547,5,2,12327,12327,12329,0,2,3
3548,5,2,12332,12332,12334,0,2,3
3549,2,2,12334,12334,12336,0,2,0
3550,3,1,12337,12337,12338,0,1,1
3551,2,2,12339,12339,12341,0,2,1
3552,4,3,12343,12343,12346,0,3,2
3553,1,1,12344,12346,12347,2,3,0
3554,6,3,12350,12350,12353,0,3,3
3555,6,1,12356,12356,12357,0,1,3
3556,4,1,12360,12360,12361,0,1,3
3557,6,1,12366,12366,12367,0,1,5
3558,1,2,12367,12367,12369,0,2,0
3559,3,1,12370,12370,12371,0,1,1
3560,5,2,12375,12375,12377,0,2,4
3561,4,2,12379,12379,12381,0,2,2
3562,3,3,12382,12382,12385,0,3,1
3563,5,3,12387,12387,12390,0,3,2
3564,6,1,12393,12393,12394,0,1,3
3565,4,2,12397,12397,12399,0,2,3
3566,1,1,12398,12399,12400,1,2,0
3567,5,1,12403,12403,12404,0,1,3
3568,5,2,12408,12408,12410,0,2,4
3569,2,1,12410,12410,12411,0,1,0
3570,2,3,12412,12412,12415,0,3,1
3571,3,2,12415,12415,12417,0,2,0
3572,4,1,12419,12419,12420,0,1,2
3573,4,2,12423,12423,12425,0,2,3
3574,5,1,12428,12428,12429,0,1,3
3575,5,3,12433,12433,12436,0,3,4
3576,3,2,12436,12436,12438,0,2,0
3577,4,2,12440,12440,12442,0,2,2
3578,3,3,12443,12443,12446,0,3,1
3579,1,3,12444,12446,12449,2,5,0
3580,6,1,12450,12450,12451,0,1,1
3581,3,3,12453,12453,12456,0,3,2
3582,4,3,12457,12457,12460,0,3,1
3583,1,2,12458,12460,12462,2,4,0
3584,2,2,12460,12462,12464,2,4,0
3585,2,1,12462,12464,12465,2,3,0
3586,1,1,12463,12465,12466,2,3,0
3587,6,3,12469,12469,12472,0,3,3
3588,5,3,12474,12474,12477,0,3,2
3589,4,3,12478,12478,12481,0,3,1
3590,4,1,12482,12482,12483,0,1,1
3591,5,2,12487,12487,12489,0,2,4
3592,4,3,12491,12491,12494,0,3,2
3593,5,2,12496,12496,12498,0,2,2
3594,1,3,12497,12498,12501,1,4,0
3595,3,3,12500,12501,12504,1,4,0
3596,2,1,12502,12504,12505,2,3,0
3597,2,2,12504,12505,12507,1,3,0
3598,2,2,12506,12507,12509,1,3,0
3599,5,3,12511,12511,12514,0,3,2
3600,4,2,12515,12515,12517,0,2,1
3601,1,1,12516,12517,12518,1,2,0
3602,4,2,12520,12520,12522,0,2,2
3603,6,1,12526,12526,12527,0,1,4
3604,5,1,12531,12531,12532,0,1,4
3605,2,3,12533,12533,12536,0,3,1
3606,5,3,12538,12538,12541,0,3,2
3607,6,3,12544,12544,12547,0,3,3
3608,1,2,12545,12547,12549,2,4,0
3609,5,2,12550,12550,12552,0,2,1
3610,1,3,12551,12552,12555,1,4,0
3611,5,3,12556,12556,12559,0,3,1
3612,6,2,12562,12562,12564,0,2,3
3613,3,3,12565,12565,12568,0,3,1
3614,2,1,12567,12568,12569,1,2,0
3615,6,3,12573,12573,12576,0,3,4
3616,4,1,12577,12577,12578,0,1,1
3617,6,3,12583,12583,12586,0,3,5
3618,2,1,12585,12586,12587,1,2,0
3619,1,3,12586,12587,12590,1,4,0
3620,5,2,12591,12591,12593,0,2,1
3621,4,2,12595,12595,12597,0,2,2
3622,3,3,12598,12598,12601,0,3,1
3623,6,1,12604,12604,12605,0,1,3
3624,2,1,12606,12606,12607,0,1,1
3625,4,1,12610,12610,12611,0,1,3
3626,1,2,12611,12611,12613,0,2,0
3627,3,3,12614,12614,12617,0,3,1
3628,5,1,12619,12619,12620,0,1,2
3629,4,3,12623,12623,12626,0,3,3
3630,2,3,12625,12626,12629,1,4,0
3631,3,2,12628,12629,12631,1,3,0
3632,3,3,12631,12631,12634,0,3,0
3633,6,3,12637,12637,12640,0,3,3
3634,1,1,12638,12640,12641,2,3,0
3635,2,1,12640,12641,12642,1,2,0
3636,4,2,12644,12644,12646,0,2,2
3637,5,2,12649,12649,12651,0,2,3
3638,2,2,12651,12651,12653,0,2,0
3639,4,2,12655,12655,12657,0,2,2
3640,1,3,12656,12657,12660,1,4,0
3641,2,1,12658,12660,12661,2,3,0
3642,3,2,12661,12661,12663,0,2,0
3643,2,2,12663,12663,12665,0,2,0
3644,1,2,12664,12665,12667,1,3,0
3645,5,2,12669,12669,12671,0,2,2
3646,4,2,12673,12673,12675,0,2,2
3647,2,3,12675,12675,12678,0,3,0
3648,2,3,12677,12678,12681,1,4,0
3649,1,3,12678,12681,12684,3,6,0
3650,4,3,12682,12684,12687,2,5,0
3651,5,2,12687,12687,12689,0,2,0
3652,3,1,12690,12690,12691,0,1,1
3653,5,3,12695,12695,12698,0,3,4
3654,4,3,12699,12699,12702,0,3,1
3655,4,2,12703,12703,12705,0,2,1
3656,1,1,12704,12705,12706,1,2,0
3657,4,1,12708,12708,12709,0,1,2
3658,3,2,12711,12711,12713,0,2,2
3659,2,2,12713,12713,12715,0,2,0
3660,4,1,12717,12717,12718,0,1,2
3661,6,1,12723,12723,12724,0,1,5
3662,1,1,12724,12724,12725,0,1,0
3663,2,1,12726,12726,12727,0,1,1
3664,5,1,12731,12731,12732,0,1,4
3665,5,3,12736,12736,12739,0,3,4
3666,6,2,12742,12742,12744,0,2,3
3667,2,3,12744,12744,12747,0,3,0
3668,1,2,12745,12747,12749,2,4,0
3669,4,3,12749,12749,12752,0,3,0
3670,3,3,12752,12752,12755,0,3,0
3671,3,3,12755,12755,12758,0,3,0
3672,1,3,12756,12758,12761,2,5,0
3673,5,1,12761,12761,12762,0,1,0
3674,3,2,12764,12764,12766,0,2,2
3675,6,2,12770,12770,12772,0,2,4
3676,4,3,12774,12774,12777,0,3,2
3677,2,2,12776,12777,12779,1,3,0
3678,6,3,12782,12782,12785,0,3,3
3679,1,1,12783,12785,12786,2,3,0
3680,6,1,12789,12789,12790,0,1,3
3681,2,2,12791,12791,12793,0,2,1
3682,4,2,12795,12795,12797,0,2,2
3683,2,3,12797,12797,12800,0,3,0
3684,5,2,12802,12802,12804,0,2,2
3685,3,1,12805,12805,12806,0,1,1
3686,6,1,12811,12811,12812,0,1,5
3687,6,3,12817,12817,12820,0,3,5
3688,1,2,12818,12820,12822,2,4,0
3689,2,1,12820,12822,12823,2,3,0
3690,4,3,12824,12824,12827,0,3,1
3691,3,3,12827,12827,12830,0,3,0
3692,1,3,12828,12830,12833,2,5,0
3693,3,3,12831,12833,12836,2,5,0
3694,3,1,12834,12836,12837,2,3,0
3695,5,3,12839,12839,12842,0,3,2
3696,1,2,12840,12842,12844,2,4,0
3697,6,3,12846,12846,12849,0,3,2
3698,5,1,12851,12851,12852,0,1,2
3699,1,3,12852,12852,12855,0,3,0
3700,6,2,12858,12858,12860,0,2,3
3701,6,3,12864,12864,12867,0,3,4
3702,1,1,12865,12867,12868,2,3,0
3703,6,2,12871,12871,12873,0,2,3
3704,5,2,12876,12876,12878,0,2,3
3705,3,3,12879,12879,12882,0,3,1
3706,2,2,12881,12882,12884,1,3,0
3707,1,3,12882,12884,12887,2,5,0
3708,1,1,12883,12887,12888,4,5,0
3709,4,3,12887,12888,12891,1,4,0
3710,4,1,12891,12891,12892,0,1,0
3711,3,2,12894,12894,12896,0,2,2
3712,4,2,12898,12898,12900,0,2,2
3713,5,2,12903,12903,12905,0,2,3
3714,5,1,12908,12908,12909,0,1,3
3715,5,1,12913,12913,12914,0,1,4
3716,6,3,12919,12919,12922,0,3,5
3717,1,3,12920,12922,12925,2,5,0
3718,5,3,12925,12925,12928,0,3,0
3719,3,3,12928,12928,12931,0,3,0
3720,6,2,12934,12934,12936,0,2,3
3721,1,3,12935,12936,12939,1,4,0
3722,5,2,12940,12940,12942,0,2,1
3723,3,1,12943,12943,12944,0,1,1
3724,3,1,12946,12946,12947,0,1,2
3725,3,2,12949,12949,12951,0,2,2
3726,3,3,12952,12952,12955,0,3,1
3727,2,1,12954,12955,12956,1,2,0
3728,3,1,12957,12957,12958,0,1,1
3729,5,3,12962,12962,12965,0,3,4
3730,2,3,12964,12965,12968,1,4,0
3731,5,1,12969,12969,12970,0,1,1
3732,6,3,12975,12975,12978,0,3,5
3733,1,2,12976,12978,12980,2,4,0
3734,4,2,12980,12980,12982,0,2,0
3735,4,1,12984,12984,12985,0,1,2
3736,3,2,12987,12987,12989,0,2,2
3737,1,2,12988,12989,12991,1,3,0
3738,1,1,12989,12991,12992,2,3,0
3739,1,1,12990,12992,12993,2,3,0
3740,5,2,12995,12995,12997,0,2,2
3741,1,3,12996,12997,13000,1,4,0
3742,6,2,13002,13002,13004,0,2,2
3743,2,1,13004,13004,13005,0,1,0
3744,2,1,13006,13006,13007,0,1,1
3745,1,2,13007,13007,13009,0,2,0
3746,1,1,13008,13009,13010,1,2,0
3747,3,1,13011,13011,13012,0,1,1
3748,1,2,13012,13012,13014,0,2,0
3749,4,1,13016,13016,13017,0,1,2
3750,4,2,13020,13020,13022,0,2,3
3751,4,2,13024,13024,13026,0,2,2
3752,2,2,13026,13026,13028,0,2,0
3753,4,2,13030,13030,13032,0,2,2
3754,4,2,13034,13034,13036,0,2,2
3755,3,3,13037,13037,13040,0,3,1
3756,4,3,13041,13041,13044,0,3,1
3757,3,3,13044,13044,13047,0,3,0
3758,5,3,13049,13049,13052,0,3,2
3759,1,1,13050,13052,13053,2,3,0
3760,5,2,13055,13055,13057,0,2,2
3761,5,3,13060,13060,13063,0,3,3
3762,5,2,13065,13065,13067,0,2,2
3763,6,3,13071,13071,13074,0,3,4
3764,5,2,13076,13076,13078,0,2,2
3765,2,2,13078,13078,13080,0,2,0
3766,5,1,13083,13083,13084,0,1,3
3767,4,3,13087,13087,13090,0,3,3
3768,5,3,13092,13092,13095,0,3,2
3769,1,3,13093,13095,13098,2,5,0
3770,4,1,13097,13098,13099,1,2,0
3771,4,3,13101,13101,13104,0,3,2
3772,2,1,13103,13104,13105,1,2,0
3773,4,3,13107,13107,13110,0,3,2
3774,5,1,13112,13112,13113,0,1,2
3775,6,2,13118,13118,13120,0,2,5
3776,1,2,13119,13120,13122,1,3,0
3777,6,3,13125,13125,13128,0,3,3
3778,2,2,13127,13128,13130,1,3,0
3779,6,2,13133,13133,13135,0,2,3
3780,3,2,13136,13136,13138,0,2,1
3781,2,1,13138,13138,13139,0,1,0
3782,6,1,13144,13144,13145,0,1,5
3783,1,2,13145,13145,13147,0,2,0
3784,4,1,13149,13149,13150,0,1,2
3785,4,3,13153,13153,13156,0,3,3
3786,3,3,13156,13156,13159,0,3,0
3787,1,3,13157,13159,13162,2,5,0
3788,3,3,13160,13162,13165,2,5,0
3789,3,1,13163,13165,13166,2,3,0
3790,3,1,13166,13166,13167,0,1,0
3791,2,3,13168,13168,13171,0,3,1
3792,6,3,13174,13174,13177,0,3,3
3793,3,1,13177,13177,13178,0,1,0
3794,6,2,13183,13183,13185,0,2,5
3795,2,3,13185,13185,13188,0,3,0
3796,2,2,13187,13188,13190,1,3,0
3797,6,2,13193,13193,13195,0,2,3
3798,5,3,13198,13198,13201,0,3,3
3799,2,2,13200,13201,13203,1,3,0
3800,2,1,13202,13203,13204,1,2,0
3801,4,2,13206,13206,13208,0,2,2
3802,2,3,13208,13208,13211,0,3,0
3803,1,2,13209,13211,13213,2,4,0
3804,6,3,13215,13215,13218,0,3,2
3805,2,1,13217,13218,13219,1,2,0
3806,6,2,13223,13223,13225,0,2,4
3807,5,1,13228,13228,13229,0,1,3
3808,6,2,13234,13234,13236,0,2,5
3809,1,2,13235,13236,13238,1,3,0
3810,2,1,13237,13238,13239,1,2,0
3811,6,2,13243,13243,13245,0,2,4
3812,1,2,13244,13245,13247,1,3,0
3813,3,3,13247,13247,13250,0,3,0
3814,5,1,13252,13252,13253,0,1,2
3815,6,3,13258,13258,13261,0,3,5
3816,6,2,13264,13264,13266,0,2,3
3817,1,1,13265,13266,13267,1,2,0
3818,5,2,13270,13270,13272,0,2,3
3819,5,1,13275,13275,13276,0,1,3
3820,5,3,13280,13280,13283,0,3,4
3821,1,3,13281,13283,13286,2,5,0
3822,6,2,13287,13287,13289,0,2,1
3823,6,2,13293,13293,13295,0,2,4
3824,2,3,13295,13295,13298,0,3,0
3825,3,3,13298,13298,13301,0,3,0
3826,4,3,13302,13302,13305,0,3,1
3827,2,2,13304,13305,13307,1,3,0
3828,2,2,13306,13307,13309,1,3,0
3829,2,1,13308,13309,13310,1,2,0
3830,3,2,13311,13311,13313,0,2,1
3831,3,3,13314,13314,13317,0,3,1
3832,3,1,13317,13317,13318,0,1,0
3833,6,2,13323,13323,13325,0,2,5
3834,5,1,13328,13328,13329,0,1,3
3835,1,2,13329,13329,13331,0,2,0
3836,3,3,13332,13332,13335,0,3,1
3837,2,1,13334,13335,13336,1,2,0
3838,2,3,13336,13336,13339,0,3,0
3839,6,3,13342,13342,13345,0,3,3
3840,6,3,13348,13348,13351,0,3,3
3841,5,1,13353,13353,13354,0,1,2
3842,5,3,13358,13358,13361,0,3,4
3843,2,3,13360,13361,13364,1,4,0
3844,4,1,13364,13364,13365,0,1,0
3845,4,2,13368,13368,13370,0,2,3
3846,4,1,13372,13372,13373,0,1,2
3847,6,1,13378,13378,13379,0,1,5
3848,4,1,13382,13382,13383,0,1,3
3849,3,3,13385,13385,13388,0,3,2
3850,2,1,13387,13388,13389,1,2,0
3851,6,2,13393,13393,13395,0,2,4
3852,6,2,13399,13399,13401,0,2,4
3853,1,2,13400,13401,13403,1,3,0
3854,1,1,13401,13403,13404,2,3,0
3855,4,1,13405,13405,13406,0,1,1
3856,3,3,13408,13408,13411,0,3,2
3857,6,3,13414,13414,13417,0,3,3
3858,6,2,13420,13420,13422,0,2,3
3859,1,2,13421,13422,13424,1,3,0
3860,1,3,13422,13424,13427,2,5,0
3861,4,3,13426,13427,13430,1,4,0
3862,3,3,13429,13430,13433,1,4,0
3863,2,2,13431,13433,13435,2,4,0
3864,3,2,13434,13435,13437,1,3,0
3865,4,3,13438,13438,13441,0,3,1
3866,2,2,13440,13441,13443,1,3,0
3867,5,1,13445,13445,13446,0,1,2
3868,3,2,13448,13448,13450,0,2,2
3869,2,2,13450,13450,13452,0,2,0
3870,6,3,13456,13456,13459,0,3,4
3871,2,1,13458,13459,13460,1,2,0
3872,4,1,13462,13462,13463,0,1,2
3873,5,1,13467,13467,13468,0,1,4
3874,1,3,13468,13468,13471,0,3,0
3875,4,1,13472,13472,13473,0,1,1
3876,6,2,13478,13478,13480,0,2,5
3877,3,1,13481,13481,13482,0,1,1
3878,6,3,13487,13487,13490,0,3,5
3879,5,2,13492,13492,13494,0,2,2
3880,2,2,13494,13494,13496,0,2,0
3881,4,2,13498,13498,13500,0,2,2
3882,1,1,13499,13500,13501,1,2,0
3883,5,1,13504,13504,13505,0,1,3
3884,5,2,13509,13509,13511,0,2,4
3885,4,3,13513,13513,13516,0,3,2
3886,6,1,13519,13519,13520,0,1,3
3887,5,1,13524,13524,13525,0,1,4
3888,6,1,13530,13530,13531,0,1,5
3889,3,2,13533,13533,13535,0,2,2
3890,6,2,13539,13539,13541,0,2,4
3891,3,1,13542,13542,13543,0,1,1
3892,3,3,13545,13545,13548,0,3,2
3893,2,2,13547,13548,13550,1,3,0
3894,4,3,13551,13551,13554,0,3,1
3895,1,2,13552,13554,13556,2,4,0
3896,2,2,13554,13556,13558,2,4,0
3897,4,1,13558,13558,13559,0,1,0
3898,2,1,13560,13560,13561,0,1,1
3899,5,2,13565,13565,13567,0,2,4
3900,3,1,13568,13568,13569,0,1,1
3901,5,1,13573,13573,13574,0,1,4
3902,3,3,13576,13576,13579,0,3,2
3903,4,1,13580,13580,13581,0,1,1
3904,6,1,13586,13586,13587,0,1,5
3905,2,2,13588,13588,13590,0,2,1
3906,3,1,13591,13591,13592,0,1,1
3907,1,2,13592,13592,13594,0,2,0
3908,5,3,13597,13597,13600,0,3,3
3909,6,3,13603,13603,13606,0,3,3
3910,6,1,13609,13609,13610,0,1,3
3911,6,2,13615,13615,13617,0,2,5
3912,3,1,13618,13618,13619,0,1,1
3913,2,2,13620,13620,13622,0,2,1
3914,5,2,13625,13625,13627,0,2,3
3915,1,3,13626,13627,13630,1,4,0
3916,2,1,13628,13630,13631,2,3,0
3917,2,1,13630,13631,13632,1,2,0
3918,3,2,13633,13633,13635,0,2,1
3919,5,3,13638,13638,13641,0,3,3
3920,4,1,13642,13642,13643,0,1,1
3921,2,2,13644,13644,13646,0,2,1
3922,5,3,13649,13649,13652,0,3,3
3923,3,1,13652,13652,13653,0,1,0
3924,4,1,13656,13656,13657,0,1,3
3925,1,2,13657,13657,13659,0,2,0
3926,3,1,13660,13660,13661,0,1,1
3927,4,2,13664,13664,13666,0,2,3
3928,2,2,13666,13666,13668,0,2,0
3929,4,2,13670,13670,13672,0,2,2
3930,1,1,13671,13672,13673,1,2,0
3931,4,3,13675,13675,13678,0,3,2
3932,1,1,13676,13678,13679,2,3,0
3933,4,3,13680,13680,13683,0,3,1
3934,5,2,13685,13685,13687,0,2,2
3935,3,1,13688,13688,13689,0,1,1
3936,3,1,13691,13691,13692,0,1,2
3937,4,3,13695,13695,13698,0,3,3
3938,3,2,13698,13698,13700,0,2,0
3939,1,3,13699,13700,13703,1,4,0
3940,6,3,13705,13705,13708,0,3,2
3941,3,1,13708,13708,13709,0,1,0
3942,2,1,13710,13710,13711,0,1,1
3943,5,2,13715,13715,13717,0,2,4
3944,2,1,13717,13717,13718,0,1,0
3945,6,2,13723,13723,13725,0,2,5
3946,5,2,13728,13728,13730,0,2,3
3947,3,1,13731,13731,13732,0,1,1
3948,4,3,13735,13735,13738,0,3,3
3949,5,2,13740,13740,13742,0,2,2
3950,4,1,13744,13744,13745,0,1,2
3951,5,3,13749,13749,13752,0,3,4
3952,6,1,13755,13755,13756,0,1,3
3953,4,1,13759,13759,13760,0,1,3
3954,2,3,13761,13761,13764,0,3,1
3955,5,1,13766,13766,13767,0,1,2
3956,1,3,13767,13767,13770,0,3,0
3957,4,3,13771,13771,13774,0,3,1
3958,6,3,13777,13777,13780,0,3,3
3959,4,2,13781,13781,13783,0,2,1
3960,2,1,13783,13783,13784,0,1,0
3961,4,2,13787,13787,13789,0,2,3
3962,6,2,13793,13793,13795,0,2,4
3963,4,1,13797,13797,13798,0,1,2
3964,4,3,13801,13801,13804,0,3,3
3965,5,3,13806,13806,13809,0,3,2
3966,1,2,13807,13809,13811,2,4,0
3967,2,2,13809,13811,13813,2,4,0
3968,2,1,13811,13813,13814,2,3,0
3969,2,1,13813,13814,13815,1,2,0
3970,2,1,13815,13815,13816,0,1,0
3971,3,3,13818,13818,13821,0,3,2
3972,3,3,13821,13821,13824,0,3,0
3973,2,1,13823,13824,13825,1,2,0
3974,2,3,13825,13825,13828,0,3,0
3975,3,2,13828,13828,13830,0,2,0
3976,3,3,13831,13831,13834,0,3,1
3977,6,2,13837,13837,13839,0,2,3
3978,3,2,13840,13840,13842,0,2,1
3979,5,1,13845,13845,13846,0,1,3
3980,5,2,13850,13850,13852,0,2,4
3981,4,2,13854,13854,13856,0,2,2
3982,1,2,13855,13856,13858,1,3,0
3983,5,1,13860,13860,13861,0,1,2
3984,4,3,13864,13864,13867,0,3,3
3985,4,2,13868,13868,13870,0,2,1
3986,6,2,13874,13874,13876,0,2,4
3987,4,3,13878,13878,13881,0,3,2
3988,1,3,13879,13881,13884,2,5,0
3989,4,2,13883,13884,13886,1,3,0
3990,1,2,13884,13886,13888,2,4,0
3991,1,3,13885,13888,13891,3,6,0
3992,2,3,13887,13891,13894,4,7,0
3993,6,3,13893,13894,13897,1,4,0
3994,6,2,13899,13899,13901,0,2,2
3995,5,3,13904,13904,13907,0,3,3
3996,4,2,13908,13908,13910,0,2,1
3997,3,2,13911,13911,13913,0,2,1
3998,4,1,13915,13915,13916,0,1,2
3999,3,3,13918,13918,13921,0,3,2
4000,1,3,13919,13921,13924,2,5,0
4001,1,1,13920,13924,13925,4,5,0
4002,2,1,13922,13925,13926,3,4,0
4003,1,2,13923,13926,13928,3,5,0
4004,2,2,13925,13928,13930,3,5,0
4005,1,3,13926,13930,13933,4,7,0
4006,6,1,13932,13933,13934,1,2,0
4007,4,2,13936,13936,13938,0,2,2
4008,5,2,13941,13941,13943,0,2,3
4009,4,1,13945,13945,13946,0,1,2
4010,3,3,13948,13948,13951,0,3,2
4011,6,3,13954,13954,13957,0,3,3
4012,1,1,13955,13957,13958,2,3,0
4013,4,1,13959,13959,13960,0,1,1
4014,6,2,13965,13965,13967,0,2,5
4015,1,1,13966,13967,13968,1,2,0
4016,5,2,13971,13971,13973,0,2,3
4017,2,2,13973,13973,13975,0,2,0
4018,3,3,13976,13976,13979,0,3,1
4019,5,3,13981,13981,13984,0,3,2
4020,6,1,13987,13987,13988,0,1,3
4021,6,1,13993,13993,13994,0,1,5
4022,6,2,13999,13999,14001,0,2,5
4023,6,1,14005,14005,14006,0,1,4
4024,4,1,14009,14009,14010,0,1,3
4025,1,1,14010,14010,14011,0,1,0
4026,5,3,14015,14015,14018,0,3,4
4027,4,3,14019,14019,14022,0,3,1
4028,1,3,14020,14022,14025,2,5,0
4029,1,1,14021,14025,14026,4,5,0
4030,1,3,14022,14026,14029,4,7,0
4031,1,3,14023,14029,14032,6,9,0
4032,2,2,14025,14032,14034,7,9,0
4033,4,1,14029,14034,14035,5,6,0
4034,4,1,14033,14035,14036,2,3,0
4035,2,1,14035,14036,14037,1,2,0
4036,4,3,14039,14039,14042,0,3,2
4037,6,1,14045,14045,14046,0,1,3
4038,3,2,14048,14048,14050,0,2,2
4039,4,1,14052,14052,14053,0,1,2
4040,6,3,14058,14058,14061,0,3,5
4041,6,1,14064,14064,14065,0,1,3
4042,4,2,14068,14068,14070,0,2,3
4043,4,2,14072,14072,14074,0,2,2
4044,6,1,14078,14078,14079,0,1,4
4045,3,2,14081,14081,14083,0,2,2
4046,2,2,14083,14083,14085,0,2,0
4047,5,3,14088,14088,14091,0,3,3
4048,1,1,14089,14091,14092,2,3,0
4049,1,1,14090,14092,14093,2,3,0
4050,3,1,14093,14093,14094,0,1,0
4051,1,2,14094,14094,14096,0,2,0
4052,5,2,14099,14099,14101,0,2,3
4053,5,2,14104,14104,14106,0,2,3
4054,6,1,14110,14110,14111,0,1,4
4055,3,1,14113,14113,14114,0,1,2
4056,1,3,14114,14114,14117,0,3,0
4057,2,3,14116,14117,14120,1,4,0
4058,3,2,14119,14120,14122,1,3,0
4059,5,3,14124,14124,14127,0,3,2
4060,1,1,14125,14127,14128,2,3,0
4061,5,3,14130,14130,14133,0,3,2
4062,3,2,14133,14133,14135,0,2,0
4063,2,1,14135,14135,14136,0,1,0
4064,5,3,14140,14140,14143,0,3,4
4065,3,1,14143,14143,14144,0,1,0
4066,5,2,14148,14148,14150,0,2,4
4067,4,3,14152,14152,14155,0,3,2
4068,1,1,14153,14155,14156,2,3,0
4069,2,1,14155,14156,14157,1,2,0
4070,1,3,14156,14157,14160,1,4,0
4071,6,3,14162,14162,14165,0,3,2
4072,4,2,14166,14166,14168,0,2,1
4073,5,3,14171,14171,14174,0,3,3
4074,4,3,14175,14175,14178,0,3,1
4075,2,2,14177,14178,14180,1,3,0
4076,3,1,14180,14180,14181,0,1,0
4077,5,3,14185,14185,14188,0,3,4
4078,5,2,14190,14190,14192,0,2,2
4079,1,2,14191,14192,14194,1,3,0
4080,6,1,14197,14197,14198,0,1,3
4081,3,3,14200,14200,14203,0,3,2
4082,3,3,14203,14203,14206,0,3,0
4083,6,1,14209,14209,14210,0,1,3
4084,1,3,14210,14210,14213,0,3,0
4085,5,3,14215,14215,14218,0,3,2
4086,1,1,14216,14218,14219,2,3,0
4087,4,1,14220,14220,14221,0,1,1
4088,4,3,14224,14224,14227,0,3,3
4089,1,3,14225,14227,14230,2,5,0
4090,1,1,14226,14230,14231,4,5,0
4091,4,1,14230,14231,14232,1,2,0
4092,5,1,14235,14235,14236,0,1,3
4093,5,2,14240,14240,14242,0,2,4
4094,3,3,14243,14243,14246,0,3,1
4095,2,3,14245,14246,14249,1,4,0
4096,4,3,14249,14249,14252,0,3,0
4097,5,3,14254,14254,14257,0,3,2
4098,5,1,14259,14259,14260,0,1,2
4099,1,2,14260,14260,14262,0,2,0
4100,2,2,14262,14262,14264,0,2,0
4101,5,2,14267,14267,14269,0,2,3
4102,5,1,14272,14272,14273,0,1,3
4103,1,2,14273,14273,14275,0,2,0
4104,5,3,14278,14278,14281,0,3,3
4105,1,2,14279,14281,14283,2,4,0
4106,5,3,14284,14284,14287,0,3,1
4107,5,3,14289,14289,14292,0,3,2
4108,2,1,14291,14292,14293,1,2,0
4109,4,3,14295,14295,14298,0,3,2
4110,2,3,14297,14298,14301,1,4,0
4111,4,3,14301,14301,14304,0,3,0
4112,3,3,14304,14304,14307,0,3,0
4113,4,1,14308,14308,14309,0,1,1
4114,1,2,14309,14309,14311,0,2,0
4115,2,1,14311,14311,14312,0,1,0
4116,4,3,14315,14315,14318,0,3,3
4117,3,1,14318,14318,14319,0,1,0
4118,5,3,14323,14323,14326,0,3,4
4119,6,2,14329,14329,14331,0,2,3
4120,1,1,14330,14331,14332,1,2,0
4121,5,1,14335,14335,14336,0,1,3
4122,5,1,14340,14340,14341,0,1,4
4123,4,2,14344,14344,14346,0,2,3
4124,2,1,14346,14346,14347,0,1,0
4125,4,1,14350,14350,14351,0,1,3
4126,3,2,14353,14353,14355,0,2,2
4127,1,3,14354,14355,14358,1,4,0
4128,5,2,14359,14359,14361,0,2,1
4129,1,1,14360,14361,14362,1,2,0
4130,3,1,14363,14363,14364,0,1,1
4131,2,1,14365,14365,14366,0,1,1
4132,3,3,14368,14368,14371,0,3,2
4133,1,2,14369,14371,14373,2,4,0
4134,5,3,14374,14374,14377,0,3,1
4135,1,2,14375,14377,14379,2,4,0
4136,5,1,14380,14380,14381,0,1,1
4137,4,3,14384,14384,14387,0,3,3
4138,4,2,14388,14388,14390,0,2,1
4139,6,1,14394,14394,14395,0,1,4
4140,5,3,14399,14399,14402,0,3,4
4141,1,2,14400,14402,14404,2,4,0
4142,5,2,14405,14405,14407,0,2,1
4143,1,3,14406,14407,14410,1,4,0
4144,3,3,14409,14410,14413,1,4,0
4145,4,3,14413,14413,14416,0,3,0
4146,3,2,14416,14416,14418,0,2,0
4147,5,2,14421,14421,14423,0,2,3
4148,6,1,14427,14427,14428,0,1,4
4149,2,3,14429,14429,14432,0,3,1
4150,1,2,14430,14432,14434,2,4,0
4151,6,1,14436,14436,14437,0,1,2
4152,2,3,14438,14438,14441,0,3,1
4153,5,1,14443,14443,14444,0,1,2
4154,6,2,14449,14449,14451,0,2,5
4155,6,2,14455,14455,14457,0,2,4
4156,1,1,14456,14457,14458,1,2,0
4157,4,2,14460,14460,14462,0,2,2
4158,1,3,14461,14462,14465,1,4,0
4159,1,2,14462,14465,14467,3,5,0
4160,2,1,14464,14467,14468,3,4,0
4161,2,2,14466,14468,14470,2,4,0
4162,2,3,14468,14470,14473,2,5,0
4163,1,1,14469,14473,14474,4,5,0
4164,1,3,14470,14474,14477,4,7,0
4165,4,2,14474,14477,14479,3,5,0
4166,6,2,14480,14480,14482,0,2,1
4167,5,3,14485,14485,14488,0,3,3
4168,3,3,14488,14488,14491,0,3,0
4169,6,1,14494,14494,14495,0,1,3
4170,6,3,14500,14500,14503,0,3,5
4171,2,2,14502,14503,14505,1,3,0
4172,3,3,14505,14505,14508,0,3,0
4173,4,1,14509,14509,14510,0,1,1
4174,2,1,14511,14511,14512,0,1,1
4175,2,3,14513,14513,14516,0,3,1
4176,1,2,14514,14516,14518,2,4,0
4177,1,2,14515,14518,14520,3,5,0
4178,2,1,14517,14520,14521,3,4,0
4179,3,2,14520,14521,14523,1,3,0
4180,5,3,14525,14525,14528,0,3,2
4181,6,2,14531,14531,14533,0,2,3
4182,3,2,14534,14534,14536,0,2,1
4183,5,1,14539,14539,14540,0,1,3
4184,2,3,14541,14541,14544,0,3,1
4185,5,2,14546,14546,14548,0,2,2
4186,3,1,14549,14549,14550,0,1,1
4187,3,2,14552,14552,14554,0,2,2
4188,1,3,14553,14554,14557,1,4,0
4189,1,2,14554,14557,14559,3,5,0
4190,5,1,14559,14559,14560,0,1,0
4191,2,1,14561,14561,14562,0,1,1
4192,4,3,14565,14565,14568,0,3,3
4193,4,2,14569,14569,14571,0,2,1
4194,2,2,14571,14571,14573,0,2,0
4195,6,1,14577,14577,14578,0,1,4
4196,3,2,14580,14580,14582,0,2,2
4197,4,2,14584,14584,14586,0,2,2
4198,2,1,14586,14586,14587,0,1,0
4199,2,3,14588,14588,14591,0,3,1
4200,1,2,14589,14591,14593,2,4,0
4201,1,2,14590,14593,14595,3,5,0
4202,4,2,14594,14595,14597,1,3,0
4203,3,1,14597,14597,14598,0,1,0
4204,6,3,14603,14603,14606,0,3,5
4205,1,1,14604,14606,14607,2,3,0
4206,6,1,14610,14610,14611,0,1,3
4207,4,1,14614,14614,14615,0,1,3
4208,6,2,14620,14620,14622,0,2,5
4209,3,2,14623,14623,14625,0,2,1
4210,5,3,14628,14628,14631,0,3,3
4211,1,3,14629,14631,14634,2,5,0
4212,2,1,14631,14634,14635,3,4,0
4213,3,3,14634,14635,14638,1,4,0
4214,4,1,14638,14638,14639,0,1,0
4215,1,3,14639,14639,14642,0,3,0
4216,2,2,14641,14642,14644,1,3,0
4217,2,2,14643,14644,14646,1,3,0
4218,4,1,14647,14647,14648,0,1,1
4219,2,1,14649,14649,14650,0,1,1
4220,5,3,14654,14654,14657,0,3,4
4221,6,1,14660,14660,14661,0,1,3
4222,6,1,14666,14666,14667,0,1,5
4223,4,1,14670,14670,14671,0,1,3
4224,5,1,14675,14675,14676,0,1,4
4225,6,3,14681,14681,14684,0,3,5
4226,2,2,14683,14684,14686,1,3,0
4227,3,2,14686,14686,14688,0,2,0
4228,3,2,14689,14689,14691,0,2,1
4229,3,3,14692,14692,14695,0,3,1
4230,1,2,14693,14695,14697,2,4,0
4231,6,2,14699,14699,14701,0,2,2
4232,5,1,14704,14704,14705,0,1,3
4233,1,1,14705,14705,14706,0,1,0
4234,3,2,14708,14708,14710,0,2,2
4235,4,1,14712,14712,14713,0,1,2
4236,2,3,14714,14714,14717,0,3,1
4237,6,1,14720,14720,14721,0,1,3
4238,2,1,14722,14722,14723,0,1,1
4239,6,3,14728,14728,14731,0,3,5
4240,2,2,14730,14731,14733,1,3,0
4241,2,1,14732,14733,14734,1,2,0
4242,2,1,14734,14734,14735,0,1,0
4243,2,2,14736,14736,14738,0,2,1
4244,5,1,14741,14741,14742,0,1,3
4245,1,1,14742,14742,14743,0,1,0
4246,4,1,14746,14746,14747,0,1,3
4247,2,2,14748,14748,14750,0,2,1
4248,6,2,14754,14754,14756,0,2,4
4249,1,3,14755,14756,14759,1,4,0
4250,6,3,14761,14761,14764,0,3,2
4251,4,1,14765,14765,14766,0,1,1
4252,4,2,14769,14769,14771,0,2,3
4253,4,1,14773,14773,14774,0,1,2
4254,2,1,14775,14775,14776,0,1,1
4255,3,3,14778,14778,14781,0,3,2
4256,3,1,14781,14781,14782,0,1,0
4257,5,2,14786,14786,14788,0,2,4
4258,1,1,14787,14788,14789,1,2,0
4259,5,2,14792,14792,14794,0,2,3
4260,2,3,14794,14794,14797,0,3,0
4261,4,2,14798,14798,14800,0,2,1
4262,4,1,14802,14802,14803,0,1,2
4263,6,2,14808,14808,14810,0,2,5
4264,5,2,14813,14813,14815,0,2,3
4265,2,1,14815,14815,14816,0,1,0
4266,3,2,14818,14818,14820,0,2,2
4267,4,2,14822,14822,14824,0,2,2
4268,6,1,14828,14828,14829,0,1,4
4269,3,3,14831,14831,14834,0,3,2
4270,5,2,14836,14836,14838,0,2,2
4271,4,3,14840,14840,14843,0,3,2
4272,5,2,14845,14845,14847,0,2,2
4273,3,1,14848,14848,14849,0,1,1
4274,5,1,14853,14853,14854,0,1,4
4275,1,2,14854,14854,14856,0,2,0
4276,6,2,14860,14860,14862,0,2,4
4277,3,3,14863,14863,14866,0,3,1
4278,3,2,14866,14866,14868,0,2,0
4279,4,2,14870,14870,14872,0,2,2
4280,1,2,14871,14872,14874,1,3,0
4281,6,1,14877,14877,14878,0,1,3
4282,4,3,14881,14881,14884,0,3,3
4283,2,1,14883,14884,14885,1,2,0
4284,4,3,14887,14887,14890,0,3,2
4285,6,3,14893,14893,14896,0,3,3
4286,5,2,14898,14898,14900,0,2,2
4287,4,2,14902,14902,14904,0,2,2
4288,5,2,14907,14907,14909,0,2,3
4289,3,3,14910,14910,14913,0,3,1
4290,2,2,14912,14913,14915,1,3,0
4291,1,3,14913,14915,14918,2,5,0
4292,4,3,14917,14918,14921,1,4,0
4293,5,3,14922,14922,14925,0,3,1
4294,6,2,14928,14928,14930,0,2,3
4295,1,1,14929,14930,14931,1,2,0
4296,3,3,14932,14932,14935,0,3,1
4297,2,3,14934,14935,14938,1,4,0
4298,1,3,14935,14938,14941,3,6,0
4299,3,2,14938,14941,14943,3,5,0
4300,1,3,14939,14943,14946,4,7,0
4301,6,3,14945,14946,14949,1,4,0
4302,5,3,14950,14950,14953,0,3,1
4303,1,2,14951,14953,14955,2,4,0
4304,3,3,14954,14955,14958,1,4,0
4305,6,3,14960,14960,14963,0,3,2
4306,3,1,14963,14963,14964,0,1,0
4307,4,2,14967,14967,14969,0,2,3
4308,6,3,14973,14973,14976,0,3,4
4309,4,2,14977,14977,14979,0,2,1
4310,3,3,14980,14980,14983,0,3,1
4311,1,2,14981,14983,14985,2,4,0
4312,2,3,14983,14985,14988,2,5,0
4313,3,1,14986,14988,14989,2,3,0
4314,2,2,14988,14989,14991,1,3,0
4315,6,1,14994,14994,14995,0,1,3
4316,6,1,15000,15000,15001,0,1,5
4317,5,2,15005,15005,15007,0,2,4
4318,5,3,15010,15010,15013,0,3,3
4319,1,2,15011,15013,15015,2,4,0
4320,1,3,15012,15015,15018,3,6,0
4321,3,2,15015,15018,15020,3,5,0
4322,3,2,15018,15020,15022,2,4,0
4323,3,2,15021,15022,15024,1,3,0
4324,2,3,15023,15024,15027,1,4,0
4325,6,3,15029,15029,15032,0,3,2
4326,5,3,15034,15034,15037,0,3,2
4327,5,1,15039,15039,15040,0,1,2
4328,5,1,15044,15044,15045,0,1,4
4329,4,2,15048,15048,15050,0,2,3
4330,3,2,15051,15051,15053,0,2,1
4331,4,3,15055,15055,15058,0,3,2
4332,6,3,15061,15061,15064,0,3,3
4333,5,1,15066,15066,15067,0,1,2
4334,3,1,15069,15069,15070,0,1,2
4335,3,1,15072,15072,15073,0,1,2
4336,5,3,15077,15077,15080,0,3,4
4337,4,1,15081,15081,15082,0,1,1
4338,4,2,15085,15085,15087,0,2,3
4339,6,1,15091,15091,15092,0,1,4
4340,3,2,15094,15094,15096,0,2,2
4341,5,1,15099,15099,15100,0,1,3
4342,1,1,15100,15100,15101,0,1,0
4343,2,3,15102,15102,15105,0,3,1
4344,4,1,15106,15106,15107,0,1,1
4345,4,3,15110,15110,15113,0,3,3
4346,3,3,15113,15113,15116,0,3,0
4347,5,2,15118,15118,15120,0,2,2
4348,3,2,15121,15121,15123,0,2,1
4349,5,1,15126,15126,15127,0,1,3
4350,5,3,15131,15131,15134,0,3,4
4351,2,2,15133,15134,15136,1,3,0
4352,2,1,15135,15136,15137,1,2,0
4353,4,2,15139,15139,15141,0,2,2
4354,2,1,15141,15141,15142,0,1,0
4355,4,1,15145,15145,15146,0,1,3
4356,1,2,15146,15146,15148,0,2,0
4357,4,3,15150,15150,15153,0,3,2
4358,5,3,15155,15155,15158,0,3,2
4359,4,3,15159,15159,15162,0,3,1
4360,2,2,15161,15162,15164,1,3,0
4361,5,3,15166,15166,15169,0,3,2
4362,6,2,15172,15172,15174,0,2,3
4363,6,1,15178,15178,15179,0,1,4
4364,6,2,15184,15184,15186,0,2,5
4365,4,1,15188,15188,15189,0,1,2
4366,5,3,15193,15193,15196,0,3,4
4367,1,1,15194,15196,15197,2,3,0
4368,5,3,15199,15199,15202,0,3,2
4369,2,3,15201,15202,15205,1,4,0
4370,5,2,15206,15206,15208,0,2,1
4371,2,3,15208,15208,15211,0,3,0
4372,2,3,15210,15211,15214,1,4,0
4373,5,1,15215,15215,15216,0,1,1
4374,4,2,15219,15219,15221,0,2,3
4375,6,3,15225,15225,15228,0,3,4
4376,1,3,15226,15228,15231,2,5,0
4377,6,2,15232,15232,15234,0,2,1
4378,1,2,15233,15234,15236,1,3,0
4379,4,1,15237,15237,15238,0,1,1
4380,6,2,15243,15243,15245,0,2,5
4381,2,2,15245,15245,15247,0,2,0
4382,2,3,15247,15247,15250,0,3,0
4383,2,3,15249,15250,15253,1,4,0
4384,2,3,15251,15253,15256,2,5,0
4385,5,3,15256,15256,15259,0,3,0
4386,6,1,15262,15262,15263,0,1,3
4387,5,3,15267,15267,15270,0,3,4
4388,2,2,15269,15270,15272,1,3,0
4389,2,1,15271,15272,15273,1,2,0
4390,3,1,15274,15274,15275,0,1,1
4391,4,1,15278,15278,15279,0,1,3
4392,5,1,15283,15283,15284,0,1,4
4393,1,1,15284,15284,15285,0,1,0
4394,3,3,15287,15287,15290,0,3,2
4395,1,3,15288,15290,15293,2,5,0
4396,6,1,15294,15294,15295,0,1,1
4397,6,2,15300,15300,15302,0,2,5
4398,3,1,15303,15303,15304,0,1,1
4399,3,3,15306,15306,15309,0,3,2
4400,6,1,15312,15312,15313,0,1,3
4401,1,3,15313,15313,15316,0,3,0
4402,1,1,15314,15316,15317,2,3,0
4403,2,2,15316,15317,15319,1,3,0
4404,6,1,15322,15322,15323,0,1,3
4405,1,1,15323,15323,15324,0,1,0
4406,6,1,15329,15329,15330,0,1,5
4407,2,2,15331,15331,15333,0,2,1
4408,4,3,15335,15335,15338,0,3,2
4409,5,2,15340,15340,15342,0,2,2
4410,4,3,15344,15344,15347,0,3,2
4411,5,3,15349,15349,15352,0,3,2
4412,6,3,15355,15355,15358,0,3,3
4413,1,2,15356,15358,15360,2,4,0
4414,4,3,15360,15360,15363,0,3,0
4415,6,2,15366,15366,15368,0,2,3
4416,4,3,15370,15370,15373,0,3,2
4417,6,1,15376,15376,15377,0,1,3
4418,2,3,15378,15378,15381,0,3,1
4419,5,2,15383,15383,15385,0,2,2
4420,4,1,15387,15387,15388,0,1,2
4421,5,2,15392,15392,15394,0,2,4
4422,4,2,15396,15396,15398,0,2,2
4423,2,1,15398,15398,15399,0,1,0
4424,4,3,15402,15402,15405,0,3,3
4425,2,1,15404,15405,15406,1,2,0
4426,5,2,15409,15409,15411,0,2,3
4427,1,2,15410,15411,15413,1,3,0
4428,4,2,15414,15414,15416,0,2,1
4429,4,2,15418,15418,15420,0,2,2
4430,4,2,15422,15422,15424,0,2,2
4431,6,3,15428,15428,15431,0,3,4
4432,4,1,15432,15432,15433,0,1,1
4433,4,3,15436,15436,15439,0,3,3
4434,4,2,15440,15440,15442,0,2,1
4435,3,1,15443,15443,15444,0,1,1
4436,5,1,15448,15448,15449,0,1,4
4437,1,2,15449,15449,15451,0,2,0
4438,6,3,15455,15455,15458,0,3,4
4439,2,2,15457,15458,15460,1,3,0
4440,2,2,15459,15460,15462,1,3,0
4441,4,3,15463,15463,15466,0,3,1
4442,4,1,15467,15467,15468,0,1,1
4443,1,2,15468,15468,15470,0,2,0
4444,5,1,15473,15473,15474,0,1,3
4445,2,3,15475,15475,15478,0,3,1
4446,3,3,15478,15478,15481,0,3,0
4447,4,1,15482,15482,15483,0,1,1
4448,6,3,15488,15488,15491,0,3,5
4449,2,3,15490,15491,15494,1,4,0
4450,5,2,15495,15495,15497,0,2,1
4451,5,1,15500,15500,15501,0,1,3
4452,5,2,15505,15505,15507,0,2,4
4453,5,3,15510,15510,15513,0,3,3
4454,4,3,15514,15514,15517,0,3,1
4455,2,2,15516,15517,15519,1,3,0
4456,2,3,15518,15519,15522,1,4,0
4457,2,3,15520,15522,15525,2,5,0
4458,1,1,15521,15525,15526,4,5,0
4459,1,3,15522,15526,15529,4,7,0
4460,2,1,15524,15529,15530,5,6,0
4461,6,3,15530,15530,15533,0,3,0
4462,4,1,15534,15534,15535,0,1,1
4463,2,1,15536,15536,15537,0,1,1
4464,2,2,15538,15538,15540,0,2,1
4465,2,3,15540,15540,15543,0,3,0
4466,2,1,15542,15543,15544,1,2,0
4467,6,2,15548,15548,15550,0,2,4
4468,1,3,15549,15550,15553,1,4,0
4469,3,3,15552,15553,15556,1,4,0
4470,1,3,15553,15556,15559,3,6,0
4471,5,3,15558,15559,15562,1,4,0
4472,1,1,15559,15562,15563,3,4,0
4473,5,2,15564,15564,15566,0,2,1
4474,4,2,15568,15568,15570,0,2,2
4475,1,1,15569,15570,15571,1,2,0
4476,5,3,15574,15574,15577,0,3,3
4477,5,1,15579,15579,15580,0,1,2
4478,5,3,15584,15584,15587,0,3,4
4479,1,3,15585,15587,15590,2,5,0
4480,2,3,15587,15590,15593,3,6,0
4481,6,3,15593,15593,15596,0,3,0
4482,4,2,15597,15597,15599,0,2,1
4483,3,1,15600,15600,15601,0,1,1
4484,1,3,15601,15601,15604,0,3,0
4485,1,3,15602,15604,15607,2,5,0
4486,1,3,15603,15607,15610,4,7,0
4487,4,2,15607,15610,15612,3,5,0
4488,4,1,15611,15612,15613,1,2,0
4489,6,1,15617,15617,15618,0,1,4
4490,4,1,15621,15621,15622,0,1,3
4491,5,2,15626,15626,15628,0,2,4
4492,5,3,15631,15631,15634,0,3,3
4493,2,3,15633,15634,15637,1,4,0
4494,2,1,15635,15637,15638,2,3,0
4495,1,1,15636,15638,15639,2,3,0
4496,3,2,15639,15639,15641,0,2,0
4497,2,1,15641,15641,15642,0,1,0
4498,6,3,15647,15647,15650,0,3,5
4499,5,1,15652,15652,15653,0,1,2
4500,1,1,15653,15653,15654,0,1,0
4501,5,1,15658,15658,15659,0,1,4
4502,6,2,15664,15664,15666,0,2,5
4503,1,3,15665,15666,15669,1,4,0
4504,4,1,15669,15669,15670,0,1,0
4505,6,2,15675,15675,15677,0,2,5
4506,4,1,15679,15679,15680,0,1,2
4507,1,3,15680,15680,15683,0,3,0
4508,6,3,15686,15686,15689,0,3,3
4509,3,1,15689,15689,15690,0,1,0
4510,1,3,15690,15690,15693,0,3,0
4511,1,3,15691,15693,15696,2,5,0
4512,3,2,15694,15696,15698,2,4,0
4513,6,1,15700,15700,15701,0,1,2
4514,3,2,15703,15703,15705,0,2,2
4515,5,2,15708,15708,15710,0,2,3
4516,1,2,15709,15710,15712,1,3,0
4517,4,1,15713,15713,15714,0,1,1
4518,6,2,15719,15719,15721,0,2,5
4519,3,3,15722,15722,15725,0,3,1
4520,4,3,15726,15726,15729,0,3,1
4521,2,2,15728,15729,15731,1,3,0
4522,4,1,15732,15732,15733,0,1,1
4523,5,2,15737,15737,15739,0,2,4
4524,1,1,15738,15739,15740,1,2,0
4525,2,1,15740,15740,15741,0,1,0
4526,4,2,15744,15744,15746,0,2,3
4527,1,1,15745,15746,15747,1,2,0
4528,5,3,15750,15750,15753,0,3,3
4529,4,3,15754,15754,15757,0,3,1
4530,6,2,15760,15760,15762,0,2,3
4531,5,3,15765,15765,15768,0,3,3
4532,2,2,15767,15768,15770,1,3,0
4533,5,2,15772,15772,15774,0,2,2
4534,6,3,15778,15778,15781,0,3,4
4535,1,1,15779,15781,15782,2,3,0
4536,5,2,15784,15784,15786,0,2,2
4537,1,3,15785,15786,15789,1,4,0
4538,1,1,15786,15789,15790,3,4,0
4539,5,3,15791,15791,15794,0,3,1
4540,5,2,15796,15796,15798,0,2,2
4541,4,2,15800,15800,15802,0,2,2
4542,3,3,15803,15803,15806,0,3,1
4543,4,1,15807,15807,15808,0,1,1
4544,5,2,15812,15812,15814,0,2,4
4545,3,3,15815,15815,15818,0,3,1
4546,4,1,15819,15819,15820,0,1,1
4547,5,1,15824,15824,15825,0,1,4
4548,2,1,15826,15826,15827,0,1,1
4549,3,1,15829,15829,15830,0,1,2
4550,3,1,15832,15832,15833,0,1,2
4551,4,2,15836,15836,15838,0,2,3
4552,1,1,15837,15838,15839,1,2,0
4553,6,2,15843,15843,15845,0,2,4
4554,4,3,15847,15847,15850,0,3,2
4555,2,2,15849,15850,15852,1,3,0
4556,5,3,15854,15854,15857,0,3,2
4557,1,2,15855,15857,15859,2,4,0
4558,3,3,15858,15859,15862,1,4,0
4559,3,3,15861,15862,15865,1,4,0
4560,2,3,15863,15865,15868,2,5,0
4561,1,3,15864,15868,15871,4,7,0
4562,1,1,15865,15871,15872,6,7,0
4563,2,1,15867,15872,15873,5,6,0
4564,5,1,15872,15873,15874,1,2,0
4565,2,1,15874,15874,15875,0,1,0
4566,1,3,15875,15875,15878,0,3,0
4567,1,2,15876,15878,15880,2,4,0
4568,5,2,15881,15881,15883,0,2,1
4569,3,2,15884,15884,15886,0,2,1
4570,2,2,15886,15886,15888,0,2,0
4571,6,1,15892,15892,15893,0,1,4
4572,2,3,15894,15894,15897,0,3,1
4573,2,1,15896,15897,15898,1,2,0
4574,6,3,15902,15902,15905,0,3,4
4575,5,2,15907,15907,15909,0,2,2
4576,6,2,15913,15913,15915,0,2,4
4577,6,1,15919,15919,15920,0,1,4
4578,6,3,15925,15925,15928,0,3,5
4579,5,2,15930,15930,15932,0,2,2
4580,1,1,15931,15932,15933,1,2,0
4581,3,1,15934,15934,15935,0,1,1
4582,4,2,15938,15938,15940,0,2,3
4583,1,3,15939,15940,15943,1,4,0
4584,5,3,15944,15944,15947,0,3,1
4585,3,3,15947,15947,15950,0,3,0
4586,5,3,15952,15952,15955,0,3,2
4587,3,3,15955,15955,15958,0,3,0
4588,6,1,15961,15961,15962,0,1,3
4589,1,2,15962,15962,15964,0,2,0
4590,2,3,15964,15964,15967,0,3,0
4591,3,2,15967,15967,15969,0,2,0
4592,6,2,15973,15973,15975,0,2,4
4593,5,3,15978,15978,15981,0,3,3
4594,1,1,15979,15981,15982,2,3,0
4595,1,1,15980,15982,15983,2,3,0
4596,3,3,15983,15983,15986,0,3,0
4597,4,2,15987,15987,15989,0,2,1
4598,6,1,15993,15993,15994,0,1,4
4599,1,1,15994,15994,15995,0,1,0
4600,4,1,15998,15998,15999,0,1,3
4601,4,3,16002,16002,16005,0,3,3
4602,2,2,16004,16005,16007,1,3,0
4603,5,2,16009,16009,16011,0,2,2
4604,3,1,16012,16012,16013,0,1,1
4605,3,3,16015,16015,16018,0,3,2
4606,4,3,16019,16019,16022,0,3,1
4607,2,1,16021,16022,16023,1,2,0
4608,6,1,16027,16027,16028,0,1,4
4609,6,3,16033,16033,16036,0,3,5
4610,4,1,16037,16037,16038,0,1,1
4611,4,1,16041,16041,16042,0,1,3
4612,2,2,16043,16043,16045,0,2,1
4613,3,1,16046,16046,16047,0,1,1
4614,2,2,16048,16048,16050,0,2,1
4615,2,3,16050,16050,16053,0,3,0
4616,5,2,16055,16055,16057,0,2,2
4617,2,3,16057,16057,16060,0,3,0
4618,2,3,16059,16060,16063,1,4,0
4619,2,1,16061,16063,16064,2,3,0
4620,1,3,16062,16064,16067,2,5,0
4621,6,2,16068,16068,16070,0,2,1
4622,1,3,16069,16070,16073,1,4,0
4623,3,1,16072,16073,16074,1,2,0
4624,4,1,16076,16076,16077,0,1,2
4625,4,3,16080,16080,16083,0,3,3
4626,3,3,16083,16083,16086,0,3,0
4627,1,3,16084,16086,16089,2,5,0
4628,4,2,16088,16089,16091,1,3,0
4629,2,1,16090,16091,16092,1,2,0
4630,1,3,16091,16092,16095,1,4,0
4631,5,3,16096,16096,16099,0,3,1
4632,6,1,16102,16102,16103,0,1,3
4633,5,3,16107,16107,16110,0,3,4
4634,2,2,16109,16110,16112,1,3,0
4635,2,1,16111,16112,16113,1,2,0
4636,1,2,16112,16113,16115,1,3,0
4637,4,3,16116,16116,16119,0,3,1
4638,5,1,16121,16121,16122,0,1,2
4639,2,2,16123,16123,16125,0,2,1
4640,6,3,16129,16129,16132,0,3,4
4641,4,1,16133,16133,16134,0,1,1
4642,1,2,16134,16134,16136,0,2,0
4643,2,1,16136,16136,16137,0,1,0
4644,3,2,16139,16139,16141,0,2,2
4645,5,1,16144,16144,16145,0,1,3
4646,4,2,16148,16148,16150,0,2,3
4647,4,2,16152,16152,16154,0,2,2
4648,2,3,16154,16154,16157,0,3,0
4649,3,3,16157,16157,16160,0,3,0
4650,6,3,16163,16163,16166,0,3,3
4651,4,1,16167,16167,16168,0,1,1
4652,6,3,16173,16173,16176,0,3,5
4653,2,3,16175,16176,16179,1,4,0
4654,1,1,16176,16179,16180,3,4,0
4655,6,3,16182,16182,16185,0,3,2
4656,4,1,16186,16186,16187,0,1,1
4657,4,1,16190,16190,16191,0,1,3
4658,2,1,16192,16192,16193,0,1,1
4659,4,3,16196,16196,16199,0,3,3
4660,3,1,16199,16199,16200,0,1,0
4661,6,1,16205,16205,16206,0,1,5
4662,3,1,16208,16208,16209,0,1,2
4663,2,2,16210,16210,16212,0,2,1
4664,1,3,16211,16212,16215,1,4,0
4665,2,3,16213,16215,16218,2,5,0
4666,4,1,16217,16218,16219,1,2,0
4667,4,2,16221,16221,16223,0,2,2
4668,6,3,16227,16227,16230,0,3,4
4669,6,1,16233,16233,16234,0,1,3
4670,5,1,16238,16238,16239,0,1,4
4671,6,1,16244,16244,16245,0,1,5
4672,3,3,16247,16247,16250,0,3,2
4673,1,3,16248,16250,16253,2,5,0
4674,1,3,16249,16253,16256,4,7,0
4675,3,2,16252,16256,16258,4,6,0
4676,6,2,16258,16258,16260,0,2,0
4677,5,2,16263,16263,16265,0,2,3
4678,6,3,16269,16269,16272,0,3,4
4679,1,1,16270,16272,16273,2,3,0
4680,6,2,16276,16276,16278,0,2,3
4681,2,2,16278,16278,16280,0,2,0
4682,3,1,16281,16281,16282,0,1,1
4683,1,2,16282,16282,16284,0,2,0
4684,6,2,16288,16288,16290,0,2,4
4685,6,3,16294,16294,16297,0,3,4
4686,6,2,16300,16300,16302,0,2,3
4687,4,1,16304,16304,16305,0,1,2
4688,6,2,16310,16310,16312,0,2,5
4689,6,1,16316,16316,16317,0,1,4
4690,6,3,16322,16322,16325,0,3,5
4691,2,3,16324,16325,16328,1,4,0
4692,2,3,16326,16328,16331,2,5,0
4693,1,2,16327,16331,16333,4,6,0
4694,6,2,16333,16333,16335,0,2,0
4695,6,1,16339,16339,16340,0,1,4
4696,6,1,16345,16345,16346,0,1,5
4697,4,2,16349,16349,16351,0,2,3
4698,6,2,16355,16355,16357,0,2,4
4699,4,2,16359,16359,16361,0,2,2
4700,5,1,16364,16364,16365,0,1,3
4701,1,2,16365,16365,16367,0,2,0
4702,3,3,16368,16368,16371,0,3,1
4703,3,2,16371,16371,16373,0,2,0
4704,1,3,16372,16373,16376,1,4,0
4705,5,1,16377,16377,16378,0,1,1
4706,5,2,16382,16382,16384,0,2,4
4707,5,1,16387,16387,16388,0,1,3
4708,3,1,16390,16390,16391,0,1,2
4709,3,3,16393,16393,16396,0,3,2
4710,5,3,16398,16398,16401,0,3,2
4711,2,3,16400,16401,16404,1,4,0
4712,4,3,16404,16404,16407,0,3,0
4713,4,1,16408,16408,16409,0,1,1
4714,4,1,16412,16412,16413,0,1,3
4715,3,3,16415,16415,16418,0,3,2
4716,6,1,16421,16421,16422,0,1,3
4717,1,2,16422,16422,16424,0,2,0
4718,5,2,16427,16427,16429,0,2,3
4719,5,1,16432,16432,16433,0,1,3
4720,3,2,16435,16435,16437,0,2,2
4721,3,2,16438,16438,16440,0,2,1
4722,2,3,16440,16440,16443,0,3,0
4723,4,3,16444,16444,16447,0,3,1
4724,2,2,16446,16447,16449,1,3,0
4725,4,1,16450,16450,16451,0,1,1
4726,6,3,16456,16456,16459,0,3,5
4727,5,1,16461,16461,16462,0,1,2
4728,1,2,16462,16462,16464,0,2,0
4729,1,2,16463,16464,16466,1,3,0
4730,2,1,16465,16466,16467,1,2,0
4731,4,1,16469,16469,16470,0,1,2
4732,3,2,16472,16472,16474,0,2,2
4733,6,1,16478,16478,16479,0,1,4
4734,4,1,16482,16482,16483,0,1,3
4735,2,1,16484,16484,16485,0,1,1
4736,5,3,16489,16489,16492,0,3,4
4737,6,3,16495,16495,16498,0,3,3
4738,6,2,16501,16501,16503,0,2,3
4739,2,2,16503,16503,16505,0,2,0
4740,4,1,16507,16507,16508,0,1,2
4741,2,3,16509,16509,16512,0,3,1
4742,3,2,16512,16512,16514,0,2,0
4743,1,2,16513,16514,16516,1,3,0
4744,4,2,16517,16517,16519,0,2,1
4745,6,2,16523,16523,16525,0,2,4
4746,1,2,16524,16525,16527,1,3,0
4747,3,1,16527,16527,16528,0,1,0
4748,4,2,16531,16531,16533,0,2,3
4749,1,3,16532,16533,16536,1,4,0
4750,3,1,16535,16536,16537,1,2,0
4751,1,1,16536,16537,16538,1,2,0
4752,3,2,16539,16539,16541,0,2,1
4753,6,2,16545,16545,16547,0,2,4
4754,6,3,16551,16551,16554,0,3,4
4755,3,3,16554,16554,16557,0,3,0
4756,6,1,16560,16560,16561,0,1,3
4757,2,2,16562,16562,16564,0,2,1
4758,2,2,16564,16564,16566,0,2,0
4759,2,2,16566,16566,16568,0,2,0
4760,4,1,16570,16570,16571,0,1,2
4761,3,1,16573,16573,16574,0,1,2
4762,6,3,16579,16579,16582,0,3,5
4763,6,2,16585,16585,16587,0,2,3
4764,4,2,16589,16589,16591,0,2,2
4765,2,1,16591,16591,16592,0,1,0
4766,3,3,16594,16594,16597,0,3,2
4767,4,3,16598,16598,16601,0,3,1
4768,4,1,16602,16602,16603,0,1,1
4769,4,3,16606,16606,16609,0,3,3
4770,6,2,16612,16612,16614,0,2,3
4771,6,2,16618,16618,16620,0,2,4
4772,3,2,16621,16621,16623,0,2,1
4773,3,3,16624,16624,16627,0,3,1
4774,3,2,16627,16627,16629,0,2,0
4775,1,3,16628,16629,16632,1,4,0
4776,3,3,16631,16632,16635,1,4,0
4777,2,1,16633,16635,16636,2,3,0
4778,1,3,16634,16636,16639,2,5,0
4779,3,1,16637,16639,16640,2,3,0
4780,5,2,16642,16642,16644,0,2,2
4781,6,1,16648,16648,16649,0,1,4
4782,1,3,16649,16649,16652,0,3,0
4783,5,3,16654,16654,16657,0,3,2
4784,3,1,16657,16657,16658,0,1,0
4785,6,1,16663,16663,16664,0,1,5
4786,5,1,16668,16668,16669,0,1,4
4787,1,1,16669,16669,16670,0,1,0
4788,4,2,16673,16673,16675,0,2,3
4789,3,2,16676,16676,16678,0,2,1
4790,1,2,16677,16678,16680,1,3,0
4791,2,1,16679,16680,16681,1,2,0
4792,1,2,16680,16681,16683,1,3,0
4793,2,1,16682,16683,16684,1,2,0
4794,1,1,16683,16684,16685,1,2,0
4795,6,3,16689,16689,16692,0,3,4
4796,1,2,16690,16692,16694,2,4,0
4797,3,3,16693,16694,16697,1,4,0
4798,6,2,16699,16699,16701,0,2,2
4799,5,2,16704,16704,16706,0,2,3
4800,1,3,16705,16706,16709,1,4,0
4801,2,3,16707,16709,16712,2,5,0
4802,6,1,16713,16713,16714,0,1,1
4803,5,2,16718,16718,16720,0,2,4
4804,1,2,16719,16720,16722,1,3,0
4805,5,1,16724,16724,16725,0,1,2
4806,5,2,16729,16729,16731,0,2,4
4807,4,3,16733,16733,16736,0,3,2
4808,2,2,16735,16736,16738,1,3,0
4809,5,2,16740,16740,16742,0,2,2
4810,6,2,16746,16746,16748,0,2,4
4811,5,1,16751,16751,16752,0,1,3
4812,3,3,16754,16754,16757,0,3,2
4813,2,3,16756,16757,16760,1,4,0
4814,5,1,16761,16761,16762,0,1,1
4815,4,3,16765,16765,16768,0,3,3
4816,3,1,16768,16768,16769,0,1,0
4817,1,1,16769,16769,16770,0,1,0
4818,4,3,16773,16773,16776,0,3,3
4819,5,2,16778,16778,16780,0,2,2
4820,6,2,16784,16784,16786,0,2,4
4821,5,1,16789,16789,16790,0,1,3
4822,1,2,16790,16790,16792,0,2,0
4823,1,2,16791,16792,16794,1,3,0
4824,5,2,16796,16796,16798,0,2,2
4825,1,2,16797,16798,16800,1,3,0
4826,4,2,16801,16801,16803,0,2,1
4827,3,2,16804,16804,16806,0,2,1
4828,5,3,16809,16809,16812,0,3,3
4829,5,1,16814,16814,16815,0,1,2
4830,4,2,16818,16818,16820,0,2,3
4831,5,3,16823,16823,16826,0,3,3
4832,4,2,16827,16827,16829,0,2,1
4833,5,3,16832,16832,16835,0,3,3
4834,4,1,16836,16836,16837,0,1,1
4835,5,2,16841,16841,16843,0,2,4
4836,5,2,16846,16846,16848,0,2,3
4837,1,2,16847,16848,16850,1,3,0
4838,2,3,16849,16850,16853,1,4,0
4839,5,2,16854,16854,16856,0,2,1
4840,1,3,16855,16856,16859,1,4,0
4841,1,3,16856,16859,16862,3,6,0
4842,5,1,16861,16862,16863,1,2,0
4843,3,1,16864,16864,16865,0,1,1
4844,2,2,16866,16866,16868,0,2,1
4845,3,2,16869,16869,16871,0,2,1
4846,1,2,16870,16871,16873,1,3,0
4847,3,1,16873,16873,16874,0,1,0
4848,2,3,16875,16875,16878,0,3,1
4849,6,1,16881,16881,16882,0,1,3
4850,1,2,16882,16882,16884,0,2,0
4851,2,3,16884,16884,16887,0,3,0
4852,1,1,16885,16887,16888,2,3,0
4853,5,1,16890,16890,16891,0,1,2
4854,1,2,16891,16891,16893,0,2,0
4855,5,2,16896,16896,16898,0,2,3
4856,1,1,16897,16898,16899,1,2,0
4857,1,3,16898,16899,16902,1,4,0
4858,2,1,16900,16902,16903,2,3,0
4859,1,3,16901,16903,16906,2,5,0
4860,2,3,16903,16906,16909,3,6,0
4861,1,2,16904,16909,16911,5,7,0
4862,3,2,16907,16911,16913,4,6,0
4863,5,3,16912,16913,16916,1,4,0
4864,2,1,16914,16916,16917,2,3,0
4865,3,3,16917,16917,16920,0,3,0
4866,5,1,16922,16922,16923,0,1,2
4867,6,1,16928,16928,16929,0,1,5
4868,5,1,16933,16933,16934,0,1,4
4869,1,3,16934,16934,16937,0,3,0
4870,1,3,16935,16937,16940,2,5,0
4871,2,2,16937,16940,16942,3,5,0
4872,2,3,16939,16942,16945,3,6,0
4873,2,1,16941,16945,16946,4,5,0
4874,5,1,16946,16946,16947,0,1,0
4875,6,3,16952,16952,16955,0,3,5
4876,5,1,16957,16957,16958,0,1,2
4877,4,3,16961,16961,16964,0,3,3
4878,3,3,16964,16964,16967,0,3,0
4879,2,2,16966,16967,16969,1,3,0
4880,6,1,16972,16972,16973,0,1,3
4881,5,3,16977,16977,16980,0,3,4
4882,2,1,16979,16980,16981,1,2,0
4883,1,3,16980,16981,16984,1,4,0
4884,1,3,16981,16984,16987,3,6,0
4885,4,1,16985,16987,16988,2,3,0
4886,5,2,16990,16990,16992,0,2,2
4887,4,1,16994,16994,16995,0,1,2
4888,6,2,17000,17000,17002,0,2,5
4889,5,1,17005,17005,17006,0,1,3
4890,1,3,17006,17006,17009,0,3,0
4891,4,1,17010,17010,17011,0,1,1
4892,2,3,17012,17012,17015,0,3,1
4893,2,3,17014,17015,17018,1,4,0
4894,3,2,17017,17018,17020,1,3,0
4895,3,2,17020,17020,17022,0,2,0
4896,1,1,17021,17022,17023,1,2,0
4897,3,1,17024,17024,17025,0,1,1
4898,5,2,17029,17029,17031,0,2,4
4899,5,3,17034,17034,17037,0,3,3
4900,3,3,17037,17037,17040,0,3,0
4901,4,3,17041,17041,17044,0,3,1
4902,5,1,17046,17046,17047,0,1,2
4903,3,3,17049,17049,17052,0,3,2
4904,1,1,17050,17052,17053,2,3,0
4905,1,3,17051,17053,17056,2,5,0
4906,2,2,17053,17056,17058,3,5,0
4907,3,3,17056,17058,17061,2,5,0
4908,2,3,17058,17061,17064,3,6,0
4909,3,2,17061,17064,17066,3,5,0
4910,5,1,17066,17066,17067,0,1,0
4911,3,3,17069,17069,17072,0,3,2
4912,5,1,17074,17074,17075,0,1,2
4913,6,2,17080,17080,17082,0,2,5
4914,5,2,17085,17085,17087,0,2,3
4915,3,2,17088,17088,17090,0,2,1
4916,4,3,17092,17092,17095,0,3,2
4917,2,2,17094,17095,17097,1,3,0
4918,4,1,17098,17098,17099,0,1,1
4919,3,2,17101,17101,17103,0,2,2
4920,2,2,17103,17103,17105,0,2,0
4921,2,2,17105,17105,17107,0,2,0
4922,1,2,17106,17107,17109,1,3,0
4923,3,3,17109,17109,17112,0,3,0
4924,4,3,17113,17113,17116,0,3,1
4925,2,2,17115,17116,17118,1,3,0
4926,6,1,17121,17121,17122,0,1,3
4927,5,2,17126,17126,17128,0,2,4
4928,6,2,17132,17132,17134,0,2,4
4929,3,3,17135,17135,17138,0,3,1
4930,5,1,17140,17140,17141,0,1,2
4931,1,1,17141,17141,17142,0,1,0
4932,1,2,17142,17142,17144,0,2,0
4933,2,2,17144,17144,17146,0,2,0
4934,2,3,17146,17146,17149,0,3,0
4935,6,1,17152,17152,17153,0,1,3
4936,3,2,17155,17155,17157,0,2,2
4937,3,2,17158,17158,17160,0,2,1
4938,3,1,17161,17161,17162,0,1,1
4939,3,1,17164,17164,17165,0,1,2
4940,3,2,17167,17167,17169,0,2,2
4941,5,1,17172,17172,17173,0,1,3
4942,1,3,17173,17173,17176,0,3,0
4943,3,3,17176,17176,17179,0,3,0
4944,3,3,17179,17179,17182,0,3,0
4945,4,1,17183,17183,17184,0,1,1
4946,5,1,17188,17188,17189,0,1,4
4947,5,3,17193,17193,17196,0,3,4
4948,6,3,17199,17199,17202,0,3,3
4949,1,3,17200,17202,17205,2,5,0
4950,5,3,17205,17205,17208,0,3,0
4951,6,3,17211,17211,17214,0,3,3
4952,3,1,17214,17214,17215,0,1,0
4953,4,1,17218,17218,17219,0,1,3
4954,4,1,17222,17222,17223,0,1,3
4955,4,2,17226,17226,17228,0,2,3
4956,6,3,17232,17232,17235,0,3,4
4957,6,2,17238,17238,17240,0,2,3
4958,4,1,17242,17242,17243,0,1,2
4959,4,3,17246,17246,17249,0,3,3
4960,4,1,17250,17250,17251,0,1,1
4961,2,2,17252,17252,17254,0,2,1
4962,1,2,17253,17254,17256,1,3,0
4963,2,3,17255,17256,17259,1,4,0
4964,5,1,17260,17260,17261,0,1,1
4965,6,2,17266,17266,17268,0,2,5
4966,4,2,17270,17270,17272,0,2,2
4967,1,3,17271,17272,17275,1,4,0
4968,4,1,17275,17275,17276,0,1,0
4969,1,1,17276,17276,17277,0,1,0
4970,4,1,17280,17280,17281,0,1,3
4971,4,2,17284,17284,17286,0,2,3
4972,3,2,17287,17287,17289,0,2,1
4973,3,3,17290,17290,17293,0,3,1
4974,6,3,17296,17296,17299,0,3,3
4975,1,1,17297,17299,17300,2,3,0
4976,2,3,17299,17300,17303,1,4,0
4977,6,1,17305,17305,17306,0,1,2
4978,4,1,17309,17309,17310,0,1,3
4979,4,1,17313,17313,17314,0,1,3
4980,4,2,17317,17317,17319,0,2,3
4981,1,3,17318,17319,17322,1,4,0
4982,4,1,17322,17322,17323,0,1,0
4983,3,1,17325,17325,17326,0,1,2
4984,1,2,17326,17326,17328,0,2,0
4985,3,1,17329,17329,17330,0,1,1
4986,4,3,17333,17333,17336,0,3,3
4987,4,2,17337,17337,17339,0,2,1
4988,1,3,17338,17339,17342,1,4,0
4989,1,3,17339,17342,17345,3,6,0
4990,3,1,17342,17345,17346,3,4,0
4991,5,3,17347,17347,17350,0,3,1
4992,1,2,17348,17350,17352,2,4,0
4993,4,1,17352,17352,17353,0,1,0
4994,3,3,17355,17355,17358,0,3,2
4995,5,1,17360,17360,17361,0,1,2
4996,6,2,17366,17366,17368,0,2,5
4997,5,1,17371,17371,17372,0,1,3
4998,3,2,17374,17374,17376,0,2,2
4999,6,3,17380,17380,17383,0,3,4
5000,5,1,17385,17385,17386,0,1,2
5001,4,2,17389,17389,17391,0,2,3
5002,1,3,17390,17391,17394,1,4,0
5003,6,3,17396,17396,17399,0,3,2
5004,4,2,17400,17400,17402,0,2,1
5005,1,1,17401,17402,17403,1,2,0
5006,1,1,17402,17403,17404,1,2,0
5007,5,2,17407,17407,17409,0,2,3
5008,2,1,17409,17409,17410,0,1,0
5009,3,1,17412,17412,17413,0,1,2
5010,1,2,17413,17413,17415,0,2,0
5011,5,3,17418,17418,17421,0,3,3
5012,3,2,17421,17421,17423,0,2,0
5013,3,1,17424,17424,17425,0,1,1
5014,2,1,17426,17426,17427,0,1,1
5015,1,1,17427,17427,17428,0,1,0
5016,2,2,17429,17429,17431,0,2,1
5017,5,1,17434,17434,17435,0,1,3
5018,2,1,17436,17436,17437,0,1,1
5019,5,1,17441,17441,17442,0,1,4
5020,1,2,17442,17442,17444,0,2,0
5021,6,2,17448,17448,17450,0,2,4
5022,3,2,17451,17451,17453,0,2,1
5023,2,1,17453,17453,17454,0,1,0
5024,5,1,17458,17458,17459,0,1,4
5025,1,1,17459,17459,17460,0,1,0
5026,4,3,17463,17463,17466,0,3,3
5027,4,1,17467,17467,17468,0,1,1
5028,4,3,17471,17471,17474,0,3,3
5029,1,3,17472,17474,17477,2,5,0
5030,2,1,17474,17477,17478,3,4,0
5031,2,1,17476,17478,17479,2,3,0
5032,2,3,17478,17479,17482,1,4,0
5033,3,1,17481,17482,17483,1,2,0
5034,4,2,17485,17485,17487,0,2,2
5035,1,2,17486,17487,17489,1,3,0
5036,5,3,17491,17491,17494,0,3,2
5037,3,2,17494,17494,17496,0,2,0
5038,2,3,17496,17496,17499,0,3,0
5039,2,2,17498,17499,17501,1,3,0
5040,5,3,17503,17503,17506,0,3,2
5041,1,2,17504,17506,17508,2,4,0
5042,6,1,17510,17510,17511,0,1,2
5043,1,3,17511,17511,17514,0,3,0
5044,2,1,17513,17514,17515,1,2,0
5045,3,1,17516,17516,17517,0,1,1
5046,5,3,17521,17521,17524,0,3,4
5047,4,1,17525,17525,17526,0,1,1
5048,1,2,17526,17526,17528,0,2,0
5049,3,2,17529,17529,17531,0,2,1
5050,4,3,17533,17533,17536,0,3,2
5051,2,3,17535,17536,17539,1,4,0
5052,2,3,17537,17539,17542,2,5,0
5053,4,2,17541,17542,17544,1,3,0
5054,6,2,17547,17547,17549,0,2,3
5055,3,3,17550,17550,17553,0,3,1
5056,2,2,17552,17553,17555,1,3,0
5057,4,3,17556,17556,17559,0,3,1
5058,5,2,17561,17561,17563,0,2,2
5059,5,3,17566,17566,17569,0,3,3
5060,3,3,17569,17569,17572,0,3,0
5061,5,2,17574,17574,17576,0,2,2
5062,1,2,17575,17576,17578,1,3,0
5063,2,1,17577,17578,17579,1,2,0
5064,4,1,17581,17581,17582,0,1,2
5065,6,3,17587,17587,17590,0,3,5
5066,4,1,17591,17591,17592,0,1,1
5067,1,3,17592,17592,17595,0,3,0
5068,5,3,17597,17597,17600,0,3,2
5069,5,1,17602,17602,17603,0,1,2
5070,6,2,17608,17608,17610,0,2,5
5071,3,1,17611,17611,17612,0,1,1
5072,5,3,17616,17616,17619,0,3,4
5073,4,3,17620,17620,17623,0,3,1
5074,6,2,17626,17626,17628,0,2,3
5075,6,3,17632,17632,17635,0,3,4
5076,4,3,17636,17636,17639,0,3,1
5077,3,3,17639,17639,17642,0,3,0
5078,2,2,17641,17642,17644,1,3,0
5079,4,1,17645,17645,17646,0,1,1
5080,4,2,17649,17649,17651,0,2,3
5081,1,3,17650,17651,17654,1,4,0
5082,3,1,17653,17654,17655,1,2,0
5083,5,3,17658,17658,17661,0,3,3
5084,4,2,17662,17662,17664,0,2,1
5085,2,3,17664,17664,17667,0,3,0
5086,5,2,17669,17669,17671,0,2,2
5087,5,1,17674,17674,17675,0,1,3
5088,3,3,17677,17677,17680,0,3,2
5089,2,1,17679,17680,17681,1,2,0
5090,5,2,17684,17684,17686,0,2,3
5091,1,2,17685,17686,17688,1,3,0
5092,4,3,17689,17689,17692,0,3,1
5093,2,2,17691,17692,17694,1,3,0
5094,6,2,17697,17697,17699,0,2,3
5095,1,3,17698,17699,17702,1,4,0
5096,4,1,17702,17702,17703,0,1,0
5097,3,3,17705,17705,17708,0,3,2
5098,1,2,17706,17708,17710,2,4,0
5099,6,2,17712,17712,17714,0,2,2
5100,2,1,17714,17714,17715,0,1,0
5101,4,2,17718,17718,17720,0,2,3
5102,2,3,17720,17720,17723,0,3,0
5103,2,2,17722,17723,17725,1,3,0
5104,6,1,17728,17728,17729,0,1,3
5105,2,1,17730,17730,17731,0,1,1
5106,4,2,17734,17734,17736,0,2,3
5107,4,3,17738,17738,17741,0,3,2
5108,6,2,17744,17744,17746,0,2,3
5109,1,3,17745,17746,17749,1,4,0
5110,4,3,17749,17749,17752,0,3,0
5111,5,2,17754,17754,17756,0,2,2
5112,3,3,17757,17757,17760,0,3,1
5113,1,1,17758,17760,17761,2,3,0
5114,3,1,17761,17761,17762,0,1,0
5115,5,3,17766,17766,17769,0,3,4
5116,6,3,17772,17772,17775,0,3,3
5117,1,1,17773,17775,17776,2,3,0
5118,1,3,17774,17776,17779,2,5,0
5119,3,1,17777,17779,17780,2,3,0
5120,6,2,17783,17783,17785,0,2,3
5121,5,1,17788,17788,17789,0,1,3
5122,3,2,17791,17791,17793,0,2,2
5123,2,1,17793,17793,17794,0,1,0
5124,6,1,17799,17799,17800,0,1,5
5125,4,2,17803,17803,17805,0,2,3
5126,4,3,17807,17807,17810,0,3,2
5127,4,1,17811,17811,17812,0,1,1
5128,5,2,17816,17816,17818,0,2,4
5129,6,3,17822,17822,17825,0,3,4
5130,4,1,17826,17826,17827,0,1,1
5131,4,3,17830,17830,17833,0,3,3
5132,3,2,17833,17833,17835,0,2,0
5133,1,3,17834,17835,17838,1,4,0
5134,4,1,17838,17838,17839,0,1,0
5135,3,1,17841,17841,17842,0,1,2
5136,4,2,17845,17845,17847,0,2,3
5137,4,3,17849,17849,17852,0,3,2
5138,6,3,17855,17855,17858,0,3,3
5139,2,1,17857,17858,17859,1,2,0
5140,5,3,17862,17862,17865,0,3,3
5141,2,1,17864,17865,17866,1,2,0
5142,5,3,17869,17869,17872,0,3,3
5143,6,2,17875,17875,17877,0,2,3
5144,3,2,17878,17878,17880,0,2,1
5145,3,2,17881,17881,17883,0,2,1
5146,6,1,17887,17887,17888,0,1,4
5147,1,3,17888,17888,17891,0,3,0
5148,4,1,17892,17892,17893,0,1,1
5149,5,2,17897,17897,17899,0,2,4
5150,5,2,17902,17902,17904,0,2,3
5151,6,3,17908,17908,17911,0,3,4
5152,1,1,17909,17911,17912,2,3,0
5153,5,1,17914,17914,17915,0,1,2
5154,3,1,17917,17917,17918,0,1,2
5155,1,1,17918,17918,17919,0,1,0
5156,2,1,17920,17920,17921,0,1,1
5157,4,2,17924,17924,17926,0,2,3
5158,5,1,17929,17929,17930,0,1,3
5159,1,2,17930,17930,17932,0,2,0
5160,5,1,17935,17935,17936,0,1,3
5161,3,2,17938,17938,17940,0,2,2
5162,2,1,17940,17940,17941,0,1,0
5163,2,2,17942,17942,17944,0,2,1
5164,2,2,17944,17944,17946,0,2,0
5165,4,2,17948,17948,17950,0,2,2
5166,6,3,17954,17954,17957,0,3,4
5167,4,3,17958,17958,17961,0,3,1
5168,1,3,17959,17961,17964,2,5,0
5169,4,3,17963,17964,17967,1,4,0
5170,1,1,17964,17967,17968,3,4,0
5171,1,1,17965,17968,17969,3,4,0
5172,3,1,17968,17969,17970,1,2,0
5173,5,3,17973,17973,17976,0,3,3
5174,3,2,17976,17976,17978,0,2,0
5175,1,1,17977,17978,17979,1,2,0
5176,4,3,17981,17981,17984,0,3,2
5177,4,3,17985,17985,17988,0,3,1
5178,6,3,17991,17991,17994,0,3,3
5179,1,3,17992,17994,17997,2,5,0
5180,3,1,17995,17997,17998,2,3,0
5181,3,1,17998,17998,17999,0,1,0
5182,3,2,18001,18001,18003,0,2,2
5183,1,1,18002,18003,18004,1,2,0
5184,5,3,18007,18007,18010,0,3,3
5185,3,1,18010,18010,18011,0,1,0
5186,3,2,18013,18013,18015,0,2,2
5187,6,2,18019,18019,18021,0,2,4
5188,6,2,18025,18025,18027,0,2,4
5189,1,3,18026,18027,18030,1,4,0
5190,1,3,18027,18030,18033,3,6,0
5191,2,1,18029,18033,18034,4,5,0
5192,6,1,18035,18035,18036,0,1,1
5193,5,1,18040,18040,18041,0,1,4
5194,4,1,18044,18044,18045,0,1,3
5195,4,3,18048,18048,18051,0,3,3
5196,5,2,18053,18053,18055,0,2,2
5197,1,2,18054,18055,18057,1,3,0
5198,5,2,18059,18059,18061,0,2,2
5199,6,2,18065,18065,18067,0,2,4
5200,2,3,18067,18067,18070,0,3,0
5201,3,1,18070,18070,18071,0,1,0
5202,2,1,18072,18072,18073,0,1,1
5203,1,1,18073,18073,18074,0,1,0
5204,5,3,18078,18078,18081,0,3,4
5205,4,3,18082,18082,18085,0,3,1
5206,2,1,18084,18085,18086,1,2,0
5207,3,2,18087,18087,18089,0,2,1
5208,5,2,18092,18092,18094,0,2,3
5209,4,2,18096,18096,18098,0,2,2
5210,6,3,18102,18102,18105,0,3,4
5211,3,1,18105,18105,18106,0,1,0
5212,6,1,18111,18111,18112,0,1,5
5213,4,1,18115,18115,18116,0,1,3
5214,1,2,18116,18116,18118,0,2,0
5215,2,1,18118,18118,18119,0,1,0
5216,6,2,18124,18124,18126,0,2,5
5217,2,2,18126,18126,18128,0,2,0
5218,4,2,18130,18130,18132,0,2,2
5219,3,2,18133,18133,18135,0,2,1
5220,5,3,18138,18138,18141,0,3,3
5221,2,1,18140,18141,18142,1,2,0
5222,6,1,18146,18146,18147,0,1,4
5223,1,2,18147,18147,18149,0,2,0
5224,6,2,18153,18153,18155,0,2,4
5225,1,3,18154,18155,18158,1,4,0
5226,5,2,18159,18159,18161,0,2,1
5227,5,3,18164,18164,18167,0,3,3
5228,3,1,18167,18167,18168,0,1,0
5229,6,3,18173,18173,18176,0,3,5
5230,2,1,18175,18176,18177,1,2,0
5231,6,3,18181,18181,18184,0,3,4
5232,6,1,18187,18187,18188,0,1,3
5233,6,1,18193,18193,18194,0,1,5
5234,4,2,18197,18197,18199,0,2,3
5235,3,1,18200,18200,18201,0,1,1
5236,1,1,18201,18201,18202,0,1,0
5237,5,1,18206,18206,18207,0,1,4
5238,3,2,18209,18209,18211,0,2,2
5239,4,3,18213,18213,18216,0,3,2
5240,6,2,18219,18219,18221,0,2,3
5241,6,3,18225,18225,18228,0,3,4
5242,6,3,18231,18231,18234,0,3,3
5243,2,1,18233,18234,18235,1,2,0
5244,4,1,18237,18237,18238,0,1,2
5245,6,2,18243,18243,18245,0,2,5
5246,1,3,18244,18245,18248,1,4,0
5247,2,1,18246,18248,18249,2,3,0
5248,3,3,18249,18249,18252,0,3,0
5249,3,1,18252,18252,18253,0,1,0
5250,1,3,18253,18253,18256,0,3,0
5251,1,2,18254,18256,18258,2,4,0
5252,6,1,18260,18260,18261,0,1,2
5253,1,1,18261,18261,18262,0,1,0
5254,5,2,18266,18266,18268,0,2,4
5255,4,2,18270,18270,18272,0,2,2
5256,4,2,18274,18274,18276,0,2,2
5257,3,1,18277,18277,18278,0,1,1
5258,5,1,18282,18282,18283,0,1,4
5259,5,2,18287,18287,18289,0,2,4
5260,5,3,18292,18292,18295,0,3,3
5261,2,2,18294,18295,18297,1,3,0
5262,3,1,18297,18297,18298,0,1,0
5263,2,3,18299,18299,18302,0,3,1
5264,1,3,18300,18302,18305,2,5,0
5265,3,2,18303,18305,18307,2,4,0
5266,5,1,18308,18308,18309,0,1,1
5267,4,3,18312,18312,18315,0,3,3
5268,2,1,18314,18315,18316,1,2,0
5269,3,2,18317,18317,18319,0,2,1
5270,5,1,18322,18322,18323,0,1,3
5271,5,2,18327,18327,18329,0,2,4
5272,6,2,18333,18333,18335,0,2,4
5273,5,3,18338,18338,18341,0,3,3
5274,1,2,18339,18341,18343,2,4,0
5275,3,2,18342,18343,18345,1,3,0
5276,5,1,18347,18347,18348,0,1,2
5277,4,3,18351,18351,18354,0,3,3
5278,3,2,18354,18354,18356,0,2,0
5279,3,3,18357,18357,18360,0,3,1
5280,5,3,18362,18362,18365,0,3,2
5281,2,3,18364,18365,18368,1,4,0
5282,2,1,18366,18368,18369,2,3,0
5283,2,2,18368,18369,18371,1,3,0
5284,2,1,18370,18371,18372,1,2,0
5285,6,2,18376,18376,18378,0,2,4
5286,3,3,18379,18379,18382,0,3,1
5287,6,3,18385,18385,18388,0,3,3
5288,4,3,18389,18389,18392,0,3,1
5289,3,2,18392,18392,18394,0,2,0
5290,3,2,18395,18395,18397,0,2,1
5291,1,1,18396,18397,18398,1,2,0
5292,5,2,18401,18401,18403,0,2,3
5293,6,3,18407,18407,18410,0,3,4
5294,4,2,18411,18411,18413,0,2,1
5295,2,3,18413,18413,18416,0,3,0
5296,6,3,18419,18419,18422,0,3,3
5297,3,2,18422,18422,18424,0,2,0
5298,6,1,18428,18428,18429,0,1,4
5299,1,2,18429,18429,18431,0,2,0
5300,5,2,18434,18434,18436,0,2,3
5301,1,1,18435,18436,18437,1,2,0
5302,3,3,18438,18438,18441,0,3,1
5303,5,3,18443,18443,18446,0,3,2
5304,4,2,18447,18447,18449,0,2,1
5305,5,1,18452,18452,18453,0,1,3
5306,2,1,18454,18454,18455,0,1,1
5307,3,2,18457,18457,18459,0,2,2
5308,1,2,18458,18459,18461,1,3,0
5309,4,1,18462,18462,18463,0,1,1
5310,6,2,18468,18468,18470,0,2,5
5311,2,2,18470,18470,18472,0,2,0
5312,5,2,18475,18475,18477,0,2,3
5313,4,3,18479,18479,18482,0,3,2
5314,5,1,18484,18484,18485,0,1,2
5315,6,2,18490,18490,18492,0,2,5
5316,4,1,18494,18494,18495,0,1,2
5317,2,1,18496,18496,18497,0,1,1
5318,2,1,18498,18498,18499,0,1,1
5319,4,3,18502,18502,18505,0,3,3
5320,4,1,18506,18506,18507,0,1,1
5321,2,1,18508,18508,18509,0,1,1
5322,2,3,18510,18510,18513,0,3,1
5323,4,3,18514,18514,18517,0,3,1
5324,3,3,18517,18517,18520,0,3,0
5325,6,3,18523,18523,18526,0,3,3
5326,4,1,18527,18527,18528,0,1,1
5327,4,1,18531,18531,18532,0,1,3
5328,2,3,18533,18533,18536,0,3,1
5329,1,1,18534,18536,18537,2,3,0
5330,5,1,18539,18539,18540,0,1,2
5331,4,1,18543,18543,18544,0,1,3
5332,5,2,18548,18548,18550,0,2,4
5333,6,3,18554,18554,18557,0,3,4
5334,5,3,18559,18559,18562,0,3,2
5335,4,1,18563,18563,18564,0,1,1
5336,1,2,18564,18564,18566,0,2,0
5337,6,1,18570,18570,18571,0,1,4
5338,6,1,18576,18576,18577,0,1,5
5339,5,3,18581,18581,18584,0,3,4
5340,2,2,18583,18584,18586,1,3,0
5341,1,2,18584,18586,18588,2,4,0
5342,1,1,18585,18588,18589,3,4,0
5343,2,3,18587,18589,18592,2,5,0
5344,3,3,18590,18592,18595,2,5,0
5345,4,1,18594,18595,18596,1,2,0
5346,6,1,18600,18600,18601,0,1,4
5347,2,1,18602,18602,18603,0,1,1
5348,2,3,18604,18604,18607,0,3,1
5349,2,1,18606,18607,18608,1,2,0
5350,2,2,18608,18608,18610,0,2,0
5351,4,1,18612,18612,18613,0,1,2
5352,6,2,18618,18618,18620,0,2,5
5353,2,3,18620,18620,18623,0,3,0
5354,3,2,18623,18623,18625,0,2,0
5355,1,3,18624,18625,18628,1,4,0
5356,2,1,18626,18628,18629,2,3,0
5357,6,2,18632,18632,18634,0,2,3
5358,6,2,18638,18638,18640,0,2,4
5359,6,2,18644,18644,18646,0,2,4
5360,3,1,18647,18647,18648,0,1,1
5361,6,2,18653,18653,18655,0,2,5
5362,6,2,18659,18659,18661,0,2,4
5363,2,1,18661,18661,18662,0,1,0
5364,6,1,18667,18667,18668,0,1,5
5365,3,3,18670,18670,18673,0,3,2
5366,6,1,18676,18676,18677,0,1,3
5367,1,2,18677,18677,18679,0,2,0
5368,2,1,18679,18679,18680,0,1,0
5369,5,3,18684,18684,18687,0,3,4
5370,2,1,18686,18687,18688,1,2,0
5371,5,1,18691,18691,18692,0,1,3
5372,5,2,18696,18696,18698,0,2,4
5373,2,2,18698,18698,18700,0,2,0
5374,2,1,18700,18700,18701,0,1,0
5375,4,3,18704,18704,18707,0,3,3
5376,3,1,18707,18707,18708,0,1,0
5377,3,3,18710,18710,18713,0,3,2
5378,1,3,18711,18713,18716,2,5,0
5379,3,3,18714,18716,18719,2,5,0
5380,3,3,18717,18719,18722,2,5,0
5381,6,2,18723,18723,18725,0,2,1
5382,5,1,18728,18728,18729,0,1,3
5383,6,2,18734,18734,18736,0,2,5
5384,2,1,18736,18736,18737,0,1,0
5385,5,1,18741,18741,18742,0,1,4
5386,2,3,18743,18743,18746,0,3,1
5387,3,1,18746,18746,18747,0,1,0
5388,5,3,18751,18751,18754,0,3,4
5389,4,1,18755,18755,18756,0,1,1
5390,1,2,18756,18756,18758,0,2,0
5391,1,3,18757,18758,18761,1,4,0
5392,1,1,18758,18761,18762,3,4,0
5393,5,2,18763,18763,18765,0,2,1
5394,6,2,18769,18769,18771,0,2,4
5395,2,3,18771,18771,18774,0,3,0
5396,1,3,18772,18774,18777,2,5,0
5397,2,1,18774,18777,18778,3,4,0
5398,3,3,18777,18778,18781,1,4,0
5399,3,2,18780,18781,18783,1,3,0
5400,1,2,18781,18783,18785,2,4,0
5401,4,3,18785,18785,18788,0,3,0
5402,6,2,18791,18791,18793,0,2,3
5403,1,3,18792,18793,18796,1,4,0
5404,4,1,18796,18796,18797,0,1,0
5405,5,3,18801,18801,18804,0,3,4
5406,4,2,18805,18805,18807,0,2,1
5407,3,1,18808,18808,18809,0,1,1
5408,1,2,18809,18809,18811,0,2,0
5409,4,3,18813,18813,18816,0,3,2
5410,4,2,18817,18817,18819,0,2,1
5411,3,1,18820,18820,18821,0,1,1
5412,6,3,18826,18826,18829,0,3,5
5413,3,1,18829,18829,18830,0,1,0
5414,6,3,18835,18835,18838,0,3,5
5415,3,3,18838,18838,18841,0,3,0
5416,6,3,18844,18844,18847,0,3,3
5417,6,2,18850,18850,18852,0,2,3
5418,3,3,18853,18853,18856,0,3,1
5419,3,2,18856,18856,18858,0,2,0
5420,2,3,18858,18858,18861,0,3,0
5421,6,2,18864,18864,18866,0,2,3
5422,2,1,18866,18866,18867,0,1,0
5423,5,2,18871,18871,18873,0,2,4
5424,3,3,18874,18874,18877,0,3,1
5425,1,2,18875,18877,18879,2,4,0
5426,5,2,18880,18880,18882,0,2,1
5427,5,2,18885,18885,18887,0,2,3
5428,2,3,18887,18887,18890,0,3,0
5429,3,3,18890,18890,18893,0,3,0
5430,1,1,18891,18893,18894,2,3,0
5431,3,2,18894,18894,18896,0,2,0
5432,1,2,18895,18896,18898,1,3,0
5433,1,1,18896,18898,18899,2,3,0
5434,5,3,18901,18901,18904,0,3,2
5435,5,1,18906,18906,18907,0,1,2
5436,5,3,18911,18911,18914,0,3,4
5437,6,2,18917,18917,18919,0,2,3
5438,5,2,18922,18922,18924,0,2,3
5439,3,3,18925,18925,18928,0,3,1
5440,3,2,18928,18928,18930,0,2,0
5441,3,2,18931,18931,18933,0,2,1
5442,3,3,18934,18934,18937,0,3,1
5443,1,1,18935,18937,18938,2,3,0
5444,5,1,18940,18940,18941,0,1,2
5445,2,3,18942,18942,18945,0,3,1
5446,1,1,18943,18945,18946,2,3,0
5447,2,2,18945,18946,18948,1,3,0
5448,3,3,18948,18948,18951,0,3,0
5449,4,3,18952,18952,18955,0,3,1
5450,6,3,18958,18958,18961,0,3,3
5451,5,2,18963,18963,18965,0,2,2
5452,4,1,18967,18967,18968,0,1,2
5453,5,1,18972,18972,18973,0,1,4
5454,6,3,18978,18978,18981,0,3,5
5455,4,2,18982,18982,18984,0,2,1
5456,1,1,18983,18984,18985,1,2,0
5457,1,1,18984,18985,18986,1,2,0
5458,4,1,18988,18988,18989,0,1,2
5459,2,2,18990,18990,18992,0,2,1
5460,6,1,18996,18996,18997,0,1,4
5461,4,2,19000,19000,19002,0,2,3
5462,2,1,19002,19002,19003,0,1,0
5463,4,3,19006,19006,19009,0,3,3
5464,1,3,19007,19009,19012,2,5,0
5465,4,1,19011,19012,19013,1,2,0
5466,5,2,19016,19016,19018,0,2,3
5467,3,3,19019,19019,19022,0,3,1
5468,2,2,19021,19022,19024,1,3,0
5469,4,3,19025,19025,19028,0,3,1
5470,4,1,19029,19029,19030,0,1,1
5471,2,2,19031,19031,19033,0,2,1
5472,3,1,19034,19034,19035,0,1,1
5473,1,3,19035,19035,19038,0,3,0
5474,5,2,19040,19040,19042,0,2,2
5475,4,2,19044,19044,19046,0,2,2
5476,5,1,19049,19049,19050,0,1,3
5477,6,1,19055,19055,19056,0,1,5
5478,2,2,19057,19057,19059,0,2,1
5479,2,3,19059,19059,19062,0,3,0
5480,3,1,19062,19062,19063,0,1,0
5481,3,1,19065,19065,19066,0,1,2
5482,5,2,19070,19070,19072,0,2,4
5483,3,1,19073,19073,19074,0,1,1
5484,4,1,19077,19077,19078,0,1,3
5485,6,3,19083,19083,19086,0,3,5
5486,5,2,19088,19088,19090,0,2,2
5487,5,2,19093,19093,19095,0,2,3
5488,1,1,19094,19095,19096,1,2,0
5489,3,3,19097,19097,19100,0,3,1
5490,1,2,19098,19100,19102,2,4,0
5491,2,1,19100,19102,19103,2,3,0
5492,5,3,19105,19105,19108,0,3,2
5493,3,3,19108,19108,19111,0,3,0
5494,3,1,19111,19111,19112,0,1,0
5495,5,2,19116,19116,19118,0,2,4
5496,2,3,19118,19118,19121,0,3,0
5497,1,1,19119,19121,19122,2,3,0
5498,3,3,19122,19122,19125,0,3,0
5499,5,2,19127,19127,19129,0,2,2
5500,4,3,19131,19131,19134,0,3,2
5501,1,2,19132,19134,19136,2,4,0
5502,4,2,19136,19136,19138,0,2,0
5503,6,1,19142,19142,19143,0,1,4
5504,5,1,19147,19147,19148,0,1,4
5505,3,2,19150,19150,19152,0,2,2
5506,2,1,19152,19152,19153,0,1,0
5507,3,3,19155,19155,19158,0,3,2
5508,1,2,19156,19158,19160,2,4,0
5509,1,2,19157,19160,19162,3,5,0
5510,4,2,19161,19162,19164,1,3,0
5511,4,1,19165,19165,19166,0,1,1
5512,4,1,19169,19169,19170,0,1,3
5513,3,2,19172,19172,19174,0,2,2
5514,5,3,19177,19177,19180,0,3,3
5515,3,3,19180,19180,19183,0,3,0
5516,6,2,19186,19186,19188,0,2,3
5517,1,1,19187,19188,19189,1,2,0
5518,4,3,19191,19191,19194,0,3,2
5519,4,2,19195,19195,19197,0,2,1
5520,3,2,19198,19198,19200,0,2,1
5521,5,1,19203,19203,19204,0,1,3
5522,5,2,19208,19208,19210,0,2,4
5523,3,1,19211,19211,19212,0,1,1
5524,6,3,19217,19217,19220,0,3,5
5525,3,1,19220,19220,19221,0,1,0
5526,4,1,19224,19224,19225,0,1,3
5527,6,1,19230,19230,19231,0,1,5
5528,4,1,19234,19234,19235,0,1,3
5529,6,3,19240,19240,19243,0,3,5
5530,5,2,19245,19245,19247,0,2,2
5531,3,1,19248,19248,19249,0,1,1
5532,3,2,19251,19251,19253,0,2,2
5533,3,3,19254,19254,19257,0,3,1
5534,4,3,19258,19258,19261,0,3,1
5535,4,2,19262,19262,19264,0,2,1
5536,3,1,19265,19265,19266,0,1,1
5537,4,3,19269,19269,19272,0,3,3
5538,4,3,19273,19273,19276,0,3,1
5539,5,1,19278,19278,19279,0,1,2
5540,1,2,19279,19279,19281,0,2,0
5541,4,2,19283,19283,19285,0,2,2
5542,4,2,19287,19287,19289,0,2,2
5543,3,1,19290,19290,19291,0,1,1
5544,3,1,19293,19293,19294,0,1,2
5545,2,2,19295,19295,19297,0,2,1
5546,4,3,19299,19299,19302,0,3,2
5547,6,3,19305,19305,19308,0,3,3
5548,3,3,19308,19308,19311,0,3,0
5549,6,1,19314,19314,19315,0,1,3
5550,4,2,19318,19318,19320,0,2,3
5551,4,3,19322,19322,19325,0,3,2
5552,3,2,19325,19325,19327,0,2,0
5553,5,2,19330,19330,19332,0,2,3
5554,1,2,19331,19332,19334,1,3,0
5555,1,3,19332,19334,19337,2,5,0
5556,6,3,19338,19338,19341,0,3,1
5557,6,2,19344,19344,19346,0,2,3
5558,4,1,19348,19348,19349,0,1,2
5559,1,2,19349,19349,19351,0,2,0
5560,2,2,19351,19351,19353,0,2,0
5561,3,3,19354,19354,19357,0,3,1
5562,1,1,19355,19357,19358,2,3,0
5563,4,1,19359,19359,19360,0,1,1
5564,3,2,19362,19362,19364,0,2,2
5565,4,2,19366,19366,19368,0,2,2
5566,2,1,19368,19368,19369,0,1,0
5567,1,3,19369,19369,19372,0,3,0
5568,2,2,19371,19372,19374,1,3,0
5569,1,3,19372,19374,19377,2,5,0
5570,5,3,19377,19377,19380,0,3,0
5571,4,1,19381,19381,19382,0,1,1
5572,2,2,19383,19383,19385,0,2,1
5573,2,1,19385,19385,19386,0,1,0
5574,2,2,19387,19387,19389,0,2,1
5575,5,1,19392,19392,19393,0,1,3
5576,4,3,19396,19396,19399,0,3,3
5577,6,2,19402,19402,19404,0,2,3
5578,5,2,19407,19407,19409,0,2,3
5579,6,2,19413,19413,19415,0,2,4
5580,3,1,19416,19416,19417,0,1,1
5581,2,1,19418,19418,19419,0,1,1
5582,4,2,19422,19422,19424,0,2,3
5583,4,2,19426,19426,19428,0,2,2
5584,2,2,19428,19428,19430,0,2,0
5585,5,2,19433,19433,19435,0,2,3
5586,4,1,19437,19437,19438,0,1,2
5587,2,3,19439,19439,19442,0,3,1
5588,1,1,19440,19442,19443,2,3,0
5589,3,2,19443,19443,19445,0,2,0
5590,2,2,19445,19445,19447,0,2,0
5591,3,3,19448,19448,19451,0,3,1
5592,3,1,19451,19451,19452,0,1,0
5593,4,3,19455,19455,19458,0,3,3
5594,5,3,19460,19460,19463,0,3,2
5595,6,1,19466,19466,19467,0,1,3
5596,4,3,19470,19470,19473,0,3,3
5597,6,3,19476,19476,19479,0,3,3
5598,1,2,19477,19479,19481,2,4,0
5599,6,3,19483,19483,19486,0,3,2
5600,2,3,19485,19486,19489,1,4,0
5601,5,3,19490,19490,19493,0,3,1
5602,5,1,19495,19495,19496,0,1,2
5603,2,1,19497,19497,19498,0,1,1
5604,2,2,19499,19499,19501,0,2,1
5605,6,1,19505,19505,19506,0,1,4
5606,4,1,19509,19509,19510,0,1,3
5607,2,2,19511,19511,19513,0,2,1
5608,4,3,19515,19515,19518,0,3,2
5609,1,1,19516,19518,19519,2,3,0
5610,4,2,19520,19520,19522,0,2,1
5611,4,2,19524,19524,19526,0,2,2
5612,3,3,19527,19527,19530,0,3,1
5613,5,3,19532,19532,19535,0,3,2
5614,3,2,19535,19535,19537,0,2,0
5615,6,3,19541,19541,19544,0,3,4
5616,6,2,19547,19547,19549,0,2,3
5617,6,1,19553,19553,19554,0,1,4
5618,5,3,19558,19558,19561,0,3,4
5619,2,2,19560,19561,19563,1,3,0
5620,5,1,19565,19565,19566,0,1,2
5621,1,1,19566,19566,19567,0,1,0
5622,1,3,19567,19567,19570,0,3,0
5623,2,1,19569,19570,19571,1,2,0
5624,1,2,19570,19571,19573,1,3,0
5625,5,2,19575,19575,19577,0,2,2
5626,4,2,19579,19579,19581,0,2,2
5627,3,3,19582,19582,19585,0,3,1
5628,3,2,19585,19585,19587,0,2,0
5629,1,2,19586,19587,19589,1,3,0
5630,5,1,19591,19591,19592,0,1,2
5631,1,3,19592,19592,19595,0,3,0
5632,2,1,19594,19595,19596,1,2,0
5633,3,1,19597,19597,19598,0,1,1
5634,5,1,19602,19602,19603,0,1,4
5635,3,3,19605,19605,19608,0,3,2
5636,5,1,19610,19610,19611,0,1,2
5637,5,1,19615,19615,19616,0,1,4
5638,3,2,19618,19618,19620,0,2,2
5639,1,1,19619,19620,19621,1,2,0
5640,2,2,19621,19621,19623,0,2,0
5641,2,1,19623,19623,19624,0,1,0
5642,2,2,19625,19625,19627,0,2,1
5643,2,2,19627,19627,19629,0,2,0
5644,4,1,19631,19631,19632,0,1,2
5645,6,3,19637,19637,19640,0,3,5
5646,2,2,19639,19640,19642,1,3,0
5647,1,2,19640,19642,19644,2,4,0
5648,4,3,19644,19644,19647,0,3,0
5649,4,3,19648,19648,19651,0,3,1
5650,5,3,19653,19653,19656,0,3,2
5651,1,3,19654,19656,19659,2,5,0
5652,1,3,19655,19659,19662,4,7,0
5653,1,1,19656,19662,19663,6,7,0
5654,6,3,19662,19663,19666,1,4,0
5655,1,3,19663,19666,19669,3,6,0
5656,1,1,19664,19669,19670,5,6,0
5657,6,3,19670,19670,19673,0,3,0
5658,5,1,19675,19675,19676,0,1,2
5659,6,2,19681,19681,19683,0,2,5
5660,2,3,19683,19683,19686,0,3,0
5661,2,3,19685,19686,19689,1,4,0
5662,3,1,19688,19689,19690,1,2,0
5663,6,1,19694,19694,19695,0,1,4
5664,4,2,19698,19698,19700,0,2,3
5665,5,2,19703,19703,19705,0,2,3
5666,6,1,19709,19709,19710,0,1,4
5667,1,2,19710,19710,19712,0,2,0
5668,5,3,19715,19715,19718,0,3,3
5669,2,2,19717,19718,19720,1,3,0
5670,1,1,19718,19720,19721,2,3,0
5671,5,1,19723,19723,19724,0,1,2
5672,3,3,19726,19726,19729,0,3,2
5673,5,2,19731,19731,19733,0,2,2
5674,4,3,19735,19735,19738,0,3,2
5675,2,3,19737,19738,19741,1,4,0
5676,2,3,19739,19741,19744,2,5,0
5677,6,3,19745,19745,19748,0,3,1
5678,4,1,19749,19749,19750,0,1,1
5679,4,2,19753,19753,19755,0,2,3
5680,1,1,19754,19755,19756,1,2,0
5681,2,1,19756,19756,19757,0,1,0
5682,5,1,19761,19761,19762,0,1,4
5683,3,3,19764,19764,19767,0,3,2
5684,5,2,19769,19769,19771,0,2,2
5685,4,2,19773,19773,19775,0,2,2
5686,6,2,19779,19779,19781,0,2,4
5687,1,2,19780,19781,19783,1,3,0
5688,1,3,19781,19783,19786,2,5,0
5689,2,3,19783,19786,19789,3,6,0
5690,6,3,19789,19789,19792,0,3,0
5691,5,1,19794,19794,19795,0,1,2
5692,2,2,19796,19796,19798,0,2,1
5693,1,2,19797,19798,19800,1,3,0
5694,5,3,19802,19802,19805,0,3,2
5695,6,1,19808,19808,19809,0,1,3
5696,2,1,19810,19810,19811,0,1,1
5697,4,1,19814,19814,19815,0,1,3
5698,4,3,19818,19818,19821,0,3,3
5699,1,2,19819,19821,19823,2,4,0
5700,1,1,19820,19823,19824,3,4,0
5701,6,2,19826,19826,19828,0,2,2
5702,3,1,19829,19829,19830,0,1,1
5703,6,2,19835,19835,19837,0,2,5
5704,6,1,19841,19841,19842,0,1,4
5705,3,3,19844,19844,19847,0,3,2
5706,5,2,19849,19849,19851,0,2,2
5707,1,2,19850,19851,19853,1,3,0
5708,1,3,19851,19853,19856,2,5,0
5709,3,3,19854,19856,19859,2,5,0
5710,4,3,19858,19859,19862,1,4,0
5711,2,1,19860,19862,19863,2,3,0
5712,3,1,19863,19863,19864,0,1,0
5713,2,2,19865,19865,19867,0,2,1
5714,1,1,19866,19867,19868,1,2,0
5715,3,2,19869,19869,19871,0,2,1
5716,4,2,19873,19873,19875,0,2,2
5717,6,1,19879,19879,19880,0,1,4
5718,2,1,19881,19881,19882,0,1,1
5719,5,3,19886,19886,19889,0,3,4
5720,2,2,19888,19889,19891,1,3,0
5721,6,3,19894,19894,19897,0,3,3
5722,3,2,19897,19897,19899,0,2,0
5723,4,2,19901,19901,19903,0,2,2
5724,2,2,19903,19903,19905,0,2,0
5725,2,1,19905,19905,19906,0,1,0
5726,1,3,19906,19906,19909,0,3,0
5727,6,1,19912,19912,19913,0,1,3
5728,4,1,19916,19916,19917,0,1,3
5729,3,2,19919,19919,19921,0,2,2
5730,5,1,19924,19924,19925,0,1,3
5731,4,1,19928,19928,19929,0,1,3
5732,6,3,19934,19934,19937,0,3,5
5733,2,1,19936,19937,19938,1,2,0
5734,3,2,19939,19939,19941,0,2,1
5735,5,2,19944,19944,19946,0,2,3
5736,5,1,19949,19949,19950,0,1,3
5737,1,1,19950,19950,19951,0,1,0
5738,2,2,19952,19952,19954,0,2,1
5739,2,2,19954,19954,19956,0,2,0
5740,2,1,19956,19956,19957,0,1,0
5741,2,3,19958,19958,19961,0,3,1
5742,5,3,19963,19963,19966,0,3,2
5743,1,1,19964,19966,19967,2,3,0
5744,5,2,19969,19969,19971,0,2,2
5745,4,2,19973,19973,19975,0,2,2
5746,2,1,19975,19975,19976,0,1,0
5747,3,3,19978,19978,19981,0,3,2
5748,4,2,19982,19982,19984,0,2,1
5749,6,2,19988,19988,19990,0,2,4
5750,4,1,19992,19992,19993,0,1,2
5751,1,3,19993,19993,19996,0,3,0
5752,5,1,19998,19998,19999,0,1,2
5753,2,3,20000,20000,20003,0,3,1
5754,6,2,20006,20006,20008,0,2,3
5755,6,3,20012,20012,20015,0,3,4
5756,2,1,20014,20015,20016,1,2,0
5757,4,3,20018,20018,20021,0,3,2
5758,4,1,20022,20022,20023,0,1,1
5759,2,3,20024,20024,20027,0,3,1
5760,3,3,20027,20027,20030,0,3,0
5761,2,1,20029,20030,20031,1,2,0
5762,2,3,20031,20031,20034,0,3,0
5763,1,2,20032,20034,20036,2,4,0
5764,1,3,20033,20036,20039,3,6,0
5765,6,3,20039,20039,20042,0,3,0
5766,2,2,20041,20042,20044,1,3,0
5767,1,3,20042,20044,20047,2,5,0
5768,4,3,20046,20047,20050,1,4,0
5769,1,2,20047,20050,20052,3,5,0
5770,6,2,20053,20053,20055,0,2,1
5771,4,2,20057,20057,20059,0,2,2
5772,6,1,20063,20063,20064,0,1,4
5773,1,3,20064,20064,20067,0,3,0
5774,4,3,20068,20068,20071,0,3,1
5775,6,2,20074,20074,20076,0,2,3
5776,2,2,20076,20076,20078,0,2,0
5777,3,1,20079,20079,20080,0,1,1
5778,6,1,20085,20085,20086,0,1,5
5779,3,3,20088,20088,20091,0,3,2
5780,2,2,20090,20091,20093,1,3,0
5781,3,2,20093,20093,20095,0,2,0
5782,5,3,20098,20098,20101,0,3,3
5783,3,2,20101,20101,20103,0,2,0
5784,5,2,20106,20106,20108,0,2,3
5785,6,1,20112,20112,20113,0,1,4
5786,5,1,20117,20117,20118,0,1,4
5787,2,1,20119,20119,20120,0,1,1
5788,3,1,20122,20122,20123,0,1,2
5789,4,3,20126,20126,20129,0,3,3
5790,5,2,20131,20131,20133,0,2,2
5791,4,1,20135,20135,20136,0,1,2
5792,1,3,20136,20136,20139,0,3,0
5793,6,3,20142,20142,20145,0,3,3
5794,2,1,20144,20145,20146,1,2,0
5795,3,3,20147,20147,20150,0,3,1
5796,6,2,20153,20153,20155,0,2,3
5797,2,1,20155,20155,20156,0,1,0
5798,1,3,20156,20156,20159,0,3,0
5799,2,2,20158,20159,20161,1,3,0
5800,1,2,20159,20161,20163,2,4,0
5801,3,1,20162,20163,20164,1,2,0
5802,5,3,20167,20167,20170,0,3,3
5803,3,2,20170,20170,20172,0,2,0
5804,2,1,20172,20172,20173,0,1,0
5805,3,2,20175,20175,20177,0,2,2
5806,3,2,20178,20178,20180,0,2,1
5807,2,3,20180,20180,20183,0,3,0
5808,1,2,20181,20183,20185,2,4,0
5809,3,3,20184,20185,20188,1,4,0
5810,6,3,20190,20190,20193,0,3,2
5811,3,2,20193,20193,20195,0,2,0
5812,6,1,20199,20199,20200,0,1,4
5813,4,1,20203,20203,20204,0,1,3
5814,4,3,20207,20207,20210,0,3,3
5815,5,2,20212,20212,20214,0,2,2
5816,1,3,20213,20214,20217,1,4,0
5817,2,1,20215,20217,20218,2,3,0
5818,5,3,20220,20220,20223,0,3,2
5819,6,3,20226,20226,20229,0,3,3
5820,1,2,20227,20229,20231,2,4,0
5821,3,3,20230,20231,20234,1,4,0
5822,5,1,20235,20235,20236,0,1,1
5823,1,1,20236,20236,20237,0,1,0
5824,5,2,20241,20241,20243,0,2,4
5825,5,2,20246,20246,20248,0,2,3
5826,4,2,20250,20250,20252,0,2,2
5827,1,1,20251,20252,20253,1,2,0
5828,5,3,20256,20256,20259,0,3,3
5829,4,1,20260,20260,20261,0,1,1
5830,2,1,20262,20262,20263,0,1,1
5831,5,1,20267,20267,20268,0,1,4
5832,1,3,20268,20268,20271,0,3,0
5833,4,3,20272,20272,20275,0,3,1
5834,2,2,20274,20275,20277,1,3,0
5835,1,2,20275,20277,20279,2,4,0
5836,6,3,20281,20281,20284,0,3,2
5837,6,3,20287,20287,20290,0,3,3
5838,4,2,20291,20291,20293,0,2,1
5839,5,3,20296,20296,20299,0,3,3
5840,6,2,20302,20302,20304,0,2,3
5841,4,2,20306,20306,20308,0,2,2
5842,6,3,20312,20312,20315,0,3,4
5843,3,1,20315,20315,20316,0,1,0
5844,5,1,20320,20320,20321,0,1,4
5845,1,2,20321,20321,20323,0,2,0
5846,2,3,20323,20323,20326,0,3,0
5847,5,3,20328,20328,20331,0,3,2
5848,3,3,20331,20331,20334,0,3,0
5849,6,1,20337,20337,20338,0,1,3
5850,2,2,20339,20339,20341,0,2,1
5851,5,3,20344,20344,20347,0,3,3
5852,4,2,20348,20348,20350,0,2,1
5853,1,2,20349,20350,20352,1,3,0
5854,6,1,20355,20355,20356,0,1,3
5855,3,1,20358,20358,20359,0,1,2
5856,5,3,20363,20363,20366,0,3,4
5857,5,1,20368,20368,20369,0,1,2
5858,1,2,20369,20369,20371,0,2,0
5859,1,1,20370,20371,20372,1,2,0
5860,1,1,20371,20372,20373,1,2,0
5861,5,1,20376,20376,20377,0,1,3
5862,2,1,20378,20378,20379,0,1,1
5863,6,1,20384,20384,20385,0,1,5
5864,2,2,20386,20386,20388,0,2,1
5865,3,2,20389,20389,20391,0,2,1
5866,5,3,20394,20394,20397,0,3,3
5867,4,1,20398,20398,20399,0,1,1
5868,4,2,20402,20402,20404,0,2,3
5869,5,1,20407,20407,20408,0,1,3
5870,3,3,20410,20410,20413,0,3,2
5871,1,3,20411,20413,20416,2,5,0
5872,1,1,20412,20416,20417,4,5,0
5873,6,3,20418,20418,20421,0,3,1
5874,1,1,20419,20421,20422,2,3,0
5875,1,2,20420,20422,20424,2,4,0
5876,5,2,20425,20425,20427,0,2,1
5877,2,3,20427,20427,20430,0,3,0
5878,4,1,20431,20431,20432,0,1,1
5879,3,3,20434,20434,20437,0,3,2
5880,3,2,20437,20437,20439,0,2,0
5881,2,2,20439,20439,20441,0,2,0
5882,1,2,20440,20441,20443,1,3,0
5883,5,1,20445,20445,20446,0,1,2
5884,5,2,20450,20450,20452,0,2,4
5885,4,3,20454,20454,20457,0,3,2
5886,2,2,20456,20457,20459,1,3,0
5887,6,2,20462,20462,20464,0,2,3
5888,5,1,20467,20467,20468,0,1,3
5889,4,3,20471,20471,20474,0,3,3
5890,5,1,20476,20476,20477,0,1,2
5891,3,3,20479,20479,20482,0,3,2
5892,2,2,20481,20482,20484,1,3,0
5893,1,1,20482,20484,20485,2,3,0
5894,6,1,20488,20488,20489,0,1,3
5895,5,1,20493,20493,20494,0,1,4
5896,2,3,20495,20495,20498,0,3,1
5897,5,3,20500,20500,20503,0,3,2
5898,2,2,20502,20503,20505,1,3,0
5899,2,1,20504,20505,20506,1,2,0
5900,3,3,20507,20507,20510,0,3,1
5901,1,2,20508,20510,20512,2,4,0
5902,4,1,20512,20512,20513,0,1,0
5903,2,2,20514,20514,20516,0,2,1
5904,6,1,20520,20520,20521,0,1,4
5905,5,3,20525,20525,20528,0,3,4
5906,3,2,20528,20528,20530,0,2,0
5907,5,2,20533,20533,20535,0,2,3
5908,3,2,20536,20536,20538,0,2,1
5909,6,1,20542,20542,20543,0,1,4
5910,2,1,20544,20544,20545,0,1,1
5911,1,1,20545,20545,20546,0,1,0
5912,6,1,20551,20551,20552,0,1,5
5913,5,2,20556,20556,20558,0,2,4
5914,2,2,20558,20558,20560,0,2,0
5915,6,3,20564,20564,20567,0,3,4
5916,6,2,20570,20570,20572,0,2,3
5917,2,1,20572,20572,20573,0,1,0
5918,1,3,20573,20573,20576,0,3,0
5919,1,2,20574,20576,20578,2,4,0
5920,5,2,20579,20579,20581,0,2,1
5921,6,3,20585,20585,20588,0,3,4
5922,2,1,20587,20588,20589,1,2,0
5923,1,2,20588,20589,20591,1,3,0
5924,6,2,20594,20594,20596,0,2,3
5925,2,3,20596,20596,20599,0,3,0
5926,1,2,20597,20599,20601,2,4,0
5927,3,1,20600,20601,20602,1,2,0
5928,6,3,20606,20606,20609,0,3,4
5929,3,3,20609,20609,20612,0,3,0
5930,1,3,20610,20612,20615,2,5,0
5931,5,1,20615,20615,20616,0,1,0
5932,2,2,20617,20617,20619,0,2,1
5933,1,2,20618,20619,20621,1,3,0
5934,1,3,20619,20621,20624,2,5,0
5935,5,1,20624,20624,20625,0,1,0
5936,2,1,20626,20626,20627,0,1,1
5937,4,3,20630,20630,20633,0,3,3
5938,3,1,20633,20633,20634,0,1,0
5939,3,2,20636,20636,20638,0,2,2
5940,4,1,20640,20640,20641,0,1,2
5941,2,3,20642,20642,20645,0,3,1
5942,5,3,20647,20647,20650,0,3,2
5943,6,3,20653,20653,20656,0,3,3
5944,1,1,20654,20656,20657,2,3,0
5945,6,1,20660,20660,20661,0,1,3
5946,6,2,20666,20666,20668,0,2,5
5947,3,3,20669,20669,20672,0,3,1
5948,6,3,20675,20675,20678,0,3,3
5949,5,3,20680,20680,20683,0,3,2
5950,4,2,20684,20684,20686,0,2,1
5951,2,3,20686,20686,20689,0,3,0
5952,6,2,20692,20692,20694,0,2,3
5953,5,2,20697,20697,20699,0,2,3
5954,6,3,20703,20703,20706,0,3,4
5955,3,2,20706,20706,20708,0,2,0
5956,4,1,20710,20710,20711,0,1,2
5957,5,3,20715,20715,20718,0,3,4
5958,1,1,20716,20718,20719,2,3,0
5959,4,2,20720,20720,20722,0,2,1
5960,3,2,20723,20723,20725,0,2,1
5961,4,3,20727,20727,20730,0,3,2
5962,6,3,20733,20733,20736,0,3,3
5963,2,1,20735,20736,20737,1,2,0
5964,1,1,20736,20737,20738,1,2,0
5965,5,1,20741,20741,20742,0,1,3
5966,5,2,20746,20746,20748,0,2,4
5967,3,1,20749,20749,20750,0,1,1
5968,2,3,20751,20751,20754,0,3,1
5969,1,2,20752,20754,20756,2,4,0
5970,2,1,20754,20756,20757,2,3,0
5971,6,2,20760,20760,20762,0,2,3
5972,4,3,20764,20764,20767,0,3,2
5973,2,3,20766,20767,20770,1,4,0
5974,2,2,20768,20770,20772,2,4,0
5975,6,3,20774,20774,20777,0,3,2
5976,4,2,20778,20778,20780,0,2,1
5977,5,3,20783,20783,20786,0,3,3
5978,4,1,20787,20787,20788,0,1,1
5979,3,1,20790,20790,20791,0,1,2
5980,4,1,20794,20794,20795,0,1,3
5981,3,2,20797,20797,20799,0,2,2
5982,4,2,20801,20801,20803,0,2,2
5983,4,3,20805,20805,20808,0,3,2
5984,6,1,20811,20811,20812,0,1,3
5985,4,1,20815,20815,20816,0,1,3
5986,5,2,20820,20820,20822,0,2,4
5987,4,1,20824,20824,20825,0,1,2
5988,2,3,20826,20826,20829,0,3,1
5989,4,2,20830,20830,20832,0,2,1
5990,5,1,20835,20835,20836,0,1,3
5991,3,2,20838,20838,20840,0,2,2
5992,2,2,20840,20840,20842,0,2,0
5993,4,2,20844,20844,20846,0,2,2
5994,6,3,20850,20850,20853,0,3,4
5995,2,1,20852,20853,20854,1,2,0
5996,4,1,20856,20856,20857,0,1,2
5997,4,3,20860,20860,20863,0,3,3
5998,1,2,20861,20863,20865,2,4,0
5999,6,2,20867,20867,20869,0,2,2
6000,3,2,20870,20870,20872,0,2,1
6001,6,1,20876,20876,20877,0,1,4
6002,2,3,20878,20878,20881,0,3,1
6003,3,2,20881,20881,20883,0,2,0
6004,3,1,20884,20884,20885,0,1,1
6005,2,1,20886,20886,20887,0,1,1
6006,5,2,20891,20891,20893,0,2,4
6007,6,1,20897,20897,20898,0,1,4
6008,6,1,20903,20903,20904,0,1,5
6009,5,2,20908,20908,20910,0,2,4
6010,6,2,20914,20914,20916,0,2,4
6011,1,2,20915,20916,20918,1,3,0
6012,6,1,20921,20921,20922,0,1,3
6013,4,2,20925,20925,20927,0,2,3
6014,1,3,20926,20927,20930,1,4,0
6015,3,2,20929,20930,20932,1,3,0
6016,5,3,20934,20934,20937,0,3,2
6017,6,3,20940,20940,20943,0,3,3
6018,5,3,20945,20945,20948,0,3,2
6019,2,1,20947,20948,20949,1,2,0
6020,6,1,20953,20953,20954,0,1,4
6021,3,2,20956,20956,20958,0,2,2
6022,6,1,20962,20962,20963,0,1,4
6023,1,3,20963,20963,20966,0,3,0
6024,1,2,20964,20966,20968,2,4,0
6025,1,3,20965,20968,20971,3,6,0
6026,6,2,20971,20971,20973,0,2,0
6027,4,2,20975,20975,20977,0,2,2
6028,6,3,20981,20981,20984,0,3,4
6029,3,2,20984,20984,20986,0,2,0
6030,5,2,20989,20989,20991,0,2,3
6031,2,2,20991,20991,20993,0,2,0
6032,6,2,20997,20997,20999,0,2,4
6033,2,2,20999,20999,21001,0,2,0
6034,6,1,21005,21005,21006,0,1,4
6035,4,1,21009,21009,21010,0,1,3
6036,4,1,21013,21013,21014,0,1,3
6037,1,1,21014,21014,21015,0,1,0
6038,3,2,21017,21017,21019,0,2,2
6039,6,2,21023,21023,21025,0,2,4
6040,1,1,21024,21025,21026,1,2,0
6041,2,3,21026,21026,21029,0,3,0
6042,3,1,21029,21029,21030,0,1,0
6043,3,1,21032,21032,21033,0,1,2
6044,4,1,21036,21036,21037,0,1,3
6045,3,3,21039,21039,21042,0,3,2
6046,2,1,21041,21042,21043,1,2,0
6047,4,3,21045,21045,21048,0,3,2
6048,3,3,21048,21048,21051,0,3,0
6049,4,2,21052,21052,21054,0,2,1
6050,6,2,21058,21058,21060,0,2,4
6051,4,2,21062,21062,21064,0,2,2
6052,3,1,21065,21065,21066,0,1,1
6053,6,1,21071,21071,21072,0,1,5
6054,1,2,21072,21072,21074,0,2,0
6055,5,2,21077,21077,21079,0,2,3
6056,2,2,21079,21079,21081,0,2,0
6057,4,3,21083,21083,21086,0,3,2
6058,6,1,21089,21089,21090,0,1,3
6059,6,1,21095,21095,21096,0,1,5
6060,6,1,21101,21101,21102,0,1,5
6061,6,1,21107,21107,21108,0,1,5
6062,4,1,21111,21111,21112,0,1,3
6063,2,2,21113,21113,21115,0,2,1
6064,3,3,21116,21116,21119,0,3,1
6065,5,3,21121,21121,21124,0,3,2
6066,4,2,21125,21125,21127,0,2,1
6067,4,3,21129,21129,21132,0,3,2
6068,6,3,21135,21135,21138,0,3,3
6069,3,2,21138,21138,21140,0,2,0
6070,6,3,21144,21144,21147,0,3,4
6071,1,2,21145,21147,21149,2,4,0
6072,4,1,21149,21149,21150,0,1,0
6073,5,3,21154,21154,21157,0,3,4
6074,5,2,21159,21159,21161,0,2,2
6075,2,2,21161,21161,21163,0,2,0
6076,1,3,21162,21163,21166,1,4,0
6077,2,3,21164,21166,21169,2,5,0
6078,4,1,21168,21169,21170,1,2,0
6079,4,3,21172,21172,21175,0,3,2
6080,5,1,21177,21177,21178,0,1,2
6081,1,1,21178,21178,21179,0,1,0
6082,2,1,21180,21180,21181,0,1,1
6083,4,2,21184,21184,21186,0,2,3
6084,5,2,21189,21189,21191,0,2,3
6085,2,1,21191,21191,21192,0,1,0
6086,4,2,21195,21195,21197,0,2,3
6087,1,2,21196,21197,21199,1,3,0
6088,3,2,21199,21199,21201,0,2,0
6089,1,2,21200,21201,21203,1,3,0
6090,4,2,21204,21204,21206,0,2,1
6091,5,2,21209,21209,21211,0,2,3
6092,5,2,21214,21214,21216,0,2,3
6093,2,2,21216,21216,21218,0,2,0
6094,5,2,21221,21221,21223,0,2,3
6095,4,2,21225,21225,21227,0,2,2
6096,2,3,21227,21227,21230,0,3,0
6097,4,2,21231,21231,21233,0,2,1
6098,1,2,21232,21233,21235,1,3,0
6099,6,3,21238,21238,21241,0,3,3
6100,4,1,21242,21242,21243,0,1,1
6101,4,3,21246,21246,21249,0,3,3
6102,2,1,21248,21249,21250,1,2,0
6103,1,2,21249,21250,21252,1,3,0
6104,1,3,21250,21252,21255,2,5,0
6105,4,3,21254,21255,21258,1,4,0
6106,6,1,21260,21260,21261,0,1,2
6107,1,3,21261,21261,21264,0,3,0
6108,6,1,21267,21267,21268,0,1,3
6109,4,3,21271,21271,21274,0,3,3
6110,3,3,21274,21274,21277,0,3,0
6111,1,1,21275,21277,21278,2,3,0
6112,6,1,21281,21281,21282,0,1,3
6113,6,2,21287,21287,21289,0,2,5
6114,1,1,21288,21289,21290,1,2,0
6115,2,3,21290,21290,21293,0,3,0
6116,4,3,21294,21294,21297,0,3,1
6117,3,1,21297,21297,21298,0,1,0
6118,6,2,21303,21303,21305,0,2,5
6119,6,2,21309,21309,21311,0,2,4
6120,5,2,21314,21314,21316,0,2,3
6121,1,1,21315,21316,21317,1,2,0
6122,4,3,21319,21319,21322,0,3,2
6123,6,2,21325,21325,21327,0,2,3
6124,6,1,21331,21331,21332,0,1,4
6125,1,1,21332,21332,21333,0,1,0
6126,4,2,21336,21336,21338,0,2,3
6127,6,2,21342,21342,21344,0,2,4
6128,1,1,21343,21344,21345,1,2,0
6129,6,2,21349,21349,21351,0,2,4
6130,4,3,21353,21353,21356,0,3,2
6131,2,3,21355,21356,21359,1,4,0
6132,6,2,21361,21361,21363,0,2,2
6133,3,1,21364,21364,21365,0,1,1
6134,1,3,21365,21365,21368,0,3,0
6135,6,3,21371,21371,21374,0,3,3
6136,3,1,21374,21374,21375,0,1,0
6137,6,2,21380,21380,21382,0,2,5
6138,4,3,21384,21384,21387,0,3,2
6139,5,3,21389,21389,21392,0,3,2
6140,4,1,21393,21393,21394,0,1,1
6141,2,2,21395,21395,21397,0,2,1
6142,1,1,21396,21397,21398,1,2,0
6143,2,2,21398,21398,21400,0,2,0
6144,1,1,21399,21400,21401,1,2,0
6145,3,2,21402,21402,21404,0,2,1
6146,3,1,21405,21405,21406,0,1,1
6147,6,3,21411,21411,21414,0,3,5
6148,3,2,21414,21414,21416,0,2,0
6149,3,3,21417,21417,21420,0,3,1
6150,3,3,21420,21420,21423,0,3,0
6151,1,2,21421,21423,21425,2,4,0
6152,2,1,21423,21425,21426,2,3,0
6153,3,2,21426,21426,21428,0,2,0
6154,3,2,21429,21429,21431,0,2,1
6155,5,3,21434,21434,21437,0,3,3
6156,5,3,21439,21439,21442,0,3,2
6157,5,1,21444,21444,21445,0,1,2
6158,3,3,21447,21447,21450,0,3,2
6159,5,1,21452,21452,21453,0,1,2
6160,4,3,21456,21456,21459,0,3,3
6161,4,2,21460,21460,21462,0,2,1
6162,6,2,21466,21466,21468,0,2,4
6163,5,3,21471,21471,21474,0,3,3
6164,3,3,21474,21474,21477,0,3,0
6165,2,3,21476,21477,21480,1,4,0
6166,5,3,21481,21481,21484,0,3,1
6167,2,3,21483,21484,21487,1,4,0
6168,1,2,21484,21487,21489,3,5,0
6169,4,1,21488,21489,21490,1,2,0
6170,5,1,21493,21493,21494,0,1,3
6171,1,3,21494,21494,21497,0,3,0
6172,2,2,21496,21497,21499,1,3,0
6173,4,1,21500,21500,21501,0,1,1
6174,6,3,21506,21506,21509,0,3,5
6175,2,3,21508,21509,21512,1,4,0
6176,3,2,21511,21512,21514,1,3,0
6177,6,2,21517,21517,21519,0,2,3
6178,4,3,21521,21521,21524,0,3,2
6179,3,3,21524,21524,21527,0,3,0
6180,4,1,21528,21528,21529,0,1,1
6181,4,2,21532,21532,21534,0,2,3
6182,1,3,21533,21534,21537,1,4,0
6183,1,3,21534,21537,21540,3,6,0
6184,2,3,21536,21540,21543,4,7,0
6185,1,2,21537,21543,21545,6,8,0
6186,3,2,21540,21545,21547,5,7,0
6187,1,1,21541,21547,21548,6,7,0
6188,2,1,21543,21548,21549,5,6,0
6189,6,2,21549,21549,21551,0,2,0
6190,1,2,21550,21551,21553,1,3,0
6191,6,1,21556,21556,21557,0,1,3
6192,1,1,21557,21557,21558,0,1,0
6193,3,3,21560,21560,21563,0,3,2
6194,5,2,21565,21565,21567,0,2,2
6195,4,2,21569,21569,21571,0,2,2
6196,1,2,21570,21571,21573,1,3,0
6197,5,2,21575,21575,21577,0,2,2
6198,1,2,21576,21577,21579,1,3,0
6199,6,2,21582,21582,21584,0,2,3
6200,6,1,21588,21588,21589,0,1,4
6201,4,3,21592,21592,21595,0,3,3
6202,4,2,21596,21596,21598,0,2,1
6203,2,2,21598,21598,21600,0,2,0
6204,5,3,21603,21603,21606,0,3,3
6205,1,2,21604,21606,21608,2,4,0
6206,3,2,21607,21608,21610,1,3,0
6207,3,1,21610,21610,21611,0,1,0
6208,3,3,21613,21613,21616,0,3,2
6209,2,3,21615,21616,21619,1,4,0
6210,1,3,21616,21619,21622,3,6,0
6211,6,2,21622,21622,21624,0,2,0
6212,3,3,21625,21625,21628,0,3,1
6213,1,3,21626,21628,21631,2,5,0
6214,2,3,21628,21631,21634,3,6,0
6215,5,2,21633,21634,21636,1,3,0
6216,4,1,21637,21637,21638,0,1,1
6217,6,1,21643,21643,21644,0,1,5
6218,4,2,21647,21647,21649,0,2,3
6219,1,3,21648,21649,21652,1,4,0
6220,1,1,21649,21652,21653,3,4,0
6221,2,2,21651,21653,21655,2,4,0
6222,2,2,21653,21655,21657,2,4,0
6223,3,2,21656,21657,21659,1,3,0
6224,4,2,21660,21660,21662,0,2,1
6225,4,2,21664,21664,21666,0,2,2
6226,2,3,21666,21666,21669,0,3,0
6227,5,3,21671,21671,21674,0,3,2
6228,1,3,21672,21674,21677,2,5,0
6229,1,1,21673,21677,21678,4,5,0
6230,1,2,21674,21678,21680,4,6,0
6231,2,2,21676,21680,21682,4,6,0
6232,4,1,21680,21682,21683,2,3,0
6233,5,1,21685,21685,21686,0,1,2
6234,2,3,21687,21687,21690,0,3,1
6235,3,1,21690,21690,21691,0,1,0
6236,2,1,21692,21692,21693,0,1,1
6237,6,1,21698,21698,21699,0,1,5
6238,2,2,21700,21700,21702,0,2,1
6239,2,2,21702,21702,21704,0,2,0
6240,6,2,21708,21708,21710,0,2,4
6241,1,3,21709,21710,21713,1,4,0
6242,3,2,21712,21713,21715,1,3,0
6243,1,2,21713,21715,21717,2,4,0
6244,6,1,21719,21719,21720,0,1,2
6245,6,2,21725,21725,21727,0,2,5
6246,5,3,21730,21730,21733,0,3,3
6247,1,2,21731,21733,21735,2,4,0
6248,1,1,21732,21735,21736,3,4,0
6249,3,1,21735,21736,21737,1,2,0
6250,2,1,21737,21737,21738,0,1,0
6251,6,2,21743,21743,21745,0,2,5
6252,2,2,21745,21745,21747,0,2,0
6253,2,3,21747,21747,21750,0,3,0
6254,1,2,21748,21750,21752,2,4,0
6255,6,2,21754,21754,21756,0,2,2
6256,5,3,21759,21759,21762,0,3,3
6257,6,2,21765,21765,21767,0,2,3
6258,3,1,21768,21768,21769,0,1,1
6259,6,1,21774,21774,21775,0,1,5
6260,2,1,21776,21776,21777,0,1,1
6261,5,2,21781,21781,21783,0,2,4
6262,2,2,21783,21783,21785,0,2,0
6263,6,2,21789,21789,21791,0,2,4
6264,1,3,21790,21791,21794,1,4,0
6265,6,2,21796,21796,21798,0,2,2
6266,4,3,21800,21800,21803,0,3,2
6267,3,2,21803,21803,21805,0,2,0
6268,2,2,21805,21805,21807,0,2,0
6269,2,3,21807,21807,21810,0,3,0
6270,3,2,21810,21810,21812,0,2,0
6271,3,3,21813,21813,21816,0,3,1
6272,4,1,21817,21817,21818,0,1,1
6273,5,1,21822,21822,21823,0,1,4
6274,5,3,21827,21827,21830,0,3,4
6275,6,1,21833,21833,21834,0,1,3
6276,3,3,21836,21836,21839,0,3,2
6277,5,3,21841,21841,21844,0,3,2
6278,5,1,21846,21846,21847,0,1,2
6279,6,2,21852,21852,21854,0,2,5
6280,2,2,21854,21854,21856,0,2,0
6281,6,1,21860,21860,21861,0,1,4
6282,5,2,21865,21865,21867,0,2,4
6283,2,2,21867,21867,21869,0,2,0
6284,3,1,21870,21870,21871,0,1,1
6285,1,2,21871,21871,21873,0,2,0
6286,1,3,21872,21873,21876,1,4,0
6287,4,2,21876,21876,21878,0,2,0
6288,2,3,21878,21878,21881,0,3,0
6289,4,1,21882,21882,21883,0,1,1
6290,2,2,21884,21884,21886,0,2,1
6291,2,1,21886,21886,21887,0,1,0
6292,5,2,21891,21891,21893,0,2,4
6293,4,1,21895,21895,21896,0,1,2
6294,4,1,21899,21899,21900,0,1,3
6295,3,2,21902,21902,21904,0,2,2
6296,3,2,21905,21905,21907,0,2,1
6297,5,1,21910,21910,21911,0,1,3
6298,5,1,21915,21915,21916,0,1,4
6299,2,1,21917,21917,21918,0,1,1
6300,5,1,21922,21922,21923,0,1,4
6301,1,1,21923,21923,21924,0,1,0
6302,3,3,21926,21926,21929,0,3,2
6303,2,2,21928,21929,21931,1,3,0
6304,5,2,21933,21933,21935,0,2,2
6305,1,1,21934,21935,21936,1,2,0
6306,6,2,21940,21940,21942,0,2,4
6307,5,1,21945,21945,21946,0,1,3
6308,2,1,21947,21947,21948,0,1,1
6309,5,2,21952,21952,21954,0,2,4
6310,3,3,21955,21955,21958,0,3,1
6311,3,2,21958,21958,21960,0,2,0
6312,6,2,21964,21964,21966,0,2,4
6313,1,1,21965,21966,21967,1,2,0
6314,2,3,21967,21967,21970,0,3,0
6315,1,1,21968,21970,21971,2,3,0
6316,1,2,21969,21971,21973,2,4,0
6317,2,1,21971,21973,21974,2,3,0
6318,4,2,21975,21975,21977,0,2,1
6319,3,3,21978,21978,21981,0,3,1
6320,2,1,21980,21981,21982,1,2,0
6321,6,3,21986,21986,21989,0,3,4
6322,4,1,21990,21990,21991,0,1,1
6323,2,3,21992,21992,21995,0,3,1
6324,6,1,21998,21998,21999,0,1,3
6325,4,3,22002,22002,22005,0,3,3
6326,3,3,22005,22005,22008,0,3,0
6327,2,2,22007,22008,22010,1,3,0
6328,4,2,22011,22011,22013,0,2,1
6329,4,2,22015,22015,22017,0,2,2
6330,5,3,22020,22020,22023,0,3,3
6331,4,2,22024,22024,22026,0,2,1
6332,4,2,22028,22028,22030,0,2,2
6333,3,3,22031,22031,22034,0,3,1
6334,4,3,22035,22035,22038,0,3,1
6335,4,3,22039,22039,22042,0,3,1
6336,6,3,22045,22045,22048,0,3,3
6337,5,3,22050,22050,22053,0,3,2
6338,3,1,22053,22053,22054,0,1,0
6339,6,1,22059,22059,22060,0,1,5
6340,2,2,22061,22061,22063,0,2,1
6341,2,1,22063,22063,22064,0,1,0
6342,3,2,22066,22066,22068,0,2,2
6343,3,2,22069,22069,22071,0,2,1
6344,1,2,22070,22071,22073,1,3,0
6345,4,3,22074,22074,22077,0,3,1
6346,1,1,22075,22077,22078,2,3,0
6347,5,1,22080,22080,22081,0,1,2
6348,2,1,22082,22082,22083,0,1,1
6349,3,1,22085,22085,22086,0,1,2
6350,1,2,22086,22086,22088,0,2,0
6351,3,1,22089,22089,22090,0,1,1
6352,3,2,22092,22092,22094,0,2,2
6353,1,1,22093,22094,22095,1,2,0
6354,6,2,22099,22099,22101,0,2,4
6355,1,1,22100,22101,22102,1,2,0
6356,3,3,22103,22103,22106,0,3,1
6357,4,2,22107,22107,22109,0,2,1
6358,3,1,22110,22110,22111,0,1,1
6359,2,2,22112,22112,22114,0,2,1
6360,5,3,22117,22117,22120,0,3,3
6361,2,1,22119,22120,22121,1,2,0
6362,3,3,22122,22122,22125,0,3,1
6363,4,2,22126,22126,22128,0,2,1
6364,6,2,22132,22132,22134,0,2,4
6365,6,3,22138,22138,22141,0,3,4
6366,4,1,22142,22142,22143,0,1,1
6367,4,3,22146,22146,22149,0,3,3
6368,3,2,22149,22149,22151,0,2,0
6369,2,2,22151,22151,22153,0,2,0
6370,4,3,22155,22155,22158,0,3,2
6371,3,2,22158,22158,22160,0,2,0
6372,2,1,22160,22160,22161,0,1,0
6373,5,2,22165,22165,22167,0,2,4
6374,1,2,22166,22167,22169,1,3,0
6375,1,2,22167,22169,22171,2,4,0
6376,4,2,22171,22171,22173,0,2,0
6377,3,3,22174,22174,22177,0,3,1
6378,6,3,22180,22180,22183,0,3,3
6379,1,2,22181,22183,22185,2,4,0
6380,4,3,22185,22185,22188,0,3,0
6381,1,2,22186,22188,22190,2,4,0
6382,3,2,22189,22190,22192,1,3,0
6383,4,3,22193,22193,22196,0,3,1
6384,3,1,22196,22196,22197,0,1,0
6385,6,1,22202,22202,22203,0,1,5
6386,2,2,22204,22204,22206,0,2,1
6387,1,1,22205,22206,22207,1,2,0
6388,4,3,22209,22209,22212,0,3,2
6389,6,1,22215,22215,22216,0,1,3
6390,2,2,22217,22217,22219,0,2,1
6391,4,3,22221,22221,22224,0,3,2
6392,4,3,22225,22225,22228,0,3,1
6393,5,2,22230,22230,22232,0,2,2
6394,5,2,22235,22235,22237,0,2,3
6395,4,2,22239,22239,22241,0,2,2
6396,5,3,22244,22244,22247,0,3,3
6397,3,3,22247,22247,22250,0,3,0
6398,2,2,22249,22250,22252,1,3,0
6399,1,1,22250,22252,22253,2,3,0
6400,3,3,22253,22253,22256,0,3,0
6401,2,3,22255,22256,22259,1,4,0
6402,3,2,22258,22259,22261,1,3,0
6403,5,1,22263,22263,22264,0,1,2
6404,3,2,22266,22266,22268,0,2,2
6405,4,2,22270,22270,22272,0,2,2
6406,4,2,22274,22274,22276,0,2,2
6407,5,3,22279,22279,22282,0,3,3
6408,6,3,22285,22285,22288,0,3,3
6409,3,2,22288,22288,22290,0,2,0
6410,4,2,22292,22292,22294,0,2,2
6411,2,3,22294,22294,22297,0,3,0
6412,6,2,22300,22300,22302,0,2,3
6413,2,1,22302,22302,22303,0,1,0
6414,6,1,22308,22308,22309,0,1,5
6415,5,3,22313,22313,22316,0,3,4
6416,1,1,22314,22316,22317,2,3,0
6417,1,1,22315,22317,22318,2,3,0
6418,4,1,22319,22319,22320,0,1,1
6419,5,1,22324,22324,22325,0,1,4
6420,2,2,22326,22326,22328,0,2,1
6421,6,3,22332,22332,22335,0,3,4
6422,5,1,22337,22337,22338,0,1,2
6423,1,2,22338,22338,22340,0,2,0
6424,4,3,22342,22342,22345,0,3,2
6425,4,2,22346,22346,22348,0,2,1
6426,2,1,22348,22348,22349,0,1,0
6427,4,1,22352,22352,22353,0,1,3
6428,5,2,22357,22357,22359,0,2,4
6429,6,3,22363,22363,22366,0,3,4
6430,5,1,22368,22368,22369,0,1,2
6431,3,3,22371,22371,22374,0,3,2
6432,6,1,22377,22377,22378,0,1,3
6433,3,3,22380,22380,22383,0,3,2
6434,4,3,22384,22384,22387,0,3,1
6435,4,2,22388,22388,22390,0,2,1
6436,1,3,22389,22390,22393,1,4,0
6437,2,3,22391,22393,22396,2,5,0
6438,5,2,22396,22396,22398,0,2,0
6439,2,2,22398,22398,22400,0,2,0
6440,6,2,22404,22404,22406,0,2,4
6441,6,1,22410,22410,22411,0,1,4
6442,5,2,22415,22415,22417,0,2,4
6443,2,3,22417,22417,22420,0,3,0
6444,6,1,22423,22423,22424,0,1,3
6445,3,1,22426,22426,22427,0,1,2
6446,4,2,22430,22430,22432,0,2,3
6447,3,2,22433,22433,22435,0,2,1
6448,6,1,22439,22439,22440,0,1,4
6449,4,3,22443,22443,22446,0,3,3
6450,6,1,22449,22449,22450,0,1,3
6451,5,3,22454,22454,22457,0,3,4
6452,5,2,22459,22459,22461,0,2,2
6453,4,3,22463,22463,22466,0,3,2
6454,5,3,22468,22468,22471,0,3,2
6455,5,1,22473,22473,22474,0,1,2
6456,1,3,22474,22474,22477,0,3,0
6457,4,1,22478,22478,22479,0,1,1
6458,3,2,22481,22481,22483,0,2,2
6459,4,1,22485,22485,22486,0,1,2
6460,6,2,22491,22491,22493,0,2,5
6461,6,3,22497,22497,22500,0,3,4
6462,3,2,22500,22500,22502,0,2,0
6463,3,1,22503,22503,22504,0,1,1
6464,6,1,22509,22509,22510,0,1,5
6465,6,1,22515,22515,22516,0,1,5
6466,4,3,22519,22519,22522,0,3,3
6467,5,3,22524,22524,22527,0,3,2
6468,6,1,22530,22530,22531,0,1,3
6469,3,3,22533,22533,22536,0,3,2
6470,2,2,22535,22536,22538,1,3,0
6471,5,3,22540,22540,22543,0,3,2
6472,6,1,22546,22546,22547,0,1,3
6473,2,3,22548,22548,22551,0,3,1
6474,5,3,22553,22553,22556,0,3,2
6475,4,1,22557,22557,22558,0,1,1
6476,3,3,22560,22560,22563,0,3,2
6477,4,3,22564,22564,22567,0,3,1
6478,6,2,22570,22570,22572,0,2,3
6479,2,2,22572,22572,22574,0,2,0
6480,3,1,22575,22575,22576,0,1,1
6481,5,3,22580,22580,22583,0,3,4
6482,6,3,22586,22586,22589,0,3,3
6483,4,1,22590,22590,22591,0,1,1
6484,1,3,22591,22591,22594,0,3,0
6485,5,1,22596,22596,22597,0,1,2
6486,6,2,22602,22602,22604,0,2,5
6487,5,2,22607,22607,22609,0,2,3
6488,4,3,22611,22611,22614,0,3,2
6489,3,3,22614,22614,22617,0,3,0
6490,4,1,22618,22618,22619,0,1,1
6491,5,2,22623,22623,22625,0,2,4
6492,5,3,22628,22628,22631,0,3,3
6493,5,1,22633,22633,22634,0,1,2
6494,1,1,22634,22634,22635,0,1,0
6495,5,3,22639,22639,22642,0,3,4
6496,1,1,22640,22642,22643,2,3,0
6497,5,3,22645,22645,22648,0,3,2
6498,1,2,22646,22648,22650,2,4,0
6499,2,2,22648,22650,22652,2,4,0
6500,5,1,22653,22653,22654,0,1,1
6501,3,3,22656,22656,22659,0,3,2
6502,2,3,22658,22659,22662,1,4,0
6503,5,1,22663,22663,22664,0,1,1
6504,3,2,22666,22666,22668,0,2,2
6505,1,2,22667,22668,22670,1,3,0
6506,5,2,22672,22672,22674,0,2,2
6507,5,1,22677,22677,22678,0,1,3
6508,1,3,22678,22678,22681,0,3,0
6509,6,3,22684,22684,22687,0,3,3
6510,5,1,22689,22689,22690,0,1,2
6511,1,2,22690,22690,22692,0,2,0
6512,4,2,22694,22694,22696,0,2,2
6513,5,3,22699,22699,22702,0,3,3
6514,2,3,22701,22702,22705,1,4,0
6515,5,1,22706,22706,22707,0,1,1
6516,3,1,22709,22709,22710,0,1,2
6517,1,3,22710,22710,22713,0,3,0
6518,3,2,22713,22713,22715,0,2,0
6519,3,1,22716,22716,22717,0,1,1
6520,3,3,22719,22719,22722,0,3,2
6521,2,3,22721,22722,22725,1,4,0
6522,4,2,22725,22725,22727,0,2,0
6523,3,3,22728,22728,22731,0,3,1
6524,1,2,22729,22731,22733,2,4,0
6525,3,2,22732,22733,22735,1,3,0
6526,1,1,22733,22735,22736,2,3,0
6527,1,3,22734,22736,22739,2,5,0
6528,6,2,22740,22740,22742,0,2,1
6529,1,2,22741,22742,22744,1,3,0
6530,2,1,22743,22744,22745,1,2,0
6531,2,1,22745,22745,22746,0,1,0
6532,2,2,22747,22747,22749,0,2,1
6533,2,1,22749,22749,22750,0,1,0
6534,4,3,22753,22753,22756,0,3,3
6535,6,1,22759,22759,22760,0,1,3
6536,5,2,22764,22764,22766,0,2,4
6537,2,2,22766,22766,22768,0,2,0
6538,4,2,22770,22770,22772,0,2,2
6539,6,1,22776,22776,22777,0,1,4
6540,3,1,22779,22779,22780,0,1,2
6541,2,2,22781,22781,22783,0,2,1
6542,4,1,22785,22785,22786,0,1,2
6543,4,2,22789,22789,22791,0,2,3
6544,1,1,22790,22791,22792,1,2,0
6545,3,3,22793,22793,22796,0,3,1
6546,6,1,22799,22799,22800,0,1,3
6547,3,1,22802,22802,22803,0,1,2
6548,5,1,22807,22807,22808,0,1,4
6549,3,2,22810,22810,22812,0,2,2
6550,1,3,22811,22812,22815,1,4,0
6551,1,1,22812,22815,22816,3,4,0
6552,5,1,22817,22817,22818,0,1,1
6553,3,2,22820,22820,22822,0,2,2
6554,1,2,22821,22822,22824,1,3,0
6555,5,2,22826,22826,22828,0,2,2
6556,6,3,22832,22832,22835,0,3,4
6557,4,3,22836,22836,22839,0,3,1
6558,3,1,22839,22839,22840,0,1,0
6559,1,1,22840,22840,22841,0,1,0
6560,1,3,22841,22841,22844,0,3,0
6561,4,3,22845,22845,22848,0,3,1
6562,6,2,22851,22851,22853,0,2,3
6563,6,1,22857,22857,22858,0,1,4
6564,3,2,22860,22860,22862,0,2,2
6565,6,3,22866,22866,22869,0,3,4
6566,2,1,22868,22869,22870,1,2,0
6567,3,2,22871,22871,22873,0,2,1
6568,2,3,22873,22873,22876,0,3,0
6569,2,1,22875,22876,22877,1,2,0
6570,4,3,22879,22879,22882,0,3,2
6571,5,3,22884,22884,22887,0,3,2
6572,5,3,22889,22889,22892,0,3,2
6573,3,2,22892,22892,22894,0,2,0
6574,5,1,22897,22897,22898,0,1,3
6575,6,2,22903,22903,22905,0,2,5
6576,5,2,22908,22908,22910,0,2,3
6577,2,2,22910,22910,22912,0,2,0
6578,6,3,22916,22916,22919,0,3,4
6579,2,1,22918,22919,22920,1,2,0
6580,1,3,22919,22920,22923,1,4,0
6581,6,3,22925,22925,22928,0,3,2
6582,3,1,22928,22928,22929,0,1,0
6583,5,3,22933,22933,22936,0,3,4
6584,3,2,22936,22936,22938,0,2,0
6585,3,2,22939,22939,22941,0,2,1
6586,4,3,22943,22943,22946,0,3,2
6587,1,2,22944,22946,22948,2,4,0
6588,4,3,22948,22948,22951,0,3,0
6589,3,3,22951,22951,22954,0,3,0
6590,1,2,22952,22954,22956,2,4,0
6591,2,1,22954,22956,22957,2,3,0
6592,1,1,22955,22957,22958,2,3,0
6593,2,1,22957,22958,22959,1,2,0
6594,1,2,22958,22959,22961,1,3,0
6595,2,2,22960,22961,22963,1,3,0
6596,6,2,22966,22966,22968,0,2,3
6597,3,2,22969,22969,22971,0,2,1
6598,2,1,22971,22971,22972,0,1,0
6599,3,3,22974,22974,22977,0,3,2
6600,6,1,22980,22980,22981,0,1,3
6601,5,3,22985,22985,22988,0,3,4
6602,5,2,22990,22990,22992,0,2,2
6603,2,2,22992,22992,22994,0,2,0
6604,2,2,22994,22994,22996,0,2,0
6605,2,2,22996,22996,22998,0,2,0
6606,6,3,23002,23002,23005,0,3,4
6607,5,1,23007,23007,23008,0,1,2
6608,1,1,23008,23008,23009,0,1,0
6609,5,2,23013,23013,23015,0,2,4
6610,3,1,23016,23016,23017,0,1,1
6611,5,3,23021,23021,23024,0,3,4
6612,4,1,23025,23025,23026,0,1,1
6613,3,2,23028,23028,23030,0,2,2
6614,6,1,23034,23034,23035,0,1,4
6615,5,2,23039,23039,23041,0,2,4
6616,1,3,23040,23041,23044,1,4,0
6617,5,1,23045,23045,23046,0,1,1
6618,2,2,23047,23047,23049,0,2,1
6619,6,1,23053,23053,23054,0,1,4
6620,4,3,23057,23057,23060,0,3,3
6621,2,1,23059,23060,23061,1,2,0
6622,3,1,23062,23062,23063,0,1,1
6623,2,3,23064,23064,23067,0,3,1
6624,6,1,23070,23070,23071,0,1,3
6625,4,3,23074,23074,23077,0,3,3
6626,2,3,23076,23077,23080,1,4,0
6627,5,1,23081,23081,23082,0,1,1
6628,4,2,23085,23085,23087,0,2,3
6629,3,2,23088,23088,23090,0,2,1
6630,3,1,23091,23091,23092,0,1,1
6631,4,1,23095,23095,23096,0,1,3
6632,2,2,23097,23097,23099,0,2,1
6633,2,3,23099,23099,23102,0,3,0
6634,2,1,23101,23102,23103,1,2,0
6635,1,1,23102,23103,23104,1,2,0
6636,2,1,23104,23104,23105,0,1,0
6637,6,1,23110,23110,23111,0,1,5
6638,1,3,23111,23111,23114,0,3,0
6639,4,1,23115,23115,23116,0,1,1
6640,1,3,23116,23116,23119,0,3,0
6641,6,3,23122,23122,23125,0,3,3
6642,6,3,23128,23128,23131,0,3,3
6643,6,3,23134,23134,23137,0,3,3
6644,1,2,23135,23137,23139,2,4,0
6645,2,3,23137,23139,23142,2,5,0
6646,6,2,23143,23143,23145,0,2,1
6647,4,2,23147,23147,23149,0,2,2
6648,4,3,23151,23151,23154,0,3,2
6649,6,2,23157,23157,23159,0,2,3
6650,5,1,23162,23162,23163,0,1,3
6651,5,3,23167,23167,23170,0,3,4
6652,1,1,23168,23170,23171,2,3,0
6653,6,1,23174,23174,23175,0,1,3
6654,1,3,23175,23175,23178,0,3,0
6655,5,2,23180,23180,23182,0,2,2
6656,2,2,23182,23182,23184,0,2,0
6657,5,3,23187,23187,23190,0,3,3
6658,2,1,23189,23190,23191,1,2,0
6659,3,2,23192,23192,23194,0,2,1
6660,2,3,23194,23194,23197,0,3,0
6661,5,1,23199,23199,23200,0,1,2
6662,4,3,23203,23203,23206,0,3,3
6663,5,1,23208,23208,23209,0,1,2
6664,6,1,23214,23214,23215,0,1,5
6665,3,1,23217,23217,23218,0,1,2
6666,6,3,23223,23223,23226,0,3,5
6667,3,3,23226,23226,23229,0,3,0
6668,1,3,23227,23229,23232,2,5,0
6669,2,2,23229,23232,23234,3,5,0
6670,6,3,23235,23235,23238,0,3,1
6671,2,2,23237,23238,23240,1,3,0
6672,2,1,23239,23240,23241,1,2,0
6673,5,1,23244,23244,23245,0,1,3
6674,3,2,23247,23247,23249,0,2,2
6675,1,1,23248,23249,23250,1,2,0
6676,2,3,23250,23250,23253,0,3,0
6677,6,2,23256,23256,23258,0,2,3
6678,5,2,23261,23261,23263,0,2,3
6679,3,1,23264,23264,23265,0,1,1
6680,2,2,23266,23266,23268,0,2,1
6681,5,1,23271,23271,23272,0,1,3
6682,4,2,23275,23275,23277,0,2,3
6683,6,1,23281,23281,23282,0,1,4
6684,5,1,23286,23286,23287,0,1,4
6685,2,3,23288,23288,23291,0,3,1
6686,5,3,23293,23293,23296,0,3,2
6687,6,2,23299,23299,23301,0,2,3
6688,2,1,23301,23301,23302,0,1,0
6689,1,2,23302,23302,23304,0,2,0
6690,3,1,23305,23305,23306,0,1,1
6691,6,2,23311,23311,23313,0,2,5
6692,6,2,23317,23317,23319,0,2,4
6693,3,2,23320,23320,23322,0,2,1
6694,5,1,23325,23325,23326,0,1,3
6695,4,3,23329,23329,23332,0,3,3
6696,5,2,23334,23334,23336,0,2,2
6697,3,3,23337,23337,23340,0,3,1
6698,4,1,23341,23341,23342,0,1,1
6699,3,1,23344,23344,23345,0,1,2
6700,1,3,23345,23345,23348,0,3,0
6701,3,3,23348,23348,23351,0,3,0
6702,4,2,23352,23352,23354,0,2,1
6703,4,1,23356,23356,23357,0,1,2
6704,6,2,23362,23362,23364,0,2,5
6705,6,1,23368,23368,23369,0,1,4
6706,4,2,23372,23372,23374,0,2,3
6707,2,1,23374,23374,23375,0,1,0
6708,3,3,23377,23377,23380,0,3,2
6709,1,3,23378,23380,23383,2,5,0
6710,2,3,23380,23383,23386,3,6,0
6711,2,3,23382,23386,23389,4,7,0
6712,6,1,23388,23389,23390,1,2,0
6713,2,1,23390,23390,23391,0,1,0
6714,3,2,23393,23393,23395,0,2,2
6715,4,1,23397,23397,23398,0,1,2
6716,4,1,23401,23401,23402,0,1,3
6717,5,2,23406,23406,23408,0,2,4
6718,2,3,23408,23408,23411,0,3,0
6719,4,2,23412,23412,23414,0,2,1
6720,4,3,23416,23416,23419,0,3,2
6721,6,3,23422,23422,23425,0,3,3
6722,5,1,23427,23427,23428,0,1,2
6723,1,1,23428,23428,23429,0,1,0
6724,2,1,23430,23430,23431,0,1,1
6725,4,3,23434,23434,23437,0,3,3
6726,1,3,23435,23437,23440,2,5,0
6727,1,3,23436,23440,23443,4,7,0
6728,3,2,23439,23443,23445,4,6,0
6729,6,3,23445,23445,23448,0,3,0
6730,5,2,23450,23450,23452,0,2,2
6731,6,2,23456,23456,23458,0,2,4
6732,2,3,23458,23458,23461,0,3,0
6733,5,3,23463,23463,23466,0,3,2
6734,4,1,23467,23467,23468,0,1,1
6735,3,2,23470,23470,23472,0,2,2
6736,4,1,23474,23474,23475,0,1,2
6737,6,2,23480,23480,23482,0,2,5
6738,6,3,23486,23486,23489,0,3,4
6739,6,1,23492,23492,23493,0,1,3
6740,1,3,23493,23493,23496,0,3,0
6741,3,1,23496,23496,23497,0,1,0
6742,2,1,23498,23498,23499,0,1,1
6743,3,1,23501,23501,23502,0,1,2
6744,5,2,23506,23506,23508,0,2,4
6745,3,2,23509,23509,23511,0,2,1
6746,3,2,23512,23512,23514,0,2,1
6747,4,3,23516,23516,23519,0,3,2
6748,4,2,23520,23520,23522,0,2,1
6749,5,1,23525,23525,23526,0,1,3
6750,1,2,23526,23526,23528,0,2,0
6751,4,3,23530,23530,23533,0,3,2
6752,4,1,23534,23534,23535,0,1,1
6753,1,2,23535,23535,23537,0,2,0
6754,6,2,23541,23541,23543,0,2,4
6755,1,2,23542,23543,23545,1,3,0
6756,3,2,23545,23545,23547,0,2,0
6757,6,3,23551,23551,23554,0,3,4
6758,1,1,23552,23554,23555,2,3,0
6759,6,2,23558,23558,23560,0,2,3
6760,1,3,23559,23560,23563,1,4,0
6761,2,2,23561,23563,23565,2,4,0
6762,4,1,23565,23565,23566,0,1,0
6763,3,1,23568,23568,23569,0,1,2
6764,2,3,23570,23570,23573,0,3,1
6765,1,1,23571,23573,23574,2,3,0
6766,5,3,23576,23576,23579,0,3,2
6767,2,3,23578,23579,23582,1,4,0
6768,3,1,23581,23582,23583,1,2,0
6769,6,3,23587,23587,23590,0,3,4
6770,2,1,23589,23590,23591,1,2,0
6771,5,1,23594,23594,23595,0,1,3
6772,5,1,23599,23599,23600,0,1,4
6773,1,2,23600,23600,23602,0,2,0
6774,5,2,23605,23605,23607,0,2,3
6775,6,1,23611,23611,23612,0,1,4
6776,5,2,23616,23616,23618,0,2,4
6777,2,3,23618,23618,23621,0,3,0
6778,1,3,23619,23621,23624,2,5,0
6779,2,1,23621,23624,23625,3,4,0
6780,3,1,23624,23625,23626,1,2,0
6781,1,2,23625,23626,23628,1,3,0
6782,4,3,23629,23629,23632,0,3,1
6783,6,3,23635,23635,23638,0,3,3
6784,5,3,23640,23640,23643,0,3,2
6785,3,3,23643,23643,23646,0,3,0
6786,4,2,23647,23647,23649,0,2,1
6787,2,3,23649,23649,23652,0,3,0
6788,5,3,23654,23654,23657,0,3,2
6789,5,2,23659,23659,23661,0,2,2
6790,4,2,23663,23663,23665,0,2,2
6791,6,2,23669,23669,23671,0,2,4
6792,1,2,23670,23671,23673,1,3,0
6793,6,3,23676,23676,23679,0,3,3
6794,1,2,23677,23679,23681,2,4,0
6795,3,2,23680,23681,23683,1,3,0
6796,6,3,23686,23686,23689,0,3,3
6797,2,3,23688,23689,23692,1,4,0
6798,1,3,23689,23692,23695,3,6,0
6799,4,3,23693,23695,23698,2,5,0
6800,1,2,23694,23698,23700,4,6,0
6801,3,1,23697,23700,23701,3,4,0
6802,2,3,23699,23701,23704,2,5,0
6803,2,1,23701,23704,23705,3,4,0
6804,4,2,23705,23705,23707,0,2,0
6805,6,1,23711,23711,23712,0,1,4
6806,4,2,23715,23715,23717,0,2,3
6807,1,1,23716,23717,23718,1,2,0
6808,6,1,23722,23722,23723,0,1,4
6809,6,3,23728,23728,23731,0,3,5
6810,5,2,23733,23733,23735,0,2,2
6811,1,1,23734,23735,23736,1,2,0
6812,6,2,23740,23740,23742,0,2,4
6813,1,2,23741,23742,23744,1,3,0
6814,1,3,23742,23744,23747,2,5,0
6815,2,2,23744,23747,23749,3,5,0
6816,1,2,23745,23749,23751,4,6,0
6817,2,1,23747,23751,23752,4,5,0
6818,6,2,23753,23753,23755,0,2,1
6819,4,3,23757,23757,23760,0,3,2
6820,2,2,23759,23760,23762,1,3,0
6821,5,3,23764,23764,23767,0,3,2
6822,3,3,23767,23767,23770,0,3,0
6823,4,1,23771,23771,23772,0,1,1
6824,5,2,23776,23776,23778,0,2,4
6825,3,1,23779,23779,23780,0,1,1
6826,3,3,23782,23782,23785,0,3,2
6827,5,1,23787,23787,23788,0,1,2
6828,3,1,23790,23790,23791,0,1,2
6829,2,3,23792,23792,23795,0,3,1
6830,5,3,23797,23797,23800,0,3,2
6831,4,3,23801,23801,23804,0,3,1
6832,5,2,23806,23806,23808,0,2,2
6833,1,1,23807,23808,23809,1,2,0
6834,5,3,23812,23812,23815,0,3,3
6835,3,3,23815,23815,23818,0,3,0
6836,2,2,23817,23818,23820,1,3,0
6837,6,1,23823,23823,23824,0,1,3
6838,1,1,23824,23824,23825,0,1,0
6839,6,3,23830,23830,23833,0,3,5
6840,3,3,23833,23833,23836,0,3,0
6841,4,2,23837,23837,23839,0,2,1
6842,3,1,23840,23840,23841,0,1,1
6843,5,2,23845,23845,23847,0,2,4
6844,6,1,23851,23851,23852,0,1,4
6845,4,2,23855,23855,23857,0,2,3
6846,3,2,23858,23858,23860,0,2,1
6847,4,1,23862,23862,23863,0,1,2
6848,6,3,23868,23868,23871,0,3,5
6849,5,1,23873,23873,23874,0,1,2
6850,1,3,23874,23874,23877,0,3,0
6851,5,3,23879,23879,23882,0,3,2
6852,2,3,23881,23882,23885,1,4,0
6853,1,2,23882,23885,23887,3,5,0
6854,6,2,23888,23888,23890,0,2,1
6855,6,3,23894,23894,23897,0,3,4
6856,3,3,23897,23897,23900,0,3,0
6857,1,2,23898,23900,23902,2,4,0
6858,6,1,23904,23904,23905,0,1,2
6859,2,1,23906,23906,23907,0,1,1
6860,1,1,23907,23907,23908,0,1,0
6861,3,3,23910,23910,23913,0,3,2
6862,2,3,23912,23913,23916,1,4,0
6863,4,2,23916,23916,23918,0,2,0
6864,3,2,23919,23919,23921,0,2,1
6865,6,3,23925,23925,23928,0,3,4
6866,1,2,23926,23928,23930,2,4,0
6867,3,2,23929,23930,23932,1,3,0
6868,5,1,23934,23934,23935,0,1,2
6869,5,2,23939,23939,23941,0,2,4
6870,4,2,23943,23943,23945,0,2,2
6871,6,3,23949,23949,23952,0,3,4
6872,6,3,23955,23955,23958,0,3,3
6873,1,2,23956,23958,23960,2,4,0
6874,4,3,23960,23960,23963,0,3,0
6875,3,3,23963,23963,23966,0,3,0
6876,5,1,23968,23968,23969,0,1,2
6877,5,1,23973,23973,23974,0,1,4
6878,6,1,23979,23979,23980,0,1,5
6879,3,1,23982,23982,23983,0,1,2
6880,3,3,23985,23985,23988,0,3,2
6881,2,3,23987,23988,23991,1,4,0
6882,2,3,23989,23991,23994,2,5,0
6883,1,2,23990,23994,23996,4,6,0
6884,2,2,23992,23996,23998,4,6,0
6885,6,3,23998,23998,24001,0,3,0
6886,3,1,24001,24001,24002,0,1,0
6887,4,3,24005,24005,24008,0,3,3
6888,3,3,24008,24008,24011,0,3,0
6889,4,3,24012,24012,24015,0,3,1
6890,3,1,24015,24015,24016,0,1,0
6891,4,1,24019,24019,24020,0,1,3
6892,2,2,24021,24021,24023,0,2,1
6893,3,3,24024,24024,24027,0,3,1
6894,3,1,24027,24027,24028,0,1,0
6895,5,3,24032,24032,24035,0,3,4
6896,5,1,24037,24037,24038,0,1,2
6897,1,1,24038,24038,24039,0,1,0
6898,3,1,24041,24041,24042,0,1,2
6899,5,2,24046,24046,24048,0,2,4
6900,5,1,24051,24051,24052,0,1,3
6901,6,3,24057,24057,24060,0,3,5
6902,4,2,24061,24061,24063,0,2,1
6903,2,2,24063,24063,24065,0,2,0
6904,3,3,24066,24066,24069,0,3,1
6905,6,1,24072,24072,24073,0,1,3
6906,3,1,24075,24075,24076,0,1,2
6907,2,1,24077,24077,24078,0,1,1
6908,2,3,24079,24079,24082,0,3,1
6909,1,3,24080,24082,24085,2,5,0
6910,4,2,24084,24085,24087,1,3,0
6911,1,3,24085,24087,24090,2,5,0
6912,2,1,24087,24090,24091,3,4,0
6913,1,1,24088,24091,24092,3,4,0
6914,3,3,24091,24092,24095,1,4,0
6915,6,3,24097,24097,24100,0,3,2
6916,6,1,24103,24103,24104,0,1,3
6917,5,2,24108,24108,24110,0,2,4
6918,2,1,24110,24110,24111,0,1,0
6919,5,3,24115,24115,24118,0,3,4
6920,6,3,24121,24121,24124,0,3,3
6921,2,2,24123,24124,24126,1,3,0
6922,1,1,24124,24126,24127,2,3,0
6923,3,2,24127,24127,24129,0,2,0
6924,6,2,24133,24133,24135,0,2,4
6925,1,3,24134,24135,24138,1,4,0
6926,1,2,24135,24138,24140,3,5,0
6927,1,3,24136,24140,24143,4,7,0
6928,2,2,24138,24143,24145,5,7,0
6929,2,3,24140,24145,24148,5,8,0
6930,1,3,24141,24148,24151,7,10,0
6931,6,3,24147,24151,24154,4,7,0
6932,6,3,24153,24154,24157,1,4,0
6933,5,1,24158,24158,24159,0,1,1
6934,2,3,24160,24160,24163,0,3,1
6935,2,2,24162,24163,24165,1,3,0
6936,5,1,24167,24167,24168,0,1,2
6937,3,1,24170,24170,24171,0,1,2
6938,4,2,24174,24174,24176,0,2,3
6939,2,1,24176,24176,24177,0,1,0
6940,3,2,24179,24179,24181,0,2,2
6941,2,1,24181,24181,24182,0,1,0
6942,6,3,24187,24187,24190,0,3,5
6943,5,3,24192,24192,24195,0,3,2
6944,3,1,24195,24195,24196,0,1,0
6945,5,3,24200,24200,24203,0,3,4
6946,4,3,24204,24204,24207,0,3,1
6947,4,2,24208,24208,24210,0,2,1
6948,6,1,24214,24214,24215,0,1,4
6949,1,3,24215,24215,24218,0,3,0
6950,3,3,24218,24218,24221,0,3,0
6951,5,2,24223,24223,24225,0,2,2
6952,3,3,24226,24226,24229,0,3,1
6953,5,2,24231,24231,24233,0,2,2
6954,1,1,24232,24233,24234,1,2,0
6955,6,3,24238,24238,24241,0,3,4
6956,1,1,24239,24241,24242,2,3,0
6957,6,2,24245,24245,24247,0,2,3
6958,6,1,24251,24251,24252,0,1,4
6959,2,3,24253,24253,24256,0,3,1
6960,6,1,24259,24259,24260,0,1,3
6961,6,2,24265,24265,24267,0,2,5
6962,1,3,24266,24267,24270,1,4,0
6963,4,2,24270,24270,24272,0,2,0
6964,2,3,24272,24272,24275,0,3,0
6965,6,2,24278,24278,24280,0,2,3
6966,3,2,24281,24281,24283,0,2,1
6967,4,2,24285,24285,24287,0,2,2
6968,5,2,24290,24290,24292,0,2,3
6969,2,1,24292,24292,24293,0,1,0
6970,1,2,24293,24293,24295,0,2,0
6971,5,3,24298,24298,24301,0,3,3
6972,5,3,24303,24303,24306,0,3,2
6973,6,3,24309,24309,24312,0,3,3
6974,6,2,24315,24315,24317,0,2,3
6975,5,2,24320,24320,24322,0,2,3
6976,3,3,24323,24323,24326,0,3,1
6977,2,3,24325,24326,24329,1,4,0
6978,4,1,24329,24329,24330,0,1,0
6979,3,3,24332,24332,24335,0,3,2
6980,3,1,24335,24335,24336,0,1,0
6981,3,2,24338,24338,24340,0,2,2
6982,6,1,24344,24344,24345,0,1,4
6983,4,2,24348,24348,24350,0,2,3
6984,1,1,24349,24350,24351,1,2,0
6985,6,2,24355,24355,24357,0,2,4
6986,1,3,24356,24357,24360,1,4,0
6987,6,2,24362,24362,24364,0,2,2
6988,4,2,24366,24366,24368,0,2,2
6989,3,2,24369,24369,24371,0,2,1
6990,4,1,24373,24373,24374,0,1,2
6991,2,2,24375,24375,24377,0,2,1
6992,4,1,24379,24379,24380,0,1,2
6993,2,1,24381,24381,24382,0,1,1
6994,5,1,24386,24386,24387,0,1,4
6995,2,2,24388,24388,24390,0,2,1
6996,6,3,24394,24394,24397,0,3,4
6997,1,3,24395,24397,24400,2,5,0
6998,4,1,24399,24400,24401,1,2,0
6999,1,2,24400,24401,24403,1,3,0
7000,3,3,24403,24403,24406,0,3,0
7001,4,1,24407,24407,24408,0,1,1
7002,2,1,24409,24409,24410,0,1,1
7003,3,3,24412,24412,24415,0,3,2
7004,6,2,24418,24418,24420,0,2,3
7005,1,2,24419,24420,24422,1,3,0
7006,1,2,24420,24422,24424,2,4,0
7007,1,2,24421,24424,24426,3,5,0
7008,4,1,24425,24426,24427,1,2,0
7009,5,1,24430,24430,24431,0,1,3
7010,2,3,24432,24432,24435,0,3,1
7011,2,2,24434,24435,24437,1,3,0
7012,3,2,24437,24437,24439,0,2,0
7013,2,2,24439,24439,24441,0,2,0
7014,3,3,24442,24442,24445,0,3,1
7015,5,2,24447,24447,24449,0,2,2
7016,6,1,24453,24453,24454,0,1,4
7017,6,3,24459,24459,24462,0,3,5
7018,5,3,24464,24464,24467,0,3,2
7019,6,1,24470,24470,24471,0,1,3
7020,1,1,24471,24471,24472,0,1,0
7021,3,2,24474,24474,24476,0,2,2
7022,2,1,24476,24476,24477,0,1,0
7023,1,3,24477,24477,24480,0,3,0
7024,2,3,24479,24480,24483,1,4,0
7025,4,3,24483,24483,24486,0,3,0
7026,3,1,24486,24486,24487,0,1,0
7027,1,1,24487,24487,24488,0,1,0
7028,4,1,24491,24491,24492,0,1,3
7029,3,2,24494,24494,24496,0,2,2
7030,2,2,24496,24496,24498,0,2,0
7031,2,3,24498,24498,24501,0,3,0
7032,5,2,24503,24503,24505,0,2,2
7033,1,3,24504,24505,24508,1,4,0
7034,3,1,24507,24508,24509,1,2,0
7035,2,2,24509,24509,24511,0,2,0
7036,1,2,24510,24511,24513,1,3,0
7037,3,2,24513,24513,24515,0,2,0
7038,3,2,24516,24516,24518,0,2,1
7039,1,2,24517,24518,24520,1,3,0
7040,5,3,24522,24522,24525,0,3,2
7041,3,1,24525,24525,24526,0,1,0
7042,3,3,24528,24528,24531,0,3,2
7043,3,1,24531,24531,24532,0,1,0
7044,5,2,24536,24536,24538,0,2,4
7045,2,1,24538,24538,24539,0,1,0
7046,1,2,24539,24539,24541,0,2,0
7047,6,2,24545,24545,24547,0,2,4
7048,3,3,24548,24548,24551,0,3,1
7049,4,1,24552,24552,24553,0,1,1
7050,6,1,24558,24558,24559,0,1,5
7051,5,3,24563,24563,24566,0,3,4
7052,4,3,24567,24567,24570,0,3,1
7053,1,1,24568,24570,24571,2,3,0
7054,6,2,24574,24574,24576,0,2,3
7055,4,3,24578,24578,24581,0,3,2
7056,2,2,24580,24581,24583,1,3,0
7057,4,2,24584,24584,24586,0,2,1
7058,1,2,24585,24586,24588,1,3,0
7059,2,3,24587,24588,24591,1,4,0
7060,1,1,24588,24591,24592,3,4,0
7061,2,2,24590,24592,24594,2,4,0
7062,3,1,24593,24594,24595,1,2,0
7063,6,3,24599,24599,24602,0,3,4
7064,6,2,24605,24605,24607,0,2,3
7065,3,1,24608,24608,24609,0,1,1
7066,3,3,24611,24611,24614,0,3,2
7067,6,2,24617,24617,24619,0,2,3
7068,6,2,24623,24623,24625,0,2,4
7069,5,3,24628,24628,24631,0,3,3
7070,5,2,24633,24633,24635,0,2,2
7071,6,2,24639,24639,24641,0,2,4
7072,1,1,24640,24641,24642,1,2,0
7073,5,2,24645,24645,24647,0,2,3
7074,5,2,24650,24650,24652,0,2,3
7075,5,2,24655,24655,24657,0,2,3
7076,4,2,24659,24659,24661,0,2,2
7077,3,3,24662,24662,24665,0,3,1
7078,3,1,24665,24665,24666,0,1,0
7079,1,3,24666,24666,24669,0,3,0
7080,3,1,24669,24669,24670,0,1,0
7081,4,1,24673,24673,24674,0,1,3
7082,2,3,24675,24675,24678,0,3,1
7083,2,3,24677,24678,24681,1,4,0
7084,4,1,24681,24681,24682,0,1,0
7085,4,3,24685,24685,24688,0,3,3
7086,5,1,24690,24690,24691,0,1,2
7087,3,3,24693,24693,24696,0,3,2
7088,6,1,24699,24699,24700,0,1,3
7089,4,3,24703,24703,24706,0,3,3
7090,3,2,24706,24706,24708,0,2,0
7091,5,1,24711,24711,24712,0,1,3
7092,1,3,24712,24712,24715,0,3,0
7093,6,1,24718,24718,24719,0,1,3
7094,4,1,24722,24722,24723,0,1,3
7095,5,3,24727,24727,24730,0,3,4
7096,1,1,24728,24730,24731,2,3,0
7097,4,2,24732,24732,24734,0,2,1
7098,2,1,24734,24734,24735,0,1,0
7099,4,2,24738,24738,24740,0,2,3
7100,4,3,24742,24742,24745,0,3,2
7101,3,2,24745,24745,24747,0,2,0
7102,2,3,24747,24747,24750,0,3,0
7103,1,3,24748,24750,24753,2,5,0
7104,4,2,24752,24753,24755,1,3,0
7105,2,3,24754,24755,24758,1,4,0
7106,1,1,24755,24758,24759,3,4,0
7107,2,2,24757,24759,24761,2,4,0
7108,4,3,24761,24761,24764,0,3,0
7109,5,3,24766,24766,24769,0,3,2
7110,2,2,24768,24769,24771,1,3,0
7111,5,3,24773,24773,24776,0,3,2
7112,3,2,24776,24776,24778,0,2,0
7113,1,1,24777,24778,24779,1,2,0
7114,4,1,24781,24781,24782,0,1,2
7115,3,2,24784,24784,24786,0,2,2
7116,5,2,24789,24789,24791,0,2,3
7117,6,2,24795,24795,24797,0,2,4
7118,2,3,24797,24797,24800,0,3,0
7119,4,3,24801,24801,24804,0,3,1
7120,5,1,24806,24806,24807,0,1,2
7121,2,2,24808,24808,24810,0,2,1
7122,5,3,24813,24813,24816,0,3,3
7123,4,1,24817,24817,24818,0,1,1
7124,1,2,24818,24818,24820,0,2,0
7125,1,1,24819,24820,24821,1,2,0
7126,6,2,24825,24825,24827,0,2,4
7127,6,3,24831,24831,24834,0,3,4
7128,3,3,24834,24834,24837,0,3,0
7129,6,3,24840,24840,24843,0,3,3
7130,1,2,24841,24843,24845,2,4,0
7131,6,1,24847,24847,24848,0,1,2
7132,5,2,24852,24852,24854,0,2,4
7133,3,1,24855,24855,24856,0,1,1
7134,5,3,24860,24860,24863,0,3,4
7135,2,3,24862,24863,24866,1,4,0
7136,6,1,24868,24868,24869,0,1,2
7137,2,3,24870,24870,24873,0,3,1
7138,4,3,24874,24874,24877,0,3,1
7139,1,3,24875,24877,24880,2,5,0
7140,1,3,24876,24880,24883,4,7,0
7141,5,3,24881,24883,24886,2,5,0
7142,1,2,24882,24886,24888,4,6,0
7143,5,2,24887,24888,24890,1,3,0
7144,4,2,24891,24891,24893,0,2,1
7145,2,2,24893,24893,24895,0,2,0
7146,3,1,24896,24896,24897,0,1,1
7147,3,3,24899,24899,24902,0,3,2
7148,2,2,24901,24902,24904,1,3,0
7149,3,3,24904,24904,24907,0,3,0
7150,5,3,24909,24909,24912,0,3,2
7151,2,2,24911,24912,24914,1,3,0
7152,5,2,24916,24916,24918,0,2,2
7153,3,3,24919,24919,24922,0,3,1
7154,5,1,24924,24924,24925,0,1,2
7155,3,2,24927,24927,24929,0,2,2
7156,2,3,24929,24929,24932,0,3,0
7157,6,3,24935,24935,24938,0,3,3
7158,1,1,24936,24938,24939,2,3,0
7159,2,3,24938,24939,24942,1,4,0
7160,4,3,24942,24942,24945,0,3,0
7161,3,3,24945,24945,24948,0,3,0
7162,6,2,24951,24951,24953,0,2,3
7163,5,2,24956,24956,24958,0,2,3
7164,1,3,24957,24958,24961,1,4,0
7165,5,2,24962,24962,24964,0,2,1
7166,6,3,24968,24968,24971,0,3,4
7167,1,3,24969,24971,24974,2,5,0
7168,1,2,24970,24974,24976,4,6,0
7169,1,2,24971,24976,24978,5,7,0
7170,4,2,24975,24978,24980,3,5,0
7171,3,2,24978,24980,24982,2,4,0
7172,2,3,24980,24982,24985,2,5,0
7173,2,1,24982,24985,24986,3,4,0
7174,4,3,24986,24986,24989,0,3,0
7175,6,1,24992,24992,24993,0,1,3
7176,6,2,24998,24998,25000,0,2,5
7177,6,1,25004,25004,25005,0,1,4
7178,4,2,25008,25008,25010,0,2,3
7179,3,1,25011,25011,25012,0,1,1
7180,6,2,25017,25017,25019,0,2,5
7181,2,2,25019,25019,25021,0,2,0
7182,6,1,25025,25025,25026,0,1,4
7183,6,3,25031,25031,25034,0,3,5
7184,6,2,25037,25037,25039,0,2,3
7185,3,1,25040,25040,25041,0,1,1
7186,3,2,25043,25043,25045,0,2,2
7187,4,2,25047,25047,25049,0,2,2
7188,4,3,25051,25051,25054,0,3,2
7189,6,1,25057,25057,25058,0,1,3
7190,3,2,25060,25060,25062,0,2,2
7191,6,3,25066,25066,25069,0,3,4
7192,4,1,25070,25070,25071,0,1,1
7193,2,1,25072,25072,25073,0,1,1
7194,1,3,25073,25073,25076,0,3,0
7195,1,2,25074,25076,25078,2,4,0
7196,2,3,25076,25078,25081,2,5,0
7197,6,2,25082,25082,25084,0,2,1
7198,4,3,25086,25086,25089,0,3,2
7199,5,2,25091,25091,25093,0,2,2
7200,4,3,25095,25095,25098,0,3,2
7201,4,1,25099,25099,25100,0,1,1
7202,2,3,25101,25101,25104,0,3,1
7203,2,2,25103,25104,25106,1,3,0
7204,2,1,25105,25106,25107,1,2,0
7205,4,2,25109,25109,25111,0,2,2
7206,1,1,25110,25111,25112,1,2,0
7207,3,3,25113,25113,25116,0,3,1
7208,2,2,25115,25116,25118,1,3,0
7209,2,3,25117,25118,25121,1,4,0
7210,4,2,25121,25121,25123,0,2,0
7211,6,3,25127,25127,25130,0,3,4
7212,3,3,25130,25130,25133,0,3,0
7213,2,3,25132,25133,25136,1,4,0
7214,3,1,25135,25136,25137,1,2,0
7215,2,2,25137,25137,25139,0,2,0
7216,6,1,25143,25143,25144,0,1,4
7217,1,3,25144,25144,25147,0,3,0
7218,4,3,25148,25148,25151,0,3,1
7219,3,1,25151,25151,25152,0,1,0
7220,1,1,25152,25152,25153,0,1,0
7221,1,1,25153,25153,25154,0,1,0
7222,5,3,25158,25158,25161,0,3,4
7223,1,1,25159,25161,25162,2,3,0
7224,6,3,25165,25165,25168,0,3,3
7225,6,3,25171,25171,25174,0,3,3
7226,4,3,25175,25175,25178,0,3,1
7227,4,1,25179,25179,25180,0,1,1
7228,5,1,25184,25184,25185,0,1,4
7229,4,1,25188,25188,25189,0,1,3
7230,3,1,25191,25191,25192,0,1,2
7231,6,1,25197,25197,25198,0,1,5
7232,1,2,25198,25198,25200,0,2,0
7233,2,1,25200,25200,25201,0,1,0
7234,5,1,25205,25205,25206,0,1,4
7235,6,1,25211,25211,25212,0,1,5
7236,2,2,25213,25213,25215,0,2,1
7237,1,1,25214,25215,25216,1,2,0
7238,1,2,25215,25216,25218,1,3,0
7239,6,3,25221,25221,25224,0,3,3
7240,6,2,25227,25227,25229,0,2,3
7241,3,3,25230,25230,25233,0,3,1
7242,6,1,25236,25236,25237,0,1,3
7243,4,2,25240,25240,25242,0,2,3
7244,3,3,25243,25243,25246,0,3,1
7245,1,3,25244,25246,25249,2,5,0
7246,3,1,25247,25249,25250,2,3,0
7247,6,3,25253,25253,25256,0,3,3
7248,2,3,25255,25256,25259,1,4,0
7249,6,3,25261,25261,25264,0,3,2
7250,2,3,25263,25264,25267,1,4,0
7251,5,2,25268,25268,25270,0,2,1
7252,2,3,25270,25270,25273,0,3,0
7253,1,3,25271,25273,25276,2,5,0
7254,2,3,25273,25276,25279,3,6,0
7255,5,2,25278,25279,25281,1,3,0
7256,4,2,25282,25282,25284,0,2,1
7257,4,1,25286,25286,25287,0,1,2
7258,4,2,25290,25290,25292,0,2,3
7259,5,3,25295,25295,25298,0,3,3
7260,3,1,25298,25298,25299,0,1,0
7261,2,2,25300,25300,25302,0,2,1
7262,3,3,25303,25303,25306,0,3,1
7263,5,3,25308,25308,25311,0,3,2
7264,1,2,25309,25311,25313,2,4,0
7265,1,1,25310,25313,25314,3,4,0
7266,6,1,25316,25316,25317,0,1,2
7267,6,2,25322,25322,25324,0,2,5
7268,6,2,25328,25328,25330,0,2,4
7269,5,1,25333,25333,25334,0,1,3
7270,4,1,25337,25337,25338,0,1,3
7271,5,2,25342,25342,25344,0,2,4
7272,5,1,25347,25347,25348,0,1,3
7273,2,1,25349,25349,25350,0,1,1
7274,3,1,25352,25352,25353,0,1,2
7275,6,3,25358,25358,25361,0,3,5
7276,2,2,25360,25361,25363,1,3,0
7277,2,2,25362,25363,25365,1,3,0
7278,3,3,25365,25365,25368,0,3,0
7279,2,2,25367,25368,25370,1,3,0
7280,3,2,25370,25370,25372,0,2,0
7281,5,1,25375,25375,25376,0,1,3
7282,2,1,25377,25377,25378,0,1,1
7283,5,1,25382,25382,25383,0,1,4
7284,3,1,25385,25385,25386,0,1,2
7285,4,1,25389,25389,25390,0,1,3
7286,3,2,25392,25392,25394,0,2,2
7287,6,1,25398,25398,25399,0,1,4
7288,2,2,25400,25400,25402,0,2,1
7289,5,3,25405,25405,25408,0,3,3
7290,3,3,25408,25408,25411,0,3,0
7291,3,1,25411,25411,25412,0,1,0
7292,3,2,25414,25414,25416,0,2,2
7293,5,3,25419,25419,25422,0,3,3
7294,4,1,25423,25423,25424,0,1,1
7295,2,1,25425,25425,25426,0,1,1
7296,6,1,25431,25431,25432,0,1,5
7297,3,2,25434,25434,25436,0,2,2
7298,4,2,25438,25438,25440,0,2,2
7299,4,3,25442,25442,25445,0,3,2
7300,3,1,25445,25445,25446,0,1,0
7301,2,2,25447,25447,25449,0,2,1
7302,5,3,25452,25452,25455,0,3,3
7303,4,1,25456,25456,25457,0,1,1
7304,4,2,25460,25460,25462,0,2,3
7305,2,1,25462,25462,25463,0,1,0
7306,2,2,25464,25464,25466,0,2,1
7307,5,3,25469,25469,25472,0,3,3
7308,5,2,25474,25474,25476,0,2,2
7309,3,3,25477,25477,25480,0,3,1
7310,1,2,25478,25480,25482,2,4,0
7311,2,2,25480,25482,25484,2,4,0
7312,6,3,25486,25486,25489,0,3,2
7313,5,2,25491,25491,25493,0,2,2
7314,1,3,25492,25493,25496,1,4,0
7315,2,2,25494,25496,25498,2,4,0
7316,1,3,25495,25498,25501,3,6,0
7317,2,3,25497,25501,25504,4,7,0
7318,6,3,25503,25504,25507,1,4,0
7319,6,1,25509,25509,25510,0,1,2
7320,5,3,25514,25514,25517,0,3,4
7321,6,3,25520,25520,25523,0,3,3
7322,2,3,25522,25523,25526,1,4,0
7323,4,3,25526,25526,25529,0,3,0
7324,4,1,25530,25530,25531,0,1,1
7325,5,1,25535,25535,25536,0,1,4
7326,2,1,25537,25537,25538,0,1,1
7327,5,2,25542,25542,25544,0,2,4
7328,6,2,25548,25548,25550,0,2,4
7329,4,2,25552,25552,25554,0,2,2
7330,3,3,25555,25555,25558,0,3,1
7331,5,2,25560,25560,25562,0,2,2
7332,5,2,25565,25565,25567,0,2,3
7333,1,3,25566,25567,25570,1,4,0
7334,2,1,25568,25570,25571,2,3,0
7335,3,1,25571,25571,25572,0,1,0
7336,3,3,25574,25574,25577,0,3,2
7337,6,1,25580,25580,25581,0,1,3
7338,3,1,25583,25583,25584,0,1,2
7339,3,2,25586,25586,25588,0,2,2
7340,4,2,25590,25590,25592,0,2,2
7341,6,3,25596,25596,25599,0,3,4
7342,1,2,25597,25599,25601,2,4,0
7343,1,2,25598,25601,25603,3,5,0
7344,1,3,25599,25603,25606,4,7,0
7345,4,2,25603,25606,25608,3,5,0
7346,2,3,25605,25608,25611,3,6,0
7347,3,2,25608,25611,25613,3,5,0
7348,2,2,25610,25613,25615,3,5,0
7349,4,2,25614,25615,25617,1,3,0
7350,1,1,25615,25617,25618,2,3,0
7351,5,3,25620,25620,25623,0,3,2
7352,6,1,25626,25626,25627,0,1,3
7353,1,3,25627,25627,25630,0,3,0
7354,2,2,25629,25630,25632,1,3,0
7355,3,3,25632,25632,25635,0,3,0
7356,5,2,25637,25637,25639,0,2,2
7357,5,2,25642,25642,25644,0,2,3
7358,1,2,25643,25644,25646,1,3,0
7359,6,1,25649,25649,25650,0,1,3
7360,2,3,25651,25651,25654,0,3,1
7361,3,2,25654,25654,25656,0,2,0
7362,2,1,25656,25656,25657,0,1,0
7363,4,3,25660,25660,25663,0,3,3
7364,4,2,25664,25664,25666,0,2,1
7365,4,3,25668,25668,25671,0,3,2
7366,3,2,25671,25671,25673,0,2,0
7367,5,3,25676,25676,25679,0,3,3
7368,3,1,25679,25679,25680,0,1,0
7369,5,1,25684,25684,25685,0,1,4
7370,5,2,25689,25689,25691,0,2,4
7371,6,3,25695,25695,25698,0,3,4
7372,1,1,25696,25698,25699,2,3,0
7373,3,1,25699,25699,25700,0,1,0
7374,5,3,25704,25704,25707,0,3,4
7375,1,3,25705,25707,25710,2,5,0
7376,1,1,25706,25710,25711,4,5,0
7377,2,1,25708,25711,25712,3,4,0
7378,6,1,25714,25714,25715,0,1,2
7379,4,1,25718,25718,25719,0,1,3
7380,1,1,25719,25719,25720,0,1,0
7381,3,3,25722,25722,25725,0,3,2
7382,1,2,25723,25725,25727,2,4,0
7383,2,3,25725,25727,25730,2,5,0
7384,1,3,25726,25730,25733,4,7,0
7385,6,1,25732,25733,25734,1,2,0
7386,6,1,25738,25738,25739,0,1,4
7387,1,3,25739,25739,25742,0,3,0
7388,2,2,25741,25742,25744,1,3,0
7389,4,1,25745,25745,25746,0,1,1
7390,1,2,25746,25746,25748,0,2,0
7391,3,3,25749,25749,25752,0,3,1
7392,2,1,25751,25752,25753,1,2,0
7393,5,1,25756,25756,25757,0,1,3
7394,2,1,25758,25758,25759,0,1,1
7395,1,1,25759,25759,25760,0,1,0
7396,2,1,25761,25761,25762,0,1,1
7397,2,2,25763,25763,25765,0,2,1
7398,2,3,25765,25765,25768,0,3,0
7399,1,1,25766,25768,25769,2,3,0
7400,5,2,25771,25771,25773,0,2,2
7401,5,1,25776,25776,25777,0,1,3
7402,5,1,25781,25781,25782,0,1,4
7403,1,2,25782,25782,25784,0,2,0
7404,5,3,25787,25787,25790,0,3,3
7405,5,3,25792,25792,25795,0,3,2
7406,4,1,25796,25796,25797,0,1,1
7407,1,3,25797,25797,25800,0,3,0
7408,6,1,25803,25803,25804,0,1,3
7409,5,3,25808,25808,25811,0,3,4
7410,5,1,25813,25813,25814,0,1,2
7411,3,1,25816,25816,25817,0,1,2
7412,3,2,25819,25819,25821,0,2,2
7413,1,1,25820,25821,25822,1,2,0
7414,4,2,25824,25824,25826,0,2,2
7415,1,3,25825,25826,25829,1,4,0
7416,5,1,25830,25830,25831,0,1,1
7417,4,2,25834,25834,25836,0,2,3
7418,3,1,25837,25837,25838,0,1,1
7419,2,2,25839,25839,25841,0,2,1
7420,2,3,25841,25841,25844,0,3,0
7421,1,2,25842,25844,25846,2,4,0
7422,6,1,25848,25848,25849,0,1,2
7423,6,1,25854,25854,25855,0,1,5
7424,5,3,25859,25859,25862,0,3,4
7425,2,3,25861,25862,25865,1,4,0
7426,1,3,25862,25865,25868,3,6,0
7427,3,1,25865,25868,25869,3,4,0
7428,3,3,25868,25869,25872,1,4,0
7429,5,2,25873,25873,25875,0,2,1
7430,5,1,25878,25878,25879,0,1,3
7431,1,1,25879,25879,25880,0,1,0
7432,3,2,25882,25882,25884,0,2,2
7433,5,2,25887,25887,25889,0,2,3
7434,2,2,25889,25889,25891,0,2,0
7435,6,1,25895,25895,25896,0,1,4
7436,1,3,25896,25896,25899,0,3,0
7437,4,2,25900,25900,25902,0,2,1
7438,4,1,25904,25904,25905,0,1,2
7439,3,1,25907,25907,25908,0,1,2
7440,2,3,25909,25909,25912,0,3,1
7441,1,3,25910,25912,25915,2,5,0
7442,1,3,25911,25915,25918,4,7,0
7443,1,2,25912,25918,25920,6,8,0
7444,3,2,25915,25920,25922,5,7,0
7445,4,2,25919,25922,25924,3,5,0
7446,2,2,25921,25924,25926,3,5,0
7447,3,1,25924,25926,25927,2,3,0
7448,1,1,25925,25927,25928,2,3,0
7449,3,3,25928,25928,25931,0,3,0
7450,3,3,25931,25931,25934,0,3,0
7451,2,2,25933,25934,25936,1,3,0
7452,4,1,25937,25937,25938,0,1,1
7453,3,1,25940,25940,25941,0,1,2
7454,4,3,25944,25944,25947,0,3,3
7455,6,2,25950,25950,25952,0,2,3
7456,2,1,25952,25952,25953,0,1,0
7457,3,3,25955,25955,25958,0,3,2
7458,1,3,25956,25958,25961,2,5,0
7459,3,3,25959,25961,25964,2,5,0
7460,2,2,25961,25964,25966,3,5,0
7461,5,1,25966,25966,25967,0,1,0
7462,4,2,25970,25970,25972,0,2,3
7463,5,1,25975,25975,25976,0,1,3
7464,1,3,25976,25976,25979,0,3,0
7465,6,2,25982,25982,25984,0,2,3
7466,3,1,25985,25985,25986,0,1,1
7467,2,1,25987,25987,25988,0,1,1
7468,4,1,25991,25991,25992,0,1,3
7469,1,2,25992,25992,25994,0,2,0
7470,2,1,25994,25994,25995,0,1,0
7471,1,2,25995,25995,25997,0,2,0
7472,4,2,25999,25999,26001,0,2,2
7473,2,3,26001,26001,26004,0,3,0
7474,1,2,26002,26004,26006,2,4,0
7475,6,1,26008,26008,26009,0,1,2
7476,1,2,26009,26009,26011,0,2,0
7477,6,2,26015,26015,26017,0,2,4
7478,6,1,26021,26021,26022,0,1,4
7479,4,3,26025,26025,26028,0,3,3
7480,2,1,26027,26028,26029,1,2,0
7481,4,1,26031,26031,26032,0,1,2
7482,5,2,26036,26036,26038,0,2,4
7483,1,1,26037,26038,26039,1,2,0
7484,6,1,26043,26043,26044,0,1,4
7485,1,3,26044,26044,26047,0,3,0
7486,6,2,26050,26050,26052,0,2,3
7487,4,2,26054,26054,26056,0,2,2
7488,5,2,26059,26059,26061,0,2,3
7489,1,1,26060,26061,26062,1,2,0
7490,1,1,26061,26062,26063,1,2,0
7491,5,3,26066,26066,26069,0,3,3
7492,3,3,26069,26069,26072,0,3,0
7493,1,3,26070,26072,26075,2,5,0
7494,6,1,26076,26076,26077,0,1,1
7495,3,2,26079,26079,26081,0,2,2
7496,4,2,26083,26083,26085,0,2,2
7497,1,3,26084,26085,26088,1,4,0
7498,1,3,26085,26088,26091,3,6,0
7499,6,2,26091,26091,26093,0,2,0
7500,6,2,26097,26097,26099,0,2,4
7501,3,3,26100,26100,26103,0,3,1
7502,2,1,26102,26103,26104,1,2,0
7503,2,1,26104,26104,26105,0,1,0
7504,3,3,26107,26107,26110,0,3,2
7505,2,1,26109,26110,26111,1,2,0
7506,4,2,26113,26113,26115,0,2,2
7507,6,2,26119,26119,26121,0,2,4
7508,2,2,26121,26121,26123,0,2,0
7509,4,2,26125,26125,26127,0,2,2
7510,4,2,26129,26129,26131,0,2,2
7511,2,1,26131,26131,26132,0,1,0
7512,5,2,26136,26136,26138,0,2,4
7513,4,2,26140,26140,26142,0,2,2
7514,4,2,26144,26144,26146,0,2,2
7515,1,3,26145,26146,26149,1,4,0
7516,6,2,26151,26151,26153,0,2,2
7517,4,2,26155,26155,26157,0,2,2
7518,4,2,26159,26159,26161,0,2,2
7519,4,2,26163,26163,26165,0,2,2
7520,5,1,26168,26168,26169,0,1,3
7521,2,1,26170,26170,26171,0,1,1
7522,5,2,26175,26175,26177,0,2,4
7523,4,2,26179,26179,26181,0,2,2
7524,6,1,26185,26185,26186,0,1,4
7525,5,3,26190,26190,26193,0,3,4
7526,5,2,26195,26195,26197,0,2,2
7527,3,3,26198,26198,26201,0,3,1
7528,4,1,26202,26202,26203,0,1,1
7529,5,2,26207,26207,26209,0,2,4
7530,6,2,26213,26213,26215,0,2,4
7531,5,2,26218,26218,26220,0,2,3
7532,6,3,26224,26224,26227,0,3,4
7533,2,3,26226,26227,26230,1,4,0
7534,4,2,26230,26230,26232,0,2,0
7535,3,3,26233,26233,26236,0,3,1
7536,2,3,26235,26236,26239,1,4,0
7537,6,3,26241,26241,26244,0,3,2
7538,1,2,26242,26244,26246,2,4,0
7539,4,3,26246,26246,26249,0,3,0
7540,1,2,26247,26249,26251,2,4,0
7541,3,3,26250,26251,26254,1,4,0
7542,3,1,26253,26254,26255,1,2,0
7543,5,1,26258,26258,26259,0,1,3
7544,2,2,26260,26260,26262,0,2,1
7545,6,3,26266,26266,26269,0,3,4
7546,6,2,26272,26272,26274,0,2,3
7547,6,1,26278,26278,26279,0,1,4
7548,2,3,26280,26280,26283,0,3,1
7549,2,3,26282,26283,26286,1,4,0
7550,6,2,26288,26288,26290,0,2,2
7551,2,3,26290,26290,26293,0,3,0
7552,5,3,26295,26295,26298,0,3,2
7553,4,1,26299,26299,26300,0,1,1
7554,1,1,26300,26300,26301,0,1,0
7555,5,2,26305,26305,26307,0,2,4
7556,3,3,26308,26308,26311,0,3,1
7557,5,2,26313,26313,26315,0,2,2
7558,2,1,26315,26315,26316,0,1,0
7559,1,1,26316,26316,26317,0,1,0
7560,1,2,26317,26317,26319,0,2,0
7561,1,3,26318,26319,26322,1,4,0
7562,5,2,26323,26323,26325,0,2,1
7563,6,1,26329,26329,26330,0,1,4
7564,1,1,26330,26330,26331,0,1,0
7565,2,3,26332,26332,26335,0,3,1
7566,4,1,26336,26336,26337,0,1,1
7567,6,2,26342,26342,26344,0,2,5
7568,1,3,26343,26344,26347,1,4,0
7569,6,1,26349,26349,26350,0,1,2
7570,6,3,26355,26355,26358,0,3,5
7571,4,3,26359,26359,26362,0,3,1
7572,2,2,26361,26362,26364,1,3,0
7573,2,1,26363,26364,26365,1,2,0
7574,6,3,26369,26369,26372,0,3,4
7575,3,3,26372,26372,26375,0,3,0
7576,2,1,26374,26375,26376,1,2,0
7577,2,2,26376,26376,26378,0,2,0
7578,3,1,26379,26379,26380,0,1,1
7579,3,3,26382,26382,26385,0,3,2
7580,1,3,26383,26385,26388,2,5,0
7581,2,2,26385,26388,26390,3,5,0
7582,1,2,26386,26390,26392,4,6,0
7583,1,3,26387,26392,26395,5,8,0
7584,2,2,26389,26395,26397,6,8,0
7585,4,1,26393,26397,26398,4,5,0
7586,6,3,26399,26399,26402,0,3,1
7587,6,3,26405,26405,26408,0,3,3
7588,1,1,26406,26408,26409,2,3,0
7589,1,3,26407,26409,26412,2,5,0
7590,5,1,26412,26412,26413,0,1,0
7591,5,3,26417,26417,26420,0,3,4
7592,5,2,26422,26422,26424,0,2,2
7593,3,1,26425,26425,26426,0,1,1
7594,5,2,26430,26430,26432,0,2,4
7595,1,1,26431,26432,26433,1,2,0
7596,2,3,26433,26433,26436,0,3,0
7597,5,2,26438,26438,26440,0,2,2
7598,5,1,26443,26443,26444,0,1,3
7599,3,3,26446,26446,26449,0,3,2
7600,3,1,26449,26449,26450,0,1,0
7601,2,1,26451,26451,26452,0,1,1
7602,1,2,26452,26452,26454,0,2,0
7603,3,1,26455,26455,26456,0,1,1
7604,2,3,26457,26457,26460,0,3,1
7605,3,1,26460,26460,26461,0,1,0
7606,3,2,26463,26463,26465,0,2,2
7607,5,2,26468,26468,26470,0,2,3
7608,1,2,26469,26470,26472,1,3,0
7609,3,2,26472,26472,26474,0,2,0
7610,4,3,26476,26476,26479,0,3,2
7611,6,1,26482,26482,26483,0,1,3
7612,2,1,26484,26484,26485,0,1,1
7613,4,3,26488,26488,26491,0,3,3
7614,3,3,26491,26491,26494,0,3,0
7615,4,2,26495,26495,26497,0,2,1
7616,2,1,26497,26497,26498,0,1,0
7617,4,1,26501,26501,26502,0,1,3
7618,3,2,26504,26504,26506,0,2,2
7619,6,2,26510,26510,26512,0,2,4
7620,1,2,26511,26512,26514,1,3,0
7621,3,3,26514,26514,26517,0,3,0
7622,1,3,26515,26517,26520,2,5,0
7623,1,1,26516,26520,26521,4,5,0
7624,3,2,26519,26521,26523,2,4,0
7625,1,2,26520,26523,26525,3,5,0
7626,1,1,26521,26525,26526,4,5,0
7627,4,1,26525,26526,26527,1,2,0
7628,1,1,26526,26527,26528,1,2,0
7629,6,2,26532,26532,26534,0,2,4
7630,2,3,26534,26534,26537,0,3,0
7631,5,1,26539,26539,26540,0,1,2
7632,5,3,26544,26544,26547,0,3,4
7633,2,3,26546,26547,26550,1,4,0
7634,2,1,26548,26550,26551,2,3,0
7635,4,3,26552,26552,26555,0,3,1
7636,1,2,26553,26555,26557,2,4,0
7637,6,1,26559,26559,26560,0,1,2
7638,4,1,26563,26563,26564,0,1,3
7639,4,3,26567,26567,26570,0,3,3
7640,5,3,26572,26572,26575,0,3,2
7641,4,1,26576,26576,26577,0,1,1
7642,4,3,26580,26580,26583,0,3,3
7643,2,2,26582,26583,26585,1,3,0
7644,4,1,26586,26586,26587,0,1,1
7645,5,1,26591,26591,26592,0,1,4
7646,1,1,26592,26592,26593,0,1,0
7647,1,3,26593,26593,26596,0,3,0
7648,4,2,26597,26597,26599,0,2,1
7649,5,2,26602,26602,26604,0,2,3
7650,1,3,26603,26604,26607,1,4,0
7651,3,2,26606,26607,26609,1,3,0
7652,6,3,26612,26612,26615,0,3,3
7653,2,3,26614,26615,26618,1,4,0
7654,2,1,26616,26618,26619,2,3,0
7655,5,1,26621,26621,26622,0,1,2
7656,1,3,26622,26622,26625,0,3,0
7657,6,1,26628,26628,26629,0,1,3
7658,4,3,26632,26632,26635,0,3,3
7659,4,2,26636,26636,26638,0,2,1
7660,3,1,26639,26639,26640,0,1,1
7661,3,2,26642,26642,26644,0,2,2
7662,5,2,26647,26647,26649,0,2,3
7663,5,2,26652,26652,26654,0,2,3
7664,1,1,26653,26654,26655,1,2,0
7665,6,1,26659,26659,26660,0,1,4
7666,3,3,26662,26662,26665,0,3,2
7667,1,1,26663,26665,26666,2,3,0
7668,3,3,26666,26666,26669,0,3,0
7669,5,2,26671,26671,26673,0,2,2
7670,1,1,26672,26673,26674,1,2,0
7671,4,1,26676,26676,26677,0,1,2
7672,4,1,26680,26680,26681,0,1,3
7673,6,3,26686,26686,26689,0,3,5
7674,3,2,26689,26689,26691,0,2,0
7675,6,1,26695,26695,26696,0,1,4
7676,1,1,26696,26696,26697,0,1,0
7677,1,1,26697,26697,26698,0,1,0
7678,2,3,26699,26699,26702,0,3,1
7679,2,1,26701,26702,26703,1,2,0
7680,2,2,26703,26703,26705,0,2,0
7681,6,2,26709,26709,26711,0,2,4
7682,3,1,26712,26712,26713,0,1,1
7683,1,3,26713,26713,26716,0,3,0
7684,5,3,26718,26718,26721,0,3,2
7685,4,1,26722,26722,26723,0,1,1
7686,6,2,26728,26728,26730,0,2,5
7687,3,1,26731,26731,26732,0,1,1
7688,5,2,26736,26736,26738,0,2,4
7689,4,3,26740,26740,26743,0,3,2
7690,5,1,26745,26745,26746,0,1,2
7691,3,3,26748,26748,26751,0,3,2
7692,1,2,26749,26751,26753,2,4,0
7693,3,2,26752,26753,26755,1,3,0
7694,5,1,26757,26757,26758,0,1,2
7695,3,1,26760,26760,26761,0,1,2
7696,5,1,26765,26765,26766,0,1,4
7697,4,3,26769,26769,26772,0,3,3
7698,6,3,26775,26775,26778,0,3,3
7699,1,3,26776,26778,26781,2,5,0
7700,4,1,26780,26781,26782,1,2,0
7701,5,1,26785,26785,26786,0,1,3
7702,3,3,26788,26788,26791,0,3,2
7703,1,1,26789,26791,26792,2,3,0
7704,6,3,26795,26795,26798,0,3,3
7705,5,1,26800,26800,26801,0,1,2
7706,1,2,26801,26801,26803,0,2,0
7707,2,1,26803,26803,26804,0,1,0
7708,1,3,26804,26804,26807,0,3,0
7709,5,2,26809,26809,26811,0,2,2
7710,1,1,26810,26811,26812,1,2,0
7711,4,2,26814,26814,26816,0,2,2
7712,6,2,26820,26820,26822,0,2,4
7713,6,1,26826,26826,26827,0,1,4
7714,2,3,26828,26828,26831,0,3,1
7715,4,2,26832,26832,26834,0,2,1
7716,3,2,26835,26835,26837,0,2,1
7717,2,3,26837,26837,26840,0,3,0
7718,3,2,26840,26840,26842,0,2,0
7719,3,3,26843,26843,26846,0,3,1
7720,4,3,26847,26847,26850,0,3,1
7721,1,3,26848,26850,26853,2,5,0
7722,4,2,26852,26853,26855,1,3,0
7723,3,1,26855,26855,26856,0,1,0
7724,1,2,26856,26856,26858,0,2,0
7725,1,3,26857,26858,26861,1,4,0
7726,4,3,26861,26861,26864,0,3,0
7727,6,1,26867,26867,26868,0,1,3
7728,3,3,26870,26870,26873,0,3,2
7729,2,1,26872,26873,26874,1,2,0
7730,6,1,26878,26878,26879,0,1,4
7731,1,2,26879,26879,26881,0,2,0
7732,6,2,26885,26885,26887,0,2,4
7733,2,1,26887,26887,26888,0,1,0
7734,2,2,26889,26889,26891,0,2,1
7735,4,3,26893,26893,26896,0,3,2
7736,2,3,26895,26896,26899,1,4,0
7737,1,3,26896,26899,26902,3,6,0
7738,5,3,26901,26902,26905,1,4,0
7739,5,3,26906,26906,26909,0,3,1
7740,3,2,26909,26909,26911,0,2,0
7741,5,2,26914,26914,26916,0,2,3
7742,5,1,26919,26919,26920,0,1,3
7743,5,3,26924,26924,26927,0,3,4
7744,2,2,26926,26927,26929,1,3,0
7745,5,3,26931,26931,26934,0,3,2
7746,2,1,26933,26934,26935,1,2,0
7747,6,3,26939,26939,26942,0,3,4
7748,4,3,26943,26943,26946,0,3,1
7749,6,3,26949,26949,26952,0,3,3
7750,3,3,26952,26952,26955,0,3,0
7751,3,1,26955,26955,26956,0,1,0
7752,4,2,26959,26959,26961,0,2,3
7753,4,1,26963,26963,26964,0,1,2
7754,2,3,26965,26965,26968,0,3,1
7755,3,3,26968,26968,26971,0,3,0
7756,1,1,26969,26971,26972,2,3,0
7757,4,1,26973,26973,26974,0,1,1
7758,6,1,26979,26979,26980,0,1,5
7759,6,2,26985,26985,26987,0,2,5
7760,1,2,26986,26987,26989,1,3,0
7761,1,2,26987,26989,26991,2,4,0
7762,5,1,26992,26992,26993,0,1,1
7763,3,1,26995,26995,26996,0,1,2
7764,2,1,26997,26997,26998,0,1,1
7765,4,3,27001,27001,27004,0,3,3
7766,6,1,27007,27007,27008,0,1,3
7767,4,1,27011,27011,27012,0,1,3
7768,6,1,27017,27017,27018,0,1,5
7769,4,2,27021,27021,27023,0,2,3
7770,3,3,27024,27024,27027,0,3,1
7771,3,2,27027,27027,27029,0,2,0
7772,5,2,27032,27032,27034,0,2,3
7773,5,3,27037,27037,27040,0,3,3
7774,3,2,27040,27040,27042,0,2,0
7775,6,2,27046,27046,27048,0,2,4
7776,4,2,27050,27050,27052,0,2,2
7777,6,3,27056,27056,27059,0,3,4
7778,1,1,27057,27059,27060,2,3,0
7779,3,1,27060,27060,27061,0,1,0
7780,4,3,27064,27064,27067,0,3,3
7781,4,1,27068,27068,27069,0,1,1
7782,2,1,27070,27070,27071,0,1,1
7783,4,3,27074,27074,27077,0,3,3
7784,6,1,27080,27080,27081,0,1,3
7785,2,2,27082,27082,27084,0,2,1
7786,5,2,27087,27087,27089,0,2,3
7787,2,1,27089,27089,27090,0,1,0
7788,1,3,27090,27090,27093,0,3,0
7789,1,1,27091,27093,27094,2,3,0
7790,1,3,27092,27094,27097,2,5,0
7791,6,2,27098,27098,27100,0,2,1
7792,6,2,27104,27104,27106,0,2,4
7793,4,2,27108,27108,27110,0,2,2
7794,3,1,27111,27111,27112,0,1,1
7795,4,3,27115,27115,27118,0,3,3
7796,2,2,27117,27118,27120,1,3,0
7797,3,2,27120,27120,27122,0,2,0
7798,6,1,27126,27126,27127,0,1,4
7799,1,1,27127,27127,27128,0,1,0
7800,5,2,27132,27132,27134,0,2,4
7801,6,3,27138,27138,27141,0,3,4
7802,6,1,27144,27144,27145,0,1,3
7803,4,1,27148,27148,27149,0,1,3
7804,3,2,27151,27151,27153,0,2,2
7805,6,3,27157,27157,27160,0,3,4
7806,2,2,27159,27160,27162,1,3,0
7807,1,1,27160,27162,27163,2,3,0
7808,6,1,27166,27166,27167,0,1,3
7809,5,1,27171,27171,27172,0,1,4
7810,6,1,27177,27177,27178,0,1,5
7811,3,1,27180,27180,27181,0,1,2
7812,6,1,27186,27186,27187,0,1,5
7813,6,3,27192,27192,27195,0,3,5
7814,3,1,27195,27195,27196,0,1,0
7815,2,1,27197,27197,27198,0,1,1
7816,4,3,27201,27201,27204,0,3,3
7817,1,2,27202,27204,27206,2,4,0
7818,4,1,27206,27206,27207,0,1,0
7819,5,1,27211,27211,27212,0,1,4
7820,2,1,27213,27213,27214,0,1,1
7821,1,1,27214,27214,27215,0,1,0
7822,2,2,27216,27216,27218,0,2,1
7823,3,2,27219,27219,27221,0,2,1
7824,3,1,27222,27222,27223,0,1,1
7825,4,1,27226,27226,27227,0,1,3
7826,6,1,27232,27232,27233,0,1,5
7827,2,2,27234,27234,27236,0,2,1
7828,6,1,27240,27240,27241,0,1,4
7829,3,2,27243,27243,27245,0,2,2
7830,2,1,27245,27245,27246,0,1,0
7831,1,3,27246,27246,27249,0,3,0
7832,1,2,27247,27249,27251,2,4,0
7833,5,2,27252,27252,27254,0,2,1
7834,4,3,27256,27256,27259,0,3,2
7835,1,1,27257,27259,27260,2,3,0
7836,6,3,27263,27263,27266,0,3,3
7837,3,1,27266,27266,27267,0,1,0
7838,2,2,27268,27268,27270,0,2,1
7839,2,1,27270,27270,27271,0,1,0
7840,3,3,27273,27273,27276,0,3,2
7841,5,3,27278,27278,27281,0,3,2
7842,1,1,27279,27281,27282,2,3,0
7843,3,1,27282,27282,27283,0,1,0
7844,5,3,27287,27287,27290,0,3,4
7845,2,1,27289,27290,27291,1,2,0
7846,5,2,27294,27294,27296,0,2,3
7847,2,1,27296,27296,27297,0,1,0
7848,5,1,27301,27301,27302,0,1,4
7849,4,1,27305,27305,27306,0,1,3
7850,2,1,27307,27307,27308,0,1,1
7851,2,1,27309,27309,27310,0,1,1
7852,2,1,27311,27311,27312,0,1,1
7853,1,1,27312,27312,27313,0,1,0
7854,3,3,27315,27315,27318,0,3,2
7855,6,2,27321,27321,27323,0,2,3
7856,4,1,27325,27325,27326,0,1,2
7857,6,1,27331,27331,27332,0,1,5
7858,2,3,27333,27333,27336,0,3,1
7859,3,3,27336,27336,27339,0,3,0
7860,5,1,27341,27341,27342,0,1,2
7861,6,1,27347,27347,27348,0,1,5
7862,4,3,27351,27351,27354,0,3,3
7863,2,3,27353,27354,27357,1,4,0
7864,3,2,27356,27357,27359,1,3,0
7865,6,1,27362,27362,27363,0,1,3
7866,4,3,27366,27366,27369,0,3,3
7867,5,3,27371,27371,27374,0,3,2
7868,4,1,27375,27375,27376,0,1,1
7869,1,2,27376,27376,27378,0,2,0
7870,1,1,27377,27378,27379,1,2,0
7871,5,2,27382,27382,27384,0,2,3
7872,5,3,27387,27387,27390,0,3,3
7873,1,2,27388,27390,27392,2,4,0
7874,6,2,27394,27394,27396,0,2,2
7875,6,2,27400,27400,27402,0,2,4
7876,1,1,27401,27402,27403,1,2,0
7877,4,3,27405,27405,27408,0,3,2
7878,5,2,27410,27410,27412,0,2,2
7879,6,2,27416,27416,27418,0,2,4
7880,4,1,27420,27420,27421,0,1,2
7881,4,2,27424,27424,27426,0,2,3
7882,4,1,27428,27428,27429,0,1,2
7883,1,3,27429,27429,27432,0,3,0
7884,1,1,27430,27432,27433,2,3,0
7885,1,1,27431,27433,27434,2,3,0
7886,4,3,27435,27435,27438,0,3,1
7887,1,3,27436,27438,27441,2,5,0
7888,4,1,27440,27441,27442,1,2,0
7889,2,3,27442,27442,27445,0,3,0
7890,6,1,27448,27448,27449,0,1,3
7891,5,3,27453,27453,27456,0,3,4
7892,2,3,27455,27456,27459,1,4,0
7893,5,1,27460,27460,27461,0,1,1
7894,4,3,27464,27464,27467,0,3,3
7895,6,3,27470,27470,27473,0,3,3
7896,3,2,27473,27473,27475,0,2,0
7897,2,2,27475,27475,27477,0,2,0
7898,6,2,27481,27481,27483,0,2,4
7899,3,3,27484,27484,27487,0,3,1
7900,3,2,27487,27487,27489,0,2,0
7901,5,1,27492,27492,27493,0,1,3
7902,4,1,27496,27496,27497,0,1,3
7903,1,2,27497,27497,27499,0,2,0
7904,5,1,27502,27502,27503,0,1,3
7905,1,2,27503,27503,27505,0,2,0
7906,5,1,27508,27508,27509,0,1,3
7907,6,1,27514,27514,27515,0,1,5
7908,1,1,27515,27515,27516,0,1,0
7909,5,2,27520,27520,27522,0,2,4
7910,1,2,27521,27522,27524,1,3,0
7911,6,2,27527,27527,27529,0,2,3
7912,6,3,27533,27533,27536,0,3,4
7913,1,1,27534,27536,27537,2,3,0
7914,4,2,27538,27538,27540,0,2,1
7915,1,3,27539,27540,27543,1,4,0
7916,1,2,27540,27543,27545,3,5,0
7917,6,1,27546,27546,27547,0,1,1
7918,6,3,27552,27552,27555,0,3,5
7919,6,2,27558,27558,27560,0,2,3
7920,1,3,27559,27560,27563,1,4,0
7921,2,3,27561,27563,27566,2,5,0
7922,6,1,27567,27567,27568,0,1,1
7923,2,3,27569,27569,27572,0,3,1
7924,2,1,27571,27572,27573,1,2,0
7925,2,3,27573,27573,27576,0,3,0
7926,5,1,27578,27578,27579,0,1,2
7927,4,2,27582,27582,27584,0,2,3
7928,2,3,27584,27584,27587,0,3,0
7929,4,2,27588,27588,27590,0,2,1
7930,3,1,27591,27591,27592,0,1,1
7931,6,2,27597,27597,27599,0,2,5
7932,1,2,27598,27599,27601,1,3,0
7933,2,1,27600,27601,27602,1,2,0
7934,1,2,27601,27602,27604,1,3,0
7935,5,3,27606,27606,27609,0,3,2
7936,1,1,27607,27609,27610,2,3,0
7937,3,3,27610,27610,27613,0,3,0
7938,3,1,27613,27613,27614,0,1,0
7939,6,3,27619,27619,27622,0,3,5
7940,1,3,27620,27622,27625,2,5,0
7941,5,1,27625,27625,27626,0,1,0
7942,3,3,27628,27628,27631,0,3,2
7943,6,1,27634,27634,27635,0,1,3
7944,3,3,27637,27637,27640,0,3,2
7945,6,2,27643,27643,27645,0,2,3
7946,5,2,27648,27648,27650,0,2,3
7947,5,2,27653,27653,27655,0,2,3
7948,6,1,27659,27659,27660,0,1,4
7949,3,1,27662,27662,27663,0,1,2
7950,2,1,27664,27664,27665,0,1,1
7951,5,1,27669,27669,27670,0,1,4
7952,2,1,27671,27671,27672,0,1,1
7953,1,2,27672,27672,27674,0,2,0
7954,6,2,27678,27678,27680,0,2,4
7955,4,2,27682,27682,27684,0,2,2
7956,5,3,27687,27687,27690,0,3,3
7957,4,3,27691,27691,27694,0,3,1
7958,6,3,27697,27697,27700,0,3,3
7959,2,2,27699,27700,27702,1,3,0
7960,4,1,27703,27703,27704,0,1,1
7961,2,1,27705,27705,27706,0,1,1
7962,2,3,27707,27707,27710,0,3,1
7963,2,2,27709,27710,27712,1,3,0
7964,3,1,27712,27712,27713,0,1,0
7965,4,2,27716,27716,27718,0,2,3
7966,6,3,27722,27722,27725,0,3,4
7967,3,3,27725,27725,27728,0,3,0
7968,3,1,27728,27728,27729,0,1,0
7969,3,1,27731,27731,27732,0,1,2
7970,1,3,27732,27732,27735,0,3,0
7971,3,2,27735,27735,27737,0,2,0
7972,1,3,27736,27737,27740,1,4,0
7973,1,3,27737,27740,27743,3,6,0
7974,5,1,27742,27743,27744,1,2,0
7975,5,3,27747,27747,27750,0,3,3
7976,3,2,27750,27750,27752,0,2,0
7977,4,3,27754,27754,27757,0,3,2
7978,5,2,27759,27759,27761,0,2,2
7979,1,3,27760,27761,27764,1,4,0
7980,6,3,27766,27766,27769,0,3,2
7981,2,3,27768,27769,27772,1,4,0
7982,5,3,27773,27773,27776,0,3,1
7983,4,2,27777,27777,27779,0,2,1
7984,2,2,27779,27779,27781,0,2,0
7985,6,1,27785,27785,27786,0,1,4
7986,5,2,27790,27790,27792,0,2,4
7987,6,2,27796,27796,27798,0,2,4
7988,4,3,27800,27800,27803,0,3,2
7989,1,2,27801,27803,27805,2,4,0
7990,2,3,27803,27805,27808,2,5,0
7991,1,1,27804,27808,27809,4,5,0
7992,4,2,27808,27809,27811,1,3,0
7993,6,2,27814,27814,27816,0,2,3
7994,2,2,27816,27816,27818,0,2,0
7995,4,2,27820,27820,27822,0,2,2
7996,2,2,27822,27822,27824,0,2,0
7997,1,3,27823,27824,27827,1,4,0
7998,2,1,27825,27827,27828,2,3,0
7999,5,3,27830,27830,27833,0,3,2
8000,1,1,27831,27833,27834,2,3,0
8001,2,2,27833,27834,27836,1,3,0
8002,6,2,27839,27839,27841,0,2,3
8003,4,3,27843,27843,27846,0,3,2
8004,6,1,27849,27849,27850,0,1,3
8005,2,2,27851,27851,27853,0,2,1
8006,3,1,27854,27854,27855,0,1,1
8007,5,3,27859,27859,27862,0,3,4
8008,3,3,27862,27862,27865,0,3,0
8009,5,2,27867,27867,27869,0,2,2
8010,3,2,27870,27870,27872,0,2,1
8011,3,2,27873,27873,27875,0,2,1
8012,3,3,27876,27876,27879,0,3,1
8013,2,1,27878,27879,27880,1,2,0
8014,2,2,27880,27880,27882,0,2,0
8015,1,2,27881,27882,27884,1,3,0
8016,6,3,27887,27887,27890,0,3,3
8017,1,3,27888,27890,27893,2,5,0
8018,6,2,27894,27894,27896,0,2,1
8019,4,2,27898,27898,27900,0,2,2
8020,5,1,27903,27903,27904,0,1,3
8021,5,2,27908,27908,27910,0,2,4
8022,5,2,27913,27913,27915,0,2,3
8023,2,1,27915,27915,27916,0,1,0
8024,4,2,27919,27919,27921,0,2,3
8025,1,1,27920,27921,27922,1,2,0
8026,3,3,27923,27923,27926,0,3,1
8027,4,3,27927,27927,27930,0,3,1
8028,3,1,27930,27930,27931,0,1,0
8029,4,3,27934,27934,27937,0,3,3
8030,6,3,27940,27940,27943,0,3,3
8031,4,3,27944,27944,27947,0,3,1
8032,4,3,27948,27948,27951,0,3,1
8033,6,2,27954,27954,27956,0,2,3
8034,2,3,27956,27956,27959,0,3,0
8035,3,3,27959,27959,27962,0,3,0
8036,3,1,27962,27962,27963,0,1,0
8037,3,1,27965,27965,27966,0,1,2
8038,1,3,27966,27966,27969,0,3,0
8039,2,3,27968,27969,27972,1,4,0
8040,1,3,27969,27972,27975,3,6,0
8041,6,1,27975,27975,27976,0,1,0
8042,2,2,27977,27977,27979,0,2,1
8043,6,3,27983,27983,27986,0,3,4
8044,1,1,27984,27986,27987,2,3,0
8045,2,1,27986,27987,27988,1,2,0
8046,3,3,27989,27989,27992,0,3,1
8047,3,2,27992,27992,27994,0,2,0
8048,1,1,27993,27994,27995,1,2,0
8049,6,2,27999,27999,28001,0,2,4
8050,6,1,28005,28005,28006,0,1,4
8051,1,1,28006,28006,28007,0,1,0
8052,3,3,28009,28009,28012,0,3,2
8053,2,3,28011,28012,28015,1,4,0
8054,5,2,28016,28016,28018,0,2,1
8055,1,3,28017,28018,28021,1,4,0
8056,2,3,28019,28021,28024,2,5,0
8057,1,3,28020,28024,28027,4,7,0
8058,2,2,28022,28027,28029,5,7,0
8059,2,1,28024,28029,28030,5,6,0
8060,1,1,28025,28030,28031,5,6,0
8061,5,2,28030,28031,28033,1,3,0
8062,6,1,28036,28036,28037,0,1,3
8063,1,3,28037,28037,28040,0,3,0
8064,6,3,28043,28043,28046,0,3,3
8065,2,1,28045,28046,28047,1,2,0
8066,2,2,28047,28047,28049,0,2,0
8067,4,1,28051,28051,28052,0,1,2
8068,5,1,28056,28056,28057,0,1,4
8069,6,1,28062,28062,28063,0,1,5
8070,5,1,28067,28067,28068,0,1,4
8071,1,3,28068,28068,28071,0,3,0
8072,1,2,28069,28071,28073,2,4,0
8073,6,2,28075,28075,28077,0,2,2
8074,6,3,28081,28081,28084,0,3,4
8075,6,3,28087,28087,28090,0,3,3
8076,5,1,28092,28092,28093,0,1,2
8077,6,3,28098,28098,28101,0,3,5
8078,1,3,28099,28101,28104,2,5,0
8079,4,3,28103,28104,28107,1,4,0
8080,6,3,28109,28109,28112,0,3,2
8081,3,3,28112,28112,28115,0,3,0
8082,4,3,28116,28116,28119,0,3,1
8083,2,2,28118,28119,28121,1,3,0
8084,5,3,28123,28123,28126,0,3,2
8085,3,2,28126,28126,28128,0,2,0
8086,5,2,28131,28131,28133,0,2,3
8087,6,3,28137,28137,28140,0,3,4
8088,2,3,28139,28140,28143,1,4,0
8089,5,1,28144,28144,28145,0,1,1
8090,4,1,28148,28148,28149,0,1,3
8091,1,2,28149,28149,28151,0,2,0
8092,2,3,28151,28151,28154,0,3,0
8093,2,3,28153,28154,28157,1,4,0
8094,2,2,28155,28157,28159,2,4,0
8095,1,2,28156,28159,28161,3,5,0
8096,6,1,28162,28162,28163,0,1,1
8097,4,1,28166,28166,28167,0,1,3
8098,3,1,28169,28169,28170,0,1,2
8099,5,2,28174,28174,28176,0,2,4
8100,4,3,28178,28178,28181,0,3,2
8101,6,1,28184,28184,28185,0,1,3
8102,1,3,28185,28185,28188,0,3,0
8103,2,3,28187,28188,28191,1,4,0
8104,4,3,28191,28191,28194,0,3,0
8105,1,2,28192,28194,28196,2,4,0
8106,4,2,28196,28196,28198,0,2,0
8107,6,1,28202,28202,28203,0,1,4
8108,5,3,28207,28207,28210,0,3,4
8109,3,1,28210,28210,28211,0,1,0
8110,1,2,28211,28211,28213,0,2,0
8111,5,2,28216,28216,28218,0,2,3
8112,5,3,28221,28221,28224,0,3,3
8113,3,2,28224,28224,28226,0,2,0
8114,5,2,28229,28229,28231,0,2,3
8115,4,3,28233,28233,28236,0,3,2
8116,2,2,28235,28236,28238,1,3,0
8117,4,1,28239,28239,28240,0,1,1
8118,1,3,28240,28240,28243,0,3,0
8119,3,2,28243,28243,28245,0,2,0
8120,6,3,28249,28249,28252,0,3,4
8121,5,3,28254,28254,28257,0,3,2
8122,3,3,28257,28257,28260,0,3,0
8123,3,3,28260,28260,28263,0,3,0
8124,3,2,28263,28263,28265,0,2,0
8125,5,1,28268,28268,28269,0,1,3
8126,2,2,28270,28270,28272,0,2,1
8127,5,3,28275,28275,28278,0,3,3
8128,4,1,28279,28279,28280,0,1,1
8129,5,3,28284,28284,28287,0,3,4
8130,3,2,28287,28287,28289,0,2,0
8131,4,2,28291,28291,28293,0,2,2
8132,4,2,28295,28295,28297,0,2,2
8133,5,2,28300,28300,28302,0,2,3
8134,6,2,28306,28306,28308,0,2,4
8135,1,1,28307,28308,28309,1,2,0
8136,2,3,28309,28309,28312,0,3,0
8137,5,2,28314,28314,28316,0,2,2
8138,5,2,28319,28319,28321,0,2,3
8139,2,3,28321,28321,28324,0,3,0
8140,2,1,28323,28324,28325,1,2,0
8141,3,2,28326,28326,28328,0,2,1
8142,6,3,28332,28332,28335,0,3,4
8143,6,2,28338,28338,28340,0,2,3
8144,6,3,28344,28344,28347,0,3,4
8145,2,3,28346,28347,28350,1,4,0
8146,5,1,28351,28351,28352,0,1,1
8147,1,1,28352,28352,28353,0,1,0
8148,2,1,28354,28354,28355,0,1,1
8149,1,1,28355,28355,28356,0,1,0
8150,5,1,28360,28360,28361,0,1,4
8151,1,2,28361,28361,28363,0,2,0
8152,5,3,28366,28366,28369,0,3,3
8153,2,3,28368,28369,28372,1,4,0
8154,1,3,28369,28372,28375,3,6,0
8155,6,3,28375,28375,28378,0,3,0
8156,2,3,28377,28378,28381,1,4,0
8157,2,2,28379,28381,28383,2,4,0
8158,5,2,28384,28384,28386,0,2,1
8159,4,1,28388,28388,28389,0,1,2
8160,4,3,28392,28392,28395,0,3,3
8161,5,3,28397,28397,28400,0,3,2
8162,2,1,28399,28400,28401,1,2,0
8163,4,1,28403,28403,28404,0,1,2
8164,1,3,28404,28404,28407,0,3,0
8165,3,3,28407,28407,28410,0,3,0
8166,2,3,28409,28410,28413,1,4,0
8167,2,1,28411,28413,28414,2,3,0
8168,5,2,28416,28416,28418,0,2,2
8169,4,3,28420,28420,28423,0,3,2
8170,4,1,28424,28424,28425,0,1,1
8171,1,1,28425,28425,28426,0,1,0
8172,4,3,28429,28429,28432,0,3,3
8173,3,1,28432,28432,28433,0,1,0
8174,5,3,28437,28437,28440,0,3,4
8175,1,3,28438,28440,28443,2,5,0
8176,1,3,28439,28443,28446,4,7,0
8177,4,1,28443,28446,28447,3,4,0
8178,1,2,28444,28447,28449,3,5,0
8179,1,1,28445,28449,28450,4,5,0
8180,4,1,28449,28450,28451,1,2,0
8181,1,1,28450,28451,28452,1,2,0
8182,6,2,28456,28456,28458,0,2,4
8183,3,1,28459,28459,28460,0,1,1
8184,4,2,28463,28463,28465,0,2,3
8185,2,1,28465,28465,28466,0,1,0
8186,1,1,28466,28466,28467,0,1,0
8187,4,2,28470,28470,28472,0,2,3
8188,3,2,28473,28473,28475,0,2,1
8189,5,2,28478,28478,28480,0,2,3
8190,3,1,28481,28481,28482,0,1,1
8191,1,3,28482,28482,28485,0,3,0
8192,2,3,28484,28485,28488,1,4,0
8193,6,1,28490,28490,28491,0,1,2
8194,4,3,28494,28494,28497,0,3,3
8195,2,2,28496,28497,28499,1,3,0
8196,1,1,28497,28499,28500,2,3,0
8197,4,3,28501,28501,28504,0,3,1
8198,3,1,28504,28504,28505,0,1,0
8199,6,1,28510,28510,28511,0,1,5
8200,5,2,28515,28515,28517,0,2,4
8201,3,3,28518,28518,28521,0,3,1
8202,2,1,28520,28521,28522,1,2,0
8203,3,3,28523,28523,28526,0,3,1
8204,3,1,28526,28526,28527,0,1,0
8205,3,1,28529,28529,28530,0,1,2
8206,6,2,28535,28535,28537,0,2,5
8207,1,1,28536,28537,28538,1,2,0
8208,4,1,28540,28540,28541,0,1,2
8209,2,1,28542,28542,28543,0,1,1
8210,2,1,28544,28544,28545,0,1,1
8211,5,3,28549,28549,28552,0,3,4
8212,1,2,28550,28552,28554,2,4,0
8213,1,2,28551,28554,28556,3,5,0
8214,5,2,28556,28556,28558,0,2,0
8215,4,1,28560,28560,28561,0,1,2
8216,1,3,28561,28561,28564,0,3,0
8217,4,1,28565,28565,28566,0,1,1
8218,2,3,28567,28567,28570,0,3,1
8219,6,1,28573,28573,28574,0,1,3
8220,1,3,28574,28574,28577,0,3,0
8221,2,2,28576,28577,28579,1,3,0
8222,4,3,28580,28580,28583,0,3,1
8223,2,2,28582,28583,28585,1,3,0
8224,5,2,28587,28587,28589,0,2,2
8225,3,3,28590,28590,28593,0,3,1
8226,4,3,28594,28594,28597,0,3,1
8227,2,2,28596,28597,28599,1,3,0
8228,1,3,28597,28599,28602,2,5,0
8229,1,2,28598,28602,28604,4,6,0
8230,4,2,28602,28604,28606,2,4,0
8231,6,1,28608,28608,28609,0,1,2
8232,3,1,28611,28611,28612,0,1,2
8233,3,2,28614,28614,28616,0,2,2
8234,6,2,28620,28620,28622,0,2,4
8235,2,3,28622,28622,28625,0,3,0
8236,3,2,28625,28625,28627,0,2,0
8237,3,1,28628,28628,28629,0,1,1
8238,3,1,28631,28631,28632,0,1,2
8239,3,1,28634,28634,28635,0,1,2
8240,3,2,28637,28637,28639,0,2,2
8241,2,3,28639,28639,28642,0,3,0
8242,1,1,28640,28642,28643,2,3,0
8243,2,2,28642,28643,28645,1,3,0
8244,5,1,28647,28647,28648,0,1,2
8245,2,1,28649,28649,28650,0,1,1
8246,1,2,28650,28650,28652,0,2,0
8247,6,2,28656,28656,28658,0,2,4
8248,1,3,28657,28658,28661,1,4,0
8249,5,2,28662,28662,28664,0,2,1
8250,1,1,28663,28664,28665,1,2,0
8251,2,3,28665,28665,28668,0,3,0
8252,6,2,28671,28671,28673,0,2,3
8253,6,2,28677,28677,28679,0,2,4
8254,1,1,28678,28679,28680,1,2,0
8255,6,3,28684,28684,28687,0,3,4
8256,5,1,28689,28689,28690,0,1,2
8257,1,1,28690,28690,28691,0,1,0
8258,3,2,28693,28693,28695,0,2,2
8259,2,3,28695,28695,28698,0,3,0
8260,6,3,28701,28701,28704,0,3,3
8261,6,1,28707,28707,28708,0,1,3
8262,3,2,28710,28710,28712,0,2,2
8263,6,2,28716,28716,28718,0,2,4
8264,4,2,28720,28720,28722,0,2,2
8265,3,1,28723,28723,28724,0,1,1
8266,5,2,28728,28728,28730,0,2,4
8267,2,1,28730,28730,28731,0,1,0
8268,6,1,28736,28736,28737,0,1,5
8269,2,2,28738,28738,28740,0,2,1
8270,5,2,28743,28743,28745,0,2,3
8271,3,3,28746,28746,28749,0,3,1
8272,5,3,28751,28751,28754,0,3,2
8273,4,1,28755,28755,28756,0,1,1
8274,1,1,28756,28756,28757,0,1,0
8275,2,3,28758,28758,28761,0,3,1
8276,5,1,28763,28763,28764,0,1,2
8277,1,2,28764,28764,28766,0,2,0
8278,2,3,28766,28766,28769,0,3,0
8279,5,1,28771,28771,28772,0,1,2
8280,4,3,28775,28775,28778,0,3,3
8281,3,2,28778,28778,28780,0,2,0
8282,5,2,28783,28783,28785,0,2,3
8283,6,3,28789,28789,28792,0,3,4
8284,2,3,28791,28792,28795,1,4,0
8285,4,2,28795,28795,28797,0,2,0
8286,1,1,28796,28797,28798,1,2,0
8287,1,1,28797,28798,28799,1,2,0
8288,6,2,28803,28803,28805,0,2,4
8289,5,3,28808,28808,28811,0,3,3
8290,3,2,28811,28811,28813,0,2,0
8291,3,3,28814,28814,28817,0,3,1
8292,2,3,28816,28817,28820,1,4,0
8293,2,3,28818,28820,28823,2,5,0
8294,4,1,28822,28823,28824,1,2,0
8295,3,2,28825,28825,28827,0,2,1
8296,4,3,28829,28829,28832,0,3,2
8297,1,2,28830,28832,28834,2,4,0
8298,3,3,28833,28834,28837,1,4,0
8299,4,1,28837,28837,28838,0,1,0
8300,4,2,28841,28841,28843,0,2,3
8301,1,1,28842,28843,28844,1,2,0
8302,6,1,28848,28848,28849,0,1,4
8303,1,1,28849,28849,28850,0,1,0
8304,3,3,28852,28852,28855,0,3,2
8305,6,1,28858,28858,28859,0,1,3
8306,4,1,28862,28862,28863,0,1,3
8307,2,2,28864,28864,28866,0,2,1
8308,4,2,28868,28868,28870,0,2,2
8309,5,3,28873,28873,28876,0,3,3
8310,2,1,28875,28876,28877,1,2,0
8311,3,3,28878,28878,28881,0,3,1
8312,3,1,28881,28881,28882,0,1,0
8313,4,3,28885,28885,28888,0,3,3
8314,5,2,28890,28890,28892,0,2,2
8315,1,1,28891,28892,28893,1,2,0
8316,1,1,28892,28893,28894,1,2,0
8317,1,1,28893,28894,28895,1,2,0
8318,1,2,28894,28895,28897,1,3,0
8319,3,3,28897,28897,28900,0,3,0
8320,4,2,28901,28901,28903,0,2,1
8321,5,3,28906,28906,28909,0,3,3
8322,5,3,28911,28911,28914,0,3,2
8323,2,1,28913,28914,28915,1,2,0
8324,6,1,28919,28919,28920,0,1,4
8325,2,3,28921,28921,28924,0,3,1
8326,1,3,28922,28924,28927,2,5,0
8327,6,1,28928,28928,28929,0,1,1
8328,3,2,28931,28931,28933,0,2,2
8329,2,1,28933,28933,28934,0,1,0
8330,4,2,28937,28937,28939,0,2,3
8331,4,1,28941,28941,28942,0,1,2
8332,6,1,28947,28947,28948,0,1,5
8333,5,1,28952,28952,28953,0,1,4
8334,1,3,28953,28953,28956,0,3,0
8335,4,3,28957,28957,28960,0,3,1
8336,6,3,28963,28963,28966,0,3,3
8337,1,1,28964,28966,28967,2,3,0
8338,6,3,28970,28970,28973,0,3,3
8339,1,3,28971,28973,28976,2,5,0
8340,1,2,28972,28976,28978,4,6,0
8341,2,2,28974,28978,28980,4,6,0
8342,6,2,28980,28980,28982,0,2,0
8343,2,1,28982,28982,28983,0,1,0
8344,4,2,28986,28986,28988,0,2,3
8345,6,1,28992,28992,28993,0,1,4
8346,5,2,28997,28997,28999,0,2,4
8347,3,1,29000,29000,29001,0,1,1
8348,3,1,29003,29003,29004,0,1,2
8349,3,3,29006,29006,29009,0,3,2
8350,4,1,29010,29010,29011,0,1,1
8351,3,1,29013,29013,29014,0,1,2
8352,1,3,29014,29014,29017,0,3,0
8353,1,2,29015,29017,29019,2,4,0
8354,2,3,29017,29019,29022,2,5,0
8355,5,3,29022,29022,29025,0,3,0
8356,1,1,29023,29025,29026,2,3,0
8357,3,2,29026,29026,29028,0,2,0
8358,6,2,29032,29032,29034,0,2,4
8359,4,1,29036,29036,29037,0,1,2
8360,1,3,29037,29037,29040,0,3,0
8361,5,2,29042,29042,29044,0,2,2
8362,1,2,29043,29044,29046,1,3,0
8363,3,1,29046,29046,29047,0,1,0
8364,4,2,29050,29050,29052,0,2,3
8365,1,1,29051,29052,29053,1,2,0
8366,6,2,29057,29057,29059,0,2,4
8367,2,1,29059,29059,29060,0,1,0
8368,6,3,29065,29065,29068,0,3,5
8369,3,2,29068,29068,29070,0,2,0
8370,6,2,29074,29074,29076,0,2,4
8371,6,1,29080,29080,29081,0,1,4
8372,2,2,29082,29082,29084,0,2,1
8373,5,2,29087,29087,29089,0,2,3
8374,5,3,29092,29092,29095,0,3,3
8375,4,1,29096,29096,29097,0,1,1
8376,4,3,29100,29100,29103,0,3,3
8377,1,3,29101,29103,29106,2,5,0
8378,6,3,29107,29107,29110,0,3,1
8379,3,2,29110,29110,29112,0,2,0
8380,4,2,29114,29114,29116,0,2,2
8381,1,1,29115,29116,29117,1,2,0
8382,4,1,29119,29119,29120,0,1,2
8383,5,3,29124,29124,29127,0,3,4
8384,4,3,29128,29128,29131,0,3,1
8385,6,3,29134,29134,29137,0,3,3
8386,2,3,29136,29137,29140,1,4,0
8387,5,2,29141,29141,29143,0,2,1
8388,4,1,29145,29145,29146,0,1,2
8389,6,3,29151,29151,29154,0,3,5
8390,2,2,29153,29154,29156,1,3,0
8391,1,2,29154,29156,29158,2,4,0
8392,6,3,29160,29160,29163,0,3,2
8393,6,1,29166,29166,29167,0,1,3
8394,4,2,29170,29170,29172,0,2,3
8395,2,2,29172,29172,29174,0,2,0
8396,1,3,29173,29174,29177,1,4,0
8397,3,1,29176,29177,29178,1,2,0
8398,4,3,29180,29180,29183,0,3,2
8399,4,2,29184,29184,29186,0,2,1
8400,1,2,29185,29186,29188,1,3,0
8401,3,3,29188,29188,29191,0,3,0
8402,6,3,29194,29194,29197,0,3,3
8403,6,3,29200,29200,29203,0,3,3
8404,4,3,29204,29204,29207,0,3,1
8405,2,1,29206,29207,29208,1,2,0
8406,5,1,29211,29211,29212,0,1,3
8407,1,2,29212,29212,29214,0,2,0
8408,4,1,29216,29216,29217,0,1,2
8409,4,1,29220,29220,29221,0,1,3
8410,3,2,29223,29223,29225,0,2,2
8411,4,2,29227,29227,29229,0,2,2
8412,3,2,29230,29230,29232,0,2,1
8413,4,2,29234,29234,29236,0,2,2
8414,2,1,29236,29236,29237,0,1,0
8415,3,3,29239,29239,29242,0,3,2
8416,2,2,29241,29242,29244,1,3,0
8417,5,1,29246,29246,29247,0,1,2
8418,2,1,29248,29248,29249,0,1,1
8419,3,2,29251,29251,29253,0,2,2
8420,5,2,29256,29256,29258,0,2,3
8421,6,2,29262,29262,29264,0,2,4
8422,5,1,29267,29267,29268,0,1,3
8423,3,2,29270,29270,29272,0,2,2
8424,6,1,29276,29276,29277,0,1,4
8425,3,2,29279,29279,29281,0,2,2
8426,6,3,29285,29285,29288,0,3,4
8427,2,2,29287,29288,29290,1,3,0
8428,2,3,29289,29290,29293,1,4,0
8429,6,3,29295,29295,29298,0,3,2
8430,3,2,29298,29298,29300,0,2,0
8431,1,2,29299,29300,29302,1,3,0
8432,4,1,29303,29303,29304,0,1,1
8433,3,3,29306,29306,29309,0,3,2
8434,1,3,29307,29309,29312,2,5,0
8435,6,1,29313,29313,29314,0,1,1
8436,2,3,29315,29315,29318,0,3,1
8437,6,2,29321,29321,29323,0,2,3
8438,4,3,29325,29325,29328,0,3,2
8439,4,2,29329,29329,29331,0,2,1
8440,5,3,29334,29334,29337,0,3,3
8441,3,3,29337,29337,29340,0,3,0
8442,2,1,29339,29340,29341,1,2,0
8443,1,3,29340,29341,29344,1,4,0
8444,4,1,29344,29344,29345,0,1,0
8445,1,2,29345,29345,29347,0,2,0
8446,3,2,29348,29348,29350,0,2,1
8447,1,2,29349,29350,29352,1,3,0
8448,4,1,29353,29353,29354,0,1,1
8449,3,2,29356,29356,29358,0,2,2
8450,3,2,29359,29359,29361,0,2,1
8451,3,1,29362,29362,29363,0,1,1
8452,6,1,29368,29368,29369,0,1,5
8453,1,2,29369,29369,29371,0,2,0
8454,5,2,29374,29374,29376,0,2,3
8455,1,3,29375,29376,29379,1,4,0
8456,6,3,29381,29381,29384,0,3,2
8457,1,1,29382,29384,29385,2,3,0
8458,4,2,29386,29386,29388,0,2,1
8459,4,3,29390,29390,29393,0,3,2
8460,1,3,29391,29393,29396,2,5,0
8461,2,3,29393,29396,29399,3,6,0
8462,5,2,29398,29399,29401,1,3,0
8463,3,3,29401,29401,29404,0,3,0
8464,6,1,29407,29407,29408,0,1,3
8465,3,1,29410,29410,29411,0,1,2
8466,3,3,29413,29413,29416,0,3,2
8467,3,2,29416,29416,29418,0,2,0
8468,6,3,29422,29422,29425,0,3,4
8469,5,1,29427,29427,29428,0,1,2
8470,2,1,29429,29429,29430,0,1,1
8471,5,2,29434,29434,29436,0,2,4
8472,2,2,29436,29436,29438,0,2,0
8473,2,3,29438,29438,29441,0,3,0
8474,3,3,29441,29441,29444,0,3,0
8475,6,3,29447,29447,29450,0,3,3
8476,4,1,29451,29451,29452,0,1,1
8477,1,3,29452,29452,29455,0,3,0
8478,1,3,29453,29455,29458,2,5,0
8479,4,2,29457,29458,29460,1,3,0
8480,5,3,29462,29462,29465,0,3,2
8481,2,1,29464,29465,29466,1,2,0
8482,3,2,29467,29467,29469,0,2,1
8483,4,1,29471,29471,29472,0,1,2
8484,3,2,29474,29474,29476,0,2,2
8485,5,3,29479,29479,29482,0,3,3
8486,5,2,29484,29484,29486,0,2,2
8487,6,3,29490,29490,29493,0,3,4
8488,6,2,29496,29496,29498,0,2,3
8489,1,3,29497,29498,29501,1,4,0
8490,1,2,29498,29501,29503,3,5,0
8491,6,1,29504,29504,29505,0,1,1
8492,6,1,29510,29510,29511,0,1,5
8493,6,1,29516,29516,29517,0,1,5
8494,6,1,29522,29522,29523,0,1,5
8495,4,3,29526,29526,29529,0,3,3
8496,5,3,29531,29531,29534,0,3,2
8497,4,2,29535,29535,29537,0,2,1
8498,6,2,29541,29541,29543,0,2,4
8499,5,2,29546,29546,29548,0,2,3
8500,4,2,29550,29550,29552,0,2,2
8501,5,2,29555,29555,29557,0,2,3
8502,1,1,29556,29557,29558,1,2,0
8503,2,1,29558,29558,29559,0,1,0
8504,4,2,29562,29562,29564,0,2,3
8505,2,2,29564,29564,29566,0,2,0
8506,4,2,29568,29568,29570,0,2,2
8507,5,1,29573,29573,29574,0,1,3
8508,2,1,29575,29575,29576,0,1,1
8509,2,2,29577,29577,29579,0,2,1
8510,6,2,29583,29583,29585,0,2,4
8511,6,2,29589,29589,29591,0,2,4
8512,4,1,29593,29593,29594,0,1,2
8513,5,1,29598,29598,29599,0,1,4
8514,6,1,29604,29604,29605,0,1,5
8515,2,3,29606,29606,29609,0,3,1
8516,4,2,29610,29610,29612,0,2,1
8517,2,1,29612,29612,29613,0,1,0
8518,5,1,29617,29617,29618,0,1,4
8519,5,2,29622,29622,29624,0,2,4
8520,4,3,29626,29626,29629,0,3,2
8521,4,1,29630,29630,29631,0,1,1
8522,1,1,29631,29631,29632,0,1,0
8523,6,3,29637,29637,29640,0,3,5
8524,3,2,29640,29640,29642,0,2,0
8525,4,3,29644,29644,29647,0,3,2
8526,6,1,29650,29650,29651,0,1,3
8527,3,3,29653,29653,29656,0,3,2
8528,2,1,29655,29656,29657,1,2,0
8529,3,1,29658,29658,29659,0,1,1
8530,2,1,29660,29660,29661,0,1,1
8531,1,3,29661,29661,29664,0,3,0
8532,3,1,29664,29664,29665,0,1,0
8533,6,1,29670,29670,29671,0,1,5
8534,2,3,29672,29672,29675,0,3,1
8535,3,1,29675,29675,29676,0,1,0
8536,3,3,29678,29678,29681,0,3,2
8537,1,3,29679,29681,29684,2,5,0
8538,6,2,29685,29685,29687,0,2,1
8539,3,2,29688,29688,29690,0,2,1
8540,1,3,29689,29690,29693,1,4,0
8541,4,3,29693,29693,29696,0,3,0
8542,1,1,29694,29696,29697,2,3,0
8543,5,3,29699,29699,29702,0,3,2
8544,6,2,29705,29705,29707,0,2,3
8545,3,2,29708,29708,29710,0,2,1
8546,3,3,29711,29711,29714,0,3,1
8547,1,2,29712,29714,29716,2,4,0
8548,6,2,29718,29718,29720,0,2,2
8549,6,2,29724,29724,29726,0,2,4
8550,1,2,29725,29726,29728,1,3,0
8551,6,2,29731,29731,29733,0,2,3
8552,6,1,29737,29737,29738,0,1,4
8553,6,2,29743,29743,29745,0,2,5
8554,2,1,29745,29745,29746,0,1,0
8555,1,3,29746,29746,29749,0,3,0
8556,5,1,29751,29751,29752,0,1,2
8557,5,2,29756,29756,29758,0,2,4
8558,3,2,29759,29759,29761,0,2,1
8559,4,1,29763,29763,29764,0,1,2
8560,3,2,29766,29766,29768,0,2,2
8561,6,3,29772,29772,29775,0,3,4
8562,3,2,29775,29775,29777,0,2,0
8563,4,3,29779,29779,29782,0,3,2
8564,6,3,29785,29785,29788,0,3,3
8565,5,3,29790,29790,29793,0,3,2
8566,1,1,29791,29793,29794,2,3,0
8567,4,1,29795,29795,29796,0,1,1
8568,1,3,29796,29796,29799,0,3,0
8569,3,2,29799,29799,29801,0,2,0
8570,6,3,29805,29805,29808,0,3,4
8571,6,2,29811,29811,29813,0,2,3
8572,5,2,29816,29816,29818,0,2,3
8573,1,1,29817,29818,29819,1,2,0
8574,6,2,29823,29823,29825,0,2,4
8575,1,1,29824,29825,29826,1,2,0
8576,4,2,29828,29828,29830,0,2,2
8577,1,2,29829,29830,29832,1,3,0
8578,6,2,29835,29835,29837,0,2,3
8579,1,1,29836,29837,29838,1,2,0
8580,5,1,29841,29841,29842,0,1,3
8581,4,1,29845,29845,29846,0,1,3
8582,2,3,29847,29847,29850,0,3,1
8583,4,1,29851,29851,29852,0,1,1
8584,3,1,29854,29854,29855,0,1,2
8585,5,3,29859,29859,29862,0,3,4
8586,5,1,29864,29864,29865,0,1,2
8587,4,3,29868,29868,29871,0,3,3
8588,1,3,29869,29871,29874,2,5,0
8589,4,1,29873,29874,29875,1,2,0
8590,2,3,29875,29875,29878,0,3,0
8591,2,1,29877,29878,29879,1,2,0
8592,2,2,29879,29879,29881,0,2,0
8593,3,3,29882,29882,29885,0,3,1
8594,2,2,29884,29885,29887,1,3,0
8595,1,1,29885,29887,29888,2,3,0
8596,4,3,29889,29889,29892,0,3,1
8597,4,1,29893,29893,29894,0,1,1
8598,4,1,29897,29897,29898,0,1,3
8599,1,3,29898,29898,29901,0,3,0
8600,2,3,29900,29901,29904,1,4,0
8601,2,2,29902,29904,29906,2,4,0
8602,3,3,29905,29906,29909,1,4,0
8603,3,1,29908,29909,29910,1,2,0
8604,3,2,29911,29911,29913,0,2,1
8605,5,1,29916,29916,29917,0,1,3
8606,4,2,29920,29920,29922,0,2,3
8607,3,1,29923,29923,29924,0,1,1
8608,1,2,29924,29924,29926,0,2,0
8609,2,3,29926,29926,29929,0,3,0
8610,5,3,29931,29931,29934,0,3,2
8611,3,2,29934,29934,29936,0,2,0
8612,6,1,29940,29940,29941,0,1,4
8613,1,3,29941,29941,29944,0,3,0
8614,2,2,29943,29944,29946,1,3,0
8615,3,3,29946,29946,29949,0,3,0
8616,4,2,29950,29950,29952,0,2,1
8617,2,1,29952,29952,29953,0,1,0
8618,2,2,29954,29954,29956,0,2,1
8619,3,1,29957,29957,29958,0,1,1
8620,6,2,29963,29963,29965,0,2,5
8621,2,3,29965,29965,29968,0,3,0
8622,6,1,29971,29971,29972,0,1,3
8623,6,3,29977,29977,29980,0,3,5
8624,4,3,29981,29981,29984,0,3,1
8625,1,2,29982,29984,29986,2,4,0
8626,6,1,29988,29988,29989,0,1,2
8627,3,2,29991,29991,29993,0,2,2
8628,4,3,29995,29995,29998,0,3,2
8629,6,1,30001,30001,30002,0,1,3
8630,3,3,30004,30004,30007,0,3,2
8631,1,1,30005,30007,30008,2,3,0
8632,1,2,30006,30008,30010,2,4,0
8633,6,1,30012,30012,30013,0,1,2
8634,4,2,30016,30016,30018,0,2,3
8635,3,3,30019,30019,30022,0,3,1
8636,5,1,30024,30024,30025,0,1,2
8637,2,3,30026,30026,30029,0,3,1
8638,3,2,30029,30029,30031,0,2,0
8639,2,2,30031,30031,30033,0,2,0
8640,5,1,30036,30036,30037,0,1,3
8641,4,2,30040,30040,30042,0,2,3
8642,3,3,30043,30043,30046,0,3,1
8643,1,3,30044,30046,30049,2,5,0
8644,1,1,30045,30049,30050,4,5,0
8645,5,2,30050,30050,30052,0,2,0
8646,5,2,30055,30055,30057,0,2,3
8647,5,1,30060,30060,30061,0,1,3
8648,6,2,30066,30066,30068,0,2,5
8649,4,3,30070,30070,30073,0,3,2
8650,3,1,30073,30073,30074,0,1,0
8651,5,2,30078,30078,30080,0,2,4
8652,6,3,30084,30084,30087,0,3,4
8653,5,3,30089,30089,30092,0,3,2
8654,4,3,30093,30093,30096,0,3,1
8655,4,3,30097,30097,30100,0,3,1
8656,2,3,30099,30100,30103,1,4,0
8657,1,1,30100,30103,30104,3,4,0
8658,5,3,30105,30105,30108,0,3,1
8659,2,1,30107,30108,30109,1,2,0
8660,4,1,30111,30111,30112,0,1,2
8661,4,2,30115,30115,30117,0,2,3
8662,2,2,30117,30117,30119,0,2,0
8663,3,3,30120,30120,30123,0,3,1
8664,3,3,30123,30123,30126,0,3,0
8665,1,1,30124,30126,30127,2,3,0
8666,2,3,30126,30127,30130,1,4,0
8667,5,2,30131,30131,30133,0,2,1
8668,4,3,30135,30135,30138,0,3,2
8669,6,1,30141,30141,30142,0,1,3
8670,3,1,30144,30144,30145,0,1,2
8671,2,2,30146,30146,30148,0,2,1
8672,5,1,30151,30151,30152,0,1,3
8673,6,2,30157,30157,30159,0,2,5
8674,2,3,30159,30159,30162,0,3,0
8675,1,3,30160,30162,30165,2,5,0
8676,1,2,30161,30165,30167,4,6,0
8677,6,3,30167,30167,30170,0,3,0
8678,1,2,30168,30170,30172,2,4,0
8679,2,2,30170,30172,30174,2,4,0
8680,4,1,30174,30174,30175,0,1,0
8681,4,1,30178,30178,30179,0,1,3
8682,1,2,30179,30179,30181,0,2,0
8683,3,3,30182,30182,30185,0,3,1
8684,1,1,30183,30185,30186,2,3,0
8685,6,2,30189,30189,30191,0,2,3
8686,1,3,30190,30191,30194,1,4,0
8687,4,3,30194,30194,30197,0,3,0
8688,3,3,30197,30197,30200,0,3,0
8689,3,2,30200,30200,30202,0,2,0
8690,4,1,30204,30204,30205,0,1,2
8691,6,2,30210,30210,30212,0,2,5
8692,6,3,30216,30216,30219,0,3,4
8693,2,2,30218,30219,30221,1,3,0
8694,3,1,30221,30221,30222,0,1,0
8695,6,3,30227,30227,30230,0,3,5
8696,6,1,30233,30233,30234,0,1,3
8697,4,1,30237,30237,30238,0,1,3
8698,1,1,30238,30238,30239,0,1,0
8699,2,3,30240,30240,30243,0,3,1
8700,1,3,30241,30243,30246,2,5,0
8701,5,2,30246,30246,30248,0,2,0
8702,1,2,30247,30248,30250,1,3,0
8703,6,2,30253,30253,30255,0,2,3
8704,6,3,30259,30259,30262,0,3,4
8705,5,3,30264,30264,30267,0,3,2
8706,4,1,30268,30268,30269,0,1,1
8707,3,2,30271,30271,30273,0,2,2
8708,1,3,30272,30273,30276,1,4,0
8709,6,1,30278,30278,30279,0,1,2
8710,1,1,30279,30279,30280,0,1,0
8711,6,2,30285,30285,30287,0,2,5
8712,5,1,30290,30290,30291,0,1,3
8713,3,1,30293,30293,30294,0,1,2
8714,5,1,30298,30298,30299,0,1,4
8715,5,2,30303,30303,30305,0,2,4
8716,6,2,30309,30309,30311,0,2,4
8717,4,1,30313,30313,30314,0,1,2
8718,4,3,30317,30317,30320,0,3,3
8719,5,2,30322,30322,30324,0,2,2
8720,1,3,30323,30324,30327,1,4,0
8721,1,1,30324,30327,30328,3,4,0
8722,6,2,30330,30330,30332,0,2,2
8723,2,1,30332,30332,30333,0,1,0
8724,4,1,30336,30336,30337,0,1,3
8725,1,2,30337,30337,30339,0,2,0
8726,4,3,30341,30341,30344,0,3,2
8727,3,2,30344,30344,30346,0,2,0
8728,3,1,30347,30347,30348,0,1,1
8729,1,1,30348,30348,30349,0,1,0
8730,1,2,30349,30349,30351,0,2,0
8731,6,3,30355,30355,30358,0,3,4
8732,5,3,30360,30360,30363,0,3,2
8733,3,2,30363,30363,30365,0,2,0
8734,6,2,30369,30369,30371,0,2,4
8735,3,1,30372,30372,30373,0,1,1
8736,4,3,30376,30376,30379,0,3,3
8737,5,2,30381,30381,30383,0,2,2
8738,6,2,30387,30387,30389,0,2,4
8739,3,3,30390,30390,30393,0,3,1
8740,6,2,30396,30396,30398,0,2,3
8741,6,1,30402,30402,30403,0,1,4
8742,1,2,30403,30403,30405,0,2,0
8743,1,2,30404,30405,30407,1,3,0
8744,3,1,30407,30407,30408,0,1,0
8745,2,1,30409,30409,30410,0,1,1
8746,4,3,30413,30413,30416,0,3,3
8747,3,3,30416,30416,30419,0,3,0
8748,6,3,30422,30422,30425,0,3,3
8749,5,3,30427,30427,30430,0,3,2
8750,1,3,30428,30430,30433,2,5,0
8751,3,3,30431,30433,30436,2,5,0
8752,3,3,30434,30436,30439,2,5,0
8753,1,2,30435,30439,30441,4,6,0
8754,2,3,30437,30441,30444,4,7,0
8755,4,1,30441,30444,30445,3,4,0
8756,1,2,30442,30445,30447,3,5,0
8757,6,1,30448,30448,30449,0,1,1
8758,5,1,30453,30453,30454,0,1,4
8759,4,2,30457,30457,30459,0,2,3
8760,1,1,30458,30459,30460,1,2,0
8761,1,1,30459,30460,30461,1,2,0
8762,3,3,30462,30462,30465,0,3,1
8763,6,2,30468,30468,30470,0,2,3
8764,2,2,30470,30470,30472,0,2,0
8765,3,1,30473,30473,30474,0,1,1
8766,1,1,30474,30474,30475,0,1,0
8767,1,3,30475,30475,30478,0,3,0
8768,1,1,30476,30478,30479,2,3,0
8769,1,3,30477,30479,30482,2,5,0
8770,1,1,30478,30482,30483,4,5,0
8771,5,3,30483,30483,30486,0,3,0
8772,5,3,30488,30488,30491,0,3,2
8773,2,1,30490,30491,30492,1,2,0
8774,2,2,30492,30492,30494,0,2,0
8775,5,3,30497,30497,30500,0,3,3
8776,3,2,30500,30500,30502,0,2,0
8777,2,3,30502,30502,30505,0,3,0
8778,4,2,30506,30506,30508,0,2,1
8779,2,3,30508,30508,30511,0,3,0
8780,1,1,30509,30511,30512,2,3,0
8781,4,1,30513,30513,30514,0,1,1
8782,5,3,30518,30518,30521,0,3,4
8783,4,3,30522,30522,30525,0,3,1
8784,6,2,30528,30528,30530,0,2,3
8785,3,3,30531,30531,30534,0,3,1
8786,6,3,30537,30537,30540,0,3,3
8787,4,1,30541,30541,30542,0,1,1
8788,4,3,30545,30545,30548,0,3,3
8789,5,2,30550,30550,30552,0,2,2
8790,2,3,30552,30552,30555,0,3,0
8791,1,1,30553,30555,30556,2,3,0
8792,2,1,30555,30556,30557,1,2,0
8793,2,3,30557,30557,30560,0,3,0
8794,1,2,30558,30560,30562,2,4,0
8795,6,3,30564,30564,30567,0,3,2
8796,5,1,30569,30569,30570,0,1,2
8797,1,2,30570,30570,30572,0,2,0
8798,2,3,30572,30572,30575,0,3,0
8799,2,3,30574,30575,30578,1,4,0
8800,4,2,30578,30578,30580,0,2,0
8801,1,2,30579,30580,30582,1,3,0
8802,2,3,30581,30582,30585,1,4,0
8803,2,1,30583,30585,30586,2,3,0
8804,3,1,30586,30586,30587,0,1,0
8805,4,1,30590,30590,30591,0,1,3
8806,2,3,30592,30592,30595,0,3,1
8807,5,1,30597,30597,30598,0,1,2
8808,2,1,30599,30599,30600,0,1,1
8809,5,3,30604,30604,30607,0,3,4
8810,3,1,30607,30607,30608,0,1,0
8811,6,2,30613,30613,30615,0,2,5
8812,1,3,30614,30615,30618,1,4,0
8813,1,3,30615,30618,30621,3,6,0
8814,2,2,30617,30621,30623,4,6,0
8815,2,3,30619,30623,30626,4,7,0
8816,3,1,30622,30626,30627,4,5,0
8817,5,3,30627,30627,30630,0,3,0
8818,3,1,30630,30630,30631,0,1,0
8819,3,2,30633,30633,30635,0,2,2
8820,6,1,30639,30639,30640,0,1,4
8821,4,3,30643,30643,30646,0,3,3
8822,1,1,30644,30646,30647,2,3,0
8823,4,3,30648,30648,30651,0,3,1
8824,3,1,30651,30651,30652,0,1,0
8825,2,3,30653,30653,30656,0,3,1
8826,4,2,30657,30657,30659,0,2,1
8827,3,1,30660,30660,30661,0,1,1
8828,3,3,30663,30663,30666,0,3,2
8829,4,3,30667,30667,30670,0,3,1
8830,2,3,30669,30670,30673,1,4,0
8831,5,1,30674,30674,30675,0,1,1
8832,4,1,30678,30678,30679,0,1,3
8833,3,3,30681,30681,30684,0,3,2
8834,1,1,30682,30684,30685,2,3,0
8835,6,3,30688,30688,30691,0,3,3
8836,4,2,30692,30692,30694,0,2,1
8837,4,1,30696,30696,30697,0,1,2
8838,4,3,30700,30700,30703,0,3,3
8839,5,3,30705,30705,30708,0,3,2
8840,1,3,30706,30708,30711,2,5,0
8841,6,2,30712,30712,30714,0,2,1
8842,4,1,30716,30716,30717,0,1,2
8843,5,3,30721,30721,30724,0,3,4
8844,1,3,30722,30724,30727,2,5,0
8845,2,1,30724,30727,30728,3,4,0
8846,5,2,30729,30729,30731,0,2,1
8847,2,2,30731,30731,30733,0,2,0
8848,5,1,30736,30736,30737,0,1,3
8849,3,3,30739,30739,30742,0,3,2
8850,6,3,30745,30745,30748,0,3,3
8851,5,2,30750,30750,30752,0,2,2
8852,6,1,30756,30756,30757,0,1,4
8853,3,1,30759,30759,30760,0,1,2
8854,6,3,30765,30765,30768,0,3,5
8855,2,2,30767,30768,30770,1,3,0
8856,3,3,30770,30770,30773,0,3,0
8857,1,2,30771,30773,30775,2,4,0
8858,2,1,30773,30775,30776,2,3,0
8859,4,1,30777,30777,30778,0,1,1
8860,2,3,30779,30779,30782,0,3,1
8861,3,2,30782,30782,30784,0,2,0
8862,3,2,30785,30785,30787,0,2,1
8863,4,2,30789,30789,30791,0,2,2
8864,2,2,30791,30791,30793,0,2,0
8865,1,1,30792,30793,30794,1,2,0
8866,2,3,30794,30794,30797,0,3,0
8867,2,1,30796,30797,30798,1,2,0
8868,2,1,30798,30798,30799,0,1,0
8869,4,1,30802,30802,30803,0,1,3
8870,6,1,30808,30808,30809,0,1,5
8871,2,2,30810,30810,30812,0,2,1
8872,1,1,30811,30812,30813,1,2,0
8873,5,1,30816,30816,30817,0,1,3
8874,2,3,30818,30818,30821,0,3,1
8875,2,1,30820,30821,30822,1,2,0
8876,2,1,30822,30822,30823,0,1,0
8877,6,3,30828,30828,30831,0,3,5
8878,2,2,30830,30831,30833,1,3,0
8879,2,2,30832,30833,30835,1,3,0
8880,6,3,30838,30838,30841,0,3,3
8881,4,2,30842,30842,30844,0,2,1
8882,3,3,30845,30845,30848,0,3,1
8883,1,2,30846,30848,30850,2,4,0
8884,3,2,30849,30850,30852,1,3,0
8885,5,3,30854,30854,30857,0,3,2
8886,3,3,30857,30857,30860,0,3,0
8887,2,3,30859,30860,30863,1,4,0
8888,5,3,30864,30864,30867,0,3,1
8889,2,1,30866,30867,30868,1,2,0
8890,6,2,30872,30872,30874,0,2,4
8891,5,2,30877,30877,30879,0,2,3
8892,1,2,30878,30879,30881,1,3,0
8893,2,2,30880,30881,30883,1,3,0
8894,5,2,30885,30885,30887,0,2,2
8895,5,2,30890,30890,30892,0,2,3
8896,1,2,30891,30892,30894,1,3,0
8897,3,2,30894,30894,30896,0,2,0
8898,4,3,30898,30898,30901,0,3,2
8899,6,1,30904,30904,30905,0,1,3
8900,4,3,30908,30908,30911,0,3,3
8901,2,3,30910,30911,30914,1,4,0
8902,3,1,30913,30914,30915,1,2,0
8903,3,1,30916,30916,30917,0,1,1
8904,3,1,30919,30919,30920,0,1,2
8905,3,1,30922,30922,30923,0,1,2
8906,4,2,30926,30926,30928,0,2,3
8907,6,2,30932,30932,30934,0,2,4
8908,3,2,30935,30935,30937,0,2,1
8909,4,1,30939,30939,30940,0,1,2
8910,5,1,30944,30944,30945,0,1,4
8911,1,1,30945,30945,30946,0,1,0
8912,6,1,30951,30951,30952,0,1,5
8913,1,3,30952,30952,30955,0,3,0
8914,1,1,30953,30955,30956,2,3,0
8915,3,1,30956,30956,30957,0,1,0
8916,4,1,30960,30960,30961,0,1,3
8917,3,2,30963,30963,30965,0,2,2
8918,6,1,30969,30969,30970,0,1,4
8919,5,3,30974,30974,30977,0,3,4
8920,6,3,30980,30980,30983,0,3,3
8921,3,1,30983,30983,30984,0,1,0
8922,6,3,30989,30989,30992,0,3,5
8923,5,1,30994,30994,30995,0,1,2
8924,4,1,30998,30998,30999,0,1,3
8925,3,1,31001,31001,31002,0,1,2
8926,5,2,31006,31006,31008,0,2,4
8927,5,3,31011,31011,31014,0,3,3
8928,5,3,31016,31016,31019,0,3,2
8929,5,2,31021,31021,31023,0,2,2
8930,4,1,31025,31025,31026,0,1,2
8931,1,2,31026,31026,31028,0,2,0
8932,6,3,31032,31032,31035,0,3,4
8933,2,3,31034,31035,31038,1,4,0
8934,4,3,31038,31038,31041,0,3,0
8935,4,3,31042,31042,31045,0,3,1
8936,5,2,31047,31047,31049,0,2,2
8937,1,1,31048,31049,31050,1,2,0
8938,4,3,31052,31052,31055,0,3,2
8939,2,3,31054,31055,31058,1,4,0
8940,2,1,31056,31058,31059,2,3,0
8941,3,3,31059,31059,31062,0,3,0
8942,3,2,31062,31062,31064,0,2,0
8943,3,2,31065,31065,31067,0,2,1
8944,6,2,31071,31071,31073,0,2,4
8945,2,3,31073,31073,31076,0,3,0
8946,6,2,31079,31079,31081,0,2,3
8947,6,1,31085,31085,31086,0,1,4
8948,1,2,31086,31086,31088,0,2,0
8949,2,2,31088,31088,31090,0,2,0
8950,6,3,31094,31094,31097,0,3,4
8951,3,1,31097,31097,31098,0,1,0
8952,5,3,31102,31102,31105,0,3,4
8953,2,2,31104,31105,31107,1,3,0
8954,4,1,31108,31108,31109,0,1,1
8955,6,2,31114,31114,31116,0,2,5
8956,2,1,31116,31116,31117,0,1,0
8957,5,2,31121,31121,31123,0,2,4
8958,2,2,31123,31123,31125,0,2,0
8959,4,1,31127,31127,31128,0,1,2
8960,4,2,31131,31131,31133,0,2,3
8961,6,1,31137,31137,31138,0,1,4
8962,4,1,31141,31141,31142,0,1,3
8963,3,2,31144,31144,31146,0,2,2
8964,2,1,31146,31146,31147,0,1,0
8965,5,2,31151,31151,31153,0,2,4
8966,6,2,31157,31157,31159,0,2,4
8967,4,2,31161,31161,31163,0,2,2
8968,2,1,31163,31163,31164,0,1,0
8969,4,3,31167,31167,31170,0,3,3
8970,1,3,31168,31170,31173,2,5,0
8971,1,1,31169,31173,31174,4,5,0
8972,6,2,31175,31175,31177,0,2,1
8973,6,2,31181,31181,31183,0,2,4
8974,2,2,31183,31183,31185,0,2,0
8975,1,3,31184,31185,31188,1,4,0
8976,6,2,31190,31190,31192,0,2,2
8977,2,1,31192,31192,31193,0,1,0
8978,4,2,31196,31196,31198,0,2,3
8979,1,1,31197,31198,31199,1,2,0
8980,5,3,31202,31202,31205,0,3,3
8981,6,2,31208,31208,31210,0,2,3
8982,5,3,31213,31213,31216,0,3,3
8983,6,1,31219,31219,31220,0,1,3
8984,1,3,31220,31220,31223,0,3,0
8985,4,2,31224,31224,31226,0,2,1
8986,6,3,31230,31230,31233,0,3,4
8987,6,1,31236,31236,31237,0,1,3
8988,6,3,31242,31242,31245,0,3,5
8989,2,1,31244,31245,31246,1,2,0
8990,2,1,31246,31246,31247,0,1,0
8991,5,2,31251,31251,31253,0,2,4
8992,5,3,31256,31256,31259,0,3,3
8993,3,2,31259,31259,31261,0,2,0
8994,5,3,31264,31264,31267,0,3,3
8995,1,2,31265,31267,31269,2,4,0
8996,4,3,31269,31269,31272,0,3,0
8997,4,1,31273,31273,31274,0,1,1
8998,1,1,31274,31274,31275,0,1,0
8999,6,1,31280,31280,31281,0,1,5
9000,6,1,31286,31286,31287,0,1,5
9001,2,2,31288,31288,31290,0,2,1
9002,1,1,31289,31290,31291,1,2,0
9003,4,2,31293,31293,31295,0,2,2
9004,6,2,31299,31299,31301,0,2,4
9005,2,2,31301,31301,31303,0,2,0
9006,2,3,31303,31303,31306,0,3,0
9007,1,1,31304,31306,31307,2,3,0
9008,1,3,31305,31307,31310,2,5,0
9009,4,3,31309,31310,31313,1,4,0
9010,3,2,31312,31313,31315,1,3,0
9011,1,3,31313,31315,31318,2,5,0
9012,5,3,31318,31318,31321,0,3,0
9013,3,3,31321,31321,31324,0,3,0
9014,4,1,31325,31325,31326,0,1,1
9015,1,3,31326,31326,31329,0,3,0
9016,5,2,31331,31331,31333,0,2,2
9017,3,2,31334,31334,31336,0,2,1
9018,6,3,31340,31340,31343,0,3,4
9019,3,3,31343,31343,31346,0,3,0
9020,5,2,31348,31348,31350,0,2,2
9021,4,2,31352,31352,31354,0,2,2
9022,3,2,31355,31355,31357,0,2,1
9023,1,2,31356,31357,31359,1,3,0
9024,2,2,31358,31359,31361,1,3,0
9025,5,1,31363,31363,31364,0,1,2
9026,2,1,31365,31365,31366,0,1,1
9027,3,3,31368,31368,31371,0,3,2
9028,6,3,31374,31374,31377,0,3,3
9029,4,2,31378,31378,31380,0,2,1
9030,5,1,31383,31383,31384,0,1,3
9031,5,3,31388,31388,31391,0,3,4
9032,3,2,31391,31391,31393,0,2,0
9033,6,1,31397,31397,31398,0,1,4
9034,3,2,31400,31400,31402,0,2,2
9035,2,3,31402,31402,31405,0,3,0
9036,2,3,31404,31405,31408,1,4,0
9037,4,1,31408,31408,31409,0,1,0
9038,6,2,31414,31414,31416,0,2,5
9039,2,3,31416,31416,31419,0,3,0
9040,1,2,31417,31419,31421,2,4,0
9041,5,1,31422,31422,31423,0,1,1
9042,1,1,31423,31423,31424,0,1,0
9043,3,1,31426,31426,31427,0,1,2
9044,2,2,31428,31428,31430,0,2,1
9045,3,1,31431,31431,31432,0,1,1
9046,6,1,31437,31437,31438,0,1,5
9047,6,1,31443,31443,31444,0,1,5
9048,1,1,31444,31444,31445,0,1,0
9049,4,2,31448,31448,31450,0,2,3
9050,3,1,31451,31451,31452,0,1,1
9051,3,1,31454,31454,31455,0,1,2
9052,1,3,31455,31455,31458,0,3,0
9053,1,2,31456,31458,31460,2,4,0
9054,1,2,31457,31460,31462,3,5,0
9055,1,3,31458,31462,31465,4,7,0
9056,1,1,31459,31465,31466,6,7,0
9057,6,1,31465,31466,31467,1,2,0
9058,4,1,31469,31469,31470,0,1,2
9059,6,1,31475,31475,31476,0,1,5
9060,5,1,31480,31480,31481,0,1,4
9061,5,3,31485,31485,31488,0,3,4
9062,2,3,31487,31488,31491,1,4,0
9063,5,3,31492,31492,31495,0,3,1
9064,6,1,31498,31498,31499,0,1,3
9065,1,2,31499,31499,31501,0,2,0
9066,4,2,31503,31503,31505,0,2,2
9067,3,3,31506,31506,31509,0,3,1
9068,5,3,31511,31511,31514,0,3,2
9069,2,1,31513,31514,31515,1,2,0
9070,3,2,31516,31516,31518,0,2,1
9071,5,1,31521,31521,31522,0,1,3
9072,3,3,31524,31524,31527,0,3,2
9073,5,3,31529,31529,31532,0,3,2
9074,1,2,31530,31532,31534,2,4,0
9075,5,1,31535,31535,31536,0,1,1
9076,5,3,31540,31540,31543,0,3,4
9077,4,1,31544,31544,31545,0,1,1
9078,6,2,31550,31550,31552,0,2,5
9079,5,1,31555,31555,31556,0,1,3
9080,4,2,31559,31559,31561,0,2,3
9081,5,2,31564,31564,31566,0,2,3
9082,5,1,31569,31569,31570,0,1,3
9083,1,3,31570,31570,31573,0,3,0
9084,4,1,31574,31574,31575,0,1,1
9085,3,1,31577,31577,31578,0,1,2
9086,4,3,31581,31581,31584,0,3,3
9087,1,1,31582,31584,31585,2,3,0
9088,3,1,31585,31585,31586,0,1,0
9089,4,2,31589,31589,31591,0,2,3
9090,4,2,31593,31593,31595,0,2,2
9091,3,1,31596,31596,31597,0,1,1
9092,3,2,31599,31599,31601,0,2,2
9093,1,2,31600,31601,31603,1,3,0
9094,3,3,31603,31603,31606,0,3,0
9095,6,2,31609,31609,31611,0,2,3
9096,5,3,31614,31614,31617,0,3,3
9097,3,1,31617,31617,31618,0,1,0
9098,1,3,31618,31618,31621,0,3,0
9099,5,2,31623,31623,31625,0,2,2
9100,3,2,31626,31626,31628,0,2,1
9101,3,2,31629,31629,31631,0,2,1
9102,5,1,31634,31634,31635,0,1,3
9103,4,1,31638,31638,31639,0,1,3
9104,3,3,31641,31641,31644,0,3,2
9105,3,3,31644,31644,31647,0,3,0
9106,4,2,31648,31648,31650,0,2,1
9107,3,1,31651,31651,31652,0,1,1
9108,5,2,31656,31656,31658,0,2,4
9109,1,2,31657,31658,31660,1,3,0
9110,1,2,31658,31660,31662,2,4,0
9111,5,3,31663,31663,31666,0,3,1
9112,1,3,31664,31666,31669,2,5,0
9113,3,3,31667,31669,31672,2,5,0
9114,4,2,31671,31672,31674,1,3,0
9115,1,3,31672,31674,31677,2,5,0
9116,5,3,31677,31677,31680,0,3,0
9117,6,2,31683,31683,31685,0,2,3
9118,3,2,31686,31686,31688,0,2,1
9119,5,1,31691,31691,31692,0,1,3
9120,4,2,31695,31695,31697,0,2,3
9121,2,2,31697,31697,31699,0,2,0
9122,1,3,31698,31699,31702,1,4,0
9123,3,3,31701,31702,31705,1,4,0
9124,4,1,31705,31705,31706,0,1,0
9125,3,3,31708,31708,31711,0,3,2
9126,6,1,31714,31714,31715,0,1,3
9127,2,2,31716,31716,31718,0,2,1
9128,6,3,31722,31722,31725,0,3,4
9129,4,1,31726,31726,31727,0,1,1
9130,6,3,31732,31732,31735,0,3,5
9131,3,2,31735,31735,31737,0,2,0
9132,2,2,31737,31737,31739,0,2,0
9133,6,1,31743,31743,31744,0,1,4
9134,6,3,31749,31749,31752,0,3,5
9135,1,3,31750,31752,31755,2,5,0
9136,1,3,31751,31755,31758,4,7,0
9137,2,1,31753,31758,31759,5,6,0
9138,3,1,31756,31759,31760,3,4,0
9139,1,1,31757,31760,31761,3,4,0
9140,6,1,31763,31763,31764,0,1,2
9141,3,3,31766,31766,31769,0,3,2
9142,3,1,31769,31769,31770,0,1,0
9143,5,1,31774,31774,31775,0,1,4
9144,1,2,31775,31775,31777,0,2,0
9145,6,2,31781,31781,31783,0,2,4
9146,6,1,31787,31787,31788,0,1,4
9147,2,3,31789,31789,31792,0,3,1
9148,4,1,31793,31793,31794,0,1,1
9149,5,2,31798,31798,31800,0,2,4
9150,6,1,31804,31804,31805,0,1,4
9151,1,3,31805,31805,31808,0,3,0
9152,4,3,31809,31809,31812,0,3,1
9153,4,3,31813,31813,31816,0,3,1
9154,2,1,31815,31816,31817,1,2,0
9155,6,1,31821,31821,31822,0,1,4
9156,3,3,31824,31824,31827,0,3,2
9157,6,3,31830,31830,31833,0,3,3
9158,1,3,31831,31833,31836,2,5,0
9159,3,3,31834,31836,31839,2,5,0
9160,2,3,31836,31839,31842,3,6,0
9161,6,2,31842,31842,31844,0,2,0
9162,1,3,31843,31844,31847,1,4,0
9163,2,2,31845,31847,31849,2,4,0
9164,4,2,31849,31849,31851,0,2,0
9165,2,3,31851,31851,31854,0,3,0
9166,5,1,31856,31856,31857,0,1,2
9167,1,1,31857,31857,31858,0,1,0
9168,3,1,31860,31860,31861,0,1,2
9169,3,1,31863,31863,31864,0,1,2
9170,3,1,31866,31866,31867,0,1,2
9171,6,3,31872,31872,31875,0,3,5
9172,5,2,31877,31877,31879,0,2,2
9173,1,2,31878,31879,31881,1,3,0
9174,3,3,31881,31881,31884,0,3,0
9175,6,3,31887,31887,31890,0,3,3
9176,4,3,31891,31891,31894,0,3,1
9177,6,2,31897,31897,31899,0,2,3
9178,3,1,31900,31900,31901,0,1,1
9179,5,3,31905,31905,31908,0,3,4
9180,5,2,31910,31910,31912,0,2,2
9181,4,3,31914,31914,31917,0,3,2
9182,5,3,31919,31919,31922,0,3,2
9183,5,2,31924,31924,31926,0,2,2
9184,4,1,31928,31928,31929,0,1,2
9185,1,1,31929,31929,31930,0,1,0
9186,5,1,31934,31934,31935,0,1,4
9187,6,3,31940,31940,31943,0,3,5
9188,5,3,31945,31945,31948,0,3,2
9189,6,3,31951,31951,31954,0,3,3
9190,1,2,31952,31954,31956,2,4,0
9191,1,3,31953,31956,31959,3,6,0
9192,4,1,31957,31959,31960,2,3,0
9193,4,2,31961,31961,31963,0,2,1
9194,2,3,31963,31963,31966,0,3,0
9195,1,2,31964,31966,31968,2,4,0
9196,4,1,31968,31968,31969,0,1,0
9197,1,3,31969,31969,31972,0,3,0
9198,4,2,31973,31973,31975,0,2,1
9199,6,3,31979,31979,31982,0,3,4
9200,6,3,31985,31985,31988,0,3,3
9201,4,3,31989,31989,31992,0,3,1
9202,4,2,31993,31993,31995,0,2,1
9203,3,1,31996,31996,31997,0,1,1
9204,2,2,31998,31998,32000,0,2,1
9205,3,2,32001,32001,32003,0,2,1
9206,4,3,32005,32005,32008,0,3,2
9207,1,2,32006,32008,32010,2,4,0
9208,2,3,32008,32010,32013,2,5,0
9209,2,1,32010,32013,32014,3,4,0
9210,2,1,32012,32014,32015,2,3,0
9211,6,2,32018,32018,32020,0,2,3
9212,5,1,32023,32023,32024,0,1,3
9213,2,3,32025,32025,32028,0,3,1
9214,5,2,32030,32030,32032,0,2,2
9215,3,1,32033,32033,32034,0,1,1
9216,2,3,32035,32035,32038,0,3,1
9217,3,2,32038,32038,32040,0,2,0
9218,1,3,32039,32040,32043,1,4,0
9219,5,1,32044,32044,32045,0,1,1
9220,2,3,32046,32046,32049,0,3,1
9221,5,3,32051,32051,32054,0,3,2
9222,6,3,32057,32057,32060,0,3,3
9223,1,1,32058,32060,32061,2,3,0
9224,4,3,32062,32062,32065,0,3,1
9225,5,3,32067,32067,32070,0,3,2
9226,4,2,32071,32071,32073,0,2,1
9227,2,1,32073,32073,32074,0,1,0
9228,3,3,32076,32076,32079,0,3,2
9229,4,2,32080,32080,32082,0,2,1
9230,1,3,32081,32082,32085,1,4,0
9231,4,2,32085,32085,32087,0,2,0
9232,2,2,32087,32087,32089,0,2,0
9233,4,1,32091,32091,32092,0,1,2
9234,5,1,32096,32096,32097,0,1,4
9235,3,1,32099,32099,32100,0,1,2
9236,6,3,32105,32105,32108,0,3,5
9237,3,3,32108,32108,32111,0,3,0
9238,3,3,32111,32111,32114,0,3,0
9239,3,1,32114,32114,32115,0,1,0
9240,4,3,32118,32118,32121,0,3,3
9241,3,2,32121,32121,32123,0,2,0
9242,4,1,32125,32125,32126,0,1,2
9243,1,1,32126,32126,32127,0,1,0
9244,4,3,32130,32130,32133,0,3,3
9245,2,3,32132,32133,32136,1,4,0
9246,4,1,32136,32136,32137,0,1,0
9247,5,1,32141,32141,32142,0,1,4
9248,1,3,32142,32142,32145,0,3,0
9249,6,1,32148,32148,32149,0,1,3
9250,4,2,32152,32152,32154,0,2,3
9251,4,2,32156,32156,32158,0,2,2
9252,2,3,32158,32158,32161,0,3,0
9253,2,1,32160,32161,32162,1,2,0
9254,6,3,32166,32166,32169,0,3,4
9255,2,2,32168,32169,32171,1,3,0
9256,3,3,32171,32171,32174,0,3,0
9257,4,1,32175,32175,32176,0,1,1
9258,4,3,32179,32179,32182,0,3,3
9259,2,2,32181,32182,32184,1,3,0
9260,6,3,32187,32187,32190,0,3,3
9261,5,1,32192,32192,32193,0,1,2
9262,1,2,32193,32193,32195,0,2,0
9263,4,2,32197,32197,32199,0,2,2
9264,4,2,32201,32201,32203,0,2,2
9265,3,3,32204,32204,32207,0,3,1
9266,4,3,32208,32208,32211,0,3,1
9267,5,3,32213,32213,32216,0,3,2
9268,4,1,32217,32217,32218,0,1,1
9269,3,3,32220,32220,32223,0,3,2
9270,1,3,32221,32223,32226,2,5,0
9271,3,2,32224,32226,32228,2,4,0
9272,3,2,32227,32228,32230,1,3,0
9273,1,2,32228,32230,32232,2,4,0
9274,5,1,32233,32233,32234,0,1,1
9275,4,1,32237,32237,32238,0,1,3
9276,3,3,32240,32240,32243,0,3,2
9277,3,3,32243,32243,32246,0,3,0
9278,5,3,32248,32248,32251,0,3,2
9279,5,2,32253,32253,32255,0,2,2
9280,4,3,32257,32257,32260,0,3,2
9281,1,1,32258,32260,32261,2,3,0
9282,2,1,32260,32261,32262,1,2,0
9283,2,3,32262,32262,32265,0,3,0
9284,4,1,32266,32266,32267,0,1,1
9285,1,3,32267,32267,32270,0,3,0
9286,5,3,32272,32272,32275,0,3,2
9287,6,3,32278,32278,32281,0,3,3
9288,6,1,32284,32284,32285,0,1,3
9289,4,3,32288,32288,32291,0,3,3
9290,6,1,32294,32294,32295,0,1,3
9291,1,1,32295,32295,32296,0,1,0
9292,4,1,32299,32299,32300,0,1,3
9293,4,2,32303,32303,32305,0,2,3
9294,1,3,32304,32305,32308,1,4,0
9295,1,2,32305,32308,32310,3,5,0
9296,4,2,32309,32310,32312,1,3,0
9297,5,1,32314,32314,32315,0,1,2
9298,3,1,32317,32317,32318,0,1,2
9299,1,1,32318,32318,32319,0,1,0
9300,1,3,32319,32319,32322,0,3,0
9301,3,3,32322,32322,32325,0,3,0
9302,5,3,32327,32327,32330,0,3,2
9303,5,1,32332,32332,32333,0,1,2
9304,5,3,32337,32337,32340,0,3,4
9305,1,1,32338,32340,32341,2,3,0
9306,1,3,32339,32341,32344,2,5,0
9307,1,2,32340,32344,32346,4,6,0
9308,4,2,32344,32346,32348,2,4,0
9309,2,1,32346,32348,32349,2,3,0
9310,1,3,32347,32349,32352,2,5,0
9311,3,1,32350,32352,32353,2,3,0
9312,6,3,32356,32356,32359,0,3,3
9313,4,2,32360,32360,32362,0,2,1
9314,2,3,32362,32362,32365,0,3,0
9315,2,3,32364,32365,32368,1,4,0
9316,1,3,32365,32368,32371,3,6,0
9317,1,1,32366,32371,32372,5,6,0
9318,4,2,32370,32372,32374,2,4,0
9319,5,2,32375,32375,32377,0,2,1
9320,5,3,32380,32380,32383,0,3,3
9321,6,1,32386,32386,32387,0,1,3
9322,3,3,32389,32389,32392,0,3,2
9323,2,2,32391,32392,32394,1,3,0
9324,1,2,32392,32394,32396,2,4,0
9325,4,3,32396,32396,32399,0,3,0
9326,4,3,32400,32400,32403,0,3,1
9327,4,1,32404,32404,32405,0,1,1
9328,2,2,32406,32406,32408,0,2,1
9329,2,2,32408,32408,32410,0,2,0
9330,3,3,32411,32411,32414,0,3,1
9331,4,2,32415,32415,32417,0,2,1
9332,1,1,32416,32417,32418,1,2,0
9333,6,2,32422,32422,32424,0,2,4
9334,4,2,32426,32426,32428,0,2,2
9335,4,2,32430,32430,32432,0,2,2
9336,1,1,32431,32432,32433,1,2,0
9337,3,2,32434,32434,32436,0,2,1
9338,6,1,32440,32440,32441,0,1,4
9339,4,3,32444,32444,32447,0,3,3
9340,6,2,32450,32450,32452,0,2,3
9341,1,2,32451,32452,32454,1,3,0
9342,2,1,32453,32454,32455,1,2,0
9343,6,1,32459,32459,32460,0,1,4
9344,5,2,32464,32464,32466,0,2,4
9345,2,3,32466,32466,32469,0,3,0
9346,5,1,32471,32471,32472,0,1,2
9347,2,2,32473,32473,32475,0,2,1
9348,2,1,32475,32475,32476,0,1,0
9349,3,3,32478,32478,32481,0,3,2
9350,3,3,32481,32481,32484,0,3,0
9351,5,1,32486,32486,32487,0,1,2
9352,5,3,32491,32491,32494,0,3,4
9353,5,2,32496,32496,32498,0,2,2
9354,4,2,32500,32500,32502,0,2,2
9355,6,1,32506,32506,32507,0,1,4
9356,3,2,32509,32509,32511,0,2,2
9357,3,2,32512,32512,32514,0,2,1
9358,4,1,32516,32516,32517,0,1,2
9359,6,1,32522,32522,32523,0,1,5
9360,6,1,32528,32528,32529,0,1,5
9361,6,2,32534,32534,32536,0,2,5
9362,6,1,32540,32540,32541,0,1,4
9363,1,2,32541,32541,32543,0,2,0
9364,1,1,32542,32543,32544,1,2,0
9365,6,3,32548,32548,32551,0,3,4
9366,3,2,32551,32551,32553,0,2,0
9367,4,3,32555,32555,32558,0,3,2
9368,2,1,32557,32558,32559,1,2,0
9369,2,3,32559,32559,32562,0,3,0
9370,2,3,32561,32562,32565,1,4,0
9371,4,3,32565,32565,32568,0,3,0
9372,5,2,32570,32570,32572,0,2,2
9373,5,1,32575,32575,32576,0,1,3
9374,5,2,32580,32580,32582,0,2,4
9375,1,2,32581,32582,32584,1,3,0
9376,6,3,32587,32587,32590,0,3,3
9377,2,2,32589,32590,32592,1,3,0
9378,4,2,32593,32593,32595,0,2,1
9379,5,1,32598,32598,32599,0,1,3
9380,3,1,32601,32601,32602,0,1,2
9381,1,3,32602,32602,32605,0,3,0
9382,6,2,32608,32608,32610,0,2,3
9383,2,2,32610,32610,32612,0,2,0
9384,5,1,32615,32615,32616,0,1,3
9385,2,3,32617,32617,32620,0,3,1
9386,4,3,32621,32621,32624,0,3,1
9387,4,1,32625,32625,32626,0,1,1
9388,3,2,32628,32628,32630,0,2,2
9389,2,1,32630,32630,32631,0,1,0
9390,2,1,32632,32632,32633,0,1,1
9391,4,2,32636,32636,32638,0,2,3
9392,2,2,32638,32638,32640,0,2,0
9393,2,2,32640,32640,32642,0,2,0
9394,4,2,32644,32644,32646,0,2,2
9395,1,2,32645,32646,32648,1,3,0
9396,4,1,32649,32649,32650,0,1,1
9397,6,3,32655,32655,32658,0,3,5
9398,6,3,32661,32661,32664,0,3,3
9399,2,3,32663,32664,32667,1,4,0
9400,6,2,32669,32669,32671,0,2,2
9401,2,2,32671,32671,32673,0,2,0
9402,6,3,32677,32677,32680,0,3,4
9403,5,1,32682,32682,32683,0,1,2
9404,3,2,32685,32685,32687,0,2,2
9405,2,3,32687,32687,32690,0,3,0
9406,3,1,32690,32690,32691,0,1,0
9407,5,2,32695,32695,32697,0,2,4
9408,3,1,32698,32698,32699,0,1,1
9409,4,1,32702,32702,32703,0,1,3
9410,4,1,32706,32706,32707,0,1,3
9411,5,1,32711,32711,32712,0,1,4
9412,4,1,32715,32715,32716,0,1,3
9413,4,2,32719,32719,32721,0,2,3
9414,1,1,32720,32721,32722,1,2,0
9415,1,1,32721,32722,32723,1,2,0
9416,2,1,32723,32723,32724,0,1,0
9417,6,3,32729,32729,32732,0,3,5
9418,3,3,32732,32732,32735,0,3,0
9419,5,3,32737,32737,32740,0,3,2
9420,2,1,32739,32740,32741,1,2,0
9421,6,2,32745,32745,32747,0,2,4
9422,1,2,32746,32747,32749,1,3,0
9423,1,3,32747,32749,32752,2,5,0
9424,2,1,32749,32752,32753,3,4,0
9425,3,3,32752,32753,32756,1,4,0
9426,1,2,32753,32756,32758,3,5,0
9427,1,1,32754,32758,32759,4,5,0
9428,6,3,32760,32760,32763,0,3,1
9429,1,3,32761,32763,32766,2,5,0
9430,6,2,32767,32767,32769,0,2,1
9431,5,1,32772,32772,32773,0,1,3
9432,3,1,32775,32775,32776,0,1,2
9433,5,3,32780,32780,32783,0,3,4
9434,5,2,32785,32785,32787,0,2,2
9435,3,3,32788,32788,32791,0,3,1
9436,1,1,32789,32791,32792,2,3,0
9437,2,3,32791,32792,32795,1,4,0
9438,2,3,32793,32795,32798,2,5,0
9439,4,1,32797,32798,32799,1,2,0
9440,3,2,32800,32800,32802,0,2,1
9441,4,3,32804,32804,32807,0,3,2
9442,6,2,32810,32810,32812,0,2,3
9443,5,1,32815,32815,32816,0,1,3
9444,4,3,32819,32819,32822,0,3,3
9445,4,2,32823,32823,32825,0,2,1
9446,5,3,32828,32828,32831,0,3,3
9447,4,3,32832,32832,32835,0,3,1
9448,2,3,32834,32835,32838,1,4,0
9449,1,3,32835,32838,32841,3,6,0
9450,1,3,32836,32841,32844,5,8,0
9451,5,1,32841,32844,32845,3,4,0
9452,4,2,32845,32845,32847,0,2,0
9453,1,3,32846,32847,32850,1,4,0
9454,4,2,32850,32850,32852,0,2,0
9455,6,3,32856,32856,32859,0,3,4
9456,2,3,32858,32859,32862,1,4,0
9457,1,1,32859,32862,32863,3,4,0
9458,3,1,32862,32863,32864,1,2,0
9459,2,3,32864,32864,32867,0,3,0
9460,2,2,32866,32867,32869,1,3,0
9461,4,3,32870,32870,32873,0,3,1
9462,6,1,32876,32876,32877,0,1,3
9463,6,1,32882,32882,32883,0,1,5
9464,1,1,32883,32883,32884,0,1,0
9465,6,3,32889,32889,32892,0,3,5
9466,2,1,32891,32892,32893,1,2,0
9467,6,3,32897,32897,32900,0,3,4
9468,2,2,32899,32900,32902,1,3,0
9469,5,3,32904,32904,32907,0,3,2
9470,5,3,32909,32909,32912,0,3,2
9471,4,3,32913,32913,32916,0,3,1
9472,6,1,32919,32919,32920,0,1,3
9473,4,3,32923,32923,32926,0,3,3
9474,3,2,32926,32926,32928,0,2,0
9475,2,1,32928,32928,32929,0,1,0
9476,3,3,32931,32931,32934,0,3,2
9477,2,3,32933,32934,32937,1,4,0
9478,5,3,32938,32938,32941,0,3,1
9479,1,2,32939,32941,32943,2,4,0
9480,5,3,32944,32944,32947,0,3,1
9481,6,2,32950,32950,32952,0,2,3
9482,6,1,32956,32956,32957,0,1,4
9483,1,1,32957,32957,32958,0,1,0
9484,6,1,32963,32963,32964,0,1,5
9485,2,3,32965,32965,32968,0,3,1
9486,6,3,32971,32971,32974,0,3,3
9487,4,2,32975,32975,32977,0,2,1
9488,1,2,32976,32977,32979,1,3,0
9489,4,1,32980,32980,32981,0,1,1
9490,2,2,32982,32982,32984,0,2,1
9491,6,2,32988,32988,32990,0,2,4
9492,4,3,32992,32992,32995,0,3,2
9493,5,1,32997,32997,32998,0,1,2
9494,1,2,32998,32998,33000,0,2,0
9495,2,2,33000,33000,33002,0,2,0
9496,1,2,33001,33002,33004,1,3,0
9497,3,1,33004,33004,33005,0,1,0
9498,6,3,33010,33010,33013,0,3,5
9499,4,3,33014,33014,33017,0,3,1
9500,4,1,33018,33018,33019,0,1,1
9501,4,1,33022,33022,33023,0,1,3
9502,1,1,33023,33023,33024,0,1,0
9503,3,2,33026,33026,33028,0,2,2
9504,3,3,33029,33029,33032,0,3,1
9505,6,3,33035,33035,33038,0,3,3
9506,5,3,33040,33040,33043,0,3,2
9507,2,1,33042,33043,33044,1,2,0
9508,2,2,33044,33044,33046,0,2,0
9509,3,3,33047,33047,33050,0,3,1
9510,2,2,33049,33050,33052,1,3,0
9511,6,1,33055,33055,33056,0,1,3
9512,4,2,33059,33059,33061,0,2,3
9513,6,3,33065,33065,33068,0,3,4
9514,2,1,33067,33068,33069,1,2,0
9515,2,1,33069,33069,33070,0,1,0
9516,3,2,33072,33072,33074,0,2,2
9517,3,2,33075,33075,33077,0,2,1
9518,6,2,33081,33081,33083,0,2,4
9519,5,3,33086,33086,33089,0,3,3
9520,6,1,33092,33092,33093,0,1,3
9521,2,3,33094,33094,33097,0,3,1
9522,4,1,33098,33098,33099,0,1,1
9523,5,1,33103,33103,33104,0,1,4
9524,3,2,33106,33106,33108,0,2,2
9525,4,2,33110,33110,33112,0,2,2
9526,6,1,33116,33116,33117,0,1,4
9527,3,2,33119,33119,33121,0,2,2
9528,3,1,33122,33122,33123,0,1,1
9529,5,3,33127,33127,33130,0,3,4
9530,1,3,33128,33130,33133,2,5,0
9531,3,1,33131,33133,33134,2,3,0
9532,6,1,33137,33137,33138,0,1,3
9533,3,3,33140,33140,33143,0,3,2
9534,4,1,33144,33144,33145,0,1,1
9535,6,2,33150,33150,33152,0,2,5
9536,1,1,33151,33152,33153,1,2,0
9537,3,3,33154,33154,33157,0,3,1
9538,1,3,33155,33157,33160,2,5,0
9539,3,3,33158,33160,33163,2,5,0
9540,2,2,33160,33163,33165,3,5,0
9541,1,2,33161,33165,33167,4,6,0
9542,6,1,33167,33167,33168,0,1,0
9543,2,2,33169,33169,33171,0,2,1
9544,6,3,33175,33175,33178,0,3,4
9545,6,3,33181,33181,33184,0,3,3
9546,2,3,33183,33184,33187,1,4,0
9547,5,3,33188,33188,33191,0,3,1
9548,6,3,33194,33194,33197,0,3,3
9549,1,1,33195,33197,33198,2,3,0
9550,2,3,33197,33198,33201,1,4,0
9551,6,1,33203,33203,33204,0,1,2
9552,2,3,33205,33205,33208,0,3,1
9553,4,1,33209,33209,33210,0,1,1
9554,5,3,33214,33214,33217,0,3,4
9555,3,1,33217,33217,33218,0,1,0
9556,3,3,33220,33220,33223,0,3,2
9557,2,1,33222,33223,33224,1,2,0
9558,5,2,33227,33227,33229,0,2,3
9559,2,3,33229,33229,33232,0,3,0
9560,6,1,33235,33235,33236,0,1,3
9561,3,3,33238,33238,33241,0,3,2
9562,6,2,33244,33244,33246,0,2,3
9563,6,2,33250,33250,33252,0,2,4
9564,1,2,33251,33252,33254,1,3,0
9565,2,2,33253,33254,33256,1,3,0
9566,1,3,33254,33256,33259,2,5,0
9567,4,3,33258,33259,33262,1,4,0
9568,3,1,33261,33262,33263,1,2,0
9569,4,1,33265,33265,33266,0,1,2
9570,3,1,33268,33268,33269,0,1,2
9571,5,3,33273,33273,33276,0,3,4
9572,2,1,33275,33276,33277,1,2,0
9573,3,3,33278,33278,33281,0,3,1
9574,2,2,33280,33281,33283,1,3,0
9575,6,2,33286,33286,33288,0,2,3
9576,3,1,33289,33289,33290,0,1,1
9577,1,2,33290,33290,33292,0,2,0
9578,4,3,33294,33294,33297,0,3,2
9579,2,1,33296,33297,33298,1,2,0
9580,4,2,33300,33300,33302,0,2,2
9581,4,2,33304,33304,33306,0,2,2
9582,2,3,33306,33306,33309,0,3,0
9583,2,2,33308,33309,33311,1,3,0
9584,4,1,33312,33312,33313,0,1,1
9585,1,3,33313,33313,33316,0,3,0
9586,6,2,33319,33319,33321,0,2,3
9587,5,1,33324,33324,33325,0,1,3
9588,3,3,33327,33327,33330,0,3,2
9589,2,1,33329,33330,33331,1,2,0
9590,2,2,33331,33331,33333,0,2,0
9591,2,2,33333,33333,33335,0,2,0
9592,5,3,33338,33338,33341,0,3,3
9593,4,1,33342,33342,33343,0,1,1
9594,5,3,33347,33347,33350,0,3,4
9595,3,3,33350,33350,33353,0,3,0
9596,1,3,33351,33353,33356,2,5,0
9597,6,1,33357,33357,33358,0,1,1
9598,1,1,33358,33358,33359,0,1,0
9599,3,3,33361,33361,33364,0,3,2
9600,2,1,33363,33364,33365,1,2,0
9601,5,1,33368,33368,33369,0,1,3
9602,1,2,33369,33369,33371,0,2,0
9603,5,1,33374,33374,33375,0,1,3
9604,5,2,33379,33379,33381,0,2,4
9605,1,1,33380,33381,33382,1,2,0
9606,3,2,33383,33383,33385,0,2,1
9607,2,2,33385,33385,33387,0,2,0
9608,3,3,33388,33388,33391,0,3,1
9609,6,3,33394,33394,33397,0,3,3
9610,2,1,33396,33397,33398,1,2,0
9611,6,2,33402,33402,33404,0,2,4
9612,1,2,33403,33404,33406,1,3,0
9613,2,2,33405,33406,33408,1,3,0
9614,5,1,33410,33410,33411,0,1,2
9615,6,1,33416,33416,33417,0,1,5
9616,1,3,33417,33417,33420,0,3,0
9617,2,1,33419,33420,33421,1,2,0
9618,2,3,33421,33421,33424,0,3,0
9619,1,3,33422,33424,33427,2,5,0
9620,5,1,33427,33427,33428,0,1,0
9621,2,3,33429,33429,33432,0,3,1
9622,5,3,33434,33434,33437,0,3,2
9623,6,3,33440,33440,33443,0,3,3
9624,3,1,33443,33443,33444,0,1,0
9625,4,3,33447,33447,33450,0,3,3
9626,4,3,33451,33451,33454,0,3,1
9627,2,3,33453,33454,33457,1,4,0
9628,6,2,33459,33459,33461,0,2,2
9629,6,2,33465,33465,33467,0,2,4
9630,2,1,33467,33467,33468,0,1,0
9631,4,3,33471,33471,33474,0,3,3
9632,4,1,33475,33475,33476,0,1,1
9633,2,3,33477,33477,33480,0,3,1
9634,6,1,33483,33483,33484,0,1,3
9635,3,3,33486,33486,33489,0,3,2
9636,6,3,33492,33492,33495,0,3,3
9637,6,2,33498,33498,33500,0,2,3
9638,4,1,33502,33502,33503,0,1,2
9639,3,2,33505,33505,33507,0,2,2
9640,6,3,33511,33511,33514,0,3,4
9641,6,1,33517,33517,33518,0,1,3
9642,6,3,33523,33523,33526,0,3,5
9643,1,3,33524,33526,33529,2,5,0
9644,1,1,33525,33529,33530,4,5,0
9645,3,3,33528,33530,33533,2,5,0
9646,6,2,33534,33534,33536,0,2,1
9647,3,1,33537,33537,33538,0,1,1
9648,6,1,33543,33543,33544,0,1,5
9649,2,1,33545,33545,33546,0,1,1
9650,5,1,33550,33550,33551,0,1,4
9651,3,3,33553,33553,33556,0,3,2
9652,2,1,33555,33556,33557,1,2,0
9653,3,2,33558,33558,33560,0,2,1
9654,6,2,33564,33564,33566,0,2,4
9655,1,2,33565,33566,33568,1,3,0
9656,2,2,33567,33568,33570,1,3,0
9657,2,1,33569,33570,33571,1,2,0
9658,4,2,33573,33573,33575,0,2,2
9659,4,2,33577,33577,33579,0,2,2
9660,3,3,33580,33580,33583,0,3,1
9661,6,3,33586,33586,33589,0,3,3
9662,6,1,33592,33592,33593,0,1,3
9663,1,1,33593,33593,33594,0,1,0
9664,3,3,33596,33596,33599,0,3,2
9665,2,3,33598,33599,33602,1,4,0
9666,4,2,33602,33602,33604,0,2,0
9667,2,2,33604,33604,33606,0,2,0
9668,6,3,33610,33610,33613,0,3,4
9669,2,2,33612,33613,33615,1,3,0
9670,4,2,33616,33616,33618,0,2,1
9671,4,3,33620,33620,33623,0,3,2
9672,3,1,33623,33623,33624,0,1,0
9673,6,3,33629,33629,33632,0,3,5
9674,5,3,33634,33634,33637,0,3,2
9675,3,2,33637,33637,33639,0,2,0
9676,2,3,33639,33639,33642,0,3,0
9677,1,3,33640,33642,33645,2,5,0
9678,2,3,33642,33645,33648,3,6,0
9679,6,2,33648,33648,33650,0,2,0
9680,2,2,33650,33650,33652,0,2,0
9681,1,1,33651,33652,33653,1,2,0
9682,4,2,33655,33655,33657,0,2,2
9683,4,2,33659,33659,33661,0,2,2
9684,2,1,33661,33661,33662,0,1,0
9685,5,3,33666,33666,33669,0,3,4
9686,4,3,33670,33670,33673,0,3,1
9687,3,3,33673,33673,33676,0,3,0
9688,4,2,33677,33677,33679,0,2,1
9689,1,2,33678,33679,33681,1,3,0
9690,2,3,33680,33681,33684,1,4,0
9691,5,2,33685,33685,33687,0,2,1
9692,1,1,33686,33687,33688,1,2,0
9693,5,3,33691,33691,33694,0,3,3
9694,2,2,33693,33694,33696,1,3,0
9695,5,3,33698,33698,33701,0,3,2
9696,3,2,33701,33701,33703,0,2,0
9697,4,3,33705,33705,33708,0,3,2
9698,5,3,33710,33710,33713,0,3,2
9699,2,2,33712,33713,33715,1,3,0
9700,5,3,33717,33717,33720,0,3,2
9701,4,1,33721,33721,33722,0,1,1
9702,6,1,33727,33727,33728,0,1,5
9703,6,2,33733,33733,33735,0,2,5
9704,3,2,33736,33736,33738,0,2,1
9705,2,1,33738,33738,33739,0,1,0
9706,2,3,33740,33740,33743,0,3,1
9707,1,1,33741,33743,33744,2,3,0
9708,6,1,33747,33747,33748,0,1,3
9709,6,2,33753,33753,33755,0,2,5
9710,2,3,33755,33755,33758,0,3,0
9711,6,3,33761,33761,33764,0,3,3
9712,2,3,33763,33764,33767,1,4,0
9713,3,3,33766,33767,33770,1,4,0
9714,2,3,33768,33770,33773,2,5,0
9715,4,2,33772,33773,33775,1,3,0
9716,1,3,33773,33775,33778,2,5,0
9717,2,3,33775,33778,33781,3,6,0
9718,6,1,33781,33781,33782,0,1,0
9719,5,3,33786,33786,33789,0,3,4
9720,3,1,33789,33789,33790,0,1,0
9721,2,3,33791,33791,33794,0,3,1
9722,1,3,33792,33794,33797,2,5,0
9723,2,3,33794,33797,33800,3,6,0
9724,4,3,33798,33800,33803,2,5,0
9725,6,1,33804,33804,33805,0,1,1
9726,6,3,33810,33810,33813,0,3,5
9727,6,2,33816,33816,33818,0,2,3
9728,3,2,33819,33819,33821,0,2,1
9729,2,2,33821,33821,33823,0,2,0
9730,4,3,33825,33825,33828,0,3,2
9731,5,3,33830,33830,33833,0,3,2
9732,5,3,33835,33835,33838,0,3,2
9733,4,2,33839,33839,33841,0,2,1
9734,5,2,33844,33844,33846,0,2,3
9735,5,3,33849,33849,33852,0,3,3
9736,5,1,33854,33854,33855,0,1,2
9737,4,3,33858,33858,33861,0,3,3
9738,5,3,33863,33863,33866,0,3,2
9739,6,1,33869,33869,33870,0,1,3
9740,1,2,33870,33870,33872,0,2,0
9741,6,2,33876,33876,33878,0,2,4
9742,2,2,33878,33878,33880,0,2,0
9743,1,1,33879,33880,33881,1,2,0
9744,1,2,33880,33881,33883,1,3,0
9745,1,1,33881,33883,33884,2,3,0
9746,2,3,33883,33884,33887,1,4,0
9747,5,2,33888,33888,33890,0,2,1
9748,3,3,33891,33891,33894,0,3,1
9749,4,1,33895,33895,33896,0,1,1
9750,1,3,33896,33896,33899,0,3,0
9751,1,1,33897,33899,33900,2,3,0
9752,3,3,33900,33900,33903,0,3,0
9753,6,3,33906,33906,33909,0,3,3
9754,6,3,33912,33912,33915,0,3,3
9755,5,1,33917,33917,33918,0,1,2
9756,2,3,33919,33919,33922,0,3,1
9757,5,2,33924,33924,33926,0,2,2
9758,1,1,33925,33926,33927,1,2,0
9759,2,2,33927,33927,33929,0,2,0
9760,3,3,33930,33930,33933,0,3,1
9761,4,1,33934,33934,33935,0,1,1
9762,5,1,33939,33939,33940,0,1,4
9763,5,2,33944,33944,33946,0,2,4
9764,1,3,33945,33946,33949,1,4,0
9765,1,2,33946,33949,33951,3,5,0
9766,1,1,33947,33951,33952,4,5,0
9767,1,1,33948,33952,33953,4,5,0
9768,1,2,33949,33953,33955,4,6,0
9769,1,2,33950,33955,33957,5,7,0
9770,6,1,33956,33957,33958,1,2,0
9771,5,3,33961,33961,33964,0,3,3
9772,2,3,33963,33964,33967,1,4,0
9773,5,1,33968,33968,33969,0,1,1
9774,4,1,33972,33972,33973,0,1,3
9775,5,2,33977,33977,33979,0,2,4
9776,5,1,33982,33982,33983,0,1,3
9777,6,3,33988,33988,33991,0,3,5
9778,1,3,33989,33991,33994,2,5,0
9779,2,3,33991,33994,33997,3,6,0
9780,6,1,33997,33997,33998,0,1,0
9781,3,1,34000,34000,34001,0,1,2
9782,4,2,34004,34004,34006,0,2,3
9783,2,1,34006,34006,34007,0,1,0
9784,6,3,34012,34012,34015,0,3,5
9785,5,2,34017,34017,34019,0,2,2
9786,2,3,34019,34019,34022,0,3,0
9787,6,3,34025,34025,34028,0,3,3
9788,5,3,34030,34030,34033,0,3,2
9789,1,2,34031,34033,34035,2,4,0
9790,3,3,34034,34035,34038,1,4,0
9791,1,2,34035,34038,34040,3,5,0
9792,1,1,34036,34040,34041,4,5,0
9793,4,2,34040,34041,34043,1,3,0
9794,6,1,34046,34046,34047,0,1,3
9795,2,2,34048,34048,34050,0,2,1
9796,5,1,34053,34053,34054,0,1,3
9797,2,1,34055,34055,34056,0,1,1
9798,1,2,34056,34056,34058,0,2,0
9799,5,3,34061,34061,34064,0,3,3
9800,5,2,34066,34066,34068,0,2,2
9801,5,2,34071,34071,34073,0,2,3
9802,3,3,34074,34074,34077,0,3,1
9803,6,3,34080,34080,34083,0,3,3
9804,1,2,34081,34083,34085,2,4,0
9805,4,2,34085,34085,34087,0,2,0
9806,3,3,34088,34088,34091,0,3,1
9807,3,1,34091,34091,34092,0,1,0
9808,5,1,34096,34096,34097,0,1,4
9809,5,1,34101,34101,34102,0,1,4
9810,5,2,34106,34106,34108,0,2,4
9811,5,2,34111,34111,34113,0,2,3
9812,2,1,34113,34113,34114,0,1,0
9813,5,3,34118,34118,34121,0,3,4
9814,1,3,34119,34121,34124,2,5,0
9815,2,1,34121,34124,34125,3,4,0
9816,3,1,34124,34125,34126,1,2,0
9817,2,1,34126,34126,34127,0,1,0
9818,5,2,34131,34131,34133,0,2,4
9819,1,1,34132,34133,34134,1,2,0
9820,2,3,34134,34134,34137,0,3,0
9821,2,3,34136,34137,34140,1,4,0
9822,1,1,34137,34140,34141,3,4,0
9823,5,1,34142,34142,34143,0,1,1
9824,4,2,34146,34146,34148,0,2,3
9825,3,1,34149,34149,34150,0,1,1
9826,2,3,34151,34151,34154,0,3,1
9827,3,3,34154,34154,34157,0,3,0
9828,2,3,34156,34157,34160,1,4,0
9829,2,1,34158,34160,34161,2,3,0
9830,2,3,34160,34161,34164,1,4,0
9831,2,3,34162,34164,34167,2,5,0
9832,6,2,34168,34168,34170,0,2,1
9833,1,1,34169,34170,34171,1,2,0
9834,2,1,34171,34171,34172,0,1,0
9835,6,1,34177,34177,34178,0,1,5
9836,1,2,34178,34178,34180,0,2,0
9837,2,1,34180,34180,34181,0,1,0
9838,3,2,34183,34183,34185,0,2,2
9839,1,1,34184,34185,34186,1,2,0
9840,2,1,34186,34186,34187,0,1,0
9841,3,1,34189,34189,34190,0,1,2
9842,6,2,34195,34195,34197,0,2,5
9843,1,1,34196,34197,34198,1,2,0
9844,2,2,34198,34198,34200,0,2,0
9845,5,3,34203,34203,34206,0,3,3
9846,5,2,34208,34208,34210,0,2,2
9847,4,2,34212,34212,34214,0,2,2
9848,3,3,34215,34215,34218,0,3,1
9849,4,1,34219,34219,34220,0,1,1
9850,4,3,34223,34223,34226,0,3,3
9851,6,3,34229,34229,34232,0,3,3
9852,3,1,34232,34232,34233,0,1,0
9853,1,2,34233,34233,34235,0,2,0
9854,4,2,34237,34237,34239,0,2,2
9855,2,3,34239,34239,34242,0,3,0
9856,1,3,34240,34242,34245,2,5,0
9857,4,3,34244,34245,34248,1,4,0
9858,4,1,34248,34248,34249,0,1,0
9859,4,3,34252,34252,34255,0,3,3
9860,6,1,34258,34258,34259,0,1,3
9861,1,2,34259,34259,34261,0,2,0
9862,3,2,34262,34262,34264,0,2,1
9863,1,1,34263,34264,34265,1,2,0
9864,2,2,34265,34265,34267,0,2,0
9865,4,2,34269,34269,34271,0,2,2
9866,5,1,34274,34274,34275,0,1,3
9867,1,2,34275,34275,34277,0,2,0
9868,6,2,34281,34281,34283,0,2,4
9869,2,1,34283,34283,34284,0,1,0
9870,6,3,34289,34289,34292,0,3,5
9871,3,3,34292,34292,34295,0,3,0
9872,1,2,34293,34295,34297,2,4,0
9873,3,3,34296,34297,34300,1,4,0
9874,1,1,34297,34300,34301,3,4,0
9875,5,1,34302,34302,34303,0,1,1
9876,3,3,34305,34305,34308,0,3,2
9877,4,3,34309,34309,34312,0,3,1
9878,1,1,34310,34312,34313,2,3,0
9879,6,2,34316,34316,34318,0,2,3
9880,1,3,34317,34318,34321,1,4,0
9881,2,3,34319,34321,34324,2,5,0
9882,3,3,34322,34324,34327,2,5,0
9883,2,3,34324,34327,34330,3,6,0
9884,6,1,34330,34330,34331,0,1,0
9885,4,2,34334,34334,34336,0,2,3
9886,3,3,34337,34337,34340,0,3,1
9887,1,1,34338,34340,34341,2,3,0
9888,2,3,34340,34341,34344,1,4,0
9889,4,3,34344,34344,34347,0,3,0
9890,4,2,34348,34348,34350,0,2,1
9891,5,1,34353,34353,34354,0,1,3
9892,5,1,34358,34358,34359,0,1,4
9893,2,1,34360,34360,34361,0,1,1
9894,1,1,34361,34361,34362,0,1,0
9895,4,1,34365,34365,34366,0,1,3
9896,3,1,34368,34368,34369,0,1,2
9897,6,1,34374,34374,34375,0,1,5
9898,3,2,34377,34377,34379,0,2,2
9899,6,1,34383,34383,34384,0,1,4
9900,3,3,34386,34386,34389,0,3,2
9901,5,3,34391,34391,34394,0,3,2
9902,1,1,34392,34394,34395,2,3,0
9903,1,3,34393,34395,34398,2,5,0
9904,2,3,34395,34398,34401,3,6,0
9905,4,3,34399,34401,34404,2,5,0
9906,5,1,34404,34404,34405,0,1,0
9907,1,2,34405,34405,34407,0,2,0
9908,1,3,34406,34407,34410,1,4,0
9909,4,2,34410,34410,34412,0,2,0
9910,2,3,34412,34412,34415,0,3,0
9911,4,3,34416,34416,34419,0,3,1
9912,1,2,34417,34419,34421,2,4,0
9913,1,1,34418,34421,34422,3,4,0
9914,2,2,34420,34422,34424,2,4,0
9915,6,2,34426,34426,34428,0,2,2
9916,4,2,34430,34430,34432,0,2,2
9917,6,1,34436,34436,34437,0,1,4
9918,2,3,34438,34438,34441,0,3,1
9919,5,1,34443,34443,34444,0,1,2
9920,1,1,34444,34444,34445,0,1,0
9921,1,2,34445,34445,34447,0,2,0
9922,3,3,34448,34448,34451,0,3,1
9923,2,2,34450,34451,34453,1,3,0
9924,6,3,34456,34456,34459,0,3,3
9925,5,2,34461,34461,34463,0,2,2
9926,3,3,34464,34464,34467,0,3,1
9927,3,2,34467,34467,34469,0,2,0
9928,4,3,34471,34471,34474,0,3,2
9929,1,2,34472,34474,34476,2,4,0
9930,3,3,34475,34476,34479,1,4,0
9931,5,2,34480,34480,34482,0,2,1
9932,6,3,34486,34486,34489,0,3,4
9933,6,1,34492,34492,34493,0,1,3
9934,6,1,34498,34498,34499,0,1,5
9935,6,3,34504,34504,34507,0,3,5
9936,5,1,34509,34509,34510,0,1,2
9937,6,2,34515,34515,34517,0,2,5
9938,1,2,34516,34517,34519,1,3,0
9939,2,2,34518,34519,34521,1,3,0
9940,2,1,34520,34521,34522,1,2,0
9941,2,3,34522,34522,34525,0,3,0
9942,2,2,34524,34525,34527,1,3,0
9943,3,1,34527,34527,34528,0,1,0
9944,5,1,34532,34532,34533,0,1,4
9945,6,1,34538,34538,34539,0,1,5
9946,6,2,34544,34544,34546,0,2,5
9947,5,2,34549,34549,34551,0,2,3
9948,1,1,34550,34551,34552,1,2,0
9949,1,2,34551,34552,34554,1,3,0
9950,2,3,34553,34554,34557,1,4,0
9951,1,1,34554,34557,34558,3,4,0
9952,6,2,34560,34560,34562,0,2,2
9953,4,1,34564,34564,34565,0,1,2
9954,4,1,34568,34568,34569,0,1,3
9955,2,3,34570,34570,34573,0,3,1
9956,3,3,34573,34573,34576,0,3,0
9957,2,3,34575,34576,34579,1,4,0
9958,3,3,34578,34579,34582,1,4,0
9959,6,2,34584,34584,34586,0,2,2
9960,4,2,34588,34588,34590,0,2,2
9961,4,2,34592,34592,34594,0,2,2
9962,2,2,34594,34594,34596,0,2,0
9963,6,1,34600,34600,34601,0,1,4
9964,6,2,34606,34606,34608,0,2,5
9965,6,2,34612,34612,34614,0,2,4
9966,3,3,34615,34615,34618,0,3,1
9967,1,3,34616,34618,34621,2,5,0
9968,6,2,34622,34622,34624,0,2,1
9969,2,3,34624,34624,34627,0,3,0
9970,5,3,34629,34629,34632,0,3,2
9971,3,3,34632,34632,34635,0,3,0
9972,2,3,34634,34635,34638,1,4,0
9973,2,2,34636,34638,34640,2,4,0
9974,6,2,34642,34642,34644,0,2,2
9975,4,3,34646,34646,34649,0,3,2
9976,2,1,34648,34649,34650,1,2,0
9977,3,1,34651,34651,34652,0,1,1
9978,3,3,34654,34654,34657,0,3,2
9979,1,2,34655,34657,34659,2,4,0
9980,5,1,34660,34660,34661,0,1,1
9981,4,2,34664,34664,34666,0,2,3
9982,6,1,34670,34670,34671,0,1,4
9983,4,2,34674,34674,34676,0,2,3
9984,4,3,34678,34678,34681,0,3,2
9985,1,3,34679,34681,34684,2,5,0
9986,6,3,34685,34685,34688,0,3,1
9987,6,2,34691,34691,34693,0,2,3
9988,4,3,34695,34695,34698,0,3,2
9989,1,1,34696,34698,34699,2,3,0
9990,2,2,34698,34699,34701,1,3,0
9991,2,2,34700,34701,34703,1,3,0
9992,2,2,34702,34703,34705,1,3,0
9993,3,3,34705,34705,34708,0,3,0
9994,3,2,34708,34708,34710,0,2,0
9995,2,2,34710,34710,34712,0,2,0
9996,6,3,34716,34716,34719,0,3,4
9997,4,2,34720,34720,34722,0,2,1
9998,1,2,34721,34722,34724,1,3,0
9999,2,3,34723,34724,34727,1,4,0
10000,5,3,34728,34728,34731,0,3,1
10001,1,1,34729,34731,34732,2,3,0
10002,3,3,34732,34732,34735,0,3,0
10003,5,1,34737,34737,34738,0,1,2
10004,5,3,34742,34742,34745,0,3,4
10005,3,1,34745,34745,34746,0,1,0
10006,4,1,34749,34749,34750,0,1,3
10007,2,3,34751,34751,34754,0,3,1
10008,2,3,34753,34754,34757,1,4,0
10009,1,2,34754,34757,34759,3,5,0
10010,5,1,34759,34759,34760,0,1,0
10011,2,2,34761,34761,34763,0,2,1
10012,6,3,34767,34767,34770,0,3,4
10013,1,1,34768,34770,34771,2,3,0
10014,6,2,34774,34774,34776,0,2,3
10015,3,3,34777,34777,34780,0,3,1
10016,4,1,34781,34781,34782,0,1,1
10017,6,1,34787,34787,34788,0,1,5
10018,4,3,34791,34791,34794,0,3,3
10019,6,2,34797,34797,34799,0,2,3
10020,4,2,34801,34801,34803,0,2,2
10021,2,2,34803,34803,34805,0,2,0
10022,6,1,34809,34809,34810,0,1,4
10023,5,2,34814,34814,34816,0,2,4
10024,4,1,34818,34818,34819,0,1,2
10025,4,1,34822,34822,34823,0,1,3
10026,4,3,34826,34826,34829,0,3,3
10027,3,2,34829,34829,34831,0,2,0
10028,5,2,34834,34834,34836,0,2,3
10029,6,3,34840,34840,34843,0,3,4
10030,3,3,34843,34843,34846,0,3,0
10031,5,3,34848,34848,34851,0,3,2
10032,4,2,34852,34852,34854,0,2,1
10033,1,1,34853,34854,34855,1,2,0
10034,2,2,34855,34855,34857,0,2,0
10035,2,2,34857,34857,34859,0,2,0
10036,3,3,34860,34860,34863,0,3,1
10037,4,1,34864,34864,34865,0,1,1
10038,1,2,34865,34865,34867,0,2,0
10039,3,1,34868,34868,34869,0,1,1
10040,5,2,34873,34873,34875,0,2,4
10041,6,3,34879,34879,34882,0,3,4
10042,2,3,34881,34882,34885,1,4,0
10043,1,2,34882,34885,34887,3,5,0
10044,5,2,34887,34887,34889,0,2,0
10045,4,2,34891,34891,34893,0,2,2
10046,3,1,34894,34894,34895,0,1,1
10047,1,1,34895,34895,34896,0,1,0
10048,1,1,34896,34896,34897,0,1,0
10049,5,2,34901,34901,34903,0,2,4
10050,3,3,34904,34904,34907,0,3,1
10051,4,2,34908,34908,34910,0,2,1
10052,3,1,34911,34911,34912,0,1,1
10053,5,1,34916,34916,34917,0,1,4
10054,6,3,34922,34922,34925,0,3,5
10055,1,3,34923,34925,34928,2,5,0
10056,6,3,34929,34929,34932,0,3,1
10057,2,3,34931,34932,34935,1,4,0
10058,5,2,34936,34936,34938,0,2,1
10059,6,3,34942,34942,34945,0,3,4
10060,5,2,34947,34947,34949,0,2,2
10061,4,3,34951,34951,34954,0,3,2
10062,6,2,34957,34957,34959,0,2,3
10063,5,3,34962,34962,34965,0,3,3
10064,1,2,34963,34965,34967,2,4,0
10065,5,2,34968,34968,34970,0,2,1
10066,5,3,34973,34973,34976,0,3,3
10067,3,1,34976,34976,34977,0,1,0
10068,4,2,34980,34980,34982,0,2,3
10069,6,1,34986,34986,34987,0,1,4
10070,1,3,34987,34987,34990,0,3,0
10071,3,2,34990,34990,34992,0,2,0
10072,3,1,34993,34993,34994,0,1,1
10073,5,2,34998,34998,35000,0,2,4
10074,5,2,35003,35003,35005,0,2,3
10075,1,3,35004,35005,35008,1,4,0
10076,1,2,35005,35008,35010,3,5,0
10077,3,1,35008,35010,35011,2,3,0
10078,2,2,35010,35011,35013,1,3,0
10079,4,2,35014,35014,35016,0,2,1
10080,2,2,35016,35016,35018,0,2,0
10081,2,3,35018,35018,35021,0,3,0
10082,1,1,35019,35021,35022,2,3,0
10083,1,3,35020,35022,35025,2,5,0
10084,1,1,35021,35025,35026,4,5,0
10085,3,2,35024,35026,35028,2,4,0
10086,3,2,35027,35028,35030,1,3,0
10087,1,2,35028,35030,35032,2,4,0
10088,4,3,35032,35032,35035,0,3,0
10089,5,3,35037,35037,35040,0,3,2
10090,1,2,35038,35040,35042,2,4,0
10091,4,3,35042,35042,35045,0,3,0
10092,5,2,35047,35047,35049,0,2,2
10093,2,1,35049,35049,35050,0,1,0
10094,5,2,35054,35054,35056,0,2,4
10095,2,3,35056,35056,35059,0,3,0
10096,1,1,35057,35059,35060,2,3,0
10097,2,3,35059,35060,35063,1,4,0
10098,3,1,35062,35063,35064,1,2,0
10099,2,1,35064,35064,35065,0,1,0
10100,2,1,35066,35066,35067,0,1,1
10101,5,2,35071,35071,35073,0,2,4
10102,3,3,35074,35074,35077,0,3,1
10103,4,1,35078,35078,35079,0,1,1
10104,3,2,35081,35081,35083,0,2,2
10105,3,1,35084,35084,35085,0,1,1
10106,1,2,35085,35085,35087,0,2,0
10107,6,2,35091,35091,35093,0,2,4
10108,6,2,35097,35097,35099,0,2,4
10109,4,1,35101,35101,35102,0,1,2
10110,2,3,35103,35103,35106,0,3,1
10111,5,3,35108,35108,35111,0,3,2
10112,4,3,35112,35112,35115,0,3,1
10113,3,1,35115,35115,35116,0,1,0
10114,3,3,35118,35118,35121,0,3,2
10115,4,2,35122,35122,35124,0,2,1
10116,2,3,35124,35124,35127,0,3,0
10117,3,2,35127,35127,35129,0,2,0
10118,2,3,35129,35129,35132,0,3,0
10119,6,1,35135,35135,35136,0,1,3
10120,4,1,35139,35139,35140,0,1,3
10121,5,1,35144,35144,35145,0,1,4
10122,4,2,35148,35148,35150,0,2,3
10123,1,1,35149,35150,35151,1,2,0
10124,3,1,35152,35152,35153,0,1,1
10125,3,2,35155,35155,35157,0,2,2
10126,2,2,35157,35157,35159,0,2,0
10127,4,1,35161,35161,35162,0,1,2
10128,4,2,35165,35165,35167,0,2,3
10129,5,1,35170,35170,35171,0,1,3
10130,2,3,35172,35172,35175,0,3,1
10131,1,2,35173,35175,35177,2,4,0
10132,4,3,35177,35177,35180,0,3,0
10133,5,2,35182,35182,35184,0,2,2
10134,5,2,35187,35187,35189,0,2,3
10135,2,3,35189,35189,35192,0,3,0
10136,3,2,35192,35192,35194,0,2,0
10137,4,2,35196,35196,35198,0,2,2
10138,4,1,35200,35200,35201,0,1,2
10139,1,2,35201,35201,35203,0,2,0
10140,2,3,35203,35203,35206,0,3,0
10141,6,2,35209,35209,35211,0,2,3
10142,3,3,35212,35212,35215,0,3,1
10143,6,3,35218,35218,35221,0,3,3
10144,2,1,35220,35221,35222,1,2,0
10145,3,2,35223,35223,35225,0,2,1
10146,2,1,35225,35225,35226,0,1,0
10147,3,1,35228,35228,35229,0,1,2
10148,6,3,35234,35234,35237,0,3,5
10149,4,2,35238,35238,35240,0,2,1
10150,2,1,35240,35240,35241,0,1,0
10151,4,3,35244,35244,35247,0,3,3
10152,4,2,35248,35248,35250,0,2,1
10153,3,3,35251,35251,35254,0,3,1
10154,3,2,35254,35254,35256,0,2,0
10155,6,2,35260,35260,35262,0,2,4
10156,2,3,35262,35262,35265,0,3,0
10157,4,1,35266,35266,35267,0,1,1
10158,5,3,35271,35271,35274,0,3,4
10159,3,2,35274,35274,35276,0,2,0
10160,1,1,35275,35276,35277,1,2,0
10161,1,2,35276,35277,35279,1,3,0
10162,6,3,35282,35282,35285,0,3,3
10163,5,3,35287,35287,35290,0,3,2
10164,2,2,35289,35290,35292,1,3,0
10165,6,2,35295,35295,35297,0,2,3
10166,1,1,35296,35297,35298,1,2,0
10167,1,2,35297,35298,35300,1,3,0
10168,1,2,35298,35300,35302,2,4,0
10169,2,2,35300,35302,35304,2,4,0
10170,2,2,35302,35304,35306,2,4,0
10171,2,2,35304,35306,35308,2,4,0
10172,5,2,35309,35309,35311,0,2,1
10173,1,3,35310,35311,35314,1,4,0
10174,2,2,35312,35314,35316,2,4,0
10175,2,2,35314,35316,35318,2,4,0
10176,2,3,35316,35318,35321,2,5,0
10177,3,2,35319,35321,35323,2,4,0
10178,3,3,35322,35323,35326,1,4,0
10179,3,1,35325,35326,35327,1,2,0
10180,4,2,35329,35329,35331,0,2,2
10181,1,1,35330,35331,35332,1,2,0
10182,2,1,35332,35332,35333,0,1,0
10183,1,2,35333,35333,35335,0,2,0
10184,3,2,35336,35336,35338,0,2,1
10185,2,1,35338,35338,35339,0,1,0
10186,1,1,35339,35339,35340,0,1,0
10187,4,1,35343,35343,35344,0,1,3
10188,3,3,35346,35346,35349,0,3,2
10189,3,1,35349,35349,35350,0,1,0
10190,5,2,35354,35354,35356,0,2,4
10191,6,2,35360,35360,35362,0,2,4
10192,2,2,35362,35362,35364,0,2,0
10193,3,1,35365,35365,35366,0,1,1
10194,3,2,35368,35368,35370,0,2,2
10195,5,1,35373,35373,35374,0,1,3
10196,2,3,35375,35375,35378,0,3,1
10197,3,2,35378,35378,35380,0,2,0
10198,1,1,35379,35380,35381,1,2,0
10199,1,1,35380,35381,35382,1,2,0
10200,2,3,35382,35382,35385,0,3,0
10201,4,1,35386,35386,35387,0,1,1
10202,4,2,35390,35390,35392,0,2,3
10203,3,1,35393,35393,35394,0,1,1
10204,5,1,35398,35398,35399,0,1,4
10205,5,3,35403,35403,35406,0,3,4
10206,2,3,35405,35406,35409,1,4,0
10207,4,1,35409,35409,35410,0,1,0
10208,4,2,35413,35413,35415,0,2,3
10209,1,1,35414,35415,35416,1,2,0
10210,3,1,35417,35417,35418,0,1,1
10211,6,1,35423,35423,35424,0,1,5
10212,4,2,35427,35427,35429,0,2,3
10213,2,1,35429,35429,35430,0,1,0
10214,1,3,35430,35430,35433,0,3,0
10215,1,1,35431,35433,35434,2,3,0
10216,3,1,35434,35434,35435,0,1,0
10217,4,2,35438,35438,35440,0,2,3
10218,5,2,35443,35443,35445,0,2,3
10219,6,3,35449,35449,35452,0,3,4
10220,3,1,35452,35452,35453,0,1,0
10221,6,1,35458,35458,35459,0,1,5
10222,5,3,35463,35463,35466,0,3,4
10223,1,3,35464,35466,35469,2,5,0
10224,1,3,35465,35469,35472,4,7,0
10225,6,3,35471,35472,35475,1,4,0
10226,2,1,35473,35475,35476,2,3,0
10227,3,1,35476,35476,35477,0,1,0
10228,1,2,35477,35477,35479,0,2,0
10229,1,1,35478,35479,35480,1,2,0
10230,4,1,35482,35482,35483,0,1,2
10231,3,2,35485,35485,35487,0,2,2
10232,6,3,35491,35491,35494,0,3,4
10233,1,3,35492,35494,35497,2,5,0
10234,2,3,35494,35497,35500,3,6,0
10235,6,1,35500,35500,35501,0,1,0
10236,1,2,35501,35501,35503,0,2,0
10237,3,3,35504,35504,35507,0,3,1
10238,5,2,35509,35509,35511,0,2,2
10239,5,3,35514,35514,35517,0,3,3
10240,4,1,35518,35518,35519,0,1,1
10241,3,1,35521,35521,35522,0,1,2
10242,4,2,35525,35525,35527,0,2,3
10243,5,1,35530,35530,35531,0,1,3
10244,5,2,35535,35535,35537,0,2,4
10245,3,3,35538,35538,35541,0,3,1
10246,3,2,35541,35541,35543,0,2,0
10247,1,2,35542,35543,35545,1,3,0
10248,6,3,35548,35548,35551,0,3,3
10249,5,1,35553,35553,35554,0,1,2
10250,1,1,35554,35554,35555,0,1,0
10251,3,3,35557,35557,35560,0,3,2
10252,3,2,35560,35560,35562,0,2,0
10253,5,1,35565,35565,35566,0,1,3
10254,4,1,35569,35569,35570,0,1,3
10255,2,3,35571,35571,35574,0,3,1
10256,6,3,35577,35577,35580,0,3,3
10257,2,1,35579,35580,35581,1,2,0
10258,6,1,35585,35585,35586,0,1,4
10259,5,3,35590,35590,35593,0,3,4
10260,1,3,35591,35593,35596,2,5,0
10261,4,3,35595,35596,35599,1,4,0
10262,6,3,35601,35601,35604,0,3,2
10263,6,1,35607,35607,35608,0,1,3
10264,1,1,35608,35608,35609,0,1,0
10265,5,1,35613,35613,35614,0,1,4
10266,5,1,35618,35618,35619,0,1,4
10267,5,3,35623,35623,35626,0,3,4
10268,1,3,35624,35626,35629,2,5,0
10269,4,3,35628,35629,35632,1,4,0
10270,4,1,35632,35632,35633,0,1,0
10271,1,2,35633,35633,35635,0,2,0
10272,6,3,35639,35639,35642,0,3,4
10273,2,1,35641,35642,35643,1,2,0
10274,1,2,35642,35643,35645,1,3,0
10275,3,1,35645,35645,35646,0,1,0
10276,2,2,35647,35647,35649,0,2,1
10277,1,1,35648,35649,35650,1,2,0
10278,5,2,35653,35653,35655,0,2,3
10279,3,3,35656,35656,35659,0,3,1
10280,2,3,35658,35659,35662,1,4,0
10281,3,3,35661,35662,35665,1,4,0
10282,5,1,35666,35666,35667,0,1,1
10283,1,1,35667,35667,35668,0,1,0
10284,4,3,35671,35671,35674,0,3,3
10285,5,2,35676,35676,35678,0,2,2
10286,5,3,35681,35681,35684,0,3,3
10287,6,1,35687,35687,35688,0,1,3
10288,5,1,35692,35692,35693,0,1,4
10289,6,1,35698,35698,35699,0,1,5
10290,6,2,35704,35704,35706,0,2,5
10291,3,3,35707,35707,35710,0,3,1
10292,1,3,35708,35710,35713,2,5,0
10293,1,2,35709,35713,35715,4,6,0
10294,5,2,35714,35715,35717,1,3,0
10295,1,2,35715,35717,35719,2,4,0
10296,1,1,35716,35719,35720,3,4,0
10297,5,3,35721,35721,35724,0,3,1
10298,2,3,35723,35724,35727,1,4,0
10299,2,1,35725,35727,35728,2,3,0
10300,5,3,35730,35730,35733,0,3,2
10301,5,1,35735,35735,35736,0,1,2
10302,5,1,35740,35740,35741,0,1,4
10303,5,1,35745,35745,35746,0,1,4
10304,4,1,35749,35749,35750,0,1,3
10305,1,3,35750,35750,35753,0,3,0
10306,5,3,35755,35755,35758,0,3,2
10307,6,1,35761,35761,35762,0,1,3
10308,1,1,35762,35762,35763,0,1,0
10309,2,1,35764,35764,35765,0,1,1
10310,5,2,35769,35769,35771,0,2,4
10311,2,3,35771,35771,35774,0,3,0
10312,3,2,35774,35774,35776,0,2,0
10313,4,2,35778,35778,35780,0,2,2
10314,2,2,35780,35780,35782,0,2,0
10315,6,2,35786,35786,35788,0,2,4
10316,4,2,35790,35790,35792,0,2,2
10317,4,2,35794,35794,35796,0,2,2
10318,4,2,35798,35798,35800,0,2,2
10319,3,2,35801,35801,35803,0,2,1
10320,2,2,35803,35803,35805,0,2,0
10321,3,3,35806,35806,35809,0,3,1
10322,5,2,35811,35811,35813,0,2,2
10323,3,1,35814,35814,35815,0,1,1
10324,6,1,35820,35820,35821,0,1,5
10325,4,1,35824,35824,35825,0,1,3
10326,1,1,35825,35825,35826,0,1,0
10327,4,2,35829,35829,35831,0,2,3
10328,2,2,35831,35831,35833,0,2,0
10329,2,1,35833,35833,35834,0,1,0
10330,5,2,35838,35838,35840,0,2,4
10331,4,1,35842,35842,35843,0,1,2
10332,4,3,35846,35846,35849,0,3,3
10333,2,1,35848,35849,35850,1,2,0
10334,5,1,35853,35853,35854,0,1,3
10335,4,3,35857,35857,35860,0,3,3
10336,2,1,35859,35860,35861,1,2,0
10337,2,3,35861,35861,35864,0,3,0
10338,3,1,35864,35864,35865,0,1,0
10339,2,2,35866,35866,35868,0,2,1
10340,1,2,35867,35868,35870,1,3,0
10341,3,1,35870,35870,35871,0,1,0
10342,2,3,35872,35872,35875,0,3,1
10343,5,1,35877,35877,35878,0,1,2
10344,4,2,35881,35881,35883,0,2,3
10345,2,3,35883,35883,35886,0,3,0
10346,6,2,35889,35889,35891,0,2,3
10347,5,3,35894,35894,35897,0,3,3
10348,4,2,35898,35898,35900,0,2,1
10349,5,3,35903,35903,35906,0,3,3
10350,6,2,35909,35909,35911,0,2,3
10351,4,1,35913,35913,35914,0,1,2
10352,1,1,35914,35914,35915,0,1,0
10353,3,2,35917,35917,35919,0,2,2
10354,3,2,35920,35920,35922,0,2,1
10355,3,1,35923,35923,35924,0,1,1
10356,6,1,35929,35929,35930,0,1,5
10357,5,3,35934,35934,35937,0,3,4
10358,5,3,35939,35939,35942,0,3,2
10359,3,2,35942,35942,35944,0,2,0
10360,4,3,35946,35946,35949,0,3,2
10361,1,3,35947,35949,35952,2,5,0
10362,6,2,35953,35953,35955,0,2,1
10363,2,3,35955,35955,35958,0,3,0
10364,6,3,35961,35961,35964,0,3,3
10365,4,2,35965,35965,35967,0,2,1
10366,3,3,35968,35968,35971,0,3,1
10367,2,2,35970,35971,35973,1,3,0
10368,4,3,35974,35974,35977,0,3,1
10369,2,2,35976,35977,35979,1,3,0
10370,3,1,35979,35979,35980,0,1,0
10371,3,1,35982,35982,35983,0,1,2
10372,4,3,35986,35986,35989,0,3,3
10373,5,3,35991,35991,35994,0,3,2
10374,2,2,35993,35994,35996,1,3,0
10375,3,1,35996,35996,35997,0,1,0
10376,3,2,35999,35999,36001,0,2,2
10377,3,3,36002,36002,36005,0,3,1
10378,6,2,36008,36008,36010,0,2,3
10379,1,2,36009,36010,36012,1,3,0
10380,2,2,36011,36012,36014,1,3,0
10381,4,1,36015,36015,36016,0,1,1
10382,6,3,36021,36021,36024,0,3,5
10383,5,1,36026,36026,36027,0,1,2
10384,6,1,36032,36032,36033,0,1,5
10385,4,3,36036,36036,36039,0,3,3
10386,5,3,36041,36041,36044,0,3,2
10387,4,1,36045,36045,36046,0,1,1
10388,3,3,36048,36048,36051,0,3,2
10389,2,2,36050,36051,36053,1,3,0
10390,6,2,36056,36056,36058,0,2,3
10391,5,3,36061,36061,36064,0,3,3
10392,2,3,36063,36064,36067,1,4,0
10393,4,2,36067,36067,36069,0,2,0
10394,4,2,36071,36071,36073,0,2,2
10395,1,2,36072,36073,36075,1,3,0
10396,5,3,36077,36077,36080,0,3,2
10397,3,1,36080,36080,36081,0,1,0
10398,2,1,36082,36082,36083,0,1,1
10399,6,1,36088,36088,36089,0,1,5
10400,3,1,36091,36091,36092,0,1,2
10401,6,1,36097,36097,36098,0,1,5
10402,4,3,36101,36101,36104,0,3,3
10403,2,3,36103,36104,36107,1,4,0
10404,3,3,36106,36107,36110,1,4,0
10405,4,1,36110,36110,36111,0,1,0
10406,4,1,36114,36114,36115,0,1,3
10407,4,1,36118,36118,36119,0,1,3
10408,6,3,36124,36124,36127,0,3,5
10409,4,2,36128,36128,36130,0,2,1
10410,4,2,36132,36132,36134,0,2,2
10411,4,1,36136,36136,36137,0,1,2
10412,6,2,36142,36142,36144,0,2,5
10413,2,2,36144,36144,36146,0,2,0
10414,1,2,36145,36146,36148,1,3,0
10415,2,2,36147,36148,36150,1,3,0
10416,2,2,36149,36150,36152,1,3,0
10417,6,2,36155,36155,36157,0,2,3
10418,1,2,36156,36157,36159,1,3,0
10419,5,3,36161,36161,36164,0,3,2
10420,4,1,36165,36165,36166,0,1,1
10421,1,2,36166,36166,36168,0,2,0
10422,3,3,36169,36169,36172,0,3,1
10423,5,3,36174,36174,36177,0,3,2
10424,2,2,36176,36177,36179,1,3,0
10425,2,3,36178,36179,36182,1,4,0
10426,5,3,36183,36183,36186,0,3,1
10427,4,1,36187,36187,36188,0,1,1
10428,5,3,36192,36192,36195,0,3,4
10429,6,2,36198,36198,36200,0,2,3
10430,6,2,36204,36204,36206,0,2,4
10431,6,3,36210,36210,36213,0,3,4
10432,1,1,36211,36213,36214,2,3,0
10433,5,3,36216,36216,36219,0,3,2
10434,2,1,36218,36219,36220,1,2,0
10435,2,2,36220,36220,36222,0,2,0
10436,1,1,36221,36222,36223,1,2,0
10437,2,3,36223,36223,36226,0,3,0
10438,4,1,36227,36227,36228,0,1,1
10439,3,3,36230,36230,36233,0,3,2
10440,2,2,36232,36233,36235,1,3,0
10441,3,3,36235,36235,36238,0,3,0
10442,4,1,36239,36239,36240,0,1,1
10443,2,2,36241,36241,36243,0,2,1
10444,5,1,36246,36246,36247,0,1,3
10445,4,3,36250,36250,36253,0,3,3
10446,3,3,36253,36253,36256,0,3,0
10447,6,1,36259,36259,36260,0,1,3
10448,2,1,36261,36261,36262,0,1,1
10449,4,1,36265,36265,36266,0,1,3
10450,6,1,36271,36271,36272,0,1,5
10451,2,2,36273,36273,36275,0,2,1
10452,3,3,36276,36276,36279,0,3,1
10453,3,1,36279,36279,36280,0,1,0
10454,6,2,36285,36285,36287,0,2,5
10455,3,1,36288,36288,36289,0,1,1
10456,2,1,36290,36290,36291,0,1,1
10457,3,1,36293,36293,36294,0,1,2
10458,3,3,36296,36296,36299,0,3,2
10459,6,2,36302,36302,36304,0,2,3
10460,6,1,36308,36308,36309,0,1,4
10461,2,3,36310,36310,36313,0,3,1
10462,4,2,36314,36314,36316,0,2,1
10463,5,3,36319,36319,36322,0,3,3
10464,6,3,36325,36325,36328,0,3,3
10465,5,3,36330,36330,36333,0,3,2
10466,2,2,36332,36333,36335,1,3,0
10467,5,3,36337,36337,36340,0,3,2
10468,1,2,36338,36340,36342,2,4,0
10469,6,3,36344,36344,36347,0,3,2
10470,1,2,36345,36347,36349,2,4,0
10471,6,2,36351,36351,36353,0,2,2
10472,2,1,36353,36353,36354,0,1,0
10473,2,2,36355,36355,36357,0,2,1
10474,6,1,36361,36361,36362,0,1,4
10475,5,1,36366,36366,36367,0,1,4
10476,1,1,36367,36367,36368,0,1,0
10477,6,2,36373,36373,36375,0,2,5
10478,1,2,36374,36375,36377,1,3,0
10479,4,1,36378,36378,36379,0,1,1
10480,6,2,36384,36384,36386,0,2,5
10481,5,2,36389,36389,36391,0,2,3
10482,1,1,36390,36391,36392,1,2,0
10483,4,1,36394,36394,36395,0,1,2
10484,2,3,36396,36396,36399,0,3,1
10485,1,1,36397,36399,36400,2,3,0
10486,5,3,36402,36402,36405,0,3,2
10487,5,3,36407,36407,36410,0,3,2
10488,4,3,36411,36411,36414,0,3,1
10489,1,3,36412,36414,36417,2,5,0
10490,5,1,36417,36417,36418,0,1,0
10491,2,3,36419,36419,36422,0,3,1
10492,4,2,36423,36423,36425,0,2,1
10493,5,2,36428,36428,36430,0,2,3
10494,3,2,36431,36431,36433,0,2,1
10495,1,3,36432,36433,36436,1,4,0
10496,2,2,36434,36436,36438,2,4,0
10497,4,3,36438,36438,36441,0,3,0
10498,5,2,36443,36443,36445,0,2,2
10499,2,2,36445,36445,36447,0,2,0
10500,2,2,36447,36447,36449,0,2,0
10501,2,3,36449,36449,36452,0,3,0
10502,1,2,36450,36452,36454,2,4,0
10503,2,2,36452,36454,36456,2,4,0
10504,5,2,36457,36457,36459,0,2,1
10505,3,2,36460,36460,36462,0,2,1
10506,3,3,36463,36463,36466,0,3,1
10507,5,3,36468,36468,36471,0,3,2
10508,3,3,36471,36471,36474,0,3,0
10509,4,2,36475,36475,36477,0,2,1
10510,1,3,36476,36477,36480,1,4,0
10511,4,3,36480,36480,36483,0,3,0
10512,4,3,36484,36484,36487,0,3,1
10513,2,1,36486,36487,36488,1,2,0
10514,6,3,36492,36492,36495,0,3,4
10515,6,3,36498,36498,36501,0,3,3
10516,3,2,36501,36501,36503,0,2,0
10517,3,3,36504,36504,36507,0,3,1
10518,5,1,36509,36509,36510,0,1,2
10519,3,3,36512,36512,36515,0,3,2
10520,3,2,36515,36515,36517,0,2,0
10521,6,3,36521,36521,36524,0,3,4
10522,3,1,36524,36524,36525,0,1,0
10523,4,2,36528,36528,36530,0,2,3
10524,4,2,36532,36532,36534,0,2,2
10525,2,1,36534,36534,36535,0,1,0
10526,3,3,36537,36537,36540,0,3,2
10527,3,2,36540,36540,36542,0,2,0
10528,4,3,36544,36544,36547,0,3,2
10529,5,2,36549,36549,36551,0,2,2
10530,4,2,36553,36553,36555,0,2,2
10531,6,1,36559,36559,36560,0,1,4
10532,2,3,36561,36561,36564,0,3,1
10533,2,1,36563,36564,36565,1,2,0
10534,2,3,36565,36565,36568,0,3,0
10535,3,2,36568,36568,36570,0,2,0
10536,3,3,36571,36571,36574,0,3,1
10537,3,2,36574,36574,36576,0,2,0
10538,1,2,36575,36576,36578,1,3,0
10539,1,1,36576,36578,36579,2,3,0
10540,2,1,36578,36579,36580,1,2,0
10541,5,2,36583,36583,36585,0,2,3
10542,5,3,36588,36588,36591,0,3,3
10543,5,2,36593,36593,36595,0,2,2
10544,1,2,36594,36595,36597,1,3,0
10545,1,1,36595,36597,36598,2,3,0
10546,6,1,36601,36601,36602,0,1,3
10547,2,3,36603,36603,36606,0,3,1
10548,2,1,36605,36606,36607,1,2,0
10549,5,2,36610,36610,36612,0,2,3
10550,6,3,36616,36616,36619,0,3,4
10551,2,3,36618,36619,36622,1,4,0
10552,3,1,36621,36622,36623,1,2,0
10553,2,3,36623,36623,36626,0,3,0
10554,4,1,36627,36627,36628,0,1,1
10555,5,1,36632,36632,36633,0,1,4
10556,6,1,36638,36638,36639,0,1,5
10557,2,2,36640,36640,36642,0,2,1
10558,5,2,36645,36645,36647,0,2,3
10559,6,3,36651,36651,36654,0,3,4
10560,5,2,36656,36656,36658,0,2,2
10561,1,3,36657,36658,36661,1,4,0
10562,1,3,36658,36661,36664,3,6,0
10563,4,1,36662,36664,36665,2,3,0
10564,2,3,36664,36665,36668,1,4,0
10565,6,2,36670,36670,36672,0,2,2
10566,4,1,36674,36674,36675,0,1,2
10567,5,2,36679,36679,36681,0,2,4
10568,4,1,36683,36683,36684,0,1,2
10569,2,1,36685,36685,36686,0,1,1
10570,5,1,36690,36690,36691,0,1,4
10571,4,2,36694,36694,36696,0,2,3
10572,1,2,36695,36696,36698,1,3,0
10573,6,1,36701,36701,36702,0,1,3
10574,1,2,36702,36702,36704,0,2,0
10575,5,1,36707,36707,36708,0,1,3
10576,1,2,36708,36708,36710,0,2,0
10577,4,1,36712,36712,36713,0,1,2
10578,2,1,36714,36714,36715,0,1,1
10579,1,1,36715,36715,36716,0,1,0
10580,3,2,36718,36718,36720,0,2,2
10581,1,1,36719,36720,36721,1,2,0
10582,3,1,36722,36722,36723,0,1,1
10583,5,1,36727,36727,36728,0,1,4
10584,1,3,36728,36728,36731,0,3,0
10585,1,2,36729,36731,36733,2,4,0
10586,4,1,36733,36733,36734,0,1,0
10587,4,3,36737,36737,36740,0,3,3
10588,2,1,36739,36740,36741,1,2,0
10589,4,2,36743,36743,36745,0,2,2
10590,6,2,36749,36749,36751,0,2,4
10591,6,3,36755,36755,36758,0,3,4
10592,4,2,36759,36759,36761,0,2,1
10593,6,2,36765,36765,36767,0,2,4
10594,1,3,36766,36767,36770,1,4,0
10595,5,1,36771,36771,36772,0,1,1
10596,3,3,36774,36774,36777,0,3,2
10597,1,1,36775,36777,36778,2,3,0
10598,3,2,36778,36778,36780,0,2,0
10599,5,1,36783,36783,36784,0,1,3
10600,4,1,36787,36787,36788,0,1,3
10601,5,3,36792,36792,36795,0,3,4
10602,3,3,36795,36795,36798,0,3,0
10603,5,2,36800,36800,36802,0,2,2
10604,2,3,36802,36802,36805,0,3,0
10605,3,2,36805,36805,36807,0,2,0
10606,1,1,36806,36807,36808,1,2,0
10607,5,1,36811,36811,36812,0,1,3
10608,3,2,36814,36814,36816,0,2,2
10609,1,2,36815,36816,36818,1,3,0
10610,6,3,36821,36821,36824,0,3,3
10611,1,1,36822,36824,36825,2,3,0
10612,4,2,36826,36826,36828,0,2,1
10613,2,2,36828,36828,36830,0,2,0
10614,6,1,36834,36834,36835,0,1,4
10615,3,3,36837,36837,36840,0,3,2
10616,6,3,36843,36843,36846,0,3,3
10617,2,3,36845,36846,36849,1,4,0
10618,5,2,36850,36850,36852,0,2,1
10619,1,3,36851,36852,36855,1,4,0
10620,4,1,36855,36855,36856,0,1,0
10621,4,1,36859,36859,36860,0,1,3
10622,6,2,36865,36865,36867,0,2,5
10623,1,2,36866,36867,36869,1,3,0
10624,2,2,36868,36869,36871,1,3,0
10625,6,3,36874,36874,36877,0,3,3
10626,2,2,36876,36877,36879,1,3,0
10627,4,1,36880,36880,36881,0,1,1
10628,1,3,36881,36881,36884,0,3,0
10629,2,1,36883,36884,36885,1,2,0
10630,5,1,36888,36888,36889,0,1,3
10631,3,2,36891,36891,36893,0,2,2
10632,1,1,36892,36893,36894,1,2,0
10633,3,2,36895,36895,36897,0,2,1
10634,3,1,36898,36898,36899,0,1,1
10635,6,3,36904,36904,36907,0,3,5
10636,2,3,36906,36907,36910,1,4,0
10637,4,1,36910,36910,36911,0,1,0
10638,2,2,36912,36912,36914,0,2,1
10639,3,1,36915,36915,36916,0,1,1
10640,1,1,36916,36916,36917,0,1,0
10641,3,3,36919,36919,36922,0,3,2
10642,4,3,36923,36923,36926,0,3,1
10643,1,3,36924,36926,36929,2,5,0
10644,3,2,36927,36929,36931,2,4,0
10645,4,1,36931,36931,36932,0,1,0
10646,3,1,36934,36934,36935,0,1,2
10647,5,3,36939,36939,36942,0,3,4
10648,2,1,36941,36942,36943,1,2,0
10649,5,1,36946,36946,36947,0,1,3
10650,1,3,36947,36947,36950,0,3,0
10651,1,1,36948,36950,36951,2,3,0
10652,4,3,36952,36952,36955,0,3,1
10653,5,2,36957,36957,36959,0,2,2
10654,5,3,36962,36962,36965,0,3,3
10655,1,3,36963,36965,36968,2,5,0
10656,5,1,36968,36968,36969,0,1,0
10657,4,2,36972,36972,36974,0,2,3
10658,3,3,36975,36975,36978,0,3,1
10659,6,2,36981,36981,36983,0,2,3
10660,3,1,36984,36984,36985,0,1,1
10661,4,3,36988,36988,36991,0,3,3
10662,5,3,36993,36993,36996,0,3,2
10663,1,2,36994,36996,36998,2,4,0
10664,4,1,36998,36998,36999,0,1,0
10665,6,2,37004,37004,37006,0,2,5
10666,6,3,37010,37010,37013,0,3,4
10667,1,2,37011,37013,37015,2,4,0
10668,3,3,37014,37015,37018,1,4,0
10669,2,1,37016,37018,37019,2,3,0
10670,6,3,37022,37022,37025,0,3,3
10671,4,1,37026,37026,37027,0,1,1
10672,1,1,37027,37027,37028,0,1,0
10673,1,3,37028,37028,37031,0,3,0
10674,1,1,37029,37031,37032,2,3,0
10675,2,2,37031,37032,37034,1,3,0
10676,1,2,37032,37034,37036,2,4,0
10677,4,3,37036,37036,37039,0,3,0
10678,6,1,37042,37042,37043,0,1,3
10679,3,2,37045,37045,37047,0,2,2
10680,1,3,37046,37047,37050,1,4,0
10681,5,1,37051,37051,37052,0,1,1
10682,2,1,37053,37053,37054,0,1,1
10683,2,2,37055,37055,37057,0,2,1
10684,1,3,37056,37057,37060,1,4,0
10685,3,1,37059,37060,37061,1,2,0
10686,2,3,37061,37061,37064,0,3,0
10687,6,1,37067,37067,37068,0,1,3
10688,1,2,37068,37068,37070,0,2,0
10689,5,3,37073,37073,37076,0,3,3
10690,4,2,37077,37077,37079,0,2,1
10691,6,3,37083,37083,37086,0,3,4
10692,6,2,37089,37089,37091,0,2,3
10693,4,3,37093,37093,37096,0,3,2
10694,1,2,37094,37096,37098,2,4,0
10695,5,3,37099,37099,37102,0,3,1
10696,2,1,37101,37102,37103,1,2,0
10697,6,1,37107,37107,37108,0,1,4
10698,3,3,37110,37110,37113,0,3,2
10699,3,1,37113,37113,37114,0,1,0
10700,5,3,37118,37118,37121,0,3,4
10701,6,3,37124,37124,37127,0,3,3
10702,3,1,37127,37127,37128,0,1,0
10703,2,1,37129,37129,37130,0,1,1
10704,5,3,37134,37134,37137,0,3,4
10705,2,2,37136,37137,37139,1,3,0
10706,6,1,37142,37142,37143,0,1,3
10707,3,3,37145,37145,37148,0,3,2
10708,6,2,37151,37151,37153,0,2,3
10709,4,1,37155,37155,37156,0,1,2
10710,2,2,37157,37157,37159,0,2,1
10711,2,3,37159,37159,37162,0,3,0
10712,3,2,37162,37162,37164,0,2,0
10713,6,3,37168,37168,37171,0,3,4
10714,2,3,37170,37171,37174,1,4,0
10715,5,3,37175,37175,37178,0,3,1
10716,4,3,37179,37179,37182,0,3,1
10717,4,2,37183,37183,37185,0,2,1
10718,1,1,37184,37185,37186,1,2,0
10719,4,2,37188,37188,37190,0,2,2
10720,2,1,37190,37190,37191,0,1,0
10721,5,2,37195,37195,37197,0,2,4
10722,6,3,37201,37201,37204,0,3,4
10723,5,2,37206,37206,37208,0,2,2
10724,6,3,37212,37212,37215,0,3,4
10725,5,3,37217,37217,37220,0,3,2
10726,3,2,37220,37220,37222,0,2,0
10727,5,1,37225,37225,37226,0,1,3
10728,2,3,37227,37227,37230,0,3,1
10729,3,1,37230,37230,37231,0,1,0
10730,5,1,37235,37235,37236,0,1,4
10731,5,3,37240,37240,37243,0,3,4
10732,4,3,37244,37244,37247,0,3,1
10733,2,2,37246,37247,37249,1,3,0
10734,5,3,37251,37251,37254,0,3,2
10735,5,2,37256,37256,37258,0,2,2
10736,5,2,37261,37261,37263,0,2,3
10737,5,1,37266,37266,37267,0,1,3
10738,1,3,37267,37267,37270,0,3,0
10739,1,2,37268,37270,37272,2,4,0
10740,5,3,37273,37273,37276,0,3,1
10741,3,2,37276,37276,37278,0,2,0
10742,1,2,37277,37278,37280,1,3,0
10743,4,3,37281,37281,37284,0,3,1
10744,2,2,37283,37284,37286,1,3,0
10745,2,1,37285,37286,37287,1,2,0
10746,6,3,37291,37291,37294,0,3,4
10747,1,3,37292,37294,37297,2,5,0
10748,4,3,37296,37297,37300,1,4,0
10749,5,2,37301,37301,37303,0,2,1
10750,6,3,37307,37307,37310,0,3,4
10751,2,2,37309,37310,37312,1,3,0
10752,2,1,37311,37312,37313,1,2,0
10753,5,3,37316,37316,37319,0,3,3
10754,3,3,37319,37319,37322,0,3,0
10755,2,2,37321,37322,37324,1,3,0
10756,6,3,37327,37327,37330,0,3,3
10757,2,3,37329,37330,37333,1,4,0
10758,3,1,37332,37333,37334,1,2,0
10759,4,1,37336,37336,37337,0,1,2
10760,6,2,37342,37342,37344,0,2,5
10761,4,1,37346,37346,37347,0,1,2
10762,5,2,37351,37351,37353,0,2,4
10763,5,1,37356,37356,37357,0,1,3
10764,6,2,37362,37362,37364,0,2,5
10765,4,1,37366,37366,37367,0,1,2
10766,2,3,37368,37368,37371,0,3,1
10767,3,3,37371,37371,37374,0,3,0
10768,4,1,37375,37375,37376,0,1,1
10769,4,3,37379,37379,37382,0,3,3
10770,2,1,37381,37382,37383,1,2,0
10771,1,2,37382,37383,37385,1,3,0
10772,4,3,37386,37386,37389,0,3,1
10773,3,1,37389,37389,37390,0,1,0
10774,3,1,37392,37392,37393,0,1,2
10775,6,2,37398,37398,37400,0,2,5
10776,2,1,37400,37400,37401,0,1,0
10777,3,2,37403,37403,37405,0,2,2
10778,6,1,37409,37409,37410,0,1,4
10779,2,1,37411,37411,37412,0,1,1
10780,2,2,37413,37413,37415,0,2,1
10781,4,2,37417,37417,37419,0,2,2
10782,5,2,37422,37422,37424,0,2,3
10783,1,2,37423,37424,37426,1,3,0
10784,3,2,37426,37426,37428,0,2,0
10785,6,3,37432,37432,37435,0,3,4
10786,3,1,37435,37435,37436,0,1,0
10787,2,1,37437,37437,37438,0,1,1
10788,4,1,37441,37441,37442,0,1,3
10789,5,3,37446,37446,37449,0,3,4
10790,5,3,37451,37451,37454,0,3,2
10791,6,3,37457,37457,37460,0,3,3
10792,6,2,37463,37463,37465,0,2,3
10793,2,1,37465,37465,37466,0,1,0
10794,3,2,37468,37468,37470,0,2,2
10795,2,1,37470,37470,37471,0,1,0
10796,5,3,37475,37475,37478,0,3,4
10797,4,1,37479,37479,37480,0,1,1
10798,1,3,37480,37480,37483,0,3,0
10799,1,1,37481,37483,37484,2,3,0
10800,3,2,37484,37484,37486,0,2,0
10801,1,3,37485,37486,37489,1,4,0
10802,4,1,37489,37489,37490,0,1,0
10803,1,2,37490,37490,37492,0,2,0
10804,3,2,37493,37493,37495,0,2,1
10805,4,3,37497,37497,37500,0,3,2
10806,1,2,37498,37500,37502,2,4,0
10807,2,1,37500,37502,37503,2,3,0
10808,3,2,37503,37503,37505,0,2,0
10809,5,2,37508,37508,37510,0,2,3
10810,3,3,37511,37511,37514,0,3,1
10811,1,2,37512,37514,37516,2,4,0
10812,3,1,37515,37516,37517,1,2,0
10813,1,3,37516,37517,37520,1,4,0
10814,5,1,37521,37521,37522,0,1,1
10815,4,3,37525,37525,37528,0,3,3
10816,2,3,37527,37528,37531,1,4,0
10817,1,1,37528,37531,37532,3,4,0
10818,1,2,37529,37532,37534,3,5,0
10819,4,2,37533,37534,37536,1,3,0
10820,1,3,37534,37536,37539,2,5,0
10821,5,2,37539,37539,37541,0,2,0
10822,6,1,37545,37545,37546,0,1,4
10823,4,2,37549,37549,37551,0,2,3
10824,2,3,37551,37551,37554,0,3,0
10825,6,2,37557,37557,37559,0,2,3
10826,2,2,37559,37559,37561,0,2,0
10827,4,2,37563,37563,37565,0,2,2
10828,2,1,37565,37565,37566,0,1,0
10829,1,3,37566,37566,37569,0,3,0
10830,4,3,37570,37570,37573,0,3,1
10831,1,3,37571,37573,37576,2,5,0
10832,2,3,37573,37576,37579,3,6,0
10833,6,3,37579,37579,37582,0,3,0
10834,3,1,37582,37582,37583,0,1,0
10835,6,2,37588,37588,37590,0,2,5
10836,5,1,37593,37593,37594,0,1,3
10837,4,2,37597,37597,37599,0,2,3
10838,5,2,37602,37602,37604,0,2,3
10839,5,3,37607,37607,37610,0,3,3
10840,3,1,37610,37610,37611,0,1,0
10841,4,2,37614,37614,37616,0,2,3
10842,5,1,37619,37619,37620,0,1,3
10843,6,1,37625,37625,37626,0,1,5
10844,1,3,37626,37626,37629,0,3,0
10845,3,3,37629,37629,37632,0,3,0
10846,2,3,37631,37632,37635,1,4,0
10847,5,1,37636,37636,37637,0,1,1
10848,3,3,37639,37639,37642,0,3,2
10849,6,2,37645,37645,37647,0,2,3
10850,5,1,37650,37650,37651,0,1,3
10851,5,2,37655,37655,37657,0,2,4
10852,3,1,37658,37658,37659,0,1,1
10853,6,1,37664,37664,37665,0,1,5
10854,3,3,37667,37667,37670,0,3,2
10855,5,1,37672,37672,37673,0,1,2
10856,4,1,37676,37676,37677,0,1,3
10857,5,3,37681,37681,37684,0,3,4
10858,6,3,37687,37687,37690,0,3,3
10859,5,2,37692,37692,37694,0,2,2
10860,4,2,37696,37696,37698,0,2,2
10861,6,1,37702,37702,37703,0,1,4
10862,1,3,37703,37703,37706,0,3,0
10863,6,1,37709,37709,37710,0,1,3
10864,1,1,37710,37710,37711,0,1,0
10865,1,2,37711,37711,37713,0,2,0
10866,1,3,37712,37713,37716,1,4,0
10867,3,2,37715,37716,37718,1,3,0
10868,2,1,37717,37718,37719,1,2,0
10869,6,1,37723,37723,37724,0,1,4
10870,4,3,37727,37727,37730,0,3,3
10871,5,2,37732,37732,37734,0,2,2
10872,3,1,37735,37735,37736,0,1,1
10873,1,1,37736,37736,37737,0,1,0
10874,3,2,37739,37739,37741,0,2,2
10875,4,1,37743,37743,37744,0,1,2
10876,3,3,37746,37746,37749,0,3,2
10877,4,3,37750,37750,37753,0,3,1
10878,6,1,37756,37756,37757,0,1,3
10879,3,2,37759,37759,37761,0,2,2
10880,5,3,37764,37764,37767,0,3,3
10881,4,1,37768,37768,37769,0,1,1
10882,3,3,37771,37771,37774,0,3,2
10883,6,3,37777,37777,37780,0,3,3
10884,6,1,37783,37783,37784,0,1,3
10885,2,2,37785,37785,37787,0,2,1
10886,1,1,37786,37787,37788,1,2,0
10887,2,1,37788,37788,37789,0,1,0
10888,1,3,37789,37789,37792,0,3,0
10889,5,2,37794,37794,37796,0,2,2
10890,5,3,37799,37799,37802,0,3,3
10891,5,1,37804,37804,37805,0,1,2
10892,1,1,37805,37805,37806,0,1,0
10893,1,2,37806,37806,37808,0,2,0
10894,5,1,37811,37811,37812,0,1,3
10895,4,2,37815,37815,37817,0,2,3
10896,1,1,37816,37817,37818,1,2,0
10897,3,3,37819,37819,37822,0,3,1
10898,6,3,37825,37825,37828,0,3,3
10899,4,3,37829,37829,37832,0,3,1
10900,3,2,37832,37832,37834,0,2,0
10901,4,1,37836,37836,37837,0,1,2
10902,3,2,37839,37839,37841,0,2,2
10903,5,2,37844,37844,37846,0,2,3
10904,1,1,37845,37846,37847,1,2,0
10905,5,1,37850,37850,37851,0,1,3
10906,5,3,37855,37855,37858,0,3,4
10907,4,2,37859,37859,37861,0,2,1
10908,3,2,37862,37862,37864,0,2,1
10909,5,3,37867,37867,37870,0,3,3
10910,2,3,37869,37870,37873,1,4,0
10911,5,1,37874,37874,37875,0,1,1
10912,4,3,37878,37878,37881,0,3,3
10913,2,2,37880,37881,37883,1,3,0
10914,5,1,37885,37885,37886,0,1,2
10915,1,1,37886,37886,37887,0,1,0
10916,6,3,37892,37892,37895,0,3,5
10917,5,3,37897,37897,37900,0,3,2
10918,4,1,37901,37901,37902,0,1,1
10919,3,2,37904,37904,37906,0,2,2
10920,1,1,37905,37906,37907,1,2,0
10921,4,2,37909,37909,37911,0,2,2
10922,1,2,37910,37911,37913,1,3,0
10923,5,2,37915,37915,37917,0,2,2
10924,6,2,37921,37921,37923,0,2,4
10925,4,3,37925,37925,37928,0,3,2
10926,4,3,37929,37929,37932,0,3,1
10927,3,3,37932,37932,37935,0,3,0
10928,1,3,37933,37935,37938,2,5,0
10929,1,3,37934,37938,37941,4,7,0
10930,3,1,37937,37941,37942,4,5,0
10931,4,2,37941,37942,37944,1,3,0
10932,2,2,37943,37944,37946,1,3,0
10933,5,1,37948,37948,37949,0,1,2
10934,2,1,37950,37950,37951,0,1,1
10935,6,3,37956,37956,37959,0,3,5
10936,4,1,37960,37960,37961,0,1,1
10937,6,1,37966,37966,37967,0,1,5
10938,6,2,37972,37972,37974,0,2,5
10939,5,1,37977,37977,37978,0,1,3
10940,1,2,37978,37978,37980,0,2,0
10941,4,3,37982,37982,37985,0,3,2
10942,3,3,37985,37985,37988,0,3,0
10943,3,1,37988,37988,37989,0,1,0
10944,4,1,37992,37992,37993,0,1,3
10945,6,1,37998,37998,37999,0,1,5
10946,5,1,38003,38003,38004,0,1,4
10947,6,3,38009,38009,38012,0,3,5
10948,4,3,38013,38013,38016,0,3,1
10949,5,3,38018,38018,38021,0,3,2
10950,5,3,38023,38023,38026,0,3,2
10951,4,2,38027,38027,38029,0,2,1
10952,2,2,38029,38029,38031,0,2,0
10953,6,2,38035,38035,38037,0,2,4
10954,1,3,38036,38037,38040,1,4,0
10955,2,2,38038,38040,38042,2,4,0
10956,2,1,38040,38042,38043,2,3,0
10957,2,2,38042,38043,38045,1,3,0
10958,6,1,38048,38048,38049,0,1,3
10959,3,3,38051,38051,38054,0,3,2
10960,6,2,38057,38057,38059,0,2,3
10961,2,1,38059,38059,38060,0,1,0
10962,1,1,38060,38060,38061,0,1,0
10963,6,1,38066,38066,38067,0,1,5
10964,4,3,38070,38070,38073,0,3,3
10965,6,1,38076,38076,38077,0,1,3
10966,4,3,38080,38080,38083,0,3,3
10967,2,3,38082,38083,38086,1,4,0
10968,3,2,38085,38086,38088,1,3,0
10969,5,2,38090,38090,38092,0,2,2
10970,5,2,38095,38095,38097,0,2,3
10971,2,3,38097,38097,38100,0,3,0
10972,1,1,38098,38100,38101,2,3,0
10973,5,3,38103,38103,38106,0,3,2
10974,6,2,38109,38109,38111,0,2,3
10975,5,1,38114,38114,38115,0,1,3
10976,5,2,38119,38119,38121,0,2,4
10977,2,3,38121,38121,38124,0,3,0
10978,1,2,38122,38124,38126,2,4,0
10979,2,1,38124,38126,38127,2,3,0
10980,2,2,38126,38127,38129,1,3,0
10981,3,2,38129,38129,38131,0,2,0
10982,3,1,38132,38132,38133,0,1,1
10983,1,2,38133,38133,38135,0,2,0
10984,5,3,38138,38138,38141,0,3,3
10985,4,3,38142,38142,38145,0,3,1
10986,2,2,38144,38145,38147,1,3,0
10987,6,2,38150,38150,38152,0,2,3
10988,5,1,38155,38155,38156,0,1,3
10989,3,3,38158,38158,38161,0,3,2
10990,5,1,38163,38163,38164,0,1,2
10991,3,3,38166,38166,38169,0,3,2
10992,4,2,38170,38170,38172,0,2,1
10993,3,2,38173,38173,38175,0,2,1
10994,1,3,38174,38175,38178,1,4,0
10995,2,1,38176,38178,38179,2,3,0
10996,6,1,38182,38182,38183,0,1,3
10997,1,1,38183,38183,38184,0,1,0
10998,4,3,38187,38187,38190,0,3,3
10999,1,1,38188,38190,38191,2,3,0
11000,6,2,38194,38194,38196,0,2,3
11001,2,2,38196,38196,38198,0,2,0
11002,1,1,38197,38198,38199,1,2,0
11003,6,3,38203,38203,38206,0,3,4
11004,5,3,38208,38208,38211,0,3,2
11005,3,3,38211,38211,38214,0,3,0
11006,4,2,38215,38215,38217,0,2,1
11007,4,3,38219,38219,38222,0,3,2
11008,6,2,38225,38225,38227,0,2,3
11009,4,2,38229,38229,38231,0,2,2
11010,6,2,38235,38235,38237,0,2,4
11011,2,1,38237,38237,38238,0,1,0
11012,3,3,38240,38240,38243,0,3,2
11013,1,3,38241,38243,38246,2,5,0
11014,2,1,38243,38246,38247,3,4,0
11015,3,3,38246,38247,38250,1,4,0
11016,6,2,38252,38252,38254,0,2,2
11017,2,3,38254,38254,38257,0,3,0
11018,2,3,38256,38257,38260,1,4,0
11019,3,1,38259,38260,38261,1,2,0
11020,4,2,38263,38263,38265,0,2,2
11021,1,3,38264,38265,38268,1,4,0
11022,5,2,38269,38269,38271,0,2,1
11023,1,1,38270,38271,38272,1,2,0
11024,1,1,38271,38272,38273,1,2,0
11025,4,1,38275,38275,38276,0,1,2
11026,6,3,38281,38281,38284,0,3,5
11027,1,3,38282,38284,38287,2,5,0
11028,3,3,38285,38287,38290,2,5,0
11029,4,2,38289,38290,38292,1,3,0
11030,6,3,38295,38295,38298,0,3,3
11031,4,3,38299,38299,38302,0,3,1
11032,2,2,38301,38302,38304,1,3,0
11033,2,1,38303,38304,38305,1,2,0
11034,2,2,38305,38305,38307,0,2,0
11035,5,1,38310,38310,38311,0,1,3
11036,3,3,38313,38313,38316,0,3,2
11037,3,1,38316,38316,38317,0,1,0
11038,2,1,38318,38318,38319,0,1,1
11039,5,2,38323,38323,38325,0,2,4
11040,2,1,38325,38325,38326,0,1,0
11041,6,1,38331,38331,38332,0,1,5
11042,3,1,38334,38334,38335,0,1,2
11043,3,3,38337,38337,38340,0,3,2
11044,4,1,38341,38341,38342,0,1,1
11045,1,3,38342,38342,38345,0,3,0
11046,2,3,38344,38345,38348,1,4,0
11047,2,3,38346,38348,38351,2,5,0
11048,4,1,38350,38351,38352,1,2,0
11049,1,2,38351,38352,38354,1,3,0
11050,1,2,38352,38354,38356,2,4,0
11051,2,1,38354,38356,38357,2,3,0
11052,5,3,38359,38359,38362,0,3,2
11053,1,1,38360,38362,38363,2,3,0
11054,2,1,38362,38363,38364,1,2,0
11055,6,1,38368,38368,38369,0,1,4
11056,6,3,38374,38374,38377,0,3,5
11057,4,3,38378,38378,38381,0,3,1
11058,5,2,38383,38383,38385,0,2,2
11059,4,3,38387,38387,38390,0,3,2
11060,1,1,38388,38390,38391,2,3,0
11061,1,3,38389,38391,38394,2,5,0
11062,4,3,38393,38394,38397,1,4,0
11063,4,3,38397,38397,38400,0,3,0
11064,5,2,38402,38402,38404,0,2,2
11065,3,1,38405,38405,38406,0,1,1
11066,4,2,38409,38409,38411,0,2,3
11067,3,1,38412,38412,38413,0,1,1
11068,6,3,38418,38418,38421,0,3,5
11069,3,3,38421,38421,38424,0,3,0
11070,3,1,38424,38424,38425,0,1,0
11071,6,3,38430,38430,38433,0,3,5
11072,6,2,38436,38436,38438,0,2,3
11073,6,3,38442,38442,38445,0,3,4
11074,3,2,38445,38445,38447,0,2,0
11075,6,2,38451,38451,38453,0,2,4
11076,6,1,38457,38457,38458,0,1,4
11077,2,3,38459,38459,38462,0,3,1
11078,6,1,38465,38465,38466,0,1,3
11079,2,1,38467,38467,38468,0,1,1
11080,1,1,38468,38468,38469,0,1,0
11081,3,3,38471,38471,38474,0,3,2
11082,6,3,38477,38477,38480,0,3,3
11083,1,1,38478,38480,38481,2,3,0
11084,6,3,38484,38484,38487,0,3,3
11085,1,3,38485,38487,38490,2,5,0
11086,6,2,38491,38491,38493,0,2,1
11087,5,1,38496,38496,38497,0,1,3
11088,2,1,38498,38498,38499,0,1,1
11089,2,1,38500,38500,38501,0,1,1
11090,6,2,38506,38506,38508,0,2,5
11091,2,3,38508,38508,38511,0,3,0
11092,2,2,38510,38511,38513,1,3,0
11093,4,3,38514,38514,38517,0,3,1
11094,2,2,38516,38517,38519,1,3,0
11095,6,2,38522,38522,38524,0,2,3
11096,1,1,38523,38524,38525,1,2,0
11097,3,1,38526,38526,38527,0,1,1
11098,4,2,38530,38530,38532,0,2,3
11099,1,3,38531,38532,38535,1,4,0
11100,5,3,38536,38536,38539,0,3,1
11101,3,2,38539,38539,38541,0,2,0
11102,1,3,38540,38541,38544,1,4,0
11103,6,3,38546,38546,38549,0,3,2
11104,3,3,38549,38549,38552,0,3,0
11105,3,1,38552,38552,38553,0,1,0
11106,1,2,38553,38553,38555,0,2,0
11107,5,1,38558,38558,38559,0,1,3
11108,5,2,38563,38563,38565,0,2,4
11109,5,1,38568,38568,38569,0,1,3
11110,2,2,38570,38570,38572,0,2,1
11111,3,1,38573,38573,38574,0,1,1
11112,3,1,38576,38576,38577,0,1,2
11113,5,3,38581,38581,38584,0,3,4
11114,5,2,38586,38586,38588,0,2,2
11115,6,2,38592,38592,38594,0,2,4
11116,6,1,38598,38598,38599,0,1,4
11117,2,1,38600,38600,38601,0,1,1
11118,6,1,38606,38606,38607,0,1,5
11119,4,1,38610,38610,38611,0,1,3
11120,4,3,38614,38614,38617,0,3,3
11121,3,1,38617,38617,38618,0,1,0
11122,4,3,38621,38621,38624,0,3,3
11123,3,2,38624,38624,38626,0,2,0
11124,5,3,38629,38629,38632,0,3,3
11125,4,1,38633,38633,38634,0,1,1
11126,6,3,38639,38639,38642,0,3,5
11127,4,1,38643,38643,38644,0,1,1
11128,3,2,38646,38646,38648,0,2,2
11129,4,1,38650,38650,38651,0,1,2
11130,2,2,38652,38652,38654,0,2,1
11131,6,3,38658,38658,38661,0,3,4
11132,4,3,38662,38662,38665,0,3,1
11133,5,2,38667,38667,38669,0,2,2
11134,6,1,38673,38673,38674,0,1,4
11135,5,2,38678,38678,38680,0,2,4
11136,4,3,38682,38682,38685,0,3,2
11137,4,3,38686,38686,38689,0,3,1
11138,4,3,38690,38690,38693,0,3,1
11139,4,2,38694,38694,38696,0,2,1
11140,2,3,38696,38696,38699,0,3,0
11141,2,3,38698,38699,38702,1,4,0
11142,5,2,38703,38703,38705,0,2,1
11143,1,2,38704,38705,38707,1,3,0
11144,3,3,38707,38707,38710,0,3,0
11145,4,3,38711,38711,38714,0,3,1
11146,1,2,38712,38714,38716,2,4,0
11147,2,1,38714,38716,38717,2,3,0
11148,6,1,38720,38720,38721,0,1,3
11149,3,3,38723,38723,38726,0,3,2
11150,2,1,38725,38726,38727,1,2,0
11151,3,3,38728,38728,38731,0,3,1
11152,2,1,38730,38731,38732,1,2,0
11153,1,1,38731,38732,38733,1,2,0
11154,2,1,38733,38733,38734,0,1,0
11155,1,1,38734,38734,38735,0,1,0
11156,5,2,38739,38739,38741,0,2,4
11157,1,1,38740,38741,38742,1,2,0
11158,3,3,38743,38743,38746,0,3,1
11159,6,1,38749,38749,38750,0,1,3
11160,4,1,38753,38753,38754,0,1,3
11161,5,1,38758,38758,38759,0,1,4
11162,4,2,38762,38762,38764,0,2,3
11163,4,1,38766,38766,38767,0,1,2
11164,2,1,38768,38768,38769,0,1,1
11165,6,3,38774,38774,38777,0,3,5
11166,1,2,38775,38777,38779,2,4,0
11167,6,2,38781,38781,38783,0,2,2
11168,6,2,38787,38787,38789,0,2,4
11169,4,3,38791,38791,38794,0,3,2
11170,6,3,38797,38797,38800,0,3,3
11171,2,2,38799,38800,38802,1,3,0
11172,6,2,38805,38805,38807,0,2,3
11173,1,3,38806,38807,38810,1,4,0
11174,6,1,38812,38812,38813,0,1,2
11175,4,1,38816,38816,38817,0,1,3
11176,4,1,38820,38820,38821,0,1,3
11177,1,1,38821,38821,38822,0,1,0
11178,4,2,38825,38825,38827,0,2,3
11179,5,3,38830,38830,38833,0,3,3
11180,5,1,38835,38835,38836,0,1,2
11181,6,2,38841,38841,38843,0,2,5
11182,4,3,38845,38845,38848,0,3,2
11183,2,2,38847,38848,38850,1,3,0
11184,4,1,38851,38851,38852,0,1,1
11185,6,3,38857,38857,38860,0,3,5
11186,1,1,38858,38860,38861,2,3,0
11187,4,2,38862,38862,38864,0,2,1
11188,4,2,38866,38866,38868,0,2,2
11189,6,1,38872,38872,38873,0,1,4
11190,1,3,38873,38873,38876,0,3,0
11191,4,1,38877,38877,38878,0,1,1
11192,4,2,38881,38881,38883,0,2,3
11193,3,3,38884,38884,38887,0,3,1
11194,6,2,38890,38890,38892,0,2,3
11195,6,3,38896,38896,38899,0,3,4
11196,3,2,38899,38899,38901,0,2,0
11197,6,3,38905,38905,38908,0,3,4
11198,6,3,38911,38911,38914,0,3,3
11199,6,1,38917,38917,38918,0,1,3
11200,5,3,38922,38922,38925,0,3,4
11201,4,1,38926,38926,38927,0,1,1
11202,1,1,38927,38927,38928,0,1,0
11203,6,3,38933,38933,38936,0,3,5
11204,4,1,38937,38937,38938,0,1,1
11205,3,3,38940,38940,38943,0,3,2
11206,4,1,38944,38944,38945,0,1,1
11207,3,3,38947,38947,38950,0,3,2
11208,5,2,38952,38952,38954,0,2,2
11209,3,2,38955,38955,38957,0,2,1
11210,1,2,38956,38957,38959,1,3,0
11211,2,2,38958,38959,38961,1,3,0
11212,4,2,38962,38962,38964,0,2,1
11213,4,3,38966,38966,38969,0,3,2
11214,4,3,38970,38970,38973,0,3,1
11215,1,1,38971,38973,38974,2,3,0
11216,6,2,38977,38977,38979,0,2,3
11217,4,3,38981,38981,38984,0,3,2
11218,3,2,38984,38984,38986,0,2,0
11219,2,3,38986,38986,38989,0,3,0
11220,3,1,38989,38989,38990,0,1,0
11221,1,2,38990,38990,38992,0,2,0
11222,6,2,38996,38996,38998,0,2,4
11223,6,1,39002,39002,39003,0,1,4
11224,3,2,39005,39005,39007,0,2,2
11225,4,2,39009,39009,39011,0,2,2
11226,3,1,39012,39012,39013,0,1,1
11227,4,3,39016,39016,39019,0,3,3
11228,2,3,39018,39019,39022,1,4,0
11229,1,2,39019,39022,39024,3,5,0
11230,3,3,39022,39024,39027,2,5,0
11231,4,2,39026,39027,39029,1,3,0
11232,3,3,39029,39029,39032,0,3,0
11233,3,2,39032,39032,39034,0,2,0
11234,2,2,39034,39034,39036,0,2,0
11235,2,1,39036,39036,39037,0,1,0
11236,4,1,39040,39040,39041,0,1,3
11237,5,1,39045,39045,39046,0,1,4
11238,4,2,39049,39049,39051,0,2,3
11239,2,1,39051,39051,39052,0,1,0
11240,3,1,39054,39054,39055,0,1,2
11241,2,3,39056,39056,39059,0,3,1
11242,1,2,39057,39059,39061,2,4,0
11243,5,1,39062,39062,39063,0,1,1
11244,3,2,39065,39065,39067,0,2,2
11245,5,2,39070,39070,39072,0,2,3
11246,3,3,39073,39073,39076,0,3,1
11247,4,1,39077,39077,39078,0,1,1
11248,6,2,39083,39083,39085,0,2,5
11249,1,2,39084,39085,39087,1,3,0
11250,2,3,39086,39087,39090,1,4,0
11251,4,2,39090,39090,39092,0,2,0
11252,6,3,39096,39096,39099,0,3,4
11253,1,2,39097,39099,39101,2,4,0
11254,4,1,39101,39101,39102,0,1,0
11255,4,2,39105,39105,39107,0,2,3
11256,2,1,39107,39107,39108,0,1,0
11257,5,1,39112,39112,39113,0,1,4
11258,6,2,39118,39118,39120,0,2,5
11259,3,2,39121,39121,39123,0,2,1
11260,3,1,39124,39124,39125,0,1,1
11261,5,2,39129,39129,39131,0,2,4
11262,3,1,39132,39132,39133,0,1,1
11263,4,1,39136,39136,39137,0,1,3
11264,6,3,39142,39142,39145,0,3,5
11265,5,2,39147,39147,39149,0,2,2
11266,1,2,39148,39149,39151,1,3,0
11267,1,2,39149,39151,39153,2,4,0
11268,4,3,39153,39153,39156,0,3,0
11269,5,1,39158,39158,39159,0,1,2
11270,1,3,39159,39159,39162,0,3,0
11271,1,1,39160,39162,39163,2,3,0
11272,3,1,39163,39163,39164,0,1,0
11273,4,2,39167,39167,39169,0,2,3
11274,4,2,39171,39171,39173,0,2,2
11275,2,2,39173,39173,39175,0,2,0
11276,4,1,39177,39177,39178,0,1,2
11277,5,1,39182,39182,39183,0,1,4
11278,5,1,39187,39187,39188,0,1,4
11279,5,2,39192,39192,39194,0,2,4
11280,1,1,39193,39194,39195,1,2,0
11281,4,2,39197,39197,39199,0,2,2
11282,5,2,39202,39202,39204,0,2,3
11283,6,2,39208,39208,39210,0,2,4
11284,5,3,39213,39213,39216,0,3,3
11285,6,1,39219,39219,39220,0,1,3
11286,6,2,39225,39225,39227,0,2,5
11287,3,2,39228,39228,39230,0,2,1
11288,3,1,39231,39231,39232,0,1,1
11289,3,1,39234,39234,39235,0,1,2
11290,3,2,39237,39237,39239,0,2,2
11291,6,1,39243,39243,39244,0,1,4
11292,3,3,39246,39246,39249,0,3,2
11293,3,1,39249,39249,39250,0,1,0
11294,6,1,39255,39255,39256,0,1,5
11295,2,2,39257,39257,39259,0,2,1
11296,5,1,39262,39262,39263,0,1,3
11297,2,2,39264,39264,39266,0,2,1
11298,1,1,39265,39266,39267,1,2,0
11299,4,2,39269,39269,39271,0,2,2
11300,1,2,39270,39271,39273,1,3,0
11301,3,3,39273,39273,39276,0,3,0
11302,5,2,39278,39278,39280,0,2,2
11303,4,1,39282,39282,39283,0,1,2
11304,1,1,39283,39283,39284,0,1,0
11305,3,1,39286,39286,39287,0,1,2
11306,6,1,39292,39292,39293,0,1,5
11307,2,2,39294,39294,39296,0,2,1
11308,6,3,39300,39300,39303,0,3,4
11309,3,2,39303,39303,39305,0,2,0
11310,6,2,39309,39309,39311,0,2,4
11311,2,1,39311,39311,39312,0,1,0
11312,6,3,39317,39317,39320,0,3,5
11313,3,1,39320,39320,39321,0,1,0
11314,2,2,39322,39322,39324,0,2,1
11315,2,2,39324,39324,39326,0,2,0
11316,6,3,39330,39330,39333,0,3,4
11317,2,1,39332,39333,39334,1,2,0
11318,5,2,39337,39337,39339,0,2,3
11319,2,1,39339,39339,39340,0,1,0
11320,5,2,39344,39344,39346,0,2,4
11321,4,3,39348,39348,39351,0,3,2
11322,5,3,39353,39353,39356,0,3,2
11323,4,3,39357,39357,39360,0,3,1
11324,4,1,39361,39361,39362,0,1,1
11325,6,1,39367,39367,39368,0,1,5
11326,6,2,39373,39373,39375,0,2,5
11327,4,3,39377,39377,39380,0,3,2
11328,5,3,39382,39382,39385,0,3,2
11329,4,1,39386,39386,39387,0,1,1
11330,5,3,39391,39391,39394,0,3,4
11331,4,1,39395,39395,39396,0,1,1
11332,2,1,39397,39397,39398,0,1,1
11333,2,3,39399,39399,39402,0,3,1
11334,5,3,39404,39404,39407,0,3,2
11335,6,1,39410,39410,39411,0,1,3
11336,5,3,39415,39415,39418,0,3,4
11337,1,2,39416,39418,39420,2,4,0
11338,4,2,39420,39420,39422,0,2,0
11339,5,1,39425,39425,39426,0,1,3
11340,6,3,39431,39431,39434,0,3,5
11341,5,1,39436,39436,39437,0,1,2
11342,1,1,39437,39437,39438,0,1,0
11343,2,1,39439,39439,39440,0,1,1
11344,4,2,39443,39443,39445,0,2,3
11345,6,1,39449,39449,39450,0,1,4
11346,3,1,39452,39452,39453,0,1,2
11347,2,1,39454,39454,39455,0,1,1
11348,3,2,39457,39457,39459,0,2,2
11349,2,2,39459,39459,39461,0,2,0
11350,3,1,39462,39462,39463,0,1,1
11351,6,2,39468,39468,39470,0,2,5
11352,4,1,39472,39472,39473,0,1,2
11353,3,1,39475,39475,39476,0,1,2
11354,1,1,39476,39476,39477,0,1,0
11355,5,1,39481,39481,39482,0,1,4
11356,4,3,39485,39485,39488,0,3,3
11357,5,1,39490,39490,39491,0,1,2
11358,6,2,39496,39496,39498,0,2,5
11359,5,1,39501,39501,39502,0,1,3
11360,3,2,39504,39504,39506,0,2,2
11361,5,3,39509,39509,39512,0,3,3
11362,6,1,39515,39515,39516,0,1,3
11363,2,1,39517,39517,39518,0,1,1
11364,1,2,39518,39518,39520,0,2,0
11365,1,3,39519,39520,39523,1,4,0
11366,6,3,39525,39525,39528,0,3,2
11367,4,1,39529,39529,39530,0,1,1
11368,3,2,39532,39532,39534,0,2,2
11369,2,1,39534,39534,39535,0,1,0
11370,2,1,39536,39536,39537,0,1,1
11371,1,2,39537,39537,39539,0,2,0
11372,5,2,39542,39542,39544,0,2,3
11373,6,2,39548,39548,39550,0,2,4
11374,5,1,39553,39553,39554,0,1,3
11375,3,2,39556,39556,39558,0,2,2
11376,4,1,39560,39560,39561,0,1,2
11377,1,1,39561,39561,39562,0,1,0
11378,4,1,39565,39565,39566,0,1,3
11379,4,3,39569,39569,39572,0,3,3
11380,6,2,39575,39575,39577,0,2,3
11381,3,1,39578,39578,39579,0,1,1
11382,5,3,39583,39583,39586,0,3,4
11383,5,2,39588,39588,39590,0,2,2
11384,5,2,39593,39593,39595,0,2,3
11385,3,1,39596,39596,39597,0,1,1
11386,3,2,39599,39599,39601,0,2,2
11387,2,1,39601,39601,39602,0,1,0
11388,5,2,39606,39606,39608,0,2,4
11389,2,3,39608,39608,39611,0,3,0
11390,2,2,39610,39611,39613,1,3,0
11391,4,1,39614,39614,39615,0,1,1
11392,6,2,39620,39620,39622,0,2,5
11393,3,2,39623,39623,39625,0,2,1
11394,6,2,39629,39629,39631,0,2,4
11395,1,1,39630,39631,39632,1,2,0
11396,4,2,39634,39634,39636,0,2,2
11397,5,2,39639,39639,39641,0,2,3
11398,3,1,39642,39642,39643,0,1,1
11399,5,2,39647,39647,39649,0,2,4
11400,2,2,39649,39649,39651,0,2,0
11401,4,2,39653,39653,39655,0,2,2
11402,5,3,39658,39658,39661,0,3,3
11403,5,2,39663,39663,39665,0,2,2
11404,2,3,39665,39665,39668,0,3,0
11405,4,3,39669,39669,39672,0,3,1
11406,2,1,39671,39672,39673,1,2,0
11407,4,2,39675,39675,39677,0,2,2
11408,3,2,39678,39678,39680,0,2,1
11409,3,3,39681,39681,39684,0,3,1
11410,5,1,39686,39686,39687,0,1,2
11411,2,3,39688,39688,39691,0,3,1
11412,4,2,39692,39692,39694,0,2,1
11413,4,1,39696,39696,39697,0,1,2
11414,4,3,39700,39700,39703,0,3,3
11415,2,2,39702,39703,39705,1,3,0
11416,5,2,39707,39707,39709,0,2,2
11417,2,3,39709,39709,39712,0,3,0
11418,2,3,39711,39712,39715,1,4,0
11419,5,2,39716,39716,39718,0,2,1
11420,1,2,39717,39718,39720,1,3,0
11421,3,1,39720,39720,39721,0,1,0
11422,2,3,39722,39722,39725,0,3,1
11423,1,3,39723,39725,39728,2,5,0
11424,2,2,39725,39728,39730,3,5,0
11425,5,3,39730,39730,39733,0,3,0
11426,3,3,39733,39733,39736,0,3,0
11427,6,2,39739,39739,39741,0,2,3
11428,4,1,39743,39743,39744,0,1,2
11429,4,3,39747,39747,39750,0,3,3
11430,3,1,39750,39750,39751,0,1,0
11431,4,3,39754,39754,39757,0,3,3
11432,1,1,39755,39757,39758,2,3,0
11433,2,1,39757,39758,39759,1,2,0
11434,4,1,39761,39761,39762,0,1,2
11435,5,2,39766,39766,39768,0,2,4
11436,3,3,39769,39769,39772,0,3,1
11437,3,1,39772,39772,39773,0,1,0
11438,2,1,39774,39774,39775,0,1,1
11439,5,3,39779,39779,39782,0,3,4
11440,1,2,39780,39782,39784,2,4,0
11441,1,1,39781,39784,39785,3,4,0
11442,5,2,39786,39786,39788,0,2,1
11443,2,3,39788,39788,39791,0,3,0
11444,1,3,39789,39791,39794,2,5,0
11445,1,3,39790,39794,39797,4,7,0
11446,3,1,39793,39797,39798,4,5,0
11447,1,3,39794,39798,39801,4,7,0
11448,2,3,39796,39801,39804,5,8,0
11449,5,1,39801,39804,39805,3,4,0
11450,1,3,39802,39805,39808,3,6,0
11451,5,2,39807,39808,39810,1,3,0
11452,2,2,39809,39810,39812,1,3,0
11453,5,2,39814,39814,39816,0,2,2
11454,1,3,39815,39816,39819,1,4,0
11455,6,1,39821,39821,39822,0,1,2
11456,5,2,39826,39826,39828,0,2,4
11457,6,1,39832,39832,39833,0,1,4
11458,2,1,39834,39834,39835,0,1,1
11459,3,3,39837,39837,39840,0,3,2
11460,2,2,39839,39840,39842,1,3,0
11461,4,1,39843,39843,39844,0,1,1
11462,1,3,39844,39844,39847,0,3,0
11463,3,2,39847,39847,39849,0,2,0
11464,6,2,39853,39853,39855,0,2,4
11465,1,1,39854,39855,39856,1,2,0
11466,4,3,39858,39858,39861,0,3,2
11467,6,1,39864,39864,39865,0,1,3
11468,2,1,39866,39866,39867,0,1,1
11469,3,1,39869,39869,39870,0,1,2
11470,2,1,39871,39871,39872,0,1,1
11471,6,1,39877,39877,39878,0,1,5
11472,6,1,39883,39883,39884,0,1,5
11473,5,3,39888,39888,39891,0,3,4
11474,3,1,39891,39891,39892,0,1,0
11475,4,2,39895,39895,39897,0,2,3
11476,1,3,39896,39897,39900,1,4,0
11477,2,3,39898,39900,39903,2,5,0
11478,4,2,39902,39903,39905,1,3,0
11479,2,1,39904,39905,39906,1,2,0
11480,6,1,39910,39910,39911,0,1,4
11481,2,2,39912,39912,39914,0,2,1
11482,1,2,39913,39914,39916,1,3,0
11483,4,3,39917,39917,39920,0,3,1
11484,6,2,39923,39923,39925,0,2,3
11485,4,1,39927,39927,39928,0,1,2
11486,3,1,39930,39930,39931,0,1,2
11487,6,3,39936,39936,39939,0,3,5
11488,2,1,39938,39939,39940,1,2,0
11489,4,3,39942,39942,39945,0,3,2
11490,1,1,39943,39945,39946,2,3,0
11491,2,2,39945,39946,39948,1,3,0
11492,5,2,39950,39950,39952,0,2,2
11493,6,1,39956,39956,39957,0,1,4
11494,3,3,39959,39959,39962,0,3,2
11495,3,2,39962,39962,39964,0,2,0
11496,4,3,39966,39966,39969,0,3,2
11497,6,3,39972,39972,39975,0,3,3
11498,3,1,39975,39975,39976,0,1,0
11499,3,2,39978,39978,39980,0,2,2
11500,3,2,39981,39981,39983,0,2,1
11501,4,2,39985,39985,39987,0,2,2
11502,2,1,39987,39987,39988,0,1,0
11503,4,3,39991,39991,39994,0,3,3
11504,3,1,39994,39994,39995,0,1,0
11505,4,1,39998,39998,39999,0,1,3
11506,2,1,40000,40000,40001,0,1,1
11507,2,3,40002,40002,40005,0,3,1
11508,5,1,40007,40007,40008,0,1,2
11509,6,2,40013,40013,40015,0,2,5
11510,2,3,40015,40015,40018,0,3,0
11511,2,3,40017,40018,40021,1,4,0
11512,4,2,40021,40021,40023,0,2,0
11513,3,2,40024,40024,40026,0,2,1
11514,3,1,40027,40027,40028,0,1,1
11515,4,3,40031,40031,40034,0,3,3
11516,3,1,40034,40034,40035,0,1,0
11517,6,1,40040,40040,40041,0,1,5
11518,1,3,40041,40041,40044,0,3,0
11519,2,2,40043,40044,40046,1,3,0
11520,1,3,40044,40046,40049,2,5,0
11521,6,3,40050,40050,40053,0,3,1
11522,3,3,40053,40053,40056,0,3,0
11523,4,3,40057,40057,40060,0,3,1
11524,2,1,40059,40060,40061,1,2,0
11525,4,3,40063,40063,40066,0,3,2
11526,2,3,40065,40066,40069,1,4,0
11527,3,1,40068,40069,40070,1,2,0
11528,5,1,40073,40073,40074,0,1,3
11529,2,2,40075,40075,40077,0,2,1
11530,6,1,40081,40081,40082,0,1,4
11531,6,1,40087,40087,40088,0,1,5
11532,3,1,40090,40090,40091,0,1,2
11533,4,2,40094,40094,40096,0,2,3
11534,2,3,40096,40096,40099,0,3,0
11535,6,2,40102,40102,40104,0,2,3
11536,4,1,40106,40106,40107,0,1,2
11537,2,3,40108,40108,40111,0,3,1
11538,4,3,40112,40112,40115,0,3,1
11539,3,2,40115,40115,40117,0,2,0
11540,4,3,40119,40119,40122,0,3,2
11541,2,3,40121,40122,40125,1,4,0
11542,2,2,40123,40125,40127,2,4,0
11543,6,1,40129,40129,40130,0,1,2
11544,4,1,40133,40133,40134,0,1,3
11545,1,1,40134,40134,40135,0,1,0
11546,2,2,40136,40136,40138,0,2,1
11547,5,3,40141,40141,40144,0,3,3
11548,1,1,40142,40144,40145,2,3,0
11549,5,3,40147,40147,40150,0,3,2
11550,2,1,40149,40150,40151,1,2,0
11551,4,3,40153,40153,40156,0,3,2
11552,4,1,40157,40157,40158,0,1,1
11553,5,2,40162,40162,40164,0,2,4
11554,5,3,40167,40167,40170,0,3,3
11555,1,1,40168,40170,40171,2,3,0
11556,4,1,40172,40172,40173,0,1,1
11557,1,2,40173,40173,40175,0,2,0
11558,5,2,40178,40178,40180,0,2,3
11559,1,2,40179,40180,40182,1,3,0
11560,5,3,40184,40184,40187,0,3,2
11561,4,1,40188,40188,40189,0,1,1
11562,4,2,40192,40192,40194,0,2,3
11563,4,1,40196,40196,40197,0,1,2
11564,4,1,40200,40200,40201,0,1,3
11565,4,2,40204,40204,40206,0,2,3
11566,1,2,40205,40206,40208,1,3,0
11567,2,3,40207,40208,40211,1,4,0
11568,2,1,40209,40211,40212,2,3,0
11569,1,2,40210,40212,40214,2,4,0
11570,6,2,40216,40216,40218,0,2,2
11571,1,1,40217,40218,40219,1,2,0
11572,2,3,40219,40219,40222,0,3,0
11573,2,2,40221,40222,40224,1,3,0
11574,4,3,40225,40225,40228,0,3,1
11575,6,2,40231,40231,40233,0,2,3
11576,1,2,40232,40233,40235,1,3,0
11577,2,2,40234,40235,40237,1,3,0
11578,2,1,40236,40237,40238,1,2,0
11579,1,2,40237,40238,40240,1,3,0
11580,3,1,40240,40240,40241,0,1,0
11581,2,2,40242,40242,40244,0,2,1
11582,1,3,40243,40244,40247,1,4,0
11583,5,3,40248,40248,40251,0,3,1
11584,2,3,40250,40251,40254,1,4,0
11585,2,3,40252,40254,40257,2,5,0
11586,3,2,40255,40257,40259,2,4,0
11587,1,2,40256,40259,40261,3,5,0
11588,3,3,40259,40261,40264,2,5,0
11589,5,1,40264,40264,40265,0,1,0
11590,5,1,40269,40269,40270,0,1,4
11591,5,3,40274,40274,40277,0,3,4
11592,6,3,40280,40280,40283,0,3,3
11593,3,3,40283,40283,40286,0,3,0
11594,1,2,40284,40286,40288,2,4,0
11595,5,3,40289,40289,40292,0,3,1
11596,4,2,40293,40293,40295,0,2,1
11597,2,1,40295,40295,40296,0,1,0
11598,6,3,40301,40301,40304,0,3,5
11599,5,3,40306,40306,40309,0,3,2
11600,5,2,40311,40311,40313,0,2,2
11601,5,3,40316,40316,40319,0,3,3
11602,5,1,40321,40321,40322,0,1,2
11603,3,3,40324,40324,40327,0,3,2
11604,6,2,40330,40330,40332,0,2,3
11605,4,2,40334,40334,40336,0,2,2
11606,2,3,40336,40336,40339,0,3,0
11607,4,3,40340,40340,40343,0,3,1
11608,2,1,40342,40343,40344,1,2,0
11609,2,3,40344,40344,40347,0,3,0
11610,1,2,40345,40347,40349,2,4,0
11611,3,3,40348,40349,40352,1,4,0
11612,3,1,40351,40352,40353,1,2,0
11613,4,3,40355,40355,40358,0,3,2
11614,2,1,40357,40358,40359,1,2,0
11615,5,2,40362,40362,40364,0,2,3
11616,3,3,40365,40365,40368,0,3,1
11617,3,2,40368,40368,40370,0,2,0
11618,6,3,40374,40374,40377,0,3,4
11619,5,1,40379,40379,40380,0,1,2
11620,5,3,40384,40384,40387,0,3,4
11621,5,3,40389,40389,40392,0,3,2
11622,2,2,40391,40392,40394,1,3,0
11623,6,2,40397,40397,40399,0,2,3
11624,1,2,40398,40399,40401,1,3,0
11625,6,3,40404,40404,40407,0,3,3
11626,4,1,40408,40408,40409,0,1,1
11627,3,2,40411,40411,40413,0,2,2
11628,5,1,40416,40416,40417,0,1,3
11629,3,2,40419,40419,40421,0,2,2
11630,5,1,40424,40424,40425,0,1,3
11631,5,1,40429,40429,40430,0,1,4
11632,3,3,40432,40432,40435,0,3,2
11633,2,3,40434,40435,40438,1,4,0
11634,4,3,40438,40438,40441,0,3,0
11635,2,1,40440,40441,40442,1,2,0
11636,6,2,40446,40446,40448,0,2,4
11637,2,2,40448,40448,40450,0,2,0
11638,4,1,40452,40452,40453,0,1,2
11639,2,2,40454,40454,40456,0,2,1
11640,2,1,40456,40456,40457,0,1,0
11641,4,2,40460,40460,40462,0,2,3
11642,4,1,40464,40464,40465,0,1,2
11643,5,2,40469,40469,40471,0,2,4
11644,4,2,40473,40473,40475,0,2,2
11645,6,1,40479,40479,40480,0,1,4
11646,6,3,40485,40485,40488,0,3,5
11647,3,1,40488,40488,40489,0,1,0
11648,6,1,40494,40494,40495,0,1,5
11649,4,3,40498,40498,40501,0,3,3
11650,3,3,40501,40501,40504,0,3,0
11651,4,2,40505,40505,40507,0,2,1
11652,4,3,40509,40509,40512,0,3,2
11653,4,3,40513,40513,40516,0,3,1
11654,1,1,40514,40516,40517,2,3,0
11655,2,3,40516,40517,40520,1,4,0
11656,2,3,40518,40520,40523,2,5,0
11657,5,3,40523,40523,40526,0,3,0
11658,1,3,40524,40526,40529,2,5,0
11659,4,3,40528,40529,40532,1,4,0
11660,4,1,40532,40532,40533,0,1,0
11661,2,3,40534,40534,40537,0,3,1
11662,3,3,40537,40537,40540,0,3,0
11663,6,3,40543,40543,40546,0,3,3
11664,4,1,40547,40547,40548,0,1,1
11665,2,1,40549,40549,40550,0,1,1
11666,4,2,40553,40553,40555,0,2,3
11667,5,3,40558,40558,40561,0,3,3
11668,4,3,40562,40562,40565,0,3,1
11669,1,1,40563,40565,40566,2,3,0
11670,1,1,40564,40566,40567,2,3,0
11671,4,1,40568,40568,40569,0,1,1
11672,2,2,40570,40570,40572,0,2,1
11673,3,2,40573,40573,40575,0,2,1
11674,1,1,40574,40575,40576,1,2,0
11675,2,1,40576,40576,40577,0,1,0
11676,5,1,40581,40581,40582,0,1,4
11677,3,1,40584,40584,40585,0,1,2
11678,5,3,40589,40589,40592,0,3,4
11679,5,2,40594,40594,40596,0,2,2
11680,3,1,40597,40597,40598,0,1,1
11681,6,3,40603,40603,40606,0,3,5
11682,1,2,40604,40606,40608,2,4,0
11683,6,3,40610,40610,40613,0,3,2
11684,2,2,40612,40613,40615,1,3,0
11685,1,1,40613,40615,40616,2,3,0
11686,2,2,40615,40616,40618,1,3,0
11687,3,2,40618,40618,40620,0,2,0
11688,6,3,40624,40624,40627,0,3,4
11689,2,2,40626,40627,40629,1,3,0
11690,6,1,40632,40632,40633,0,1,3
11691,1,1,40633,40633,40634,0,1,0
11692,3,2,40636,40636,40638,0,2,2
11693,5,1,40641,40641,40642,0,1,3
11694,2,2,40643,40643,40645,0,2,1
11695,5,1,40648,40648,40649,0,1,3
11696,1,1,40649,40649,40650,0,1,0
11697,6,2,40655,40655,40657,0,2,5
11698,3,1,40658,40658,40659,0,1,1
11699,1,3,40659,40659,40662,0,3,0
11700,3,1,40662,40662,40663,0,1,0
11701,6,2,40668,40668,40670,0,2,5
11702,1,3,40669,40670,40673,1,4,0
11703,1,3,40670,40673,40676,3,6,0
11704,4,1,40674,40676,40677,2,3,0
11705,2,2,40676,40677,40679,1,3,0
11706,1,2,40677,40679,40681,2,4,0
11707,1,3,40678,40681,40684,3,6,0
11708,6,1,40684,40684,40685,0,1,0
11709,3,1,40687,40687,40688,0,1,2
11710,3,3,40690,40690,40693,0,3,2
11711,4,1,40694,40694,40695,0,1,1
11712,5,2,40699,40699,40701,0,2,4
11713,5,3,40704,40704,40707,0,3,3
11714,1,2,40705,40707,40709,2,4,0
11715,2,3,40707,40709,40712,2,5,0
11716,5,2,40712,40712,40714,0,2,0
11717,5,2,40717,40717,40719,0,2,3
11718,1,2,40718,40719,40721,1,3,0
11719,6,2,40724,40724,40726,0,2,3
11720,1,3,40725,40726,40729,1,4,0
11721,4,1,40729,40729,40730,0,1,0
11722,2,3,40731,40731,40734,0,3,1
11723,6,2,40737,40737,40739,0,2,3
11724,6,2,40743,40743,40745,0,2,4
11725,3,3,40746,40746,40749,0,3,1
11726,3,1,40749,40749,40750,0,1,0
11727,6,1,40755,40755,40756,0,1,5
11728,2,1,40757,40757,40758,0,1,1
11729,5,2,40762,40762,40764,0,2,4
11730,5,3,40767,40767,40770,0,3,3
11731,4,2,40771,40771,40773,0,2,1
11732,6,2,40777,40777,40779,0,2,4
11733,1,1,40778,40779,40780,1,2,0
11734,2,2,40780,40780,40782,0,2,0
11735,3,2,40783,40783,40785,0,2,1
11736,3,3,40786,40786,40789,0,3,1
11737,2,2,40788,40789,40791,1,3,0
11738,4,1,40792,40792,40793,0,1,1
11739,6,3,40798,40798,40801,0,3,5
11740,4,2,40802,40802,40804,0,2,1
11741,2,3,40804,40804,40807,0,3,0
11742,3,2,40807,40807,40809,0,2,0
11743,1,1,40808,40809,40810,1,2,0
11744,5,1,40813,40813,40814,0,1,3
11745,4,3,40817,40817,40820,0,3,3
11746,5,2,40822,40822,40824,0,2,2
11747,6,1,40828,40828,40829,0,1,4
11748,2,1,40830,40830,40831,0,1,1
11749,6,2,40836,40836,40838,0,2,5
11750,4,2,40840,40840,40842,0,2,2
11751,6,1,40846,40846,40847,0,1,4
11752,4,2,40850,40850,40852,0,2,3
11753,3,1,40853,40853,40854,0,1,1
11754,2,1,40855,40855,40856,0,1,1
11755,4,3,40859,40859,40862,0,3,3
11756,2,2,40861,40862,40864,1,3,0
11757,2,2,40863,40864,40866,1,3,0
11758,3,2,40866,40866,40868,0,2,0
11759,3,1,40869,40869,40870,0,1,1
11760,5,2,40874,40874,40876,0,2,4
11761,5,1,40879,40879,40880,0,1,3
11762,5,1,40884,40884,40885,0,1,4
11763,3,1,40887,40887,40888,0,1,2
11764,4,2,40891,40891,40893,0,2,3
11765,1,2,40892,40893,40895,1,3,0
11766,4,3,40896,40896,40899,0,3,1
11767,6,3,40902,40902,40905,0,3,3
11768,5,1,40907,40907,40908,0,1,2
11769,1,3,40908,40908,40911,0,3,0
11770,1,3,40909,40911,40914,2,5,0
11771,1,1,40910,40914,40915,4,5,0
11772,4,1,40914,40915,40916,1,2,0
11773,5,2,40919,40919,40921,0,2,3
11774,6,1,40925,40925,40926,0,1,4
11775,2,1,40927,40927,40928,0,1,1
11776,3,2,40930,40930,40932,0,2,2
11777,1,3,40931,40932,40935,1,4,0
11778,5,3,40936,40936,40939,0,3,1
11779,5,3,40941,40941,40944,0,3,2
11780,1,1,40942,40944,40945,2,3,0
11781,4,3,40946,40946,40949,0,3,1
11782,5,3,40951,40951,40954,0,3,2
11783,2,1,40953,40954,40955,1,2,0
11784,5,3,40958,40958,40961,0,3,3
11785,5,1,40963,40963,40964,0,1,2
11786,2,3,40965,40965,40968,0,3,1
11787,3,3,40968,40968,40971,0,3,0
11788,3,2,40971,40971,40973,0,2,0
11789,6,3,40977,40977,40980,0,3,4
11790,6,3,40983,40983,40986,0,3,3
11791,3,1,40986,40986,40987,0,1,0
11792,3,3,40989,40989,40992,0,3,2
11793,5,1,40994,40994,40995,0,1,2
11794,4,3,40998,40998,41001,0,3,3
11795,4,3,41002,41002,41005,0,3,1
11796,5,1,41007,41007,41008,0,1,2
11797,2,3,41009,41009,41012,0,3,1
11798,2,1,41011,41012,41013,1,2,0
11799,1,1,41012,41013,41014,1,2,0
11800,1,3,41013,41014,41017,1,4,0
11801,1,1,41014,41017,41018,3,4,0
11802,6,3,41020,41020,41023,0,3,2
11803,3,3,41023,41023,41026,0,3,0
11804,2,1,41025,41026,41027,1,2,0
11805,6,1,41031,41031,41032,0,1,4
11806,5,2,41036,41036,41038,0,2,4
11807,6,1,41042,41042,41043,0,1,4
11808,2,1,41044,41044,41045,0,1,1
11809,6,2,41050,41050,41052,0,2,5
11810,2,3,41052,41052,41055,0,3,0
11811,5,1,41057,41057,41058,0,1,2
11812,4,3,41061,41061,41064,0,3,3
11813,4,2,41065,41065,41067,0,2,1
11814,6,3,41071,41071,41074,0,3,4
11815,6,2,41077,41077,41079,0,2,3
11816,2,1,41079,41079,41080,0,1,0
11817,1,3,41080,41080,41083,0,3,0
11818,5,3,41085,41085,41088,0,3,2
11819,1,1,41086,41088,41089,2,3,0
11820,3,3,41089,41089,41092,0,3,0
11821,6,1,41095,41095,41096,0,1,3
11822,5,2,41100,41100,41102,0,2,4
11823,5,2,41105,41105,41107,0,2,3
11824,1,3,41106,41107,41110,1,4,0
11825,3,3,41109,41110,41113,1,4,0
11826,1,2,41110,41113,41115,3,5,0
11827,1,2,41111,41115,41117,4,6,0
11828,3,1,41114,41117,41118,3,4,0
11829,2,1,41116,41118,41119,2,3,0
11830,4,1,41120,41120,41121,0,1,1
11831,1,2,41121,41121,41123,0,2,0
11832,1,2,41122,41123,41125,1,3,0
11833,3,2,41125,41125,41127,0,2,0
11834,3,1,41128,41128,41129,0,1,1
11835,1,2,41129,41129,41131,0,2,0
11836,2,3,41131,41131,41134,0,3,0
11837,4,2,41135,41135,41137,0,2,1
11838,3,3,41138,41138,41141,0,3,1
11839,1,3,41139,41141,41144,2,5,0
11840,3,3,41142,41144,41147,2,5,0
11841,3,1,41145,41147,41148,2,3,0
11842,4,2,41149,41149,41151,0,2,1
11843,5,1,41154,41154,41155,0,1,3
11844,2,2,41156,41156,41158,0,2,1
11845,6,1,41162,41162,41163,0,1,4
11846,1,3,41163,41163,41166,0,3,0
11847,6,3,41169,41169,41172,0,3,3
11848,2,2,41171,41172,41174,1,3,0
11849,3,1,41174,41174,41175,0,1,0
11850,1,1,41175,41175,41176,0,1,0
11851,1,1,41176,41176,41177,0,1,0
11852,1,1,41177,41177,41178,0,1,0
11853,6,3,41183,41183,41186,0,3,5
11854,2,2,41185,41186,41188,1,3,0
11855,1,1,41186,41188,41189,2,3,0
11856,6,3,41192,41192,41195,0,3,3
11857,6,3,41198,41198,41201,0,3,3
11858,2,2,41200,41201,41203,1,3,0
11859,1,2,41201,41203,41205,2,4,0
11860,4,3,41205,41205,41208,0,3,0
11861,1,1,41206,41208,41209,2,3,0
11862,2,2,41208,41209,41211,1,3,0
11863,1,1,41209,41211,41212,2,3,0
11864,3,3,41212,41212,41215,0,3,0
11865,5,1,41217,41217,41218,0,1,2
11866,5,1,41222,41222,41223,0,1,4
11867,6,3,41228,41228,41231,0,3,5
11868,1,3,41229,41231,41234,2,5,0
11869,3,2,41232,41234,41236,2,4,0
11870,2,2,41234,41236,41238,2,4,0
11871,6,1,41240,41240,41241,0,1,2
11872,1,1,41241,41241,41242,0,1,0
11873,4,2,41245,41245,41247,0,2,3
11874,2,1,41247,41247,41248,0,1,0
11875,3,1,41250,41250,41251,0,1,2
11876,6,1,41256,41256,41257,0,1,5
11877,1,3,41257,41257,41260,0,3,0
11878,2,3,41259,41260,41263,1,4,0
11879,6,1,41265,41265,41266,0,1,2
11880,3,2,41268,41268,41270,0,2,2
11881,4,2,41272,41272,41274,0,2,2
11882,6,3,41278,41278,41281,0,3,4
11883,5,1,41283,41283,41284,0,1,2
11884,3,3,41286,41286,41289,0,3,2
11885,4,3,41290,41290,41293,0,3,1
11886,1,2,41291,41293,41295,2,4,0
11887,4,1,41295,41295,41296,0,1,0
11888,1,2,41296,41296,41298,0,2,0
11889,3,3,41299,41299,41302,0,3,1
11890,4,2,41303,41303,41305,0,2,1
11891,5,3,41308,41308,41311,0,3,3
11892,1,3,41309,41311,41314,2,5,0
11893,1,3,41310,41314,41317,4,7,0
11894,3,3,41313,41317,41320,4,7,0
11895,1,2,41314,41320,41322,6,8,0
11896,1,2,41315,41322,41324,7,9,0
11897,1,3,41316,41324,41327,8,11,0
11898,2,3,41318,41327,41330,9,12,0
11899,4,1,41322,41330,41331,8,9,0
11900,6,1,41328,41331,41332,3,4,0
11901,1,2,41329,41332,41334,3,5,0
11902,1,1,41330,41334,41335,4,5,0
11903,5,1,41335,41335,41336,0,1,0
11904,2,3,41337,41337,41340,0,3,1
11905,5,3,41342,41342,41345,0,3,2
11906,1,1,41343,41345,41346,2,3,0
11907,2,1,41345,41346,41347,1,2,0
11908,1,3,41346,41347,41350,1,4,0
11909,5,2,41351,41351,41353,0,2,1
11910,5,1,41356,41356,41357,0,1,3
11911,2,3,41358,41358,41361,0,3,1
11912,5,3,41363,41363,41366,0,3,2
11913,2,1,41365,41366,41367,1,2,0
11914,4,3,41369,41369,41372,0,3,2
11915,1,2,41370,41372,41374,2,4,0
11916,5,3,41375,41375,41378,0,3,1
11917,1,2,41376,41378,41380,2,4,0
11918,2,1,41378,41380,41381,2,3,0
11919,4,2,41382,41382,41384,0,2,1
11920,5,1,41387,41387,41388,0,1,3
11921,5,1,41392,41392,41393,0,1,4
11922,1,2,41393,41393,41395,0,2,0
11923,4,1,41397,41397,41398,0,1,2
11924,6,1,41403,41403,41404,0,1,5
11925,3,3,41406,41406,41409,0,3,2
11926,4,3,41410,41410,41413,0,3,1
11927,6,1,41416,41416,41417,0,1,3
11928,5,1,41421,41421,41422,0,1,4
11929,2,3,41423,41423,41426,0,3,1
11930,3,3,41426,41426,41429,0,3,0
11931,5,2,41431,41431,41433,0,2,2
11932,5,2,41436,41436,41438,0,2,3
11933,1,3,41437,41438,41441,1,4,0
11934,5,1,41442,41442,41443,0,1,1
11935,5,3,41447,41447,41450,0,3,4
11936,3,2,41450,41450,41452,0,2,0
11937,2,2,41452,41452,41454,0,2,0
11938,3,1,41455,41455,41456,0,1,1
11939,3,2,41458,41458,41460,0,2,2
11940,1,2,41459,41460,41462,1,3,0
11941,2,3,41461,41462,41465,1,4,0
11942,1,3,41462,41465,41468,3,6,0
11943,5,1,41467,41468,41469,1,2,0
11944,4,1,41471,41471,41472,0,1,2
11945,3,3,41474,41474,41477,0,3,2
11946,5,3,41479,41479,41482,0,3,2
11947,5,1,41484,41484,41485,0,1,2
11948,4,1,41488,41488,41489,0,1,3
11949,1,2,41489,41489,41491,0,2,0
11950,1,2,41490,41491,41493,1,3,0
11951,5,1,41495,41495,41496,0,1,2
11952,3,2,41498,41498,41500,0,2,2
11953,1,1,41499,41500,41501,1,2,0
11954,5,3,41504,41504,41507,0,3,3
11955,3,3,41507,41507,41510,0,3,0
11956,5,2,41512,41512,41514,0,2,2
11957,4,2,41516,41516,41518,0,2,2
11958,3,2,41519,41519,41521,0,2,1
11959,1,1,41520,41521,41522,1,2,0
11960,1,1,41521,41522,41523,1,2,0
11961,1,3,41522,41523,41526,1,4,0
11962,2,1,41524,41526,41527,2,3,0
11963,3,2,41527,41527,41529,0,2,0
11964,1,3,41528,41529,41532,1,4,0
11965,5,3,41533,41533,41536,0,3,1
11966,5,2,41538,41538,41540,0,2,2
11967,6,2,41544,41544,41546,0,2,4
11968,5,1,41549,41549,41550,0,1,3
11969,6,1,41555,41555,41556,0,1,5
11970,5,2,41560,41560,41562,0,2,4
11971,3,2,41563,41563,41565,0,2,1
11972,5,2,41568,41568,41570,0,2,3
11973,3,1,41571,41571,41572,0,1,1
11974,2,2,41573,41573,41575,0,2,1
11975,6,3,41579,41579,41582,0,3,4
11976,4,1,41583,41583,41584,0,1,1
11977,1,2,41584,41584,41586,0,2,0
11978,6,2,41590,41590,41592,0,2,4
11979,2,3,41592,41592,41595,0,3,0
11980,2,3,41594,41595,41598,1,4,0
11981,2,1,41596,41598,41599,2,3,0
11982,4,1,41600,41600,41601,0,1,1
11983,5,3,41605,41605,41608,0,3,4
11984,6,2,41611,41611,41613,0,2,3
11985,1,1,41612,41613,41614,1,2,0
11986,5,3,41617,41617,41620,0,3,3
11987,1,3,41618,41620,41623,2,5,0
11988,2,2,41620,41623,41625,3,5,0
11989,5,3,41625,41625,41628,0,3,0
11990,4,2,41629,41629,41631,0,2,1
11991,1,3,41630,41631,41634,1,4,0
11992,4,3,41634,41634,41637,0,3,0
11993,4,3,41638,41638,41641,0,3,1
11994,2,2,41640,41641,41643,1,3,0
11995,4,1,41644,41644,41645,0,1,1
11996,5,2,41649,41649,41651,0,2,4
11997,1,3,41650,41651,41654,1,4,0
11998,2,2,41652,41654,41656,2,4,0
11999,5,2,41657,41657,41659,0,2,1
12000,2,3,41659,41659,41662,0,3,0
12001,1,1,41660,41662,41663,2,3,0
12002,1,2,41661,41663,41665,2,4,0
12003,5,3,41666,41666,41669,0,3,1
12004,2,1,41668,41669,41670,1,2,0
12005,4,2,41672,41672,41674,0,2,2
12006,1,3,41673,41674,41677,1,4,0
12007,3,2,41676,41677,41679,1,3,0
12008,2,2,41678,41679,41681,1,3,0
12009,6,1,41684,41684,41685,0,1,3
12010,2,3,41686,41686,41689,0,3,1
12011,5,2,41691,41691,41693,0,2,2
12012,3,3,41694,41694,41697,0,3,1
12013,6,3,41700,41700,41703,0,3,3
12014,6,2,41706,41706,41708,0,2,3
12015,2,1,41708,41708,41709,0,1,0
12016,4,1,41712,41712,41713,0,1,3
12017,6,3,41718,41718,41721,0,3,5
12018,1,1,41719,41721,41722,2,3,0
12019,5,2,41724,41724,41726,0,2,2
12020,6,3,41730,41730,41733,0,3,4
12021,5,1,41735,41735,41736,0,1,2
12022,2,1,41737,41737,41738,0,1,1
12023,5,3,41742,41742,41745,0,3,4
12024,4,2,41746,41746,41748,0,2,1
12025,1,3,41747,41748,41751,1,4,0
12026,4,1,41751,41751,41752,0,1,0
12027,3,2,41754,41754,41756,0,2,2
12028,2,1,41756,41756,41757,0,1,0
12029,4,2,41760,41760,41762,0,2,3
12030,4,2,41764,41764,41766,0,2,2
12031,5,2,41769,41769,41771,0,2,3
12032,5,1,41774,41774,41775,0,1,3
12033,3,3,41777,41777,41780,0,3,2
12034,1,2,41778,41780,41782,2,4,0
12035,5,1,41783,41783,41784,0,1,1
12036,2,2,41785,41785,41787,0,2,1
12037,2,3,41787,41787,41790,0,3,0
12038,2,1,41789,41790,41791,1,2,0
12039,4,3,41793,41793,41796,0,3,2
12040,6,3,41799,41799,41802,0,3,3
12041,2,1,41801,41802,41803,1,2,0
12042,4,3,41805,41805,41808,0,3,2
12043,6,2,41811,41811,41813,0,2,3
12044,4,2,41815,41815,41817,0,2,2
12045,4,1,41819,41819,41820,0,1,2
12046,5,3,41824,41824,41827,0,3,4
12047,5,2,41829,41829,41831,0,2,2
12048,6,3,41835,41835,41838,0,3,4
12049,4,3,41839,41839,41842,0,3,1
12050,1,3,41840,41842,41845,2,5,0
12051,2,2,41842,41845,41847,3,5,0
12052,1,1,41843,41847,41848,4,5,0
12053,5,3,41848,41848,41851,0,3,0
12054,1,2,41849,41851,41853,2,4,0
12055,4,3,41853,41853,41856,0,3,0
12056,6,1,41859,41859,41860,0,1,3
12057,4,2,41863,41863,41865,0,2,3
12058,5,3,41868,41868,41871,0,3,3
12059,6,3,41874,41874,41877,0,3,3
12060,6,3,41880,41880,41883,0,3,3
12061,6,3,41886,41886,41889,0,3,3
12062,4,1,41890,41890,41891,0,1,1
12063,5,3,41895,41895,41898,0,3,4
12064,1,2,41896,41898,41900,2,4,0
12065,3,3,41899,41900,41903,1,4,0
12066,6,1,41905,41905,41906,0,1,2
12067,5,3,41910,41910,41913,0,3,4
12068,4,1,41914,41914,41915,0,1,1
12069,3,1,41917,41917,41918,0,1,2
12070,2,3,41919,41919,41922,0,3,1
12071,2,2,41921,41922,41924,1,3,0
12072,6,2,41927,41927,41929,0,2,3
12073,4,1,41931,41931,41932,0,1,2
12074,4,1,41935,41935,41936,0,1,3
12075,4,2,41939,41939,41941,0,2,3
12076,4,3,41943,41943,41946,0,3,2
12077,3,2,41946,41946,41948,0,2,0
12078,4,1,41950,41950,41951,0,1,2
12079,4,3,41954,41954,41957,0,3,3
12080,4,1,41958,41958,41959,0,1,1
12081,2,1,41960,41960,41961,0,1,1
12082,4,2,41964,41964,41966,0,2,3
12083,5,1,41969,41969,41970,0,1,3
12084,6,2,41975,41975,41977,0,2,5
12085,2,2,41977,41977,41979,0,2,0
12086,4,1,41981,41981,41982,0,1,2
12087,5,2,41986,41986,41988,0,2,4
12088,3,3,41989,41989,41992,0,3,1
12089,4,3,41993,41993,41996,0,3,1
12090,2,1,41995,41996,41997,1,2,0
12091,3,3,41998,41998,42001,0,3,1
12092,2,1,42000,42001,42002,1,2,0
12093,2,1,42002,42002,42003,0,1,0
12094,4,1,42006,42006,42007,0,1,3
12095,1,2,42007,42007,42009,0,2,0
12096,5,3,42012,42012,42015,0,3,3
12097,1,1,42013,42015,42016,2,3,0
12098,4,1,42017,42017,42018,0,1,1
12099,6,2,42023,42023,42025,0,2,5
12100,2,3,42025,42025,42028,0,3,0
12101,4,3,42029,42029,42032,0,3,1
12102,5,2,42034,42034,42036,0,2,2
12103,2,3,42036,42036,42039,0,3,0
12104,2,3,42038,42039,42042,1,4,0
12105,6,2,42044,42044,42046,0,2,2
12106,4,3,42048,42048,42051,0,3,2
12107,3,1,42051,42051,42052,0,1,0
12108,2,3,42053,42053,42056,0,3,1
12109,5,3,42058,42058,42061,0,3,2
12110,6,1,42064,42064,42065,0,1,3
12111,1,3,42065,42065,42068,0,3,0
12112,4,1,42069,42069,42070,0,1,1
12113,2,3,42071,42071,42074,0,3,1
12114,5,2,42076,42076,42078,0,2,2
12115,4,3,42080,42080,42083,0,3,2
12116,2,2,42082,42083,42085,1,3,0
12117,3,2,42085,42085,42087,0,2,0
12118,3,2,42088,42088,42090,0,2,1
12119,2,2,42090,42090,42092,0,2,0
12120,6,3,42096,42096,42099,0,3,4
12121,6,3,42102,42102,42105,0,3,3
12122,5,2,42107,42107,42109,0,2,2
12123,4,3,42111,42111,42114,0,3,2
12124,5,3,42116,42116,42119,0,3,2
12125,2,3,42118,42119,42122,1,4,0
12126,1,1,42119,42122,42123,3,4,0
12127,2,3,42121,42123,42126,2,5,0
12128,5,2,42126,42126,42128,0,2,0
12129,4,2,42130,42130,42132,0,2,2
12130,1,1,42131,42132,42133,1,2,0
12131,4,1,42135,42135,42136,0,1,2
12132,6,3,42141,42141,42144,0,3,5
12133,2,2,42143,42144,42146,1,3,0
12134,4,2,42147,42147,42149,0,2,1
12135,2,1,42149,42149,42150,0,1,0
12136,1,3,42150,42150,42153,0,3,0
12137,3,3,42153,42153,42156,0,3,0
12138,5,3,42158,42158,42161,0,3,2
12139,5,3,42163,42163,42166,0,3,2
12140,2,3,42165,42166,42169,1,4,0
12141,4,1,42169,42169,42170,0,1,0
12142,3,1,42172,42172,42173,0,1,2
12143,3,2,42175,42175,42177,0,2,2
12144,4,2,42179,42179,42181,0,2,2
12145,2,2,42181,42181,42183,0,2,0
12146,3,2,42184,42184,42186,0,2,1
12147,5,2,42189,42189,42191,0,2,3
12148,6,3,42195,42195,42198,0,3,4
12149,3,2,42198,42198,42200,0,2,0
12150,1,2,42199,42200,42202,1,3,0
12151,1,2,42200,42202,42204,2,4,0
12152,1,2,42201,42204,42206,3,5,0
12153,5,2,42206,42206,42208,0,2,0
12154,6,3,42212,42212,42215,0,3,4
12155,1,1,42213,42215,42216,2,3,0
12156,5,2,42218,42218,42220,0,2,2
12157,3,2,42221,42221,42223,0,2,1
12158,6,3,42227,42227,42230,0,3,4
12159,2,1,42229,42230,42231,1,2,0
12160,6,3,42235,42235,42238,0,3,4
12161,3,2,42238,42238,42240,0,2,0
12162,5,2,42243,42243,42245,0,2,3
12163,2,2,42245,42245,42247,0,2,0
12164,1,1,42246,42247,42248,1,2,0
12165,4,2,42250,42250,42252,0,2,2
12166,5,2,42255,42255,42257,0,2,3
12167,4,3,42259,42259,42262,0,3,2
12168,4,3,42263,42263,42266,0,3,1
12169,5,2,42268,42268,42270,0,2,2
12170,1,1,42269,42270,42271,1,2,0
12171,5,1,42274,42274,42275,0,1,3
12172,2,2,42276,42276,42278,0,2,1
12173,1,3,42277,42278,42281,1,4,0
12174,3,1,42280,42281,42282,1,2,0
12175,6,1,42286,42286,42287,0,1,4
12176,2,2,42288,42288,42290,0,2,1
12177,2,3,42290,42290,42293,0,3,0
12178,5,2,42295,42295,42297,0,2,2
12179,6,1,42301,42301,42302,0,1,4
12180,2,1,42303,42303,42304,0,1,1
12181,2,1,42305,42305,42306,0,1,1
12182,4,1,42309,42309,42310,0,1,3
12183,4,3,42313,42313,42316,0,3,3
12184,2,3,42315,42316,42319,1,4,0
12185,4,3,42319,42319,42322,0,3,0
12186,3,3,42322,42322,42325,0,3,0
12187,6,3,42328,42328,42331,0,3,3
12188,4,3,42332,42332,42335,0,3,1
12189,6,3,42338,42338,42341,0,3,3
12190,2,1,42340,42341,42342,1,2,0
12191,6,3,42346,42346,42349,0,3,4
12192,6,1,42352,42352,42353,0,1,3
12193,5,2,42357,42357,42359,0,2,4
12194,1,3,42358,42359,42362,1,4,0
12195,6,2,42364,42364,42366,0,2,2
12196,1,2,42365,42366,42368,1,3,0
12197,1,2,42366,42368,42370,2,4,0
12198,1,3,42367,42370,42373,3,6,0
12199,2,2,42369,42373,42375,4,6,0
12200,2,3,42371,42375,42378,4,7,0
12201,3,2,42374,42378,42380,4,6,0
12202,2,1,42376,42380,42381,4,5,0
12203,1,2,42377,42381,42383,4,6,0
12204,2,2,42379,42383,42385,4,6,0
12205,2,3,42381,42385,42388,4,7,0
12206,5,2,42386,42388,42390,2,4,0
12207,3,1,42389,42390,42391,1,2,0
12208,4,2,42393,42393,42395,0,2,2
12209,5,1,42398,42398,42399,0,1,3
12210,6,1,42404,42404,42405,0,1,5
12211,2,1,42406,42406,42407,0,1,1
12212,6,1,42412,42412,42413,0,1,5
12213,3,1,42415,42415,42416,0,1,2
12214,1,1,42416,42416,42417,0,1,0
12215,1,2,42417,42417,42419,0,2,0
12216,6,1,42423,42423,42424,0,1,4
12217,1,1,42424,42424,42425,0,1,0
12218,1,1,42425,42425,42426,0,1,0
12219,3,3,42428,42428,42431,0,3,2
12220,4,1,42432,42432,42433,0,1,1
12221,1,2,42433,42433,42435,0,2,0
12222,5,3,42438,42438,42441,0,3,3
12223,5,3,42443,42443,42446,0,3,2
12224,5,2,42448,42448,42450,0,2,2
12225,2,3,42450,42450,42453,0,3,0
12226,5,3,42455,42455,42458,0,3,2
12227,1,3,42456,42458,42461,2,5,0
12228,3,1,42459,42461,42462,2,3,0
12229,5,2,42464,42464,42466,0,2,2
12230,1,2,42465,42466,42468,1,3,0
12231,6,2,42471,42471,42473,0,2,3
12232,1,2,42472,42473,42475,1,3,0
12233,4,2,42476,42476,42478,0,2,1
12234,4,2,42480,42480,42482,0,2,2
12235,3,1,42483,42483,42484,0,1,1
12236,1,1,42484,42484,42485,0,1,0
12237,4,2,42488,42488,42490,0,2,3
12238,1,2,42489,42490,42492,1,3,0
12239,2,3,42491,42492,42495,1,4,0
12240,2,1,42493,42495,42496,2,3,0
12241,6,3,42499,42499,42502,0,3,3
12242,3,3,42502,42502,42505,0,3,0
12243,3,2,42505,42505,42507,0,2,0
12244,4,1,42509,42509,42510,0,1,2
12245,1,1,42510,42510,42511,0,1,0
12246,4,1,42514,42514,42515,0,1,3
12247,6,3,42520,42520,42523,0,3,5
12248,4,1,42524,42524,42525,0,1,1
12249,1,2,42525,42525,42527,0,2,0
12250,1,2,42526,42527,42529,1,3,0
12251,1,2,42527,42529,42531,2,4,0
12252,3,3,42530,42531,42534,1,4,0
12253,5,1,42535,42535,42536,0,1,1
12254,6,2,42541,42541,42543,0,2,5
12255,2,1,42543,42543,42544,0,1,0
12256,3,2,42546,42546,42548,0,2,2
12257,4,2,42550,42550,42552,0,2,2
12258,1,2,42551,42552,42554,1,3,0
12259,1,3,42552,42554,42557,2,5,0
12260,3,3,42555,42557,42560,2,5,0
12261,1,3,42556,42560,42563,4,7,0
12262,2,1,42558,42563,42564,5,6,0
12263,4,3,42562,42564,42567,2,5,0
12264,4,3,42566,42567,42570,1,4,0
12265,1,2,42567,42570,42572,3,5,0
12266,6,1,42573,42573,42574,0,1,1
12267,1,3,42574,42574,42577,0,3,0
12268,1,3,42575,42577,42580,2,5,0
12269,3,3,42578,42580,42583,2,5,0
12270,5,3,42583,42583,42586,0,3,0
12271,5,1,42588,42588,42589,0,1,2
12272,4,1,42592,42592,42593,0,1,3
12273,6,2,42598,42598,42600,0,2,5
12274,1,3,42599,42600,42603,1,4,0
12275,4,3,42603,42603,42606,0,3,0
12276,1,1,42604,42606,42607,2,3,0
12277,2,3,42606,42607,42610,1,4,0
12278,4,3,42610,42610,42613,0,3,0
12279,2,1,42612,42613,42614,1,2,0
12280,1,3,42613,42614,42617,1,4,0
12281,6,1,42619,42619,42620,0,1,2
12282,3,1,42622,42622,42623,0,1,2
12283,1,3,42623,42623,42626,0,3,0
12284,2,1,42625,42626,42627,1,2,0
12285,4,2,42629,42629,42631,0,2,2
12286,6,1,42635,42635,42636,0,1,4
12287,5,2,42640,42640,42642,0,2,4
12288,1,1,42641,42642,42643,1,2,0
12289,3,2,42644,42644,42646,0,2,1
12290,6,1,42650,42650,42651,0,1,4
12291,2,2,42652,42652,42654,0,2,1
12292,4,3,42656,42656,42659,0,3,2
12293,1,1,42657,42659,42660,2,3,0
12294,6,3,42663,42663,42666,0,3,3
12295,6,2,42669,42669,42671,0,2,3
12296,3,2,42672,42672,42674,0,2,1
12297,6,2,42678,42678,42680,0,2,4
12298,1,1,42679,42680,42681,1,2,0
12299,1,2,42680,42681,42683,1,3,0
12300,6,1,42686,42686,42687,0,1,3
12301,1,2,42687,42687,42689,0,2,0
12302,2,1,42689,42689,42690,0,1,0
12303,6,2,42695,42695,42697,0,2,5
12304,1,1,42696,42697,42698,1,2,0
12305,2,2,42698,42698,42700,0,2,0
12306,5,2,42703,42703,42705,0,2,3
12307,1,1,42704,42705,42706,1,2,0
12308,3,1,42707,42707,42708,0,1,1
12309,3,2,42710,42710,42712,0,2,2
12310,2,3,42712,42712,42715,0,3,0
12311,2,1,42714,42715,42716,1,2,0
12312,3,2,42717,42717,42719,0,2,1
12313,3,1,42720,42720,42721,0,1,1
12314,5,2,42725,42725,42727,0,2,4
12315,6,2,42731,42731,42733,0,2,4
12316,6,2,42737,42737,42739,0,2,4
12317,6,2,42743,42743,42745,0,2,4
12318,2,3,42745,42745,42748,0,3,0
12319,5,3,42750,42750,42753,0,3,2
12320,1,3,42751,42753,42756,2,5,0
12321,1,1,42752,42756,42757,4,5,0
12322,2,2,42754,42757,42759,3,5,0
12323,5,3,42759,42759,42762,0,3,0
12324,2,3,42761,42762,42765,1,4,0
12325,4,2,42765,42765,42767,0,2,0
12326,5,1,42770,42770,42771,0,1,3
12327,6,3,42776,42776,42779,0,3,5
12328,1,1,42777,42779,42780,2,3,0
12329,3,3,42780,42780,42783,0,3,0
12330,2,1,42782,42783,42784,1,2,0
12331,6,1,42788,42788,42789,0,1,4
12332,1,1,42789,42789,42790,0,1,0
12333,6,1,42795,42795,42796,0,1,5
12334,4,3,42799,42799,42802,0,3,3
12335,2,2,42801,42802,42804,1,3,0
12336,5,2,42806,42806,42808,0,2,2
12337,6,3,42812,42812,42815,0,3,4
12338,4,3,42816,42816,42819,0,3,1
12339,4,3,42820,42820,42823,0,3,1
12340,4,3,42824,42824,42827,0,3,1
12341,2,2,42826,42827,42829,1,3,0
12342,5,2,42831,42831,42833,0,2,2
12343,5,2,42836,42836,42838,0,2,3
12344,4,1,42840,42840,42841,0,1,2
12345,4,2,42844,42844,42846,0,2,3
12346,1,2,42845,42846,42848,1,3,0
12347,4,1,42849,42849,42850,0,1,1
12348,2,2,42851,42851,42853,0,2,1
12349,5,3,42856,42856,42859,0,3,3
12350,4,2,42860,42860,42862,0,2,1
12351,6,2,42866,42866,42868,0,2,4
12352,5,1,42871,42871,42872,0,1,3
12353,6,3,42877,42877,42880,0,3,5
12354,2,1,42879,42880,42881,1,2,0
12355,1,3,42880,42881,42884,1,4,0
12356,6,2,42886,42886,42888,0,2,2
12357,3,1,42889,42889,42890,0,1,1
12358,6,1,42895,42895,42896,0,1,5
12359,1,1,42896,42896,42897,0,1,0
12360,5,1,42901,42901,42902,0,1,4
12361,4,3,42905,42905,42908,0,3,3
12362,4,2,42909,42909,42911,0,2,1
12363,2,2,42911,42911,42913,0,2,0
12364,5,3,42916,42916,42919,0,3,3
12365,6,2,42922,42922,42924,0,2,3
12366,3,2,42925,42925,42927,0,2,1
12367,4,2,42929,42929,42931,0,2,2
12368,3,1,42932,42932,42933,0,1,1
12369,1,2,42933,42933,42935,0,2,0
12370,1,2,42934,42935,42937,1,3,0
12371,5,2,42939,42939,42941,0,2,2
12372,5,1,42944,42944,42945,0,1,3
12373,3,2,42947,42947,42949,0,2,2
12374,1,3,42948,42949,42952,1,4,0
12375,1,2,42949,42952,42954,3,5,0
12376,1,1,42950,42954,42955,4,5,0
12377,3,1,42953,42955,42956,2,3,0
12378,4,2,42957,42957,42959,0,2,1
12379,4,2,42961,42961,42963,0,2,2
12380,3,1,42964,42964,42965,0,1,1
12381,2,3,42966,42966,42969,0,3,1
12382,2,1,42968,42969,42970,1,2,0
12383,6,1,42974,42974,42975,0,1,4
12384,4,1,42978,42978,42979,0,1,3
12385,4,2,42982,42982,42984,0,2,3
12386,3,3,42985,42985,42988,0,3,1
12387,5,1,42990,42990,42991,0,1,2
12388,6,2,42996,42996,42998,0,2,5
12389,6,2,43002,43002,43004,0,2,4
12390,3,2,43005,43005,43007,0,2,1
12391,3,3,43008,43008,43011,0,3,1
12392,1,3,43009,43011,43014,2,5,0
12393,1,2,43010,43014,43016,4,6,0
12394,4,1,43014,43016,43017,2,3,0
12395,2,3,43016,43017,43020,1,4,0
12396,5,1,43021,43021,43022,0,1,1
12397,4,3,43025,43025,43028,0,3,3
12398,6,1,43031,43031,43032,0,1,3
12399,5,3,43036,43036,43039,0,3,4
12400,5,2,43041,43041,43043,0,2,2
12401,1,3,43042,43043,43046,1,4,0
12402,5,1,43047,43047,43048,0,1,1
12403,2,3,43049,43049,43052,0,3,1
12404,2,3,43051,43052,43055,1,4,0
12405,4,2,43055,43055,43057,0,2,0
12406,6,1,43061,43061,43062,0,1,4
12407,6,1,43067,43067,43068,0,1,5
12408,6,2,43073,43073,43075,0,2,5
12409,2,1,43075,43075,43076,0,1,0
12410,4,2,43079,43079,43081,0,2,3
12411,4,2,43083,43083,43085,0,2,2
12412,6,1,43089,43089,43090,0,1,4
12413,4,2,43093,43093,43095,0,2,3
12414,3,3,43096,43096,43099,0,3,1
12415,6,3,43102,43102,43105,0,3,3
12416,1,1,43103,43105,43106,2,3,0
12417,3,1,43106,43106,43107,0,1,0
12418,6,3,43112,43112,43115,0,3,5
12419,1,1,43113,43115,43116,2,3,0
12420,2,3,43115,43116,43119,1,4,0
12421,1,1,43116,43119,43120,3,4,0
12422,6,3,43122,43122,43125,0,3,2
12423,1,3,43123,43125,43128,2,5,0
12424,5,1,43128,43128,43129,0,1,0
12425,6,1,43134,43134,43135,0,1,5
12426,2,1,43136,43136,43137,0,1,1
12427,6,3,43142,43142,43145,0,3,5
12428,3,2,43145,43145,43147,0,2,0
12429,6,1,43151,43151,43152,0,1,4
12430,1,2,43152,43152,43154,0,2,0
12431,4,3,43156,43156,43159,0,3,2
12432,3,2,43159,43159,43161,0,2,0
12433,1,1,43160,43161,43162,1,2,0
12434,3,3,43163,43163,43166,0,3,1
12435,4,2,43167,43167,43169,0,2,1
12436,2,1,43169,43169,43170,0,1,0
12437,3,3,43172,43172,43175,0,3,2
12438,3,2,43175,43175,43177,0,2,0
12439,5,1,43180,43180,43181,0,1,3
12440,1,2,43181,43181,43183,0,2,0
12441,2,1,43183,43183,43184,0,1,0
12442,5,1,43188,43188,43189,0,1,4
12443,3,3,43191,43191,43194,0,3,2
12444,2,2,43193,43194,43196,1,3,0
12445,6,1,43199,43199,43200,0,1,3
12446,3,1,43202,43202,43203,0,1,2
12447,4,1,43206,43206,43207,0,1,3
12448,3,1,43209,43209,43210,0,1,2
12449,3,3,43212,43212,43215,0,3,2
12450,6,3,43218,43218,43221,0,3,3
12451,1,3,43219,43221,43224,2,5,0
12452,3,3,43222,43224,43227,2,5,0
12453,6,2,43228,43228,43230,0,2,1
12454,1,3,43229,43230,43233,1,4,0
12455,2,2,43231,43233,43235,2,4,0
12456,5,1,43236,43236,43237,0,1,1
12457,5,1,43241,43241,43242,0,1,4
12458,2,3,43243,43243,43246,0,3,1
12459,2,1,43245,43246,43247,1,2,0
12460,6,1,43251,43251,43252,0,1,4
12461,4,3,43255,43255,43258,0,3,3
12462,4,3,43259,43259,43262,0,3,1
12463,4,1,43263,43263,43264,0,1,1
12464,1,1,43264,43264,43265,0,1,0
12465,1,2,43265,43265,43267,0,2,0
12466,1,1,43266,43267,43268,1,2,0
12467,6,1,43272,43272,43273,0,1,4
12468,4,1,43276,43276,43277,0,1,3
12469,2,3,43278,43278,43281,0,3,1
12470,2,3,43280,43281,43284,1,4,0
12471,1,1,43281,43284,43285,3,4,0
12472,6,3,43287,43287,43290,0,3,2
12473,3,3,43290,43290,43293,0,3,0
12474,5,1,43295,43295,43296,0,1,2
12475,4,1,43299,43299,43300,0,1,3
12476,5,3,43304,43304,43307,0,3,4
12477,4,1,43308,43308,43309,0,1,1
12478,5,3,43313,43313,43316,0,3,4
12479,2,1,43315,43316,43317,1,2,0
12480,4,3,43319,43319,43322,0,3,2
12481,5,3,43324,43324,43327,0,3,2
12482,6,2,43330,43330,43332,0,2,3
12483,5,1,43335,43335,43336,0,1,3
12484,1,1,43336,43336,43337,0,1,0
12485,6,3,43342,43342,43345,0,3,5
12486,2,2,43344,43345,43347,1,3,0
12487,4,1,43348,43348,43349,0,1,1
12488,2,3,43350,43350,43353,0,3,1
12489,2,2,43352,43353,43355,1,3,0
12490,4,3,43356,43356,43359,0,3,1
12491,2,3,43358,43359,43362,1,4,0
12492,3,2,43361,43362,43364,1,3,0
12493,6,2,43367,43367,43369,0,2,3
12494,2,2,43369,43369,43371,0,2,0
12495,4,3,43373,43373,43376,0,3,2
12496,5,3,43378,43378,43381,0,3,2
12497,4,1,43382,43382,43383,0,1,1
12498,6,1,43388,43388,43389,0,1,5
12499,4,3,43392,43392,43395,0,3,3
12500,5,1,43397,43397,43398,0,1,2
12501,5,3,43402,43402,43405,0,3,4
12502,4,2,43406,43406,43408,0,2,1
12503,6,2,43412,43412,43414,0,2,4
12504,3,3,43415,43415,43418,0,3,1
12505,3,1,43418,43418,43419,0,1,0
12506,2,3,43420,43420,43423,0,3,1
12507,3,3,43423,43423,43426,0,3,0
12508,4,1,43427,43427,43428,0,1,1
12509,5,1,43432,43432,43433,0,1,4
12510,1,1,43433,43433,43434,0,1,0
12511,6,3,43439,43439,43442,0,3,5
12512,6,2,43445,43445,43447,0,2,3
12513,5,3,43450,43450,43453,0,3,3
12514,4,2,43454,43454,43456,0,2,1
12515,1,3,43455,43456,43459,1,4,0
12516,1,3,43456,43459,43462,3,6,0
12517,6,1,43462,43462,43463,0,1,0
12518,6,3,43468,43468,43471,0,3,5
12519,4,3,43472,43472,43475,0,3,1
12520,2,2,43474,43475,43477,1,3,0
12521,5,1,43479,43479,43480,0,1,2
12522,4,3,43483,43483,43486,0,3,3
12523,4,3,43487,43487,43490,0,3,1
12524,2,1,43489,43490,43491,1,2,0
12525,2,2,43491,43491,43493,0,2,0
12526,5,2,43496,43496,43498,0,2,3
12527,1,2,43497,43498,43500,1,3,0
12528,3,1,43500,43500,43501,0,1,0
12529,3,1,43503,43503,43504,0,1,2
12530,6,1,43509,43509,43510,0,1,5
12531,4,3,43513,43513,43516,0,3,3
12532,1,2,43514,43516,43518,2,4,0
12533,5,3,43519,43519,43522,0,3,1
12534,3,1,43522,43522,43523,0,1,0
12535,5,3,43527,43527,43530,0,3,4
12536,5,2,43532,43532,43534,0,2,2
12537,3,3,43535,43535,43538,0,3,1
12538,6,2,43541,43541,43543,0,2,3
12539,3,1,43544,43544,43545,0,1,1
12540,4,1,43548,43548,43549,0,1,3
12541,3,2,43551,43551,43553,0,2,2
12542,1,3,43552,43553,43556,1,4,0
12543,3,1,43555,43556,43557,1,2,0
12544,5,1,43560,43560,43561,0,1,3
12545,3,3,43563,43563,43566,0,3,2
12546,6,1,43569,43569,43570,0,1,3
12547,5,3,43574,43574,43577,0,3,4
12548,1,3,43575,43577,43580,2,5,0
12549,3,2,43578,43580,43582,2,4,0
12550,6,2,43584,43584,43586,0,2,2
12551,5,2,43589,43589,43591,0,2,3
12552,6,3,43595,43595,43598,0,3,4
12553,1,1,43596,43598,43599,2,3,0
12554,3,1,43599,43599,43600,0,1,0
12555,1,2,43600,43600,43602,0,2,0
12556,2,1,43602,43602,43603,0,1,0
12557,4,3,43606,43606,43609,0,3,3
12558,6,1,43612,43612,43613,0,1,3
12559,4,2,43616,43616,43618,0,2,3
12560,1,1,43617,43618,43619,1,2,0
12561,6,1,43623,43623,43624,0,1,4
12562,3,3,43626,43626,43629,0,3,2
12563,6,1,43632,43632,43633,0,1,3
12564,5,1,43637,43637,43638,0,1,4
12565,3,2,43640,43640,43642,0,2,2
12566,4,3,43644,43644,43647,0,3,2
12567,2,3,43646,43647,43650,1,4,0
12568,6,3,43652,43652,43655,0,3,2
12569,2,3,43654,43655,43658,1,4,0
12570,1,3,43655,43658,43661,3,6,0
12571,6,2,43661,43661,43663,0,2,0
12572,6,2,43667,43667,43669,0,2,4
12573,1,1,43668,43669,43670,1,2,0
12574,4,3,43672,43672,43675,0,3,2
12575,3,3,43675,43675,43678,0,3,0
12576,6,3,43681,43681,43684,0,3,3
12577,5,1,43686,43686,43687,0,1,2
12578,1,3,43687,43687,43690,0,3,0
12579,5,3,43692,43692,43695,0,3,2
12580,2,3,43694,43695,43698,1,4,0
12581,1,1,43695,43698,43699,3,4,0
12582,5,1,43700,43700,43701,0,1,1
12583,6,2,43706,43706,43708,0,2,5
12584,4,2,43710,43710,43712,0,2,2
12585,5,3,43715,43715,43718,0,3,3
12586,4,2,43719,43719,43721,0,2,1
12587,4,2,43723,43723,43725,0,2,2
12588,5,3,43728,43728,43731,0,3,3
12589,3,2,43731,43731,43733,0,2,0
12590,1,3,43732,43733,43736,1,4,0
12591,5,3,43737,43737,43740,0,3,1
12592,3,1,43740,43740,43741,0,1,0
12593,1,1,43741,43741,43742,0,1,0
12594,2,1,43743,43743,43744,0,1,1
12595,4,2,43747,43747,43749,0,2,3
12596,2,3,43749,43749,43752,0,3,0
12597,1,2,43750,43752,43754,2,4,0
12598,3,1,43753,43754,43755,1,2,0
12599,5,2,43758,43758,43760,0,2,3
12600,4,2,43762,43762,43764,0,2,2
12601,6,2,43768,43768,43770,0,2,4
12602,3,2,43771,43771,43773,0,2,1
12603,1,2,43772,43773,43775,1,3,0
12604,2,1,43774,43775,43776,1,2,0
12605,1,3,43775,43776,43779,1,4,0
12606,5,3,43780,43780,43783,0,3,1
12607,2,3,43782,43783,43786,1,4,0
12608,2,2,43784,43786,43788,2,4,0
12609,1,1,43785,43788,43789,3,4,0
12610,1,3,43786,43789,43792,3,6,0
12611,5,3,43791,43792,43795,1,4,0
12612,6,1,43797,43797,43798,0,1,2
12613,1,2,43798,43798,43800,0,2,0
12614,2,2,43800,43800,43802,0,2,0
12615,5,1,43805,43805,43806,0,1,3
12616,3,3,43808,43808,43811,0,3,2
12617,4,2,43812,43812,43814,0,2,1
12618,4,2,43816,43816,43818,0,2,2
12619,6,2,43822,43822,43824,0,2,4
12620,1,1,43823,43824,43825,1,2,0
12621,2,3,43825,43825,43828,0,3,0
12622,4,2,43829,43829,43831,0,2,1
12623,1,2,43830,43831,43833,1,3,0
12624,4,1,43834,43834,43835,0,1,1
12625,1,2,43835,43835,43837,0,2,0
12626,2,3,43837,43837,43840,0,3,0
12627,1,1,43838,43840,43841,2,3,0
12628,4,1,43842,43842,43843,0,1,1
12629,6,2,43848,43848,43850,0,2,5
12630,4,1,43852,43852,43853,0,1,2
12631,5,3,43857,43857,43860,0,3,4
12632,3,3,43860,43860,43863,0,3,0
12633,1,2,43861,43863,43865,2,4,0
12634,4,2,43865,43865,43867,0,2,0
12635,5,3,43870,43870,43873,0,3,3
12636,1,2,43871,43873,43875,2,4,0
12637,6,2,43877,43877,43879,0,2,2
12638,2,3,43879,43879,43882,0,3,0
12639,4,3,43883,43883,43886,0,3,1
12640,2,3,43885,43886,43889,1,4,0
12641,3,2,43888,43889,43891,1,3,0
12642,2,2,43890,43891,43893,1,3,0
12643,2,1,43892,43893,43894,1,2,0
12644,6,2,43898,43898,43900,0,2,4
12645,2,2,43900,43900,43902,0,2,0
12646,3,1,43903,43903,43904,0,1,1
12647,1,1,43904,43904,43905,0,1,0
12648,6,1,43910,43910,43911,0,1,5
12649,3,3,43913,43913,43916,0,3,2
12650,5,2,43918,43918,43920,0,2,2
12651,6,2,43924,43924,43926,0,2,4
12652,1,1,43925,43926,43927,1,2,0
12653,6,2,43931,43931,43933,0,2,4
12654,6,2,43937,43937,43939,0,2,4
12655,3,3,43940,43940,43943,0,3,1
12656,5,1,43945,43945,43946,0,1,2
12657,2,2,43947,43947,43949,0,2,1
12658,1,1,43948,43949,43950,1,2,0
12659,6,2,43954,43954,43956,0,2,4
12660,1,2,43955,43956,43958,1,3,0
12661,5,2,43960,43960,43962,0,2,2
12662,6,1,43966,43966,43967,0,1,4
12663,2,2,43968,43968,43970,0,2,1
12664,3,3,43971,43971,43974,0,3,1
12665,1,2,43972,43974,43976,2,4,0
12666,6,2,43978,43978,43980,0,2,2
12667,4,1,43982,43982,43983,0,1,2
12668,3,1,43985,43985,43986,0,1,2
12669,4,2,43989,43989,43991,0,2,3
12670,2,1,43991,43991,43992,0,1,0
12671,4,1,43995,43995,43996,0,1,3
12672,6,1,44001,44001,44002,0,1,5
12673,6,1,44007,44007,44008,0,1,5
12674,6,3,44013,44013,44016,0,3,5
12675,3,3,44016,44016,44019,0,3,0
12676,5,1,44021,44021,44022,0,1,2
12677,5,1,44026,44026,44027,0,1,4
12678,5,1,44031,44031,44032,0,1,4
12679,3,2,44034,44034,44036,0,2,2
12680,3,1,44037,44037,44038,0,1,1
12681,2,3,44039,44039,44042,0,3,1
12682,4,1,44043,44043,44044,0,1,1
12683,1,1,44044,44044,44045,0,1,0
12684,2,2,44046,44046,44048,0,2,1
12685,2,3,44048,44048,44051,0,3,0
12686,4,1,44052,44052,44053,0,1,1
12687,2,2,44054,44054,44056,0,2,1
12688,2,3,44056,44056,44059,0,3,0
12689,1,2,44057,44059,44061,2,4,0
12690,5,1,44062,44062,44063,0,1,1
12691,4,2,44066,44066,44068,0,2,3
12692,2,3,44068,44068,44071,0,3,0
12693,1,1,44069,44071,44072,2,3,0
12694,5,3,44074,44074,44077,0,3,2
12695,6,3,44080,44080,44083,0,3,3
12696,5,3,44085,44085,44088,0,3,2
12697,4,1,44089,44089,44090,0,1,1
12698,3,3,44092,44092,44095,0,3,2
12699,6,3,44098,44098,44101,0,3,3
12700,6,1,44104,44104,44105,0,1,3
12701,3,1,44107,44107,44108,0,1,2
12702,4,2,44111,44111,44113,0,2,3
12703,1,1,44112,44113,44114,1,2,0
12704,1,2,44113,44114,44116,1,3,0
12705,2,2,44115,44116,44118,1,3,0
12706,2,3,44117,44118,44121,1,4,0
12707,5,3,44122,44122,44125,0,3,1
12708,1,2,44123,44125,44127,2,4,0
12709,2,2,44125,44127,44129,2,4,0
12710,6,2,44131,44131,44133,0,2,2
12711,5,3,44136,44136,44139,0,3,3
12712,3,3,44139,44139,44142,0,3,0
12713,1,1,44140,44142,44143,2,3,0
12714,6,1,44146,44146,44147,0,1,3
12715,1,3,44147,44147,44150,0,3,0
12716,2,1,44149,44150,44151,1,2,0
12717,4,2,44153,44153,44155,0,2,2
12718,1,1,44154,44155,44156,1,2,0
12719,6,3,44160,44160,44163,0,3,4
12720,6,1,44166,44166,44167,0,1,3
12721,4,1,44170,44170,44171,0,1,3
12722,1,3,44171,44171,44174,0,3,0
12723,2,3,44173,44174,44177,1,4,0
12724,2,2,44175,44177,44179,2,4,0
12725,2,1,44177,44179,44180,2,3,0
12726,6,2,44183,44183,44185,0,2,3
12727,6,2,44189,44189,44191,0,2,4
12728,5,2,44194,44194,44196,0,2,3
12729,1,1,44195,44196,44197,1,2,0
12730,2,3,44197,44197,44200,0,3,0
12731,6,2,44203,44203,44205,0,2,3
12732,5,2,44208,44208,44210,0,2,3
12733,4,3,44212,44212,44215,0,3,2
12734,6,3,44218,44218,44221,0,3,3
12735,5,3,44223,44223,44226,0,3,2
12736,5,2,44228,44228,44230,0,2,2
12737,4,2,44232,44232,44234,0,2,2
12738,2,1,44234,44234,44235,0,1,0
12739,2,2,44236,44236,44238,0,2,1
12740,6,2,44242,44242,44244,0,2,4
12741,1,2,44243,44244,44246,1,3,0
12742,3,2,44246,44246,44248,0,2,0
12743,4,2,44250,44250,44252,0,2,2
12744,6,1,44256,44256,44257,0,1,4
12745,1,3,44257,44257,44260,0,3,0
12746,2,3,44259,44260,44263,1,4,0
12747,5,2,44264,44264,44266,0,2,1
12748,4,2,44268,44268,44270,0,2,2
12749,2,3,44270,44270,44273,0,3,0
12750,4,2,44274,44274,44276,0,2,1
12751,2,3,44276,44276,44279,0,3,0
12752,5,3,44281,44281,44284,0,3,2
12753,5,1,44286,44286,44287,0,1,2
12754,3,1,44289,44289,44290,0,1,2
12755,2,1,44291,44291,44292,0,1,1
12756,2,1,44293,44293,44294,0,1,1
12757,4,3,44297,44297,44300,0,3,3
12758,5,1,44302,44302,44303,0,1,2
12759,1,2,44303,44303,44305,0,2,0
12760,2,1,44305,44305,44306,0,1,0
12761,4,3,44309,44309,44312,0,3,3
12762,3,2,44312,44312,44314,0,2,0
12763,1,3,44313,44314,44317,1,4,0
12764,5,2,44318,44318,44320,0,2,1
12765,5,1,44323,44323,44324,0,1,3
12766,3,3,44326,44326,44329,0,3,2
12767,5,1,44331,44331,44332,0,1,2
12768,4,2,44335,44335,44337,0,2,3
12769,3,1,44338,44338,44339,0,1,1
12770,3,2,44341,44341,44343,0,2,2
12771,6,2,44347,44347,44349,0,2,4
12772,1,1,44348,44349,44350,1,2,0
12773,5,1,44353,44353,44354,0,1,3
12774,2,2,44355,44355,44357,0,2,1
12775,4,1,44359,44359,44360,0,1,2
12776,3,1,44362,44362,44363,0,1,2
12777,4,1,44366,44366,44367,0,1,3
12778,1,1,44367,44367,44368,0,1,0
12779,3,1,44370,44370,44371,0,1,2
12780,6,3,44376,44376,44379,0,3,5
12781,1,3,44377,44379,44382,2,5,0
12782,5,2,44382,44382,44384,0,2,0
12783,4,1,44386,44386,44387,0,1,2
12784,4,3,44390,44390,44393,0,3,3
12785,3,2,44393,44393,44395,0,2,0
12786,2,2,44395,44395,44397,0,2,0
12787,6,3,44401,44401,44404,0,3,4
12788,6,3,44407,44407,44410,0,3,3
12789,2,2,44409,44410,44412,1,3,0
12790,3,3,44412,44412,44415,0,3,0
12791,6,3,44418,44418,44421,0,3,3
12792,4,2,44422,44422,44424,0,2,1
12793,4,2,44426,44426,44428,0,2,2
12794,6,1,44432,44432,44433,0,1,4
12795,6,1,44438,44438,44439,0,1,5
12796,2,3,44440,44440,44443,0,3,1
12797,4,2,44444,44444,44446,0,2,1
12798,5,1,44449,44449,44450,0,1,3
12799,3,3,44452,44452,44455,0,3,2
12800,5,3,44457,44457,44460,0,3,2
12801,1,2,44458,44460,44462,2,4,0
12802,3,1,44461,44462,44463,1,2,0
12803,2,1,44463,44463,44464,0,1,0
12804,6,2,44469,44469,44471,0,2,5
12805,1,1,44470,44471,44472,1,2,0
12806,3,3,44473,44473,44476,0,3,1
12807,4,3,44477,44477,44480,0,3,1
12808,4,1,44481,44481,44482,0,1,1
12809,3,3,44484,44484,44487,0,3,2
12810,6,2,44490,44490,44492,0,2,3
12811,4,2,44494,44494,44496,0,2,2
12812,1,3,44495,44496,44499,1,4,0
12813,1,1,44496,44499,44500,3,4,0
12814,2,3,44498,44500,44503,2,5,0
12815,3,3,44501,44503,44506,2,5,0
12816,2,3,44503,44506,44509,3,6,0
12817,3,3,44506,44509,44512,3,6,0
12818,3,3,44509,44512,44515,3,6,0
12819,2,3,44511,44515,44518,4,7,0
12820,2,1,44513,44518,44519,5,6,0
12821,5,1,44518,44519,44520,1,2,0
12822,2,3,44520,44520,44523,0,3,0
12823,2,1,44522,44523,44524,1,2,0
12824,2,3,44524,44524,44527,0,3,0
12825,2,2,44526,44527,44529,1,3,0
12826,6,1,44532,44532,44533,0,1,3
12827,2,1,44534,44534,44535,0,1,1
12828,5,2,44539,44539,44541,0,2,4
12829,5,2,44544,44544,44546,0,2,3
12830,6,2,44550,44550,44552,0,2,4
12831,2,1,44552,44552,44553,0,1,0
12832,1,3,44553,44553,44556,0,3,0
12833,6,3,44559,44559,44562,0,3,3
12834,1,2,44560,44562,44564,2,4,0
12835,1,2,44561,44564,44566,3,5,0
12836,5,1,44566,44566,44567,0,1,0
12837,3,3,44569,44569,44572,0,3,2
12838,3,1,44572,44572,44573,0,1,0
12839,4,2,44576,44576,44578,0,2,3
12840,1,3,44577,44578,44581,1,4,0
12841,6,1,44583,44583,44584,0,1,2
12842,3,1,44586,44586,44587,0,1,2
12843,1,1,44587,44587,44588,0,1,0
12844,4,1,44591,44591,44592,0,1,3
12845,4,3,44595,44595,44598,0,3,3
12846,4,1,44599,44599,44600,0,1,1
12847,3,2,44602,44602,44604,0,2,2
12848,3,2,44605,44605,44607,0,2,1
12849,1,1,44606,44607,44608,1,2,0
12850,4,3,44610,44610,44613,0,3,2
12851,6,1,44616,44616,44617,0,1,3
12852,4,2,44620,44620,44622,0,2,3
12853,6,2,44626,44626,44628,0,2,4
12854,4,1,44630,44630,44631,0,1,2
12855,4,1,44634,44634,44635,0,1,3
12856,5,3,44639,44639,44642,0,3,4
12857,3,3,44642,44642,44645,0,3,0
12858,5,3,44647,44647,44650,0,3,2
12859,6,2,44653,44653,44655,0,2,3
12860,1,2,44654,44655,44657,1,3,0
12861,3,2,44657,44657,44659,0,2,0
12862,6,3,44663,44663,44666,0,3,4
12863,5,3,44668,44668,44671,0,3,2
12864,5,1,44673,44673,44674,0,1,2
12865,1,2,44674,44674,44676,0,2,0
12866,2,3,44676,44676,44679,0,3,0
12867,5,3,44681,44681,44684,0,3,2
12868,2,1,44683,44684,44685,1,2,0
12869,1,2,44684,44685,44687,1,3,0
12870,6,2,44690,44690,44692,0,2,3
12871,5,3,44695,44695,44698,0,3,3
12872,2,1,44697,44698,44699,1,2,0
12873,1,1,44698,44699,44700,1,2,0
12874,1,2,44699,44700,44702,1,3,0
12875,4,3,44703,44703,44706,0,3,1
12876,5,2,44708,44708,44710,0,2,2
12877,5,1,44713,44713,44714,0,1,3
12878,5,2,44718,44718,44720,0,2,4
12879,6,2,44724,44724,44726,0,2,4
12880,4,2,44728,44728,44730,0,2,2
12881,2,1,44730,44730,44731,0,1,0
12882,1,3,44731,44731,44734,0,3,0
12883,3,1,44734,44734,44735,0,1,0
12884,4,1,44738,44738,44739,0,1,3
12885,2,2,44740,44740,44742,0,2,1
12886,2,2,44742,44742,44744,0,2,0
12887,6,2,44748,44748,44750,0,2,4
12888,6,3,44754,44754,44757,0,3,4
12889,1,3,44755,44757,44760,2,5,0
12890,6,3,44761,44761,44764,0,3,1
12891,1,1,44762,44764,44765,2,3,0
12892,1,2,44763,44765,44767,2,4,0
12893,1,1,44764,44767,44768,3,4,0
12894,1,1,44765,44768,44769,3,4,0
12895,6,3,44771,44771,44774,0,3,2
12896,6,3,44777,44777,44780,0,3,3
12897,4,1,44781,44781,44782,0,1,1
12898,2,1,44783,44783,44784,0,1,1
12899,3,1,44786,44786,44787,0,1,2
12900,6,1,44792,44792,44793,0,1,5
12901,4,2,44796,44796,44798,0,2,3
12902,4,3,44800,44800,44803,0,3,2
12903,3,3,44803,44803,44806,0,3,0
12904,2,2,44805,44806,44808,1,3,0
12905,6,3,44811,44811,44814,0,3,3
12906,2,1,44813,44814,44815,1,2,0
12907,6,3,44819,44819,44822,0,3,4
12908,2,2,44821,44822,44824,1,3,0
12909,2,2,44823,44824,44826,1,3,0
12910,1,2,44824,44826,44828,2,4,0
12911,1,3,44825,44828,44831,3,6,0
12912,1,3,44826,44831,44834,5,8,0
12913,4,2,44830,44834,44836,4,6,0
12914,4,2,44834,44836,44838,2,4,0
12915,1,1,44835,44838,44839,3,4,0
12916,1,1,44836,44839,44840,3,4,0
12917,1,1,44837,44840,44841,3,4,0
12918,5,1,44842,44842,44843,0,1,1
12919,6,2,44848,44848,44850,0,2,5
12920,2,2,44850,44850,44852,0,2,0
12921,2,3,44852,44852,44855,0,3,0
12922,6,3,44858,44858,44861,0,3,3
12923,4,1,44862,44862,44863,0,1,1
12924,1,3,44863,44863,44866,0,3,0
12925,6,1,44869,44869,44870,0,1,3
12926,4,2,44873,44873,44875,0,2,3
12927,3,3,44876,44876,44879,0,3,1
12928,4,3,44880,44880,44883,0,3,1
12929,1,3,44881,44883,44886,2,5,0
12930,2,1,44883,44886,44887,3,4,0
12931,6,1,44889,44889,44890,0,1,2
12932,6,1,44895,44895,44896,0,1,5
12933,1,3,44896,44896,44899,0,3,0
12934,5,3,44901,44901,44904,0,3,2
12935,3,1,44904,44904,44905,0,1,0
12936,6,3,44910,44910,44913,0,3,5
12937,4,2,44914,44914,44916,0,2,1
12938,4,1,44918,44918,44919,0,1,2
12939,4,1,44922,44922,44923,0,1,3
12940,5,1,44927,44927,44928,0,1,4
12941,6,1,44933,44933,44934,0,1,5
12942,4,1,44937,44937,44938,0,1,3
12943,5,3,44942,44942,44945,0,3,4
12944,5,2,44947,44947,44949,0,2,2
12945,4,1,44951,44951,44952,0,1,2
12946,4,3,44955,44955,44958,0,3,3
12947,2,1,44957,44958,44959,1,2,0
12948,4,1,44961,44961,44962,0,1,2
12949,2,2,44963,44963,44965,0,2,1
12950,6,3,44969,44969,44972,0,3,4
12951,2,2,44971,44972,44974,1,3,0
12952,2,3,44973,44974,44977,1,4,0
12953,3,3,44976,44977,44980,1,4,0
12954,1,1,44977,44980,44981,3,4,0
12955,6,3,44983,44983,44986,0,3,2
12956,4,3,44987,44987,44990,0,3,1
12957,6,1,44993,44993,44994,0,1,3
12958,6,1,44999,44999,45000,0,1,5
12959,4,3,45003,45003,45006,0,3,3
12960,5,2,45008,45008,45010,0,2,2
12961,1,3,45009,45010,45013,1,4,0
12962,5,1,45014,45014,45015,0,1,1
12963,3,1,45017,45017,45018,0,1,2
12964,4,1,45021,45021,45022,0,1,3
12965,1,1,45022,45022,45023,0,1,0
12966,6,3,45028,45028,45031,0,3,5
12967,4,2,45032,45032,45034,0,2,1
12968,3,2,45035,45035,45037,0,2,1
12969,6,1,45041,45041,45042,0,1,4
12970,5,3,45046,45046,45049,0,3,4
12971,1,1,45047,45049,45050,2,3,0
12972,1,3,45048,45050,45053,2,5,0
12973,6,3,45054,45054,45057,0,3,1
12974,3,1,45057,45057,45058,0,1,0
12975,5,1,45062,45062,45063,0,1,4
12976,6,3,45068,45068,45071,0,3,5
12977,4,3,45072,45072,45075,0,3,1
12978,4,1,45076,45076,45077,0,1,1
12979,6,2,45082,45082,45084,0,2,5
12980,6,2,45088,45088,45090,0,2,4
12981,1,2,45089,45090,45092,1,3,0
12982,6,1,45095,45095,45096,0,1,3
12983,4,2,45099,45099,45101,0,2,3
12984,2,3,45101,45101,45104,0,3,0
12985,5,3,45106,45106,45109,0,3,2
12986,6,1,45112,45112,45113,0,1,3
12987,3,1,45115,45115,45116,0,1,2
12988,6,3,45121,45121,45124,0,3,5
12989,3,1,45124,45124,45125,0,1,0
12990,6,3,45130,45130,45133,0,3,5
12991,1,3,45131,45133,45136,2,5,0
12992,4,2,45135,45136,45138,1,3,0
12993,6,1,45141,45141,45142,0,1,3
12994,3,2,45144,45144,45146,0,2,2
12995,6,2,45150,45150,45152,0,2,4
12996,3,3,45153,45153,45156,0,3,1
12997,3,1,45156,45156,45157,0,1,0
12998,1,1,45157,45157,45158,0,1,0
12999,2,1,45159,45159,45160,0,1,1
13000,6,1,45165,45165,45166,0,1,5
13001,5,3,45170,45170,45173,0,3,4
13002,1,2,45171,45173,45175,2,4,0
13003,4,3,45175,45175,45178,0,3,0
13004,4,3,45179,45179,45182,0,3,1
13005,5,3,45184,45184,45187,0,3,2
13006,2,2,45186,45187,45189,1,3,0
13007,2,3,45188,45189,45192,1,4,0
13008,5,1,45193,45193,45194,0,1,1
13009,1,1,45194,45194,45195,0,1,0
13010,4,2,45198,45198,45200,0,2,3
13011,5,2,45203,45203,45205,0,2,3
13012,2,1,45205,45205,45206,0,1,0
13013,1,1,45206,45206,45207,0,1,0
13014,3,3,45209,45209,45212,0,3,2
13015,5,3,45214,45214,45217,0,3,2
13016,3,1,45217,45217,45218,0,1,0
13017,5,2,45222,45222,45224,0,2,4
13018,2,3,45224,45224,45227,0,3,0
13019,1,3,45225,45227,45230,2,5,0
13020,2,3,45227,45230,45233,3,6,0
13021,5,2,45232,45233,45235,1,3,0
13022,1,2,45233,45235,45237,2,4,0
13023,5,2,45238,45238,45240,0,2,1
13024,3,3,45241,45241,45244,0,3,1
13025,3,1,45244,45244,45245,0,1,0
13026,2,1,45246,45246,45247,0,1,1
13027,4,1,45250,45250,45251,0,1,3
13028,1,2,45251,45251,45253,0,2,0
13029,5,3,45256,45256,45259,0,3,3
13030,3,2,45259,45259,45261,0,2,0
13031,5,2,45264,45264,45266,0,2,3
13032,2,3,45266,45266,45269,0,3,0
13033,1,1,45267,45269,45270,2,3,0
13034,4,1,45271,45271,45272,0,1,1
13035,3,2,45274,45274,45276,0,2,2
13036,3,1,45277,45277,45278,0,1,1
13037,3,1,45280,45280,45281,0,1,2
13038,5,2,45285,45285,45287,0,2,4
13039,4,2,45289,45289,45291,0,2,2
13040,5,3,45294,45294,45297,0,3,3
13041,1,3,45295,45297,45300,2,5,0
13042,4,3,45299,45300,45303,1,4,0
13043,3,3,45302,45303,45306,1,4,0
13044,5,3,45307,45307,45310,0,3,1
13045,3,3,45310,45310,45313,0,3,0
13046,3,3,45313,45313,45316,0,3,0
13047,1,3,45314,45316,45319,2,5,0
13048,2,1,45316,45319,45320,3,4,0
13049,1,3,45317,45320,45323,3,6,0
13050,6,2,45323,45323,45325,0,2,0
13051,1,3,45324,45325,45328,1,4,0
13052,3,2,45327,45328,45330,1,3,0
13053,2,1,45329,45330,45331,1,2,0
13054,4,1,45333,45333,45334,0,1,2
13055,3,1,45336,45336,45337,0,1,2
13056,6,1,45342,45342,45343,0,1,5
13057,2,3,45344,45344,45347,0,3,1
13058,1,2,45345,45347,45349,2,4,0
13059,3,3,45348,45349,45352,1,4,0
13060,2,1,45350,45352,45353,2,3,0
13061,6,3,45356,45356,45359,0,3,3
13062,1,2,45357,45359,45361,2,4,0
13063,5,3,45362,45362,45365,0,3,1
13064,5,2,45367,45367,45369,0,2,2
13065,6,2,45373,45373,45375,0,2,4
13066,3,2,45376,45376,45378,0,2,1
13067,3,1,45379,45379,45380,0,1,1
13068,4,1,45383,45383,45384,0,1,3
13069,4,1,45387,45387,45388,0,1,3
13070,6,3,45393,45393,45396,0,3,5
13071,5,1,45398,45398,45399,0,1,2
13072,4,3,45402,45402,45405,0,3,3
13073,1,1,45403,45405,45406,2,3,0
13074,2,3,45405,45406,45409,1,4,0
13075,4,1,45409,45409,45410,0,1,0
13076,4,2,45413,45413,45415,0,2,3
13077,3,1,45416,45416,45417,0,1,1
13078,1,2,45417,45417,45419,0,2,0
13079,4,1,45421,45421,45422,0,1,2
13080,3,3,45424,45424,45427,0,3,2
13081,6,2,45430,45430,45432,0,2,3
13082,5,3,45435,45435,45438,0,3,3
13083,2,1,45437,45438,45439,1,2,0
13084,4,1,45441,45441,45442,0,1,2
13085,1,3,45442,45442,45445,0,3,0
13086,4,3,45446,45446,45449,0,3,1
13087,5,1,45451,45451,45452,0,1,2
13088,2,3,45453,45453,45456,0,3,1
13089,1,3,45454,45456,45459,2,5,0
13090,3,3,45457,45459,45462,2,5,0
13091,3,3,45460,45462,45465,2,5,0
13092,4,1,45464,45465,45466,1,2,0
13093,5,2,45469,45469,45471,0,2,3
13094,6,1,45475,45475,45476,0,1,4
13095,5,3,45480,45480,45483,0,3,4
13096,2,1,45482,45483,45484,1,2,0
13097,2,1,45484,45484,45485,0,1,0
13098,2,2,45486,45486,45488,0,2,1
13099,4,1,45490,45490,45491,0,1,2
13100,1,1,45491,45491,45492,0,1,0
13101,4,3,45495,45495,45498,0,3,3
13102,1,1,45496,45498,45499,2,3,0
13103,4,3,45500,45500,45503,0,3,1
13104,4,2,45504,45504,45506,0,2,1
13105,6,3,45510,45510,45513,0,3,4
13106,6,1,45516,45516,45517,0,1,3
13107,5,1,45521,45521,45522,0,1,4
13108,2,2,45523,45523,45525,0,2,1
13109,1,1,45524,45525,45526,1,2,0
13110,1,3,45525,45526,45529,1,4,0
13111,2,2,45527,45529,45531,2,4,0
13112,5,2,45532,45532,45534,0,2,1
13113,1,1,45533,45534,45535,1,2,0
13114,4,3,45537,45537,45540,0,3,2
13115,6,1,45543,45543,45544,0,1,3
13116,5,3,45548,45548,45551,0,3,4
13117,4,1,45552,45552,45553,0,1,1
13118,2,3,45554,45554,45557,0,3,1
13119,3,1,45557,45557,45558,0,1,0
13120,6,1,45563,45563,45564,0,1,5
13121,2,1,45565,45565,45566,0,1,1
13122,4,2,45569,45569,45571,0,2,3
13123,2,2,45571,45571,45573,0,2,0
13124,2,3,45573,45573,45576,0,3,0
13125,1,1,45574,45576,45577,2,3,0
13126,6,2,45580,45580,45582,0,2,3
13127,5,2,45585,45585,45587,0,2,3
13128,1,2,45586,45587,45589,1,3,0
13129,5,1,45591,45591,45592,0,1,2
13130,4,3,45595,45595,45598,0,3,3
13131,5,3,45600,45600,45603,0,3,2
13132,4,3,45604,45604,45607,0,3,1
13133,2,1,45606,45607,45608,1,2,0
13134,3,2,45609,45609,45611,0,2,1
13135,2,1,45611,45611,45612,0,1,0
13136,6,2,45617,45617,45619,0,2,5
13137,1,1,45618,45619,45620,1,2,0
13138,6,3,45624,45624,45627,0,3,4
13139,4,1,45628,45628,45629,0,1,1
13140,3,1,45631,45631,45632,0,1,2
13141,2,1,45633,45633,45634,0,1,1
13142,5,2,45638,45638,45640,0,2,4
13143,1,1,45639,45640,45641,1,2,0
13144,6,2,45645,45645,45647,0,2,4
13145,2,1,45647,45647,45648,0,1,0
13146,2,2,45649,45649,45651,0,2,1
13147,1,2,45650,45651,45653,1,3,0
13148,2,3,45652,45653,45656,1,4,0
13149,1,2,45653,45656,45658,3,5,0
13150,2,3,45655,45658,45661,3,6,0
13151,6,2,45661,45661,45663,0,2,0
13152,6,1,45667,45667,45668,0,1,4
13153,6,1,45673,45673,45674,0,1,5
13154,5,2,45678,45678,45680,0,2,4
13155,2,3,45680,45680,45683,0,3,0
13156,6,2,45686,45686,45688,0,2,3
13157,6,1,45692,45692,45693,0,1,4
13158,3,3,45695,45695,45698,0,3,2
13159,6,2,45701,45701,45703,0,2,3
13160,5,3,45706,45706,45709,0,3,3
13161,4,2,45710,45710,45712,0,2,1
13162,1,3,45711,45712,45715,1,4,0
13163,3,2,45714,45715,45717,1,3,0
13164,5,3,45719,45719,45722,0,3,2
13165,2,3,45721,45722,45725,1,4,0
13166,2,2,45723,45725,45727,2,4,0
13167,2,3,45725,45727,45730,2,5,0
13168,3,3,45728,45730,45733,2,5,0
13169,4,1,45732,45733,45734,1,2,0
13170,3,2,45735,45735,45737,0,2,1
13171,3,3,45738,45738,45741,0,3,1
13172,2,1,45740,45741,45742,1,2,0
13173,6,3,45746,45746,45749,0,3,4
13174,5,2,45751,45751,45753,0,2,2
13175,6,3,45757,45757,45760,0,3,4
13176,5,2,45762,45762,45764,0,2,2
13177,2,2,45764,45764,45766,0,2,0
13178,1,2,45765,45766,45768,1,3,0
13179,3,1,45768,45768,45769,0,1,0
13180,4,2,45772,45772,45774,0,2,3
13181,6,3,45778,45778,45781,0,3,4
13182,2,3,45780,45781,45784,1,4,0
13183,5,3,45785,45785,45788,0,3,1
13184,6,2,45791,45791,45793,0,2,3
13185,2,1,45793,45793,45794,0,1,0
13186,2,1,45795,45795,45796,0,1,1
13187,2,1,45797,45797,45798,0,1,1
13188,3,3,45800,45800,45803,0,3,2
13189,2,3,45802,45803,45806,1,4,0
13190,5,2,45807,45807,45809,0,2,1
13191,5,2,45812,45812,45814,0,2,3
13192,3,3,45815,45815,45818,0,3,1
13193,5,1,45820,45820,45821,0,1,2
13194,1,3,45821,45821,45824,0,3,0
13195,1,2,45822,45824,45826,2,4,0
13196,1,3,45823,45826,45829,3,6,0
13197,4,3,45827,45829,45832,2,5,0
13198,3,2,45830,45832,45834,2,4,0
13199,3,2,45833,45834,45836,1,3,0
13200,2,3,45835,45836,45839,1,4,0
13201,1,3,45836,45839,45842,3,6,0
13202,3,2,45839,45842,45844,3,5,0
13203,3,3,45842,45844,45847,2,5,0
13204,4,2,45846,45847,45849,1,3,0
13205,6,3,45852,45852,45855,0,3,3
13206,2,3,45854,45855,45858,1,4,0
13207,2,3,45856,45858,45861,2,5,0
13208,3,1,45859,45861,45862,2,3,0
13209,5,1,45864,45864,45865,0,1,2
13210,4,1,45868,45868,45869,0,1,3
13211,5,1,45873,45873,45874,0,1,4
13212,4,1,45877,45877,45878,0,1,3
13213,3,3,45880,45880,45883,0,3,2
13214,2,2,45882,45883,45885,1,3,0
13215,4,3,45886,45886,45889,0,3,1
13216,3,1,45889,45889,45890,0,1,0
13217,3,3,45892,45892,45895,0,3,2
13218,4,3,45896,45896,45899,0,3,1
13219,2,1,45898,45899,45900,1,2,0
13220,1,1,45899,45900,45901,1,2,0
13221,5,2,45904,45904,45906,0,2,3
13222,3,1,45907,45907,45908,0,1,1
13223,3,1,45910,45910,45911,0,1,2
13224,2,3,45912,45912,45915,0,3,1
13225,6,2,45918,45918,45920,0,2,3
13226,3,3,45921,45921,45924,0,3,1
13227,5,1,45926,45926,45927,0,1,2
13228,4,3,45930,45930,45933,0,3,3
13229,5,2,45935,45935,45937,0,2,2
13230,5,3,45940,45940,45943,0,3,3
13231,4,1,45944,45944,45945,0,1,1
13232,5,3,45949,45949,45952,0,3,4
13233,1,2,45950,45952,45954,2,4,0
13234,1,1,45951,45954,45955,3,4,0
13235,3,2,45954,45955,45957,1,3,0
13236,2,1,45956,45957,45958,1,2,0
13237,5,3,45961,45961,45964,0,3,3
13238,3,2,45964,45964,45966,0,2,0
13239,4,2,45968,45968,45970,0,2,2
13240,1,1,45969,45970,45971,1,2,0
13241,3,2,45972,45972,45974,0,2,1
13242,1,2,45973,45974,45976,1,3,0
13243,3,2,45976,45976,45978,0,2,0
13244,1,1,45977,45978,45979,1,2,0
13245,5,3,45982,45982,45985,0,3,3
13246,2,2,45984,45985,45987,1,3,0
13247,5,1,45989,45989,45990,0,1,2
13248,4,3,45993,45993,45996,0,3,3
13249,5,1,45998,45998,45999,0,1,2
13250,4,1,46002,46002,46003,0,1,3
13251,2,2,46004,46004,46006,0,2,1
13252,6,2,46010,46010,46012,0,2,4
13253,1,2,46011,46012,46014,1,3,0
13254,6,1,46017,46017,46018,0,1,3
13255,5,2,46022,46022,46024,0,2,4
13256,4,2,46026,46026,46028,0,2,2
13257,5,3,46031,46031,46034,0,3,3
13258,5,2,46036,46036,46038,0,2,2
13259,1,1,46037,46038,46039,1,2,0
13260,5,1,46042,46042,46043,0,1,3
13261,3,3,46045,46045,46048,0,3,2
13262,1,2,46046,46048,46050,2,4,0
13263,6,1,46052,46052,46053,0,1,2
13264,3,2,46055,46055,46057,0,2,2
13265,1,1,46056,46057,46058,1,2,0
13266,1,1,46057,46058,46059,1,2,0
13267,1,2,46058,46059,46061,1,3,0
13268,3,2,46061,46061,46063,0,2,0
13269,5,2,46066,46066,46068,0,2,3
13270,2,3,46068,46068,46071,0,3,0
13271,2,1,46070,46071,46072,1,2,0
13272,6,1,46076,46076,46077,0,1,4
13273,3,2,46079,46079,46081,0,2,2
13274,5,2,46084,46084,46086,0,2,3
13275,2,2,46086,46086,46088,0,2,0
13276,1,1,46087,46088,46089,1,2,0
13277,6,1,46093,46093,46094,0,1,4
13278,4,1,46097,46097,46098,0,1,3
13279,1,1,46098,46098,46099,0,1,0
13280,6,3,46104,46104,46107,0,3,5
13281,1,3,46105,46107,46110,2,5,0
13282,4,2,46109,46110,46112,1,3,0
13283,6,2,46115,46115,46117,0,2,3
13284,6,1,46121,46121,46122,0,1,4
13285,1,3,46122,46122,46125,0,3,0
13286,2,3,46124,46125,46128,1,4,0
13287,5,2,46129,46129,46131,0,2,1
13288,4,1,46133,46133,46134,0,1,2
13289,2,2,46135,46135,46137,0,2,1
13290,4,1,46139,46139,46140,0,1,2
13291,1,2,46140,46140,46142,0,2,0
13292,6,3,46146,46146,46149,0,3,4
13293,1,1,46147,46149,46150,2,3,0
13294,6,2,46153,46153,46155,0,2,3
13295,2,1,46155,46155,46156,0,1,0
13296,5,2,46160,46160,46162,0,2,4
13297,1,1,46161,46162,46163,1,2,0
13298,1,1,46162,46163,46164,1,2,0
13299,1,1,46163,46164,46165,1,2,0
13300,4,1,46167,46167,46168,0,1,2
13301,4,1,46171,46171,46172,0,1,3
13302,4,3,46175,46175,46178,0,3,3
13303,4,2,46179,46179,46181,0,2,1
13304,3,1,46182,46182,46183,0,1,1
13305,4,3,46186,46186,46189,0,3,3
13306,1,1,46187,46189,46190,2,3,0
13307,4,3,46191,46191,46194,0,3,1
13308,2,2,46193,46194,46196,1,3,0
13309,5,1,46198,46198,46199,0,1,2
13310,3,3,46201,46201,46204,0,3,2
13311,3,2,46204,46204,46206,0,2,0
13312,5,2,46209,46209,46211,0,2,3
13313,5,1,46214,46214,46215,0,1,3
13314,2,2,46216,46216,46218,0,2,1
13315,2,1,46218,46218,46219,0,1,0
13316,3,1,46221,46221,46222,0,1,2
13317,4,2,46225,46225,46227,0,2,3
13318,5,3,46230,46230,46233,0,3,3
13319,6,3,46236,46236,46239,0,3,3
13320,2,2,46238,46239,46241,1,3,0
13321,1,2,46239,46241,46243,2,4,0
13322,3,2,46242,46243,46245,1,3,0
13323,4,2,46246,46246,46248,0,2,1
13324,1,3,46247,46248,46251,1,4,0
13325,4,3,46251,46251,46254,0,3,0
13326,3,2,46254,46254,46256,0,2,0
13327,3,1,46257,46257,46258,0,1,1
13328,5,2,46262,46262,46264,0,2,4
13329,2,3,46264,46264,46267,0,3,0
13330,5,3,46269,46269,46272,0,3,2
13331,5,2,46274,46274,46276,0,2,2
13332,4,1,46278,46278,46279,0,1,2
13333,1,1,46279,46279,46280,0,1,0
13334,1,1,46280,46280,46281,0,1,0
13335,5,3,46285,46285,46288,0,3,4
13336,4,3,46289,46289,46292,0,3,1
13337,3,3,46292,46292,46295,0,3,0
13338,4,1,46296,46296,46297,0,1,1
13339,4,1,46300,46300,46301,0,1,3
13340,5,1,46305,46305,46306,0,1,4
13341,5,1,46310,46310,46311,0,1,4
13342,4,1,46314,46314,46315,0,1,3
13343,1,2,46315,46315,46317,0,2,0
13344,5,3,46320,46320,46323,0,3,3
13345,6,3,46326,46326,46329,0,3,3
13346,1,2,46327,46329,46331,2,4,0
13347,3,2,46330,46331,46333,1,3,0
13348,1,1,46331,46333,46334,2,3,0
13349,2,1,46333,46334,46335,1,2,0
13350,3,2,46336,46336,46338,0,2,1
13351,6,1,46342,46342,46343,0,1,4
13352,4,3,46346,46346,46349,0,3,3
13353,1,1,46347,46349,46350,2,3,0
13354,1,2,46348,46350,46352,2,4,0
13355,6,3,46354,46354,46357,0,3,2
13356,2,3,46356,46357,46360,1,4,0
13357,6,2,46362,46362,46364,0,2,2
13358,6,1,46368,46368,46369,0,1,4
13359,3,2,46371,46371,46373,0,2,2
13360,5,3,46376,46376,46379,0,3,3
13361,4,2,46380,46380,46382,0,2,1
13362,2,1,46382,46382,46383,0,1,0
13363,5,3,46387,46387,46390,0,3,4
13364,2,3,46389,46390,46393,1,4,0
13365,6,2,46395,46395,46397,0,2,2
13366,1,2,46396,46397,46399,1,3,0
13367,3,1,46399,46399,46400,0,1,0
13368,3,1,46402,46402,46403,0,1,2
13369,4,3,46406,46406,46409,0,3,3
13370,4,1,46410,46410,46411,0,1,1
13371,2,1,46412,46412,46413,0,1,1
13372,1,1,46413,46413,46414,0,1,0
13373,1,3,46414,46414,46417,0,3,0
13374,3,1,46417,46417,46418,0,1,0
13375,6,3,46423,46423,46426,0,3,5
13376,2,2,46425,46426,46428,1,3,0
13377,2,1,46427,46428,46429,1,2,0
13378,2,3,46429,46429,46432,0,3,0
13379,6,2,46435,46435,46437,0,2,3
13380,3,3,46438,46438,46441,0,3,1
13381,1,2,46439,46441,46443,2,4,0
13382,5,2,46444,46444,46446,0,2,1
13383,2,2,46446,46446,46448,0,2,0
13384,4,2,46450,46450,46452,0,2,2
13385,4,2,46454,46454,46456,0,2,2
13386,1,3,46455,46456,46459,1,4,0
13387,6,3,46461,46461,46464,0,3,2
13388,6,3,46467,46467,46470,0,3,3
13389,5,3,46472,46472,46475,0,3,2
13390,5,2,46477,46477,46479,0,2,2
13391,3,3,46480,46480,46483,0,3,1
13392,4,2,46484,46484,46486,0,2,1
13393,5,2,46489,46489,46491,0,2,3
13394,6,3,46495,46495,46498,0,3,4
13395,3,1,46498,46498,46499,0,1,0
13396,5,3,46503,46503,46506,0,3,4
13397,5,1,46508,46508,46509,0,1,2
13398,4,3,46512,46512,46515,0,3,3
13399,5,2,46517,46517,46519,0,2,2
13400,3,1,46520,46520,46521,0,1,1
13401,1,2,46521,46521,46523,0,2,0
13402,3,2,46524,46524,46526,0,2,1
13403,2,2,46526,46526,46528,0,2,0
13404,6,1,46532,46532,46533,0,1,4
13405,2,3,46534,46534,46537,0,3,1
13406,1,1,46535,46537,46538,2,3,0
13407,5,2,46540,46540,46542,0,2,2
13408,5,1,46545,46545,46546,0,1,3
13409,4,2,46549,46549,46551,0,2,3
13410,6,2,46555,46555,46557,0,2,4
13411,5,2,46560,46560,46562,0,2,3
13412,1,2,46561,46562,46564,1,3,0
13413,2,1,46563,46564,46565,1,2,0
13414,3,2,46566,46566,46568,0,2,1
13415,6,3,46572,46572,46575,0,3,4
13416,5,1,46577,46577,46578,0,1,2
13417,4,1,46581,46581,46582,0,1,3
13418,5,3,46586,46586,46589,0,3,4
13419,1,2,46587,46589,46591,2,4,0
13420,5,2,46592,46592,46594,0,2,1
13421,6,2,46598,46598,46600,0,2,4
13422,1,3,46599,46600,46603,1,4,0
13423,2,1,46601,46603,46604,2,3,0
13424,6,1,46607,46607,46608,0,1,3
13425,5,3,46612,46612,46615,0,3,4
13426,4,2,46616,46616,46618,0,2,1
13427,6,3,46622,46622,46625,0,3,4
13428,5,1,46627,46627,46628,0,1,2
13429,4,2,46631,46631,46633,0,2,3
13430,6,3,46637,46637,46640,0,3,4
13431,6,2,46643,46643,46645,0,2,3
13432,6,1,46649,46649,46650,0,1,4
13433,1,3,46650,46650,46653,0,3,0
13434,4,3,46654,46654,46657,0,3,1
13435,6,2,46660,46660,46662,0,2,3
13436,2,2,46662,46662,46664,0,2,0
13437,3,3,46665,46665,46668,0,3,1
13438,2,1,46667,46668,46669,1,2,0
13439,2,3,46669,46669,46672,0,3,0
13440,6,2,46675,46675,46677,0,2,3
13441,4,3,46679,46679,46682,0,3,2
13442,3,1,46682,46682,46683,0,1,0
13443,6,2,46688,46688,46690,0,2,5
13444,4,2,46692,46692,46694,0,2,2
13445,5,3,46697,46697,46700,0,3,3
13446,3,3,46700,46700,46703,0,3,0
13447,5,2,46705,46705,46707,0,2,2
13448,5,3,46710,46710,46713,0,3,3
13449,5,2,46715,46715,46717,0,2,2
13450,5,3,46720,46720,46723,0,3,3
13451,1,1,46721,46723,46724,2,3,0
13452,1,1,46722,46724,46725,2,3,0
13453,5,2,46727,46727,46729,0,2,2
13454,1,1,46728,46729,46730,1,2,0
13455,5,1,46733,46733,46734,0,1,3
13456,3,2,46736,46736,46738,0,2,2
13457,2,2,46738,46738,46740,0,2,0
13458,4,1,46742,46742,46743,0,1,2
13459,2,2,46744,46744,46746,0,2,1
13460,1,3,46745,46746,46749,1,4,0
13461,2,2,46747,46749,46751,2,4,0
13462,4,2,46751,46751,46753,0,2,0
13463,4,3,46755,46755,46758,0,3,2
13464,6,1,46761,46761,46762,0,1,3
13465,6,3,46767,46767,46770,0,3,5
13466,6,1,46773,46773,46774,0,1,3
13467,2,1,46775,46775,46776,0,1,1
13468,1,2,46776,46776,46778,0,2,0
13469,5,3,46781,46781,46784,0,3,3
13470,1,1,46782,46784,46785,2,3,0
13471,1,2,46783,46785,46787,2,4,0
13472,1,3,46784,46787,46790,3,6,0
13473,3,3,46787,46790,46793,3,6,0
13474,2,1,46789,46793,46794,4,5,0
13475,1,1,46790,46794,46795,4,5,0
13476,1,3,46791,46795,46798,4,7,0
13477,4,3,46795,46798,46801,3,6,0
13478,1,1,46796,46801,46802,5,6,0
13479,5,2,46801,46802,46804,1,3,0
13480,6,1,46807,46807,46808,0,1,3
13481,6,2,46813,46813,46815,0,2,5
13482,3,1,46816,46816,46817,0,1,1
13483,2,3,46818,46818,46821,0,3,1
13484,2,1,46820,46821,46822,1,2,0
13485,4,3,46824,46824,46827,0,3,2
13486,2,3,46826,46827,46830,1,4,0
13487,4,1,46830,46830,46831,0,1,0
13488,5,2,46835,46835,46837,0,2,4
13489,4,1,46839,46839,46840,0,1,2
13490,5,1,46844,46844,46845,0,1,4
13491,4,3,46848,46848,46851,0,3,3
13492,6,2,46854,46854,46856,0,2,3
13493,2,2,46856,46856,46858,0,2,0
13494,1,3,46857,46858,46861,1,4,0
13495,3,1,46860,46861,46862,1,2,0
13496,1,3,46861,46862,46865,1,4,0
13497,3,1,46864,46865,46866,1,2,0
13498,1,1,46865,46866,46867,1,2,0
13499,4,1,46869,46869,46870,0,1,2
13500,6,3,46875,46875,46878,0,3,5
13501,5,3,46880,46880,46883,0,3,2
13502,4,3,46884,46884,46887,0,3,1
13503,6,2,46890,46890,46892,0,2,3
13504,6,3,46896,46896,46899,0,3,4
13505,4,3,46900,46900,46903,0,3,1
13506,4,1,46904,46904,46905,0,1,1
13507,6,3,46910,46910,46913,0,3,5
13508,5,2,46915,46915,46917,0,2,2
13509,3,2,46918,46918,46920,0,2,1
13510,5,1,46923,46923,46924,0,1,3
13511,5,1,46928,46928,46929,0,1,4
13512,5,1,46933,46933,46934,0,1,4
13513,2,3,46935,46935,46938,0,3,1
13514,5,3,46940,46940,46943,0,3,2
13515,6,1,46946,46946,46947,0,1,3
13516,5,1,46951,46951,46952,0,1,4
13517,4,3,46955,46955,46958,0,3,3
13518,2,1,46957,46958,46959,1,2,0
13519,2,3,46959,46959,46962,0,3,0
13520,5,1,46964,46964,46965,0,1,2
13521,1,3,46965,46965,46968,0,3,0
13522,3,2,46968,46968,46970,0,2,0
13523,1,1,46969,46970,46971,1,2,0
13524,4,3,46973,46973,46976,0,3,2
13525,4,3,46977,46977,46980,0,3,1
13526,1,2,46978,46980,46982,2,4,0
13527,1,2,46979,46982,46984,3,5,0
13528,4,3,46983,46984,46987,1,4,0
13529,2,3,46985,46987,46990,2,5,0
13530,5,2,46990,46990,46992,0,2,0
13531,1,2,46991,46992,46994,1,3,0
13532,6,1,46997,46997,46998,0,1,3
13533,6,1,47003,47003,47004,0,1,5
13534,1,1,47004,47004,47005,0,1,0
13535,1,3,47005,47005,47008,0,3,0
13536,4,2,47009,47009,47011,0,2,1
13537,6,3,47015,47015,47018,0,3,4
13538,4,1,47019,47019,47020,0,1,1
13539,2,2,47021,47021,47023,0,2,1
13540,4,2,47025,47025,47027,0,2,2
13541,5,3,47030,47030,47033,0,3,3
13542,4,3,47034,47034,47037,0,3,1
13543,6,3,47040,47040,47043,0,3,3
13544,6,3,47046,47046,47049,0,3,3
13545,1,1,47047,47049,47050,2,3,0
13546,2,1,47049,47050,47051,1,2,0
13547,4,2,47053,47053,47055,0,2,2
13548,4,2,47057,47057,47059,0,2,2
13549,2,2,47059,47059,47061,0,2,0
13550,3,1,47062,47062,47063,0,1,1
13551,1,2,47063,47063,47065,0,2,0
13552,6,2,47069,47069,47071,0,2,4
13553,5,2,47074,47074,47076,0,2,3
13554,3,2,47077,47077,47079,0,2,1
13555,4,1,47081,47081,47082,0,1,2
13556,3,3,47084,47084,47087,0,3,2
13557,2,3,47086,47087,47090,1,4,0
13558,5,2,47091,47091,47093,0,2,1
13559,3,3,47094,47094,47097,0,3,1
13560,4,1,47098,47098,47099,0,1,1
13561,1,2,47099,47099,47101,0,2,0
13562,3,2,47102,47102,47104,0,2,1
13563,3,3,47105,47105,47108,0,3,1
13564,4,2,47109,47109,47111,0,2,1
13565,3,2,47112,47112,47114,0,2,1
13566,3,3,47115,47115,47118,0,3,1
13567,5,3,47120,47120,47123,0,3,2
13568,6,3,47126,47126,47129,0,3,3
13569,2,1,47128,47129,47130,1,2,0
13570,1,2,47129,47130,47132,1,3,0
13571,1,3,47130,47132,47135,2,5,0
13572,3,3,47133,47135,47138,2,5,0
13573,5,1,47138,47138,47139,0,1,0
13574,6,2,47144,47144,47146,0,2,5
13575,2,1,47146,47146,47147,0,1,0
13576,5,1,47151,47151,47152,0,1,4
13577,2,2,47153,47153,47155,0,2,1
13578,4,2,47157,47157,47159,0,2,2
13579,2,1,47159,47159,47160,0,1,0
13580,1,3,47160,47160,47163,0,3,0
13581,5,3,47165,47165,47168,0,3,2
13582,5,3,47170,47170,47173,0,3,2
13583,3,3,47173,47173,47176,0,3,0
13584,6,3,47179,47179,47182,0,3,3
13585,6,2,47185,47185,47187,0,2,3
13586,5,1,47190,47190,47191,0,1,3
13587,6,1,47196,47196,47197,0,1,5
13588,5,3,47201,47201,47204,0,3,4
13589,1,3,47202,47204,47207,2,5,0
13590,1,1,47203,47207,47208,4,5,0
13591,6,2,47209,47209,47211,0,2,1
13592,5,3,47214,47214,47217,0,3,3
13593,5,2,47219,47219,47221,0,2,2
13594,5,3,47224,47224,47227,0,3,3
13595,4,2,47228,47228,47230,0,2,1
13596,1,1,47229,47230,47231,1,2,0
13597,4,3,47233,47233,47236,0,3,2
13598,2,2,47235,47236,47238,1,3,0
13599,5,2,47240,47240,47242,0,2,2
13600,1,3,47241,47242,47245,1,4,0
13601,5,2,47246,47246,47248,0,2,1
13602,5,1,47251,47251,47252,0,1,3
13603,5,1,47256,47256,47257,0,1,4
13604,3,3,47259,47259,47262,0,3,2
13605,3,1,47262,47262,47263,0,1,0
13606,4,1,47266,47266,47267,0,1,3
13607,5,1,47271,47271,47272,0,1,4
13608,3,2,47274,47274,47276,0,2,2
13609,3,2,47277,47277,47279,0,2,1
13610,5,2,47282,47282,47284,0,2,3
13611,2,3,47284,47284,47287,0,3,0
13612,4,3,47288,47288,47291,0,3,1
13613,3,3,47291,47291,47294,0,3,0
13614,2,2,47293,47294,47296,1,3,0
13615,4,2,47297,47297,47299,0,2,1
13616,3,2,47300,47300,47302,0,2,1
13617,2,2,47302,47302,47304,0,2,0
13618,4,1,47306,47306,47307,0,1,2
13619,1,3,47307,47307,47310,0,3,0
13620,5,2,47312,47312,47314,0,2,2
13621,3,1,47315,47315,47316,0,1,1
13622,3,1,47318,47318,47319,0,1,2
13623,1,3,47319,47319,47322,0,3,0
13624,5,2,47324,47324,47326,0,2,2
13625,6,3,47330,47330,47333,0,3,4
13626,5,1,47335,47335,47336,0,1,2
13627,4,2,47339,47339,47341,0,2,3
13628,3,2,47342,47342,47344,0,2,1
13629,4,1,47346,47346,47347,0,1,2
13630,1,2,47347,47347,47349,0,2,0
13631,2,1,47349,47349,47350,0,1,0
13632,1,1,47350,47350,47351,0,1,0
13633,5,2,47355,47355,47357,0,2,4
13634,1,1,47356,47357,47358,1,2,0
13635,2,3,47358,47358,47361,0,3,0
13636,4,2,47362,47362,47364,0,2,1
13637,3,1,47365,47365,47366,0,1,1
13638,5,2,47370,47370,47372,0,2,4
13639,2,2,47372,47372,47374,0,2,0
13640,1,3,47373,47374,47377,1,4,0
13641,5,1,47378,47378,47379,0,1,1
13642,4,3,47382,47382,47385,0,3,3
13643,4,2,47386,47386,47388,0,2,1
13644,6,1,47392,47392,47393,0,1,4
13645,4,3,47396,47396,47399,0,3,3
13646,3,2,47399,47399,47401,0,2,0
13647,3,1,47402,47402,47403,0,1,1
13648,6,3,47408,47408,47411,0,3,5
13649,1,3,47409,47411,47414,2,5,0
13650,6,2,47415,47415,47417,0,2,1
13651,4,2,47419,47419,47421,0,2,2
13652,2,3,47421,47421,47424,0,3,0
13653,1,1,47422,47424,47425,2,3,0
13654,1,3,47423,47425,47428,2,5,0
13655,2,2,47425,47428,47430,3,5,0
13656,3,1,47428,47430,47431,2,3,0
13657,3,1,47431,47431,47432,0,1,0
13658,4,1,47435,47435,47436,0,1,3
13659,1,3,47436,47436,47439,0,3,0
13660,3,2,47439,47439,47441,0,2,0
13661,1,1,47440,47441,47442,1,2,0
13662,5,1,47445,47445,47446,0,1,3
13663,3,1,47448,47448,47449,0,1,2
13664,2,2,47450,47450,47452,0,2,1
13665,3,1,47453,47453,47454,0,1,1
13666,1,1,47454,47454,47455,0,1,0
13667,6,3,47460,47460,47463,0,3,5
13668,3,1,47463,47463,47464,0,1,0
13669,5,2,47468,47468,47470,0,2,4
13670,3,2,47471,47471,47473,0,2,1
13671,3,3,47474,47474,47477,0,3,1
13672,5,2,47479,47479,47481,0,2,2
13673,2,1,47481,47481,47482,0,1,0
13674,1,1,47482,47482,47483,0,1,0
13675,6,2,47488,47488,47490,0,2,5
13676,2,3,47490,47490,47493,0,3,0
13677,1,1,47491,47493,47494,2,3,0
13678,4,1,47495,47495,47496,0,1,1
13679,2,2,47497,47497,47499,0,2,1
13680,1,2,47498,47499,47501,1,3,0
13681,5,1,47503,47503,47504,0,1,2
13682,6,2,47509,47509,47511,0,2,5
13683,2,1,47511,47511,47512,0,1,0
13684,3,1,47514,47514,47515,0,1,2
13685,4,2,47518,47518,47520,0,2,3
13686,3,2,47521,47521,47523,0,2,1
13687,1,1,47522,47523,47524,1,2,0
13688,6,3,47528,47528,47531,0,3,4
13689,2,2,47530,47531,47533,1,3,0
13690,4,3,47534,47534,47537,0,3,1
13691,5,3,47539,47539,47542,0,3,2
13692,3,2,47542,47542,47544,0,2,0
13693,4,2,47546,47546,47548,0,2,2
13694,6,1,47552,47552,47553,0,1,4
13695,3,2,47555,47555,47557,0,2,2
13696,4,1,47559,47559,47560,0,1,2
13697,6,2,47565,47565,47567,0,2,5
13698,1,1,47566,47567,47568,1,2,0
13699,4,2,47570,47570,47572,0,2,2
13700,5,3,47575,47575,47578,0,3,3
13701,3,1,47578,47578,47579,0,1,0
13702,3,3,47581,47581,47584,0,3,2
13703,3,1,47584,47584,47585,0,1,0
13704,2,1,47586,47586,47587,0,1,1
13705,1,2,47587,47587,47589,0,2,0
13706,5,2,47592,47592,47594,0,2,3
13707,2,1,47594,47594,47595,0,1,0
13708,6,2,47600,47600,47602,0,2,5
13709,4,1,47604,47604,47605,0,1,2
13710,5,3,47609,47609,47612,0,3,4
13711,2,1,47611,47612,47613,1,2,0
13712,6,3,47617,47617,47620,0,3,4
13713,5,2,47622,47622,47624,0,2,2
13714,5,2,47627,47627,47629,0,2,3
13715,4,3,47631,47631,47634,0,3,2
13716,5,1,47636,47636,47637,0,1,2
13717,2,2,47638,47638,47640,0,2,1
13718,1,2,47639,47640,47642,1,3,0
13719,5,3,47644,47644,47647,0,3,2
13720,2,3,47646,47647,47650,1,4,0
13721,6,1,47652,47652,47653,0,1,2
13722,6,3,47658,47658,47661,0,3,5
13723,6,3,47664,47664,47667,0,3,3
13724,1,2,47665,47667,47669,2,4,0
13725,6,1,47671,47671,47672,0,1,2
13726,4,3,47675,47675,47678,0,3,3
13727,6,1,47681,47681,47682,0,1,3
13728,2,1,47683,47683,47684,0,1,1
13729,4,1,47687,47687,47688,0,1,3
13730,3,3,47690,47690,47693,0,3,2
13731,6,2,47696,47696,47698,0,2,3
13732,5,2,47701,47701,47703,0,2,3
13733,4,3,47705,47705,47708,0,3,2
13734,2,1,47707,47708,47709,1,2,0
13735,4,1,47711,47711,47712,0,1,2
13736,6,3,47717,47717,47720,0,3,5
13737,1,3,47718,47720,47723,2,5,0
13738,1,1,47719,47723,47724,4,5,0
13739,4,3,47723,47724,47727,1,4,0
13740,5,2,47728,47728,47730,0,2,1
13741,5,3,47733,47733,47736,0,3,3
13742,3,3,47736,47736,47739,0,3,0
13743,4,1,47740,47740,47741,0,1,1
13744,3,1,47743,47743,47744,0,1,2
13745,4,3,47747,47747,47750,0,3,3
13746,3,3,47750,47750,47753,0,3,0
13747,1,1,47751,47753,47754,2,3,0
13748,2,2,47753,47754,47756,1,3,0
13749,4,2,47757,47757,47759,0,2,1
13750,3,2,47760,47760,47762,0,2,1
13751,4,3,47764,47764,47767,0,3,2
13752,2,3,47766,47767,47770,1,4,0
13753,2,1,47768,47770,47771,2,3,0
13754,6,3,47774,47774,47777,0,3,3
13755,1,2,47775,47777,47779,2,4,0
13756,6,2,47781,47781,47783,0,2,2
13757,4,3,47785,47785,47788,0,3,2
13758,2,2,47787,47788,47790,1,3,0
13759,4,1,47791,47791,47792,0,1,1
13760,6,1,47797,47797,47798,0,1,5
13761,5,3,47802,47802,47805,0,3,4
13762,4,3,47806,47806,47809,0,3,1
13763,3,3,47809,47809,47812,0,3,0
13764,6,1,47815,47815,47816,0,1,3
13765,4,2,47819,47819,47821,0,2,3
13766,2,1,47821,47821,47822,0,1,0
13767,6,2,47827,47827,47829,0,2,5
13768,3,1,47830,47830,47831,0,1,1
13769,1,1,47831,47831,47832,0,1,0
13770,5,2,47836,47836,47838,0,2,4
13771,6,2,47842,47842,47844,0,2,4
13772,6,1,47848,47848,47849,0,1,4
13773,5,2,47853,47853,47855,0,2,4
13774,1,2,47854,47855,47857,1,3,0
13775,2,2,47856,47857,47859,1,3,0
13776,1,3,47857,47859,47862,2,5,0
13777,2,2,47859,47862,47864,3,5,0
13778,5,3,47864,47864,47867,0,3,0
13779,5,2,47869,47869,47871,0,2,2
13780,4,1,47873,47873,47874,0,1,2
13781,3,2,47876,47876,47878,0,2,2
13782,4,3,47880,47880,47883,0,3,2
13783,5,1,47885,47885,47886,0,1,2
13784,6,2,47891,47891,47893,0,2,5
13785,4,2,47895,47895,47897,0,2,2
13786,4,1,47899,47899,47900,0,1,2
13787,2,2,47901,47901,47903,0,2,1
13788,1,1,47902,47903,47904,1,2,0
13789,3,3,47905,47905,47908,0,3,1
13790,6,1,47911,47911,47912,0,1,3
13791,5,1,47916,47916,47917,0,1,4
13792,2,3,47918,47918,47921,0,3,1
13793,6,2,47924,47924,47926,0,2,3
13794,1,2,47925,47926,47928,1,3,0
13795,5,3,47930,47930,47933,0,3,2
13796,6,1,47936,47936,47937,0,1,3
13797,6,2,47942,47942,47944,0,2,5
13798,5,3,47947,47947,47950,0,3,3
13799,5,3,47952,47952,47955,0,3,2
13800,4,3,47956,47956,47959,0,3,1
13801,1,1,47957,47959,47960,2,3,0
13802,3,1,47960,47960,47961,0,1,0
13803,4,3,47964,47964,47967,0,3,3
13804,3,3,47967,47967,47970,0,3,0
13805,3,2,47970,47970,47972,0,2,0
13806,5,1,47975,47975,47976,0,1,3
13807,2,1,47977,47977,47978,0,1,1
13808,1,1,47978,47978,47979,0,1,0
13809,2,3,47980,47980,47983,0,3,1
13810,3,1,47983,47983,47984,0,1,0
13811,6,1,47989,47989,47990,0,1,5
13812,6,2,47995,47995,47997,0,2,5
13813,5,3,48000,48000,48003,0,3,3
13814,1,1,48001,48003,48004,2,3,0
13815,2,2,48003,48004,48006,1,3,0
13816,1,2,48004,48006,48008,2,4,0
13817,6,3,48010,48010,48013,0,3,2
13818,2,3,48012,48013,48016,1,4,0
13819,3,3,48015,48016,48019,1,4,0
13820,4,1,48019,48019,48020,0,1,0
13821,4,2,48023,48023,48025,0,2,3
13822,4,1,48027,48027,48028,0,1,2
13823,5,2,48032,48032,48034,0,2,4
13824,4,1,48036,48036,48037,0,1,2
13825,6,1,48042,48042,48043,0,1,5
13826,5,2,48047,48047,48049,0,2,4
13827,1,2,48048,48049,48051,1,3,0
13828,3,1,48051,48051,48052,0,1,0
13829,1,2,48052,48052,48054,0,2,0
13830,4,1,48056,48056,48057,0,1,2
13831,6,1,48062,48062,48063,0,1,5
13832,3,2,48065,48065,48067,0,2,2
13833,3,3,48068,48068,48071,0,3,1
13834,2,3,48070,48071,48074,1,4,0
13835,4,3,48074,48074,48077,0,3,0
13836,3,2,48077,48077,48079,0,2,0
13837,5,1,48082,48082,48083,0,1,3
13838,6,3,48088,48088,48091,0,3,5
13839,4,1,48092,48092,48093,0,1,1
13840,3,1,48095,48095,48096,0,1,2
13841,4,3,48099,48099,48102,0,3,3
13842,3,3,48102,48102,48105,0,3,0
13843,5,1,48107,48107,48108,0,1,2
13844,1,2,48108,48108,48110,0,2,0
13845,5,2,48113,48113,48115,0,2,3
13846,5,3,48118,48118,48121,0,3,3
13847,3,3,48121,48121,48124,0,3,0
13848,2,1,48123,48124,48125,1,2,0
13849,5,3,48128,48128,48131,0,3,3
13850,3,1,48131,48131,48132,0,1,0
13851,4,1,48135,48135,48136,0,1,3
13852,1,2,48136,48136,48138,0,2,0
13853,3,1,48139,48139,48140,0,1,1
13854,1,2,48140,48140,48142,0,2,0
13855,3,1,48143,48143,48144,0,1,1
13856,3,1,48146,48146,48147,0,1,2
13857,5,3,48151,48151,48154,0,3,4
13858,5,1,48156,48156,48157,0,1,2
13859,6,3,48162,48162,48165,0,3,5
13860,1,2,48163,48165,48167,2,4,0
13861,1,3,48164,48167,48170,3,6,0
13862,1,3,48165,48170,48173,5,8,0
13863,3,2,48168,48173,48175,5,7,0
13864,5,2,48173,48175,48177,2,4,0
13865,2,1,48175,48177,48178,2,3,0
13866,2,2,48177,48178,48180,1,3,0
13867,5,2,48182,48182,48184,0,2,2
13868,6,1,48188,48188,48189,0,1,4
13869,6,2,48194,48194,48196,0,2,5
13870,5,3,48199,48199,48202,0,3,3
13871,2,2,48201,48202,48204,1,3,0
13872,5,3,48206,48206,48209,0,3,2
13873,2,2,48208,48209,48211,1,3,0
13874,1,2,48209,48211,48213,2,4,0
13875,4,3,48213,48213,48216,0,3,0
13876,4,2,48217,48217,48219,0,2,1
13877,1,1,48218,48219,48220,1,2,0
13878,2,3,48220,48220,48223,0,3,0
13879,2,3,48222,48223,48226,1,4,0
13880,3,2,48225,48226,48228,1,3,0
13881,4,2,48229,48229,48231,0,2,1
13882,5,1,48234,48234,48235,0,1,3
13883,3,2,48237,48237,48239,0,2,2
13884,1,1,48238,48239,48240,1,2,0
13885,1,3,48239,48240,48243,1,4,0
13886,6,2,48245,48245,48247,0,2,2
13887,1,1,48246,48247,48248,1,2,0
13888,1,2,48247,48248,48250,1,3,0
13889,6,2,48253,48253,48255,0,2,3
13890,1,3,48254,48255,48258,1,4,0
13891,1,3,48255,48258,48261,3,6,0
13892,1,2,48256,48261,48263,5,7,0
13893,5,3,48261,48263,48266,2,5,0
13894,1,2,48262,48266,48268,4,6,0
13895,3,1,48265,48268,48269,3,4,0
13896,5,3,48270,48270,48273,0,3,1
13897,3,2,48273,48273,48275,0,2,0
13898,5,3,48278,48278,48281,0,3,3
13899,1,2,48279,48281,48283,2,4,0
13900,3,1,48282,48283,48284,1,2,0
13901,5,2,48287,48287,48289,0,2,3
13902,6,2,48293,48293,48295,0,2,4
13903,1,2,48294,48295,48297,1,3,0
13904,2,1,48296,48297,48298,1,2,0
13905,3,1,48299,48299,48300,0,1,1
13906,4,2,48303,48303,48305,0,2,3
13907,1,3,48304,48305,48308,1,4,0
13908,2,2,48306,48308,48310,2,4,0
13909,2,2,48308,48310,48312,2,4,0
13910,6,2,48314,48314,48316,0,2,2
13911,5,2,48319,48319,48321,0,2,3
13912,1,3,48320,48321,48324,1,4,0
13913,4,2,48324,48324,48326,0,2,0
13914,3,2,48327,48327,48329,0,2,1
13915,1,1,48328,48329,48330,1,2,0
13916,1,3,48329,48330,48333,1,4,0
13917,5,3,48334,48334,48337,0,3,1
13918,1,1,48335,48337,48338,2,3,0
13919,2,1,48337,48338,48339,1,2,0
13920,3,2,48340,48340,48342,0,2,1
13921,6,1,48346,48346,48347,0,1,4
13922,4,2,48350,48350,48352,0,2,3
13923,4,1,48354,48354,48355,0,1,2
13924,2,2,48356,48356,48358,0,2,1
13925,5,2,48361,48361,48363,0,2,3
13926,3,1,48364,48364,48365,0,1,1
13927,4,3,48368,48368,48371,0,3,3
13928,5,2,48373,48373,48375,0,2,2
13929,4,3,48377,48377,48380,0,3,2
13930,2,2,48379,48380,48382,1,3,0
13931,6,3,48385,48385,48388,0,3,3
13932,3,3,48388,48388,48391,0,3,0
13933,3,3,48391,48391,48394,0,3,0
13934,4,2,48395,48395,48397,0,2,1
13935,1,1,48396,48397,48398,1,2,0
13936,2,1,48398,48398,48399,0,1,0
13937,2,2,48400,48400,48402,0,2,1
13938,1,2,48401,48402,48404,1,3,0
13939,6,2,48407,48407,48409,0,2,3
13940,5,2,48412,48412,48414,0,2,3
13941,4,1,48416,48416,48417,0,1,2
13942,4,2,48420,48420,48422,0,2,3
13943,3,1,48423,48423,48424,0,1,1
13944,1,3,48424,48424,48427,0,3,0
13945,3,3,48427,48427,48430,0,3,0
13946,1,1,48428,48430,48431,2,3,0
13947,4,3,48432,48432,48435,0,3,1
13948,1,3,48433,48435,48438,2,5,0
13949,2,1,48435,48438,48439,3,4,0
13950,5,1,48440,48440,48441,0,1,1
13951,6,3,48446,48446,48449,0,3,5
13952,1,2,48447,48449,48451,2,4,0
13953,3,2,48450,48451,48453,1,3,0
13954,2,1,48452,48453,48454,1,2,0
13955,3,3,48455,48455,48458,0,3,1
13956,2,3,48457,48458,48461,1,4,0
13957,2,2,48459,48461,48463,2,4,0
13958,3,2,48462,48463,48465,1,3,0
13959,6,3,48468,48468,48471,0,3,3
13960,2,3,48470,48471,48474,1,4,0
13961,1,2,48471,48474,48476,3,5,0
13962,2,1,48473,48476,48477,3,4,0
13963,1,1,48474,48477,48478,3,4,0
13964,3,3,48477,48478,48481,1,4,0
13965,3,2,48480,48481,48483,1,3,0
13966,4,2,48484,48484,48486,0,2,1
13967,5,3,48489,48489,48492,0,3,3
13968,3,3,48492,48492,48495,0,3,0
13969,6,3,48498,48498,48501,0,3,3
13970,6,1,48504,48504,48505,0,1,3
13971,2,2,48506,48506,48508,0,2,1
13972,6,1,48512,48512,48513,0,1,4
13973,4,2,48516,48516,48518,0,2,3
13974,5,2,48521,48521,48523,0,2,3
13975,1,1,48522,48523,48524,1,2,0
13976,5,3,48527,48527,48530,0,3,3
13977,6,3,48533,48533,48536,0,3,3
13978,2,2,48535,48536,48538,1,3,0
13979,5,2,48540,48540,48542,0,2,2
13980,4,2,48544,48544,48546,0,2,2
13981,1,1,48545,48546,48547,1,2,0
13982,2,2,48547,48547,48549,0,2,0
13983,4,3,48551,48551,48554,0,3,2
13984,3,2,48554,48554,48556,0,2,0
13985,1,2,48555,48556,48558,1,3,0
13986,2,3,48557,48558,48561,1,4,0
13987,3,2,48560,48561,48563,1,3,0
13988,4,3,48564,48564,48567,0,3,1
13989,6,3,48570,48570,48573,0,3,3
13990,5,2,48575,48575,48577,0,2,2
13991,3,3,48578,48578,48581,0,3,1
13992,4,2,48582,48582,48584,0,2,1
13993,2,3,48584,48584,48587,0,3,0
13994,3,3,48587,48587,48590,0,3,0
13995,4,1,48591,48591,48592,0,1,1
13996,5,1,48596,48596,48597,0,1,4
13997,5,3,48601,48601,48604,0,3,4
13998,5,2,48606,48606,48608,0,2,2
13999,3,2,48609,48609,48611,0,2,1
14000,2,2,48611,48611,48613,0,2,0
14001,3,1,48614,48614,48615,0,1,1
14002,3,3,48617,48617,48620,0,3,2
14003,6,1,48623,48623,48624,0,1,3
14004,3,2,48626,48626,48628,0,2,2
14005,4,1,48630,48630,48631,0,1,2
14006,6,2,48636,48636,48638,0,2,5
14007,2,3,48638,48638,48641,0,3,0
14008,6,2,48644,48644,48646,0,2,3
14009,5,2,48649,48649,48651,0,2,3
14010,6,3,48655,48655,48658,0,3,4
14011,6,3,48661,48661,48664,0,3,3
14012,6,3,48667,48667,48670,0,3,3
14013,2,1,48669,48670,48671,1,2,0
14014,4,1,48673,48673,48674,0,1,2
14015,2,3,48675,48675,48678,0,3,1
14016,6,2,48681,48681,48683,0,2,3
14017,3,2,48684,48684,48686,0,2,1
14018,1,1,48685,48686,48687,1,2,0
14019,4,2,48689,48689,48691,0,2,2
14020,3,1,48692,48692,48693,0,1,1
14021,5,3,48697,48697,48700,0,3,4
14022,6,3,48703,48703,48706,0,3,3
14023,4,3,48707,48707,48710,0,3,1
14024,4,1,48711,48711,48712,0,1,1
14025,3,3,48714,48714,48717,0,3,2
14026,4,2,48718,48718,48720,0,2,1
14027,3,2,48721,48721,48723,0,2,1
14028,1,2,48722,48723,48725,1,3,0
14029,6,1,48728,48728,48729,0,1,3
14030,5,2,48733,48733,48735,0,2,4
14031,2,3,48735,48735,48738,0,3,0
14032,6,3,48741,48741,48744,0,3,3
14033,5,1,48746,48746,48747,0,1,2
14034,6,2,48752,48752,48754,0,2,5
14035,2,2,48754,48754,48756,0,2,0
14036,6,3,48760,48760,48763,0,3,4
14037,6,2,48766,48766,48768,0,2,3
14038,5,3,48771,48771,48774,0,3,3
14039,5,3,48776,48776,48779,0,3,2
14040,3,2,48779,48779,48781,0,2,0
14041,1,1,48780,48781,48782,1,2,0
14042,1,2,48781,48782,48784,1,3,0
14043,4,1,48785,48785,48786,0,1,1
14044,1,1,48786,48786,48787,0,1,0
14045,3,3,48789,48789,48792,0,3,2
14046,3,1,48792,48792,48793,0,1,0
14047,3,2,48795,48795,48797,0,2,2
14048,5,1,48800,48800,48801,0,1,3
14049,6,3,48806,48806,48809,0,3,5
14050,1,1,48807,48809,48810,2,3,0
14051,2,1,48809,48810,48811,1,2,0
14052,1,3,48810,48811,48814,1,4,0
14053,5,3,48815,48815,48818,0,3,1
14054,1,3,48816,48818,48821,2,5,0
14055,2,1,48818,48821,48822,3,4,0
14056,4,3,48822,48822,48825,0,3,0
14057,5,2,48827,48827,48829,0,2,2
14058,6,3,48833,48833,48836,0,3,4
14059,4,2,48837,48837,48839,0,2,1
14060,4,2,48841,48841,48843,0,2,2
14061,5,1,48846,48846,48847,0,1,3
14062,1,2,48847,48847,48849,0,2,0
14063,6,3,48853,48853,48856,0,3,4
14064,2,2,48855,48856,48858,1,3,0
14065,2,2,48857,48858,48860,1,3,0
14066,4,3,48861,48861,48864,0,3,1
14067,6,1,48867,48867,48868,0,1,3
14068,3,2,48870,48870,48872,0,2,2
14069,5,3,48875,48875,48878,0,3,3
14070,6,3,48881,48881,48884,0,3,3
14071,4,1,48885,48885,48886,0,1,1
14072,4,3,48889,48889,48892,0,3,3
14073,4,1,48893,48893,48894,0,1,1
14074,4,2,48897,48897,48899,0,2,3
14075,2,2,48899,48899,48901,0,2,0
14076,1,3,48900,48901,48904,1,4,0
14077,6,2,48906,48906,48908,0,2,2
14078,5,2,48911,48911,48913,0,2,3
14079,1,3,48912,48913,48916,1,4,0
14080,6,2,48918,48918,48920,0,2,2
14081,2,2,48920,48920,48922,0,2,0
14082,5,3,48925,48925,48928,0,3,3
14083,2,2,48927,48928,48930,1,3,0
14084,6,2,48933,48933,48935,0,2,3
14085,3,2,48936,48936,48938,0,2,1
14086,4,3,48940,48940,48943,0,3,2
14087,2,3,48942,48943,48946,1,4,0
14088,4,2,48946,48946,48948,0,2,0
14089,1,3,48947,48948,48951,1,4,0
14090,4,2,48951,48951,48953,0,2,0
14091,4,3,48955,48955,48958,0,3,2
14092,6,1,48961,48961,48962,0,1,3
14093,5,2,48966,48966,48968,0,2,4
14094,3,3,48969,48969,48972,0,3,1
14095,1,3,48970,48972,48975,2,5,0
14096,4,3,48974,48975,48978,1,4,0
14097,6,1,48980,48980,48981,0,1,2
14098,1,2,48981,48981,48983,0,2,0
14099,3,3,48984,48984,48987,0,3,1
14100,5,1,48989,48989,48990,0,1,2
14101,4,3,48993,48993,48996,0,3,3
14102,1,3,48994,48996,48999,2,5,0
14103,4,1,48998,48999,49000,1,2,0
14104,4,1,49002,49002,49003,0,1,2
14105,1,2,49003,49003,49005,0,2,0
14106,6,2,49009,49009,49011,0,2,4
14107,5,3,49014,49014,49017,0,3,3
14108,5,3,49019,49019,49022,0,3,2
14109,2,3,49021,49022,49025,1,4,0
14110,5,1,49026,49026,49027,0,1,1
14111,6,3,49032,49032,49035,0,3,5
14112,1,3,49033,49035,49038,2,5,0
14113,4,1,49037,49038,49039,1,2,0
14114,5,3,49042,49042,49045,0,3,3
14115,4,3,49046,49046,49049,0,3,1
14116,2,1,49048,49049,49050,1,2,0
14117,2,2,49050,49050,49052,0,2,0
14118,4,1,49054,49054,49055,0,1,2
14119,6,3,49060,49060,49063,0,3,5
14120,4,3,49064,49064,49067,0,3,1
14121,3,3,49067,49067,49070,0,3,0
14122,6,1,49073,49073,49074,0,1,3
14123,5,1,49078,49078,49079,0,1,4
14124,4,3,49082,49082,49085,0,3,3
14125,2,2,49084,49085,49087,1,3,0
14126,2,2,49086,49087,49089,1,3,0
14127,1,2,49087,49089,49091,2,4,0
14128,4,1,49091,49091,49092,0,1,0
14129,3,1,49094,49094,49095,0,1,2
14130,1,3,49095,49095,49098,0,3,0
14131,1,1,49096,49098,49099,2,3,0
14132,2,3,49098,49099,49102,1,4,0
14133,6,3,49104,49104,49107,0,3,2
14134,5,1,49109,49109,49110,0,1,2
14135,2,1,49111,49111,49112,0,1,1
14136,6,3,49117,49117,49120,0,3,5
14137,2,1,49119,49120,49121,1,2,0
14138,3,3,49122,49122,49125,0,3,1
14139,5,3,49127,49127,49130,0,3,2
14140,4,3,49131,49131,49134,0,3,1
14141,5,1,49136,49136,49137,0,1,2
14142,1,2,49137,49137,49139,0,2,0
14143,5,1,49142,49142,49143,0,1,3
14144,3,3,49145,49145,49148,0,3,2
14145,4,2,49149,49149,49151,0,2,1
14146,5,3,49154,49154,49157,0,3,3
14147,4,2,49158,49158,49160,0,2,1
14148,3,1,49161,49161,49162,0,1,1
14149,3,1,49164,49164,49165,0,1,2
14150,2,1,49166,49166,49167,0,1,1
14151,5,1,49171,49171,49172,0,1,4
14152,6,1,49177,49177,49178,0,1,5
14153,1,3,49178,49178,49181,0,3,0
14154,4,2,49182,49182,49184,0,2,1
14155,5,1,49187,49187,49188,0,1,3
14156,4,3,49191,49191,49194,0,3,3
14157,2,3,49193,49194,49197,1,4,0
14158,2,1,49195,49197,49198,2,3,0
14159,1,3,49196,49198,49201,2,5,0
14160,3,2,49199,49201,49203,2,4,0
14161,2,2,49201,49203,49205,2,4,0
14162,1,2,49202,49205,49207,3,5,0
14163,1,3,49203,49207,49210,4,7,0
14164,1,2,49204,49210,49212,6,8,0
14165,5,2,49209,49212,49214,3,5,0
14166,1,2,49210,49214,49216,4,6,0
14167,6,2,49216,49216,49218,0,2,0
14168,3,3,49219,49219,49222,0,3,1
14169,4,3,49223,49223,49226,0,3,1
14170,1,1,49224,49226,49227,2,3,0
14171,1,1,49225,49227,49228,2,3,0
14172,1,3,49226,49228,49231,2,5,0
14173,4,3,49230,49231,49234,1,4,0
14174,3,3,49233,49234,49237,1,4,0
14175,3,3,49236,49237,49240,1,4,0
14176,3,2,49239,49240,49242,1,3,0
14177,5,1,49244,49244,49245,0,1,2
14178,2,2,49246,49246,49248,0,2,1
14179,3,2,49249,49249,49251,0,2,1
14180,1,2,49250,49251,49253,1,3,0
14181,5,3,49255,49255,49258,0,3,2
14182,6,3,49261,49261,49264,0,3,3
14183,4,2,49265,49265,49267,0,2,1
14184,3,1,49268,49268,49269,0,1,1
14185,2,3,49270,49270,49273,0,3,1
14186,1,1,49271,49273,49274,2,3,0
14187,1,1,49272,49274,49275,2,3,0
14188,3,3,49275,49275,49278,0,3,0
14189,4,2,49279,49279,49281,0,2,1
14190,2,2,49281,49281,49283,0,2,0
14191,1,3,49282,49283,49286,1,4,0
14192,2,1,49284,49286,49287,2,3,0
14193,2,2,49286,49287,49289,1,3,0
14194,3,3,49289,49289,49292,0,3,0
14195,4,2,49293,49293,49295,0,2,1
14196,2,1,49295,49295,49296,0,1,0
14197,3,3,49298,49298,49301,0,3,2
14198,3,2,49301,49301,49303,0,2,0
14199,3,3,49304,49304,49307,0,3,1
14200,5,1,49309,49309,49310,0,1,2
14201,4,3,49313,49313,49316,0,3,3
14202,4,2,49317,49317,49319,0,2,1
14203,5,3,49322,49322,49325,0,3,3
14204,5,3,49327,49327,49330,0,3,2
14205,1,2,49328,49330,49332,2,4,0
14206,4,1,49332,49332,49333,0,1,0
14207,6,1,49338,49338,49339,0,1,5
14208,5,2,49343,49343,49345,0,2,4
14209,5,2,49348,49348,49350,0,2,3
14210,1,3,49349,49350,49353,1,4,0
14211,5,2,49354,49354,49356,0,2,1
14212,3,1,49357,49357,49358,0,1,1
14213,4,2,49361,49361,49363,0,2,3
14214,4,2,49365,49365,49367,0,2,2
14215,5,1,49370,49370,49371,0,1,3
14216,4,1,49374,49374,49375,0,1,3
14217,1,3,49375,49375,49378,0,3,0
14218,1,2,49376,49378,49380,2,4,0
14219,6,1,49382,49382,49383,0,1,2
14220,4,1,49386,49386,49387,0,1,3
14221,6,3,49392,49392,49395,0,3,5
14222,4,3,49396,49396,49399,0,3,1
14223,2,1,49398,49399,49400,1,2,0
14224,6,1,49404,49404,49405,0,1,4
14225,2,1,49406,49406,49407,0,1,1
14226,1,3,49407,49407,49410,0,3,0
14227,6,1,49413,49413,49414,0,1,3
14228,4,1,49417,49417,49418,0,1,3
14229,4,1,49421,49421,49422,0,1,3
14230,1,3,49422,49422,49425,0,3,0
14231,2,2,49424,49425,49427,1,3,0
14232,1,3,49425,49427,49430,2,5,0
14233,6,2,49431,49431,49433,0,2,1
14234,3,1,49434,49434,49435,0,1,1
14235,5,3,49439,49439,49442,0,3,4
14236,1,3,49440,49442,49445,2,5,0
14237,2,3,49442,49445,49448,3,6,0
14238,6,1,49448,49448,49449,0,1,0
14239,1,1,49449,49449,49450,0,1,0
14240,3,1,49452,49452,49453,0,1,2
14241,4,3,49456,49456,49459,0,3,3
14242,5,3,49461,49461,49464,0,3,2
14243,4,3,49465,49465,49468,0,3,1
14244,2,2,49467,49468,49470,1,3,0
14245,5,3,49472,49472,49475,0,3,2
14246,5,3,49477,49477,49480,0,3,2
14247,6,1,49483,49483,49484,0,1,3
14248,3,2,49486,49486,49488,0,2,2
14249,2,1,49488,49488,49489,0,1,0
14250,6,1,49494,49494,49495,0,1,5
14251,5,1,49499,49499,49500,0,1,4
14252,4,1,49503,49503,49504,0,1,3
14253,2,2,49505,49505,49507,0,2,1
14254,2,1,49507,49507,49508,0,1,0
14255,2,3,49509,49509,49512,0,3,1
14256,3,1,49512,49512,49513,0,1,0
14257,5,1,49517,49517,49518,0,1,4
14258,6,1,49523,49523,49524,0,1,5
14259,2,2,49525,49525,49527,0,2,1
14260,4,3,49529,49529,49532,0,3,2
14261,1,3,49530,49532,49535,2,5,0
14262,3,3,49533,49535,49538,2,5,0
14263,3,2,49536,49538,49540,2,4,0
14264,3,1,49539,49540,49541,1,2,0
14265,2,3,49541,49541,49544,0,3,0
14266,3,1,49544,49544,49545,0,1,0
14267,2,1,49546,49546,49547,0,1,1
14268,5,2,49551,49551,49553,0,2,4
14269,5,3,49556,49556,49559,0,3,3
14270,2,3,49558,49559,49562,1,4,0
14271,1,3,49559,49562,49565,3,6,0
14272,6,2,49565,49565,49567,0,2,0
14273,2,3,49567,49567,49570,0,3,0
14274,1,3,49568,49570,49573,2,5,0
14275,3,2,49571,49573,49575,2,4,0
14276,5,3,49576,49576,49579,0,3,1
14277,3,3,49579,49579,49582,0,3,0
14278,2,1,49581,49582,49583,1,2,0
14279,3,1,49584,49584,49585,0,1,1
14280,2,2,49586,49586,49588,0,2,1
14281,3,1,49589,49589,49590,0,1,1
14282,2,1,49591,49591,49592,0,1,1
14283,4,2,49595,49595,49597,0,2,3
14284,1,1,49596,49597,49598,1,2,0
14285,4,3,49600,49600,49603,0,3,2
14286,3,1,49603,49603,49604,0,1,0
14287,3,1,49606,49606,49607,0,1,2
14288,3,3,49609,49609,49612,0,3,2
14289,5,1,49614,49614,49615,0,1,2
14290,3,1,49617,49617,49618,0,1,2
14291,5,2,49622,49622,49624,0,2,4
14292,4,2,49626,49626,49628,0,2,2
14293,5,1,49631,49631,49632,0,1,3
14294,2,2,49633,49633,49635,0,2,1
14295,6,1,49639,49639,49640,0,1,4
14296,4,1,49643,49643,49644,0,1,3
14297,4,3,49647,49647,49650,0,3,3
14298,6,3,49653,49653,49656,0,3,3
14299,1,3,49654,49656,49659,2,5,0
14300,4,2,49658,49659,49661,1,3,0
14301,6,3,49664,49664,49667,0,3,3
14302,2,2,49666,49667,49669,1,3,0
14303,2,1,49668,49669,49670,1,2,0
14304,4,3,49672,49672,49675,0,3,2
14305,2,3,49674,49675,49678,1,4,0
14306,6,3,49680,49680,49683,0,3,2
14307,5,2,49685,49685,49687,0,2,2
14308,5,1,49690,49690,49691,0,1,3
14309,6,1,49696,49696,49697,0,1,5
14310,1,1,49697,49697,49698,0,1,0
14311,3,1,49700,49700,49701,0,1,2
14312,6,2,49706,49706,49708,0,2,5
14313,2,3,49708,49708,49711,0,3,0
14314,2,1,49710,49711,49712,1,2,0
14315,6,2,49716,49716,49718,0,2,4
14316,2,2,49718,49718,49720,0,2,0
14317,2,3,49720,49720,49723,0,3,0
14318,2,1,49722,49723,49724,1,2,0
14319,3,2,49725,49725,49727,0,2,1
14320,1,3,49726,49727,49730,1,4,0
14321,6,1,49732,49732,49733,0,1,2
14322,2,2,49734,49734,49736,0,2,1
14323,1,1,49735,49736,49737,1,2,0
14324,2,1,49737,49737,49738,0,1,0
14325,5,1,49742,49742,49743,0,1,4
14326,6,2,49748,49748,49750,0,2,5
14327,6,3,49754,49754,49757,0,3,4
14328,5,2,49759,49759,49761,0,2,2
14329,3,3,49762,49762,49765,0,3,1
14330,4,3,49766,49766,49769,0,3,1
14331,1,3,49767,49769,49772,2,5,0
14332,4,3,49771,49772,49775,1,4,0
14333,4,2,49775,49775,49777,0,2,0
14334,4,1,49779,49779,49780,0,1,2
14335,1,2,49780,49780,49782,0,2,0
14336,3,1,49783,49783,49784,0,1,1
14337,6,3,49789,49789,49792,0,3,5
14338,5,2,49794,49794,49796,0,2,2
14339,2,2,49796,49796,49798,0,2,0
14340,2,1,49798,49798,49799,0,1,0
14341,1,2,49799,49799,49801,0,2,0
14342,3,1,49802,49802,49803,0,1,1
14343,2,3,49804,49804,49807,0,3,1
14344,5,3,49809,49809,49812,0,3,2
14345,6,1,49815,49815,49816,0,1,3
14346,2,2,49817,49817,49819,0,2,1
14347,1,2,49818,49819,49821,1,3,0
14348,2,1,49820,49821,49822,1,2,0
14349,3,2,49823,49823,49825,0,2,1
14350,6,3,49829,49829,49832,0,3,4
14351,5,3,49834,49834,49837,0,3,2
14352,3,1,49837,49837,49838,0,1,0
14353,5,1,49842,49842,49843,0,1,4
14354,5,3,49847,49847,49850,0,3,4
14355,1,2,49848,49850,49852,2,4,0
14356,5,3,49853,49853,49856,0,3,1
14357,4,2,49857,49857,49859,0,2,1
14358,5,3,49862,49862,49865,0,3,3
14359,5,2,49867,49867,49869,0,2,2
14360,3,3,49870,49870,49873,0,3,1
14361,6,2,49876,49876,49878,0,2,3
14362,4,3,49880,49880,49883,0,3,2
14363,4,3,49884,49884,49887,0,3,1
14364,5,3,49889,49889,49892,0,3,2
14365,6,3,49895,49895,49898,0,3,3
14366,5,2,49900,49900,49902,0,2,2
14367,1,1,49901,49902,49903,1,2,0
14368,2,2,49903,49903,49905,0,2,0
14369,2,1,49905,49905,49906,0,1,0
14370,5,2,49910,49910,49912,0,2,4
14371,5,1,49915,49915,49916,0,1,3
14372,4,3,49919,49919,49922,0,3,3
14373,5,3,49924,49924,49927,0,3,2
14374,4,3,49928,49928,49931,0,3,1
14375,3,2,49931,49931,49933,0,2,0
14376,4,3,49935,49935,49938,0,3,2
14377,2,3,49937,49938,49941,1,4,0
14378,4,3,49941,49941,49944,0,3,0
14379,4,3,49945,49945,49948,0,3,1
14380,1,2,49946,49948,49950,2,4,0
14381,3,3,49949,49950,49953,1,4,0
14382,2,2,49951,49953,49955,2,4,0
14383,3,3,49954,49955,49958,1,4,0
14384,6,3,49960,49960,49963,0,3,2
14385,6,3,49966,49966,49969,0,3,3
14386,5,3,49971,49971,49974,0,3,2
14387,4,3,49975,49975,49978,0,3,1
14388,3,1,49978,49978,49979,0,1,0
14389,6,3,49984,49984,49987,0,3,5
14390,1,1,49985,49987,49988,2,3,0
14391,4,2,49989,49989,49991,0,2,1
14392,1,1,49990,49991,49992,1,2,0
14393,6,1,49996,49996,49997,0,1,4
14394,1,1,49997,49997,49998,0,1,0
14395,4,3,50001,50001,50004,0,3,3
14396,4,3,50005,50005,50008,0,3,1
14397,1,3,50006,50008,50011,2,5,0
14398,6,2,50012,50012,50014,0,2,1
14399,3,1,50015,50015,50016,0,1,1
14400,6,3,50021,50021,50024,0,3,5
14401,5,1,50026,50026,50027,0,1,2
14402,3,2,50029,50029,50031,0,2,2
14403,6,3,50035,50035,50038,0,3,4
14404,4,3,50039,50039,50042,0,3,1
14405,4,3,50043,50043,50046,0,3,1
14406,3,3,50046,50046,50049,0,3,0
14407,3,1,50049,50049,50050,0,1,0
14408,3,3,50052,50052,50055,0,3,2
14409,2,3,50054,50055,50058,1,4,0
14410,6,1,50060,50060,50061,0,1,2
14411,6,3,50066,50066,50069,0,3,5
14412,6,3,50072,50072,50075,0,3,3
14413,5,1,50077,50077,50078,0,1,2
14414,3,2,50080,50080,50082,0,2,2
14415,4,3,50084,50084,50087,0,3,2
14416,4,1,50088,50088,50089,0,1,1
14417,1,1,50089,50089,50090,0,1,0
14418,5,1,50094,50094,50095,0,1,4
14419,4,1,50098,50098,50099,0,1,3
14420,6,3,50104,50104,50107,0,3,5
14421,4,2,50108,50108,50110,0,2,1
14422,5,1,50113,50113,50114,0,1,3
14423,1,2,50114,50114,50116,0,2,0
14424,5,1,50119,50119,50120,0,1,3
14425,6,2,50125,50125,50127,0,2,5
14426,6,3,50131,50131,50134,0,3,4
14427,1,1,50132,50134,50135,2,3,0
14428,6,3,50138,50138,50141,0,3,3
14429,5,1,50143,50143,50144,0,1,2
14430,6,3,50149,50149,50152,0,3,5
14431,3,1,50152,50152,50153,0,1,0
14432,3,2,50155,50155,50157,0,2,2
14433,3,3,50158,50158,50161,0,3,1
14434,5,1,50163,50163,50164,0,1,2
14435,6,1,50169,50169,50170,0,1,5
14436,6,2,50175,50175,50177,0,2,5
14437,2,2,50177,50177,50179,0,2,0
14438,4,1,50181,50181,50182,0,1,2
14439,6,3,50187,50187,50190,0,3,5
14440,1,2,50188,50190,50192,2,4,0
14441,2,3,50190,50192,50195,2,5,0
14442,5,1,50195,50195,50196,0,1,0
14443,3,2,50198,50198,50200,0,2,2
14444,4,2,50202,50202,50204,0,2,2
14445,5,3,50207,50207,50210,0,3,3
14446,5,1,50212,50212,50213,0,1,2
14447,5,2,50217,50217,50219,0,2,4
14448,3,1,50220,50220,50221,0,1,1
14449,5,3,50225,50225,50228,0,3,4
14450,5,1,50230,50230,50231,0,1,2
14451,3,3,50233,50233,50236,0,3,2
14452,2,2,50235,50236,50238,1,3,0
14453,3,3,50238,50238,50241,0,3,0
14454,2,1,50240,50241,50242,1,2,0
14455,1,1,50241,50242,50243,1,2,0
14456,3,2,50244,50244,50246,0,2,1
14457,4,3,50248,50248,50251,0,3,2
14458,4,1,50252,50252,50253,0,1,1
14459,3,3,50255,50255,50258,0,3,2
14460,1,3,50256,50258,50261,2,5,0
14461,6,2,50262,50262,50264,0,2,1
14462,5,3,50267,50267,50270,0,3,3
14463,6,1,50273,50273,50274,0,1,3
14464,4,1,50277,50277,50278,0,1,3
14465,6,3,50283,50283,50286,0,3,5
14466,1,3,50284,50286,50289,2,5,0
14467,2,1,50286,50289,50290,3,4,0
14468,6,1,50292,50292,50293,0,1,2
14469,1,1,50293,50293,50294,0,1,0
14470,6,2,50299,50299,50301,0,2,5
14471,6,3,50305,50305,50308,0,3,4
14472,5,3,50310,50310,50313,0,3,2
14473,6,1,50316,50316,50317,0,1,3
14474,5,2,50321,50321,50323,0,2,4
14475,3,3,50324,50324,50327,0,3,1
14476,4,1,50328,50328,50329,0,1,1
14477,2,1,50330,50330,50331,0,1,1
14478,4,2,50334,50334,50336,0,2,3
14479,2,2,50336,50336,50338,0,2,0
14480,1,1,50337,50338,50339,1,2,0
14481,3,3,50340,50340,50343,0,3,1
14482,5,3,50345,50345,50348,0,3,2
14483,1,3,50346,50348,50351,2,5,0
14484,3,3,50349,50351,50354,2,5,0
14485,4,2,50353,50354,50356,1,3,0
14486,5,3,50358,50358,50361,0,3,2
14487,2,3,50360,50361,50364,1,4,0
14488,2,2,50362,50364,50366,2,4,0
14489,4,3,50366,50366,50369,0,3,0
14490,2,1,50368,50369,50370,1,2,0
14491,4,3,50372,50372,50375,0,3,2
14492,6,3,50378,50378,50381,0,3,3
14493,5,3,50383,50383,50386,0,3,2
14494,2,3,50385,50386,50389,1,4,0
14495,5,1,50390,50390,50391,0,1,1
14496,2,2,50392,50392,50394,0,2,1
14497,1,1,50393,50394,50395,1,2,0
14498,4,3,50397,50397,50400,0,3,2
14499,6,2,50403,50403,50405,0,2,3
14500,5,1,50408,50408,50409,0,1,3
14501,2,1,50410,50410,50411,0,1,1
14502,5,1,50415,50415,50416,0,1,4
14503,4,2,50419,50419,50421,0,2,3
14504,5,2,50424,50424,50426,0,2,3
14505,6,1,50430,50430,50431,0,1,4
14506,3,2,50433,50433,50435,0,2,2
14507,4,3,50437,50437,50440,0,3,2
14508,6,3,50443,50443,50446,0,3,3
14509,6,3,50449,50449,50452,0,3,3
14510,5,1,50454,50454,50455,0,1,2
14511,1,1,50455,50455,50456,0,1,0
14512,2,3,50457,50457,50460,0,3,1
14513,2,2,50459,50460,50462,1,3,0
14514,3,3,50462,50462,50465,0,3,0
14515,3,3,50465,50465,50468,0,3,0
14516,2,1,50467,50468,50469,1,2,0
14517,2,2,50469,50469,50471,0,2,0
14518,3,1,50472,50472,50473,0,1,1
14519,6,2,50478,50478,50480,0,2,5
14520,1,3,50479,50480,50483,1,4,0
14521,6,3,50485,50485,50488,0,3,2
14522,1,1,50486,50488,50489,2,3,0
14523,5,1,50491,50491,50492,0,1,2
14524,2,1,50493,50493,50494,0,1,1
14525,2,1,50495,50495,50496,0,1,1
14526,3,3,50498,50498,50501,0,3,2
14527,3,1,50501,50501,50502,0,1,0
14528,5,2,50506,50506,50508,0,2,4
14529,2,1,50508,50508,50509,0,1,0
14530,6,3,50514,50514,50517,0,3,5
14531,3,1,50517,50517,50518,0,1,0
14532,3,1,50520,50520,50521,0,1,2
14533,6,2,50526,50526,50528,0,2,5
14534,4,2,50530,50530,50532,0,2,2
14535,5,2,50535,50535,50537,0,2,3
14536,1,3,50536,50537,50540,1,4,0
14537,4,3,50540,50540,50543,0,3,0
14538,6,3,50546,50546,50549,0,3,3
14539,3,2,50549,50549,50551,0,2,0
14540,2,2,50551,50551,50553,0,2,0
14541,6,2,50557,50557,50559,0,2,4
14542,1,2,50558,50559,50561,1,3,0
14543,2,2,50560,50561,50563,1,3,0
14544,3,3,50563,50563,50566,0,3,0
14545,6,2,50569,50569,50571,0,2,3
14546,6,2,50575,50575,50577,0,2,4
14547,4,1,50579,50579,50580,0,1,2
14548,5,2,50584,50584,50586,0,2,4
14549,5,1,50589,50589,50590,0,1,3
14550,1,2,50590,50590,50592,0,2,0
14551,5,2,50595,50595,50597,0,2,3
14552,4,1,50599,50599,50600,0,1,2
14553,4,1,50603,50603,50604,0,1,3
14554,1,2,50604,50604,50606,0,2,0
14555,6,1,50610,50610,50611,0,1,4
14556,1,3,50611,50611,50614,0,3,0
14557,2,1,50613,50614,50615,1,2,0
14558,1,1,50614,50615,50616,1,2,0
14559,4,2,50618,50618,50620,0,2,2
14560,2,2,50620,50620,50622,0,2,0
14561,4,2,50624,50624,50626,0,2,2
14562,2,2,50626,50626,50628,0,2,0
14563,4,2,50630,50630,50632,0,2,2
14564,6,1,50636,50636,50637,0,1,4
14565,5,2,50641,50641,50643,0,2,4
14566,1,1,50642,50643,50644,1,2,0
14567,6,3,50648,50648,50651,0,3,4
14568,1,3,50649,50651,50654,2,5,0
14569,1,1,50650,50654,50655,4,5,0
14570,6,2,50656,50656,50658,0,2,1
14571,3,1,50659,50659,50660,0,1,1
14572,5,2,50664,50664,50666,0,2,4
14573,5,1,50669,50669,50670,0,1,3
14574,2,2,50671,50671,50673,0,2,1
14575,3,2,50674,50674,50676,0,2,1
14576,4,2,50678,50678,50680,0,2,2
14577,1,2,50679,50680,50682,1,3,0
14578,2,3,50681,50682,50685,1,4,0
14579,4,1,50685,50685,50686,0,1,0
14580,4,1,50689,50689,50690,0,1,3
14581,5,2,50694,50694,50696,0,2,4
14582,2,2,50696,50696,50698,0,2,0
14583,6,1,50702,50702,50703,0,1,4
14584,2,3,50704,50704,50707,0,3,1
14585,4,1,50708,50708,50709,0,1,1
14586,6,2,50714,50714,50716,0,2,5
14587,2,2,50716,50716,50718,0,2,0
14588,4,1,50720,50720,50721,0,1,2
14589,3,2,50723,50723,50725,0,2,2
14590,3,1,50726,50726,50727,0,1,1
14591,1,2,50727,50727,50729,0,2,0
14592,3,3,50730,50730,50733,0,3,1
14593,3,2,50733,50733,50735,0,2,0
14594,1,3,50734,50735,50738,1,4,0
14595,4,2,50738,50738,50740,0,2,0
14596,6,1,50744,50744,50745,0,1,4
14597,1,2,50745,50745,50747,0,2,0
14598,5,3,50750,50750,50753,0,3,3
14599,5,1,50755,50755,50756,0,1,2
14600,6,2,50761,50761,50763,0,2,5
14601,4,1,50765,50765,50766,0,1,2
14602,2,3,50767,50767,50770,0,3,1
14603,1,1,50768,50770,50771,2,3,0
14604,5,1,50773,50773,50774,0,1,2
14605,1,2,50774,50774,50776,0,2,0
14606,5,2,50779,50779,50781,0,2,3
14607,1,2,50780,50781,50783,1,3,0
14608,2,3,50782,50783,50786,1,4,0
14609,3,2,50785,50786,50788,1,3,0
14610,5,1,50790,50790,50791,0,1,2
14611,3,1,50793,50793,50794,0,1,2
14612,5,2,50798,50798,50800,0,2,4
14613,5,2,50803,50803,50805,0,2,3
14614,6,1,50809,50809,50810,0,1,4
14615,1,2,50810,50810,50812,0,2,0
14616,1,2,50811,50812,50814,1,3,0
14617,1,1,50812,50814,50815,2,3,0
14618,3,2,50815,50815,50817,0,2,0
14619,5,3,50820,50820,50823,0,3,3
14620,4,2,50824,50824,50826,0,2,1
14621,6,2,50830,50830,50832,0,2,4
14622,5,1,50835,50835,50836,0,1,3
14623,4,2,50839,50839,50841,0,2,3
14624,5,1,50844,50844,50845,0,1,3
14625,6,2,50850,50850,50852,0,2,5
14626,2,3,50852,50852,50855,0,3,0
14627,6,2,50858,50858,50860,0,2,3
14628,2,2,50860,50860,50862,0,2,0
14629,6,3,50866,50866,50869,0,3,4
14630,2,3,50868,50869,50872,1,4,0
14631,4,3,50872,50872,50875,0,3,0
14632,2,2,50874,50875,50877,1,3,0
14633,2,1,50876,50877,50878,1,2,0
14634,1,1,50877,50878,50879,1,2,0
14635,6,3,50883,50883,50886,0,3,4
14636,2,2,50885,50886,50888,1,3,0
14637,3,2,50888,50888,50890,0,2,0
14638,1,2,50889,50890,50892,1,3,0
14639,5,3,50894,50894,50897,0,3,2
14640,3,3,50897,50897,50900,0,3,0
14641,4,1,50901,50901,50902,0,1,1
14642,4,1,50905,50905,50906,0,1,3
14643,1,3,50906,50906,50909,0,3,0
14644,1,3,50907,50909,50912,2,5,0
14645,2,3,50909,50912,50915,3,6,0
14646,3,1,50912,50915,50916,3,4,0
14647,6,2,50918,50918,50920,0,2,2
14648,5,3,50923,50923,50926,0,3,3
14649,6,1,50929,50929,50930,0,1,3
14650,2,1,50931,50931,50932,0,1,1
14651,6,2,50937,50937,50939,0,2,5
14652,6,2,50943,50943,50945,0,2,4
14653,1,2,50944,50945,50947,1,3,0
14654,3,2,50947,50947,50949,0,2,0
14655,3,2,50950,50950,50952,0,2,1
14656,6,1,50956,50956,50957,0,1,4
14657,2,2,50958,50958,50960,0,2,1
14658,6,2,50964,50964,50966,0,2,4
14659,1,2,50965,50966,50968,1,3,0
14660,5,2,50970,50970,50972,0,2,2
14661,1,2,50971,50972,50974,1,3,0
14662,6,1,50977,50977,50978,0,1,3
14663,3,1,50980,50980,50981,0,1,2
14664,6,3,50986,50986,50989,0,3,5
14665,6,3,50992,50992,50995,0,3,3
14666,5,2,50997,50997,50999,0,2,2
14667,3,1,51000,51000,51001,0,1,1
14668,6,1,51006,51006,51007,0,1,5
14669,4,3,51010,51010,51013,0,3,3
14670,5,3,51015,51015,51018,0,3,2
14671,6,3,51021,51021,51024,0,3,3
14672,5,3,51026,51026,51029,0,3,2
14673,6,1,51032,51032,51033,0,1,3
14674,4,3,51036,51036,51039,0,3,3
14675,1,3,51037,51039,51042,2,5,0
14676,1,3,51038,51042,51045,4,7,0
14677,5,2,51043,51045,51047,2,4,0
14678,6,2,51049,51049,51051,0,2,2
14679,6,1,51055,51055,51056,0,1,4
14680,4,3,51059,51059,51062,0,3,3
14681,6,1,51065,51065,51066,0,1,3
14682,1,1,51066,51066,51067,0,1,0
14683,2,2,51068,51068,51070,0,2,1
14684,5,1,51073,51073,51074,0,1,3
14685,5,3,51078,51078,51081,0,3,4
14686,6,2,51084,51084,51086,0,2,3
14687,5,1,51089,51089,51090,0,1,3
14688,6,3,51095,51095,51098,0,3,5
14689,6,1,51101,51101,51102,0,1,3
14690,5,1,51106,51106,51107,0,1,4
14691,3,3,51109,51109,51112,0,3,2
14692,4,1,51113,51113,51114,0,1,1
14693,3,1,51116,51116,51117,0,1,2
14694,2,3,51118,51118,51121,0,3,1
14695,1,3,51119,51121,51124,2,5,0
14696,1,3,51120,51124,51127,4,7,0
14697,4,1,51124,51127,51128,3,4,0
14698,5,3,51129,51129,51132,0,3,1
14699,3,3,51132,51132,51135,0,3,0
14700,1,3,51133,51135,51138,2,5,0
14701,1,3,51134,51138,51141,4,7,0
14702,6,2,51140,51141,51143,1,3,0
14703,1,1,51141,51143,51144,2,3,0
14704,6,3,51147,51147,51150,0,3,3
14705,5,1,51152,51152,51153,0,1,2
14706,5,3,51157,51157,51160,0,3,4
14707,5,1,51162,51162,51163,0,1,2
14708,2,2,51164,51164,51166,0,2,1
14709,2,1,51166,51166,51167,0,1,0
14710,3,3,51169,51169,51172,0,3,2
14711,1,2,51170,51172,51174,2,4,0
14712,5,2,51175,51175,51177,0,2,1
14713,3,2,51178,51178,51180,0,2,1
14714,4,3,51182,51182,51185,0,3,2
14715,4,1,51186,51186,51187,0,1,1
14716,5,2,51191,51191,51193,0,2,4
14717,1,1,51192,51193,51194,1,2,0
14718,1,3,51193,51194,51197,1,4,0
14719,1,1,51194,51197,51198,3,4,0
14720,4,1,51198,51198,51199,0,1,0
14721,5,1,51203,51203,51204,0,1,4
14722,6,3,51209,51209,51212,0,3,5
14723,4,2,51213,51213,51215,0,2,1
14724,2,1,51215,51215,51216,0,1,0
14725,3,2,51218,51218,51220,0,2,2
14726,6,3,51224,51224,51227,0,3,4
14727,3,2,51227,51227,51229,0,2,0
14728,4,3,51231,51231,51234,0,3,2
14729,6,1,51237,51237,51238,0,1,3
14730,5,2,51242,51242,51244,0,2,4
14731,2,3,51244,51244,51247,0,3,0
14732,3,1,51247,51247,51248,0,1,0
14733,2,1,51249,51249,51250,0,1,1
14734,1,3,51250,51250,51253,0,3,0
14735,4,2,51254,51254,51256,0,2,1
14736,4,3,51258,51258,51261,0,3,2
14737,5,3,51263,51263,51266,0,3,2
14738,1,3,51264,51266,51269,2,5,0
14739,2,3,51266,51269,51272,3,6,0
14740,3,3,51269,51272,51275,3,6,0
14741,5,2,51274,51275,51277,1,3,0
14742,1,2,51275,51277,51279,2,4,0
14743,6,1,51281,51281,51282,0,1,2
14744,3,3,51284,51284,51287,0,3,2
14745,4,3,51288,51288,51291,0,3,1
14746,3,2,51291,51291,51293,0,2,0
14747,1,1,51292,51293,51294,1,2,0
14748,4,3,51296,51296,51299,0,3,2
14749,3,3,51299,51299,51302,0,3,0
14750,5,3,51304,51304,51307,0,3,2
14751,3,1,51307,51307,51308,0,1,0
14752,5,2,51312,51312,51314,0,2,4
14753,1,1,51313,51314,51315,1,2,0
14754,2,1,51315,51315,51316,0,1,0
14755,1,3,51316,51316,51319,0,3,0
14756,5,2,51321,51321,51323,0,2,2
14757,5,3,51326,51326,51329,0,3,3
14758,2,2,51328,51329,51331,1,3,0
14759,3,1,51331,51331,51332,0,1,0
14760,1,2,51332,51332,51334,0,2,0
14761,1,3,51333,51334,51337,1,4,0
14762,3,2,51336,51337,51339,1,3,0
14763,5,3,51341,51341,51344,0,3,2
14764,6,2,51347,51347,51349,0,2,3
14765,5,1,51352,51352,51353,0,1,3
14766,6,2,51358,51358,51360,0,2,5
14767,4,3,51362,51362,51365,0,3,2
14768,4,2,51366,51366,51368,0,2,1
14769,4,2,51370,51370,51372,0,2,2
14770,1,1,51371,51372,51373,1,2,0
14771,5,3,51376,51376,51379,0,3,3
14772,4,1,51380,51380,51381,0,1,1
14773,4,3,51384,51384,51387,0,3,3
14774,1,2,51385,51387,51389,2,4,0
14775,6,1,51391,51391,51392,0,1,2
14776,2,2,51393,51393,51395,0,2,1
14777,3,3,51396,51396,51399,0,3,1
14778,2,2,51398,51399,51401,1,3,0
14779,6,2,51404,51404,51406,0,2,3
14780,5,2,51409,51409,51411,0,2,3
14781,1,2,51410,51411,51413,1,3,0
14782,4,2,51414,51414,51416,0,2,1
14783,6,1,51420,51420,51421,0,1,4
14784,4,2,51424,51424,51426,0,2,3
14785,4,1,51428,51428,51429,0,1,2
14786,5,2,51433,51433,51435,0,2,4
14787,3,1,51436,51436,51437,0,1,1
14788,3,1,51439,51439,51440,0,1,2
14789,1,1,51440,51440,51441,0,1,0
14790,2,2,51442,51442,51444,0,2,1
14791,3,2,51445,51445,51447,0,2,1
14792,2,3,51447,51447,51450,0,3,0
14793,5,2,51452,51452,51454,0,2,2
14794,5,3,51457,51457,51460,0,3,3
14795,4,1,51461,51461,51462,0,1,1
14796,6,3,51467,51467,51470,0,3,5
14797,5,1,51472,51472,51473,0,1,2
14798,3,1,51475,51475,51476,0,1,2
14799,1,1,51476,51476,51477,0,1,0
14800,5,2,51481,51481,51483,0,2,4
14801,1,2,51482,51483,51485,1,3,0
14802,2,2,51484,51485,51487,1,3,0
14803,2,1,51486,51487,51488,1,2,0
14804,1,1,51487,51488,51489,1,2,0
14805,3,3,51490,51490,51493,0,3,1
14806,5,3,51495,51495,51498,0,3,2
14807,4,2,51499,51499,51501,0,2,1
14808,2,3,51501,51501,51504,0,3,0
14809,3,2,51504,51504,51506,0,2,0
14810,6,3,51510,51510,51513,0,3,4
14811,4,2,51514,51514,51516,0,2,1
14812,2,1,51516,51516,51517,0,1,0
14813,3,3,51519,51519,51522,0,3,2
14814,3,3,51522,51522,51525,0,3,0
14815,6,1,51528,51528,51529,0,1,3
14816,5,3,51533,51533,51536,0,3,4
14817,4,1,51537,51537,51538,0,1,1
14818,6,2,51543,51543,51545,0,2,5
14819,3,1,51546,51546,51547,0,1,1
14820,5,3,51551,51551,51554,0,3,4
14821,3,2,51554,51554,51556,0,2,0
14822,6,1,51560,51560,51561,0,1,4
14823,6,1,51566,51566,51567,0,1,5
14824,5,3,51571,51571,51574,0,3,4
14825,6,2,51577,51577,51579,0,2,3
14826,1,3,51578,51579,51582,1,4,0
14827,2,2,51580,51582,51584,2,4,0
14828,1,1,51581,51584,51585,3,4,0
14829,1,3,51582,51585,51588,3,6,0
14830,2,2,51584,51588,51590,4,6,0
14831,6,1,51590,51590,51591,0,1,0
14832,3,1,51593,51593,51594,0,1,2
14833,3,3,51596,51596,51599,0,3,2
14834,6,2,51602,51602,51604,0,2,3
14835,6,3,51608,51608,51611,0,3,4
14836,1,1,51609,51611,51612,2,3,0
14837,4,1,51613,51613,51614,0,1,1
14838,4,3,51617,51617,51620,0,3,3
14839,1,2,51618,51620,51622,2,4,0
14840,3,3,51621,51622,51625,1,4,0
14841,3,1,51624,51625,51626,1,2,0
14842,6,3,51630,51630,51633,0,3,4
14843,5,2,51635,51635,51637,0,2,2
14844,4,1,51639,51639,51640,0,1,2
14845,1,3,51640,51640,51643,0,3,0
14846,5,1,51645,51645,51646,0,1,2
14847,1,2,51646,51646,51648,0,2,0
14848,5,2,51651,51651,51653,0,2,3
14849,6,2,51657,51657,51659,0,2,4
14850,1,3,51658,51659,51662,1,4,0
14851,1,3,51659,51662,51665,3,6,0
14852,3,3,51662,51665,51668,3,6,0
14853,5,2,51667,51668,51670,1,3,0
14854,6,3,51673,51673,51676,0,3,3
14855,3,2,51676,51676,51678,0,2,0
14856,3,1,51679,51679,51680,0,1,1
14857,6,1,51685,51685,51686,0,1,5
14858,2,1,51687,51687,51688,0,1,1
14859,5,3,51692,51692,51695,0,3,4
14860,2,3,51694,51695,51698,1,4,0
14861,2,3,51696,51698,51701,2,5,0
14862,5,3,51701,51701,51704,0,3,0
14863,2,1,51703,51704,51705,1,2,0
14864,4,3,51707,51707,51710,0,3,2
14865,1,1,51708,51710,51711,2,3,0
14866,3,3,51711,51711,51714,0,3,0
14867,1,2,51712,51714,51716,2,4,0
14868,2,2,51714,51716,51718,2,4,0
14869,4,3,51718,51718,51721,0,3,0
14870,5,3,51723,51723,51726,0,3,2
14871,5,2,51728,51728,51730,0,2,2
14872,3,3,51731,51731,51734,0,3,1
14873,6,2,51737,51737,51739,0,2,3
14874,2,3,51739,51739,51742,0,3,0
14875,1,1,51740,51742,51743,2,3,0
14876,5,1,51745,51745,51746,0,1,2
14877,3,1,51748,51748,51749,0,1,2
14878,5,3,51753,51753,51756,0,3,4
14879,4,2,51757,51757,51759,0,2,1
14880,4,2,51761,51761,51763,0,2,2
14881,1,3,51762,51763,51766,1,4,0
14882,2,2,51764,51766,51768,2,4,0
14883,4,1,51768,51768,51769,0,1,0
14884,2,2,51770,51770,51772,0,2,1
14885,1,3,51771,51772,51775,1,4,0
14886,4,1,51775,51775,51776,0,1,0
14887,5,2,51780,51780,51782,0,2,4
14888,2,1,51782,51782,51783,0,1,0
14889,4,2,51786,51786,51788,0,2,3
14890,5,3,51791,51791,51794,0,3,3
14891,5,3,51796,51796,51799,0,3,2
14892,3,3,51799,51799,51802,0,3,0
14893,5,2,51804,51804,51806,0,2,2
14894,6,1,51810,51810,51811,0,1,4
14895,5,1,51815,51815,51816,0,1,4
14896,3,3,51818,51818,51821,0,3,2
14897,5,3,51823,51823,51826,0,3,2
14898,3,1,51826,51826,51827,0,1,0
14899,5,2,51831,51831,51833,0,2,4
14900,1,3,51832,51833,51836,1,4,0
14901,5,1,51837,51837,51838,0,1,1
14902,5,3,51842,51842,51845,0,3,4
14903,3,2,51845,51845,51847,0,2,0
14904,5,2,51850,51850,51852,0,2,3
14905,2,2,51852,51852,51854,0,2,0
14906,2,1,51854,51854,51855,0,1,0
14907,3,2,51857,51857,51859,0,2,2
14908,4,1,51861,51861,51862,0,1,2
14909,6,2,51867,51867,51869,0,2,5
14910,2,3,51869,51869,51872,0,3,0
14911,6,3,51875,51875,51878,0,3,3
14912,4,3,51879,51879,51882,0,3,1
14913,3,1,51882,51882,51883,0,1,0
14914,5,2,51887,51887,51889,0,2,4
14915,4,1,51891,51891,51892,0,1,2
14916,4,2,51895,51895,51897,0,2,3
14917,5,1,51900,51900,51901,0,1,3
14918,3,1,51903,51903,51904,0,1,2
14919,6,2,51909,51909,51911,0,2,5
14920,4,3,51913,51913,51916,0,3,2
14921,6,3,51919,51919,51922,0,3,3
14922,6,1,51925,51925,51926,0,1,3
14923,6,3,51931,51931,51934,0,3,5
14924,5,3,51936,51936,51939,0,3,2
14925,6,3,51942,51942,51945,0,3,3
14926,3,1,51945,51945,51946,0,1,0
14927,5,1,51950,51950,51951,0,1,4
14928,2,2,51952,51952,51954,0,2,1
14929,6,2,51958,51958,51960,0,2,4
14930,3,2,51961,51961,51963,0,2,1
14931,4,1,51965,51965,51966,0,1,2
14932,2,2,51967,51967,51969,0,2,1
14933,4,1,51971,51971,51972,0,1,2
14934,2,2,51973,51973,51975,0,2,1
14935,4,2,51977,51977,51979,0,2,2
14936,5,2,51982,51982,51984,0,2,3
14937,5,3,51987,51987,51990,0,3,3
14938,6,2,51993,51993,51995,0,2,3
14939,3,3,51996,51996,51999,0,3,1
14940,5,3,52001,52001,52004,0,3,2
14941,1,1,52002,52004,52005,2,3,0
14942,1,2,52003,52005,52007,2,4,0
14943,5,3,52008,52008,52011,0,3,1
14944,4,2,52012,52012,52014,0,2,1
14945,5,3,52017,52017,52020,0,3,3
14946,4,1,52021,52021,52022,0,1,1
14947,3,2,52024,52024,52026,0,2,2
14948,3,2,52027,52027,52029,0,2,1
14949,4,2,52031,52031,52033,0,2,2
14950,1,1,52032,52033,52034,1,2,0
14951,6,2,52038,52038,52040,0,2,4
14952,6,2,52044,52044,52046,0,2,4
14953,4,1,52048,52048,52049,0,1,2
14954,1,2,52049,52049,52051,0,2,0
14955,2,2,52051,52051,52053,0,2,0
14956,5,3,52056,52056,52059,0,3,3
14957,5,2,52061,52061,52063,0,2,2
14958,2,2,52063,52063,52065,0,2,0
14959,1,1,52064,52065,52066,1,2,0
14960,1,2,52065,52066,52068,1,3,0
14961,5,1,52070,52070,52071,0,1,2
14962,6,1,52076,52076,52077,0,1,5
14963,6,1,52082,52082,52083,0,1,5
14964,2,1,52084,52084,52085,0,1,1
14965,1,3,52085,52085,52088,0,3,0
14966,6,3,52091,52091,52094,0,3,3
14967,2,3,52093,52094,52097,1,4,0
14968,4,1,52097,52097,52098,0,1,0
14969,4,3,52101,52101,52104,0,3,3
14970,1,3,52102,52104,52107,2,5,0
14971,2,1,52104,52107,52108,3,4,0
14972,5,1,52109,52109,52110,0,1,1
14973,2,2,52111,52111,52113,0,2,1
14974,1,3,52112,52113,52116,1,4,0
14975,6,3,52118,52118,52121,0,3,2
14976,4,1,52122,52122,52123,0,1,1
14977,3,2,52125,52125,52127,0,2,2
14978,1,2,52126,52127,52129,1,3,0
14979,1,3,52127,52129,52132,2,5,0
14980,3,1,52130,52132,52133,2,3,0
14981,4,2,52134,52134,52136,0,2,1
14982,2,3,52136,52136,52139,0,3,0
14983,5,2,52141,52141,52143,0,2,2
14984,1,1,52142,52143,52144,1,2,0
14985,2,1,52144,52144,52145,0,1,0
14986,6,1,52150,52150,52151,0,1,5
14987,3,1,52153,52153,52154,0,1,2
14988,1,2,52154,52154,52156,0,2,0
14989,6,2,52160,52160,52162,0,2,4
14990,5,1,52165,52165,52166,0,1,3
14991,4,2,52169,52169,52171,0,2,3
14992,4,2,52173,52173,52175,0,2,2
14993,1,2,52174,52175,52177,1,3,0
14994,2,2,52176,52177,52179,1,3,0
14995,3,2,52179,52179,52181,0,2,0
14996,2,2,52181,52181,52183,0,2,0
14997,6,3,52187,52187,52190,0,3,4
14998,2,2,52189,52190,52192,1,3,0
14999,1,2,52190,52192,52194,2,4,0
15000,1,2,52191,52194,52196,3,5,0
15001,1,1,52192,52196,52197,4,5,0
15002,3,1,52195,52197,52198,2,3,0
15003,6,1,52201,52201,52202,0,1,3
15004,6,2,52207,52207,52209,0,2,5
15005,6,1,52213,52213,52214,0,1,4
15006,4,1,52217,52217,52218,0,1,3
15007,6,1,52223,52223,52224,0,1,5
15008,6,3,52229,52229,52232,0,3,5
15009,1,3,52230,52232,52235,2,5,0
15010,5,1,52235,52235,52236,0,1,0
15011,3,2,52238,52238,52240,0,2,2
15012,5,2,52243,52243,52245,0,2,3
15013,4,3,52247,52247,52250,0,3,2
15014,5,1,52252,52252,52253,0,1,2
15015,3,2,52255,52255,52257,0,2,2
15016,2,1,52257,52257,52258,0,1,0
15017,1,1,52258,52258,52259,0,1,0
15018,6,2,52264,52264,52266,0,2,5
15019,6,3,52270,52270,52273,0,3,4
15020,5,3,52275,52275,52278,0,3,2
15021,3,3,52278,52278,52281,0,3,0
15022,2,2,52280,52281,52283,1,3,0
15023,2,1,52282,52283,52284,1,2,0
15024,5,1,52287,52287,52288,0,1,3
15025,1,1,52288,52288,52289,0,1,0
15026,6,2,52294,52294,52296,0,2,5
15027,6,2,52300,52300,52302,0,2,4
15028,1,1,52301,52302,52303,1,2,0
15029,6,1,52307,52307,52308,0,1,4
15030,1,3,52308,52308,52311,0,3,0
15031,5,1,52313,52313,52314,0,1,2
15032,6,2,52319,52319,52321,0,2,5
15033,3,1,52322,52322,52323,0,1,1
15034,3,2,52325,52325,52327,0,2,2
15035,6,2,52331,52331,52333,0,2,4
15036,6,1,52337,52337,52338,0,1,4
15037,3,2,52340,52340,52342,0,2,2
15038,2,3,52342,52342,52345,0,3,0
15039,5,3,52347,52347,52350,0,3,2
15040,2,3,52349,52350,52353,1,4,0
15041,1,2,52350,52353,52355,3,5,0
15042,4,2,52354,52355,52357,1,3,0
15043,1,3,52355,52357,52360,2,5,0
15044,3,1,52358,52360,52361,2,3,0
15045,1,3,52359,52361,52364,2,5,0
15046,3,1,52362,52364,52365,2,3,0
15047,6,3,52368,52368,52371,0,3,3
15048,2,3,52370,52371,52374,1,4,0
15049,6,1,52376,52376,52377,0,1,2
15050,4,3,52380,52380,52383,0,3,3
15051,3,1,52383,52383,52384,0,1,0
15052,2,1,52385,52385,52386,0,1,1
15053,4,2,52389,52389,52391,0,2,3
15054,1,3,52390,52391,52394,1,4,0
15055,1,2,52391,52394,52396,3,5,0
15056,6,2,52397,52397,52399,0,2,1
15057,5,2,52402,52402,52404,0,2,3
15058,5,1,52407,52407,52408,0,1,3
15059,2,3,52409,52409,52412,0,3,1
15060,6,1,52415,52415,52416,0,1,3
15061,6,2,52421,52421,52423,0,2,5
15062,2,3,52423,52423,52426,0,3,0
15063,5,1,52428,52428,52429,0,1,2
15064,5,1,52433,52433,52434,0,1,4
15065,2,2,52435,52435,52437,0,2,1
15066,5,2,52440,52440,52442,0,2,3
15067,6,3,52446,52446,52449,0,3,4
15068,6,3,52452,52452,52455,0,3,3
15069,1,1,52453,52455,52456,2,3,0
15070,2,3,52455,52456,52459,1,4,0
15071,4,3,52459,52459,52462,0,3,0
15072,4,3,52463,52463,52466,0,3,1
15073,5,2,52468,52468,52470,0,2,2
15074,2,3,52470,52470,52473,0,3,0
15075,5,3,52475,52475,52478,0,3,2
15076,5,3,52480,52480,52483,0,3,2
15077,3,1,52483,52483,52484,0,1,0
15078,1,2,52484,52484,52486,0,2,0
15079,5,1,52489,52489,52490,0,1,3
15080,1,1,52490,52490,52491,0,1,0
15081,4,2,52494,52494,52496,0,2,3
15082,3,2,52497,52497,52499,0,2,1
15083,3,2,52500,52500,52502,0,2,1
15084,2,2,52502,52502,52504,0,2,0
15085,3,1,52505,52505,52506,0,1,1
15086,2,2,52507,52507,52509,0,2,1
15087,4,3,52511,52511,52514,0,3,2
15088,3,2,52514,52514,52516,0,2,0
15089,4,1,52518,52518,52519,0,1,2
15090,6,3,52524,52524,52527,0,3,5
15091,3,2,52527,52527,52529,0,2,0
15092,6,3,52533,52533,52536,0,3,4
15093,5,3,52538,52538,52541,0,3,2
15094,1,1,52539,52541,52542,2,3,0
15095,4,2,52543,52543,52545,0,2,1
15096,4,3,52547,52547,52550,0,3,2
15097,1,2,52548,52550,52552,2,4,0
15098,2,2,52550,52552,52554,2,4,0
15099,4,2,52554,52554,52556,0,2,0
15100,1,2,52555,52556,52558,1,3,0
15101,4,2,52559,52559,52561,0,2,1
15102,3,2,52562,52562,52564,0,2,1
15103,5,2,52567,52567,52569,0,2,3
15104,1,1,52568,52569,52570,1,2,0
15105,4,3,52572,52572,52575,0,3,2
15106,2,1,52574,52575,52576,1,2,0
15107,1,2,52575,52576,52578,1,3,0
15108,4,3,52579,52579,52582,0,3,1
15109,2,1,52581,52582,52583,1,2,0
15110,6,3,52587,52587,52590,0,3,4
15111,1,3,52588,52590,52593,2,5,0
15112,6,1,52594,52594,52595,0,1,1
15113,6,1,52600,52600,52601,0,1,5
15114,2,2,52602,52602,52604,0,2,1
15115,1,2,52603,52604,52606,1,3,0
15116,5,1,52608,52608,52609,0,1,2
15117,4,3,52612,52612,52615,0,3,3
15118,6,2,52618,52618,52620,0,2,3
15119,2,3,52620,52620,52623,0,3,0
15120,3,1,52623,52623,52624,0,1,0
15121,5,2,52628,52628,52630,0,2,4
15122,5,1,52633,52633,52634,0,1,3
15123,1,3,52634,52634,52637,0,3,0
15124,4,2,52638,52638,52640,0,2,1
15125,5,3,52643,52643,52646,0,3,3
15126,5,3,52648,52648,52651,0,3,2
15127,6,1,52654,52654,52655,0,1,3
15128,4,3,52658,52658,52661,0,3,3
15129,2,3,52660,52661,52664,1,4,0
15130,4,3,52664,52664,52667,0,3,0
15131,1,3,52665,52667,52670,2,5,0
15132,1,3,52666,52670,52673,4,7,0
15133,2,1,52668,52673,52674,5,6,0
15134,2,2,52670,52674,52676,4,6,0
15135,3,1,52673,52676,52677,3,4,0
15136,6,3,52679,52679,52682,0,3,2
15137,1,1,52680,52682,52683,2,3,0
15138,1,3,52681,52683,52686,2,5,0
15139,5,1,52686,52686,52687,0,1,0
15140,1,1,52687,52687,52688,0,1,0
15141,6,3,52693,52693,52696,0,3,5
15142,1,3,52694,52696,52699,2,5,0
15143,2,2,52696,52699,52701,3,5,0
15144,1,3,52697,52701,52704,4,7,0
15145,3,2,52700,52704,52706,4,6,0
15146,5,3,52705,52706,52709,1,4,0
15147,5,2,52710,52710,52712,0,2,1
15148,5,3,52715,52715,52718,0,3,3
15149,2,2,52717,52718,52720,1,3,0
15150,2,3,52719,52720,52723,1,4,0
15151,3,1,52722,52723,52724,1,2,0
15152,6,3,52728,52728,52731,0,3,4
15153,6,2,52734,52734,52736,0,2,3
15154,6,1,52740,52740,52741,0,1,4
15155,1,2,52741,52741,52743,0,2,0
15156,6,1,52747,52747,52748,0,1,4
15157,2,1,52749,52749,52750,0,1,1
15158,3,1,52752,52752,52753,0,1,2
15159,3,2,52755,52755,52757,0,2,2
15160,5,3,52760,52760,52763,0,3,3
15161,2,2,52762,52763,52765,1,3,0
15162,3,1,52765,52765,52766,0,1,0
15163,1,1,52766,52766,52767,0,1,0
15164,3,3,52769,52769,52772,0,3,2
15165,1,1,52770,52772,52773,2,3,0
15166,4,1,52774,52774,52775,0,1,1
15167,1,3,52775,52775,52778,0,3,0
15168,3,3,52778,52778,52781,0,3,0
15169,1,2,52779,52781,52783,2,4,0
15170,6,1,52785,52785,52786,0,1,2
15171,5,3,52790,52790,52793,0,3,4
15172,6,1,52796,52796,52797,0,1,3
15173,3,2,52799,52799,52801,0,2,2
15174,5,2,52804,52804,52806,0,2,3
15175,1,1,52805,52806,52807,1,2,0
15176,5,1,52810,52810,52811,0,1,3
15177,5,2,52815,52815,52817,0,2,4
15178,3,2,52818,52818,52820,0,2,1
15179,1,2,52819,52820,52822,1,3,0
15180,2,2,52821,52822,52824,1,3,0
15181,4,2,52825,52825,52827,0,2,1
15182,3,3,52828,52828,52831,0,3,1
15183,1,2,52829,52831,52833,2,4,0
15184,1,3,52830,52833,52836,3,6,0
15185,5,3,52835,52836,52839,1,4,0
15186,4,3,52839,52839,52842,0,3,0
15187,4,1,52843,52843,52844,0,1,1
15188,1,1,52844,52844,52845,0,1,0
15189,1,3,52845,52845,52848,0,3,0
15190,6,2,52851,52851,52853,0,2,3
15191,2,2,52853,52853,52855,0,2,0
15192,2,3,52855,52855,52858,0,3,0
15193,4,3,52859,52859,52862,0,3,1
15194,3,2,52862,52862,52864,0,2,0
15195,3,2,52865,52865,52867,0,2,1
15196,3,1,52868,52868,52869,0,1,1
15197,5,3,52873,52873,52876,0,3,4
15198,6,2,52879,52879,52881,0,2,3
15199,2,3,52881,52881,52884,0,3,0
15200,3,3,52884,52884,52887,0,3,0
15201,2,1,52886,52887,52888,1,2,0
15202,3,1,52889,52889,52890,0,1,1
15203,3,1,52892,52892,52893,0,1,2
15204,3,3,52895,52895,52898,0,3,2
15205,4,3,52899,52899,52902,0,3,1
15206,4,1,52903,52903,52904,0,1,1
15207,1,2,52904,52904,52906,0,2,0
15208,1,2,52905,52906,52908,1,3,0
15209,2,2,52907,52908,52910,1,3,0
15210,5,2,52912,52912,52914,0,2,2
15211,5,3,52917,52917,52920,0,3,3
15212,2,2,52919,52920,52922,1,3,0
15213,3,2,52922,52922,52924,0,2,0
15214,2,1,52924,52924,52925,0,1,0
15215,2,1,52926,52926,52927,0,1,1
15216,4,1,52930,52930,52931,0,1,3
15217,1,3,52931,52931,52934,0,3,0
15218,6,1,52937,52937,52938,0,1,3
15219,6,1,52943,52943,52944,0,1,5
15220,5,2,52948,52948,52950,0,2,4
15221,5,2,52953,52953,52955,0,2,3
15222,3,2,52956,52956,52958,0,2,1
15223,2,3,52958,52958,52961,0,3,0
15224,5,1,52963,52963,52964,0,1,2
15225,6,3,52969,52969,52972,0,3,5
15226,1,2,52970,52972,52974,2,4,0
15227,2,1,52972,52974,52975,2,3,0
15228,2,2,52974,52975,52977,1,3,0
15229,4,1,52978,52978,52979,0,1,1
15230,3,3,52981,52981,52984,0,3,2
15231,1,1,52982,52984,52985,2,3,0
15232,5,1,52987,52987,52988,0,1,2
15233,4,2,52991,52991,52993,0,2,3
15234,6,2,52997,52997,52999,0,2,4
15235,4,3,53001,53001,53004,0,3,2
15236,3,3,53004,53004,53007,0,3,0
15237,4,1,53008,53008,53009,0,1,1
15238,4,1,53012,53012,53013,0,1,3
15239,3,1,53015,53015,53016,0,1,2
15240,6,3,53021,53021,53024,0,3,5
15241,4,3,53025,53025,53028,0,3,1
15242,4,3,53029,53029,53032,0,3,1
15243,4,3,53033,53033,53036,0,3,1
15244,3,1,53036,53036,53037,0,1,0
15245,5,3,53041,53041,53044,0,3,4
15246,3,1,53044,53044,53045,0,1,0
15247,5,3,53049,53049,53052,0,3,4
15248,5,3,53054,53054,53057,0,3,2
15249,4,3,53058,53058,53061,0,3,1
15250,4,3,53062,53062,53065,0,3,1
15251,1,1,53063,53065,53066,2,3,0
15252,4,3,53067,53067,53070,0,3,1
15253,1,1,53068,53070,53071,2,3,0
15254,1,2,53069,53071,53073,2,4,0
15255,2,3,53071,53073,53076,2,5,0
15256,3,3,53074,53076,53079,2,5,0
15257,1,2,53075,53079,53081,4,6,0
15258,6,3,53081,53081,53084,0,3,0
15259,5,2,53086,53086,53088,0,2,2
15260,2,2,53088,53088,53090,0,2,0
15261,1,1,53089,53090,53091,1,2,0
15262,2,3,53091,53091,53094,0,3,0
15263,1,3,53092,53094,53097,2,5,0
15264,2,3,53094,53097,53100,3,6,0
15265,1,2,53095,53100,53102,5,7,0
15266,5,1,53100,53102,53103,2,3,0
15267,5,1,53105,53105,53106,0,1,2
15268,4,1,53109,53109,53110,0,1,3
15269,1,3,53110,53110,53113,0,3,0
15270,5,3,53115,53115,53118,0,3,2
15271,4,3,53119,53119,53122,0,3,1
15272,5,2,53124,53124,53126,0,2,2
15273,1,1,53125,53126,53127,1,2,0
15274,4,1,53129,53129,53130,0,1,2
15275,6,2,53135,53135,53137,0,2,5
15276,5,3,53140,53140,53143,0,3,3
15277,3,2,53143,53143,53145,0,2,0
15278,5,1,53148,53148,53149,0,1,3
15279,3,2,53151,53151,53153,0,2,2
15280,3,3,53154,53154,53157,0,3,1
15281,1,1,53155,53157,53158,2,3,0
15282,1,3,53156,53158,53161,2,5,0
15283,4,2,53160,53161,53163,1,3,0
15284,6,3,53166,53166,53169,0,3,3
15285,2,1,53168,53169,53170,1,2,0
15286,5,2,53173,53173,53175,0,2,3
15287,5,2,53178,53178,53180,0,2,3
15288,1,1,53179,53180,53181,1,2,0
15289,4,1,53183,53183,53184,0,1,2
15290,5,3,53188,53188,53191,0,3,4
15291,3,3,53191,53191,53194,0,3,0
15292,5,2,53196,53196,53198,0,2,2
15293,2,1,53198,53198,53199,0,1,0
15294,6,1,53204,53204,53205,0,1,5
15295,2,3,53206,53206,53209,0,3,1
15296,1,2,53207,53209,53211,2,4,0
15297,6,1,53213,53213,53214,0,1,2
15298,1,3,53214,53214,53217,0,3,0
15299,6,1,53220,53220,53221,0,1,3
15300,2,1,53222,53222,53223,0,1,1
15301,3,3,53225,53225,53228,0,3,2
15302,4,2,53229,53229,53231,0,2,1
15303,4,2,53233,53233,53235,0,2,2
15304,2,3,53235,53235,53238,0,3,0
15305,4,3,53239,53239,53242,0,3,1
15306,4,1,53243,53243,53244,0,1,1
15307,5,3,53248,53248,53251,0,3,4
15308,1,3,53249,53251,53254,2,5,0
15309,1,1,53250,53254,53255,4,5,0
15310,6,1,53256,53256,53257,0,1,1
15311,1,1,53257,53257,53258,0,1,0
15312,3,2,53260,53260,53262,0,2,2
15313,3,1,53263,53263,53264,0,1,1
15314,2,2,53265,53265,53267,0,2,1
15315,1,1,53266,53267,53268,1,2,0
15316,4,1,53270,53270,53271,0,1,2
15317,4,2,53274,53274,53276,0,2,3
15318,2,3,53276,53276,53279,0,3,0
15319,4,1,53280,53280,53281,0,1,1
15320,6,2,53286,53286,53288,0,2,5
15321,1,3,53287,53288,53291,1,4,0
15322,2,3,53289,53291,53294,2,5,0
15323,1,2,53290,53294,53296,4,6,0
15324,2,2,53292,53296,53298,4,6,0
15325,4,3,53296,53298,53301,2,5,0
15326,3,1,53299,53301,53302,2,3,0
15327,6,3,53305,53305,53308,0,3,3
15328,3,2,53308,53308,53310,0,2,0
15329,5,3,53313,53313,53316,0,3,3
15330,3,3,53316,53316,53319,0,3,0
15331,6,2,53322,53322,53324,0,2,3
15332,4,2,53326,53326,53328,0,2,2
15333,2,1,53328,53328,53329,0,1,0
15334,4,2,53332,53332,53334,0,2,3
15335,6,3,53338,53338,53341,0,3,4
15336,6,2,53344,53344,53346,0,2,3
15337,6,1,53350,53350,53351,0,1,4
15338,6,3,53356,53356,53359,0,3,5
15339,3,3,53359,53359,53362,0,3,0
15340,2,1,53361,53362,53363,1,2,0
15341,6,2,53367,53367,53369,0,2,4
15342,2,1,53369,53369,53370,0,1,0
15343,3,2,53372,53372,53374,0,2,2
15344,3,1,53375,53375,53376,0,1,1
15345,4,1,53379,53379,53380,0,1,3
15346,6,2,53385,53385,53387,0,2,5
15347,2,2,53387,53387,53389,0,2,0
15348,5,2,53392,53392,53394,0,2,3
15349,5,1,53397,53397,53398,0,1,3
15350,2,3,53399,53399,53402,0,3,1
15351,3,1,53402,53402,53403,0,1,0
15352,2,2,53404,53404,53406,0,2,1
15353,2,3,53406,53406,53409,0,3,0
15354,3,3,53409,53409,53412,0,3,0
15355,3,1,53412,53412,53413,0,1,0
15356,6,3,53418,53418,53421,0,3,5
15357,2,2,53420,53421,53423,1,3,0
15358,1,2,53421,53423,53425,2,4,0
15359,1,1,53422,53425,53426,3,4,0
15360,1,1,53423,53426,53427,3,4,0
15361,1,3,53424,53427,53430,3,6,0
15362,4,1,53428,53430,53431,2,3,0
15363,2,1,53430,53431,53432,1,2,0
15364,5,2,53435,53435,53437,0,2,3
15365,5,1,53440,53440,53441,0,1,3
15366,5,3,53445,53445,53448,0,3,4
15367,3,1,53448,53448,53449,0,1,0
15368,5,2,53453,53453,53455,0,2,4
15369,2,2,53455,53455,53457,0,2,0
15370,6,2,53461,53461,53463,0,2,4
15371,5,1,53466,53466,53467,0,1,3
15372,6,1,53472,53472,53473,0,1,5
15373,4,1,53476,53476,53477,0,1,3
15374,3,2,53479,53479,53481,0,2,2
15375,3,3,53482,53482,53485,0,3,1
15376,6,3,53488,53488,53491,0,3,3
15377,2,2,53490,53491,53493,1,3,0
15378,1,2,53491,53493,53495,2,4,0
15379,1,2,53492,53495,53497,3,5,0
15380,6,2,53498,53498,53500,0,2,1
15381,5,2,53503,53503,53505,0,2,3
15382,5,2,53508,53508,53510,0,2,3
15383,4,3,53512,53512,53515,0,3,2
15384,3,3,53515,53515,53518,0,3,0
15385,1,2,53516,53518,53520,2,4,0
15386,1,2,53517,53520,53522,3,5,0
15387,5,1,53522,53522,53523,0,1,0
15388,5,1,53527,53527,53528,0,1,4
15389,1,1,53528,53528,53529,0,1,0
15390,4,1,53532,53532,53533,0,1,3
15391,5,3,53537,53537,53540,0,3,4
15392,3,2,53540,53540,53542,0,2,0
15393,6,3,53546,53546,53549,0,3,4
15394,2,3,53548,53549,53552,1,4,0
15395,3,3,53551,53552,53555,1,4,0
15396,2,3,53553,53555,53558,2,5,0
15397,6,1,53559,53559,53560,0,1,1
15398,2,3,53561,53561,53564,0,3,1
15399,5,2,53566,53566,53568,0,2,2
15400,6,1,53572,53572,53573,0,1,4
15401,6,2,53578,53578,53580,0,2,5
15402,2,3,53580,53580,53583,0,3,0
15403,5,3,53585,53585,53588,0,3,2
15404,4,1,53589,53589,53590,0,1,1
15405,3,1,53592,53592,53593,0,1,2
15406,6,2,53598,53598,53600,0,2,5
15407,2,1,53600,53600,53601,0,1,0
15408,1,1,53601,53601,53602,0,1,0
15409,5,3,53606,53606,53609,0,3,4
15410,5,1,53611,53611,53612,0,1,2
15411,3,1,53614,53614,53615,0,1,2
15412,2,3,53616,53616,53619,0,3,1
15413,5,1,53621,53621,53622,0,1,2
15414,5,1,53626,53626,53627,0,1,4
15415,5,1,53631,53631,53632,0,1,4
15416,4,1,53635,53635,53636,0,1,3
15417,3,3,53638,53638,53641,0,3,2
15418,2,3,53640,53641,53644,1,4,0
15419,3,2,53643,53644,53646,1,3,0
15420,3,1,53646,53646,53647,0,1,0
15421,3,2,53649,53649,53651,0,2,2
15422,6,2,53655,53655,53657,0,2,4
15423,6,1,53661,53661,53662,0,1,4
15424,5,1,53666,53666,53667,0,1,4
15425,1,2,53667,53667,53669,0,2,0
15426,5,3,53672,53672,53675,0,3,3
15427,4,1,53676,53676,53677,0,1,1
15428,6,2,53682,53682,53684,0,2,5
15429,3,3,53685,53685,53688,0,3,1
15430,1,2,53686,53688,53690,2,4,0
15431,3,2,53689,53690,53692,1,3,0
15432,2,2,53691,53692,53694,1,3,0
15433,6,1,53697,53697,53698,0,1,3
15434,5,1,53702,53702,53703,0,1,4
15435,6,1,53708,53708,53709,0,1,5
15436,3,2,53711,53711,53713,0,2,2
15437,4,2,53715,53715,53717,0,2,2
15438,5,2,53720,53720,53722,0,2,3
15439,3,1,53723,53723,53724,0,1,1
15440,4,1,53727,53727,53728,0,1,3
15441,5,1,53732,53732,53733,0,1,4
15442,3,2,53735,53735,53737,0,2,2
15443,5,3,53740,53740,53743,0,3,3
15444,5,3,53745,53745,53748,0,3,2
15445,2,1,53747,53748,53749,1,2,0
15446,3,1,53750,53750,53751,0,1,1
15447,1,2,53751,53751,53753,0,2,0
15448,2,1,53753,53753,53754,0,1,0
15449,2,2,53755,53755,53757,0,2,1
15450,2,3,53757,53757,53760,0,3,0
15451,3,2,53760,53760,53762,0,2,0
15452,4,2,53764,53764,53766,0,2,2
15453,6,3,53770,53770,53773,0,3,4
15454,2,3,53772,53773,53776,1,4,0
15455,2,3,53774,53776,53779,2,5,0
15456,2,3,53776,53779,53782,3,6,0
15457,2,3,53778,53782,53785,4,7,0
15458,1,3,53779,53785,53788,6,9,0
15459,6,3,53785,53788,53791,3,6,0
15460,6,3,53791,53791,53794,0,3,0
15461,6,2,53797,53797,53799,0,2,3
15462,5,2,53802,53802,53804,0,2,3
15463,1,1,53803,53804,53805,1,2,0
15464,6,1,53809,53809,53810,0,1,4
15465,3,3,53812,53812,53815,0,3,2
15466,4,2,53816,53816,53818,0,2,1
15467,6,1,53822,53822,53823,0,1,4
15468,3,2,53825,53825,53827,0,2,2
15469,3,2,53828,53828,53830,0,2,1
15470,3,2,53831,53831,53833,0,2,1
15471,2,1,53833,53833,53834,0,1,0
15472,4,1,53837,53837,53838,0,1,3
15473,6,2,53843,53843,53845,0,2,5
15474,6,2,53849,53849,53851,0,2,4
15475,1,2,53850,53851,53853,1,3,0
15476,3,1,53853,53853,53854,0,1,0
15477,6,2,53859,53859,53861,0,2,5
15478,1,3,53860,53861,53864,1,4,0
15479,1,1,53861,53864,53865,3,4,0
15480,6,1,53867,53867,53868,0,1,2
15481,2,1,53869,53869,53870,0,1,1
15482,1,1,53870,53870,53871,0,1,0
15483,2,3,53872,53872,53875,0,3,1
15484,1,1,53873,53875,53876,2,3,0
15485,4,1,53877,53877,53878,0,1,1
15486,1,3,53878,53878,53881,0,3,0
15487,3,3,53881,53881,53884,0,3,0
15488,3,1,53884,53884,53885,0,1,0
15489,4,3,53888,53888,53891,0,3,3
15490,1,2,53889,53891,53893,2,4,0
15491,6,3,53895,53895,53898,0,3,2
15492,2,1,53897,53898,53899,1,2,0
15493,2,1,53899,53899,53900,0,1,0
15494,2,1,53901,53901,53902,0,1,1
15495,4,2,53905,53905,53907,0,2,3
15496,5,2,53910,53910,53912,0,2,3
15497,4,3,53914,53914,53917,0,3,2
15498,5,2,53919,53919,53921,0,2,2
15499,4,1,53923,53923,53924,0,1,2
15500,3,2,53926,53926,53928,0,2,2
15501,2,1,53928,53928,53929,0,1,0
15502,2,2,53930,53930,53932,0,2,1
15503,3,3,53933,53933,53936,0,3,1
15504,2,1,53935,53936,53937,1,2,0
15505,5,3,53940,53940,53943,0,3,3
15506,3,2,53943,53943,53945,0,2,0
15507,5,3,53948,53948,53951,0,3,3
15508,5,1,53953,53953,53954,0,1,2
15509,2,1,53955,53955,53956,0,1,1
15510,5,2,53960,53960,53962,0,2,4
15511,3,1,53963,53963,53964,0,1,1
15512,4,3,53967,53967,53970,0,3,3
15513,1,1,53968,53970,53971,2,3,0
15514,1,3,53969,53971,53974,2,5,0
15515,6,1,53975,53975,53976,0,1,1
15516,1,3,53976,53976,53979,0,3,0
15517,5,3,53981,53981,53984,0,3,2
15518,2,3,53983,53984,53987,1,4,0
15519,2,2,53985,53987,53989,2,4,0
15520,4,1,53989,53989,53990,0,1,0
15521,5,3,53994,53994,53997,0,3,4
15522,2,2,53996,53997,53999,1,3,0
15523,6,1,54002,54002,54003,0,1,3
15524,1,3,54003,54003,54006,0,3,0
15525,3,1,54006,54006,54007,0,1,0
15526,4,1,54010,54010,54011,0,1,3
15527,2,3,54012,54012,54015,0,3,1
15528,1,1,54013,54015,54016,2,3,0
15529,4,1,54017,54017,54018,0,1,1
15530,1,2,54018,54018,54020,0,2,0
15531,5,1,54023,54023,54024,0,1,3
15532,2,2,54025,54025,54027,0,2,1
15533,3,1,54028,54028,54029,0,1,1
15534,6,2,54034,54034,54036,0,2,5
15535,4,2,54038,54038,54040,0,2,2
15536,6,2,54044,54044,54046,0,2,4
15537,2,2,54046,54046,54048,0,2,0
15538,2,3,54048,54048,54051,0,3,0
15539,4,2,54052,54052,54054,0,2,1
15540,3,1,54055,54055,54056,0,1,1
15541,3,2,54058,54058,54060,0,2,2
15542,5,3,54063,54063,54066,0,3,3
15543,6,1,54069,54069,54070,0,1,3
15544,5,1,54074,54074,54075,0,1,4
15545,6,2,54080,54080,54082,0,2,5
15546,6,2,54086,54086,54088,0,2,4
15547,5,1,54091,54091,54092,0,1,3
15548,2,2,54093,54093,54095,0,2,1
15549,3,3,54096,54096,54099,0,3,1
15550,5,2,54101,54101,54103,0,2,2
15551,3,3,54104,54104,54107,0,3,1
15552,2,1,54106,54107,54108,1,2,0
15553,3,1,54109,54109,54110,0,1,1
15554,5,1,54114,54114,54115,0,1,4
15555,6,1,54120,54120,54121,0,1,5
15556,3,3,54123,54123,54126,0,3,2
15557,3,2,54126,54126,54128,0,2,0
15558,6,1,54132,54132,54133,0,1,4
15559,1,2,54133,54133,54135,0,2,0
15560,2,2,54135,54135,54137,0,2,0
15561,3,1,54138,54138,54139,0,1,1
15562,1,2,54139,54139,54141,0,2,0
15563,3,3,54142,54142,54145,0,3,1
15564,4,2,54146,54146,54148,0,2,1
15565,3,1,54149,54149,54150,0,1,1
15566,2,1,54151,54151,54152,0,1,1
15567,4,1,54155,54155,54156,0,1,3
15568,3,2,54158,54158,54160,0,2,2
15569,4,1,54162,54162,54163,0,1,2
15570,6,3,54168,54168,54171,0,3,5
15571,2,1,54170,54171,54172,1,2,0
15572,5,3,54175,54175,54178,0,3,3
15573,4,2,54179,54179,54181,0,2,1
15574,5,2,54184,54184,54186,0,2,3
15575,5,2,54189,54189,54191,0,2,3
15576,6,2,54195,54195,54197,0,2,4
15577,5,2,54200,54200,54202,0,2,3
15578,3,3,54203,54203,54206,0,3,1
15579,3,1,54206,54206,54207,0,1,0
15580,5,3,54211,54211,54214,0,3,4
15581,1,2,54212,54214,54216,2,4,0
15582,3,1,54215,54216,54217,1,2,0
15583,6,1,54221,54221,54222,0,1,4
15584,6,1,54227,54227,54228,0,1,5
15585,5,2,54232,54232,54234,0,2,4
15586,6,3,54238,54238,54241,0,3,4
15587,1,2,54239,54241,54243,2,4,0
15588,2,2,54241,54243,54245,2,4,0
15589,5,1,54246,54246,54247,0,1,1
15590,1,2,54247,54247,54249,0,2,0
15591,1,3,54248,54249,54252,1,4,0
15592,6,3,54254,54254,54257,0,3,2
15593,3,1,54257,54257,54258,0,1,0
15594,2,2,54259,54259,54261,0,2,1
15595,2,3,54261,54261,54264,0,3,0
15596,3,3,54264,54264,54267,0,3,0
15597,6,3,54270,54270,54273,0,3,3
15598,6,3,54276,54276,54279,0,3,3
15599,2,1,54278,54279,54280,1,2,0
15600,5,2,54283,54283,54285,0,2,3
15601,5,2,54288,54288,54290,0,2,3
15602,6,1,54294,54294,54295,0,1,4
15603,2,2,54296,54296,54298,0,2,1
15604,5,2,54301,54301,54303,0,2,3
15605,5,3,54306,54306,54309,0,3,3
15606,6,2,54312,54312,54314,0,2,3
15607,1,3,54313,54314,54317,1,4,0
15608,2,1,54315,54317,54318,2,3,0
15609,1,1,54316,54318,54319,2,3,0
15610,4,2,54320,54320,54322,0,2,1
15611,2,2,54322,54322,54324,0,2,0
15612,4,3,54326,54326,54329,0,3,2
15613,5,1,54331,54331,54332,0,1,2
15614,3,1,54334,54334,54335,0,1,2
15615,2,3,54336,54336,54339,0,3,1
15616,6,1,54342,54342,54343,0,1,3
15617,6,1,54348,54348,54349,0,1,5
15618,3,2,54351,54351,54353,0,2,2
15619,3,2,54354,54354,54356,0,2,1
15620,1,2,54355,54356,54358,1,3,0
15621,2,1,54357,54358,54359,1,2,0
15622,2,1,54359,54359,54360,0,1,0
15623,5,1,54364,54364,54365,0,1,4
15624,1,3,54365,54365,54368,0,3,0
15625,5,3,54370,54370,54373,0,3,2
15626,4,1,54374,54374,54375,0,1,1
15627,1,1,54375,54375,54376,0,1,0
15628,6,2,54381,54381,54383,0,2,5
15629,4,2,54385,54385,54387,0,2,2
15630,4,1,54389,54389,54390,0,1,2
15631,1,1,54390,54390,54391,0,1,0
15632,1,2,54391,54391,54393,0,2,0
15633,2,1,54393,54393,54394,0,1,0
15634,4,2,54397,54397,54399,0,2,3
15635,5,2,54402,54402,54404,0,2,3
15636,6,3,54408,54408,54411,0,3,4
15637,3,2,54411,54411,54413,0,2,0
15638,5,1,54416,54416,54417,0,1,3
15639,4,2,54420,54420,54422,0,2,3
15640,5,2,54425,54425,54427,0,2,3
15641,3,3,54428,54428,54431,0,3,1
15642,6,3,54434,54434,54437,0,3,3
15643,1,2,54435,54437,54439,2,4,0
15644,4,1,54439,54439,54440,0,1,0
15645,6,2,54445,54445,54447,0,2,5
15646,4,3,54449,54449,54452,0,3,2
15647,2,2,54451,54452,54454,1,3,0
15648,3,2,54454,54454,54456,0,2,0
15649,2,1,54456,54456,54457,0,1,0
15650,5,2,54461,54461,54463,0,2,4
15651,5,1,54466,54466,54467,0,1,3
15652,3,3,54469,54469,54472,0,3,2
15653,4,2,54473,54473,54475,0,2,1
15654,1,1,54474,54475,54476,1,2,0
15655,5,2,54479,54479,54481,0,2,3
15656,2,2,54481,54481,54483,0,2,0
15657,3,2,54484,54484,54486,0,2,1
15658,6,1,54490,54490,54491,0,1,4
15659,3,2,54493,54493,54495,0,2,2
15660,6,1,54499,54499,54500,0,1,4
15661,2,1,54501,54501,54502,0,1,1
15662,6,2,54507,54507,54509,0,2,5
15663,2,3,54509,54509,54512,0,3,0
15664,5,2,54514,54514,54516,0,2,2
15665,3,1,54517,54517,54518,0,1,1
15666,5,1,54522,54522,54523,0,1,4
15667,2,3,54524,54524,54527,0,3,1
15668,3,1,54527,54527,54528,0,1,0
15669,1,1,54528,54528,54529,0,1,0
15670,1,1,54529,54529,54530,0,1,0
15671,3,3,54532,54532,54535,0,3,2
15672,6,2,54538,54538,54540,0,2,3
15673,2,2,54540,54540,54542,0,2,0
15674,3,1,54543,54543,54544,0,1,1
15675,6,3,54549,54549,54552,0,3,5
15676,2,1,54551,54552,54553,1,2,0
15677,5,2,54556,54556,54558,0,2,3
15678,1,2,54557,54558,54560,1,3,0
15679,2,1,54559,54560,54561,1,2,0
15680,4,3,54563,54563,54566,0,3,2
15681,4,3,54567,54567,54570,0,3,1
15682,3,1,54570,54570,54571,0,1,0
15683,3,1,54573,54573,54574,0,1,2
15684,1,1,54574,54574,54575,0,1,0
15685,2,3,54576,54576,54579,0,3,1
15686,5,2,54581,54581,54583,0,2,2
15687,3,1,54584,54584,54585,0,1,1
15688,1,3,54585,54585,54588,0,3,0
15689,4,3,54589,54589,54592,0,3,1
15690,1,1,54590,54592,54593,2,3,0
15691,5,1,54595,54595,54596,0,1,2
15692,6,3,54601,54601,54604,0,3,5
15693,4,3,54605,54605,54608,0,3,1
15694,6,3,54611,54611,54614,0,3,3
15695,5,3,54616,54616,54619,0,3,2
15696,3,2,54619,54619,54621,0,2,0
15697,5,2,54624,54624,54626,0,2,3
15698,3,2,54627,54627,54629,0,2,1
15699,1,3,54628,54629,54632,1,4,0
15700,4,2,54632,54632,54634,0,2,0
15701,4,1,54636,54636,54637,0,1,2
15702,6,3,54642,54642,54645,0,3,5
15703,5,2,54647,54647,54649,0,2,2
15704,2,2,54649,54649,54651,0,2,0
15705,1,3,54650,54651,54654,1,4,0
15706,2,2,54652,54654,54656,2,4,0
15707,6,1,54658,54658,54659,0,1,2
15708,6,2,54664,54664,54666,0,2,5
15709,4,1,54668,54668,54669,0,1,2
15710,3,2,54671,54671,54673,0,2,2
15711,6,3,54677,54677,54680,0,3,4
15712,4,2,54681,54681,54683,0,2,1
15713,4,2,54685,54685,54687,0,2,2
15714,5,2,54690,54690,54692,0,2,3
15715,4,2,54694,54694,54696,0,2,2
15716,1,2,54695,54696,54698,1,3,0
15717,1,2,54696,54698,54700,2,4,0
15718,6,1,54702,54702,54703,0,1,2
15719,2,1,54704,54704,54705,0,1,1
15720,2,1,54706,54706,54707,0,1,1
15721,3,1,54709,54709,54710,0,1,2
15722,3,1,54712,54712,54713,0,1,2
15723,3,2,54715,54715,54717,0,2,2
15724,5,3,54720,54720,54723,0,3,3
15725,3,2,54723,54723,54725,0,2,0
15726,6,2,54729,54729,54731,0,2,4
15727,5,3,54734,54734,54737,0,3,3
15728,3,3,54737,54737,54740,0,3,0
15729,6,2,54743,54743,54745,0,2,3
15730,3,2,54746,54746,54748,0,2,1
15731,4,2,54750,54750,54752,0,2,2
15732,3,2,54753,54753,54755,0,2,1
15733,2,3,54755,54755,54758,0,3,0
15734,6,2,54761,54761,54763,0,2,3
15735,2,1,54763,54763,54764,0,1,0
15736,1,3,54764,54764,54767,0,3,0
15737,5,2,54769,54769,54771,0,2,2
15738,4,1,54773,54773,54774,0,1,2
15739,6,2,54779,54779,54781,0,2,5
15740,5,2,54784,54784,54786,0,2,3
15741,1,2,54785,54786,54788,1,3,0
15742,2,1,54787,54788,54789,1,2,0
15743,1,3,54788,54789,54792,1,4,0
15744,2,3,54790,54792,54795,2,5,0
15745,6,3,54796,54796,54799,0,3,1
15746,4,3,54800,54800,54803,0,3,1
15747,3,1,54803,54803,54804,0,1,0
15748,4,3,54807,54807,54810,0,3,3
15749,1,1,54808,54810,54811,2,3,0
15750,5,3,54813,54813,54816,0,3,2
15751,1,3,54814,54816,54819,2,5,0
15752,1,3,54815,54819,54822,4,7,0
15753,1,1,54816,54822,54823,6,7,0
15754,4,2,54820,54823,54825,3,5,0
15755,6,1,54826,54826,54827,0,1,1
15756,2,1,54828,54828,54829,0,1,1
15757,3,3,54831,54831,54834,0,3,2
15758,3,2,54834,54834,54836,0,2,0
15759,4,1,54838,54838,54839,0,1,2
15760,4,2,54842,54842,54844,0,2,3
15761,3,3,54845,54845,54848,0,3,1
15762,1,1,54846,54848,54849,2,3,0
15763,5,1,54851,54851,54852,0,1,2
15764,5,3,54856,54856,54859,0,3,4
15765,3,2,54859,54859,54861,0,2,0
15766,3,2,54862,54862,54864,0,2,1
15767,3,3,54865,54865,54868,0,3,1
15768,4,3,54869,54869,54872,0,3,1
15769,1,3,54870,54872,54875,2,5,0
15770,3,1,54873,54875,54876,2,3,0
15771,5,3,54878,54878,54881,0,3,2
15772,3,3,54881,54881,54884,0,3,0
15773,6,2,54887,54887,54889,0,2,3
15774,5,3,54892,54892,54895,0,3,3
15775,6,2,54898,54898,54900,0,2,3
15776,2,3,54900,54900,54903,0,3,0
15777,5,2,54905,54905,54907,0,2,2
15778,5,1,54910,54910,54911,0,1,3
15779,2,2,54912,54912,54914,0,2,1
15780,3,2,54915,54915,54917,0,2,1
15781,2,3,54917,54917,54920,0,3,0
15782,2,1,54919,54920,54921,1,2,0
15783,1,1,54920,54921,54922,1,2,0
15784,5,3,54925,54925,54928,0,3,3
15785,1,2,54926,54928,54930,2,4,0
15786,2,3,54928,54930,54933,2,5,0
15787,3,2,54931,54933,54935,2,4,0
15788,4,1,54935,54935,54936,0,1,0
15789,2,1,54937,54937,54938,0,1,1
15790,4,1,54941,54941,54942,0,1,3
15791,3,3,54944,54944,54947,0,3,2
15792,2,2,54946,54947,54949,1,3,0
15793,5,3,54951,54951,54954,0,3,2
15794,6,1,54957,54957,54958,0,1,3
15795,6,3,54963,54963,54966,0,3,5
15796,6,2,54969,54969,54971,0,2,3
15797,5,1,54974,54974,54975,0,1,3
15798,3,3,54977,54977,54980,0,3,2
15799,3,3,54980,54980,54983,0,3,0
15800,3,1,54983,54983,54984,0,1,0
15801,3,3,54986,54986,54989,0,3,2
15802,6,3,54992,54992,54995,0,3,3
15803,5,1,54997,54997,54998,0,1,2
15804,6,3,55003,55003,55006,0,3,5
15805,2,1,55005,55006,55007,1,2,0
15806,4,1,55009,55009,55010,0,1,2
15807,4,2,55013,55013,55015,0,2,3
15808,5,2,55018,55018,55020,0,2,3
15809,1,3,55019,55020,55023,1,4,0
15810,6,2,55025,55025,55027,0,2,2
15811,6,1,55031,55031,55032,0,1,4
15812,5,1,55036,55036,55037,0,1,4
15813,3,1,55039,55039,55040,0,1,2
15814,5,3,55044,55044,55047,0,3,4
15815,2,3,55046,55047,55050,1,4,0
15816,1,3,55047,55050,55053,3,6,0
15817,4,2,55051,55053,55055,2,4,0
15818,4,3,55055,55055,55058,0,3,0
15819,1,1,55056,55058,55059,2,3,0
15820,5,1,55061,55061,55062,0,1,2
15821,4,3,55065,55065,55068,0,3,3
15822,4,3,55069,55069,55072,0,3,1
15823,5,1,55074,55074,55075,0,1,2
15824,6,2,55080,55080,55082,0,2,5
15825,6,1,55086,55086,55087,0,1,4
15826,4,1,55090,55090,55091,0,1,3
15827,6,2,55096,55096,55098,0,2,5
15828,3,1,55099,55099,55100,0,1,1
15829,4,2,55103,55103,55105,0,2,3
15830,1,2,55104,55105,55107,1,3,0
15831,6,2,55110,55110,55112,0,2,3
15832,1,3,55111,55112,55115,1,4,0
15833,1,1,55112,55115,55116,3,4,0
15834,1,1,55113,55116,55117,3,4,0
15835,3,3,55116,55117,55120,1,4,0
15836,1,2,55117,55120,55122,3,5,0
15837,1,2,55118,55122,55124,4,6,0
15838,3,3,55121,55124,55127,3,6,0
15839,5,2,55126,55127,55129,1,3,0
15840,1,2,55127,55129,55131,2,4,0
15841,6,2,55133,55133,55135,0,2,2
15842,5,1,55138,55138,55139,0,1,3
15843,2,1,55140,55140,55141,0,1,1
15844,5,1,55145,55145,55146,0,1,4
15845,5,1,55150,55150,55151,0,1,4
15846,1,2,55151,55151,55153,0,2,0
15847,4,1,55155,55155,55156,0,1,2
15848,4,3,55159,55159,55162,0,3,3
15849,3,2,55162,55162,55164,0,2,0
15850,5,2,55167,55167,55169,0,2,3
15851,6,3,55173,55173,55176,0,3,4
15852,5,3,55178,55178,55181,0,3,2
15853,2,1,55180,55181,55182,1,2,0
15854,2,1,55182,55182,55183,0,1,0
15855,6,1,55188,55188,55189,0,1,5
15856,3,1,55191,55191,55192,0,1,2
15857,5,3,55196,55196,55199,0,3,4
15858,2,2,55198,55199,55201,1,3,0
15859,4,2,55202,55202,55204,0,2,1
15860,6,1,55208,55208,55209,0,1,4
15861,4,3,55212,55212,55215,0,3,3
15862,5,1,55217,55217,55218,0,1,2
15863,1,1,55218,55218,55219,0,1,0
15864,6,2,55224,55224,55226,0,2,5
15865,2,2,55226,55226,55228,0,2,0
15866,2,2,55228,55228,55230,0,2,0
15867,3,1,55231,55231,55232,0,1,1
15868,6,3,55237,55237,55240,0,3,5
15869,5,3,55242,55242,55245,0,3,2
15870,1,2,55243,55245,55247,2,4,0
15871,4,3,55247,55247,55250,0,3,0
15872,1,3,55248,55250,55253,2,5,0
15873,6,3,55254,55254,55257,0,3,1
15874,3,2,55257,55257,55259,0,2,0
15875,5,1,55262,55262,55263,0,1,3
15876,2,3,55264,55264,55267,0,3,1
15877,3,3,55267,55267,55270,0,3,0
15878,5,1,55272,55272,55273,0,1,2
15879,4,2,55276,55276,55278,0,2,3
15880,2,3,55278,55278,55281,0,3,0
15881,5,3,55283,55283,55286,0,3,2
15882,6,2,55289,55289,55291,0,2,3
15883,3,1,55292,55292,55293,0,1,1
15884,5,1,55297,55297,55298,0,1,4
15885,6,3,55303,55303,55306,0,3,5
15886,3,1,55306,55306,55307,0,1,0
15887,4,3,55310,55310,55313,0,3,3
15888,4,2,55314,55314,55316,0,2,1
15889,2,2,55316,55316,55318,0,2,0
15890,2,2,55318,55318,55320,0,2,0
15891,4,2,55322,55322,55324,0,2,2
15892,6,2,55328,55328,55330,0,2,4
15893,2,3,55330,55330,55333,0,3,0
15894,3,3,55333,55333,55336,0,3,0
15895,3,1,55336,55336,55337,0,1,0
15896,2,3,55338,55338,55341,0,3,1
15897,5,3,55343,55343,55346,0,3,2
15898,2,3,55345,55346,55349,1,4,0
15899,1,3,55346,55349,55352,3,6,0
15900,5,1,55351,55352,55353,1,2,0
15901,6,2,55357,55357,55359,0,2,4
15902,1,1,55358,55359,55360,1,2,0
15903,6,3,55364,55364,55367,0,3,4
15904,3,2,55367,55367,55369,0,2,0
15905,3,2,55370,55370,55372,0,2,1
15906,2,1,55372,55372,55373,0,1,0
15907,5,1,55377,55377,55378,0,1,4
15908,1,2,55378,55378,55380,0,2,0
15909,4,2,55382,55382,55384,0,2,2
15910,1,1,55383,55384,55385,1,2,0
15911,4,3,55387,55387,55390,0,3,2
15912,1,2,55388,55390,55392,2,4,0
15913,1,3,55389,55392,55395,3,6,0
15914,4,1,55393,55395,55396,2,3,0
15915,2,1,55395,55396,55397,1,2,0
15916,2,1,55397,55397,55398,0,1,0
15917,2,3,55399,55399,55402,0,3,1
15918,5,2,55404,55404,55406,0,2,2
15919,2,1,55406,55406,55407,0,1,0
15920,3,2,55409,55409,55411,0,2,2
15921,6,1,55415,55415,55416,0,1,4
15922,1,2,55416,55416,55418,0,2,0
15923,3,2,55419,55419,55421,0,2,1
15924,3,3,55422,55422,55425,0,3,1
15925,5,2,55427,55427,55429,0,2,2
15926,1,3,55428,55429,55432,1,4,0
15927,6,1,55434,55434,55435,0,1,2
15928,5,3,55439,55439,55442,0,3,4
15929,6,3,55445,55445,55448,0,3,3
15930,3,2,55448,55448,55450,0,2,0
15931,5,2,55453,55453,55455,0,2,3
15932,1,3,55454,55455,55458,1,4,0
15933,1,1,55455,55458,55459,3,4,0
15934,2,3,55457,55459,55462,2,5,0
15935,4,2,55461,55462,55464,1,3,0
15936,1,1,55462,55464,55465,2,3,0
15937,1,1,55463,55465,55466,2,3,0
15938,2,1,55465,55466,55467,1,2,0
15939,2,1,55467,55467,55468,0,1,0
15940,3,3,55470,55470,55473,0,3,2
15941,6,2,55476,55476,55478,0,2,3
15942,5,3,55481,55481,55484,0,3,3
15943,1,2,55482,55484,55486,2,4,0
15944,4,2,55486,55486,55488,0,2,0
15945,2,3,55488,55488,55491,0,3,0
15946,2,2,55490,55491,55493,1,3,0
15947,2,3,55492,55493,55496,1,4,0
15948,3,3,55495,55496,55499,1,4,0
15949,1,1,55496,55499,55500,3,4,0
15950,4,3,55500,55500,55503,0,3,0
15951,2,1,55502,55503,55504,1,2,0
15952,3,2,55505,55505,55507,0,2,1
15953,5,1,55510,55510,55511,0,1,3
15954,5,1,55515,55515,55516,0,1,4
15955,6,3,55521,55521,55524,0,3,5
15956,6,3,55527,55527,55530,0,3,3
15957,5,3,55532,55532,55535,0,3,2
15958,3,2,55535,55535,55537,0,2,0
15959,4,2,55539,55539,55541,0,2,2
15960,5,2,55544,55544,55546,0,2,3
15961,2,3,55546,55546,55549,0,3,0
15962,4,3,55550,55550,55553,0,3,1
15963,6,1,55556,55556,55557,0,1,3
15964,1,2,55557,55557,55559,0,2,0
15965,2,1,55559,55559,55560,0,1,0
15966,2,1,55561,55561,55562,0,1,1
15967,3,1,55564,55564,55565,0,1,2
15968,1,1,55565,55565,55566,0,1,0
15969,5,1,55570,55570,55571,0,1,4
15970,2,3,55572,55572,55575,0,3,1
15971,6,3,55578,55578,55581,0,3,3
15972,6,3,55584,55584,55587,0,3,3
15973,5,2,55589,55589,55591,0,2,2
15974,1,2,55590,55591,55593,1,3,0
15975,2,2,55592,55593,55595,1,3,0
15976,6,1,55598,55598,55599,0,1,3
15977,6,3,55604,55604,55607,0,3,5
15978,5,2,55609,55609,55611,0,2,2
15979,2,1,55611,55611,55612,0,1,0
15980,3,1,55614,55614,55615,0,1,2
15981,6,2,55620,55620,55622,0,2,5
15982,1,3,55621,55622,55625,1,4,0
15983,3,1,55624,55625,55626,1,2,0
15984,2,2,55626,55626,55628,0,2,0
15985,3,2,55629,55629,55631,0,2,1
15986,1,2,55630,55631,55633,1,3,0
15987,4,3,55634,55634,55637,0,3,1
15988,5,3,55639,55639,55642,0,3,2
15989,2,3,55641,55642,55645,1,4,0
15990,3,3,55644,55645,55648,1,4,0
15991,5,2,55649,55649,55651,0,2,1
15992,5,3,55654,55654,55657,0,3,3
15993,6,2,55660,55660,55662,0,2,3
15994,2,2,55662,55662,55664,0,2,0
15995,3,2,55665,55665,55667,0,2,1
15996,4,1,55669,55669,55670,0,1,2
15997,4,3,55673,55673,55676,0,3,3
15998,6,3,55679,55679,55682,0,3,3
15999,4,1,55683,55683,55684,0,1,1
16000,1,3,55684,55684,55687,0,3,0
16001,3,3,55687,55687,55690,0,3,0
16002,6,3,55693,55693,55696,0,3,3
16003,5,1,55698,55698,55699,0,1,2
16004,2,3,55700,55700,55703,0,3,1
16005,3,2,55703,55703,55705,0,2,0
16006,2,1,55705,55705,55706,0,1,0
16007,5,2,55710,55710,55712,0,2,4
16008,2,2,55712,55712,55714,0,2,0
16009,6,1,55718,55718,55719,0,1,4
16010,6,2,55724,55724,55726,0,2,5
16011,5,1,55729,55729,55730,0,1,3
16012,3,3,55732,55732,55735,0,3,2
16013,5,1,55737,55737,55738,0,1,2
16014,4,3,55741,55741,55744,0,3,3
16015,3,2,55744,55744,55746,0,2,0
16016,5,1,55749,55749,55750,0,1,3
16017,3,2,55752,55752,55754,0,2,2
16018,4,1,55756,55756,55757,0,1,2
16019,5,1,55761,55761,55762,0,1,4
16020,1,1,55762,55762,55763,0,1,0
16021,4,3,55766,55766,55769,0,3,3
16022,3,2,55769,55769,55771,0,2,0
16023,1,1,55770,55771,55772,1,2,0
16024,6,3,55776,55776,55779,0,3,4
16025,5,2,55781,55781,55783,0,2,2
16026,5,3,55786,55786,55789,0,3,3
16027,6,2,55792,55792,55794,0,2,3
16028,3,3,55795,55795,55798,0,3,1
16029,1,1,55796,55798,55799,2,3,0
16030,6,2,55802,55802,55804,0,2,3
16031,5,1,55807,55807,55808,0,1,3
16032,1,3,55808,55808,55811,0,3,0
16033,5,3,55813,55813,55816,0,3,2
16034,5,2,55818,55818,55820,0,2,2
16035,1,3,55819,55820,55823,1,4,0
16036,5,2,55824,55824,55826,0,2,1
16037,1,2,55825,55826,55828,1,3,0
16038,4,2,55829,55829,55831,0,2,1
16039,3,3,55832,55832,55835,0,3,1
16040,4,1,55836,55836,55837,0,1,1
16041,5,2,55841,55841,55843,0,2,4
16042,3,1,55844,55844,55845,0,1,1
16043,1,3,55845,55845,55848,0,3,0
16044,5,2,55850,55850,55852,0,2,2
16045,6,1,55856,55856,55857,0,1,4
16046,2,3,55858,55858,55861,0,3,1
16047,4,3,55862,55862,55865,0,3,1
16048,2,2,55864,55865,55867,1,3,0
16049,3,3,55867,55867,55870,0,3,0
16050,2,1,55869,55870,55871,1,2,0
16051,3,3,55872,55872,55875,0,3,1
16052,1,1,55873,55875,55876,2,3,0
16053,1,2,55874,55876,55878,2,4,0
16054,4,2,55878,55878,55880,0,2,0
16055,5,1,55883,55883,55884,0,1,3
16056,2,1,55885,55885,55886,0,1,1
16057,5,1,55890,55890,55891,0,1,4
16058,2,1,55892,55892,55893,0,1,1
16059,6,2,55898,55898,55900,0,2,5
16060,6,3,55904,55904,55907,0,3,4
16061,2,1,55906,55907,55908,1,2,0
16062,1,3,55907,55908,55911,1,4,0
16063,5,2,55912,55912,55914,0,2,1
16064,2,3,55914,55914,55917,0,3,0
16065,3,2,55917,55917,55919,0,2,0
16066,5,1,55922,55922,55923,0,1,3
16067,5,1,55927,55927,55928,0,1,4
16068,4,2,55931,55931,55933,0,2,3
16069,3,3,55934,55934,55937,0,3,1
16070,3,3,55937,55937,55940,0,3,0
16071,2,1,55939,55940,55941,1,2,0
16072,2,1,55941,55941,55942,0,1,0
16073,1,1,55942,55942,55943,0,1,0
16074,6,1,55948,55948,55949,0,1,5
16075,3,1,55951,55951,55952,0,1,2
16076,4,3,55955,55955,55958,0,3,3
16077,5,2,55960,55960,55962,0,2,2
16078,1,2,55961,55962,55964,1,3,0
16079,5,2,55966,55966,55968,0,2,2
16080,3,2,55969,55969,55971,0,2,1
16081,2,1,55971,55971,55972,0,1,0
16082,4,2,55975,55975,55977,0,2,3
16083,5,2,55980,55980,55982,0,2,3
16084,1,1,55981,55982,55983,1,2,0
16085,1,1,55982,55983,55984,1,2,0
16086,6,2,55988,55988,55990,0,2,4
16087,4,2,55992,55992,55994,0,2,2
16088,6,2,55998,55998,56000,0,2,4
16089,1,2,55999,56000,56002,1,3,0
16090,5,2,56004,56004,56006,0,2,2
16091,6,2,56010,56010,56012,0,2,4
16092,2,2,56012,56012,56014,0,2,0
16093,3,3,56015,56015,56018,0,3,1
16094,2,2,56017,56018,56020,1,3,0
16095,5,3,56022,56022,56025,0,3,2
16096,3,1,56025,56025,56026,0,1,0
16097,1,2,56026,56026,56028,0,2,0
16098,2,2,56028,56028,56030,0,2,0
16099,5,1,56033,56033,56034,0,1,3
16100,1,1,56034,56034,56035,0,1,0
16101,1,1,56035,56035,56036,0,1,0
16102,3,3,56038,56038,56041,0,3,2
16103,5,1,56043,56043,56044,0,1,2
16104,1,3,56044,56044,56047,0,3,0
16105,1,3,56045,56047,56050,2,5,0
16106,4,3,56049,56050,56053,1,4,0
16107,6,1,56055,56055,56056,0,1,2
16108,1,1,56056,56056,56057,0,1,0
16109,4,1,56060,56060,56061,0,1,3
16110,1,3,56061,56061,56064,0,3,0
16111,4,3,56065,56065,56068,0,3,1
16112,2,3,56067,56068,56071,1,4,0
16113,5,1,56072,56072,56073,0,1,1
16114,4,2,56076,56076,56078,0,2,3
16115,1,1,56077,56078,56079,1,2,0
16116,5,3,56082,56082,56085,0,3,3
16117,5,3,56087,56087,56090,0,3,2
16118,4,3,56091,56091,56094,0,3,1
16119,1,3,56092,56094,56097,2,5,0
16120,6,2,56098,56098,56100,0,2,1
16121,6,2,56104,56104,56106,0,2,4
16122,6,1,56110,56110,56111,0,1,4
16123,5,1,56115,56115,56116,0,1,4
16124,3,3,56118,56118,56121,0,3,2
16125,4,3,56122,56122,56125,0,3,1
16126,2,2,56124,56125,56127,1,3,0
16127,2,1,56126,56127,56128,1,2,0
16128,4,3,56130,56130,56133,0,3,2
16129,2,1,56132,56133,56134,1,2,0
16130,4,2,56136,56136,56138,0,2,2
16131,6,2,56142,56142,56144,0,2,4
16132,2,2,56144,56144,56146,0,2,0
16133,2,3,56146,56146,56149,0,3,0
16134,2,1,56148,56149,56150,1,2,0
16135,2,2,56150,56150,56152,0,2,0
16136,5,1,56155,56155,56156,0,1,3
16137,1,1,56156,56156,56157,0,1,0
16138,4,1,56160,56160,56161,0,1,3
16139,1,3,56161,56161,56164,0,3,0
16140,5,1,56166,56166,56167,0,1,2
16141,4,1,56170,56170,56171,0,1,3
16142,3,2,56173,56173,56175,0,2,2
16143,5,2,56178,56178,56180,0,2,3
16144,4,1,56182,56182,56183,0,1,2
16145,4,2,56186,56186,56188,0,2,3
16146,1,3,56187,56188,56191,1,4,0
16147,4,3,56191,56191,56194,0,3,0
16148,1,1,56192,56194,56195,2,3,0
16149,3,2,56195,56195,56197,0,2,0
16150,5,2,56200,56200,56202,0,2,3
16151,5,2,56205,56205,56207,0,2,3
16152,4,2,56209,56209,56211,0,2,2
16153,1,3,56210,56211,56214,1,4,0
16154,1,2,56211,56214,56216,3,5,0
16155,3,2,56214,56216,56218,2,4,0
16156,2,1,56216,56218,56219,2,3,0
16157,4,3,56220,56220,56223,0,3,1
16158,6,1,56226,56226,56227,0,1,3
16159,3,1,56229,56229,56230,0,1,2
16160,4,3,56233,56233,56236,0,3,3
16161,2,2,56235,56236,56238,1,3,0
16162,6,1,56241,56241,56242,0,1,3
16163,6,2,56247,56247,56249,0,2,5
16164,5,2,56252,56252,56254,0,2,3
16165,3,3,56255,56255,56258,0,3,1
16166,2,3,56257,56258,56261,1,4,0
16167,2,2,56259,56261,56263,2,4,0
16168,4,1,56263,56263,56264,0,1,0
16169,3,2,56266,56266,56268,0,2,2
16170,5,2,56271,56271,56273,0,2,3
16171,5,1,56276,56276,56277,0,1,3
16172,6,2,56282,56282,56284,0,2,5
16173,5,3,56287,56287,56290,0,3,3
16174,6,2,56293,56293,56295,0,2,3
16175,2,1,56295,56295,56296,0,1,0
16176,3,1,56298,56298,56299,0,1,2
16177,1,1,56299,56299,56300,0,1,0
16178,4,3,56303,56303,56306,0,3,3
16179,3,3,56306,56306,56309,0,3,0
16180,6,1,56312,56312,56313,0,1,3
16181,6,3,56318,56318,56321,0,3,5
16182,6,3,56324,56324,56327,0,3,3
16183,6,2,56330,56330,56332,0,2,3
16184,4,3,56334,56334,56337,0,3,2
16185,2,2,56336,56337,56339,1,3,0
16186,3,3,56339,56339,56342,0,3,0
16187,4,3,56343,56343,56346,0,3,1
16188,1,1,56344,56346,56347,2,3,0
16189,5,3,56349,56349,56352,0,3,2
16190,3,2,56352,56352,56354,0,2,0
16191,2,2,56354,56354,56356,0,2,0
16192,2,1,56356,56356,56357,0,1,0
16193,6,2,56362,56362,56364,0,2,5
16194,3,1,56365,56365,56366,0,1,1
16195,3,2,56368,56368,56370,0,2,2
16196,6,1,56374,56374,56375,0,1,4
16197,2,3,56376,56376,56379,0,3,1
16198,2,1,56378,56379,56380,1,2,0
16199,4,1,56382,56382,56383,0,1,2
16200,5,2,56387,56387,56389,0,2,4
16201,6,3,56393,56393,56396,0,3,4
16202,3,1,56396,56396,56397,0,1,0
16203,5,3,56401,56401,56404,0,3,4
16204,4,1,56405,56405,56406,0,1,1
16205,5,2,56410,56410,56412,0,2,4
16206,4,3,56414,56414,56417,0,3,2
16207,2,3,56416,56417,56420,1,4,0
16208,5,2,56421,56421,56423,0,2,1
16209,6,1,56427,56427,56428,0,1,4
16210,3,1,56430,56430,56431,0,1,2
16211,4,2,56434,56434,56436,0,2,3
16212,6,1,56440,56440,56441,0,1,4
16213,5,2,56445,56445,56447,0,2,4
16214,4,1,56449,56449,56450,0,1,2
16215,1,2,56450,56450,56452,0,2,0
16216,3,1,56453,56453,56454,0,1,1
16217,2,1,56455,56455,56456,0,1,1
16218,5,2,56460,56460,56462,0,2,4
16219,6,1,56466,56466,56467,0,1,4
16220,6,1,56472,56472,56473,0,1,5
16221,4,2,56476,56476,56478,0,2,3
16222,5,2,56481,56481,56483,0,2,3
16223,6,3,56487,56487,56490,0,3,4
16224,4,1,56491,56491,56492,0,1,1
16225,1,1,56492,56492,56493,0,1,0
16226,4,3,56496,56496,56499,0,3,3
16227,2,2,56498,56499,56501,1,3,0
16228,3,3,56501,56501,56504,0,3,0
16229,6,1,56507,56507,56508,0,1,3
16230,3,2,56510,56510,56512,0,2,2
16231,4,3,56514,56514,56517,0,3,2
16232,5,2,56519,56519,56521,0,2,2
16233,4,1,56523,56523,56524,0,1,2
16234,5,2,56528,56528,56530,0,2,4
16235,5,1,56533,56533,56534,0,1,3
16236,5,1,56538,56538,56539,0,1,4
16237,5,1,56543,56543,56544,0,1,4
16238,4,1,56547,56547,56548,0,1,3
16239,5,1,56552,56552,56553,0,1,4
16240,1,3,56553,56553,56556,0,3,0
16241,1,3,56554,56556,56559,2,5,0
16242,2,1,56556,56559,56560,3,4,0
16243,5,1,56561,56561,56562,0,1,1
16244,5,1,56566,56566,56567,0,1,4
16245,1,2,56567,56567,56569,0,2,0
16246,4,1,56571,56571,56572,0,1,2
16247,2,1,56573,56573,56574,0,1,1
16248,6,3,56579,56579,56582,0,3,5
16249,4,1,56583,56583,56584,0,1,1
16250,6,3,56589,56589,56592,0,3,5
16251,6,3,56595,56595,56598,0,3,3
16252,4,2,56599,56599,56601,0,2,1
16253,4,2,56603,56603,56605,0,2,2
16254,2,2,56605,56605,56607,0,2,0
16255,2,1,56607,56607,56608,0,1,0
16256,2,1,56609,56609,56610,0,1,1
16257,2,2,56611,56611,56613,0,2,1
16258,4,3,56615,56615,56618,0,3,2
16259,6,3,56621,56621,56624,0,3,3
16260,5,1,56626,56626,56627,0,1,2
16261,4,2,56630,56630,56632,0,2,3
16262,2,1,56632,56632,56633,0,1,0
16263,1,2,56633,56633,56635,0,2,0
16264,4,1,56637,56637,56638,0,1,2
16265,6,2,56643,56643,56645,0,2,5
16266,1,2,56644,56645,56647,1,3,0
16267,5,2,56649,56649,56651,0,2,2
16268,6,3,56655,56655,56658,0,3,4
16269,2,2,56657,56658,56660,1,3,0
16270,2,1,56659,56660,56661,1,2,0
16271,2,3,56661,56661,56664,0,3,0
16272,4,1,56665,56665,56666,0,1,1
16273,6,2,56671,56671,56673,0,2,5
16274,4,2,56675,56675,56677,0,2,2
16275,3,1,56678,56678,56679,0,1,1
16276,1,2,56679,56679,56681,0,2,0
16277,4,1,56683,56683,56684,0,1,2
16278,5,1,56688,56688,56689,0,1,4
16279,6,3,56694,56694,56697,0,3,5
16280,2,1,56696,56697,56698,1,2,0
16281,4,1,56700,56700,56701,0,1,2
16282,3,3,56703,56703,56706,0,3,2
16283,4,1,56707,56707,56708,0,1,1
16284,3,3,56710,56710,56713,0,3,2
16285,5,3,56715,56715,56718,0,3,2
16286,6,2,56721,56721,56723,0,2,3
16287,6,1,56727,56727,56728,0,1,4
16288,5,2,56732,56732,56734,0,2,4
16289,1,3,56733,56734,56737,1,4,0
16290,1,2,56734,56737,56739,3,5,0
16291,2,2,56736,56739,56741,3,5,0
16292,3,3,56739,56741,56744,2,5,0
16293,3,2,56742,56744,56746,2,4,0
16294,5,2,56747,56747,56749,0,2,1
16295,5,3,56752,56752,56755,0,3,3
16296,1,2,56753,56755,56757,2,4,0
16297,5,1,56758,56758,56759,0,1,1
16298,2,1,56760,56760,56761,0,1,1
16299,6,2,56766,56766,56768,0,2,5
16300,4,1,56770,56770,56771,0,1,2
16301,2,2,56772,56772,56774,0,2,1
16302,3,2,56775,56775,56777,0,2,1
16303,4,3,56779,56779,56782,0,3,2
16304,6,1,56785,56785,56786,0,1,3
16305,4,1,56789,56789,56790,0,1,3
16306,4,1,56793,56793,56794,0,1,3
16307,6,1,56799,56799,56800,0,1,5
16308,5,3,56804,56804,56807,0,3,4
16309,1,1,56805,56807,56808,2,3,0
16310,6,2,56811,56811,56813,0,2,3
16311,3,3,56814,56814,56817,0,3,1
16312,1,3,56815,56817,56820,2,5,0
16313,2,2,56817,56820,56822,3,5,0
16314,2,1,56819,56822,56823,3,4,0
16315,4,3,56823,56823,56826,0,3,0
16316,3,2,56826,56826,56828,0,2,0
16317,5,1,56831,56831,56832,0,1,3
16318,3,1,56834,56834,56835,0,1,2
16319,2,2,56836,56836,56838,0,2,1
16320,3,2,56839,56839,56841,0,2,1
16321,5,3,56844,56844,56847,0,3,3
16322,1,1,56845,56847,56848,2,3,0
16323,4,3,56849,56849,56852,0,3,1
16324,1,1,56850,56852,56853,2,3,0
16325,3,1,56853,56853,56854,0,1,0
16326,5,1,56858,56858,56859,0,1,4
16327,6,3,56864,56864,56867,0,3,5
16328,6,2,56870,56870,56872,0,2,3
16329,6,3,56876,56876,56879,0,3,4
16330,4,1,56880,56880,56881,0,1,1
16331,4,2,56884,56884,56886,0,2,3
16332,1,1,56885,56886,56887,1,2,0
16333,2,2,56887,56887,56889,0,2,0
16334,4,1,56891,56891,56892,0,1,2
16335,5,3,56896,56896,56899,0,3,4
16336,3,2,56899,56899,56901,0,2,0
16337,1,3,56900,56901,56904,1,4,0
16338,5,1,56905,56905,56906,0,1,1
16339,3,3,56908,56908,56911,0,3,2
16340,1,1,56909,56911,56912,2,3,0
16341,1,3,56910,56912,56915,2,5,0
16342,3,2,56913,56915,56917,2,4,0
16343,6,1,56919,56919,56920,0,1,2
16344,2,2,56921,56921,56923,0,2,1
16345,2,2,56923,56923,56925,0,2,0
16346,2,1,56925,56925,56926,0,1,0
16347,6,1,56931,56931,56932,0,1,5
16348,4,1,56935,56935,56936,0,1,3
16349,5,1,56940,56940,56941,0,1,4
16350,3,3,56943,56943,56946,0,3,2
16351,1,2,56944,56946,56948,2,4,0
16352,5,2,56949,56949,56951,0,2,1
16353,2,2,56951,56951,56953,0,2,0
16354,5,3,56956,56956,56959,0,3,3
16355,2,1,56958,56959,56960,1,2,0
16356,5,2,56963,56963,56965,0,2,3
16357,5,1,56968,56968,56969,0,1,3
16358,6,3,56974,56974,56977,0,3,5
16359,4,2,56978,56978,56980,0,2,1
16360,2,2,56980,56980,56982,0,2,0
16361,2,3,56982,56982,56985,0,3,0
16362,4,3,56986,56986,56989,0,3,1
16363,1,1,56987,56989,56990,2,3,0
16364,2,3,56989,56990,56993,1,4,0
16365,6,3,56995,56995,56998,0,3,2
16366,3,1,56998,56998,56999,0,1,0
16367,6,1,57004,57004,57005,0,1,5
16368,6,2,57010,57010,57012,0,2,5
16369,6,3,57016,57016,57019,0,3,4
16370,2,2,57018,57019,57021,1,3,0
16371,4,3,57022,57022,57025,0,3,1
16372,5,3,57027,57027,57030,0,3,2
16373,6,2,57033,57033,57035,0,2,3
16374,5,1,57038,57038,57039,0,1,3
16375,5,1,57043,57043,57044,0,1,4
16376,6,2,57049,57049,57051,0,2,5
16377,3,3,57052,57052,57055,0,3,1
16378,2,1,57054,57055,57056,1,2,0
16379,4,2,57058,57058,57060,0,2,2
16380,1,2,57059,57060,57062,1,3,0
16381,6,3,57065,57065,57068,0,3,3
16382,5,1,57070,57070,57071,0,1,2
16383,5,2,57075,57075,57077,0,2,4
16384,6,3,57081,57081,57084,0,3,4
16385,4,2,57085,57085,57087,0,2,1
16386,5,2,57090,57090,57092,0,2,3
16387,1,3,57091,57092,57095,1,4,0
16388,1,2,57092,57095,57097,3,5,0
16389,2,2,57094,57097,57099,3,5,0
16390,2,3,57096,57099,57102,3,6,0
16391,3,1,57099,57102,57103,3,4,0
16392,1,3,57100,57103,57106,3,6,0
16393,6,3,57106,57106,57109,0,3,0
16394,3,3,57109,57109,57112,0,3,0
16395,3,2,57112,57112,57114,0,2,0
16396,4,3,57116,57116,57119,0,3,2
16397,3,2,57119,57119,57121,0,2,0
16398,5,1,57124,57124,57125,0,1,3
16399,4,1,57128,57128,57129,0,1,3
16400,2,1,57130,57130,57131,0,1,1
16401,5,2,57135,57135,57137,0,2,4
16402,2,2,57137,57137,57139,0,2,0
16403,6,2,57143,57143,57145,0,2,4
16404,1,2,57144,57145,57147,1,3,0
16405,5,1,57149,57149,57150,0,1,2
16406,4,1,57153,57153,57154,0,1,3
16407,4,2,57157,57157,57159,0,2,3
16408,5,1,57162,57162,57163,0,1,3
16409,2,1,57164,57164,57165,0,1,1
16410,1,2,57165,57165,57167,0,2,0
16411,2,3,57167,57167,57170,0,3,0
16412,2,1,57169,57170,57171,1,2,0
16413,6,1,57175,57175,57176,0,1,4
16414,3,3,57178,57178,57181,0,3,2
16415,3,1,57181,57181,57182,0,1,0
16416,1,3,57182,57182,57185,0,3,0
16417,2,3,57184,57185,57188,1,4,0
16418,3,1,57187,57188,57189,1,2,0
16419,5,3,57192,57192,57195,0,3,3
16420,1,2,57193,57195,57197,2,4,0
16421,4,2,57197,57197,57199,0,2,0
16422,5,1,57202,57202,57203,0,1,3
16423,6,1,57208,57208,57209,0,1,5
16424,3,2,57211,57211,57213,0,2,2
16425,5,3,57216,57216,57219,0,3,3
16426,2,1,57218,57219,57220,1,2,0
16427,4,2,57222,57222,57224,0,2,2
16428,1,3,57223,57224,57227,1,4,0
16429,5,3,57228,57228,57231,0,3,1
16430,6,2,57234,57234,57236,0,2,3
16431,3,2,57237,57237,57239,0,2,1
16432,6,1,57243,57243,57244,0,1,4
16433,1,1,57244,57244,57245,0,1,0
16434,6,2,57250,57250,57252,0,2,5
16435,4,3,57254,57254,57257,0,3,2
16436,1,1,57255,57257,57258,2,3,0
16437,4,2,57259,57259,57261,0,2,1
16438,4,3,57263,57263,57266,0,3,2
16439,4,2,57267,57267,57269,0,2,1
16440,5,2,57272,57272,57274,0,2,3
16441,6,1,57278,57278,57279,0,1,4
16442,3,3,57281,57281,57284,0,3,2
16443,4,1,57285,57285,57286,0,1,1
16444,6,2,57291,57291,57293,0,2,5
16445,3,1,57294,57294,57295,0,1,1
16446,6,3,57300,57300,57303,0,3,5
16447,5,1,57305,57305,57306,0,1,2
16448,2,2,57307,57307,57309,0,2,1
16449,3,2,57310,57310,57312,0,2,1
16450,4,3,57314,57314,57317,0,3,2
16451,4,3,57318,57318,57321,0,3,1
16452,1,2,57319,57321,57323,2,4,0
16453,4,2,57323,57323,57325,0,2,0
16454,4,3,57327,57327,57330,0,3,2
16455,4,2,57331,57331,57333,0,2,1
16456,5,1,57336,57336,57337,0,1,3
16457,5,3,57341,57341,57344,0,3,4
16458,3,2,57344,57344,57346,0,2,0
16459,6,2,57350,57350,57352,0,2,4
16460,3,3,57353,57353,57356,0,3,1
16461,2,1,57355,57356,57357,1,2,0
16462,6,2,57361,57361,57363,0,2,4
16463,1,1,57362,57363,57364,1,2,0
16464,2,1,57364,57364,57365,0,1,0
16465,1,2,57365,57365,57367,0,2,0
16466,1,1,57366,57367,57368,1,2,0
16467,2,3,57368,57368,57371,0,3,0
16468,4,1,57372,57372,57373,0,1,1
16469,1,2,57373,57373,57375,0,2,0
16470,5,1,57378,57378,57379,0,1,3
16471,3,1,57381,57381,57382,0,1,2
16472,1,3,57382,57382,57385,0,3,0
16473,3,1,57385,57385,57386,0,1,0
16474,1,2,57386,57386,57388,0,2,0
16475,6,1,57392,57392,57393,0,1,4
16476,5,3,57397,57397,57400,0,3,4
16477,5,1,57402,57402,57403,0,1,2
16478,2,2,57404,57404,57406,0,2,1
16479,2,3,57406,57406,57409,0,3,0
16480,1,2,57407,57409,57411,2,4,0
16481,2,1,57409,57411,57412,2,3,0
16482,3,3,57412,57412,57415,0,3,0
16483,1,1,57413,57415,57416,2,3,0
16484,1,1,57414,57416,57417,2,3,0
16485,6,1,57420,57420,57421,0,1,3
16486,4,2,57424,57424,57426,0,2,3
16487,2,1,57426,57426,57427,0,1,0
16488,3,1,57429,57429,57430,0,1,2
16489,3,3,57432,57432,57435,0,3,2
16490,4,1,57436,57436,57437,0,1,1
16491,4,3,57440,57440,57443,0,3,3
16492,3,3,57443,57443,57446,0,3,0
16493,5,1,57448,57448,57449,0,1,2
16494,2,3,57450,57450,57453,0,3,1
16495,6,1,57456,57456,57457,0,1,3
16496,1,1,57457,57457,57458,0,1,0
16497,4,2,57461,57461,57463,0,2,3
16498,5,2,57466,57466,57468,0,2,3
16499,5,2,57471,57471,57473,0,2,3
16500,4,2,57475,57475,57477,0,2,2
16501,2,2,57477,57477,57479,0,2,0
16502,4,2,57481,57481,57483,0,2,2
16503,3,3,57484,57484,57487,0,3,1
16504,1,2,57485,57487,57489,2,4,0
16505,2,2,57487,57489,57491,2,4,0
16506,6,2,57493,57493,57495,0,2,2
16507,6,1,57499,57499,57500,0,1,4
16508,4,2,57503,57503,57505,0,2,3
16509,3,3,57506,57506,57509,0,3,1
16510,2,1,57508,57509,57510,1,2,0
16511,1,3,57509,57510,57513,1,4,0
16512,5,2,57514,57514,57516,0,2,1
16513,4,2,57518,57518,57520,0,2,2
16514,1,2,57519,57520,57522,1,3,0
16515,4,2,57523,57523,57525,0,2,1
16516,4,3,57527,57527,57530,0,3,2
16517,1,3,57528,57530,57533,2,5,0
16518,4,2,57532,57533,57535,1,3,0
16519,5,3,57537,57537,57540,0,3,2
16520,1,1,57538,57540,57541,2,3,0
16521,6,2,57544,57544,57546,0,2,3
16522,5,3,57549,57549,57552,0,3,3
16523,4,3,57553,57553,57556,0,3,1
16524,3,2,57556,57556,57558,0,2,0
16525,6,3,57562,57562,57565,0,3,4
16526,2,2,57564,57565,57567,1,3,0
16527,2,1,57566,57567,57568,1,2,0
16528,6,3,57572,57572,57575,0,3,4
16529,3,2,57575,57575,57577,0,2,0
16530,3,2,57578,57578,57580,0,2,1
16531,2,2,57580,57580,57582,0,2,0
16532,5,1,57585,57585,57586,0,1,3
16533,1,1,57586,57586,57587,0,1,0
16534,5,1,57591,57591,57592,0,1,4
16535,3,1,57594,57594,57595,0,1,2
16536,4,1,57598,57598,57599,0,1,3
16537,1,3,57599,57599,57602,0,3,0
16538,4,3,57603,57603,57606,0,3,1
16539,4,3,57607,57607,57610,0,3,1
16540,4,2,57611,57611,57613,0,2,1
16541,5,1,57616,57616,57617,0,1,3
16542,5,2,57621,57621,57623,0,2,4
16543,1,3,57622,57623,57626,1,4,0
16544,6,3,57628,57628,57631,0,3,2
16545,5,1,57633,57633,57634,0,1,2
16546,5,2,57638,57638,57640,0,2,4
16547,2,3,57640,57640,57643,0,3,0
16548,4,2,57644,57644,57646,0,2,1
16549,2,2,57646,57646,57648,0,2,0
16550,5,1,57651,57651,57652,0,1,3
16551,3,2,57654,57654,57656,0,2,2
16552,3,1,57657,57657,57658,0,1,1
16553,2,3,57659,57659,57662,0,3,1
16554,2,3,57661,57662,57665,1,4,0
16555,6,3,57667,57667,57670,0,3,2
16556,2,3,57669,57670,57673,1,4,0
16557,5,1,57674,57674,57675,0,1,1
16558,1,2,57675,57675,57677,0,2,0
16559,6,3,57681,57681,57684,0,3,4
16560,5,2,57686,57686,57688,0,2,2
16561,5,1,57691,57691,57692,0,1,3
16562,3,3,57694,57694,57697,0,3,2
16563,1,1,57695,57697,57698,2,3,0
16564,4,3,57699,57699,57702,0,3,1
16565,4,1,57703,57703,57704,0,1,1
16566,5,3,57708,57708,57711,0,3,4
16567,5,3,57713,57713,57716,0,3,2
16568,5,2,57718,57718,57720,0,2,2
16569,4,2,57722,57722,57724,0,2,2
16570,5,3,57727,57727,57730,0,3,3
16571,4,1,57731,57731,57732,0,1,1
16572,1,1,57732,57732,57733,0,1,0
16573,1,3,57733,57733,57736,0,3,0
16574,2,3,57735,57736,57739,1,4,0
16575,4,1,57739,57739,57740,0,1,0
16576,4,2,57743,57743,57745,0,2,3
16577,2,2,57745,57745,57747,0,2,0
16578,3,1,57748,57748,57749,0,1,1
16579,2,2,57750,57750,57752,0,2,1
16580,5,3,57755,57755,57758,0,3,3
16581,2,2,57757,57758,57760,1,3,0
16582,3,2,57760,57760,57762,0,2,0
16583,6,1,57766,57766,57767,0,1,4
16584,5,2,57771,57771,57773,0,2,4
16585,4,3,57775,57775,57778,0,3,2
16586,3,3,57778,57778,57781,0,3,0
16587,3,2,57781,57781,57783,0,2,0
16588,6,2,57787,57787,57789,0,2,4
16589,5,1,57792,57792,57793,0,1,3
16590,3,3,57795,57795,57798,0,3,2
16591,6,3,57801,57801,57804,0,3,3
16592,3,1,57804,57804,57805,0,1,0
16593,2,1,57806,57806,57807,0,1,1
16594,4,2,57810,57810,57812,0,2,3
16595,6,2,57816,57816,57818,0,2,4
16596,4,1,57820,57820,57821,0,1,2
16597,1,1,57821,57821,57822,0,1,0
16598,4,1,57825,57825,57826,0,1,3
16599,4,1,57829,57829,57830,0,1,3
16600,3,3,57832,57832,57835,0,3,2
16601,3,1,57835,57835,57836,0,1,0
16602,6,3,57841,57841,57844,0,3,5
16603,6,2,57847,57847,57849,0,2,3
16604,5,1,57852,57852,57853,0,1,3
16605,5,1,57857,57857,57858,0,1,4
16606,6,3,57863,57863,57866,0,3,5
16607,5,2,57868,57868,57870,0,2,2
16608,5,3,57873,57873,57876,0,3,3
16609,5,2,57878,57878,57880,0,2,2
16610,4,1,57882,57882,57883,0,1,2
16611,6,3,57888,57888,57891,0,3,5
16612,6,1,57894,57894,57895,0,1,3
16613,4,3,57898,57898,57901,0,3,3
16614,6,1,57904,57904,57905,0,1,3
16615,1,2,57905,57905,57907,0,2,0
16616,1,2,57906,57907,57909,1,3,0
16617,5,2,57911,57911,57913,0,2,2
16618,1,1,57912,57913,57914,1,2,0
16619,4,2,57916,57916,57918,0,2,2
16620,1,2,57917,57918,57920,1,3,0
16621,2,3,57919,57920,57923,1,4,0
16622,3,2,57922,57923,57925,1,3,0
16623,4,3,57926,57926,57929,0,3,1
16624,1,1,57927,57929,57930,2,3,0
16625,2,1,57929,57930,57931,1,2,0
16626,6,1,57935,57935,57936,0,1,4
16627,6,2,57941,57941,57943,0,2,5
16628,6,1,57947,57947,57948,0,1,4
16629,1,2,57948,57948,57950,0,2,0
16630,1,1,57949,57950,57951,1,2,0
16631,6,3,57955,57955,57958,0,3,4
16632,4,2,57959,57959,57961,0,2,1
16633,6,3,57965,57965,57968,0,3,4
16634,1,2,57966,57968,57970,2,4,0
16635,2,1,57968,57970,57971,2,3,0
16636,5,3,57973,57973,57976,0,3,2
16637,4,1,57977,57977,57978,0,1,1
16638,6,2,57983,57983,57985,0,2,5
16639,1,3,57984,57985,57988,1,4,0
16640,4,3,57988,57988,57991,0,3,0
16641,3,3,57991,57991,57994,0,3,0
16642,4,1,57995,57995,57996,0,1,1
16643,5,1,58000,58000,58001,0,1,4
16644,5,1,58005,58005,58006,0,1,4
16645,2,1,58007,58007,58008,0,1,1
16646,1,1,58008,58008,58009,0,1,0
16647,2,1,58010,58010,58011,0,1,1
16648,5,3,58015,58015,58018,0,3,4
16649,4,3,58019,58019,58022,0,3,1
16650,6,2,58025,58025,58027,0,2,3
16651,5,3,58030,58030,58033,0,3,3
16652,2,2,58032,58033,58035,1,3,0
16653,5,3,58037,58037,58040,0,3,2
16654,3,3,58040,58040,58043,0,3,0
16655,1,2,58041,58043,58045,2,4,0
16656,1,1,58042,58045,58046,3,4,0
16657,3,2,58045,58046,58048,1,3,0
16658,5,1,58050,58050,58051,0,1,2
16659,6,2,58056,58056,58058,0,2,5
16660,5,3,58061,58061,58064,0,3,3
16661,5,2,58066,58066,58068,0,2,2
16662,4,3,58070,58070,58073,0,3,2
16663,5,2,58075,58075,58077,0,2,2
16664,6,2,58081,58081,58083,0,2,4
16665,2,3,58083,58083,58086,0,3,0
16666,3,1,58086,58086,58087,0,1,0
16667,3,1,58089,58089,58090,0,1,2
16668,5,3,58094,58094,58097,0,3,4
16669,5,2,58099,58099,58101,0,2,2
16670,2,2,58101,58101,58103,0,2,0
16671,1,1,58102,58103,58104,1,2,0
16672,4,2,58106,58106,58108,0,2,2
16673,4,1,58110,58110,58111,0,1,2
16674,1,3,58111,58111,58114,0,3,0
16675,5,2,58116,58116,58118,0,2,2
16676,4,2,58120,58120,58122,0,2,2
16677,4,1,58124,58124,58125,0,1,2
16678,1,2,58125,58125,58127,0,2,0
16679,2,1,58127,58127,58128,0,1,0
16680,5,1,58132,58132,58133,0,1,4
16681,4,2,58136,58136,58138,0,2,3
16682,3,1,58139,58139,58140,0,1,1
16683,3,3,58142,58142,58145,0,3,2
16684,5,1,58147,58147,58148,0,1,2
16685,4,1,58151,58151,58152,0,1,3
16686,6,3,58157,58157,58160,0,3,5
16687,4,2,58161,58161,58163,0,2,1
16688,1,2,58162,58163,58165,1,3,0
16689,4,3,58166,58166,58169,0,3,1
16690,4,1,58170,58170,58171,0,1,1
16691,3,3,58173,58173,58176,0,3,2
16692,3,2,58176,58176,58178,0,2,0
16693,3,2,58179,58179,58181,0,2,1
16694,2,1,58181,58181,58182,0,1,0
16695,3,2,58184,58184,58186,0,2,2
16696,6,1,58190,58190,58191,0,1,4
16697,3,1,58193,58193,58194,0,1,2
16698,3,2,58196,58196,58198,0,2,2
16699,4,2,58200,58200,58202,0,2,2
16700,4,3,58204,58204,58207,0,3,2
16701,1,3,58205,58207,58210,2,5,0
16702,4,2,58209,58210,58212,1,3,0
16703,5,1,58214,58214,58215,0,1,2
16704,6,2,58220,58220,58222,0,2,5
16705,2,1,58222,58222,58223,0,1,0
16706,3,2,58225,58225,58227,0,2,2
16707,5,1,58230,58230,58231,0,1,3
16708,3,1,58233,58233,58234,0,1,2
16709,4,1,58237,58237,58238,0,1,3
16710,1,3,58238,58238,58241,0,3,0
16711,5,2,58243,58243,58245,0,2,2
16712,4,3,58247,58247,58250,0,3,2
16713,1,2,58248,58250,58252,2,4,0
16714,2,2,58250,58252,58254,2,4,0
16715,2,3,58252,58254,58257,2,5,0
16716,5,2,58257,58257,58259,0,2,0
16717,5,3,58262,58262,58265,0,3,3
16718,2,3,58264,58265,58268,1,4,0
16719,6,2,58270,58270,58272,0,2,2
16720,2,3,58272,58272,58275,0,3,0
16721,5,1,58277,58277,58278,0,1,2
16722,2,2,58279,58279,58281,0,2,1
16723,3,2,58282,58282,58284,0,2,1
16724,4,3,58286,58286,58289,0,3,2
16725,3,2,58289,58289,58291,0,2,0
16726,1,3,58290,58291,58294,1,4,0
16727,5,3,58295,58295,58298,0,3,1
16728,1,3,58296,58298,58301,2,5,0
16729,4,1,58300,58301,58302,1,2,0
16730,6,1,58306,58306,58307,0,1,4
16731,4,2,58310,58310,58312,0,2,3
16732,2,3,58312,58312,58315,0,3,0
16733,1,1,58313,58315,58316,2,3,0
16734,1,3,58314,58316,58319,2,5,0
16735,5,3,58319,58319,58322,0,3,0
16736,1,1,58320,58322,58323,2,3,0
16737,2,3,58322,58323,58326,1,4,0
16738,5,3,58327,58327,58330,0,3,1
16739,2,3,58329,58330,58333,1,4,0
16740,2,3,58331,58333,58336,2,5,0
16741,1,3,58332,58336,58339,4,7,0
16742,3,3,58335,58339,58342,4,7,0
16743,3,1,58338,58342,58343,4,5,0
16744,5,3,58343,58343,58346,0,3,0
16745,4,2,58347,58347,58349,0,2,1
16746,3,1,58350,58350,58351,0,1,1
16747,2,1,58352,58352,58353,0,1,1
16748,5,1,58357,58357,58358,0,1,4
16749,4,2,58361,58361,58363,0,2,3
16750,4,3,58365,58365,58368,0,3,2
16751,4,2,58369,58369,58371,0,2,1
16752,3,1,58372,58372,58373,0,1,1
16753,6,1,58378,58378,58379,0,1,5
16754,1,2,58379,58379,58381,0,2,0
16755,3,2,58382,58382,58384,0,2,1
16756,3,3,58385,58385,58388,0,3,1
16757,6,3,58391,58391,58394,0,3,3
16758,1,2,58392,58394,58396,2,4,0
16759,2,1,58394,58396,58397,2,3,0
16760,4,3,58398,58398,58401,0,3,1
16761,6,3,58404,58404,58407,0,3,3
16762,2,3,58406,58407,58410,1,4,0
16763,6,2,58412,58412,58414,0,2,2
16764,4,3,58416,58416,58419,0,3,2
16765,4,3,58420,58420,58423,0,3,1
16766,3,3,58423,58423,58426,0,3,0
16767,3,2,58426,58426,58428,0,2,0
16768,4,2,58430,58430,58432,0,2,2
16769,6,1,58436,58436,58437,0,1,4
16770,4,2,58440,58440,58442,0,2,3
16771,2,3,58442,58442,58445,0,3,0
16772,6,3,58448,58448,58451,0,3,3
16773,3,1,58451,58451,58452,0,1,0
16774,6,2,58457,58457,58459,0,2,5
16775,2,2,58459,58459,58461,0,2,0
16776,4,2,58463,58463,58465,0,2,2
16777,6,3,58469,58469,58472,0,3,4
16778,3,3,58472,58472,58475,0,3,0
16779,1,3,58473,58475,58478,2,5,0
16780,2,3,58475,58478,58481,3,6,0
16781,3,3,58478,58481,58484,3,6,0
16782,4,2,58482,58484,58486,2,4,0
16783,4,1,58486,58486,58487,0,1,0
16784,1,3,58487,58487,58490,0,3,0
16785,6,1,58493,58493,58494,0,1,3
16786,3,1,58496,58496,58497,0,1,2
16787,2,1,58498,58498,58499,0,1,1
16788,4,1,58502,58502,58503,0,1,3
16789,3,2,58505,58505,58507,0,2,2
16790,5,1,58510,58510,58511,0,1,3
16791,3,2,58513,58513,58515,0,2,2
16792,6,1,58519,58519,58520,0,1,4
16793,5,3,58524,58524,58527,0,3,4
16794,3,2,58527,58527,58529,0,2,0
16795,4,3,58531,58531,58534,0,3,2
16796,6,1,58537,58537,58538,0,1,3
16797,6,2,58543,58543,58545,0,2,5
16798,3,2,58546,58546,58548,0,2,1
16799,6,2,58552,58552,58554,0,2,4
16800,1,1,58553,58554,58555,1,2,0
16801,1,2,58554,58555,58557,1,3,0
16802,2,1,58556,58557,58558,1,2,0
16803,1,2,58557,58558,58560,1,3,0
16804,1,2,58558,58560,58562,2,4,0
16805,3,2,58561,58562,58564,1,3,0
16806,1,2,58562,58564,58566,2,4,0
16807,5,2,58567,58567,58569,0,2,1
16808,2,1,58569,58569,58570,0,1,0
16809,2,3,58571,58571,58574,0,3,1
16810,2,1,58573,58574,58575,1,2,0
16811,3,2,58576,58576,58578,0,2,1
16812,2,3,58578,58578,58581,0,3,0
16813,1,1,58579,58581,58582,2,3,0
16814,5,1,58584,58584,58585,0,1,2
16815,1,2,58585,58585,58587,0,2,0
16816,6,3,58591,58591,58594,0,3,4
16817,4,3,58595,58595,58598,0,3,1
16818,1,2,58596,58598,58600,2,4,0
16819,5,3,58601,58601,58604,0,3,1
16820,5,3,58606,58606,58609,0,3,2
16821,2,3,58608,58609,58612,1,4,0
16822,4,1,58612,58612,58613,0,1,0
16823,2,2,58614,58614,58616,0,2,1
16824,2,2,58616,58616,58618,0,2,0
16825,3,1,58619,58619,58620,0,1,1
16826,3,2,58622,58622,58624,0,2,2
16827,1,1,58623,58624,58625,1,2,0
16828,6,3,58629,58629,58632,0,3,4
16829,4,1,58633,58633,58634,0,1,1
16830,3,1,58636,58636,58637,0,1,2
16831,6,3,58642,58642,58645,0,3,5
16832,6,3,58648,58648,58651,0,3,3
16833,3,2,58651,58651,58653,0,2,0
16834,5,2,58656,58656,58658,0,2,3
16835,2,2,58658,58658,58660,0,2,0
16836,4,1,58662,58662,58663,0,1,2
16837,5,1,58667,58667,58668,0,1,4
16838,3,1,58670,58670,58671,0,1,2
16839,2,1,58672,58672,58673,0,1,1
16840,3,1,58675,58675,58676,0,1,2
16841,6,2,58681,58681,58683,0,2,5
16842,2,3,58683,58683,58686,0,3,0
16843,1,2,58684,58686,58688,2,4,0
16844,2,3,58686,58688,58691,2,5,0
16845,4,2,58690,58691,58693,1,3,0
16846,1,2,58691,58693,58695,2,4,0
16847,6,3,58697,58697,58700,0,3,2
16848,5,2,58702,58702,58704,0,2,2
16849,4,1,58706,58706,58707,0,1,2
16850,2,2,58708,58708,58710,0,2,1
16851,2,3,58710,58710,58713,0,3,0
16852,4,1,58714,58714,58715,0,1,1
16853,3,1,58717,58717,58718,0,1,2
16854,3,1,58720,58720,58721,0,1,2
16855,4,2,58724,58724,58726,0,2,3
16856,5,1,58729,58729,58730,0,1,3
16857,5,2,58734,58734,58736,0,2,4
16858,4,2,58738,58738,58740,0,2,2
16859,3,3,58741,58741,58744,0,3,1
16860,2,2,58743,58744,58746,1,3,0
16861,6,1,58749,58749,58750,0,1,3
16862,2,1,58751,58751,58752,0,1,1
16863,5,3,58756,58756,58759,0,3,4
16864,4,2,58760,58760,58762,0,2,1
16865,5,3,58765,58765,58768,0,3,3
16866,2,2,58767,58768,58770,1,3,0
16867,1,3,58768,58770,58773,2,5,0
16868,4,3,58772,58773,58776,1,4,0
16869,5,1,58777,58777,58778,0,1,1
16870,5,3,58782,58782,58785,0,3,4
16871,6,3,58788,58788,58791,0,3,3
16872,1,2,58789,58791,58793,2,4,0
16873,1,2,58790,58793,58795,3,5,0
16874,1,1,58791,58795,58796,4,5,0
16875,4,3,58795,58796,58799,1,4,0
16876,1,1,58796,58799,58800,3,4,0
16877,3,1,58799,58800,58801,1,2,0
16878,2,3,58801,58801,58804,0,3,0
16879,1,3,58802,58804,58807,2,5,0
16880,1,1,58803,58807,58808,4,5,0
16881,4,1,58807,58808,58809,1,2,0
16882,4,3,58811,58811,58814,0,3,2
16883,1,2,58812,58814,58816,2,4,0
16884,1,1,58813,58816,58817,3,4,0
16885,2,3,58815,58817,58820,2,5,0
16886,2,1,58817,58820,58821,3,4,0
16887,4,2,58821,58821,58823,0,2,0
16888,1,2,58822,58823,58825,1,3,0
16889,2,1,58824,58825,58826,1,2,0
16890,3,1,58827,58827,58828,0,1,1
16891,1,1,58828,58828,58829,0,1,0
16892,4,3,58832,58832,58835,0,3,3
16893,6,3,58838,58838,58841,0,3,3
16894,4,2,58842,58842,58844,0,2,1
16895,1,2,58843,58844,58846,1,3,0
16896,5,1,58848,58848,58849,0,1,2
16897,2,2,58850,58850,58852,0,2,1
16898,4,1,58854,58854,58855,0,1,2
16899,1,1,58855,58855,58856,0,1,0
16900,6,1,58861,58861,58862,0,1,5
16901,5,2,58866,58866,58868,0,2,4
16902,5,2,58871,58871,58873,0,2,3
16903,4,1,58875,58875,58876,0,1,2
16904,3,3,58878,58878,58881,0,3,2
16905,4,2,58882,58882,58884,0,2,1
16906,5,3,58887,58887,58890,0,3,3
16907,3,1,58890,58890,58891,0,1,0
16908,2,2,58892,58892,58894,0,2,1
16909,3,1,58895,58895,58896,0,1,1
16910,5,2,58900,58900,58902,0,2,4
16911,1,3,58901,58902,58905,1,4,0
16912,6,1,58907,58907,58908,0,1,2
16913,4,3,58911,58911,58914,0,3,3
16914,2,3,58913,58914,58917,1,4,0
16915,4,3,58917,58917,58920,0,3,0
16916,6,2,58923,58923,58925,0,2,3
16917,2,3,58925,58925,58928,0,3,0
16918,1,2,58926,58928,58930,2,4,0
16919,1,1,58927,58930,58931,3,4,0
16920,1,3,58928,58931,58934,3,6,0
16921,6,1,58934,58934,58935,0,1,0
16922,1,3,58935,58935,58938,0,3,0
16923,4,1,58939,58939,58940,0,1,1
16924,2,3,58941,58941,58944,0,3,1
16925,1,1,58942,58944,58945,2,3,0
16926,5,3,58947,58947,58950,0,3,2
16927,6,1,58953,58953,58954,0,1,3
16928,6,2,58959,58959,58961,0,2,5
16929,4,2,58963,58963,58965,0,2,2
16930,3,2,58966,58966,58968,0,2,1
16931,3,1,58969,58969,58970,0,1,1
16932,3,1,58972,58972,58973,0,1,2
16933,1,2,58973,58973,58975,0,2,0
16934,5,2,58978,58978,58980,0,2,3
16935,6,2,58984,58984,58986,0,2,4
16936,2,3,58986,58986,58989,0,3,0
16937,1,3,58987,58989,58992,2,5,0
16938,3,3,58990,58992,58995,2,5,0
16939,4,3,58994,58995,58998,1,4,0
16940,2,1,58996,58998,58999,2,3,0
16941,4,3,59000,59000,59003,0,3,1
16942,5,2,59005,59005,59007,0,2,2
16943,1,1,59006,59007,59008,1,2,0
16944,2,2,59008,59008,59010,0,2,0
16945,5,3,59013,59013,59016,0,3,3
16946,5,3,59018,59018,59021,0,3,2
16947,1,1,59019,59021,59022,2,3,0
16948,5,1,59024,59024,59025,0,1,2
16949,1,3,59025,59025,59028,0,3,0
16950,1,3,59026,59028,59031,2,5,0
16951,3,2,59029,59031,59033,2,4,0
16952,3,3,59032,59033,59036,1,4,0
16953,5,3,59037,59037,59040,0,3,1
16954,2,3,59039,59040,59043,1,4,0
16955,4,3,59043,59043,59046,0,3,0
16956,5,3,59048,59048,59051,0,3,2
16957,3,1,59051,59051,59052,0,1,0
16958,6,2,59057,59057,59059,0,2,5
16959,4,3,59061,59061,59064,0,3,2
16960,4,2,59065,59065,59067,0,2,1
16961,4,3,59069,59069,59072,0,3,2
16962,3,3,59072,59072,59075,0,3,0
16963,3,2,59075,59075,59077,0,2,0
16964,1,3,59076,59077,59080,1,4,0
16965,3,3,59079,59080,59083,1,4,0
16966,5,2,59084,59084,59086,0,2,1
16967,4,1,59088,59088,59089,0,1,2
16968,6,3,59094,59094,59097,0,3,5
16969,2,1,59096,59097,59098,1,2,0
16970,5,2,59101,59101,59103,0,2,3
16971,1,1,59102,59103,59104,1,2,0
16972,6,1,59108,59108,59109,0,1,4
16973,3,1,59111,59111,59112,0,1,2
16974,2,1,59113,59113,59114,0,1,1
16975,1,2,59114,59114,59116,0,2,0
16976,4,2,59118,59118,59120,0,2,2
16977,4,1,59122,59122,59123,0,1,2
16978,6,2,59128,59128,59130,0,2,5
16979,1,2,59129,59130,59132,1,3,0
16980,2,3,59131,59132,59135,1,4,0
16981,3,2,59134,59135,59137,1,3,0
16982,3,2,59137,59137,59139,0,2,0
16983,6,3,59143,59143,59146,0,3,4
16984,3,2,59146,59146,59148,0,2,0
16985,4,1,59150,59150,59151,0,1,2
16986,4,2,59154,59154,59156,0,2,3
16987,6,2,59160,59160,59162,0,2,4
16988,1,1,59161,59162,59163,1,2,0
16989,2,3,59163,59163,59166,0,3,0
16990,1,2,59164,59166,59168,2,4,0
16991,1,2,59165,59168,59170,3,5,0
16992,4,1,59169,59170,59171,1,2,0
16993,3,2,59172,59172,59174,0,2,1
16994,2,3,59174,59174,59177,0,3,0
16995,6,1,59180,59180,59181,0,1,3
16996,4,1,59184,59184,59185,0,1,3
16997,1,1,59185,59185,59186,0,1,0
16998,1,3,59186,59186,59189,0,3,0
16999,4,2,59190,59190,59192,0,2,1
17000,5,1,59195,59195,59196,0,1,3
17001,6,3,59201,59201,59204,0,3,5
17002,6,1,59207,59207,59208,0,1,3
17003,3,3,59210,59210,59213,0,3,2
17004,6,3,59216,59216,59219,0,3,3
17005,6,3,59222,59222,59225,0,3,3
17006,3,3,59225,59225,59228,0,3,0
17007,4,1,59229,59229,59230,0,1,1
17008,5,1,59234,59234,59235,0,1,4
17009,1,3,59235,59235,59238,0,3,0
17010,3,2,59238,59238,59240,0,2,0
17011,6,2,59244,59244,59246,0,2,4
17012,6,3,59250,59250,59253,0,3,4
17013,4,3,59254,59254,59257,0,3,1
17014,1,1,59255,59257,59258,2,3,0
17015,6,3,59261,59261,59264,0,3,3
17016,3,2,59264,59264,59266,0,2,0
17017,1,1,59265,59266,59267,1,2,0
17018,6,3,59271,59271,59274,0,3,4
17019,5,2,59276,59276,59278,0,2,2
17020,1,1,59277,59278,59279,1,2,0
17021,2,1,59279,59279,59280,0,1,0
17022,5,3,59284,59284,59287,0,3,4
17023,3,1,59287,59287,59288,0,1,0
17024,4,3,59291,59291,59294,0,3,3
17025,6,1,59297,59297,59298,0,1,3
17026,4,3,59301,59301,59304,0,3,3
17027,2,1,59303,59304,59305,1,2,0
17028,6,1,59309,59309,59310,0,1,4
17029,2,1,59311,59311,59312,0,1,1
17030,6,2,59317,59317,59319,0,2,5
17031,3,1,59320,59320,59321,0,1,1
17032,4,2,59324,59324,59326,0,2,3
17033,2,1,59326,59326,59327,0,1,0
17034,1,3,59327,59327,59330,0,3,0
17035,2,2,59329,59330,59332,1,3,0
17036,4,3,59333,59333,59336,0,3,1
17037,1,2,59334,59336,59338,2,4,0
17038,3,2,59337,59338,59340,1,3,0
17039,6,2,59343,59343,59345,0,2,3
17040,4,2,59347,59347,59349,0,2,2
17041,4,2,59351,59351,59353,0,2,2
17042,5,1,59356,59356,59357,0,1,3
17043,6,3,59362,59362,59365,0,3,5
17044,3,1,59365,59365,59366,0,1,0
17045,5,3,59370,59370,59373,0,3,4
17046,6,3,59376,59376,59379,0,3,3
17047,2,3,59378,59379,59382,1,4,0
17048,3,3,59381,59382,59385,1,4,0
17049,3,1,59384,59385,59386,1,2,0
17050,5,2,59389,59389,59391,0,2,3
17051,3,2,59392,59392,59394,0,2,1
17052,6,1,59398,59398,59399,0,1,4
17053,1,3,59399,59399,59402,0,3,0
17054,3,2,59402,59402,59404,0,2,0
17055,6,1,59408,59408,59409,0,1,4
17056,4,3,59412,59412,59415,0,3,3
17057,6,1,59418,59418,59419,0,1,3
17058,3,2,59421,59421,59423,0,2,2
17059,4,1,59425,59425,59426,0,1,2
17060,1,2,59426,59426,59428,0,2,0
17061,4,1,59430,59430,59431,0,1,2
17062,4,2,59434,59434,59436,0,2,3
17063,4,3,59438,59438,59441,0,3,2
17064,6,1,59444,59444,59445,0,1,3
17065,4,2,59448,59448,59450,0,2,3
17066,2,1,59450,59450,59451,0,1,0
17067,6,3,59456,59456,59459,0,3,5
17068,6,3,59462,59462,59465,0,3,3
17069,6,1,59468,59468,59469,0,1,3
17070,2,1,59470,59470,59471,0,1,1
17071,3,1,59473,59473,59474,0,1,2
17072,4,3,59477,59477,59480,0,3,3
17073,3,1,59480,59480,59481,0,1,0
17074,4,2,59484,59484,59486,0,2,3
17075,3,3,59487,59487,59490,0,3,1
17076,4,1,59491,59491,59492,0,1,1
17077,5,2,59496,59496,59498,0,2,4
17078,3,2,59499,59499,59501,0,2,1
17079,4,2,59503,59503,59505,0,2,2
17080,3,2,59506,59506,59508,0,2,1
17081,6,3,59512,59512,59515,0,3,4
17082,3,2,59515,59515,59517,0,2,0
17083,5,3,59520,59520,59523,0,3,3
17084,2,1,59522,59523,59524,1,2,0
17085,3,1,59525,59525,59526,0,1,1
17086,5,1,59530,59530,59531,0,1,4
17087,3,1,59533,59533,59534,0,1,2
17088,5,3,59538,59538,59541,0,3,4
17089,3,2,59541,59541,59543,0,2,0
17090,4,3,59545,59545,59548,0,3,2
17091,1,3,59546,59548,59551,2,5,0
17092,4,2,59550,59551,59553,1,3,0
17093,1,1,59551,59553,59554,2,3,0
17094,2,1,59553,59554,59555,1,2,0
17095,1,2,59554,59555,59557,1,3,0
17096,3,1,59557,59557,59558,0,1,0
17097,3,1,59560,59560,59561,0,1,2
17098,3,3,59563,59563,59566,0,3,2
17099,3,3,59566,59566,59569,0,3,0
17100,6,1,59572,59572,59573,0,1,3
17101,3,2,59575,59575,59577,0,2,2
17102,6,3,59581,59581,59584,0,3,4
17103,3,3,59584,59584,59587,0,3,0
17104,2,1,59586,59587,59588,1,2,0
17105,3,3,59589,59589,59592,0,3,1
17106,4,3,59593,59593,59596,0,3,1
17107,6,3,59599,59599,59602,0,3,3
17108,1,3,59600,59602,59605,2,5,0
17109,4,2,59604,59605,59607,1,3,0
17110,1,3,59605,59607,59610,2,5,0
17111,6,2,59611,59611,59613,0,2,1
17112,1,1,59612,59613,59614,1,2,0
17113,4,1,59616,59616,59617,0,1,2
17114,3,2,59619,59619,59621,0,2,2
17115,1,3,59620,59621,59624,1,4,0
17116,6,3,59626,59626,59629,0,3,2
17117,4,2,59630,59630,59632,0,2,1
17118,1,3,59631,59632,59635,1,4,0
17119,2,1,59633,59635,59636,2,3,0
17120,6,2,59639,59639,59641,0,2,3
17121,2,2,59641,59641,59643,0,2,0
17122,6,3,59647,59647,59650,0,3,4
17123,5,2,59652,59652,59654,0,2,2
17124,3,3,59655,59655,59658,0,3,1
17125,5,2,59660,59660,59662,0,2,2
17126,1,1,59661,59662,59663,1,2,0
17127,2,2,59663,59663,59665,0,2,0
17128,6,1,59669,59669,59670,0,1,4
17129,6,1,59675,59675,59676,0,1,5
17130,4,3,59679,59679,59682,0,3,3
17131,5,3,59684,59684,59687,0,3,2
17132,1,3,59685,59687,59690,2,5,0
17133,1,1,59686,59690,59691,4,5,0
17134,4,1,59690,59691,59692,1,2,0
17135,1,3,59691,59692,59695,1,4,0
17136,3,1,59694,59695,59696,1,2,0
17137,6,3,59700,59700,59703,0,3,4
17138,6,1,59706,59706,59707,0,1,3
17139,3,2,59709,59709,59711,0,2,2
17140,3,1,59712,59712,59713,0,1,1
17141,6,2,59718,59718,59720,0,2,5
17142,4,3,59722,59722,59725,0,3,2
17143,6,1,59728,59728,59729,0,1,3
17144,5,3,59733,59733,59736,0,3,4
17145,3,2,59736,59736,59738,0,2,0
17146,3,3,59739,59739,59742,0,3,1
17147,1,1,59740,59742,59743,2,3,0
17148,6,2,59746,59746,59748,0,2,3
17149,3,2,59749,59749,59751,0,2,1
17150,4,3,59753,59753,59756,0,3,2
17151,2,3,59755,59756,59759,1,4,0
17152,1,2,59756,59759,59761,3,5,0
17153,5,2,59761,59761,59763,0,2,0
17154,2,1,59763,59763,59764,0,1,0
17155,4,1,59767,59767,59768,0,1,3
17156,5,2,59772,59772,59774,0,2,4
17157,5,3,59777,59777,59780,0,3,3
17158,4,1,59781,59781,59782,0,1,1
17159,3,1,59784,59784,59785,0,1,2
17160,6,3,59790,59790,59793,0,3,5
17161,6,1,59796,59796,59797,0,1,3
17162,3,1,59799,59799,59800,0,1,2
17163,5,2,59804,59804,59806,0,2,4
17164,1,3,59805,59806,59809,1,4,0
17165,6,3,59811,59811,59814,0,3,2
17166,4,3,59815,59815,59818,0,3,1
17167,5,2,59820,59820,59822,0,2,2
17168,6,2,59826,59826,59828,0,2,4
17169,5,2,59831,59831,59833,0,2,3
17170,5,2,59836,59836,59838,0,2,3
17171,3,3,59839,59839,59842,0,3,1
17172,6,1,59845,59845,59846,0,1,3
17173,6,1,59851,59851,59852,0,1,5
17174,4,3,59855,59855,59858,0,3,3
17175,3,3,59858,59858,59861,0,3,0
17176,5,2,59863,59863,59865,0,2,2
17177,2,1,59865,59865,59866,0,1,0
17178,1,2,59866,59866,59868,0,2,0
17179,2,3,59868,59868,59871,0,3,0
17180,4,2,59872,59872,59874,0,2,1
17181,6,2,59878,59878,59880,0,2,4
17182,5,1,59883,59883,59884,0,1,3
17183,3,2,59886,59886,59888,0,2,2
17184,4,2,59890,59890,59892,0,2,2
17185,1,1,59891,59892,59893,1,2,0
17186,2,3,59893,59893,59896,0,3,0
17187,3,3,59896,59896,59899,0,3,0
17188,2,2,59898,59899,59901,1,3,0
17189,6,3,59904,59904,59907,0,3,3
17190,6,2,59910,59910,59912,0,2,3
17191,6,3,59916,59916,59919,0,3,4
17192,3,3,59919,59919,59922,0,3,0
17193,3,3,59922,59922,59925,0,3,0
17194,3,3,59925,59925,59928,0,3,0
17195,1,3,59926,59928,59931,2,5,0
17196,2,2,59928,59931,59933,3,5,0
17197,2,1,59930,59933,59934,3,4,0
17198,1,2,59931,59934,59936,3,5,0
17199,4,2,59935,59936,59938,1,3,0
17200,3,1,59938,59938,59939,0,1,0
17201,4,3,59942,59942,59945,0,3,3
17202,4,1,59946,59946,59947,0,1,1
17203,5,1,59951,59951,59952,0,1,4
17204,5,3,59956,59956,59959,0,3,4
17205,2,1,59958,59959,59960,1,2,0
17206,3,2,59961,59961,59963,0,2,1
17207,5,2,59966,59966,59968,0,2,3
17208,3,1,59969,59969,59970,0,1,1
17209,3,2,59972,59972,59974,0,2,2
17210,2,2,59974,59974,59976,0,2,0
17211,5,3,59979,59979,59982,0,3,3
17212,2,1,59981,59982,59983,1,2,0
17213,4,2,59985,59985,59987,0,2,2
17214,6,3,59991,59991,59994,0,3,4
17215,1,1,59992,59994,59995,2,3,0
17216,2,3,59994,59995,59998,1,4,0
17217,5,2,59999,59999,60001,0,2,1
17218,1,1,60000,60001,60002,1,2,0
17219,5,3,60005,60005,60008,0,3,3
17220,1,2,60006,60008,60010,2,4,0
17221,5,1,60011,60011,60012,0,1,1
17222,1,2,60012,60012,60014,0,2,0
17223,5,1,60017,60017,60018,0,1,3
17224,6,2,60023,60023,60025,0,2,5
17225,6,3,60029,60029,60032,0,3,4
17226,4,2,60033,60033,60035,0,2,1
17227,4,2,60037,60037,60039,0,2,2
17228,5,2,60042,60042,60044,0,2,3
17229,3,3,60045,60045,60048,0,3,1
17230,1,3,60046,60048,60051,2,5,0
17231,4,2,60050,60051,60053,1,3,0
17232,5,3,60055,60055,60058,0,3,2
17233,6,2,60061,60061,60063,0,2,3
17234,6,3,60067,60067,60070,0,3,4
17235,5,2,60072,60072,60074,0,2,2
17236,1,1,60073,60074,60075,1,2,0
17237,5,1,60078,60078,60079,0,1,3
17238,2,1,60080,60080,60081,0,1,1
17239,5,2,60085,60085,60087,0,2,4
17240,1,2,60086,60087,60089,1,3,0
17241,1,2,60087,60089,60091,2,4,0
17242,1,3,60088,60091,60094,3,6,0
17243,4,2,60092,60094,60096,2,4,0
17244,2,2,60094,60096,60098,2,4,0
17245,1,2,60095,60098,60100,3,5,0
17246,1,2,60096,60100,60102,4,6,0
17247,2,3,60098,60102,60105,4,7,0
17248,1,1,60099,60105,60106,6,7,0
17249,5,3,60104,60106,60109,2,5,0
17250,3,2,60107,60109,60111,2,4,0
17251,5,2,60112,60112,60114,0,2,1
17252,6,3,60118,60118,60121,0,3,4
17253,4,1,60122,60122,60123,0,1,1
17254,6,1,60128,60128,60129,0,1,5
17255,6,1,60134,60134,60135,0,1,5
17256,2,2,60136,60136,60138,0,2,1
17257,4,2,60140,60140,60142,0,2,2
17258,4,2,60144,60144,60146,0,2,2
17259,4,1,60148,60148,60149,0,1,2
17260,2,2,60150,60150,60152,0,2,1
17261,4,2,60154,60154,60156,0,2,2
17262,6,1,60160,60160,60161,0,1,4
17263,2,3,60162,60162,60165,0,3,1
17264,3,2,60165,60165,60167,0,2,0
17265,1,1,60166,60167,60168,1,2,0
17266,4,1,60170,60170,60171,0,1,2
17267,4,1,60174,60174,60175,0,1,3
17268,1,1,60175,60175,60176,0,1,0
17269,2,1,60177,60177,60178,0,1,1
17270,6,2,60183,60183,60185,0,2,5
17271,6,1,60189,60189,60190,0,1,4
17272,5,2,60194,60194,60196,0,2,4
17273,4,3,60198,60198,60201,0,3,2
17274,4,3,60202,60202,60205,0,3,1
17275,5,2,60207,60207,60209,0,2,2
17276,1,3,60208,60209,60212,1,4,0
17277,3,1,60211,60212,60213,1,2,0
17278,4,2,60215,60215,60217,0,2,2
17279,5,3,60220,60220,60223,0,3,3
17280,6,3,60226,60226,60229,0,3,3
17281,2,2,60228,60229,60231,1,3,0
17282,2,1,60230,60231,60232,1,2,0
17283,6,2,60236,60236,60238,0,2,4
17284,3,1,60239,60239,60240,0,1,1
17285,3,2,60242,60242,60244,0,2,2
17286,4,2,60246,60246,60248,0,2,2
17287,2,2,60248,60248,60250,0,2,0
17288,5,2,60253,60253,60255,0,2,3
17289,6,2,60259,60259,60261,0,2,4
17290,3,2,60262,60262,60264,0,2,1
17291,4,3,60266,60266,60269,0,3,2
17292,6,1,60272,60272,60273,0,1,3
17293,2,3,60274,60274,60277,0,3,1
17294,4,3,60278,60278,60281,0,3,1
17295,2,2,60280,60281,60283,1,3,0
17296,4,2,60284,60284,60286,0,2,1
17297,4,1,60288,60288,60289,0,1,2
17298,3,1,60291,60291,60292,0,1,2
17299,4,2,60295,60295,60297,0,2,3
17300,3,1,60298,60298,60299,0,1,1
17301,6,1,60304,60304,60305,0,1,5
17302,6,3,60310,60310,60313,0,3,5
17303,2,1,60312,60313,60314,1,2,0
17304,4,3,60316,60316,60319,0,3,2
17305,1,2,60317,60319,60321,2,4,0
17306,4,3,60321,60321,60324,0,3,0
17307,3,2,60324,60324,60326,0,2,0
17308,1,1,60325,60326,60327,1,2,0
17309,1,2,60326,60327,60329,1,3,0
17310,2,2,60328,60329,60331,1,3,0
17311,2,3,60330,60331,60334,1,4,0
17312,6,2,60336,60336,60338,0,2,2
17313,6,2,60342,60342,60344,0,2,4
17314,4,3,60346,60346,60349,0,3,2
17315,2,2,60348,60349,60351,1,3,0
17316,5,1,60353,60353,60354,0,1,2
17317,4,2,60357,60357,60359,0,2,3
17318,4,1,60361,60361,60362,0,1,2
17319,4,1,60365,60365,60366,0,1,3
17320,2,3,60367,60367,60370,0,3,1
17321,1,3,60368,60370,60373,2,5,0
17322,6,2,60374,60374,60376,0,2,1
17323,1,3,60375,60376,60379,1,4,0
17324,2,1,60377,60379,60380,2,3,0
17325,3,2,60380,60380,60382,0,2,0
17326,2,3,60382,60382,60385,0,3,0
17327,3,2,60385,60385,60387,0,2,0
17328,5,1,60390,60390,60391,0,1,3
17329,6,3,60396,60396,60399,0,3,5
17330,6,2,60402,60402,60404,0,2,3
17331,4,2,60406,60406,60408,0,2,2
17332,5,3,60411,60411,60414,0,3,3
17333,5,3,60416,60416,60419,0,3,2
17334,5,2,60421,60421,60423,0,2,2
17335,5,2,60426,60426,60428,0,2,3
17336,3,3,60429,60429,60432,0,3,1
17337,5,3,60434,60434,60437,0,3,2
17338,2,3,60436,60437,60440,1,4,0
17339,5,2,60441,60441,60443,0,2,1
17340,4,2,60445,60445,60447,0,2,2
17341,4,1,60449,60449,60450,0,1,2
17342,5,2,60454,60454,60456,0,2,4
17343,6,2,60460,60460,60462,0,2,4
17344,3,1,60463,60463,60464,0,1,1
17345,1,2,60464,60464,60466,0,2,0
17346,3,2,60467,60467,60469,0,2,1
17347,2,2,60469,60469,60471,0,2,0
17348,4,1,60473,60473,60474,0,1,2
17349,3,2,60476,60476,60478,0,2,2
17350,3,2,60479,60479,60481,0,2,1
17351,4,3,60483,60483,60486,0,3,2
17352,4,3,60487,60487,60490,0,3,1
17353,6,2,60493,60493,60495,0,2,3
17354,3,1,60496,60496,60497,0,1,1
17355,1,3,60497,60497,60500,0,3,0
17356,5,1,60502,60502,60503,0,1,2
17357,6,1,60508,60508,60509,0,1,5
17358,6,3,60514,60514,60517,0,3,5
17359,1,3,60515,60517,60520,2,5,0
17360,2,3,60517,60520,60523,3,6,0
17361,1,1,60518,60523,60524,5,6,0
17362,1,3,60519,60524,60527,5,8,0
17363,5,2,60524,60527,60529,3,5,0
17364,4,1,60528,60529,60530,1,2,0
17365,3,2,60531,60531,60533,0,2,1
17366,1,3,60532,60533,60536,1,4,0
17367,2,1,60534,60536,60537,2,3,0
17368,1,3,60535,60537,60540,2,5,0
17369,1,3,60536,60540,60543,4,7,0
17370,6,1,60542,60543,60544,1,2,0
17371,5,2,60547,60547,60549,0,2,3
17372,3,2,60550,60550,60552,0,2,1
17373,4,2,60554,60554,60556,0,2,2
17374,1,1,60555,60556,60557,1,2,0
17375,2,3,60557,60557,60560,0,3,0
17376,3,2,60560,60560,60562,0,2,0
17377,3,1,60563,60563,60564,0,1,1
17378,2,1,60565,60565,60566,0,1,1
17379,5,3,60570,60570,60573,0,3,4
17380,2,1,60572,60573,60574,1,2,0
17381,5,2,60577,60577,60579,0,2,3
17382,6,1,60583,60583,60584,0,1,4
17383,2,1,60585,60585,60586,0,1,1
17384,2,2,60587,60587,60589,0,2,1
17385,2,1,60589,60589,60590,0,1,0
17386,6,2,60595,60595,60597,0,2,5
17387,4,2,60599,60599,60601,0,2,2
17388,2,3,60601,60601,60604,0,3,0
17389,5,1,60606,60606,60607,0,1,2
17390,4,3,60610,60610,60613,0,3,3
17391,4,1,60614,60614,60615,0,1,1
17392,6,2,60620,60620,60622,0,2,5
17393,5,1,60625,60625,60626,0,1,3
17394,1,3,60626,60626,60629,0,3,0
17395,1,2,60627,60629,60631,2,4,0
17396,5,2,60632,60632,60634,0,2,1
17397,1,1,60633,60634,60635,1,2,0
17398,1,2,60634,60635,60637,1,3,0
17399,4,2,60638,60638,60640,0,2,1
17400,5,3,60643,60643,60646,0,3,3
17401,2,2,60645,60646,60648,1,3,0
17402,3,2,60648,60648,60650,0,2,0
17403,3,2,60651,60651,60653,0,2,1
17404,1,1,60652,60653,60654,1,2,0
17405,4,2,60656,60656,60658,0,2,2
17406,4,3,60660,60660,60663,0,3,2
17407,2,1,60662,60663,60664,1,2,0
17408,3,1,60665,60665,60666,0,1,1
17409,5,1,60670,60670,60671,0,1,4
17410,2,3,60672,60672,60675,0,3,1
17411,4,3,60676,60676,60679,0,3,1
17412,1,2,60677,60679,60681,2,4,0
17413,1,1,60678,60681,60682,3,4,0
17414,2,2,60680,60682,60684,2,4,0
17415,4,3,60684,60684,60687,0,3,0
17416,1,2,60685,60687,60689,2,4,0
17417,4,2,60689,60689,60691,0,2,0
17418,3,2,60692,60692,60694,0,2,1
17419,5,1,60697,60697,60698,0,1,3
17420,1,2,60698,60698,60700,0,2,0
17421,3,2,60701,60701,60703,0,2,1
17422,6,1,60707,60707,60708,0,1,4
17423,4,1,60711,60711,60712,0,1,3
17424,4,2,60715,60715,60717,0,2,3
17425,2,2,60717,60717,60719,0,2,0
17426,4,3,60721,60721,60724,0,3,2
17427,1,1,60722,60724,60725,2,3,0
17428,4,2,60726,60726,60728,0,2,1
17429,4,3,60730,60730,60733,0,3,2
17430,6,2,60736,60736,60738,0,2,3
17431,6,2,60742,60742,60744,0,2,4
17432,2,2,60744,60744,60746,0,2,0
17433,2,3,60746,60746,60749,0,3,0
17434,5,2,60751,60751,60753,0,2,2
17435,5,2,60756,60756,60758,0,2,3
17436,3,3,60759,60759,60762,0,3,1
17437,1,3,60760,60762,60765,2,5,0
17438,3,2,60763,60765,60767,2,4,0
17439,5,3,60768,60768,60771,0,3,1
17440,1,2,60769,60771,60773,2,4,0
17441,6,2,60775,60775,60777,0,2,2
17442,1,1,60776,60777,60778,1,2,0
17443,2,2,60778,60778,60780,0,2,0
17444,1,1,60779,60780,60781,1,2,0
17445,1,1,60780,60781,60782,1,2,0
17446,2,3,60782,60782,60785,0,3,0
17447,3,3,60785,60785,60788,0,3,0
17448,3,3,60788,60788,60791,0,3,0
17449,3,3,60791,60791,60794,0,3,0
17450,2,3,60793,60794,60797,1,4,0
17451,5,3,60798,60798,60801,0,3,1
17452,6,1,60804,60804,60805,0,1,3
17453,3,3,60807,60807,60810,0,3,2
17454,1,1,60808,60810,60811,2,3,0
17455,3,2,60811,60811,60813,0,2,0
17456,5,2,60816,60816,60818,0,2,3
17457,6,2,60822,60822,60824,0,2,4
17458,1,3,60823,60824,60827,1,4,0
17459,5,2,60828,60828,60830,0,2,1
17460,1,1,60829,60830,60831,1,2,0
17461,5,1,60834,60834,60835,0,1,3
17462,5,2,60839,60839,60841,0,2,4
17463,4,2,60843,60843,60845,0,2,2
17464,1,3,60844,60845,60848,1,4,0
17465,2,2,60846,60848,60850,2,4,0
17466,4,3,60850,60850,60853,0,3,0
17467,5,3,60855,60855,60858,0,3,2
17468,5,1,60860,60860,60861,0,1,2
17469,4,2,60864,60864,60866,0,2,3
17470,4,1,60868,60868,60869,0,1,2
17471,2,2,60870,60870,60872,0,2,1
17472,2,3,60872,60872,60875,0,3,0
17473,6,3,60878,60878,60881,0,3,3
17474,3,3,60881,60881,60884,0,3,0
17475,1,3,60882,60884,60887,2,5,0
17476,2,2,60884,60887,60889,3,5,0
17477,4,1,60888,60889,60890,1,2,0
17478,6,1,60894,60894,60895,0,1,4
17479,2,2,60896,60896,60898,0,2,1
17480,3,2,60899,60899,60901,0,2,1
17481,6,2,60905,60905,60907,0,2,4
17482,3,2,60908,60908,60910,0,2,1
17483,1,3,60909,60910,60913,1,4,0
17484,1,3,60910,60913,60916,3,6,0
17485,4,1,60914,60916,60917,2,3,0
17486,4,1,60918,60918,60919,0,1,1
17487,1,3,60919,60919,60922,0,3,0
17488,1,2,60920,60922,60924,2,4,0
17489,3,2,60923,60924,60926,1,3,0
17490,2,1,60925,60926,60927,1,2,0
17491,4,3,60929,60929,60932,0,3,2
17492,3,1,60932,60932,60933,0,1,0
17493,4,2,60936,60936,60938,0,2,3
17494,3,2,60939,60939,60941,0,2,1
17495,5,1,60944,60944,60945,0,1,3
17496,4,3,60948,60948,60951,0,3,3
17497,2,3,60950,60951,60954,1,4,0
17498,1,1,60951,60954,60955,3,4,0
17499,6,1,60957,60957,60958,0,1,2
17500,4,2,60961,60961,60963,0,2,3
17501,2,1,60963,60963,60964,0,1,0
17502,3,1,60966,60966,60967,0,1,2
17503,2,1,60968,60968,60969,0,1,1
17504,5,2,60973,60973,60975,0,2,4
17505,1,2,60974,60975,60977,1,3,0
17506,2,2,60976,60977,60979,1,3,0
17507,5,2,60981,60981,60983,0,2,2
17508,2,2,60983,60983,60985,0,2,0
17509,5,3,60988,60988,60991,0,3,3
17510,6,3,60994,60994,60997,0,3,3
17511,2,1,60996,60997,60998,1,2,0
17512,2,2,60998,60998,61000,0,2,0
17513,6,2,61004,61004,61006,0,2,4
17514,6,1,61010,61010,61011,0,1,4
17515,2,3,61012,61012,61015,0,3,1
17516,4,2,61016,61016,61018,0,2,1
17517,3,1,61019,61019,61020,0,1,1
17518,2,1,61021,61021,61022,0,1,1
17519,5,1,61026,61026,61027,0,1,4
17520,3,1,61029,61029,61030,0,1,2
17521,4,1,61033,61033,61034,0,1,3
17522,2,1,61035,61035,61036,0,1,1
17523,4,1,61039,61039,61040,0,1,3
17524,5,3,61044,61044,61047,0,3,4
17525,6,2,61050,61050,61052,0,2,3
17526,3,1,61053,61053,61054,0,1,1
17527,3,1,61056,61056,61057,0,1,2
17528,4,3,61060,61060,61063,0,3,3
17529,6,3,61066,61066,61069,0,3,3
17530,5,3,61071,61071,61074,0,3,2
17531,1,1,61072,61074,61075,2,3,0
17532,5,1,61077,61077,61078,0,1,2
17533,1,3,61078,61078,61081,0,3,0
17534,3,1,61081,61081,61082,0,1,0
17535,6,3,61087,61087,61090,0,3,5
17536,1,1,61088,61090,61091,2,3,0
17537,6,1,61094,61094,61095,0,1,3
17538,2,3,61096,61096,61099,0,3,1
17539,2,1,61098,61099,61100,1,2,0
17540,3,2,61101,61101,61103,0,2,1
17541,6,1,61107,61107,61108,0,1,4
17542,1,2,61108,61108,61110,0,2,0
17543,5,3,61113,61113,61116,0,3,3
17544,4,1,61117,61117,61118,0,1,1
17545,3,1,61120,61120,61121,0,1,2
17546,5,1,61125,61125,61126,0,1,4
17547,6,1,61131,61131,61132,0,1,5
17548,2,3,61133,61133,61136,0,3,1
17549,4,2,61137,61137,61139,0,2,1
17550,4,2,61141,61141,61143,0,2,2
17551,6,1,61147,61147,61148,0,1,4
17552,6,1,61153,61153,61154,0,1,5
17553,4,1,61157,61157,61158,0,1,3
17554,2,1,61159,61159,61160,0,1,1
17555,2,1,61161,61161,61162,0,1,1
17556,1,2,61162,61162,61164,0,2,0
17557,3,3,61165,61165,61168,0,3,1
17558,3,3,61168,61168,61171,0,3,0
17559,4,1,61172,61172,61173,0,1,1
17560,4,2,61176,61176,61178,0,2,3
17561,5,2,61181,61181,61183,0,2,3
17562,6,1,61187,61187,61188,0,1,4
17563,3,2,61190,61190,61192,0,2,2
17564,1,3,61191,61192,61195,1,4,0
17565,3,3,61194,61195,61198,1,4,0
17566,3,2,61197,61198,61200,1,3,0
17567,6,3,61203,61203,61206,0,3,3
17568,2,3,61205,61206,61209,1,4,0
17569,3,1,61208,61209,61210,1,2,0
17570,5,3,61213,61213,61216,0,3,3
17571,4,3,61217,61217,61220,0,3,1
17572,4,3,61221,61221,61224,0,3,1
17573,2,3,61223,61224,61227,1,4,0
17574,4,2,61227,61227,61229,0,2,0
17575,6,2,61233,61233,61235,0,2,4
17576,1,1,61234,61235,61236,1,2,0
17577,6,3,61240,61240,61243,0,3,4
17578,4,1,61244,61244,61245,0,1,1
17579,3,1,61247,61247,61248,0,1,2
17580,1,3,61248,61248,61251,0,3,0
17581,3,3,61251,61251,61254,0,3,0
17582,2,2,61253,61254,61256,1,3,0
17583,2,2,61255,61256,61258,1,3,0
17584,3,3,61258,61258,61261,0,3,0
17585,5,1,61263,61263,61264,0,1,2
17586,2,2,61265,61265,61267,0,2,1
17587,5,2,61270,61270,61272,0,2,3
17588,6,3,61276,61276,61279,0,3,4
17589,3,3,61279,61279,61282,0,3,0
17590,5,1,61284,61284,61285,0,1,2
17591,3,3,61287,61287,61290,0,3,2
17592,1,1,61288,61290,61291,2,3,0
17593,4,3,61292,61292,61295,0,3,1
17594,3,3,61295,61295,61298,0,3,0
17595,2,2,61297,61298,61300,1,3,0
17596,6,2,61303,61303,61305,0,2,3
17597,3,2,61306,61306,61308,0,2,1
17598,2,3,61308,61308,61311,0,3,0
17599,5,1,61313,61313,61314,0,1,2
17600,4,2,61317,61317,61319,0,2,3
17601,4,3,61321,61321,61324,0,3,2
17602,3,1,61324,61324,61325,0,1,0
17603,5,1,61329,61329,61330,0,1,4
17604,6,1,61335,61335,61336,0,1,5
17605,1,2,61336,61336,61338,0,2,0
17606,3,3,61339,61339,61342,0,3,1
17607,5,1,61344,61344,61345,0,1,2
17608,2,3,61346,61346,61349,0,3,1
17609,2,3,61348,61349,61352,1,4,0
17610,2,2,61350,61352,61354,2,4,0
17611,2,3,61352,61354,61357,2,5,0
17612,2,1,61354,61357,61358,3,4,0
17613,1,1,61355,61358,61359,3,4,0
17614,4,3,61359,61359,61362,0,3,0
17615,2,3,61361,61362,61365,1,4,0
17616,4,2,61365,61365,61367,0,2,0
17617,3,1,61368,61368,61369,0,1,1
17618,4,2,61372,61372,61374,0,2,3
17619,6,1,61378,61378,61379,0,1,4
17620,4,1,61382,61382,61383,0,1,3
17621,3,1,61385,61385,61386,0,1,2
17622,6,3,61391,61391,61394,0,3,5
17623,6,1,61397,61397,61398,0,1,3
17624,1,2,61398,61398,61400,0,2,0
17625,6,3,61404,61404,61407,0,3,4
17626,4,2,61408,61408,61410,0,2,1
17627,2,1,61410,61410,61411,0,1,0
17628,1,2,61411,61411,61413,0,2,0
17629,3,1,61414,61414,61415,0,1,1
17630,1,1,61415,61415,61416,0,1,0
17631,2,1,61417,61417,61418,0,1,1
17632,2,1,61419,61419,61420,0,1,1
17633,1,1,61420,61420,61421,0,1,0
17634,1,3,61421,61421,61424,0,3,0
17635,6,1,61427,61427,61428,0,1,3
17636,6,1,61433,61433,61434,0,1,5
17637,1,3,61434,61434,61437,0,3,0
17638,4,2,61438,61438,61440,0,2,1
17639,4,3,61442,61442,61445,0,3,2
17640,2,1,61444,61445,61446,1,2,0
17641,5,1,61449,61449,61450,0,1,3
17642,1,1,61450,61450,61451,0,1,0
17643,5,1,61455,61455,61456,0,1,4
17644,3,1,61458,61458,61459,0,1,2
17645,5,2,61463,61463,61465,0,2,4
17646,1,3,61464,61465,61468,1,4,0
17647,3,3,61467,61468,61471,1,4,0
17648,5,2,61472,61472,61474,0,2,1
17649,1,2,61473,61474,61476,1,3,0
17650,3,1,61476,61476,61477,0,1,0
17651,6,1,61482,61482,61483,0,1,5
17652,6,1,61488,61488,61489,0,1,5
17653,2,1,61490,61490,61491,0,1,1
17654,4,1,61494,61494,61495,0,1,3
17655,3,2,61497,61497,61499,0,2,2
17656,4,2,61501,61501,61503,0,2,2
17657,6,1,61507,61507,61508,0,1,4
17658,1,3,61508,61508,61511,0,3,0
17659,6,3,61514,61514,61517,0,3,3
17660,3,1,61517,61517,61518,0,1,0
17661,3,2,61520,61520,61522,0,2,2
17662,6,2,61526,61526,61528,0,2,4
17663,6,1,61532,61532,61533,0,1,4
17664,5,1,61537,61537,61538,0,1,4
17665,1,2,61538,61538,61540,0,2,0
17666,2,3,61540,61540,61543,0,3,0
17667,4,1,61544,61544,61545,0,1,1
17668,1,2,61545,61545,61547,0,2,0
17669,3,2,61548,61548,61550,0,2,1
17670,6,1,61554,61554,61555,0,1,4
17671,3,2,61557,61557,61559,0,2,2
17672,2,1,61559,61559,61560,0,1,0
17673,1,2,61560,61560,61562,0,2,0
17674,1,3,61561,61562,61565,1,4,0
17675,5,3,61566,61566,61569,0,3,1
17676,6,1,61572,61572,61573,0,1,3
17677,2,3,61574,61574,61577,0,3,1
17678,6,2,61580,61580,61582,0,2,3
17679,5,2,61585,61585,61587,0,2,3
17680,4,1,61589,61589,61590,0,1,2
17681,6,2,61595,61595,61597,0,2,5
17682,1,3,61596,61597,61600,1,4,0
17683,4,3,61600,61600,61603,0,3,0
17684,6,1,61606,61606,61607,0,1,3
17685,5,3,61611,61611,61614,0,3,4
17686,2,1,61613,61614,61615,1,2,0
17687,4,1,61617,61617,61618,0,1,2
17688,5,2,61622,61622,61624,0,2,4
17689,3,2,61625,61625,61627,0,2,1
17690,5,3,61630,61630,61633,0,3,3
17691,4,2,61634,61634,61636,0,2,1
17692,6,1,61640,61640,61641,0,1,4
17693,1,3,61641,61641,61644,0,3,0
17694,3,1,61644,61644,61645,0,1,0
17695,2,1,61646,61646,61647,0,1,1
17696,2,2,61648,61648,61650,0,2,1
17697,4,1,61652,61652,61653,0,1,2
17698,3,2,61655,61655,61657,0,2,2
17699,2,3,61657,61657,61660,0,3,0
17700,2,2,61659,61660,61662,1,3,0
17701,4,2,61663,61663,61665,0,2,1
17702,4,2,61667,61667,61669,0,2,2
17703,5,1,61672,61672,61673,0,1,3
17704,3,2,61675,61675,61677,0,2,2
17705,5,3,61680,61680,61683,0,3,3
17706,5,3,61685,61685,61688,0,3,2
17707,5,1,61690,61690,61691,0,1,2
17708,3,3,61693,61693,61696,0,3,2
17709,4,2,61697,61697,61699,0,2,1
17710,6,3,61703,61703,61706,0,3,4
17711,6,3,61709,61709,61712,0,3,3
17712,1,2,61710,61712,61714,2,4,0
17713,2,3,61712,61714,61717,2,5,0
17714,5,1,61717,61717,61718,0,1,0
17715,3,1,61720,61720,61721,0,1,2
17716,4,2,61724,61724,61726,0,2,3
17717,3,2,61727,61727,61729,0,2,1
17718,2,2,61729,61729,61731,0,2,0
17719,2,3,61731,61731,61734,0,3,0
17720,4,2,61735,61735,61737,0,2,1
17721,3,2,61738,61738,61740,0,2,1
17722,2,2,61740,61740,61742,0,2,0
17723,5,2,61745,61745,61747,0,2,3
17724,2,2,61747,61747,61749,0,2,0
17725,2,2,61749,61749,61751,0,2,0
17726,3,3,61752,61752,61755,0,3,1
17727,1,1,61753,61755,61756,2,3,0
17728,1,2,61754,61756,61758,2,4,0
17729,5,2,61759,61759,61761,0,2,1
17730,2,3,61761,61761,61764,0,3,0
17731,6,1,61767,61767,61768,0,1,3
17732,1,3,61768,61768,61771,0,3,0
17733,4,1,61772,61772,61773,0,1,1
17734,4,3,61776,61776,61779,0,3,3
17735,4,1,61780,61780,61781,0,1,1
17736,6,1,61786,61786,61787,0,1,5
17737,4,2,61790,61790,61792,0,2,3
17738,3,1,61793,61793,61794,0,1,1
17739,5,3,61798,61798,61801,0,3,4
17740,4,2,61802,61802,61804,0,2,1
17741,1,2,61803,61804,61806,1,3,0
17742,1,1,61804,61806,61807,2,3,0
17743,2,1,61806,61807,61808,1,2,0
17744,4,3,61810,61810,61813,0,3,2
17745,4,2,61814,61814,61816,0,2,1
17746,1,1,61815,61816,61817,1,2,0
17747,5,1,61820,61820,61821,0,1,3
17748,1,3,61821,61821,61824,0,3,0
17749,4,2,61825,61825,61827,0,2,1
17750,3,3,61828,61828,61831,0,3,1
17751,6,2,61834,61834,61836,0,2,3
17752,3,1,61837,61837,61838,0,1,1
17753,2,1,61839,61839,61840,0,1,1
17754,1,2,61840,61840,61842,0,2,0
17755,4,2,61844,61844,61846,0,2,2
17756,4,3,61848,61848,61851,0,3,2
17757,2,3,61850,61851,61854,1,4,0
17758,6,2,61856,61856,61858,0,2,2
17759,2,2,61858,61858,61860,0,2,0
17760,2,3,61860,61860,61863,0,3,0
17761,3,1,61863,61863,61864,0,1,0
17762,5,3,61868,61868,61871,0,3,4
17763,5,2,61873,61873,61875,0,2,2
17764,4,2,61877,61877,61879,0,2,2
17765,6,3,61883,61883,61886,0,3,4
17766,5,2,61888,61888,61890,0,2,2
17767,1,1,61889,61890,61891,1,2,0
17768,2,2,61891,61891,61893,0,2,0
17769,4,3,61895,61895,61898,0,3,2
17770,5,1,61900,61900,61901,0,1,2
17771,3,3,61903,61903,61906,0,3,2
17772,5,3,61908,61908,61911,0,3,2
17773,3,1,61911,61911,61912,0,1,0
17774,2,2,61913,61913,61915,0,2,1
17775,1,2,61914,61915,61917,1,3,0
17776,3,2,61917,61917,61919,0,2,0
17777,6,2,61923,61923,61925,0,2,4
17778,6,1,61929,61929,61930,0,1,4
17779,6,2,61935,61935,61937,0,2,5
17780,1,2,61936,61937,61939,1,3,0
17781,1,1,61937,61939,61940,2,3,0
17782,1,2,61938,61940,61942,2,4,0
17783,4,3,61942,61942,61945,0,3,0
17784,2,1,61944,61945,61946,1,2,0
17785,3,1,61947,61947,61948,0,1,1
17786,3,1,61950,61950,61951,0,1,2
17787,1,1,61951,61951,61952,0,1,0
17788,1,1,61952,61952,61953,0,1,0
17789,6,1,61958,61958,61959,0,1,5
17790,1,1,61959,61959,61960,0,1,0
17791,6,3,61965,61965,61968,0,3,5
17792,6,2,61971,61971,61973,0,2,3
17793,5,2,61976,61976,61978,0,2,3
17794,1,3,61977,61978,61981,1,4,0
17795,3,3,61980,61981,61984,1,4,0
17796,3,3,61983,61984,61987,1,4,0
17797,4,2,61987,61987,61989,0,2,0
17798,2,2,61989,61989,61991,0,2,0
17799,1,1,61990,61991,61992,1,2,0
17800,2,3,61992,61992,61995,0,3,0
17801,1,1,61993,61995,61996,2,3,0
17802,1,2,61994,61996,61998,2,4,0
17803,2,1,61996,61998,61999,2,3,0
17804,4,3,62000,62000,62003,0,3,1
17805,1,2,62001,62003,62005,2,4,0
17806,5,1,62006,62006,62007,0,1,1
17807,6,3,62012,62012,62015,0,3,5
17808,4,1,62016,62016,62017,0,1,1
17809,4,3,62020,62020,62023,0,3,3
17810,1,3,62021,62023,62026,2,5,0
17811,1,1,62022,62026,62027,4,5,0
17812,3,1,62025,62027,62028,2,3,0
17813,3,1,62028,62028,62029,0,1,0
17814,2,1,62030,62030,62031,0,1,1
17815,2,2,62032,62032,62034,0,2,1
17816,3,1,62035,62035,62036,0,1,1
17817,3,2,62038,62038,62040,0,2,2
17818,2,3,62040,62040,62043,0,3,0
17819,1,3,62041,62043,62046,2,5,0
17820,1,3,62042,62046,62049,4,7,0
17821,4,3,62046,62049,62052,3,6,0
17822,6,2,62052,62052,62054,0,2,0
17823,5,3,62057,62057,62060,0,3,3
17824,3,2,62060,62060,62062,0,2,0
17825,4,1,62064,62064,62065,0,1,2
17826,6,1,62070,62070,62071,0,1,5
17827,2,2,62072,62072,62074,0,2,1
17828,2,1,62074,62074,62075,0,1,0
17829,3,2,62077,62077,62079,0,2,2
17830,3,3,62080,62080,62083,0,3,1
17831,6,1,62086,62086,62087,0,1,3
17832,1,2,62087,62087,62089,0,2,0
17833,5,1,62092,62092,62093,0,1,3
17834,2,2,62094,62094,62096,0,2,1
17835,4,1,62098,62098,62099,0,1,2
17836,3,2,62101,62101,62103,0,2,2
17837,3,1,62104,62104,62105,0,1,1
17838,1,3,62105,62105,62108,0,3,0
17839,5,2,62110,62110,62112,0,2,2
17840,4,2,62114,62114,62116,0,2,2
17841,5,1,62119,62119,62120,0,1,3
17842,4,1,62123,62123,62124,0,1,3
17843,4,3,62127,62127,62130,0,3,3
17844,5,2,62132,62132,62134,0,2,2
17845,2,2,62134,62134,62136,0,2,0
17846,6,2,62140,62140,62142,0,2,4
17847,5,2,62145,62145,62147,0,2,3
17848,3,2,62148,62148,62150,0,2,1
17849,6,3,62154,62154,62157,0,3,4
17850,2,3,62156,62157,62160,1,4,0
17851,5,2,62161,62161,62163,0,2,1
17852,6,2,62167,62167,62169,0,2,4
17853,1,3,62168,62169,62172,1,4,0
17854,1,3,62169,62172,62175,3,6,0
17855,5,3,62174,62175,62178,1,4,0
17856,4,1,62178,62178,62179,0,1,0
17857,3,2,62181,62181,62183,0,2,2
17858,4,3,62185,62185,62188,0,3,2
17859,4,2,62189,62189,62191,0,2,1
17860,4,3,62193,62193,62196,0,3,2
17861,4,3,62197,62197,62200,0,3,1
17862,5,1,62202,62202,62203,0,1,2
17863,1,3,62203,62203,62206,0,3,0
17864,6,3,62209,62209,62212,0,3,3
17865,3,1,62212,62212,62213,0,1,0
17866,4,2,62216,62216,62218,0,2,3
17867,6,2,62222,62222,62224,0,2,4
17868,4,2,62226,62226,62228,0,2,2
17869,1,1,62227,62228,62229,1,2,0
17870,4,1,62231,62231,62232,0,1,2
17871,3,2,62234,62234,62236,0,2,2
17872,5,1,62239,62239,62240,0,1,3
17873,3,2,62242,62242,62244,0,2,2
17874,6,3,62248,62248,62251,0,3,4
17875,4,2,62252,62252,62254,0,2,1
17876,5,2,62257,62257,62259,0,2,3
17877,2,2,62259,62259,62261,0,2,0
17878,2,1,62261,62261,62262,0,1,0
17879,2,2,62263,62263,62265,0,2,1
17880,5,1,62268,62268,62269,0,1,3
17881,2,2,62270,62270,62272,0,2,1
17882,4,1,62274,62274,62275,0,1,2
17883,6,3,62280,62280,62283,0,3,5
17884,4,1,62284,62284,62285,0,1,1
17885,2,3,62286,62286,62289,0,3,1
17886,4,1,62290,62290,62291,0,1,1
17887,1,1,62291,62291,62292,0,1,0
17888,6,2,62297,62297,62299,0,2,5
17889,5,3,62302,62302,62305,0,3,3
17890,1,2,62303,62305,62307,2,4,0
17891,4,1,62307,62307,62308,0,1,0
17892,2,3,62309,62309,62312,0,3,1
17893,5,3,62314,62314,62317,0,3,2
17894,5,3,62319,62319,62322,0,3,2
17895,5,2,62324,62324,62326,0,2,2
17896,4,3,62328,62328,62331,0,3,2
17897,2,1,62330,62331,62332,1,2,0
17898,4,2,62334,62334,62336,0,2,2
17899,5,2,62339,62339,62341,0,2,3
17900,3,1,62342,62342,62343,0,1,1
17901,3,3,62345,62345,62348,0,3,2
17902,5,2,62350,62350,62352,0,2,2
17903,6,2,62356,62356,62358,0,2,4
17904,1,2,62357,62358,62360,1,3,0
17905,6,2,62363,62363,62365,0,2,3
17906,5,3,62368,62368,62371,0,3,3
17907,6,1,62374,62374,62375,0,1,3
17908,1,1,62375,62375,62376,0,1,0
17909,2,2,62377,62377,62379,0,2,1
17910,5,3,62382,62382,62385,0,3,3
17911,5,2,62387,62387,62389,0,2,2
17912,1,3,62388,62389,62392,1,4,0
17913,1,3,62389,62392,62395,3,6,0
17914,3,2,62392,62395,62397,3,5,0
17915,1,3,62393,62397,62400,4,7,0
17916,3,1,62396,62400,62401,4,5,0
17917,5,1,62401,62401,62402,0,1,0
17918,5,1,62406,62406,62407,0,1,4
17919,1,2,62407,62407,62409,0,2,0
17920,5,2,62412,62412,62414,0,2,3
17921,2,3,62414,62414,62417,0,3,0
17922,4,2,62418,62418,62420,0,2,1
17923,6,2,62424,62424,62426,0,2,4
17924,4,1,62428,62428,62429,0,1,2
17925,4,1,62432,62432,62433,0,1,3
17926,4,1,62436,62436,62437,0,1,3
17927,6,2,62442,62442,62444,0,2,5
17928,2,1,62444,62444,62445,0,1,0
17929,5,2,62449,62449,62451,0,2,4
17930,5,3,62454,62454,62457,0,3,3
17931,3,3,62457,62457,62460,0,3,0
17932,6,3,62463,62463,62466,0,3,3
17933,4,2,62467,62467,62469,0,2,1
17934,3,2,62470,62470,62472,0,2,1
17935,1,1,62471,62472,62473,1,2,0
17936,1,1,62472,62473,62474,1,2,0
17937,2,2,62474,62474,62476,0,2,0
17938,1,2,62475,62476,62478,1,3,0
17939,4,1,62479,62479,62480,0,1,1
17940,4,3,62483,62483,62486,0,3,3
17941,1,2,62484,62486,62488,2,4,0
17942,1,2,62485,62488,62490,3,5,0
17943,1,2,62486,62490,62492,4,6,0
17944,1,3,62487,62492,62495,5,8,0
17945,3,3,62490,62495,62498,5,8,0
17946,2,1,62492,62498,62499,6,7,0
17947,6,3,62498,62499,62502,1,4,0
17948,6,3,62504,62504,62507,0,3,2
17949,2,2,62506,62507,62509,1,3,0
17950,5,3,62511,62511,62514,0,3,2
17951,1,1,62512,62514,62515,2,3,0
17952,5,1,62517,62517,62518,0,1,2
17953,5,3,62522,62522,62525,0,3,4
17954,2,3,62524,62525,62528,1,4,0
17955,4,2,62528,62528,62530,0,2,0
17956,5,3,62533,62533,62536,0,3,3
17957,2,2,62535,62536,62538,1,3,0
17958,6,2,62541,62541,62543,0,2,3
17959,5,3,62546,62546,62549,0,3,3
17960,3,1,62549,62549,62550,0,1,0
17961,3,2,62552,62552,62554,0,2,2
17962,4,3,62556,62556,62559,0,3,2
17963,5,2,62561,62561,62563,0,2,2
17964,4,1,62565,62565,62566,0,1,2
17965,2,3,62567,62567,62570,0,3,1
17966,1,3,62568,62570,62573,2,5,0
17967,6,2,62574,62574,62576,0,2,1
17968,3,2,62577,62577,62579,0,2,1
17969,2,2,62579,62579,62581,0,2,0
17970,5,2,62584,62584,62586,0,2,3
17971,5,1,62589,62589,62590,0,1,3
17972,5,1,62594,62594,62595,0,1,4
17973,4,3,62598,62598,62601,0,3,3
17974,2,3,62600,62601,62604,1,4,0
17975,6,2,62606,62606,62608,0,2,2
17976,6,2,62612,62612,62614,0,2,4
17977,2,3,62614,62614,62617,0,3,0
17978,6,2,62620,62620,62622,0,2,3
17979,4,1,62624,62624,62625,0,1,2
17980,6,3,62630,62630,62633,0,3,5
17981,3,1,62633,62633,62634,0,1,0
17982,3,1,62636,62636,62637,0,1,2
17983,5,2,62641,62641,62643,0,2,4
17984,2,2,62643,62643,62645,0,2,0
17985,5,2,62648,62648,62650,0,2,3
17986,4,3,62652,62652,62655,0,3,2
17987,2,2,62654,62655,62657,1,3,0
17988,3,1,62657,62657,62658,0,1,0
17989,4,1,62661,62661,62662,0,1,3
17990,4,1,62665,62665,62666,0,1,3
17991,4,3,62669,62669,62672,0,3,3
17992,6,2,62675,62675,62677,0,2,3
17993,6,3,62681,62681,62684,0,3,4
17994,5,2,62686,62686,62688,0,2,2
17995,6,2,62692,62692,62694,0,2,4
17996,4,1,62696,62696,62697,0,1,2
17997,5,1,62701,62701,62702,0,1,4
17998,1,3,62702,62702,62705,0,3,0
17999,3,2,62705,62705,62707,0,2,0
18000,1,1,62706,62707,62708,1,2,0
18001,6,3,62712,62712,62715,0,3,4
18002,4,3,62716,62716,62719,0,3,1
18003,3,1,62719,62719,62720,0,1,0
18004,1,2,62720,62720,62722,0,2,0
18005,5,3,62725,62725,62728,0,3,3
18006,3,3,62728,62728,62731,0,3,0
18007,2,3,62730,62731,62734,1,4,0
18008,1,1,62731,62734,62735,3,4,0
18009,2,3,62733,62735,62738,2,5,0
18010,5,2,62738,62738,62740,0,2,0
18011,2,2,62740,62740,62742,0,2,0
18012,1,1,62741,62742,62743,1,2,0
18013,2,1,62743,62743,62744,0,1,0
18014,2,1,62745,62745,62746,0,1,1
18015,6,3,62751,62751,62754,0,3,5
18016,5,1,62756,62756,62757,0,1,2
18017,3,1,62759,62759,62760,0,1,2
18018,2,1,62761,62761,62762,0,1,1
18019,1,1,62762,62762,62763,0,1,0
18020,5,1,62767,62767,62768,0,1,4
18021,1,3,62768,62768,62771,0,3,0
18022,3,1,62771,62771,62772,0,1,0
18023,6,1,62777,62777,62778,0,1,5
18024,1,3,62778,62778,62781,0,3,0
18025,2,3,62780,62781,62784,1,4,0
18026,5,3,62785,62785,62788,0,3,1
18027,4,2,62789,62789,62791,0,2,1
18028,1,3,62790,62791,62794,1,4,0
18029,4,1,62794,62794,62795,0,1,0
18030,2,3,62796,62796,62799,0,3,1
18031,2,1,62798,62799,62800,1,2,0
18032,3,3,62801,62801,62804,0,3,1
18033,6,2,62807,62807,62809,0,2,3
18034,5,1,62812,62812,62813,0,1,3
18035,6,1,62818,62818,62819,0,1,5
18036,4,1,62822,62822,62823,0,1,3
18037,1,2,62823,62823,62825,0,2,0
18038,5,2,62828,62828,62830,0,2,3
18039,4,3,62832,62832,62835,0,3,2
18040,5,2,62837,62837,62839,0,2,2
18041,6,1,62843,62843,62844,0,1,4
18042,4,1,62847,62847,62848,0,1,3
18043,5,2,62852,62852,62854,0,2,4
18044,5,3,62857,62857,62860,0,3,3
18045,2,2,62859,62860,62862,1,3,0
18046,3,3,62862,62862,62865,0,3,0
18047,1,2,62863,62865,62867,2,4,0
18048,5,2,62868,62868,62870,0,2,1
18049,3,1,62871,62871,62872,0,1,1
18050,6,3,62877,62877,62880,0,3,5
18051,5,3,62882,62882,62885,0,3,2
18052,1,2,62883,62885,62887,2,4,0
18053,2,1,62885,62887,62888,2,3,0
18054,6,2,62891,62891,62893,0,2,3
18055,3,3,62894,62894,62897,0,3,1
18056,1,1,62895,62897,62898,2,3,0
18057,4,1,62899,62899,62900,0,1,1
18058,4,2,62903,62903,62905,0,2,3
18059,5,3,62908,62908,62911,0,3,3
18060,6,1,62914,62914,62915,0,1,3
18061,1,3,62915,62915,62918,0,3,0
18062,5,2,62920,62920,62922,0,2,2
18063,1,2,62921,62922,62924,1,3,0
18064,6,3,62927,62927,62930,0,3,3
18065,4,1,62931,62931,62932,0,1,1
18066,1,3,62932,62932,62935,0,3,0
18067,5,1,62937,62937,62938,0,1,2
18068,6,1,62943,62943,62944,0,1,5
18069,6,1,62949,62949,62950,0,1,5
18070,2,3,62951,62951,62954,0,3,1
18071,6,1,62957,62957,62958,0,1,3
18072,3,3,62960,62960,62963,0,3,2
18073,4,3,62964,62964,62967,0,3,1
18074,3,1,62967,62967,62968,0,1,0
18075,1,1,62968,62968,62969,0,1,0
18076,2,3,62970,62970,62973,0,3,1
18077,4,2,62974,62974,62976,0,2,1
18078,5,2,62979,62979,62981,0,2,3
18079,3,3,62982,62982,62985,0,3,1
18080,2,3,62984,62985,62988,1,4,0
18081,6,3,62990,62990,62993,0,3,2
18082,5,1,62995,62995,62996,0,1,2
18083,5,3,63000,63000,63003,0,3,4
18084,5,3,63005,63005,63008,0,3,2
18085,4,1,63009,63009,63010,0,1,1
18086,2,2,63011,63011,63013,0,2,1
18087,2,2,63013,63013,63015,0,2,0
18088,2,1,63015,63015,63016,0,1,0
18089,2,2,63017,63017,63019,0,2,1
18090,4,3,63021,63021,63024,0,3,2
18091,6,1,63027,63027,63028,0,1,3
18092,1,1,63028,63028,63029,0,1,0
18093,3,3,63031,63031,63034,0,3,2
18094,5,2,63036,63036,63038,0,2,2
18095,5,2,63041,63041,63043,0,2,3
18096,1,2,63042,63043,63045,1,3,0
18097,1,1,63043,63045,63046,2,3,0
18098,2,3,63045,63046,63049,1,4,0
18099,4,3,63049,63049,63052,0,3,0
18100,4,3,63053,63053,63056,0,3,1
18101,4,3,63057,63057,63060,0,3,1
18102,6,1,63063,63063,63064,0,1,3
18103,6,2,63069,63069,63071,0,2,5
18104,2,3,63071,63071,63074,0,3,0
18105,1,3,63072,63074,63077,2,5,0
18106,5,2,63077,63077,63079,0,2,0
18107,1,3,63078,63079,63082,1,4,0
18108,4,1,63082,63082,63083,0,1,0
18109,6,3,63088,63088,63091,0,3,5
18110,4,3,63092,63092,63095,0,3,1
18111,2,2,63094,63095,63097,1,3,0
18112,5,1,63099,63099,63100,0,1,2
18113,3,2,63102,63102,63104,0,2,2
18114,3,2,63105,63105,63107,0,2,1
18115,1,3,63106,63107,63110,1,4,0
18116,3,2,63109,63110,63112,1,3,0
18117,2,1,63111,63112,63113,1,2,0
18118,3,3,63114,63114,63117,0,3,1
18119,4,3,63118,63118,63121,0,3,1
18120,6,1,63124,63124,63125,0,1,3
18121,6,2,63130,63130,63132,0,2,5
18122,5,2,63135,63135,63137,0,2,3
18123,2,2,63137,63137,63139,0,2,0
18124,5,3,63142,63142,63145,0,3,3
18125,3,2,63145,63145,63147,0,2,0
18126,1,2,63146,63147,63149,1,3,0
18127,1,3,63147,63149,63152,2,5,0
18128,1,3,63148,63152,63155,4,7,0
18129,4,3,63152,63155,63158,3,6,0
18130,6,3,63158,63158,63161,0,3,0
18131,3,1,63161,63161,63162,0,1,0
18132,1,3,63162,63162,63165,0,3,0
18133,2,2,63164,63165,63167,1,3,0
18134,3,2,63167,63167,63169,0,2,0
18135,5,2,63172,63172,63174,0,2,3
18136,3,1,63175,63175,63176,0,1,1
18137,1,3,63176,63176,63179,0,3,0
18138,3,3,63179,63179,63182,0,3,0
18139,1,2,63180,63182,63184,2,4,0
18140,4,2,63184,63184,63186,0,2,0
18141,6,1,63190,63190,63191,0,1,4
18142,1,3,63191,63191,63194,0,3,0
18143,6,2,63197,63197,63199,0,2,3
18144,3,1,63200,63200,63201,0,1,1
18145,6,2,63206,63206,63208,0,2,5
18146,6,2,63212,63212,63214,0,2,4
18147,1,1,63213,63214,63215,1,2,0
18148,2,2,63215,63215,63217,0,2,0
18149,2,1,63217,63217,63218,0,1,0
18150,6,3,63223,63223,63226,0,3,5
18151,5,2,63228,63228,63230,0,2,2
18152,2,2,63230,63230,63232,0,2,0
18153,2,3,63232,63232,63235,0,3,0
18154,1,2,63233,63235,63237,2,4,0
18155,1,2,63234,63237,63239,3,5,0
18156,3,1,63237,63239,63240,2,3,0
18157,6,2,63243,63243,63245,0,2,3
18158,1,3,63244,63245,63248,1,4,0
18159,1,2,63245,63248,63250,3,5,0
18160,5,3,63250,63250,63253,0,3,0
18161,2,2,63252,63253,63255,1,3,0
18162,5,1,63257,63257,63258,0,1,2
18163,3,3,63260,63260,63263,0,3,2
18164,5,2,63265,63265,63267,0,2,2
18165,1,1,63266,63267,63268,1,2,0
18166,3,2,63269,63269,63271,0,2,1
18167,5,1,63274,63274,63275,0,1,3
18168,1,1,63275,63275,63276,0,1,0
18169,4,2,63279,63279,63281,0,2,3
18170,1,2,63280,63281,63283,1,3,0
18171,4,1,63284,63284,63285,0,1,1
18172,4,2,63288,63288,63290,0,2,3
18173,6,3,63294,63294,63297,0,3,4
18174,1,1,63295,63297,63298,2,3,0
18175,1,2,63296,63298,63300,2,4,0
18176,2,1,63298,63300,63301,2,3,0
18177,4,3,63302,63302,63305,0,3,1
18178,4,1,63306,63306,63307,0,1,1
18179,5,1,63311,63311,63312,0,1,4
18180,2,2,63313,63313,63315,0,2,1
18181,2,3,63315,63315,63318,0,3,0
18182,2,3,63317,63318,63321,1,4,0
18183,6,1,63323,63323,63324,0,1,2
18184,5,1,63328,63328,63329,0,1,4
18185,5,2,63333,63333,63335,0,2,4
18186,1,1,63334,63335,63336,1,2,0
18187,1,3,63335,63336,63339,1,4,0
18188,5,3,63340,63340,63343,0,3,1
18189,1,2,63341,63343,63345,2,4,0
18190,1,2,63342,63345,63347,3,5,0
18191,1,1,63343,63347,63348,4,5,0
18192,2,1,63345,63348,63349,3,4,0
18193,1,1,63346,63349,63350,3,4,0
18194,5,3,63351,63351,63354,0,3,1
18195,2,2,63353,63354,63356,1,3,0
18196,4,2,63357,63357,63359,0,2,1
18197,6,1,63363,63363,63364,0,1,4
18198,1,1,63364,63364,63365,0,1,0
18199,1,2,63365,63365,63367,0,2,0
18200,4,2,63369,63369,63371,0,2,2
18201,1,3,63370,63371,63374,1,4,0
18202,5,3,63375,63375,63378,0,3,1
18203,2,1,63377,63378,63379,1,2,0
18204,5,2,63382,63382,63384,0,2,3
18205,4,3,63386,63386,63389,0,3,2
18206,2,2,63388,63389,63391,1,3,0
18207,5,1,63393,63393,63394,0,1,2
18208,4,1,63397,63397,63398,0,1,3
18209,5,1,63402,63402,63403,0,1,4
18210,1,2,63403,63403,63405,0,2,0
18211,4,3,63407,63407,63410,0,3,2
18212,3,2,63410,63410,63412,0,2,0
18213,6,1,63416,63416,63417,0,1,4
18214,4,3,63420,63420,63423,0,3,3
18215,1,3,63421,63423,63426,2,5,0
18216,5,1,63426,63426,63427,0,1,0
18217,4,1,63430,63430,63431,0,1,3
18218,4,3,63434,63434,63437,0,3,3
18219,6,3,63440,63440,63443,0,3,3
18220,3,3,63443,63443,63446,0,3,0
18221,2,3,63445,63446,63449,1,4,0
18222,3,2,63448,63449,63451,1,3,0
18223,2,3,63450,63451,63454,1,4,0
18224,6,2,63456,63456,63458,0,2,2
18225,2,3,63458,63458,63461,0,3,0
18226,2,1,63460,63461,63462,1,2,0
18227,3,1,63463,63463,63464,0,1,1
18228,3,1,63466,63466,63467,0,1,2
18229,4,1,63470,63470,63471,0,1,3
18230,6,1,63476,63476,63477,0,1,5
18231,6,3,63482,63482,63485,0,3,5
18232,3,1,63485,63485,63486,0,1,0
18233,6,3,63491,63491,63494,0,3,5
18234,3,3,63494,63494,63497,0,3,0
18235,4,2,63498,63498,63500,0,2,1
18236,5,2,63503,63503,63505,0,2,3
18237,5,2,63508,63508,63510,0,2,3
18238,6,1,63514,63514,63515,0,1,4
18239,3,3,63517,63517,63520,0,3,2
18240,5,2,63522,63522,63524,0,2,2
18241,6,1,63528,63528,63529,0,1,4
18242,4,3,63532,63532,63535,0,3,3
18243,5,2,63537,63537,63539,0,2,2
18244,5,2,63542,63542,63544,0,2,3
18245,3,2,63545,63545,63547,0,2,1
18246,4,1,63549,63549,63550,0,1,2
18247,3,3,63552,63552,63555,0,3,2
18248,3,1,63555,63555,63556,0,1,0
18249,4,3,63559,63559,63562,0,3,3
18250,2,3,63561,63562,63565,1,4,0
18251,3,1,63564,63565,63566,1,2,0
18252,2,1,63566,63566,63567,0,1,0
18253,1,1,63567,63567,63568,0,1,0
18254,4,2,63571,63571,63573,0,2,3
18255,2,3,63573,63573,63576,0,3,0
18256,6,2,63579,63579,63581,0,2,3
18257,4,2,63583,63583,63585,0,2,2
18258,2,3,63585,63585,63588,0,3,0
18259,3,1,63588,63588,63589,0,1,0
18260,5,3,63593,63593,63596,0,3,4
18261,2,2,63595,63596,63598,1,3,0
18262,2,2,63597,63598,63600,1,3,0
18263,4,2,63601,63601,63603,0,2,1
18264,2,2,63603,63603,63605,0,2,0
18265,2,3,63605,63605,63608,0,3,0
18266,5,3,63610,63610,63613,0,3,2
18267,6,2,63616,63616,63618,0,2,3
18268,6,1,63622,63622,63623,0,1,4
18269,3,1,63625,63625,63626,0,1,2
18270,6,1,63631,63631,63632,0,1,5
18271,5,3,63636,63636,63639,0,3,4
18272,4,3,63640,63640,63643,0,3,1
18273,6,1,63646,63646,63647,0,1,3
18274,5,2,63651,63651,63653,0,2,4
18275,6,1,63657,63657,63658,0,1,4
18276,3,3,63660,63660,63663,0,3,2
18277,4,1,63664,63664,63665,0,1,1
18278,5,3,63669,63669,63672,0,3,4
18279,5,1,63674,63674,63675,0,1,2
18280,4,1,63678,63678,63679,0,1,3
18281,5,3,63683,63683,63686,0,3,4
18282,1,2,63684,63686,63688,2,4,0
18283,1,1,63685,63688,63689,3,4,0
18284,3,1,63688,63689,63690,1,2,0
18285,6,1,63694,63694,63695,0,1,4
18286,2,3,63696,63696,63699,0,3,1
18287,6,2,63702,63702,63704,0,2,3
18288,1,3,63703,63704,63707,1,4,0
18289,4,1,63707,63707,63708,0,1,0
18290,6,2,63713,63713,63715,0,2,5
18291,5,1,63718,63718,63719,0,1,3
18292,4,2,63722,63722,63724,0,2,3
18293,6,2,63728,63728,63730,0,2,4
18294,5,3,63733,63733,63736,0,3,3
18295,6,2,63739,63739,63741,0,2,3
18296,4,1,63743,63743,63744,0,1,2
18297,5,3,63748,63748,63751,0,3,4
18298,2,2,63750,63751,63753,1,3,0
18299,3,3,63753,63753,63756,0,3,0
18300,1,2,63754,63756,63758,2,4,0
18301,2,3,63756,63758,63761,2,5,0
18302,2,2,63758,63761,63763,3,5,0
18303,3,2,63761,63763,63765,2,4,0
18304,2,2,63763,63765,63767,2,4,0
18305,5,3,63768,63768,63771,0,3,1
18306,5,1,63773,63773,63774,0,1,2
18307,2,3,63775,63775,63778,0,3,1
18308,3,1,63778,63778,63779,0,1,0
18309,5,1,63783,63783,63784,0,1,4
18310,6,3,63789,63789,63792,0,3,5
18311,5,3,63794,63794,63797,0,3,2
18312,3,1,63797,63797,63798,0,1,0
18313,4,1,63801,63801,63802,0,1,3
18314,2,2,63803,63803,63805,0,2,1
18315,6,1,63809,63809,63810,0,1,4
18316,1,2,63810,63810,63812,0,2,0
18317,4,1,63814,63814,63815,0,1,2
18318,1,1,63815,63815,63816,0,1,0
18319,2,2,63817,63817,63819,0,2,1
18320,6,1,63823,63823,63824,0,1,4
18321,2,2,63825,63825,63827,0,2,1
18322,4,2,63829,63829,63831,0,2,2
18323,4,3,63833,63833,63836,0,3,2
18324,5,3,63838,63838,63841,0,3,2
18325,5,3,63843,63843,63846,0,3,2
18326,6,3,63849,63849,63852,0,3,3
18327,2,1,63851,63852,63853,1,2,0
18328,3,2,63854,63854,63856,0,2,1
18329,1,2,63855,63856,63858,1,3,0
18330,3,2,63858,63858,63860,0,2,0
18331,4,1,63862,63862,63863,0,1,2
18332,3,3,63865,63865,63868,0,3,2
18333,4,1,63869,63869,63870,0,1,1
18334,6,1,63875,63875,63876,0,1,5
18335,4,1,63879,63879,63880,0,1,3
18336,5,1,63884,63884,63885,0,1,4
18337,3,2,63887,63887,63889,0,2,2
18338,5,2,63892,63892,63894,0,2,3
18339,6,2,63898,63898,63900,0,2,4
18340,2,3,63900,63900,63903,0,3,0
18341,2,3,63902,63903,63906,1,4,0
18342,2,2,63904,63906,63908,2,4,0
18343,3,3,63907,63908,63911,1,4,0
18344,1,3,63908,63911,63914,3,6,0
18345,1,1,63909,63914,63915,5,6,0
18346,6,3,63915,63915,63918,0,3,0
18347,3,1,63918,63918,63919,0,1,0
18348,4,3,63922,63922,63925,0,3,3
18349,6,1,63928,63928,63929,0,1,3
18350,3,3,63931,63931,63934,0,3,2
18351,4,2,63935,63935,63937,0,2,1
18352,4,3,63939,63939,63942,0,3,2
18353,1,2,63940,63942,63944,2,4,0
18354,1,3,63941,63944,63947,3,6,0
18355,4,2,63945,63947,63949,2,4,0
18356,3,3,63948,63949,63952,1,4,0
18357,4,1,63952,63952,63953,0,1,0
18358,6,2,63958,63958,63960,0,2,5
18359,4,3,63962,63962,63965,0,3,2
18360,3,1,63965,63965,63966,0,1,0
18361,6,2,63971,63971,63973,0,2,5
18362,6,2,63977,63977,63979,0,2,4
18363,4,1,63981,63981,63982,0,1,2
18364,6,1,63987,63987,63988,0,1,5
18365,3,2,63990,63990,63992,0,2,2
18366,4,2,63994,63994,63996,0,2,2
18367,4,2,63998,63998,64000,0,2,2
18368,2,2,64000,64000,64002,0,2,0
18369,4,3,64004,64004,64007,0,3,2
18370,1,3,64005,64007,64010,2,5,0
18371,1,3,64006,64010,64013,4,7,0
18372,2,2,64008,64013,64015,5,7,0
18373,1,1,64009,64015,64016,6,7,0
18374,1,2,64010,64016,64018,6,8,0
18375,1,3,64011,64018,64021,7,10,0
18376,5,1,64016,64021,64022,5,6,0
18377,4,1,64020,64022,64023,2,3,0
18378,1,3,64021,64023,64026,2,5,0
18379,4,3,64025,64026,64029,1,4,0
18380,2,2,64027,64029,64031,2,4,0
18381,4,2,64031,64031,64033,0,2,0
18382,1,2,64032,64033,64035,1,3,0
18383,4,3,64036,64036,64039,0,3,1
18384,3,3,64039,64039,64042,0,3,0
18385,3,2,64042,64042,64044,0,2,0
18386,4,2,64046,64046,64048,0,2,2
18387,1,2,64047,64048,64050,1,3,0
18388,3,1,64050,64050,64051,0,1,0
18389,5,2,64055,64055,64057,0,2,4
18390,6,2,64061,64061,64063,0,2,4
18391,1,3,64062,64063,64066,1,4,0
18392,5,3,64067,64067,64070,0,3,1
18393,6,2,64073,64073,64075,0,2,3
18394,4,2,64077,64077,64079,0,2,2
18395,4,2,64081,64081,64083,0,2,2
18396,3,1,64084,64084,64085,0,1,1
18397,4,2,64088,64088,64090,0,2,3
18398,5,2,64093,64093,64095,0,2,3
18399,6,2,64099,64099,64101,0,2,4
18400,1,3,64100,64101,64104,1,4,0
18401,2,2,64102,64104,64106,2,4,0
18402,3,2,64105,64106,64108,1,3,0
18403,4,3,64109,64109,64112,0,3,1
18404,2,1,64111,64112,64113,1,2,0
18405,3,2,64114,64114,64116,0,2,1
18406,5,1,64119,64119,64120,0,1,3
18407,6,2,64125,64125,64127,0,2,5
18408,4,3,64129,64129,64132,0,3,2
18409,2,2,64131,64132,64134,1,3,0
18410,2,2,64133,64134,64136,1,3,0
18411,4,1,64137,64137,64138,0,1,1
18412,5,3,64142,64142,64145,0,3,4
18413,6,2,64148,64148,64150,0,2,3
18414,3,2,64151,64151,64153,0,2,1
18415,1,2,64152,64153,64155,1,3,0
18416,2,3,64154,64155,64158,1,4,0
18417,1,1,64155,64158,64159,3,4,0
18418,3,3,64158,64159,64162,1,4,0
18419,6,3,64164,64164,64167,0,3,2
18420,4,1,64168,64168,64169,0,1,1
18421,1,3,64169,64169,64172,0,3,0
18422,1,1,64170,64172,64173,2,3,0
18423,6,1,64176,64176,64177,0,1,3
18424,2,3,64178,64178,64181,0,3,1
18425,5,3,64183,64183,64186,0,3,2
18426,2,1,64185,64186,64187,1,2,0
18427,5,3,64190,64190,64193,0,3,3
18428,3,1,64193,64193,64194,0,1,0
18429,1,1,64194,64194,64195,0,1,0
18430,2,2,64196,64196,64198,0,2,1
18431,5,3,64201,64201,64204,0,3,3
18432,2,2,64203,64204,64206,1,3,0
18433,6,1,64209,64209,64210,0,1,3
18434,3,1,64212,64212,64213,0,1,2
18435,2,2,64214,64214,64216,0,2,1
18436,5,3,64219,64219,64222,0,3,3
18437,4,1,64223,64223,64224,0,1,1
18438,1,3,64224,64224,64227,0,3,0
18439,3,2,64227,64227,64229,0,2,0
18440,4,3,64231,64231,64234,0,3,2
18441,2,2,64233,64234,64236,1,3,0
18442,2,2,64235,64236,64238,1,3,0
18443,4,1,64239,64239,64240,0,1,1
18444,6,3,64245,64245,64248,0,3,5
18445,4,2,64249,64249,64251,0,2,1
18446,5,3,64254,64254,64257,0,3,3
18447,6,3,64260,64260,64263,0,3,3
18448,4,3,64264,64264,64267,0,3,1
18449,5,2,64269,64269,64271,0,2,2
18450,4,3,64273,64273,64276,0,3,2
18451,5,1,64278,64278,64279,0,1,2
18452,4,3,64282,64282,64285,0,3,3
18453,3,2,64285,64285,64287,0,2,0
18454,5,2,64290,64290,64292,0,2,3
18455,1,2,64291,64292,64294,1,3,0
18456,2,3,64293,64294,64297,1,4,0
18457,5,1,64298,64298,64299,0,1,1
18458,2,2,64300,64300,64302,0,2,1
18459,6,3,64306,64306,64309,0,3,4
18460,1,3,64307,64309,64312,2,5,0
18461,5,3,64312,64312,64315,0,3,0
18462,3,3,64315,64315,64318,0,3,0
18463,4,1,64319,64319,64320,0,1,1
18464,2,1,64321,64321,64322,0,1,1
18465,4,2,64325,64325,64327,0,2,3
18466,4,3,64329,64329,64332,0,3,2
18467,6,1,64335,64335,64336,0,1,3
18468,3,3,64338,64338,64341,0,3,2
18469,3,1,64341,64341,64342,0,1,0
18470,6,3,64347,64347,64350,0,3,5
18471,3,2,64350,64350,64352,0,2,0
18472,5,1,64355,64355,64356,0,1,3
18473,1,3,64356,64356,64359,0,3,0
18474,2,2,64358,64359,64361,1,3,0
18475,3,1,64361,64361,64362,0,1,0
18476,6,3,64367,64367,64370,0,3,5
18477,2,3,64369,64370,64373,1,4,0
18478,6,1,64375,64375,64376,0,1,2
18479,4,2,64379,64379,64381,0,2,3
18480,3,2,64382,64382,64384,0,2,1
18481,1,1,64383,64384,64385,1,2,0
18482,5,2,64388,64388,64390,0,2,3
18483,4,3,64392,64392,64395,0,3,2
18484,1,3,64393,64395,64398,2,5,0
18485,6,3,64399,64399,64402,0,3,1
18486,5,1,64404,64404,64405,0,1,2
18487,6,3,64410,64410,64413,0,3,5
18488,3,3,64413,64413,64416,0,3,0
18489,1,3,64414,64416,64419,2,5,0
18490,1,1,64415,64419,64420,4,5,0
18491,5,3,64420,64420,64423,0,3,0
18492,1,2,64421,64423,64425,2,4,0
18493,1,1,64422,64425,64426,3,4,0
18494,1,2,64423,64426,64428,3,5,0
18495,4,3,64427,64428,64431,1,4,0
18496,3,1,64430,64431,64432,1,2,0
18497,5,3,64435,64435,64438,0,3,3
18498,5,2,64440,64440,64442,0,2,2
18499,4,2,64444,64444,64446,0,2,2
18500,2,2,64446,64446,64448,0,2,0
18501,4,1,64450,64450,64451,0,1,2
18502,2,3,64452,64452,64455,0,3,1
18503,1,3,64453,64455,64458,2,5,0
18504,6,3,64459,64459,64462,0,3,1
18505,3,3,64462,64462,64465,0,3,0
18506,3,1,64465,64465,64466,0,1,0
18507,4,3,64469,64469,64472,0,3,3
18508,6,3,64475,64475,64478,0,3,3
18509,6,2,64481,64481,64483,0,2,3
18510,5,2,64486,64486,64488,0,2,3
18511,6,1,64492,64492,64493,0,1,4
18512,6,3,64498,64498,64501,0,3,5
18513,1,1,64499,64501,64502,2,3,0
18514,5,2,64504,64504,64506,0,2,2
18515,6,3,64510,64510,64513,0,3,4
18516,3,1,64513,64513,64514,0,1,0
18517,2,1,64515,64515,64516,0,1,1
18518,3,3,64518,64518,64521,0,3,2
18519,2,1,64520,64521,64522,1,2,0
18520,5,2,64525,64525,64527,0,2,3
18521,3,3,64528,64528,64531,0,3,1
18522,5,2,64533,64533,64535,0,2,2
18523,5,2,64538,64538,64540,0,2,3
18524,2,2,64540,64540,64542,0,2,0
18525,5,3,64545,64545,64548,0,3,3
18526,6,1,64551,64551,64552,0,1,3
18527,3,3,64554,64554,64557,0,3,2
18528,5,1,64559,64559,64560,0,1,2
18529,3,3,64562,64562,64565,0,3,2
18530,4,3,64566,64566,64569,0,3,1
18531,6,2,64572,64572,64574,0,2,3
18532,4,3,64576,64576,64579,0,3,2
18533,5,1,64581,64581,64582,0,1,2
18534,1,2,64582,64582,64584,0,2,0
18535,1,3,64583,64584,64587,1,4,0
18536,3,3,64586,64587,64590,1,4,0
18537,6,2,64592,64592,64594,0,2,2
18538,5,3,64597,64597,64600,0,3,3
18539,4,1,64601,64601,64602,0,1,1
18540,6,3,64607,64607,64610,0,3,5
18541,1,2,64608,64610,64612,2,4,0
18542,3,1,64611,64612,64613,1,2,0
18543,4,3,64615,64615,64618,0,3,2
18544,1,3,64616,64618,64621,2,5,0
18545,6,3,64622,64622,64625,0,3,1
18546,5,2,64627,64627,64629,0,2,2
18547,5,2,64632,64632,64634,0,2,3
18548,4,1,64636,64636,64637,0,1,2
18549,2,3,64638,64638,64641,0,3,1
18550,6,1,64644,64644,64645,0,1,3
18551,4,1,64648,64648,64649,0,1,3
18552,2,2,64650,64650,64652,0,2,1
18553,4,3,64654,64654,64657,0,3,2
18554,2,2,64656,64657,64659,1,3,0
18555,5,3,64661,64661,64664,0,3,2
18556,1,2,64662,64664,64666,2,4,0
18557,1,1,64663,64666,64667,3,4,0
18558,1,2,64664,64667,64669,3,5,0
18559,5,3,64669,64669,64672,0,3,0
18560,2,3,64671,64672,64675,1,4,0
18561,6,3,64677,64677,64680,0,3,2
18562,6,1,64683,64683,64684,0,1,3
18563,1,1,64684,64684,64685,0,1,0
18564,2,1,64686,64686,64687,0,1,1
18565,4,1,64690,64690,64691,0,1,3
18566,1,2,64691,64691,64693,0,2,0
18567,2,2,64693,64693,64695,0,2,0
18568,2,2,64695,64695,64697,0,2,0
18569,1,3,64696,64697,64700,1,4,0
18570,2,3,64698,64700,64703,2,5,0
18571,2,3,64700,64703,64706,3,6,0
18572,1,3,64701,64706,64709,5,8,0
18573,2,3,64703,64709,64712,6,9,0
18574,2,3,64705,64712,64715,7,10,0
18575,2,3,64707,64715,64718,8,11,0
18576,4,1,64711,64718,64719,7,8,0
18577,5,3,64716,64719,64722,3,6,0
18578,3,3,64719,64722,64725,3,6,0
18579,5,3,64724,64725,64728,1,4,0
18580,6,2,64730,64730,64732,0,2,2
18581,3,3,64733,64733,64736,0,3,1
18582,2,1,64735,64736,64737,1,2,0
18583,5,1,64740,64740,64741,0,1,3
18584,3,2,64743,64743,64745,0,2,2
18585,2,2,64745,64745,64747,0,2,0
18586,3,3,64748,64748,64751,0,3,1
18587,4,2,64752,64752,64754,0,2,1
18588,1,1,64753,64754,64755,1,2,0
18589,3,1,64756,64756,64757,0,1,1
18590,6,1,64762,64762,64763,0,1,5
18591,6,3,64768,64768,64771,0,3,5
18592,6,2,64774,64774,64776,0,2,3
18593,4,1,64778,64778,64779,0,1,2
18594,3,3,64781,64781,64784,0,3,2
18595,3,1,64784,64784,64785,0,1,0
18596,3,2,64787,64787,64789,0,2,2
18597,5,2,64792,64792,64794,0,2,3
18598,1,3,64793,64794,64797,1,4,0
18599,5,1,64798,64798,64799,0,1,1
18600,6,3,64804,64804,64807,0,3,5
18601,3,2,64807,64807,64809,0,2,0
18602,5,1,64812,64812,64813,0,1,3
18603,2,3,64814,64814,64817,0,3,1
18604,6,3,64820,64820,64823,0,3,3
18605,3,3,64823,64823,64826,0,3,0
18606,1,3,64824,64826,64829,2,5,0
18607,3,1,64827,64829,64830,2,3,0
18608,5,2,64832,64832,64834,0,2,2
18609,1,3,64833,64834,64837,1,4,0
18610,4,3,64837,64837,64840,0,3,0
18611,3,2,64840,64840,64842,0,2,0
18612,2,2,64842,64842,64844,0,2,0
18613,4,1,64846,64846,64847,0,1,2
18614,5,1,64851,64851,64852,0,1,4
18615,2,1,64853,64853,64854,0,1,1
18616,4,1,64857,64857,64858,0,1,3
18617,4,3,64861,64861,64864,0,3,3
18618,2,3,64863,64864,64867,1,4,0
18619,2,1,64865,64867,64868,2,3,0
18620,2,1,64867,64868,64869,1,2,0
18621,1,3,64868,64869,64872,1,4,0
18622,2,3,64870,64872,64875,2,5,0
18623,3,1,64873,64875,64876,2,3,0
18624,3,2,64876,64876,64878,0,2,0
18625,4,2,64880,64880,64882,0,2,2
18626,5,3,64885,64885,64888,0,3,3
18627,4,3,64889,64889,64892,0,3,1
18628,6,2,64895,64895,64897,0,2,3
18629,6,2,64901,64901,64903,0,2,4
18630,2,2,64903,64903,64905,0,2,0
18631,1,1,64904,64905,64906,1,2,0
18632,2,1,64906,64906,64907,0,1,0
18633,1,3,64907,64907,64910,0,3,0
18634,2,1,64909,64910,64911,1,2,0
18635,4,1,64913,64913,64914,0,1,2
18636,2,3,64915,64915,64918,0,3,1
18637,6,1,64921,64921,64922,0,1,3
18638,4,2,64925,64925,64927,0,2,3
18639,3,1,64928,64928,64929,0,1,1
18640,3,1,64931,64931,64932,0,1,2
18641,1,1,64932,64932,64933,0,1,0
18642,6,1,64938,64938,64939,0,1,5
18643,2,1,64940,64940,64941,0,1,1
18644,2,2,64942,64942,64944,0,2,1
18645,5,2,64947,64947,64949,0,2,3
18646,4,3,64951,64951,64954,0,3,2
18647,1,3,64952,64954,64957,2,5,0
18648,5,2,64957,64957,64959,0,2,0
18649,4,3,64961,64961,64964,0,3,2
18650,2,1,64963,64964,64965,1,2,0
18651,3,1,64966,64966,64967,0,1,1
18652,3,3,64969,64969,64972,0,3,2
18653,5,3,64974,64974,64977,0,3,2
18654,1,2,64975,64977,64979,2,4,0
18655,3,2,64978,64979,64981,1,3,0
18656,6,2,64984,64984,64986,0,2,3
18657,2,1,64986,64986,64987,0,1,0
18658,3,1,64989,64989,64990,0,1,2
18659,4,3,64993,64993,64996,0,3,3
18660,3,1,64996,64996,64997,0,1,0
18661,2,3,64998,64998,65001,0,3,1
18662,6,3,65004,65004,65007,0,3,3
18663,4,3,65008,65008,65011,0,3,1
18664,2,2,65010,65011,65013,1,3,0
18665,5,1,65015,65015,65016,0,1,2
18666,1,3,65016,65016,65019,0,3,0
18667,5,3,65021,65021,65024,0,3,2
18668,4,3,65025,65025,65028,0,3,1
18669,6,3,65031,65031,65034,0,3,3
18670,6,1,65037,65037,65038,0,1,3
18671,1,1,65038,65038,65039,0,1,0
18672,5,3,65043,65043,65046,0,3,4
18673,1,2,65044,65046,65048,2,4,0
18674,3,1,65047,65048,65049,1,2,0
18675,1,2,65048,65049,65051,1,3,0
18676,5,2,65053,65053,65055,0,2,2
18677,4,3,65057,65057,65060,0,3,2
18678,2,1,65059,65060,65061,1,2,0
18679,1,3,65060,65061,65064,1,4,0
18680,1,1,65061,65064,65065,3,4,0
18681,3,3,65064,65065,65068,1,4,0
18682,6,2,65070,65070,65072,0,2,2
18683,4,2,65074,65074,65076,0,2,2
18684,5,3,65079,65079,65082,0,3,3
18685,3,3,65082,65082,65085,0,3,0
18686,3,3,65085,65085,65088,0,3,0
18687,2,1,65087,65088,65089,1,2,0
18688,6,2,65093,65093,65095,0,2,4
18689,1,1,65094,65095,65096,1,2,0
18690,5,2,65099,65099,65101,0,2,3
18691,5,1,65104,65104,65105,0,1,3
18692,4,2,65108,65108,65110,0,2,3
18693,1,3,65109,65110,65113,1,4,0
18694,3,3,65112,65113,65116,1,4,0
18695,2,1,65114,65116,65117,2,3,0
18696,5,3,65119,65119,65122,0,3,2
18697,3,3,65122,65122,65125,0,3,0
18698,1,2,65123,65125,65127,2,4,0
18699,1,3,65124,65127,65130,3,6,0
18700,6,2,65130,65130,65132,0,2,0
18701,4,3,65134,65134,65137,0,3,2
18702,1,3,65135,65137,65140,2,5,0
18703,4,3,65139,65140,65143,1,4,0
18704,4,2,65143,65143,65145,0,2,0
18705,2,3,65145,65145,65148,0,3,0
18706,1,2,65146,65148,65150,2,4,0
18707,2,3,65148,65150,65153,2,5,0
18708,2,3,65150,65153,65156,3,6,0
18709,3,1,65153,65156,65157,3,4,0
18710,2,1,65155,65157,65158,2,3,0
18711,5,1,65160,65160,65161,0,1,2
18712,5,3,65165,65165,65168,0,3,4
18713,1,2,65166,65168,65170,2,4,0
18714,2,1,65168,65170,65171,2,3,0
18715,1,3,65169,65171,65174,2,5,0
18716,6,1,65175,65175,65176,0,1,1
18717,1,1,65176,65176,65177,0,1,0
18718,6,3,65182,65182,65185,0,3,5
18719,3,2,65185,65185,65187,0,2,0
18720,6,3,65191,65191,65194,0,3,4
18721,1,2,65192,65194,65196,2,4,0
18722,3,1,65195,65196,65197,1,2,0
18723,4,1,65199,65199,65200,0,1,2
18724,3,1,65202,65202,65203,0,1,2
18725,4,3,65206,65206,65209,0,3,3
18726,1,1,65207,65209,65210,2,3,0
18727,6,1,65213,65213,65214,0,1,3
18728,2,2,65215,65215,65217,0,2,1
18729,6,1,65221,65221,65222,0,1,4
18730,2,3,65223,65223,65226,0,3,1
18731,3,2,65226,65226,65228,0,2,0
18732,3,1,65229,65229,65230,0,1,1
18733,1,1,65230,65230,65231,0,1,0
18734,6,1,65236,65236,65237,0,1,5
18735,6,1,65242,65242,65243,0,1,5
18736,1,3,65243,65243,65246,0,3,0
18737,2,2,65245,65246,65248,1,3,0
18738,1,3,65246,65248,65251,2,5,0
18739,1,3,65247,65251,65254,4,7,0
18740,2,3,65249,65254,65257,5,8,0
18741,2,1,65251,65257,65258,6,7,0
18742,4,1,65255,65258,65259,3,4,0
18743,6,3,65261,65261,65264,0,3,2
18744,4,1,65265,65265,65266,0,1,1
18745,5,3,65270,65270,65273,0,3,4
18746,3,2,65273,65273,65275,0,2,0
18747,4,1,65277,65277,65278,0,1,2
18748,3,1,65280,65280,65281,0,1,2
18749,2,1,65282,65282,65283,0,1,1
18750,4,1,65286,65286,65287,0,1,3
18751,2,2,65288,65288,65290,0,2,1
18752,3,2,65291,65291,65293,0,2,1
18753,1,1,65292,65293,65294,1,2,0
18754,4,3,65296,65296,65299,0,3,2
18755,5,1,65301,65301,65302,0,1,2
18756,2,3,65303,65303,65306,0,3,1
18757,1,3,65304,65306,65309,2,5,0
18758,6,3,65310,65310,65313,0,3,1
18759,4,1,65314,65314,65315,0,1,1
18760,6,3,65320,65320,65323,0,3,5
18761,3,2,65323,65323,65325,0,2,0
18762,1,3,65324,65325,65328,1,4,0
18763,2,2,65326,65328,65330,2,4,0
18764,5,2,65331,65331,65333,0,2,1
18765,4,3,65335,65335,65338,0,3,2
18766,3,1,65338,65338,65339,0,1,0
18767,5,1,65343,65343,65344,0,1,4
18768,4,3,65347,65347,65350,0,3,3
18769,6,2,65353,65353,65355,0,2,3
18770,5,1,65358,65358,65359,0,1,3
18771,2,1,65360,65360,65361,0,1,1
18772,3,3,65363,65363,65366,0,3,2
18773,2,3,65365,65366,65369,1,4,0
18774,6,2,65371,65371,65373,0,2,2
18775,3,1,65374,65374,65375,0,1,1
18776,1,2,65375,65375,65377,0,2,0
18777,4,2,65379,65379,65381,0,2,2
18778,4,3,65383,65383,65386,0,3,2
18779,6,1,65389,65389,65390,0,1,3
18780,3,1,65392,65392,65393,0,1,2
18781,3,3,65395,65395,65398,0,3,2
18782,2,1,65397,65398,65399,1,2,0
18783,4,3,65401,65401,65404,0,3,2
18784,4,2,65405,65405,65407,0,2,1
18785,3,2,65408,65408,65410,0,2,1
18786,5,3,65413,65413,65416,0,3,3
18787,6,3,65419,65419,65422,0,3,3
18788,3,2,65422,65422,65424,0,2,0
18789,6,2,65428,65428,65430,0,2,4
18790,6,1,65434,65434,65435,0,1,4
18791,3,3,65437,65437,65440,0,3,2
18792,3,2,65440,65440,65442,0,2,0
18793,4,2,65444,65444,65446,0,2,2
18794,5,2,65449,65449,65451,0,2,3
18795,1,1,65450,65451,65452,1,2,0
18796,1,1,65451,65452,65453,1,2,0
18797,1,3,65452,65453,65456,1,4,0
18798,1,2,65453,65456,65458,3,5,0
18799,5,1,65458,65458,65459,0,1,0
18800,3,1,65461,65461,65462,0,1,2
18801,4,1,65465,65465,65466,0,1,3
18802,6,2,65471,65471,65473,0,2,5
18803,2,3,65473,65473,65476,0,3,0
18804,6,1,65479,65479,65480,0,1,3
18805,2,2,65481,65481,65483,0,2,1
18806,6,1,65487,65487,65488,0,1,4
18807,2,2,65489,65489,65491,0,2,1
18808,6,3,65495,65495,65498,0,3,4
18809,2,1,65497,65498,65499,1,2,0
18810,2,3,65499,65499,65502,0,3,0
18811,2,2,65501,65502,65504,1,3,0
18812,4,1,65505,65505,65506,0,1,1
18813,6,3,65511,65511,65514,0,3,5
18814,4,3,65515,65515,65518,0,3,1
18815,5,3,65520,65520,65523,0,3,2
18816,6,3,65526,65526,65529,0,3,3
18817,4,1,65530,65530,65531,0,1,1
18818,2,3,65532,65532,65535,0,3,1
18819,2,2,65534,65535,65537,1,3,0
18820,2,3,65536,65537,65540,1,4,0
18821,6,1,65542,65542,65543,0,1,2
18822,2,2,65544,65544,65546,0,2,1
18823,3,2,65547,65547,65549,0,2,1
18824,6,2,65553,65553,65555,0,2,4
18825,6,2,65559,65559,65561,0,2,4
18826,5,1,65564,65564,65565,0,1,3
18827,1,1,65565,65565,65566,0,1,0
18828,6,2,65571,65571,65573,0,2,5
18829,3,2,65574,65574,65576,0,2,1
18830,6,1,65580,65580,65581,0,1,4
18831,6,2,65586,65586,65588,0,2,5
18832,1,2,65587,65588,65590,1,3,0
18833,6,2,65593,65593,65595,0,2,3
18834,6,2,65599,65599,65601,0,2,4
18835,4,1,65603,65603,65604,0,1,2
18836,3,3,65606,65606,65609,0,3,2
18837,3,2,65609,65609,65611,0,2,0
18838,2,1,65611,65611,65612,0,1,0
18839,2,1,65613,65613,65614,0,1,1
18840,6,1,65619,65619,65620,0,1,5
18841,4,2,65623,65623,65625,0,2,3
18842,1,2,65624,65625,65627,1,3,0
18843,4,3,65628,65628,65631,0,3,1
18844,2,1,65630,65631,65632,1,2,0
18845,4,1,65634,65634,65635,0,1,2
18846,5,2,65639,65639,65641,0,2,4
18847,4,3,65643,65643,65646,0,3,2
18848,1,1,65644,65646,65647,2,3,0
18849,5,2,65649,65649,65651,0,2,2
18850,4,2,65653,65653,65655,0,2,2
18851,6,1,65659,65659,65660,0,1,4
18852,6,1,65665,65665,65666,0,1,5
18853,1,3,65666,65666,65669,0,3,0
18854,3,1,65669,65669,65670,0,1,0
18855,1,2,65670,65670,65672,0,2,0
18856,4,3,65674,65674,65677,0,3,2
18857,4,3,65678,65678,65681,0,3,1
18858,5,1,65683,65683,65684,0,1,2
18859,4,1,65687,65687,65688,0,1,3
18860,1,1,65688,65688,65689,0,1,0
18861,1,2,65689,65689,65691,0,2,0
18862,5,2,65694,65694,65696,0,2,3
18863,5,3,65699,65699,65702,0,3,3
18864,1,1,65700,65702,65703,2,3,0
18865,5,1,65705,65705,65706,0,1,2
18866,3,1,65708,65708,65709,0,1,2
18867,1,3,65709,65709,65712,0,3,0
18868,6,3,65715,65715,65718,0,3,3
18869,6,1,65721,65721,65722,0,1,3
18870,2,3,65723,65723,65726,0,3,1
18871,3,1,65726,65726,65727,0,1,0
18872,1,3,65727,65727,65730,0,3,0
18873,3,3,65730,65730,65733,0,3,0
18874,2,3,65732,65733,65736,1,4,0
18875,3,2,65735,65736,65738,1,3,0
18876,1,1,65736,65738,65739,2,3,0
18877,6,1,65742,65742,65743,0,1,3
18878,4,3,65746,65746,65749,0,3,3
18879,1,2,65747,65749,65751,2,4,0
18880,3,3,65750,65751,65754,1,4,0
18881,4,2,65754,65754,65756,0,2,0
18882,1,1,65755,65756,65757,1,2,0
18883,3,3,65758,65758,65761,0,3,1
18884,4,2,65762,65762,65764,0,2,1
18885,5,1,65767,65767,65768,0,1,3
18886,1,2,65768,65768,65770,0,2,0
18887,1,1,65769,65770,65771,1,2,0
18888,3,3,65772,65772,65775,0,3,1
18889,6,3,65778,65778,65781,0,3,3
18890,1,1,65779,65781,65782,2,3,0
18891,3,3,65782,65782,65785,0,3,0
18892,6,3,65788,65788,65791,0,3,3
18893,2,2,65790,65791,65793,1,3,0
18894,3,1,65793,65793,65794,0,1,0
18895,3,1,65796,65796,65797,0,1,2
18896,2,1,65798,65798,65799,0,1,1
18897,2,2,65800,65800,65802,0,2,1
18898,2,2,65802,65802,65804,0,2,0
18899,3,2,65805,65805,65807,0,2,1
18900,1,1,65806,65807,65808,1,2,0
18901,1,2,65807,65808,65810,1,3,0
18902,6,1,65813,65813,65814,0,1,3
18903,2,1,65815,65815,65816,0,1,1
18904,4,1,65819,65819,65820,0,1,3
18905,1,2,65820,65820,65822,0,2,0
18906,1,3,65821,65822,65825,1,4,0
18907,1,2,65822,65825,65827,3,5,0
18908,4,3,65826,65827,65830,1,4,0
18909,4,1,65830,65830,65831,0,1,0
18910,1,3,65831,65831,65834,0,3,0
18911,3,3,65834,65834,65837,0,3,0
18912,6,3,65840,65840,65843,0,3,3
18913,6,1,65846,65846,65847,0,1,3
18914,4,1,65850,65850,65851,0,1,3
18915,2,1,65852,65852,65853,0,1,1
18916,6,2,65858,65858,65860,0,2,5
18917,4,3,65862,65862,65865,0,3,2
18918,2,1,65864,65865,65866,1,2,0
18919,1,2,65865,65866,65868,1,3,0
18920,1,3,65866,65868,65871,2,5,0
18921,2,1,65868,65871,65872,3,4,0
18922,4,3,65872,65872,65875,0,3,0
18923,3,2,65875,65875,65877,0,2,0
18924,1,3,65876,65877,65880,1,4,0
18925,6,2,65882,65882,65884,0,2,2
18926,4,2,65886,65886,65888,0,2,2
18927,6,3,65892,65892,65895,0,3,4
18928,3,1,65895,65895,65896,0,1,0
18929,4,1,65899,65899,65900,0,1,3
18930,1,2,65900,65900,65902,0,2,0
18931,2,3,65902,65902,65905,0,3,0
18932,3,2,65905,65905,65907,0,2,0
18933,4,2,65909,65909,65911,0,2,2
18934,1,1,65910,65911,65912,1,2,0
18935,2,3,65912,65912,65915,0,3,0
18936,6,2,65918,65918,65920,0,2,3
18937,4,3,65922,65922,65925,0,3,2
18938,1,3,65923,65925,65928,2,5,0
18939,1,1,65924,65928,65929,4,5,0
18940,5,3,65929,65929,65932,0,3,0
18941,6,2,65935,65935,65937,0,2,3
18942,5,1,65940,65940,65941,0,1,3
18943,1,1,65941,65941,65942,0,1,0
18944,3,3,65944,65944,65947,0,3,2
18945,6,1,65950,65950,65951,0,1,3
18946,6,1,65956,65956,65957,0,1,5
18947,6,3,65962,65962,65965,0,3,5
18948,4,3,65966,65966,65969,0,3,1
18949,4,2,65970,65970,65972,0,2,1
18950,3,1,65973,65973,65974,0,1,1
18951,2,1,65975,65975,65976,0,1,1
18952,5,2,65980,65980,65982,0,2,4
18953,5,1,65985,65985,65986,0,1,3
18954,4,3,65989,65989,65992,0,3,3
18955,2,1,65991,65992,65993,1,2,0
18956,4,1,65995,65995,65996,0,1,2
18957,6,2,66001,66001,66003,0,2,5
18958,1,2,66002,66003,66005,1,3,0
18959,1,1,66003,66005,66006,2,3,0
18960,2,2,66005,66006,66008,1,3,0
18961,3,1,66008,66008,66009,0,1,0
18962,4,2,66012,66012,66014,0,2,3
18963,1,3,66013,66014,66017,1,4,0
18964,4,1,66017,66017,66018,0,1,0
18965,1,1,66018,66018,66019,0,1,0
18966,3,3,66021,66021,66024,0,3,2
18967,1,2,66022,66024,66026,2,4,0
18968,3,1,66025,66026,66027,1,2,0
18969,1,3,66026,66027,66030,1,4,0
18970,3,1,66029,66030,66031,1,2,0
18971,5,1,66034,66034,66035,0,1,3
18972,1,2,66035,66035,66037,0,2,0
18973,6,2,66041,66041,66043,0,2,4
18974,1,3,66042,66043,66046,1,4,0
18975,6,3,66048,66048,66051,0,3,2
18976,1,1,66049,66051,66052,2,3,0
18977,1,1,66050,66052,66053,2,3,0
18978,4,1,66054,66054,66055,0,1,1
18979,3,1,66057,66057,66058,0,1,2
18980,6,1,66063,66063,66064,0,1,5
18981,5,1,66068,66068,66069,0,1,4
18982,6,3,66074,66074,66077,0,3,5
18983,3,3,66077,66077,66080,0,3,0
18984,4,2,66081,66081,66083,0,2,1
18985,6,1,66087,66087,66088,0,1,4
18986,2,2,66089,66089,66091,0,2,1
18987,4,1,66093,66093,66094,0,1,2
18988,4,1,66097,66097,66098,0,1,3
18989,2,1,66099,66099,66100,0,1,1
18990,2,1,66101,66101,66102,0,1,1
18991,2,2,66103,66103,66105,0,2,1
18992,3,3,66106,66106,66109,0,3,1
18993,1,3,66107,66109,66112,2,5,0
18994,1,3,66108,66112,66115,4,7,0
18995,6,3,66114,66115,66118,1,4,0
18996,6,1,66120,66120,66121,0,1,2
18997,6,1,66126,66126,66127,0,1,5
18998,5,2,66131,66131,66133,0,2,4
18999,2,1,66133,66133,66134,0,1,0
19000,6,1,66139,66139,66140,0,1,5
19001,3,3,66142,66142,66145,0,3,2
19002,4,1,66146,66146,66147,0,1,1
19003,5,2,66151,66151,66153,0,2,4
19004,1,3,66152,66153,66156,1,4,0
19005,5,1,66157,66157,66158,0,1,1
19006,3,2,66160,66160,66162,0,2,2
19007,5,2,66165,66165,66167,0,2,3
19008,6,1,66171,66171,66172,0,1,4
19009,2,3,66173,66173,66176,0,3,1
19010,2,1,66175,66176,66177,1,2,0
19011,6,3,66181,66181,66184,0,3,4
19012,3,3,66184,66184,66187,0,3,0
19013,6,2,66190,66190,66192,0,2,3
19014,1,2,66191,66192,66194,1,3,0
19015,6,3,66197,66197,66200,0,3,3
19016,6,3,66203,66203,66206,0,3,3
19017,5,1,66208,66208,66209,0,1,2
19018,6,3,66214,66214,66217,0,3,5
19019,3,1,66217,66217,66218,0,1,0
19020,2,2,66219,66219,66221,0,2,1
19021,6,3,66225,66225,66228,0,3,4
19022,5,1,66230,66230,66231,0,1,2
19023,3,3,66233,66233,66236,0,3,2
19024,2,3,66235,66236,66239,1,4,0
19025,2,2,66237,66239,66241,2,4,0
19026,5,2,66242,66242,66244,0,2,1
19027,1,1,66243,66244,66245,1,2,0
19028,5,2,66248,66248,66250,0,2,3
19029,1,2,66249,66250,66252,1,3,0
19030,5,2,66254,66254,66256,0,2,2
19031,4,3,66258,66258,66261,0,3,2
19032,2,3,66260,66261,66264,1,4,0
19033,1,1,66261,66264,66265,3,4,0
19034,2,3,66263,66265,66268,2,5,0
19035,5,1,66268,66268,66269,0,1,0
19036,4,2,66272,66272,66274,0,2,3
19037,1,2,66273,66274,66276,1,3,0
19038,5,2,66278,66278,66280,0,2,2
19039,4,2,66282,66282,66284,0,2,2
19040,5,1,66287,66287,66288,0,1,3
19041,1,1,66288,66288,66289,0,1,0
19042,5,1,66293,66293,66294,0,1,4
19043,6,1,66299,66299,66300,0,1,5
19044,6,1,66305,66305,66306,0,1,5
19045,5,3,66310,66310,66313,0,3,4
19046,4,1,66314,66314,66315,0,1,1
19047,1,2,66315,66315,66317,0,2,0
19048,1,2,66316,66317,66319,1,3,0
19049,3,1,66319,66319,66320,0,1,0
19050,5,2,66324,66324,66326,0,2,4
19051,4,3,66328,66328,66331,0,3,2
19052,6,2,66334,66334,66336,0,2,3
19053,5,2,66339,66339,66341,0,2,3
19054,4,2,66343,66343,66345,0,2,2
19055,5,3,66348,66348,66351,0,3,3
19056,6,2,66354,66354,66356,0,2,3
19057,4,1,66358,66358,66359,0,1,2
19058,6,2,66364,66364,66366,0,2,5
19059,2,1,66366,66366,66367,0,1,0
19060,4,2,66370,66370,66372,0,2,3
19061,1,1,66371,66372,66373,1,2,0
19062,3,1,66374,66374,66375,0,1,1
19063,2,1,66376,66376,66377,0,1,1
19064,1,2,66377,66377,66379,0,2,0
19065,6,3,66383,66383,66386,0,3,4
19066,2,1,66385,66386,66387,1,2,0
19067,4,1,66389,66389,66390,0,1,2
19068,3,3,66392,66392,66395,0,3,2
19069,4,1,66396,66396,66397,0,1,1
19070,3,2,66399,66399,66401,0,2,2
19071,6,3,66405,66405,66408,0,3,4
19072,1,2,66406,66408,66410,2,4,0
19073,5,1,66411,66411,66412,0,1,1
19074,3,2,66414,66414,66416,0,2,2
19075,6,2,66420,66420,66422,0,2,4
19076,1,2,66421,66422,66424,1,3,0
19077,3,2,66424,66424,66426,0,2,0
19078,2,2,66426,66426,66428,0,2,0
19079,2,1,66428,66428,66429,0,1,0
19080,2,3,66430,66430,66433,0,3,1
19081,3,1,66433,66433,66434,0,1,0
19082,5,1,66438,66438,66439,0,1,4
19083,4,2,66442,66442,66444,0,2,3
19084,6,1,66448,66448,66449,0,1,4
19085,5,2,66453,66453,66455,0,2,4
19086,3,1,66456,66456,66457,0,1,1
19087,2,3,66458,66458,66461,0,3,1
19088,5,2,66463,66463,66465,0,2,2
19089,1,3,66464,66465,66468,1,4,0
19090,6,3,66470,66470,66473,0,3,2
19091,2,2,66472,66473,66475,1,3,0
19092,3,3,66475,66475,66478,0,3,0
19093,2,2,66477,66478,66480,1,3,0
19094,5,3,66482,66482,66485,0,3,2
19095,2,3,66484,66485,66488,1,4,0
19096,3,3,66487,66488,66491,1,4,0
19097,3,1,66490,66491,66492,1,2,0
19098,1,2,66491,66492,66494,1,3,0
19099,3,1,66494,66494,66495,0,1,0
19100,1,3,66495,66495,66498,0,3,0
19101,5,2,66500,66500,66502,0,2,2
19102,2,1,66502,66502,66503,0,1,0
19103,2,2,66504,66504,66506,0,2,1
19104,1,2,66505,66506,66508,1,3,0
19105,3,3,66508,66508,66511,0,3,0
19106,1,3,66509,66511,66514,2,5,0
19107,6,3,66515,66515,66518,0,3,1
19108,5,1,66520,66520,66521,0,1,2
19109,4,2,66524,66524,66526,0,2,3
19110,6,3,66530,66530,66533,0,3,4
19111,1,2,66531,66533,66535,2,4,0
19112,4,1,66535,66535,66536,0,1,0
19113,5,1,66540,66540,66541,0,1,4
19114,2,3,66542,66542,66545,0,3,1
19115,4,2,66546,66546,66548,0,2,1
19116,6,3,66552,66552,66555,0,3,4
19117,1,2,66553,66555,66557,2,4,0
19118,4,2,66557,66557,66559,0,2,0
19119,5,1,66562,66562,66563,0,1,3
19120,1,2,66563,66563,66565,0,2,0
19121,5,1,66568,66568,66569,0,1,3
19122,2,1,66570,66570,66571,0,1,1
19123,6,3,66576,66576,66579,0,3,5
19124,4,2,66580,66580,66582,0,2,1
19125,2,3,66582,66582,66585,0,3,0
19126,1,1,66583,66585,66586,2,3,0
19127,6,2,66589,66589,66591,0,2,3
19128,1,3,66590,66591,66594,1,4,0
19129,3,2,66593,66594,66596,1,3,0
19130,4,3,66597,66597,66600,0,3,1
19131,1,1,66598,66600,66601,2,3,0
19132,5,2,66603,66603,66605,0,2,2
19133,4,2,66607,66607,66609,0,2,2
19134,6,3,66613,66613,66616,0,3,4
19135,6,3,66619,66619,66622,0,3,3
19136,2,3,66621,66622,66625,1,4,0
19137,1,1,66622,66625,66626,3,4,0
19138,5,3,66627,66627,66630,0,3,1
19139,6,2,66633,66633,66635,0,2,3
19140,6,2,66639,66639,66641,0,2,4
19141,6,1,66645,66645,66646,0,1,4
19142,1,2,66646,66646,66648,0,2,0
19143,2,2,66648,66648,66650,0,2,0
19144,3,2,66651,66651,66653,0,2,1
19145,3,2,66654,66654,66656,0,2,1
19146,1,2,66655,66656,66658,1,3,0
19147,5,2,66660,66660,66662,0,2,2
19148,2,3,66662,66662,66665,0,3,0
19149,4,1,66666,66666,66667,0,1,1
19150,4,2,66670,66670,66672,0,2,3
19151,1,3,66671,66672,66675,1,4,0
19152,4,1,66675,66675,66676,0,1,0
19153,3,3,66678,66678,66681,0,3,2
19154,5,2,66683,66683,66685,0,2,2
19155,6,3,66689,66689,66692,0,3,4
19156,3,1,66692,66692,66693,0,1,0
19157,5,2,66697,66697,66699,0,2,4
19158,2,3,66699,66699,66702,0,3,0
19159,5,3,66704,66704,66707,0,3,2
19160,6,2,66710,66710,66712,0,2,3
19161,2,3,66712,66712,66715,0,3,0
19162,6,2,66718,66718,66720,0,2,3
19163,3,3,66721,66721,66724,0,3,1
19164,4,2,66725,66725,66727,0,2,1
19165,2,3,66727,66727,66730,0,3,0
19166,4,2,66731,66731,66733,0,2,1
19167,5,1,66736,66736,66737,0,1,3
19168,3,3,66739,66739,66742,0,3,2
19169,2,1,66741,66742,66743,1,2,0
19170,3,3,66744,66744,66747,0,3,1
19171,6,2,66750,66750,66752,0,2,3
19172,6,2,66756,66756,66758,0,2,4
19173,3,1,66759,66759,66760,0,1,1
19174,1,3,66760,66760,66763,0,3,0
19175,1,1,66761,66763,66764,2,3,0
19176,2,1,66763,66764,66765,1,2,0
19177,2,1,66765,66765,66766,0,1,0
19178,3,2,66768,66768,66770,0,2,2
19179,4,2,66772,66772,66774,0,2,2
19180,4,3,66776,66776,66779,0,3,2
19181,1,3,66777,66779,66782,2,5,0
19182,2,2,66779,66782,66784,3,5,0
19183,3,3,66782,66784,66787,2,5,0
19184,4,2,66786,66787,66789,1,3,0
19185,4,2,66790,66790,66792,0,2,1
19186,3,3,66793,66793,66796,0,3,1
19187,1,1,66794,66796,66797,2,3,0
19188,1,1,66795,66797,66798,2,3,0
19189,3,2,66798,66798,66800,0,2,0
19190,1,2,66799,66800,66802,1,3,0
19191,3,3,66802,66802,66805,0,3,0
19192,1,2,66803,66805,66807,2,4,0
19193,3,3,66806,66807,66810,1,4,0
19194,1,3,66807,66810,66813,3,6,0
19195,4,1,66811,66813,66814,2,3,0
19196,4,1,66815,66815,66816,0,1,1
19197,1,2,66816,66816,66818,0,2,0
19198,6,1,66822,66822,66823,0,1,4
19199,3,3,66825,66825,66828,0,3,2
19200,2,2,66827,66828,66830,1,3,0
19201,3,2,66830,66830,66832,0,2,0
19202,2,3,66832,66832,66835,0,3,0
19203,1,3,66833,66835,66838,2,5,0
19204,2,2,66835,66838,66840,3,5,0
19205,2,3,66837,66840,66843,3,6,0
19206,1,2,66838,66843,66845,5,7,0
19207,5,2,66843,66845,66847,2,4,0
19208,6,2,66849,66849,66851,0,2,2
19209,5,1,66854,66854,66855,0,1,3
19210,5,1,66859,66859,66860,0,1,4
19211,4,1,66863,66863,66864,0,1,3
19212,2,3,66865,66865,66868,0,3,1
19213,5,2,66870,66870,66872,0,2,2
19214,3,2,66873,66873,66875,0,2,1
19215,1,2,66874,66875,66877,1,3,0
19216,4,3,66878,66878,66881,0,3,1
19217,3,2,66881,66881,66883,0,2,0
19218,6,3,66887,66887,66890,0,3,4
19219,2,2,66889,66890,66892,1,3,0
19220,6,3,66895,66895,66898,0,3,3
19221,5,3,66900,66900,66903,0,3,2
19222,6,1,66906,66906,66907,0,1,3
19223,2,1,66908,66908,66909,0,1,1
19224,5,1,66913,66913,66914,0,1,4
19225,6,3,66919,66919,66922,0,3,5
19226,5,1,66924,66924,66925,0,1,2
19227,1,3,66925,66925,66928,0,3,0
19228,1,2,66926,66928,66930,2,4,0
19229,6,3,66932,66932,66935,0,3,2
19230,1,1,66933,66935,66936,2,3,0
19231,4,2,66937,66937,66939,0,2,1
19232,5,2,66942,66942,66944,0,2,3
19233,5,2,66947,66947,66949,0,2,3
19234,4,2,66951,66951,66953,0,2,2
19235,5,1,66956,66956,66957,0,1,3
19236,3,1,66959,66959,66960,0,1,2
19237,4,2,66963,66963,66965,0,2,3
19238,1,1,66964,66965,66966,1,2,0
19239,2,1,66966,66966,66967,0,1,0
19240,3,3,66969,66969,66972,0,3,2
19241,2,2,66971,66972,66974,1,3,0
19242,3,3,66974,66974,66977,0,3,0
19243,4,1,66978,66978,66979,0,1,1
19244,5,1,66983,66983,66984,0,1,4
19245,2,2,66985,66985,66987,0,2,1
19246,6,2,66991,66991,66993,0,2,4
19247,1,3,66992,66993,66996,1,4,0
19248,2,1,66994,66996,66997,2,3,0
19249,3,3,66997,66997,67000,0,3,0
19250,3,1,67000,67000,67001,0,1,0
19251,3,1,67003,67003,67004,0,1,2
19252,6,3,67009,67009,67012,0,3,5
19253,1,2,67010,67012,67014,2,4,0
19254,5,1,67015,67015,67016,0,1,1
19255,3,2,67018,67018,67020,0,2,2
19256,1,3,67019,67020,67023,1,4,0
19257,3,1,67022,67023,67024,1,2,0
19258,5,2,67027,67027,67029,0,2,3
19259,3,2,67030,67030,67032,0,2,1
19260,3,1,67033,67033,67034,0,1,1
19261,6,1,67039,67039,67040,0,1,5
19262,4,2,67043,67043,67045,0,2,3
19263,5,2,67048,67048,67050,0,2,3
19264,6,1,67054,67054,67055,0,1,4
19265,3,2,67057,67057,67059,0,2,2
19266,5,2,67062,67062,67064,0,2,3
19267,5,1,67067,67067,67068,0,1,3
19268,2,3,67069,67069,67072,0,3,1
19269,3,2,67072,67072,67074,0,2,0
19270,1,2,67073,67074,67076,1,3,0
19271,2,1,67075,67076,67077,1,2,0
19272,1,3,67076,67077,67080,1,4,0
19273,1,2,67077,67080,67082,3,5,0
19274,3,1,67080,67082,67083,2,3,0
19275,2,3,67082,67083,67086,1,4,0
19276,6,1,67088,67088,67089,0,1,2
19277,1,2,67089,67089,67091,0,2,0
19278,1,3,67090,67091,67094,1,4,0
19279,5,1,67095,67095,67096,0,1,1
19280,4,2,67099,67099,67101,0,2,3
19281,4,1,67103,67103,67104,0,1,2
19282,3,2,67106,67106,67108,0,2,2
19283,1,2,67107,67108,67110,1,3,0
19284,1,3,67108,67110,67113,2,5,0
19285,6,2,67114,67114,67116,0,2,1
19286,4,1,67118,67118,67119,0,1,2
19287,3,2,67121,67121,67123,0,2,2
19288,4,2,67125,67125,67127,0,2,2
19289,2,2,67127,67127,67129,0,2,0
19290,5,2,67132,67132,67134,0,2,3
19291,5,1,67137,67137,67138,0,1,3
19292,2,3,67139,67139,67142,0,3,1
19293,1,3,67140,67142,67145,2,5,0
19294,2,1,67142,67145,67146,3,4,0
19295,3,3,67145,67146,67149,1,4,0
19296,4,1,67149,67149,67150,0,1,0
19297,5,2,67154,67154,67156,0,2,4
19298,1,2,67155,67156,67158,1,3,0
19299,3,1,67158,67158,67159,0,1,0
19300,4,2,67162,67162,67164,0,2,3
19301,3,3,67165,67165,67168,0,3,1
19302,6,2,67171,67171,67173,0,2,3
19303,6,2,67177,67177,67179,0,2,4
19304,1,1,67178,67179,67180,1,2,0
19305,5,1,67183,67183,67184,0,1,3
19306,6,1,67189,67189,67190,0,1,5
19307,4,2,67193,67193,67195,0,2,3
19308,2,2,67195,67195,67197,0,2,0
19309,4,2,67199,67199,67201,0,2,2
19310,2,1,67201,67201,67202,0,1,0
19311,5,1,67206,67206,67207,0,1,4
19312,4,3,67210,67210,67213,0,3,3
19313,3,1,67213,67213,67214,0,1,0
19314,5,1,67218,67218,67219,0,1,4
19315,6,2,67224,67224,67226,0,2,5
19316,5,2,67229,67229,67231,0,2,3
19317,3,1,67232,67232,67233,0,1,1
19318,3,3,67235,67235,67238,0,3,2
19319,4,2,67239,67239,67241,0,2,1
19320,1,2,67240,67241,67243,1,3,0
19321,3,2,67243,67243,67245,0,2,0
19322,4,2,67247,67247,67249,0,2,2
19323,6,1,67253,67253,67254,0,1,4
19324,3,1,67256,67256,67257,0,1,2
19325,2,2,67258,67258,67260,0,2,1
19326,5,2,67263,67263,67265,0,2,3
19327,5,2,67268,67268,67270,0,2,3
19328,5,1,67273,67273,67274,0,1,3
19329,1,2,67274,67274,67276,0,2,0
19330,3,3,67277,67277,67280,0,3,1
19331,5,1,67282,67282,67283,0,1,2
19332,6,2,67288,67288,67290,0,2,5
19333,4,1,67292,67292,67293,0,1,2
19334,6,2,67298,67298,67300,0,2,5
19335,3,2,67301,67301,67303,0,2,1
19336,1,2,67302,67303,67305,1,3,0
19337,6,2,67308,67308,67310,0,2,3
19338,4,2,67312,67312,67314,0,2,2
19339,2,1,67314,67314,67315,0,1,0
19340,4,3,67318,67318,67321,0,3,3
19341,1,3,67319,67321,67324,2,5,0
19342,6,3,67325,67325,67328,0,3,1
19343,3,2,67328,67328,67330,0,2,0
19344,6,3,67334,67334,67337,0,3,4
19345,5,1,67339,67339,67340,0,1,2
19346,2,1,67341,67341,67342,0,1,1
19347,5,1,67346,67346,67347,0,1,4
19348,5,1,67351,67351,67352,0,1,4
19349,1,3,67352,67352,67355,0,3,0
19350,1,2,67353,67355,67357,2,4,0
19351,4,2,67357,67357,67359,0,2,0
19352,3,2,67360,67360,67362,0,2,1
19353,5,1,67365,67365,67366,0,1,3
19354,4,3,67369,67369,67372,0,3,3
19355,4,3,67373,67373,67376,0,3,1
19356,5,2,67378,67378,67380,0,2,2
19357,3,2,67381,67381,67383,0,2,1
19358,3,3,67384,67384,67387,0,3,1
19359,5,2,67389,67389,67391,0,2,2
19360,2,1,67391,67391,67392,0,1,0
19361,6,2,67397,67397,67399,0,2,5
19362,6,2,67403,67403,67405,0,2,4
19363,4,3,67407,67407,67410,0,3,2
19364,1,3,67408,67410,67413,2,5,0
19365,3,1,67411,67413,67414,2,3,0
19366,3,3,67414,67414,67417,0,3,0
19367,6,3,67420,67420,67423,0,3,3
19368,5,2,67425,67425,67427,0,2,2
19369,4,1,67429,67429,67430,0,1,2
19370,2,1,67431,67431,67432,0,1,1
19371,6,3,67437,67437,67440,0,3,5
19372,6,1,67443,67443,67444,0,1,3
19373,6,1,67449,67449,67450,0,1,5
19374,6,2,67455,67455,67457,0,2,5
19375,3,3,67458,67458,67461,0,3,1
19376,1,2,67459,67461,67463,2,4,0
19377,1,1,67460,67463,67464,3,4,0
19378,6,2,67466,67466,67468,0,2,2
19379,6,2,67472,67472,67474,0,2,4
19380,1,1,67473,67474,67475,1,2,0
19381,4,3,67477,67477,67480,0,3,2
19382,3,3,67480,67480,67483,0,3,0
19383,5,1,67485,67485,67486,0,1,2
19384,5,2,67490,67490,67492,0,2,4
19385,2,1,67492,67492,67493,0,1,0
19386,5,1,67497,67497,67498,0,1,4
19387,5,2,67502,67502,67504,0,2,4
19388,2,2,67504,67504,67506,0,2,0
19389,4,1,67508,67508,67509,0,1,2
19390,3,3,67511,67511,67514,0,3,2
19391,2,2,67513,67514,67516,1,3,0
19392,2,3,67515,67516,67519,1,4,0
19393,3,1,67518,67519,67520,1,2,0
19394,5,2,67523,67523,67525,0,2,3
19395,3,2,67526,67526,67528,0,2,1
19396,5,3,67531,67531,67534,0,3,3
19397,5,3,67536,67536,67539,0,3,2
19398,1,2,67537,67539,67541,2,4,0
19399,5,2,67542,67542,67544,0,2,1
19400,5,2,67547,67547,67549,0,2,3
19401,3,1,67550,67550,67551,0,1,1
19402,6,3,67556,67556,67559,0,3,5
19403,1,2,67557,67559,67561,2,4,0
19404,5,3,67562,67562,67565,0,3,1
19405,3,2,67565,67565,67567,0,2,0
19406,4,1,67569,67569,67570,0,1,2
19407,5,3,67574,67574,67577,0,3,4
19408,4,1,67578,67578,67579,0,1,1
19409,6,3,67584,67584,67587,0,3,5
19410,5,2,67589,67589,67591,0,2,2
19411,2,2,67591,67591,67593,0,2,0
19412,6,3,67597,67597,67600,0,3,4
19413,6,2,67603,67603,67605,0,2,3
19414,1,1,67604,67605,67606,1,2,0
19415,2,3,67606,67606,67609,0,3,0
19416,6,1,67612,67612,67613,0,1,3
19417,5,1,67617,67617,67618,0,1,4
19418,3,1,67620,67620,67621,0,1,2
19419,6,2,67626,67626,67628,0,2,5
19420,6,1,67632,67632,67633,0,1,4
19421,4,3,67636,67636,67639,0,3,3
19422,1,3,67637,67639,67642,2,5,0
19423,2,1,67639,67642,67643,3,4,0
19424,1,1,67640,67643,67644,3,4,0
19425,2,1,67642,67644,67645,2,3,0
19426,4,2,67646,67646,67648,0,2,1
19427,4,1,67650,67650,67651,0,1,2
19428,4,3,67654,67654,67657,0,3,3
19429,5,3,67659,67659,67662,0,3,2
19430,1,2,67660,67662,67664,2,4,0
19431,3,3,67663,67664,67667,1,4,0
19432,6,3,67669,67669,67672,0,3,2
19433,2,1,67671,67672,67673,1,2,0
19434,2,2,67673,67673,67675,0,2,0
19435,1,2,67674,67675,67677,1,3,0
19436,5,2,67679,67679,67681,0,2,2
19437,1,2,67680,67681,67683,1,3,0
19438,5,3,67685,67685,67688,0,3,2
19439,3,3,67688,67688,67691,0,3,0
19440,4,3,67692,67692,67695,0,3,1
19441,3,1,67695,67695,67696,0,1,0
19442,3,1,67698,67698,67699,0,1,2
19443,2,1,67700,67700,67701,0,1,1
19444,6,3,67706,67706,67709,0,3,5
19445,3,3,67709,67709,67712,0,3,0
19446,6,2,67715,67715,67717,0,2,3
19447,6,2,67721,67721,67723,0,2,4
19448,4,1,67725,67725,67726,0,1,2
19449,5,1,67730,67730,67731,0,1,4
19450,1,2,67731,67731,67733,0,2,0
19451,5,2,67736,67736,67738,0,2,3
19452,4,1,67740,67740,67741,0,1,2
19453,3,1,67743,67743,67744,0,1,2
19454,2,2,67745,67745,67747,0,2,1
19455,3,1,67748,67748,67749,0,1,1
19456,2,2,67750,67750,67752,0,2,1
19457,3,2,67753,67753,67755,0,2,1
19458,4,2,67757,67757,67759,0,2,2
19459,6,2,67763,67763,67765,0,2,4
19460,4,2,67767,67767,67769,0,2,2
19461,3,3,67770,67770,67773,0,3,1
19462,3,3,67773,67773,67776,0,3,0
19463,1,3,67774,67776,67779,2,5,0
19464,1,3,67775,67779,67782,4,7,0
19465,1,2,67776,67782,67784,6,8,0
19466,6,3,67782,67784,67787,2,5,0
19467,6,2,67788,67788,67790,0,2,1
19468,1,3,67789,67790,67793,1,4,0
19469,3,3,67792,67793,67796,1,4,0
19470,5,1,67797,67797,67798,0,1,1
19471,4,3,67801,67801,67804,0,3,3
19472,1,2,67802,67804,67806,2,4,0
19473,4,1,67806,67806,67807,0,1,0
19474,6,1,67812,67812,67813,0,1,5
19475,2,1,67814,67814,67815,0,1,1
19476,4,2,67818,67818,67820,0,2,3
19477,1,3,67819,67820,67823,1,4,0
19478,6,2,67825,67825,67827,0,2,2
19479,3,1,67828,67828,67829,0,1,1
19480,6,3,67834,67834,67837,0,3,5
19481,2,3,67836,67837,67840,1,4,0
19482,5,1,67841,67841,67842,0,1,1
19483,2,1,67843,67843,67844,0,1,1
19484,6,3,67849,67849,67852,0,3,5
19485,5,3,67854,67854,67857,0,3,2
19486,5,2,67859,67859,67861,0,2,2
19487,5,1,67864,67864,67865,0,1,3
19488,6,3,67870,67870,67873,0,3,5
19489,2,3,67872,67873,67876,1,4,0
19490,6,3,67878,67878,67881,0,3,2
19491,5,3,67883,67883,67886,0,3,2
19492,6,3,67889,67889,67892,0,3,3
19493,6,2,67895,67895,67897,0,2,3
19494,1,1,67896,67897,67898,1,2,0
19495,5,1,67901,67901,67902,0,1,3
19496,3,1,67904,67904,67905,0,1,2
19497,5,3,67909,67909,67912,0,3,4
19498,2,2,67911,67912,67914,1,3,0
19499,4,3,67915,67915,67918,0,3,1
19500,6,3,67921,67921,67924,0,3,3
19501,3,2,67924,67924,67926,0,2,0
19502,4,3,67928,67928,67931,0,3,2
19503,1,2,67929,67931,67933,2,4,0
19504,5,1,67934,67934,67935,0,1,1
19505,1,2,67935,67935,67937,0,2,0
19506,4,3,67939,67939,67942,0,3,2
19507,2,1,67941,67942,67943,1,2,0
19508,2,2,67943,67943,67945,0,2,0
19509,4,2,67947,67947,67949,0,2,2
19510,5,2,67952,67952,67954,0,2,3
19511,1,1,67953,67954,67955,1,2,0
19512,6,3,67959,67959,67962,0,3,4
19513,2,3,67961,67962,67965,1,4,0
19514,2,2,67963,67965,67967,2,4,0
19515,3,3,67966,67967,67970,1,4,0
19516,4,1,67970,67970,67971,0,1,0
19517,2,2,67972,67972,67974,0,2,1
19518,6,1,67978,67978,67979,0,1,4
19519,5,1,67983,67983,67984,0,1,4
19520,1,3,67984,67984,67987,0,3,0
19521,5,1,67989,67989,67990,0,1,2
19522,3,1,67992,67992,67993,0,1,2
19523,5,3,67997,67997,68000,0,3,4
19524,2,1,67999,68000,68001,1,2,0
19525,2,2,68001,68001,68003,0,2,0
19526,1,3,68002,68003,68006,1,4,0
19527,5,3,68007,68007,68010,0,3,1
19528,6,3,68013,68013,68016,0,3,3
19529,2,3,68015,68016,68019,1,4,0
19530,1,3,68016,68019,68022,3,6,0
19531,6,1,68022,68022,68023,0,1,0
19532,1,2,68023,68023,68025,0,2,0
19533,5,3,68028,68028,68031,0,3,3
19534,3,3,68031,68031,68034,0,3,0
19535,6,3,68037,68037,68040,0,3,3
19536,3,3,68040,68040,68043,0,3,0
19537,2,3,68042,68043,68046,1,4,0
19538,4,1,68046,68046,68047,0,1,0
19539,6,1,68052,68052,68053,0,1,5
19540,2,3,68054,68054,68057,0,3,1
19541,6,2,68060,68060,68062,0,2,3
19542,6,2,68066,68066,68068,0,2,4
19543,4,1,68070,68070,68071,0,1,2
19544,5,3,68075,68075,68078,0,3,4
19545,2,1,68077,68078,68079,1,2,0
19546,6,2,68083,68083,68085,0,2,4
19547,2,2,68085,68085,68087,0,2,0
19548,6,3,68091,68091,68094,0,3,4
19549,3,3,68094,68094,68097,0,3,0
19550,2,3,68096,68097,68100,1,4,0
19551,4,3,68100,68100,68103,0,3,0
19552,4,3,68104,68104,68107,0,3,1
19553,1,2,68105,68107,68109,2,4,0
19554,3,1,68108,68109,68110,1,2,0
19555,4,2,68112,68112,68114,0,2,2
19556,6,3,68118,68118,68121,0,3,4
19557,4,2,68122,68122,68124,0,2,1
19558,1,1,68123,68124,68125,1,2,0
19559,1,2,68124,68125,68127,1,3,0
19560,3,1,68127,68127,68128,0,1,0
19561,5,3,68132,68132,68135,0,3,4
19562,5,1,68137,68137,68138,0,1,2
19563,1,1,68138,68138,68139,0,1,0
19564,2,2,68140,68140,68142,0,2,1
19565,2,1,68142,68142,68143,0,1,0
19566,5,3,68147,68147,68150,0,3,4
19567,5,1,68152,68152,68153,0,1,2
19568,2,3,68154,68154,68157,0,3,1
19569,5,2,68159,68159,68161,0,2,2
19570,5,1,68164,68164,68165,0,1,3
19571,3,3,68167,68167,68170,0,3,2
19572,4,2,68171,68171,68173,0,2,1
19573,1,1,68172,68173,68174,1,2,0
19574,3,2,68175,68175,68177,0,2,1
19575,4,2,68179,68179,68181,0,2,2
19576,5,2,68184,68184,68186,0,2,3
19577,2,2,68186,68186,68188,0,2,0
19578,6,1,68192,68192,68193,0,1,4
19579,4,3,68196,68196,68199,0,3,3
19580,1,1,68197,68199,68200,2,3,0
19581,5,1,68202,68202,68203,0,1,2
19582,5,3,68207,68207,68210,0,3,4
19583,3,3,68210,68210,68213,0,3,0
19584,5,3,68215,68215,68218,0,3,2
19585,2,3,68217,68218,68221,1,4,0
19586,4,2,68221,68221,68223,0,2,0
19587,4,1,68225,68225,68226,0,1,2
19588,3,3,68228,68228,68231,0,3,2
19589,5,1,68233,68233,68234,0,1,2
19590,4,2,68237,68237,68239,0,2,3
19591,4,2,68241,68241,68243,0,2,2
19592,2,1,68243,68243,68244,0,1,0
19593,1,3,68244,68244,68247,0,3,0
19594,4,1,68248,68248,68249,0,1,1
19595,6,3,68254,68254,68257,0,3,5
19596,1,1,68255,68257,68258,2,3,0
19597,6,2,68261,68261,68263,0,2,3
19598,5,1,68266,68266,68267,0,1,3
19599,1,2,68267,68267,68269,0,2,0
19600,2,1,68269,68269,68270,0,1,0
19601,3,1,68272,68272,68273,0,1,2
19602,3,1,68275,68275,68276,0,1,2
19603,6,2,68281,68281,68283,0,2,5
19604,2,2,68283,68283,68285,0,2,0
19605,1,2,68284,68285,68287,1,3,0
19606,4,1,68288,68288,68289,0,1,1
19607,6,1,68294,68294,68295,0,1,5
19608,3,1,68297,68297,68298,0,1,2
19609,3,3,68300,68300,68303,0,3,2
19610,2,3,68302,68303,68306,1,4,0
19611,5,3,68307,68307,68310,0,3,1
19612,6,1,68313,68313,68314,0,1,3
19613,3,2,68316,68316,68318,0,2,2
19614,2,2,68318,68318,68320,0,2,0
19615,1,2,68319,68320,68322,1,3,0
19616,3,3,68322,68322,68325,0,3,0
19617,5,3,68327,68327,68330,0,3,2
19618,6,1,68333,68333,68334,0,1,3
19619,2,2,68335,68335,68337,0,2,1
19620,5,1,68340,68340,68341,0,1,3
19621,6,2,68346,68346,68348,0,2,5
19622,3,2,68349,68349,68351,0,2,1
19623,4,2,68353,68353,68355,0,2,2
19624,3,1,68356,68356,68357,0,1,1
19625,2,3,68358,68358,68361,0,3,1
19626,3,2,68361,68361,68363,0,2,0
19627,6,3,68367,68367,68370,0,3,4
19628,6,3,68373,68373,68376,0,3,3
19629,3,2,68376,68376,68378,0,2,0
19630,4,3,68380,68380,68383,0,3,2
19631,2,2,68382,68383,68385,1,3,0
19632,3,2,68385,68385,68387,0,2,0
19633,6,1,68391,68391,68392,0,1,4
19634,1,2,68392,68392,68394,0,2,0
19635,5,1,68397,68397,68398,0,1,3
19636,1,2,68398,68398,68400,0,2,0
19637,1,3,68399,68400,68403,1,4,0
19638,1,1,68400,68403,68404,3,4,0
19639,1,1,68401,68404,68405,3,4,0
19640,3,2,68404,68405,68407,1,3,0
19641,1,3,68405,68407,68410,2,5,0
19642,5,1,68410,68410,68411,0,1,0
19643,3,3,68413,68413,68416,0,3,2
19644,6,2,68419,68419,68421,0,2,3
19645,2,3,68421,68421,68424,0,3,0
19646,3,2,68424,68424,68426,0,2,0
19647,4,3,68428,68428,68431,0,3,2
19648,6,1,68434,68434,68435,0,1,3
19649,3,3,68437,68437,68440,0,3,2
19650,6,3,68443,68443,68446,0,3,3
19651,1,1,68444,68446,68447,2,3,0
19652,3,3,68447,68447,68450,0,3,0
19653,2,1,68449,68450,68451,1,2,0
19654,2,3,68451,68451,68454,0,3,0
19655,3,1,68454,68454,68455,0,1,0
19656,1,1,68455,68455,68456,0,1,0
19657,3,2,68458,68458,68460,0,2,2
19658,2,3,68460,68460,68463,0,3,0
19659,1,1,68461,68463,68464,2,3,0
19660,1,3,68462,68464,68467,2,5,0
19661,6,1,68468,68468,68469,0,1,1
19662,1,1,68469,68469,68470,0,1,0
19663,1,3,68470,68470,68473,0,3,0
19664,1,2,68471,68473,68475,2,4,0
19665,3,2,68474,68475,68477,1,3,0
19666,2,1,68476,68477,68478,1,2,0
19667,6,1,68482,68482,68483,0,1,4
19668,4,2,68486,68486,68488,0,2,3
19669,2,1,68488,68488,68489,0,1,0
19670,6,1,68494,68494,68495,0,1,5
19671,4,1,68498,68498,68499,0,1,3
19672,1,3,68499,68499,68502,0,3,0
19673,3,1,68502,68502,68503,0,1,0
19674,5,1,68507,68507,68508,0,1,4
19675,6,3,68513,68513,68516,0,3,5
19676,4,1,68517,68517,68518,0,1,1
19677,3,1,68520,68520,68521,0,1,2
19678,1,2,68521,68521,68523,0,2,0
19679,5,1,68526,68526,68527,0,1,3
19680,4,1,68530,68530,68531,0,1,3
19681,3,1,68533,68533,68534,0,1,2
19682,2,3,68535,68535,68538,0,3,1
19683,4,1,68539,68539,68540,0,1,1
19684,3,2,68542,68542,68544,0,2,2
19685,5,1,68547,68547,68548,0,1,3
19686,6,2,68553,68553,68555,0,2,5
19687,1,1,68554,68555,68556,1,2,0
19688,4,3,68558,68558,68561,0,3,2
19689,6,2,68564,68564,68566,0,2,3
19690,4,2,68568,68568,68570,0,2,2
19691,1,3,68569,68570,68573,1,4,0
19692,4,3,68573,68573,68576,0,3,0
19693,3,3,68576,68576,68579,0,3,0
19694,4,2,68580,68580,68582,0,2,1
19695,5,1,68585,68585,68586,0,1,3
19696,6,2,68591,68591,68593,0,2,5
19697,2,3,68593,68593,68596,0,3,0
19698,3,2,68596,68596,68598,0,2,0
19699,2,2,68598,68598,68600,0,2,0
19700,6,1,68604,68604,68605,0,1,4
19701,2,2,68606,68606,68608,0,2,1
19702,5,3,68611,68611,68614,0,3,3
19703,2,1,68613,68614,68615,1,2,0
19704,3,2,68616,68616,68618,0,2,1
19705,2,1,68618,68618,68619,0,1,0
19706,6,2,68624,68624,68626,0,2,5
19707,3,3,68627,68627,68630,0,3,1
19708,5,1,68632,68632,68633,0,1,2
19709,1,2,68633,68633,68635,0,2,0
19710,5,1,68638,68638,68639,0,1,3
19711,6,3,68644,68644,68647,0,3,5
19712,4,3,68648,68648,68651,0,3,1
19713,6,2,68654,68654,68656,0,2,3
19714,1,3,68655,68656,68659,1,4,0
19715,4,2,68659,68659,68661,0,2,0
19716,4,3,68663,68663,68666,0,3,2
19717,1,1,68664,68666,68667,2,3,0
19718,6,1,68670,68670,68671,0,1,3
19719,3,2,68673,68673,68675,0,2,2
19720,2,2,68675,68675,68677,0,2,0
19721,5,1,68680,68680,68681,0,1,3
19722,3,2,68683,68683,68685,0,2,2
19723,4,2,68687,68687,68689,0,2,2
19724,2,3,68689,68689,68692,0,3,0
19725,6,1,68695,68695,68696,0,1,3
19726,5,1,68700,68700,68701,0,1,4
19727,2,1,68702,68702,68703,0,1,1
19728,6,3,68708,68708,68711,0,3,5
19729,1,3,68709,68711,68714,2,5,0
19730,2,3,68711,68714,68717,3,6,0
19731,1,2,68712,68717,68719,5,7,0
19732,1,3,68713,68719,68722,6,9,0
19733,6,2,68719,68722,68724,3,5,0
19734,2,3,68721,68724,68727,3,6,0
19735,6,1,68727,68727,68728,0,1,0
19736,2,1,68729,68729,68730,0,1,1
19737,5,2,68734,68734,68736,0,2,4
19738,5,3,68739,68739,68742,0,3,3
19739,3,2,68742,68742,68744,0,2,0
19740,3,3,68745,68745,68748,0,3,1
19741,3,2,68748,68748,68750,0,2,0
19742,1,3,68749,68750,68753,1,4,0
19743,1,2,68750,68753,68755,3,5,0
19744,4,1,68754,68755,68756,1,2,0
19745,5,2,68759,68759,68761,0,2,3
19746,5,2,68764,68764,68766,0,2,3
19747,2,1,68766,68766,68767,0,1,0
19748,4,1,68770,68770,68771,0,1,3
19749,5,3,68775,68775,68778,0,3,4
19750,1,1,68776,68778,68779,2,3,0
19751,6,1,68782,68782,68783,0,1,3
19752,3,1,68785,68785,68786,0,1,2
19753,5,2,68790,68790,68792,0,2,4
19754,4,1,68794,68794,68795,0,1,2
19755,4,1,68798,68798,68799,0,1,3
19756,1,2,68799,68799,68801,0,2,0
19757,5,3,68804,68804,68807,0,3,3
19758,6,3,68810,68810,68813,0,3,3
19759,6,3,68816,68816,68819,0,3,3
19760,5,3,68821,68821,68824,0,3,2
19761,3,1,68824,68824,68825,0,1,0
19762,2,1,68826,68826,68827,0,1,1
19763,4,2,68830,68830,68832,0,2,3
19764,3,1,68833,68833,68834,0,1,1
19765,6,1,68839,68839,68840,0,1,5
19766,5,1,68844,68844,68845,0,1,4
19767,2,2,68846,68846,68848,0,2,1
19768,1,3,68847,68848,68851,1,4,0
19769,5,1,68852,68852,68853,0,1,1
19770,2,2,68854,68854,68856,0,2,1
19771,6,2,68860,68860,68862,0,2,4
19772,1,3,68861,68862,68865,1,4,0
19773,6,1,68867,68867,68868,0,1,2
19774,4,2,68871,68871,68873,0,2,3
19775,4,2,68875,68875,68877,0,2,2
19776,6,2,68881,68881,68883,0,2,4
19777,3,1,68884,68884,68885,0,1,1
19778,3,3,68887,68887,68890,0,3,2
19779,5,2,68892,68892,68894,0,2,2
19780,5,3,68897,68897,68900,0,3,3
19781,6,1,68903,68903,68904,0,1,3
19782,5,1,68908,68908,68909,0,1,4
19783,3,3,68911,68911,68914,0,3,2
19784,6,1,68917,68917,68918,0,1,3
19785,2,3,68919,68919,68922,0,3,1
19786,5,1,68924,68924,68925,0,1,2
19787,4,3,68928,68928,68931,0,3,3
19788,6,2,68934,68934,68936,0,2,3
19789,6,2,68940,68940,68942,0,2,4
19790,4,1,68944,68944,68945,0,1,2
19791,2,2,68946,68946,68948,0,2,1
19792,4,2,68950,68950,68952,0,2,2
19793,6,2,68956,68956,68958,0,2,4
19794,4,3,68960,68960,68963,0,3,2
19795,3,1,68963,68963,68964,0,1,0
19796,1,1,68964,68964,68965,0,1,0
19797,6,2,68970,68970,68972,0,2,5
19798,1,3,68971,68972,68975,1,4,0
19799,5,2,68976,68976,68978,0,2,1
19800,1,3,68977,68978,68981,1,4,0
19801,2,3,68979,68981,68984,2,5,0
19802,6,3,68985,68985,68988,0,3,1
19803,6,3,68991,68991,68994,0,3,3
19804,6,1,68997,68997,68998,0,1,3
19805,3,1,69000,69000,69001,0,1,2
19806,2,3,69002,69002,69005,0,3,1
19807,2,2,69004,69005,69007,1,3,0
19808,1,2,69005,69007,69009,2,4,0
19809,1,3,69006,69009,69012,3,6,0
19810,1,2,69007,69012,69014,5,7,0
19811,5,1,69012,69014,69015,2,3,0
19812,1,3,69013,69015,69018,2,5,0
19813,2,1,69015,69018,69019,3,4,0
19814,6,1,69021,69021,69022,0,1,2
19815,6,3,69027,69027,69030,0,3,5
19816,6,3,69033,69033,69036,0,3,3
19817,2,2,69035,69036,69038,1,3,0
19818,6,3,69041,69041,69044,0,3,3
19819,5,3,69046,69046,69049,0,3,2
19820,6,3,69052,69052,69055,0,3,3
19821,1,2,69053,69055,69057,2,4,0
19822,2,1,69055,69057,69058,2,3,0
19823,6,2,69061,69061,69063,0,2,3
19824,5,1,69066,69066,69067,0,1,3
19825,2,1,69068,69068,69069,0,1,1
19826,2,1,69070,69070,69071,0,1,1
19827,5,2,69075,69075,69077,0,2,4
19828,6,2,69081,69081,69083,0,2,4
19829,1,1,69082,69083,69084,1,2,0
19830,6,3,69088,69088,69091,0,3,4
19831,3,3,69091,69091,69094,0,3,0
19832,5,3,69096,69096,69099,0,3,2
19833,1,1,69097,69099,69100,2,3,0
19834,1,2,69098,69100,69102,2,4,0
19835,4,1,69102,69102,69103,0,1,0
19836,6,2,69108,69108,69110,0,2,5
19837,6,3,69114,69114,69117,0,3,4
19838,1,2,69115,69117,69119,2,4,0
19839,4,3,69119,69119,69122,0,3,0
19840,3,2,69122,69122,69124,0,2,0
19841,4,3,69126,69126,69129,0,3,2
19842,6,1,69132,69132,69133,0,1,3
19843,5,3,69137,69137,69140,0,3,4
19844,6,2,69143,69143,69145,0,2,3
19845,1,2,69144,69145,69147,1,3,0
19846,2,2,69146,69147,69149,1,3,0
19847,3,3,69149,69149,69152,0,3,0
19848,2,3,69151,69152,69155,1,4,0
19849,3,1,69154,69155,69156,1,2,0
19850,2,2,69156,69156,69158,0,2,0
19851,1,2,69157,69158,69160,1,3,0
19852,3,3,69160,69160,69163,0,3,0
19853,6,1,69166,69166,69167,0,1,3
19854,4,1,69170,69170,69171,0,1,3
19855,5,3,69175,69175,69178,0,3,4
19856,6,3,69181,69181,69184,0,3,3
19857,3,2,69184,69184,69186,0,2,0
19858,4,2,69188,69188,69190,0,2,2
19859,2,3,69190,69190,69193,0,3,0
19860,1,2,69191,69193,69195,2,4,0
19861,3,3,69194,69195,69198,1,4,0
19862,6,2,69200,69200,69202,0,2,2
19863,3,1,69203,69203,69204,0,1,1
19864,4,3,69207,69207,69210,0,3,3
19865,2,2,69209,69210,69212,1,3,0
19866,5,2,69214,69214,69216,0,2,2
19867,1,2,69215,69216,69218,1,3,0
19868,4,2,69219,69219,69221,0,2,1
19869,3,3,69222,69222,69225,0,3,1
19870,5,2,69227,69227,69229,0,2,2
19871,2,1,69229,69229,69230,0,1,0
19872,1,2,69230,69230,69232,0,2,0
19873,3,1,69233,69233,69234,0,1,1
19874,2,2,69235,69235,69237,0,2,1
19875,2,1,69237,69237,69238,0,1,0
19876,6,1,69243,69243,69244,0,1,5
19877,2,3,69245,69245,69248,0,3,1
19878,1,1,69246,69248,69249,2,3,0
19879,5,3,69251,69251,69254,0,3,2
19880,5,3,69256,69256,69259,0,3,2
19881,3,2,69259,69259,69261,0,2,0
19882,6,2,69265,69265,69267,0,2,4
19883,4,3,69269,69269,69272,0,3,2
19884,1,1,69270,69272,69273,2,3,0
19885,4,3,69274,69274,69277,0,3,1
19886,5,3,69279,69279,69282,0,3,2
19887,6,3,69285,69285,69288,0,3,3
19888,3,2,69288,69288,69290,0,2,0
19889,5,3,69293,69293,69296,0,3,3
19890,4,2,69297,69297,69299,0,2,1
19891,2,3,69299,69299,69302,0,3,0
19892,1,2,69300,69302,69304,2,4,0
19893,2,1,69302,69304,69305,2,3,0
19894,4,3,69306,69306,69309,0,3,1
19895,4,1,69310,69310,69311,0,1,1
19896,4,2,69314,69314,69316,0,2,3
19897,4,2,69318,69318,69320,0,2,2
19898,3,1,69321,69321,69322,0,1,1
19899,6,2,69327,69327,69329,0,2,5
19900,4,1,69331,69331,69332,0,1,2
19901,3,1,69334,69334,69335,0,1,2
19902,2,3,69336,69336,69339,0,3,1
19903,1,3,69337,69339,69342,2,5,0
19904,6,2,69343,69343,69345,0,2,1
19905,3,1,69346,69346,69347,0,1,1
19906,6,3,69352,69352,69355,0,3,5
19907,5,2,69357,69357,69359,0,2,2
19908,5,3,69362,69362,69365,0,3,3
19909,1,2,69363,69365,69367,2,4,0
19910,2,1,69365,69367,69368,2,3,0
19911,2,2,69367,69368,69370,1,3,0
19912,3,1,69370,69370,69371,0,1,0
19913,5,2,69375,69375,69377,0,2,4
19914,1,1,69376,69377,69378,1,2,0
19915,6,1,69382,69382,69383,0,1,4
19916,5,3,69387,69387,69390,0,3,4
19917,4,3,69391,69391,69394,0,3,1
19918,3,2,69394,69394,69396,0,2,0
19919,1,2,69395,69396,69398,1,3,0
19920,6,3,69401,69401,69404,0,3,3
19921,5,1,69406,69406,69407,0,1,2
19922,6,1,69412,69412,69413,0,1,5
19923,2,3,69414,69414,69417,0,3,1
19924,4,1,69418,69418,69419,0,1,1
19925,2,2,69420,69420,69422,0,2,1
19926,6,2,69426,69426,69428,0,2,4
19927,2,3,69428,69428,69431,0,3,0
19928,2,2,69430,69431,69433,1,3,0
19929,6,1,69436,69436,69437,0,1,3
19930,5,1,69441,69441,69442,0,1,4
19931,3,2,69444,69444,69446,0,2,2
19932,4,2,69448,69448,69450,0,2,2
19933,5,2,69453,69453,69455,0,2,3
19934,6,1,69459,69459,69460,0,1,4
19935,4,1,69463,69463,69464,0,1,3
19936,1,3,69464,69464,69467,0,3,0
19937,3,2,69467,69467,69469,0,2,0
19938,1,1,69468,69469,69470,1,2,0
19939,4,3,69472,69472,69475,0,3,2
19940,3,2,69475,69475,69477,0,2,0
19941,6,2,69481,69481,69483,0,2,4
19942,4,1,69485,69485,69486,0,1,2
19943,6,1,69491,69491,69492,0,1,5
19944,5,1,69496,69496,69497,0,1,4
19945,6,2,69502,69502,69504,0,2,5
19946,1,3,69503,69504,69507,1,4,0
19947,6,2,69509,69509,69511,0,2,2
19948,6,2,69515,69515,69517,0,2,4
19949,1,2,69516,69517,69519,1,3,0
19950,3,2,69519,69519,69521,0,2,0
19951,5,2,69524,69524,69526,0,2,3
19952,2,3,69526,69526,69529,0,3,0
19953,2,3,69528,69529,69532,1,4,0
19954,1,1,69529,69532,69533,3,4,0
19955,6,3,69535,69535,69538,0,3,2
19956,4,1,69539,69539,69540,0,1,1
19957,1,3,69540,69540,69543,0,3,0
19958,4,3,69544,69544,69547,0,3,1
19959,5,1,69549,69549,69550,0,1,2
19960,1,1,69550,69550,69551,0,1,0
19961,6,2,69556,69556,69558,0,2,5
19962,1,1,69557,69558,69559,1,2,0
19963,6,2,69563,69563,69565,0,2,4
19964,3,3,69566,69566,69569,0,3,1
19965,3,2,69569,69569,69571,0,2,0
19966,5,1,69574,69574,69575,0,1,3
19967,4,1,69578,69578,69579,0,1,3
19968,2,3,69580,69580,69583,0,3,1
19969,2,1,69582,69583,69584,1,2,0
19970,5,3,69587,69587,69590,0,3,3
19971,4,3,69591,69591,69594,0,3,1
19972,2,2,69593,69594,69596,1,3,0
19973,6,2,69599,69599,69601,0,2,3
19974,4,3,69603,69603,69606,0,3,2
19975,6,1,69609,69609,69610,0,1,3
19976,2,2,69611,69611,69613,0,2,1
19977,1,3,69612,69613,69616,1,4,0
19978,4,2,69616,69616,69618,0,2,0
19979,2,3,69618,69618,69621,0,3,0
19980,5,3,69623,69623,69626,0,3,2
19981,5,2,69628,69628,69630,0,2,2
19982,2,2,69630,69630,69632,0,2,0
19983,1,1,69631,69632,69633,1,2,0
19984,3,1,69634,69634,69635,0,1,1
19985,6,1,69640,69640,69641,0,1,5
19986,3,2,69643,69643,69645,0,2,2
19987,2,3,69645,69645,69648,0,3,0
19988,4,1,69649,69649,69650,0,1,1
19989,2,1,69651,69651,69652,0,1,1
19990,2,3,69653,69653,69656,0,3,1
19991,1,3,69654,69656,69659,2,5,0
19992,2,2,69656,69659,69661,3,5,0
19993,6,2,69662,69662,69664,0,2,1
19994,5,3,69667,69667,69670,0,3,3
19995,4,3,69671,69671,69674,0,3,1
19996,5,1,69676,69676,69677,0,1,2
19997,4,1,69680,69680,69681,0,1,3
19998,4,2,69684,69684,69686,0,2,3
19999,6,3,69690,69690,69693,0,3,4
20000,4,2,69694,69694,69696,0,2,1
20001,1,1,69695,69696,69697,1,2,0
20002,1,1,69696,69697,69698,1,2,0
20003,1,1,69697,69698,69699,1,2,0
20004,3,1,69700,69700,69701,0,1,1
20005,1,2,69701,69701,69703,0,2,0
20006,6,2,69707,69707,69709,0,2,4
20007,2,2,69709,69709,69711,0,2,0
20008,6,2,69715,69715,69717,0,2,4
20009,1,1,69716,69717,69718,1,2,0
20010,3,3,69719,69719,69722,0,3,1
20011,6,2,69725,69725,69727,0,2,3
20012,2,2,69727,69727,69729,0,2,0
20013,6,2,69733,69733,69735,0,2,4
20014,2,1,69735,69735,69736,0,1,0
20015,5,2,69740,69740,69742,0,2,4
20016,1,3,69741,69742,69745,1,4,0
20017,6,2,69747,69747,69749,0,2,2
20018,2,2,69749,69749,69751,0,2,0
20019,1,3,69750,69751,69754,1,4,0
20020,1,1,69751,69754,69755,3,4,0
20021,4,2,69755,69755,69757,0,2,0
20022,6,2,69761,69761,69763,0,2,4
20023,6,2,69767,69767,69769,0,2,4
20024,1,1,69768,69769,69770,1,2,0
20025,5,2,69773,69773,69775,0,2,3
20026,2,2,69775,69775,69777,0,2,0
20027,6,1,69781,69781,69782,0,1,4
20028,4,1,69785,69785,69786,0,1,3
20029,4,2,69789,69789,69791,0,2,3
20030,3,2,69792,69792,69794,0,2,1
20031,2,1,69794,69794,69795,0,1,0
20032,6,1,69800,69800,69801,0,1,5
20033,4,2,69804,69804,69806,0,2,3
20034,4,2,69808,69808,69810,0,2,2
20035,5,3,69813,69813,69816,0,3,3
20036,4,2,69817,69817,69819,0,2,1
20037,2,1,69819,69819,69820,0,1,0
20038,6,3,69825,69825,69828,0,3,5
20039,1,3,69826,69828,69831,2,5,0
20040,5,2,69831,69831,69833,0,2,0
20041,2,2,69833,69833,69835,0,2,0
20042,4,2,69837,69837,69839,0,2,2
20043,6,1,69843,69843,69844,0,1,4
20044,2,2,69845,69845,69847,0,2,1
20045,5,3,69850,69850,69853,0,3,3
20046,6,3,69856,69856,69859,0,3,3
20047,1,2,69857,69859,69861,2,4,0
20048,2,3,69859,69861,69864,2,5,0
20049,4,2,69863,69864,69866,1,3,0
20050,2,2,69865,69866,69868,1,3,0
20051,6,2,69871,69871,69873,0,2,3
20052,5,1,69876,69876,69877,0,1,3
20053,5,1,69881,69881,69882,0,1,4
20054,4,1,69885,69885,69886,0,1,3
20055,3,2,69888,69888,69890,0,2,2
20056,6,3,69894,69894,69897,0,3,4
20057,5,2,69899,69899,69901,0,2,2
20058,6,1,69905,69905,69906,0,1,4
20059,4,3,69909,69909,69912,0,3,3
20060,5,2,69914,69914,69916,0,2,2
20061,4,2,69918,69918,69920,0,2,2
20062,3,2,69921,69921,69923,0,2,1
20063,2,1,69923,69923,69924,0,1,0
20064,4,1,69927,69927,69928,0,1,3
20065,2,2,69929,69929,69931,0,2,1
20066,2,2,69931,69931,69933,0,2,0
20067,1,2,69932,69933,69935,1,3,0
20068,2,1,69934,69935,69936,1,2,0
20069,3,2,69937,69937,69939,0,2,1
20070,6,1,69943,69943,69944,0,1,4
20071,4,2,69947,69947,69949,0,2,3
20072,5,3,69952,69952,69955,0,3,3
20073,2,2,69954,69955,69957,1,3,0
20074,5,3,69959,69959,69962,0,3,2
20075,3,1,69962,69962,69963,0,1,0
20076,3,2,69965,69965,69967,0,2,2
20077,4,3,69969,69969,69972,0,3,2
20078,4,3,69973,69973,69976,0,3,1
20079,3,1,69976,69976,69977,0,1,0
20080,5,2,69981,69981,69983,0,2,4
20081,4,2,69985,69985,69987,0,2,2
20082,3,2,69988,69988,69990,0,2,1
20083,2,3,69990,69990,69993,0,3,0
20084,6,2,69996,69996,69998,0,2,3
20085,6,1,70002,70002,70003,0,1,4
20086,2,3,70004,70004,70007,0,3,1
20087,6,2,70010,70010,70012,0,2,3
20088,2,3,70012,70012,70015,0,3,0
20089,3,3,70015,70015,70018,0,3,0
20090,5,1,70020,70020,70021,0,1,2
20091,5,1,70025,70025,70026,0,1,4
20092,4,1,70029,70029,70030,0,1,3
20093,1,2,70030,70030,70032,0,2,0
20094,5,3,70035,70035,70038,0,3,3
20095,5,3,70040,70040,70043,0,3,2
20096,3,3,70043,70043,70046,0,3,0
20097,3,1,70046,70046,70047,0,1,0
20098,4,3,70050,70050,70053,0,3,3
20099,5,3,70055,70055,70058,0,3,2
20100,5,3,70060,70060,70063,0,3,2
20101,1,1,70061,70063,70064,2,3,0
20102,5,2,70066,70066,70068,0,2,2
20103,4,2,70070,70070,70072,0,2,2
20104,3,3,70073,70073,70076,0,3,1
20105,3,2,70076,70076,70078,0,2,0
20106,6,2,70082,70082,70084,0,2,4
20107,2,3,70084,70084,70087,0,3,0
20108,3,3,70087,70087,70090,0,3,0
20109,5,3,70092,70092,70095,0,3,2
20110,4,3,70096,70096,70099,0,3,1
20111,3,1,70099,70099,70100,0,1,0
20112,4,3,70103,70103,70106,0,3,3
20113,4,2,70107,70107,70109,0,2,1
20114,5,1,70112,70112,70113,0,1,3
20115,6,1,70118,70118,70119,0,1,5
20116,3,2,70121,70121,70123,0,2,2
20117,6,1,70127,70127,70128,0,1,4
20118,6,3,70133,70133,70136,0,3,5
20119,3,2,70136,70136,70138,0,2,0
20120,2,2,70138,70138,70140,0,2,0
20121,2,3,70140,70140,70143,0,3,0
20122,6,3,70146,70146,70149,0,3,3
20123,6,1,70152,70152,70153,0,1,3
20124,6,3,70158,70158,70161,0,3,5
20125,4,1,70162,70162,70163,0,1,1
20126,6,3,70168,70168,70171,0,3,5
20127,5,3,70173,70173,70176,0,3,2
20128,4,2,70177,70177,70179,0,2,1
20129,4,2,70181,70181,70183,0,2,2
20130,1,1,70182,70183,70184,1,2,0
20131,5,3,70187,70187,70190,0,3,3
20132,2,1,70189,70190,70191,1,2,0
20133,3,2,70192,70192,70194,0,2,1
20134,3,1,70195,70195,70196,0,1,1
20135,6,3,70201,70201,70204,0,3,5
20136,2,1,70203,70204,70205,1,2,0
20137,5,2,70208,70208,70210,0,2,3
20138,1,3,70209,70210,70213,1,4,0
20139,2,3,70211,70213,70216,2,5,0
20140,4,1,70215,70216,70217,1,2,0
20141,2,1,70217,70217,70218,0,1,0
20142,3,1,70220,70220,70221,0,1,2
20143,4,1,70224,70224,70225,0,1,3
20144,2,3,70226,70226,70229,0,3,1
20145,5,1,70231,70231,70232,0,1,2
20146,4,2,70235,70235,70237,0,2,3
20147,1,2,70236,70237,70239,1,3,0
20148,3,1,70239,70239,70240,0,1,0
20149,2,1,70241,70241,70242,0,1,1
20150,4,1,70245,70245,70246,0,1,3
20151,5,1,70250,70250,70251,0,1,4
20152,6,3,70256,70256,70259,0,3,5
20153,6,1,70262,70262,70263,0,1,3
20154,4,2,70266,70266,70268,0,2,3
20155,1,3,70267,70268,70271,1,4,0
20156,2,3,70269,70271,70274,2,5,0
20157,3,3,70272,70274,70277,2,5,0
20158,2,2,70274,70277,70279,3,5,0
20159,5,3,70279,70279,70282,0,3,0
20160,3,2,70282,70282,70284,0,2,0
20161,6,2,70288,70288,70290,0,2,4
20162,2,2,70290,70290,70292,0,2,0
20163,5,1,70295,70295,70296,0,1,3
20164,2,1,70297,70297,70298,0,1,1
20165,6,1,70303,70303,70304,0,1,5
20166,3,3,70306,70306,70309,0,3,2
20167,1,1,70307,70309,70310,2,3,0
20168,1,3,70308,70310,70313,2,5,0
20169,1,2,70309,70313,70315,4,6,0
20170,2,2,70311,70315,70317,4,6,0
20171,3,2,70314,70317,70319,3,5,0
20172,4,2,70318,70319,70321,1,3,0
20173,2,3,70320,70321,70324,1,4,0
20174,3,3,70323,70324,70327,1,4,0
20175,3,1,70326,70327,70328,1,2,0
20176,1,2,70327,70328,70330,1,3,0
20177,3,3,70330,70330,70333,0,3,0
20178,2,3,70332,70333,70336,1,4,0
20179,3,2,70335,70336,70338,1,3,0
20180,1,1,70336,70338,70339,2,3,0
20181,2,1,70338,70339,70340,1,2,0
20182,3,2,70341,70341,70343,0,2,1
20183,2,3,70343,70343,70346,0,3,0
20184,4,1,70347,70347,70348,0,1,1
20185,2,3,70349,70349,70352,0,3,1
20186,2,1,70351,70352,70353,1,2,0
20187,4,1,70355,70355,70356,0,1,2
20188,6,3,70361,70361,70364,0,3,5
20189,3,2,70364,70364,70366,0,2,0
20190,1,1,70365,70366,70367,1,2,0
20191,3,2,70368,70368,70370,0,2,1
20192,2,3,70370,70370,70373,0,3,0
20193,6,2,70376,70376,70378,0,2,3
20194,4,3,70380,70380,70383,0,3,2
20195,6,2,70386,70386,70388,0,2,3
20196,1,2,70387,70388,70390,1,3,0
20197,3,2,70390,70390,70392,0,2,0
20198,4,2,70394,70394,70396,0,2,2
20199,3,1,70397,70397,70398,0,1,1
20200,3,1,70400,70400,70401,0,1,2
20201,3,2,70403,70403,70405,0,2,2
20202,4,1,70407,70407,70408,0,1,2
20203,3,2,70410,70410,70412,0,2,2
20204,6,3,70416,70416,70419,0,3,4
20205,4,1,70420,70420,70421,0,1,1
20206,3,1,70423,70423,70424,0,1,2
20207,5,1,70428,70428,70429,0,1,4
20208,1,3,70429,70429,70432,0,3,0
20209,6,2,70435,70435,70437,0,2,3
20210,6,2,70441,70441,70443,0,2,4
20211,5,1,70446,70446,70447,0,1,3
20212,3,3,70449,70449,70452,0,3,2
20213,2,3,70451,70452,70455,1,4,0
20214,3,1,70454,70455,70456,1,2,0
20215,5,1,70459,70459,70460,0,1,3
20216,6,2,70465,70465,70467,0,2,5
20217,4,1,70469,70469,70470,0,1,2
20218,5,1,70474,70474,70475,0,1,4
20219,5,2,70479,70479,70481,0,2,4
20220,1,1,70480,70481,70482,1,2,0
20221,6,1,70486,70486,70487,0,1,4
20222,2,3,70488,70488,70491,0,3,1
20223,6,2,70494,70494,70496,0,2,3
20224,4,1,70498,70498,70499,0,1,2
20225,5,2,70503,70503,70505,0,2,4
20226,3,1,70506,70506,70507,0,1,1
20227,1,1,70507,70507,70508,0,1,0
20228,4,2,70511,70511,70513,0,2,3
20229,5,3,70516,70516,70519,0,3,3
20230,3,1,70519,70519,70520,0,1,0
20231,5,3,70524,70524,70527,0,3,4
20232,6,2,70530,70530,70532,0,2,3
20233,6,1,70536,70536,70537,0,1,4
20234,4,3,70540,70540,70543,0,3,3
20235,5,2,70545,70545,70547,0,2,2
20236,1,1,70546,70547,70548,1,2,0
20237,2,1,70548,70548,70549,0,1,0
20238,6,1,70554,70554,70555,0,1,5
20239,5,2,70559,70559,70561,0,2,4
20240,1,3,70560,70561,70564,1,4,0
20241,5,1,70565,70565,70566,0,1,1
20242,5,2,70570,70570,70572,0,2,4
20243,4,1,70574,70574,70575,0,1,2
20244,1,1,70575,70575,70576,0,1,0
20245,4,1,70579,70579,70580,0,1,3
20246,6,3,70585,70585,70588,0,3,5
20247,6,3,70591,70591,70594,0,3,3
20248,3,2,70594,70594,70596,0,2,0
20249,1,1,70595,70596,70597,1,2,0
20250,3,2,70598,70598,70600,0,2,1
20251,3,3,70601,70601,70604,0,3,1
20252,1,1,70602,70604,70605,2,3,0
20253,2,1,70604,70605,70606,1,2,0
20254,3,3,70607,70607,70610,0,3,1
20255,4,1,70611,70611,70612,0,1,1
20256,1,2,70612,70612,70614,0,2,0
20257,2,1,70614,70614,70615,0,1,0
20258,5,3,70619,70619,70622,0,3,4
20259,2,1,70621,70622,70623,1,2,0
20260,6,3,70627,70627,70630,0,3,4
20261,1,3,70628,70630,70633,2,5,0
20262,3,1,70631,70633,70634,2,3,0
20263,1,1,70632,70634,70635,2,3,0
20264,3,3,70635,70635,70638,0,3,0
20265,6,2,70641,70641,70643,0,2,3
20266,1,3,70642,70643,70646,1,4,0
20267,1,1,70643,70646,70647,3,4,0
20268,6,3,70649,70649,70652,0,3,2
20269,1,2,70650,70652,70654,2,4,0
20270,1,1,70651,70654,70655,3,4,0
20271,2,3,70653,70655,70658,2,5,0
20272,5,2,70658,70658,70660,0,2,0
20273,5,2,70663,70663,70665,0,2,3
20274,5,3,70668,70668,70671,0,3,3
20275,3,1,70671,70671,70672,0,1,0
20276,3,3,70674,70674,70677,0,3,2
20277,5,1,70679,70679,70680,0,1,2
20278,4,2,70683,70683,70685,0,2,3
20279,5,1,70688,70688,70689,0,1,3
20280,6,2,70694,70694,70696,0,2,5
20281,4,1,70698,70698,70699,0,1,2
20282,6,2,70704,70704,70706,0,2,5
20283,5,3,70709,70709,70712,0,3,3
20284,6,1,70715,70715,70716,0,1,3
20285,6,3,70721,70721,70724,0,3,5
20286,3,1,70724,70724,70725,0,1,0
20287,3,1,70727,70727,70728,0,1,2
20288,5,2,70732,70732,70734,0,2,4
20289,5,1,70737,70737,70738,0,1,3
20290,3,2,70740,70740,70742,0,2,2
20291,3,1,70743,70743,70744,0,1,1
20292,6,3,70749,70749,70752,0,3,5
20293,3,1,70752,70752,70753,0,1,0
20294,2,3,70754,70754,70757,0,3,1
20295,4,2,70758,70758,70760,0,2,1
20296,6,3,70764,70764,70767,0,3,4
20297,6,2,70770,70770,70772,0,2,3
20298,2,1,70772,70772,70773,0,1,0
20299,1,3,70773,70773,70776,0,3,0
20300,5,1,70778,70778,70779,0,1,2
20301,5,2,70783,70783,70785,0,2,4
20302,2,2,70785,70785,70787,0,2,0
20303,1,1,70786,70787,70788,1,2,0
20304,4,3,70790,70790,70793,0,3,2
20305,3,1,70793,70793,70794,0,1,0
20306,4,2,70797,70797,70799,0,2,3
20307,2,1,70799,70799,70800,0,1,0
20308,6,1,70805,70805,70806,0,1,5
20309,4,2,70809,70809,70811,0,2,3
20310,4,3,70813,70813,70816,0,3,2
20311,1,1,70814,70816,70817,2,3,0
20312,5,3,70819,70819,70822,0,3,2
20313,5,3,70824,70824,70827,0,3,2
20314,1,2,70825,70827,70829,2,4,0
20315,4,2,70829,70829,70831,0,2,0
20316,1,1,70830,70831,70832,1,2,0
20317,2,3,70832,70832,70835,0,3,0
20318,6,3,70838,70838,70841,0,3,3
20319,1,1,70839,70841,70842,2,3,0
20320,4,1,70843,70843,70844,0,1,1
20321,6,1,70849,70849,70850,0,1,5
20322,3,3,70852,70852,70855,0,3,2
20323,4,1,70856,70856,70857,0,1,1
20324,6,3,70862,70862,70865,0,3,5
20325,6,1,70868,70868,70869,0,1,3
20326,4,2,70872,70872,70874,0,2,3
20327,6,2,70878,70878,70880,0,2,4
20328,3,1,70881,70881,70882,0,1,1
20329,1,1,70882,70882,70883,0,1,0
20330,1,1,70883,70883,70884,0,1,0
20331,3,1,70886,70886,70887,0,1,2
20332,6,3,70892,70892,70895,0,3,5
20333,2,1,70894,70895,70896,1,2,0
20334,3,3,70897,70897,70900,0,3,1
20335,4,3,70901,70901,70904,0,3,1
20336,6,2,70907,70907,70909,0,2,3
20337,4,1,70911,70911,70912,0,1,2
20338,3,1,70914,70914,70915,0,1,2
20339,5,1,70919,70919,70920,0,1,4
20340,6,1,70925,70925,70926,0,1,5
20341,1,3,70926,70926,70929,0,3,0
20342,3,2,70929,70929,70931,0,2,0
20343,2,3,70931,70931,70934,0,3,0
20344,6,3,70937,70937,70940,0,3,3
20345,2,3,70939,70940,70943,1,4,0
20346,5,1,70944,70944,70945,0,1,1
20347,5,1,70949,70949,70950,0,1,4
20348,6,2,70955,70955,70957,0,2,5
20349,1,1,70956,70957,70958,1,2,0
20350,1,2,70957,70958,70960,1,3,0
20351,4,1,70961,70961,70962,0,1,1
20352,3,2,70964,70964,70966,0,2,2
20353,4,1,70968,70968,70969,0,1,2
20354,2,1,70970,70970,70971,0,1,1
20355,1,1,70971,70971,70972,0,1,0
20356,6,3,70977,70977,70980,0,3,5
20357,2,3,70979,70980,70983,1,4,0
20358,4,2,70983,70983,70985,0,2,0
20359,5,2,70988,70988,70990,0,2,3
20360,5,3,70993,70993,70996,0,3,3
20361,3,2,70996,70996,70998,0,2,0
20362,6,3,71002,71002,71005,0,3,4
20363,3,3,71005,71005,71008,0,3,0
20364,6,1,71011,71011,71012,0,1,3
20365,3,1,71014,71014,71015,0,1,2
20366,1,2,71015,71015,71017,0,2,0
20367,4,2,71019,71019,71021,0,2,2
20368,1,2,71020,71021,71023,1,3,0
20369,2,3,71022,71023,71026,1,4,0
20370,3,2,71025,71026,71028,1,3,0
20371,1,1,71026,71028,71029,2,3,0
20372,2,3,71028,71029,71032,1,4,0
20373,5,1,71033,71033,71034,0,1,1
20374,6,2,71039,71039,71041,0,2,5
20375,3,1,71042,71042,71043,0,1,1
20376,2,3,71044,71044,71047,0,3,1
20377,2,3,71046,71047,71050,1,4,0
20378,3,1,71049,71050,71051,1,2,0
20379,3,1,71052,71052,71053,0,1,1
20380,3,3,71055,71055,71058,0,3,2
20381,5,2,71060,71060,71062,0,2,2
20382,2,1,71062,71062,71063,0,1,0
20383,3,3,71065,71065,71068,0,3,2
20384,2,1,71067,71068,71069,1,2,0
20385,1,2,71068,71069,71071,1,3,0
20386,6,2,71074,71074,71076,0,2,3
20387,6,1,71080,71080,71081,0,1,4
20388,1,1,71081,71081,71082,0,1,0
20389,2,2,71083,71083,71085,0,2,1
20390,2,3,71085,71085,71088,0,3,0
20391,4,2,71089,71089,71091,0,2,1
20392,3,2,71092,71092,71094,0,2,1
20393,5,3,71097,71097,71100,0,3,3
20394,2,2,71099,71100,71102,1,3,0
20395,5,3,71104,71104,71107,0,3,2
20396,6,1,71110,71110,71111,0,1,3
20397,5,3,71115,71115,71118,0,3,4
20398,5,2,71120,71120,71122,0,2,2
20399,1,3,71121,71122,71125,1,4,0
20400,4,3,71125,71125,71128,0,3,0
20401,4,3,71129,71129,71132,0,3,1
20402,2,2,71131,71132,71134,1,3,0
20403,3,2,71134,71134,71136,0,2,0
20404,3,2,71137,71137,71139,0,2,1
20405,2,2,71139,71139,71141,0,2,0
20406,1,1,71140,71141,71142,1,2,0
20407,2,2,71142,71142,71144,0,2,0
20408,4,2,71146,71146,71148,0,2,2
20409,4,1,71150,71150,71151,0,1,2
20410,3,2,71153,71153,71155,0,2,2
20411,1,3,71154,71155,71158,1,4,0
20412,4,2,71158,71158,71160,0,2,0
20413,3,2,71161,71161,71163,0,2,1
20414,6,1,71167,71167,71168,0,1,4
20415,4,1,71171,71171,71172,0,1,3
20416,4,2,71175,71175,71177,0,2,3
20417,1,2,71176,71177,71179,1,3,0
20418,6,2,71182,71182,71184,0,2,3
20419,5,2,71187,71187,71189,0,2,3
20420,2,1,71189,71189,71190,0,1,0
20421,2,3,71191,71191,71194,0,3,1
20422,1,1,71192,71194,71195,2,3,0
20423,3,1,71195,71195,71196,0,1,0
20424,3,2,71198,71198,71200,0,2,2
20425,2,1,71200,71200,71201,0,1,0
20426,3,1,71203,71203,71204,0,1,2
20427,1,1,71204,71204,71205,0,1,0
20428,5,3,71209,71209,71212,0,3,4
20429,4,3,71213,71213,71216,0,3,1
20430,6,1,71219,71219,71220,0,1,3
20431,2,3,71221,71221,71224,0,3,1
20432,5,3,71226,71226,71229,0,3,2
20433,3,1,71229,71229,71230,0,1,0
20434,2,2,71231,71231,71233,0,2,1
20435,1,2,71232,71233,71235,1,3,0
20436,2,3,71234,71235,71238,1,4,0
20437,1,3,71235,71238,71241,3,6,0
20438,5,2,71240,71241,71243,1,3,0
20439,3,3,71243,71243,71246,0,3,0
20440,3,3,71246,71246,71249,0,3,0
20441,4,3,71250,71250,71253,0,3,1
20442,1,2,71251,71253,71255,2,4,0
20443,5,1,71256,71256,71257,0,1,1
20444,6,1,71262,71262,71263,0,1,5
20445,5,1,71267,71267,71268,0,1,4
20446,3,2,71270,71270,71272,0,2,2
20447,4,1,71274,71274,71275,0,1,2
20448,2,1,71276,71276,71277,0,1,1
20449,2,3,71278,71278,71281,0,3,1
20450,4,1,71282,71282,71283,0,1,1
20451,5,3,71287,71287,71290,0,3,4
20452,4,1,71291,71291,71292,0,1,1
20453,6,1,71297,71297,71298,0,1,5
20454,5,1,71302,71302,71303,0,1,4
20455,4,3,71306,71306,71309,0,3,3
20456,3,2,71309,71309,71311,0,2,0
20457,2,2,71311,71311,71313,0,2,0
20458,5,3,71316,71316,71319,0,3,3
20459,4,3,71320,71320,71323,0,3,1
20460,1,2,71321,71323,71325,2,4,0
20461,6,1,71327,71327,71328,0,1,2
20462,1,1,71328,71328,71329,0,1,0
20463,2,2,71330,71330,71332,0,2,1
20464,5,2,71335,71335,71337,0,2,3
20465,3,1,71338,71338,71339,0,1,1
20466,5,3,71343,71343,71346,0,3,4
20467,6,3,71349,71349,71352,0,3,3
20468,5,1,71354,71354,71355,0,1,2
20469,2,2,71356,71356,71358,0,2,1
20470,4,3,71360,71360,71363,0,3,2
20471,2,3,71362,71363,71366,1,4,0
20472,1,2,71363,71366,71368,3,5,0
20473,3,2,71366,71368,71370,2,4,0
20474,5,3,71371,71371,71374,0,3,1
20475,4,1,71375,71375,71376,0,1,1
20476,1,3,71376,71376,71379,0,3,0
20477,1,1,71377,71379,71380,2,3,0
20478,2,3,71379,71380,71383,1,4,0
20479,5,2,71384,71384,71386,0,2,1
20480,3,3,71387,71387,71390,0,3,1
20481,6,3,71393,71393,71396,0,3,3
20482,1,2,71394,71396,71398,2,4,0
20483,1,1,71395,71398,71399,3,4,0
20484,5,1,71400,71400,71401,0,1,1
20485,4,1,71404,71404,71405,0,1,3
20486,5,3,71409,71409,71412,0,3,4
20487,6,1,71415,71415,71416,0,1,3
20488,2,1,71417,71417,71418,0,1,1
20489,6,3,71423,71423,71426,0,3,5
20490,2,2,71425,71426,71428,1,3,0
20491,4,1,71429,71429,71430,0,1,1
20492,2,2,71431,71431,71433,0,2,1
20493,6,1,71437,71437,71438,0,1,4
20494,6,1,71443,71443,71444,0,1,5
20495,2,1,71445,71445,71446,0,1,1
20496,6,3,71451,71451,71454,0,3,5
20497,6,1,71457,71457,71458,0,1,3
20498,3,1,71460,71460,71461,0,1,2
20499,1,1,71461,71461,71462,0,1,0
20500,2,2,71463,71463,71465,0,2,1
20501,1,1,71464,71465,71466,1,2,0
20502,4,3,71468,71468,71471,0,3,2
20503,1,3,71469,71471,71474,2,5,0
20504,6,2,71475,71475,71477,0,2,1
20505,5,3,71480,71480,71483,0,3,3
20506,4,1,71484,71484,71485,0,1,1
20507,1,2,71485,71485,71487,0,2,0
20508,6,3,71491,71491,71494,0,3,4
20509,3,3,71494,71494,71497,0,3,0
20510,5,3,71499,71499,71502,0,3,2
20511,4,1,71503,71503,71504,0,1,1
20512,5,1,71508,71508,71509,0,1,4
20513,4,3,71512,71512,71515,0,3,3
20514,4,1,71516,71516,71517,0,1,1
20515,1,2,71517,71517,71519,0,2,0
20516,1,2,71518,71519,71521,1,3,0
20517,1,1,71519,71521,71522,2,3,0
20518,1,3,71520,71522,71525,2,5,0
20519,5,1,71525,71525,71526,0,1,0
20520,1,2,71526,71526,71528,0,2,0
20521,2,2,71528,71528,71530,0,2,0
20522,1,2,71529,71530,71532,1,3,0
20523,5,3,71534,71534,71537,0,3,2
20524,2,1,71536,71537,71538,1,2,0
20525,5,3,71541,71541,71544,0,3,3
20526,5,3,71546,71546,71549,0,3,2
20527,4,1,71550,71550,71551,0,1,1
20528,3,2,71553,71553,71555,0,2,2
20529,4,1,71557,71557,71558,0,1,2
20530,3,1,71560,71560,71561,0,1,2
20531,1,3,71561,71561,71564,0,3,0
20532,2,2,71563,71564,71566,1,3,0
20533,4,3,71567,71567,71570,0,3,1
20534,2,3,71569,71570,71573,1,4,0
20535,5,1,71574,71574,71575,0,1,1
20536,4,3,71578,71578,71581,0,3,3
20537,1,1,71579,71581,71582,2,3,0
20538,1,1,71580,71582,71583,2,3,0
20539,4,2,71584,71584,71586,0,2,1
20540,5,1,71589,71589,71590,0,1,3
20541,1,3,71590,71590,71593,0,3,0
20542,3,2,71593,71593,71595,0,2,0
20543,2,3,71595,71595,71598,0,3,0
20544,5,1,71600,71600,71601,0,1,2
20545,3,3,71603,71603,71606,0,3,2
20546,5,2,71608,71608,71610,0,2,2
20547,1,1,71609,71610,71611,1,2,0
20548,4,3,71613,71613,71616,0,3,2
20549,4,1,71617,71617,71618,0,1,1
20550,6,1,71623,71623,71624,0,1,5
20551,5,3,71628,71628,71631,0,3,4
20552,1,1,71629,71631,71632,2,3,0
20553,4,1,71633,71633,71634,0,1,1
20554,4,3,71637,71637,71640,0,3,3
20555,2,1,71639,71640,71641,1,2,0
20556,4,3,71643,71643,71646,0,3,2
20557,1,3,71644,71646,71649,2,5,0
20558,6,2,71650,71650,71652,0,2,1
20559,2,1,71652,71652,71653,0,1,0
20560,1,1,71653,71653,71654,0,1,0
20561,6,2,71659,71659,71661,0,2,5
20562,4,3,71663,71663,71666,0,3,2
20563,3,3,71666,71666,71669,0,3,0
20564,2,1,71668,71669,71670,1,2,0
20565,2,3,71670,71670,71673,0,3,0
20566,4,3,71674,71674,71677,0,3,1
20567,2,2,71676,71677,71679,1,3,0
20568,3,1,71679,71679,71680,0,1,0
20569,3,1,71682,71682,71683,0,1,2
20570,2,3,71684,71684,71687,0,3,1
20571,2,1,71686,71687,71688,1,2,0
20572,3,3,71689,71689,71692,0,3,1
20573,2,3,71691,71692,71695,1,4,0
20574,5,3,71696,71696,71699,0,3,1
20575,1,1,71697,71699,71700,2,3,0
20576,2,2,71699,71700,71702,1,3,0
20577,3,3,71702,71702,71705,0,3,0
20578,2,3,71704,71705,71708,1,4,0
20579,4,3,71708,71708,71711,0,3,0
20580,4,1,71712,71712,71713,0,1,1
20581,1,1,71713,71713,71714,0,1,0
20582,6,2,71719,71719,71721,0,2,5
20583,3,2,71722,71722,71724,0,2,1
20584,5,1,71727,71727,71728,0,1,3
20585,3,2,71730,71730,71732,0,2,2
20586,2,1,71732,71732,71733,0,1,0
20587,1,1,71733,71733,71734,0,1,0
20588,5,3,71738,71738,71741,0,3,4
20589,2,2,71740,71741,71743,1,3,0
20590,4,3,71744,71744,71747,0,3,1
20591,1,2,71745,71747,71749,2,4,0
20592,6,2,71751,71751,71753,0,2,2
20593,2,1,71753,71753,71754,0,1,0
20594,3,1,71756,71756,71757,0,1,2
20595,1,2,71757,71757,71759,0,2,0
20596,5,2,71762,71762,71764,0,2,3
20597,5,3,71767,71767,71770,0,3,3
20598,5,1,71772,71772,71773,0,1,2
20599,6,3,71778,71778,71781,0,3,5
20600,1,1,71779,71781,71782,2,3,0
20601,1,3,71780,71782,71785,2,5,0
20602,2,2,71782,71785,71787,3,5,0
20603,2,3,71784,71787,71790,3,6,0
20604,1,3,71785,71790,71793,5,8,0
20605,2,3,71787,71793,71796,6,9,0
20606,4,3,71791,71796,71799,5,8,0
20607,3,3,71794,71799,71802,5,8,0
20608,5,1,71799,71802,71803,3,4,0
20609,3,2,71802,71803,71805,1,3,0
20610,5,2,71807,71807,71809,0,2,2
20611,1,1,71808,71809,71810,1,2,0
20612,1,1,71809,71810,71811,1,2,0
20613,4,2,71813,71813,71815,0,2,2
20614,2,3,71815,71815,71818,0,3,0
20615,1,2,71816,71818,71820,2,4,0
20616,5,2,71821,71821,71823,0,2,1
20617,4,1,71825,71825,71826,0,1,2
20618,6,2,71831,71831,71833,0,2,5
20619,1,1,71832,71833,71834,1,2,0
20620,2,3,71834,71834,71837,0,3,0
20621,2,2,71836,71837,71839,1,3,0
20622,5,3,71841,71841,71844,0,3,2
20623,3,2,71844,71844,71846,0,2,0
20624,1,3,71845,71846,71849,1,4,0
20625,6,1,71851,71851,71852,0,1,2
20626,5,3,71856,71856,71859,0,3,4
20627,6,2,71862,71862,71864,0,2,3
20628,2,1,71864,71864,71865,0,1,0
20629,6,3,71870,71870,71873,0,3,5
20630,4,1,71874,71874,71875,0,1,1
20631,1,1,71875,71875,71876,0,1,0
20632,4,3,71879,71879,71882,0,3,3
20633,4,2,71883,71883,71885,0,2,1
20634,2,1,71885,71885,71886,0,1,0
20635,6,1,71891,71891,71892,0,1,5
20636,6,3,71897,71897,71900,0,3,5
20637,5,3,71902,71902,71905,0,3,2
20638,3,3,71905,71905,71908,0,3,0
20639,4,1,71909,71909,71910,0,1,1
20640,6,1,71915,71915,71916,0,1,5
20641,4,3,71919,71919,71922,0,3,3
20642,5,2,71924,71924,71926,0,2,2
20643,1,1,71925,71926,71927,1,2,0
20644,5,2,71930,71930,71932,0,2,3
20645,6,1,71936,71936,71937,0,1,4
20646,6,3,71942,71942,71945,0,3,5
20647,1,1,71943,71945,71946,2,3,0
20648,1,2,71944,71946,71948,2,4,0
20649,4,3,71948,71948,71951,0,3,0
20650,3,3,71951,71951,71954,0,3,0
20651,2,3,71953,71954,71957,1,4,0
20652,6,1,71959,71959,71960,0,1,2
20653,6,3,71965,71965,71968,0,3,5
20654,1,2,71966,71968,71970,2,4,0
20655,5,3,71971,71971,71974,0,3,1
20656,4,3,71975,71975,71978,0,3,1
20657,3,2,71978,71978,71980,0,2,0
20658,4,3,71982,71982,71985,0,3,2
20659,1,2,71983,71985,71987,2,4,0
20660,6,1,71989,71989,71990,0,1,2
20661,4,1,71993,71993,71994,0,1,3
20662,4,3,71997,71997,72000,0,3,3
20663,6,2,72003,72003,72005,0,2,3
20664,6,1,72009,72009,72010,0,1,4
20665,2,1,72011,72011,72012,0,1,1
20666,3,2,72014,72014,72016,0,2,2
20667,5,3,72019,72019,72022,0,3,3
20668,3,3,72022,72022,72025,0,3,0
20669,6,3,72028,72028,72031,0,3,3
20670,1,1,72029,72031,72032,2,3,0
20671,2,2,72031,72032,72034,1,3,0
20672,1,1,72032,72034,72035,2,3,0
20673,4,2,72036,72036,72038,0,2,1
20674,6,2,72042,72042,72044,0,2,4
20675,3,2,72045,72045,72047,0,2,1
20676,1,2,72046,72047,72049,1,3,0
20677,1,2,72047,72049,72051,2,4,0
20678,6,3,72053,72053,72056,0,3,2
20679,5,2,72058,72058,72060,0,2,2
20680,4,2,72062,72062,72064,0,2,2
20681,1,1,72063,72064,72065,1,2,0
20682,2,2,72065,72065,72067,0,2,0
20683,4,2,72069,72069,72071,0,2,2
20684,3,1,72072,72072,72073,0,1,1
20685,4,3,72076,72076,72079,0,3,3
20686,6,3,72082,72082,72085,0,3,3
20687,2,1,72084,72085,72086,1,2,0
20688,4,3,72088,72088,72091,0,3,2
20689,6,3,72094,72094,72097,0,3,3
20690,1,2,72095,72097,72099,2,4,0
20691,2,1,72097,72099,72100,2,3,0
20692,2,1,72099,72100,72101,1,2,0
20693,2,2,72101,72101,72103,0,2,0
20694,1,3,72102,72103,72106,1,4,0
20695,1,2,72103,72106,72108,3,5,0
20696,3,1,72106,72108,72109,2,3,0
20697,5,3,72111,72111,72114,0,3,2
20698,6,1,72117,72117,72118,0,1,3
20699,5,3,72122,72122,72125,0,3,4
20700,3,1,72125,72125,72126,0,1,0
20701,1,2,72126,72126,72128,0,2,0
20702,5,3,72131,72131,72134,0,3,3
20703,6,3,72137,72137,72140,0,3,3
20704,1,1,72138,72140,72141,2,3,0
20705,4,1,72142,72142,72143,0,1,1
20706,2,3,72144,72144,72147,0,3,1
20707,3,3,72147,72147,72150,0,3,0
20708,5,3,72152,72152,72155,0,3,2
20709,5,1,72157,72157,72158,0,1,2
20710,5,3,72162,72162,72165,0,3,4
20711,4,1,72166,72166,72167,0,1,1
20712,2,2,72168,72168,72170,0,2,1
20713,3,1,72171,72171,72172,0,1,1
20714,4,1,72175,72175,72176,0,1,3
20715,5,2,72180,72180,72182,0,2,4
20716,4,2,72184,72184,72186,0,2,2
20717,2,1,72186,72186,72187,0,1,0
20718,2,3,72188,72188,72191,0,3,1
20719,1,1,72189,72191,72192,2,3,0
20720,5,2,72194,72194,72196,0,2,2
20721,2,1,72196,72196,72197,0,1,0
20722,2,3,72198,72198,72201,0,3,1
20723,2,2,72200,72201,72203,1,3,0
20724,3,3,72203,72203,72206,0,3,0
20725,1,3,72204,72206,72209,2,5,0
20726,1,1,72205,72209,72210,4,5,0
20727,5,1,72210,72210,72211,0,1,0
20728,2,2,72212,72212,72214,0,2,1
20729,3,3,72215,72215,72218,0,3,1
20730,1,1,72216,72218,72219,2,3,0
20731,3,3,72219,72219,72222,0,3,0
20732,3,3,72222,72222,72225,0,3,0
20733,3,1,72225,72225,72226,0,1,0
20734,1,1,72226,72226,72227,0,1,0
20735,2,1,72228,72228,72229,0,1,1
20736,5,3,72233,72233,72236,0,3,4
20737,3,2,72236,72236,72238,0,2,0
20738,4,1,72240,72240,72241,0,1,2
20739,2,3,72242,72242,72245,0,3,1
20740,4,1,72246,72246,72247,0,1,1
20741,5,2,72251,72251,72253,0,2,4
20742,4,1,72255,72255,72256,0,1,2
20743,4,2,72259,72259,72261,0,2,3
20744,1,1,72260,72261,72262,1,2,0
20745,3,3,72263,72263,72266,0,3,1
20746,1,2,72264,72266,72268,2,4,0
20747,1,3,72265,72268,72271,3,6,0
20748,2,1,72267,72271,72272,4,5,0
20749,5,1,72272,72272,72273,0,1,0
20750,3,2,72275,72275,72277,0,2,2
20751,1,3,72276,72277,72280,1,4,0
20752,1,2,72277,72280,72282,3,5,0
20753,5,2,72282,72282,72284,0,2,0
20754,4,1,72286,72286,72287,0,1,2
20755,3,2,72289,72289,72291,0,2,2
20756,2,3,72291,72291,72294,0,3,0
20757,1,2,72292,72294,72296,2,4,0
20758,4,2,72296,72296,72298,0,2,0
20759,3,1,72299,72299,72300,0,1,1
20760,3,3,72302,72302,72305,0,3,2
20761,2,1,72304,72305,72306,1,2,0
20762,3,1,72307,72307,72308,0,1,1
20763,1,3,72308,72308,72311,0,3,0
20764,4,2,72312,72312,72314,0,2,1
20765,2,2,72314,72314,72316,0,2,0
20766,6,3,72320,72320,72323,0,3,4
20767,1,2,72321,72323,72325,2,4,0
20768,1,2,72322,72325,72327,3,5,0
20769,5,2,72327,72327,72329,0,2,0
20770,5,2,72332,72332,72334,0,2,3
20771,2,3,72334,72334,72337,0,3,0
20772,6,1,72340,72340,72341,0,1,3
20773,4,2,72344,72344,72346,0,2,3
20774,2,3,72346,72346,72349,0,3,0
20775,4,1,72350,72350,72351,0,1,1
20776,6,2,72356,72356,72358,0,2,5
20777,5,3,72361,72361,72364,0,3,3
20778,5,1,72366,72366,72367,0,1,2
20779,1,1,72367,72367,72368,0,1,0
20780,5,2,72372,72372,72374,0,2,4
20781,3,1,72375,72375,72376,0,1,1
20782,5,1,72380,72380,72381,0,1,4
20783,5,1,72385,72385,72386,0,1,4
20784,6,3,72391,72391,72394,0,3,5
20785,6,2,72397,72397,72399,0,2,3
20786,3,1,72400,72400,72401,0,1,1
20787,5,2,72405,72405,72407,0,2,4
20788,4,3,72409,72409,72412,0,3,2
20789,2,1,72411,72412,72413,1,2,0
20790,2,3,72413,72413,72416,0,3,0
20791,3,2,72416,72416,72418,0,2,0
20792,4,2,72420,72420,72422,0,2,2
20793,3,2,72423,72423,72425,0,2,1
20794,3,2,72426,72426,72428,0,2,1
20795,4,2,72430,72430,72432,0,2,2
20796,3,1,72433,72433,72434,0,1,1
20797,1,2,72434,72434,72436,0,2,0
20798,5,1,72439,72439,72440,0,1,3
20799,2,3,72441,72441,72444,0,3,1
20800,1,3,72442,72444,72447,2,5,0
20801,4,3,72446,72447,72450,1,4,0
20802,3,3,72449,72450,72453,1,4,0
20803,4,2,72453,72453,72455,0,2,0
20804,6,1,72459,72459,72460,0,1,4
20805,1,3,72460,72460,72463,0,3,0
20806,4,1,72464,72464,72465,0,1,1
20807,6,2,72470,72470,72472,0,2,5
20808,5,1,72475,72475,72476,0,1,3
20809,6,2,72481,72481,72483,0,2,5
20810,2,3,72483,72483,72486,0,3,0
20811,3,2,72486,72486,72488,0,2,0
20812,4,2,72490,72490,72492,0,2,2
20813,1,3,72491,72492,72495,1,4,0
20814,5,3,72496,72496,72499,0,3,1
20815,2,2,72498,72499,72501,1,3,0
20816,1,1,72499,72501,72502,2,3,0
20817,3,3,72502,72502,72505,0,3,0
20818,4,2,72506,72506,72508,0,2,1
20819,4,2,72510,72510,72512,0,2,2
20820,4,3,72514,72514,72517,0,3,2
20821,2,1,72516,72517,72518,1,2,0
20822,3,1,72519,72519,72520,0,1,1
20823,2,3,72521,72521,72524,0,3,1
20824,1,3,72522,72524,72527,2,5,0
20825,2,1,72524,72527,72528,3,4,0
20826,1,1,72525,72528,72529,3,4,0
20827,2,3,72527,72529,72532,2,5,0
20828,2,3,72529,72532,72535,3,6,0
20829,6,1,72535,72535,72536,0,1,0
20830,1,2,72536,72536,72538,0,2,0
20831,6,1,72542,72542,72543,0,1,4
20832,2,2,72544,72544,72546,0,2,1
20833,6,2,72550,72550,72552,0,2,4
20834,4,2,72554,72554,72556,0,2,2
20835,6,2,72560,72560,72562,0,2,4
20836,6,1,72566,72566,72567,0,1,4
20837,3,3,72569,72569,72572,0,3,2
20838,6,3,72575,72575,72578,0,3,3
20839,5,1,72580,72580,72581,0,1,2
20840,1,2,72581,72581,72583,0,2,0
20841,3,2,72584,72584,72586,0,2,1
20842,5,2,72589,72589,72591,0,2,3
20843,3,1,72592,72592,72593,0,1,1
20844,3,2,72595,72595,72597,0,2,2
20845,1,3,72596,72597,72600,1,4,0
20846,3,2,72599,72600,72602,1,3,0
20847,5,1,72604,72604,72605,0,1,2
20848,2,2,72606,72606,72608,0,2,1
20849,6,3,72612,72612,72615,0,3,4
20850,4,3,72616,72616,72619,0,3,1
20851,3,1,72619,72619,72620,0,1,0
20852,2,3,72621,72621,72624,0,3,1
20853,6,3,72627,72627,72630,0,3,3
20854,5,2,72632,72632,72634,0,2,2
20855,4,3,72636,72636,72639,0,3,2
20856,6,3,72642,72642,72645,0,3,3
20857,4,1,72646,72646,72647,0,1,1
20858,1,1,72647,72647,72648,0,1,0
20859,1,2,72648,72648,72650,0,2,0
20860,2,3,72650,72650,72653,0,3,0
20861,5,2,72655,72655,72657,0,2,2
20862,5,1,72660,72660,72661,0,1,3
20863,5,3,72665,72665,72668,0,3,4
20864,5,1,72670,72670,72671,0,1,2
20865,2,1,72672,72672,72673,0,1,1
20866,3,3,72675,72675,72678,0,3,2
20867,4,3,72679,72679,72682,0,3,1
20868,4,1,72683,72683,72684,0,1,1
20869,3,2,72686,72686,72688,0,2,2
20870,6,2,72692,72692,72694,0,2,4
20871,2,3,72694,72694,72697,0,3,0
20872,2,2,72696,72697,72699,1,3,0
20873,4,3,72700,72700,72703,0,3,1
20874,3,1,72703,72703,72704,0,1,0
20875,2,3,72705,72705,72708,0,3,1
20876,3,3,72708,72708,72711,0,3,0
20877,1,3,72709,72711,72714,2,5,0
20878,2,3,72711,72714,72717,3,6,0
20879,3,1,72714,72717,72718,3,4,0
20880,2,3,72716,72718,72721,2,5,0
20881,4,3,72720,72721,72724,1,4,0
20882,3,3,72723,72724,72727,1,4,0
20883,2,1,72725,72727,72728,2,3,0
20884,5,1,72730,72730,72731,0,1,2
20885,2,3,72732,72732,72735,0,3,1
20886,4,1,72736,72736,72737,0,1,1
20887,6,1,72742,72742,72743,0,1,5
20888,5,1,72747,72747,72748,0,1,4
20889,2,3,72749,72749,72752,0,3,1
20890,1,3,72750,72752,72755,2,5,0
20891,6,2,72756,72756,72758,0,2,1
20892,1,3,72757,72758,72761,1,4,0
20893,2,1,72759,72761,72762,2,3,0
20894,4,2,72763,72763,72765,0,2,1
20895,3,2,72766,72766,72768,0,2,1
20896,1,1,72767,72768,72769,1,2,0
20897,5,2,72772,72772,72774,0,2,3
20898,6,3,72778,72778,72781,0,3,4
20899,3,3,72781,72781,72784,0,3,0
20900,3,3,72784,72784,72787,0,3,0
20901,2,3,72786,72787,72790,1,4,0
20902,2,1,72788,72790,72791,2,3,0
20903,4,2,72792,72792,72794,0,2,1
20904,3,1,72795,72795,72796,0,1,1
20905,3,2,72798,72798,72800,0,2,2
20906,1,2,72799,72800,72802,1,3,0
20907,6,2,72805,72805,72807,0,2,3
20908,3,3,72808,72808,72811,0,3,1
20909,1,3,72809,72811,72814,2,5,0
20910,4,1,72813,72814,72815,1,2,0
20911,5,2,72818,72818,72820,0,2,3
20912,1,2,72819,72820,72822,1,3,0
20913,2,1,72821,72822,72823,1,2,0
20914,4,3,72825,72825,72828,0,3,2
20915,4,3,72829,72829,72832,0,3,1
20916,5,3,72834,72834,72837,0,3,2
20917,3,2,72837,72837,72839,0,2,0
20918,4,1,72841,72841,72842,0,1,2
20919,1,1,72842,72842,72843,0,1,0
20920,4,1,72846,72846,72847,0,1,3
20921,4,1,72850,72850,72851,0,1,3
20922,4,1,72854,72854,72855,0,1,3
20923,5,2,72859,72859,72861,0,2,4
20924,4,2,72863,72863,72865,0,2,2
20925,3,2,72866,72866,72868,0,2,1
20926,1,3,72867,72868,72871,1,4,0
20927,3,1,72870,72871,72872,1,2,0
20928,4,2,72874,72874,72876,0,2,2
20929,4,2,72878,72878,72880,0,2,2
20930,6,3,72884,72884,72887,0,3,4
20931,2,1,72886,72887,72888,1,2,0
20932,5,1,72891,72891,72892,0,1,3
20933,5,2,72896,72896,72898,0,2,4
20934,5,3,72901,72901,72904,0,3,3
20935,5,3,72906,72906,72909,0,3,2
20936,1,3,72907,72909,72912,2,5,0
20937,2,2,72909,72912,72914,3,5,0
20938,6,2,72915,72915,72917,0,2,1
20939,1,2,72916,72917,72919,1,3,0
20940,6,3,72922,72922,72925,0,3,3
20941,1,1,72923,72925,72926,2,3,0
20942,4,3,72927,72927,72930,0,3,1
20943,1,3,72928,72930,72933,2,5,0
20944,1,3,72929,72933,72936,4,7,0
20945,3,1,72932,72936,72937,4,5,0
20946,6,3,72938,72938,72941,0,3,1
20947,6,1,72944,72944,72945,0,1,3
20948,5,3,72949,72949,72952,0,3,4
20949,6,3,72955,72955,72958,0,3,3
20950,5,1,72960,72960,72961,0,1,2
20951,5,1,72965,72965,72966,0,1,4
20952,6,2,72971,72971,72973,0,2,5
20953,1,3,72972,72973,72976,1,4,0
20954,6,2,72978,72978,72980,0,2,2
20955,4,2,72982,72982,72984,0,2,2
20956,5,3,72987,72987,72990,0,3,3
20957,2,3,72989,72990,72993,1,4,0
20958,3,2,72992,72993,72995,1,3,0
20959,3,1,72995,72995,72996,0,1,0
20960,3,2,72998,72998,73000,0,2,2
20961,4,2,73002,73002,73004,0,2,2
20962,5,3,73007,73007,73010,0,3,3
20963,5,3,73012,73012,73015,0,3,2
20964,6,2,73018,73018,73020,0,2,3
20965,1,2,73019,73020,73022,1,3,0
20966,1,1,73020,73022,73023,2,3,0
20967,6,2,73026,73026,73028,0,2,3
20968,1,2,73027,73028,73030,1,3,0
20969,2,1,73029,73030,73031,1,2,0
20970,5,2,73034,73034,73036,0,2,3
20971,4,3,73038,73038,73041,0,3,2
20972,6,2,73044,73044,73046,0,2,3
20973,5,2,73049,73049,73051,0,2,3
20974,6,1,73055,73055,73056,0,1,4
20975,5,2,73060,73060,73062,0,2,4
20976,5,3,73065,73065,73068,0,3,3
20977,6,1,73071,73071,73072,0,1,3
20978,1,3,73072,73072,73075,0,3,0
20979,6,2,73078,73078,73080,0,2,3
20980,6,2,73084,73084,73086,0,2,4
20981,6,3,73090,73090,73093,0,3,4
20982,6,2,73096,73096,73098,0,2,3
20983,1,3,73097,73098,73101,1,4,0
20984,5,2,73102,73102,73104,0,2,1
20985,1,2,73103,73104,73106,1,3,0
20986,6,2,73109,73109,73111,0,2,3
20987,1,3,73110,73111,73114,1,4,0
20988,3,3,73113,73114,73117,1,4,0
20989,3,2,73116,73117,73119,1,3,0
20990,1,2,73117,73119,73121,2,4,0
20991,4,1,73121,73121,73122,0,1,0
20992,2,1,73123,73123,73124,0,1,1
20993,6,3,73129,73129,73132,0,3,5
20994,6,2,73135,73135,73137,0,2,3
20995,4,2,73139,73139,73141,0,2,2
20996,5,2,73144,73144,73146,0,2,3
20997,6,1,73150,73150,73151,0,1,4
20998,4,2,73154,73154,73156,0,2,3
20999,2,3,73156,73156,73159,0,3,0
21000,5,1,73161,73161,73162,0,1,2
21001,3,1,73164,73164,73165,0,1,2
21002,3,1,73167,73167,73168,0,1,2
21003,4,3,73171,73171,73174,0,3,3
21004,3,3,73174,73174,73177,0,3,0
21005,5,1,73179,73179,73180,0,1,2
21006,6,1,73185,73185,73186,0,1,5
21007,4,2,73189,73189,73191,0,2,3
21008,4,2,73193,73193,73195,0,2,2
21009,6,3,73199,73199,73202,0,3,4
21010,2,1,73201,73202,73203,1,2,0
21011,6,3,73207,73207,73210,0,3,4
21012,4,2,73211,73211,73213,0,2,1
21013,6,2,73217,73217,73219,0,2,4
21014,3,3,73220,73220,73223,0,3,1
21015,5,3,73225,73225,73228,0,3,2
21016,3,2,73228,73228,73230,0,2,0
21017,6,3,73234,73234,73237,0,3,4
21018,2,3,73236,73237,73240,1,4,0
21019,1,3,73237,73240,73243,3,6,0
21020,6,3,73243,73243,73246,0,3,0
21021,6,3,73249,73249,73252,0,3,3
21022,2,1,73251,73252,73253,1,2,0
21023,5,2,73256,73256,73258,0,2,3
21024,2,3,73258,73258,73261,0,3,0
21025,4,3,73262,73262,73265,0,3,1
21026,4,2,73266,73266,73268,0,2,1
21027,6,3,73272,73272,73275,0,3,4
21028,2,2,73274,73275,73277,1,3,0
21029,1,3,73275,73277,73280,2,5,0
21030,1,2,73276,73280,73282,4,6,0
21031,4,2,73280,73282,73284,2,4,0
21032,5,3,73285,73285,73288,0,3,1
21033,6,2,73291,73291,73293,0,2,3
21034,1,3,73292,73293,73296,1,4,0
21035,5,3,73297,73297,73300,0,3,1
21036,6,3,73303,73303,73306,0,3,3
21037,2,1,73305,73306,73307,1,2,0
21038,4,2,73309,73309,73311,0,2,2
21039,6,3,73315,73315,73318,0,3,4
21040,1,2,73316,73318,73320,2,4,0
21041,3,1,73319,73320,73321,1,2,0
21042,1,3,73320,73321,73324,1,4,0
21043,2,1,73322,73324,73325,2,3,0
21044,1,3,73323,73325,73328,2,5,0
21045,5,1,73328,73328,73329,0,1,0
21046,3,1,73331,73331,73332,0,1,2
21047,1,2,73332,73332,73334,0,2,0
21048,4,1,73336,73336,73337,0,1,2
21049,4,2,73340,73340,73342,0,2,3
21050,6,2,73346,73346,73348,0,2,4
21051,3,1,73349,73349,73350,0,1,1
21052,3,1,73352,73352,73353,0,1,2
21053,2,1,73354,73354,73355,0,1,1
21054,6,2,73360,73360,73362,0,2,5
21055,5,1,73365,73365,73366,0,1,3
21056,4,3,73369,73369,73372,0,3,3
21057,2,1,73371,73372,73373,1,2,0
21058,2,1,73373,73373,73374,0,1,0
21059,1,1,73374,73374,73375,0,1,0
21060,4,3,73378,73378,73381,0,3,3
21061,1,1,73379,73381,73382,2,3,0
21062,3,3,73382,73382,73385,0,3,0
21063,5,3,73387,73387,73390,0,3,2
21064,6,1,73393,73393,73394,0,1,3
21065,5,1,73398,73398,73399,0,1,4
21066,4,1,73402,73402,73403,0,1,3
21067,6,3,73408,73408,73411,0,3,5
21068,2,3,73410,73411,73414,1,4,0
21069,5,2,73415,73415,73417,0,2,1
21070,1,3,73416,73417,73420,1,4,0
21071,4,3,73420,73420,73423,0,3,0
21072,6,3,73426,73426,73429,0,3,3
21073,1,2,73427,73429,73431,2,4,0
21074,5,3,73432,73432,73435,0,3,1
21075,3,3,73435,73435,73438,0,3,0
21076,3,1,73438,73438,73439,0,1,0
21077,3,1,73441,73441,73442,0,1,2
21078,2,3,73443,73443,73446,0,3,1
21079,2,3,73445,73446,73449,1,4,0
21080,1,3,73446,73449,73452,3,6,0
21081,6,3,73452,73452,73455,0,3,0
21082,4,1,73456,73456,73457,0,1,1
21083,3,1,73459,73459,73460,0,1,2
21084,6,1,73465,73465,73466,0,1,5
21085,1,2,73466,73466,73468,0,2,0
21086,2,3,73468,73468,73471,0,3,0
21087,3,3,73471,73471,73474,0,3,0
21088,3,1,73474,73474,73475,0,1,0
21089,2,3,73476,73476,73479,0,3,1
21090,4,1,73480,73480,73481,0,1,1
21091,6,1,73486,73486,73487,0,1,5
21092,6,2,73492,73492,73494,0,2,5
21093,3,1,73495,73495,73496,0,1,1
21094,5,3,73500,73500,73503,0,3,4
21095,5,2,73505,73505,73507,0,2,2
21096,2,1,73507,73507,73508,0,1,0
21097,4,2,73511,73511,73513,0,2,3
21098,4,3,73515,73515,73518,0,3,2
21099,6,2,73521,73521,73523,0,2,3
21100,3,3,73524,73524,73527,0,3,1
21101,4,3,73528,73528,73531,0,3,1
21102,4,2,73532,73532,73534,0,2,1
21103,6,2,73538,73538,73540,0,2,4
21104,1,3,73539,73540,73543,1,4,0
21105,1,3,73540,73543,73546,3,6,0
21106,5,2,73545,73546,73548,1,3,0
21107,4,3,73549,73549,73552,0,3,1
21108,4,1,73553,73553,73554,0,1,1
21109,4,1,73557,73557,73558,0,1,3
21110,6,3,73563,73563,73566,0,3,5
21111,6,2,73569,73569,73571,0,2,3
21112,4,3,73573,73573,73576,0,3,2
21113,6,3,73579,73579,73582,0,3,3
21114,5,2,73584,73584,73586,0,2,2
21115,5,3,73589,73589,73592,0,3,3
21116,6,3,73595,73595,73598,0,3,3
21117,2,3,73597,73598,73601,1,4,0
21118,3,2,73600,73601,73603,1,3,0
21119,5,3,73605,73605,73608,0,3,2
21120,2,1,73607,73608,73609,1,2,0
21121,6,2,73613,73613,73615,0,2,4
21122,2,2,73615,73615,73617,0,2,0
21123,3,1,73618,73618,73619,0,1,1
21124,5,3,73623,73623,73626,0,3,4
21125,2,3,73625,73626,73629,1,4,0
21126,6,2,73631,73631,73633,0,2,2
21127,1,1,73632,73633,73634,1,2,0
21128,1,3,73633,73634,73637,1,4,0
21129,1,2,73634,73637,73639,3,5,0
21130,1,1,73635,73639,73640,4,5,0
21131,4,2,73639,73640,73642,1,3,0
21132,2,3,73641,73642,73645,1,4,0
21133,1,3,73642,73645,73648,3,6,0
21134,1,2,73643,73648,73650,5,7,0
21135,2,3,73645,73650,73653,5,8,0
21136,5,3,73650,73653,73656,3,6,0
21137,6,1,73656,73656,73657,0,1,0
21138,4,2,73660,73660,73662,0,2,3
21139,6,2,73666,73666,73668,0,2,4
21140,3,3,73669,73669,73672,0,3,1
21141,4,2,73673,73673,73675,0,2,1
21142,6,1,73679,73679,73680,0,1,4
21143,1,2,73680,73680,73682,0,2,0
21144,2,2,73682,73682,73684,0,2,0
21145,6,1,73688,73688,73689,0,1,4
21146,2,1,73690,73690,73691,0,1,1
21147,1,3,73691,73691,73694,0,3,0
21148,5,2,73696,73696,73698,0,2,2
21149,6,2,73702,73702,73704,0,2,4
21150,2,1,73704,73704,73705,0,1,0
21151,6,1,73710,73710,73711,0,1,5
21152,1,3,73711,73711,73714,0,3,0
21153,4,2,73715,73715,73717,0,2,1
21154,1,1,73716,73717,73718,1,2,0
21155,3,2,73719,73719,73721,0,2,1
21156,5,3,73724,73724,73727,0,3,3
21157,5,1,73729,73729,73730,0,1,2
21158,3,3,73732,73732,73735,0,3,2
21159,2,3,73734,73735,73738,1,4,0
21160,1,2,73735,73738,73740,3,5,0
21161,3,1,73738,73740,73741,2,3,0
21162,6,3,73744,73744,73747,0,3,3
21163,1,2,73745,73747,73749,2,4,0
21164,5,2,73750,73750,73752,0,2,1
21165,6,2,73756,73756,73758,0,2,4
21166,2,1,73758,73758,73759,0,1,0
21167,5,1,73763,73763,73764,0,1,4
21168,6,1,73769,73769,73770,0,1,5
21169,3,3,73772,73772,73775,0,3,2
21170,5,3,73777,73777,73780,0,3,2
21171,3,1,73780,73780,73781,0,1,0
21172,2,1,73782,73782,73783,0,1,1
21173,2,2,73784,73784,73786,0,2,1
21174,1,1,73785,73786,73787,1,2,0
21175,4,2,73789,73789,73791,0,2,2
21176,6,1,73795,73795,73796,0,1,4
21177,4,1,73799,73799,73800,0,1,3
21178,5,1,73804,73804,73805,0,1,4
21179,1,3,73805,73805,73808,0,3,0
21180,3,3,73808,73808,73811,0,3,0
21181,1,1,73809,73811,73812,2,3,0
21182,2,1,73811,73812,73813,1,2,0
21183,2,1,73813,73813,73814,0,1,0
21184,5,2,73818,73818,73820,0,2,4
21185,5,2,73823,73823,73825,0,2,3
21186,6,2,73829,73829,73831,0,2,4
21187,1,2,73830,73831,73833,1,3,0
21188,2,3,73832,73833,73836,1,4,0
21189,2,2,73834,73836,73838,2,4,0
21190,1,1,73835,73838,73839,3,4,0
21191,3,3,73838,73839,73842,1,4,0
21192,5,1,73843,73843,73844,0,1,1
21193,1,3,73844,73844,73847,0,3,0
21194,4,2,73848,73848,73850,0,2,1
21195,6,2,73854,73854,73856,0,2,4
21196,3,1,73857,73857,73858,0,1,1
21197,6,1,73863,73863,73864,0,1,5
21198,1,1,73864,73864,73865,0,1,0
21199,5,1,73869,73869,73870,0,1,4
21200,4,1,73873,73873,73874,0,1,3
21201,5,3,73878,73878,73881,0,3,4
21202,6,2,73884,73884,73886,0,2,3
21203,6,1,73890,73890,73891,0,1,4
21204,6,1,73896,73896,73897,0,1,5
21205,1,2,73897,73897,73899,0,2,0
21206,6,3,73903,73903,73906,0,3,4
21207,1,2,73904,73906,73908,2,4,0
21208,4,2,73908,73908,73910,0,2,0
21209,5,3,73913,73913,73916,0,3,3
21210,1,1,73914,73916,73917,2,3,0
21211,2,1,73916,73917,73918,1,2,0
21212,6,2,73922,73922,73924,0,2,4
21213,1,2,73923,73924,73926,1,3,0
21214,3,2,73926,73926,73928,0,2,0
21215,4,3,73930,73930,73933,0,3,2
21216,2,1,73932,73933,73934,1,2,0
21217,5,1,73937,73937,73938,0,1,3
21218,3,2,73940,73940,73942,0,2,2
21219,1,2,73941,73942,73944,1,3,0
21220,5,2,73946,73946,73948,0,2,2
21221,6,3,73952,73952,73955,0,3,4
21222,6,3,73958,73958,73961,0,3,3
21223,4,3,73962,73962,73965,0,3,1
21224,5,2,73967,73967,73969,0,2,2
21225,1,2,73968,73969,73971,1,3,0
21226,4,3,73972,73972,73975,0,3,1
21227,6,2,73978,73978,73980,0,2,3
21228,4,2,73982,73982,73984,0,2,2
21229,3,1,73985,73985,73986,0,1,1
21230,4,1,73989,73989,73990,0,1,3
21231,5,3,73994,73994,73997,0,3,4
21232,3,3,73997,73997,74000,0,3,0
21233,3,2,74000,74000,74002,0,2,0
21234,2,3,74002,74002,74005,0,3,0
21235,5,2,74007,74007,74009,0,2,2
21236,3,3,74010,74010,74013,0,3,1
21237,3,1,74013,74013,74014,0,1,0
21238,2,3,74015,74015,74018,0,3,1
21239,1,2,74016,74018,74020,2,4,0
21240,1,2,74017,74020,74022,3,5,0
21241,6,3,74023,74023,74026,0,3,1
21242,1,3,74024,74026,74029,2,5,0
21243,1,2,74025,74029,74031,4,6,0
21244,4,1,74029,74031,74032,2,3,0
21245,6,1,74035,74035,74036,0,1,3
21246,2,2,74037,74037,74039,0,2,1
21247,4,1,74041,74041,74042,0,1,2
21248,3,1,74044,74044,74045,0,1,2
21249,4,3,74048,74048,74051,0,3,3
21250,2,3,74050,74051,74054,1,4,0
21251,2,2,74052,74054,74056,2,4,0
21252,2,3,74054,74056,74059,2,5,0
21253,5,1,74059,74059,74060,0,1,0
21254,3,2,74062,74062,74064,0,2,2
21255,5,2,74067,74067,74069,0,2,3
21256,4,2,74071,74071,74073,0,2,2
21257,3,3,74074,74074,74077,0,3,1
21258,3,2,74077,74077,74079,0,2,0
21259,3,2,74080,74080,74082,0,2,1
21260,1,3,74081,74082,74085,1,4,0
21261,1,2,74082,74085,74087,3,5,0
21262,2,2,74084,74087,74089,3,5,0
21263,4,3,74088,74089,74092,1,4,0
21264,2,3,74090,74092,74095,2,5,0
21265,4,1,74094,74095,74096,1,2,0
21266,1,2,74095,74096,74098,1,3,0
21267,5,2,74100,74100,74102,0,2,2
21268,6,2,74106,74106,74108,0,2,4
21269,1,3,74107,74108,74111,1,4,0
21270,1,2,74108,74111,74113,3,5,0
21271,3,1,74111,74113,74114,2,3,0
21272,3,2,74114,74114,74116,0,2,0
21273,5,3,74119,74119,74122,0,3,3
21274,6,2,74125,74125,74127,0,2,3
21275,2,2,74127,74127,74129,0,2,0
21276,1,2,74128,74129,74131,1,3,0
21277,1,3,74129,74131,74134,2,5,0
21278,2,2,74131,74134,74136,3,5,0
21279,4,2,74135,74136,74138,1,3,0
21280,6,2,74141,74141,74143,0,2,3
21281,4,1,74145,74145,74146,0,1,2
21282,1,1,74146,74146,74147,0,1,0
21283,1,3,74147,74147,74150,0,3,0
21284,1,2,74148,74150,74152,2,4,0
21285,5,1,74153,74153,74154,0,1,1
21286,4,1,74157,74157,74158,0,1,3
21287,5,2,74162,74162,74164,0,2,4
21288,5,1,74167,74167,74168,0,1,3
21289,6,2,74173,74173,74175,0,2,5
21290,4,3,74177,74177,74180,0,3,2
21291,3,1,74180,74180,74181,0,1,0
21292,5,3,74185,74185,74188,0,3,4
21293,4,1,74189,74189,74190,0,1,1
21294,2,1,74191,74191,74192,0,1,1
21295,4,2,74195,74195,74197,0,2,3
21296,5,1,74200,74200,74201,0,1,3
21297,2,3,74202,74202,74205,0,3,1
21298,3,2,74205,74205,74207,0,2,0
21299,3,3,74208,74208,74211,0,3,1
21300,3,2,74211,74211,74213,0,2,0
21301,5,3,74216,74216,74219,0,3,3
21302,2,2,74218,74219,74221,1,3,0
21303,3,2,74221,74221,74223,0,2,0
21304,6,1,74227,74227,74228,0,1,4
21305,6,3,74233,74233,74236,0,3,5
21306,4,2,74237,74237,74239,0,2,1
21307,6,3,74243,74243,74246,0,3,4
21308,3,1,74246,74246,74247,0,1,0
21309,1,2,74247,74247,74249,0,2,0
21310,3,1,74250,74250,74251,0,1,1
21311,3,3,74253,74253,74256,0,3,2
21312,5,2,74258,74258,74260,0,2,2
21313,6,3,74264,74264,74267,0,3,4
21314,3,3,74267,74267,74270,0,3,0
21315,4,1,74271,74271,74272,0,1,1
21316,1,2,74272,74272,74274,0,2,0
21317,6,2,74278,74278,74280,0,2,4
21318,2,3,74280,74280,74283,0,3,0
21319,6,2,74286,74286,74288,0,2,3
21320,1,2,74287,74288,74290,1,3,0
21321,3,3,74290,74290,74293,0,3,0
21322,2,1,74292,74293,74294,1,2,0
21323,3,2,74295,74295,74297,0,2,1
21324,3,1,74298,74298,74299,0,1,1
21325,2,1,74300,74300,74301,0,1,1
21326,1,1,74301,74301,74302,0,1,0
21327,3,1,74304,74304,74305,0,1,2
21328,3,2,74307,74307,74309,0,2,2
21329,4,2,74311,74311,74313,0,2,2
21330,2,2,74313,74313,74315,0,2,0
21331,2,3,74315,74315,74318,0,3,0
21332,4,1,74319,74319,74320,0,1,1
21333,4,3,74323,74323,74326,0,3,3
21334,5,3,74328,74328,74331,0,3,2
21335,2,3,74330,74331,74334,1,4,0
21336,3,2,74333,74334,74336,1,3,0
21337,2,1,74335,74336,74337,1,2,0
21338,6,3,74341,74341,74344,0,3,4
21339,6,1,74347,74347,74348,0,1,3
21340,1,2,74348,74348,74350,0,2,0
21341,3,1,74351,74351,74352,0,1,1
21342,1,2,74352,74352,74354,0,2,0
21343,1,3,74353,74354,74357,1,4,0
21344,3,2,74356,74357,74359,1,3,0
21345,5,1,74361,74361,74362,0,1,2
21346,4,1,74365,74365,74366,0,1,3
21347,6,2,74371,74371,74373,0,2,5
21348,6,1,74377,74377,74378,0,1,4
21349,6,2,74383,74383,74385,0,2,5
21350,4,1,74387,74387,74388,0,1,2
21351,3,3,74390,74390,74393,0,3,2
21352,2,1,74392,74393,74394,1,2,0
21353,1,3,74393,74394,74397,1,4,0
21354,6,1,74399,74399,74400,0,1,2
21355,2,3,74401,74401,74404,0,3,1
21356,3,1,74404,74404,74405,0,1,0
21357,3,1,74407,74407,74408,0,1,2
21358,1,1,74408,74408,74409,0,1,0
21359,6,2,74414,74414,74416,0,2,5
21360,3,1,74417,74417,74418,0,1,1
21361,4,2,74421,74421,74423,0,2,3
21362,1,2,74422,74423,74425,1,3,0
21363,1,1,74423,74425,74426,2,3,0
21364,2,2,74425,74426,74428,1,3,0
21365,2,1,74427,74428,74429,1,2,0
21366,5,2,74432,74432,74434,0,2,3
21367,2,2,74434,74434,74436,0,2,0
21368,6,2,74440,74440,74442,0,2,4
21369,2,3,74442,74442,74445,0,3,0
21370,4,1,74446,74446,74447,0,1,1
21371,6,2,74452,74452,74454,0,2,5
21372,3,3,74455,74455,74458,0,3,1
21373,4,1,74459,74459,74460,0,1,1
21374,4,1,74463,74463,74464,0,1,3
21375,2,3,74465,74465,74468,0,3,1
21376,6,3,74471,74471,74474,0,3,3
21377,6,1,74477,74477,74478,0,1,3
21378,6,2,74483,74483,74485,0,2,5
21379,6,2,74489,74489,74491,0,2,4
21380,1,2,74490,74491,74493,1,3,0
21381,3,1,74493,74493,74494,0,1,0
21382,6,1,74499,74499,74500,0,1,5
21383,3,3,74502,74502,74505,0,3,2
21384,6,1,74508,74508,74509,0,1,3
21385,5,3,74513,74513,74516,0,3,4
21386,6,3,74519,74519,74522,0,3,3
21387,6,1,74525,74525,74526,0,1,3
21388,6,1,74531,74531,74532,0,1,5
21389,6,1,74537,74537,74538,0,1,5
21390,6,2,74543,74543,74545,0,2,5
21391,4,1,74547,74547,74548,0,1,2
21392,5,3,74552,74552,74555,0,3,4
21393,2,1,74554,74555,74556,1,2,0
21394,4,2,74558,74558,74560,0,2,2
21395,1,1,74559,74560,74561,1,2,0
21396,5,2,74564,74564,74566,0,2,3
21397,1,2,74565,74566,74568,1,3,0
21398,2,2,74567,74568,74570,1,3,0
21399,6,1,74573,74573,74574,0,1,3
21400,3,1,74576,74576,74577,0,1,2
21401,4,1,74580,74580,74581,0,1,3
21402,4,2,74584,74584,74586,0,2,3
21403,4,3,74588,74588,74591,0,3,2
21404,2,3,74590,74591,74594,1,4,0
21405,6,3,74596,74596,74599,0,3,2
21406,2,2,74598,74599,74601,1,3,0
21407,5,2,74603,74603,74605,0,2,2
21408,3,1,74606,74606,74607,0,1,1
21409,4,3,74610,74610,74613,0,3,3
21410,4,2,74614,74614,74616,0,2,1
21411,3,3,74617,74617,74620,0,3,1
21412,6,3,74623,74623,74626,0,3,3
21413,1,3,74624,74626,74629,2,5,0
21414,6,1,74630,74630,74631,0,1,1
21415,5,2,74635,74635,74637,0,2,4
21416,5,2,74640,74640,74642,0,2,3
21417,2,2,74642,74642,74644,0,2,0
21418,2,2,74644,74644,74646,0,2,0
21419,1,1,74645,74646,74647,1,2,0
21420,2,1,74647,74647,74648,0,1,0
21421,3,3,74650,74650,74653,0,3,2
21422,6,1,74656,74656,74657,0,1,3
21423,3,1,74659,74659,74660,0,1,2
21424,1,2,74660,74660,74662,0,2,0
21425,1,1,74661,74662,74663,1,2,0
21426,4,1,74665,74665,74666,0,1,2
21427,5,1,74670,74670,74671,0,1,4
21428,5,3,74675,74675,74678,0,3,4
21429,3,1,74678,74678,74679,0,1,0
21430,3,2,74681,74681,74683,0,2,2
21431,3,2,74684,74684,74686,0,2,1
21432,3,2,74687,74687,74689,0,2,1
21433,4,2,74691,74691,74693,0,2,2
21434,2,3,74693,74693,74696,0,3,0
21435,1,2,74694,74696,74698,2,4,0
21436,2,3,74696,74698,74701,2,5,0
21437,4,3,74700,74701,74704,1,4,0
21438,6,3,74706,74706,74709,0,3,2
21439,4,3,74710,74710,74713,0,3,1
21440,2,2,74712,74713,74715,1,3,0
21441,1,3,74713,74715,74718,2,5,0
21442,6,1,74719,74719,74720,0,1,1
21443,3,3,74722,74722,74725,0,3,2
21444,1,3,74723,74725,74728,2,5,0
21445,3,2,74726,74728,74730,2,4,0
21446,4,1,74730,74730,74731,0,1,0
21447,3,3,74733,74733,74736,0,3,2
21448,5,3,74738,74738,74741,0,3,2
21449,6,3,74744,74744,74747,0,3,3
21450,2,1,74746,74747,74748,1,2,0
21451,1,3,74747,74748,74751,1,4,0
21452,4,1,74751,74751,74752,0,1,0
21453,6,2,74757,74757,74759,0,2,5
21454,6,1,74763,74763,74764,0,1,4
21455,3,2,74766,74766,74768,0,2,2
21456,5,2,74771,74771,74773,0,2,3
21457,1,3,74772,74773,74776,1,4,0
21458,6,1,74778,74778,74779,0,1,2
21459,5,2,74783,74783,74785,0,2,4
21460,4,2,74787,74787,74789,0,2,2
21461,4,1,74791,74791,74792,0,1,2
21462,3,1,74794,74794,74795,0,1,2
21463,6,1,74800,74800,74801,0,1,5
21464,1,1,74801,74801,74802,0,1,0
21465,2,1,74803,74803,74804,0,1,1
21466,6,1,74809,74809,74810,0,1,5
21467,2,2,74811,74811,74813,0,2,1
21468,4,3,74815,74815,74818,0,3,2
21469,4,3,74819,74819,74822,0,3,1
21470,4,1,74823,74823,74824,0,1,1
21471,4,3,74827,74827,74830,0,3,3
21472,3,1,74830,74830,74831,0,1,0
21473,6,3,74836,74836,74839,0,3,5
21474,4,1,74840,74840,74841,0,1,1
21475,2,2,74842,74842,74844,0,2,1
21476,6,2,74848,74848,74850,0,2,4
21477,5,2,74853,74853,74855,0,2,3
21478,6,2,74859,74859,74861,0,2,4
21479,5,1,74864,74864,74865,0,1,3
21480,4,3,74868,74868,74871,0,3,3
21481,1,1,74869,74871,74872,2,3,0
21482,5,1,74874,74874,74875,0,1,2
21483,6,2,74880,74880,74882,0,2,5
21484,3,2,74883,74883,74885,0,2,1
21485,2,2,74885,74885,74887,0,2,0
21486,4,1,74889,74889,74890,0,1,2
21487,2,1,74891,74891,74892,0,1,1
21488,2,1,74893,74893,74894,0,1,1
21489,3,2,74896,74896,74898,0,2,2
21490,3,2,74899,74899,74901,0,2,1
21491,6,2,74905,74905,74907,0,2,4
21492,5,1,74910,74910,74911,0,1,3
21493,1,1,74911,74911,74912,0,1,0
21494,5,2,74916,74916,74918,0,2,4
21495,5,2,74921,74921,74923,0,2,3
21496,6,3,74927,74927,74930,0,3,4
21497,2,3,74929,74930,74933,1,4,0
21498,1,3,74930,74933,74936,3,6,0
21499,2,3,74932,74936,74939,4,7,0
21500,1,3,74933,74939,74942,6,9,0
21501,5,1,74938,74942,74943,4,5,0
21502,1,2,74939,74943,74945,4,6,0
21503,4,1,74943,74945,74946,2,3,0
21504,5,2,74948,74948,74950,0,2,2
21505,5,1,74953,74953,74954,0,1,3
21506,2,1,74955,74955,74956,0,1,1
21507,6,2,74961,74961,74963,0,2,5
21508,4,3,74965,74965,74968,0,3,2
21509,4,2,74969,74969,74971,0,2,1
21510,4,2,74973,74973,74975,0,2,2
21511,5,3,74978,74978,74981,0,3,3
21512,2,3,74980,74981,74984,1,4,0
21513,6,1,74986,74986,74987,0,1,2
21514,4,2,74990,74990,74992,0,2,3
21515,4,2,74994,74994,74996,0,2,2
21516,3,3,74997,74997,75000,0,3,1
21517,2,3,74999,75000,75003,1,4,0
21518,6,3,75005,75005,75008,0,3,2
21519,1,3,75006,75008,75011,2,5,0
21520,4,1,75010,75011,75012,1,2,0
21521,6,1,75016,75016,75017,0,1,4
21522,2,3,75018,75018,75021,0,3,1
21523,5,3,75023,75023,75026,0,3,2
21524,2,2,75025,75026,75028,1,3,0
21525,6,1,75031,75031,75032,0,1,3
21526,5,1,75036,75036,75037,0,1,4
21527,2,1,75038,75038,75039,0,1,1
21528,4,2,75042,75042,75044,0,2,3
21529,2,2,75044,75044,75046,0,2,0
21530,5,2,75049,75049,75051,0,2,3
21531,5,3,75054,75054,75057,0,3,3
21532,4,1,75058,75058,75059,0,1,1
21533,5,1,75063,75063,75064,0,1,4
21534,1,2,75064,75064,75066,0,2,0
21535,3,1,75067,75067,75068,0,1,1
21536,5,3,75072,75072,75075,0,3,4
21537,4,3,75076,75076,75079,0,3,1
21538,1,1,75077,75079,75080,2,3,0
21539,6,1,75083,75083,75084,0,1,3
21540,6,1,75089,75089,75090,0,1,5
21541,1,2,75090,75090,75092,0,2,0
21542,5,1,75095,75095,75096,0,1,3
21543,1,2,75096,75096,75098,0,2,0
21544,1,1,75097,75098,75099,1,2,0
21545,3,1,75100,75100,75101,0,1,1
21546,3,3,75103,75103,75106,0,3,2
21547,6,3,75109,75109,75112,0,3,3
21548,2,1,75111,75112,75113,1,2,0
21549,6,2,75117,75117,75119,0,2,4
21550,4,2,75121,75121,75123,0,2,2
21551,4,2,75125,75125,75127,0,2,2
21552,6,1,75131,75131,75132,0,1,4
21553,6,1,75137,75137,75138,0,1,5
21554,5,1,75142,75142,75143,0,1,4
21555,3,2,75145,75145,75147,0,2,2
21556,6,1,75151,75151,75152,0,1,4
21557,2,1,75153,75153,75154,0,1,1
21558,3,3,75156,75156,75159,0,3,2
21559,4,3,75160,75160,75163,0,3,1
21560,5,3,75165,75165,75168,0,3,2
21561,4,2,75169,75169,75171,0,2,1
21562,6,2,75175,75175,75177,0,2,4
21563,4,3,75179,75179,75182,0,3,2
21564,1,3,75180,75182,75185,2,5,0
21565,1,3,75181,75185,75188,4,7,0
21566,5,3,75186,75188,75191,2,5,0
21567,2,2,75188,75191,75193,3,5,0
21568,5,2,75193,75193,75195,0,2,0
21569,6,2,75199,75199,75201,0,2,4
21570,5,1,75204,75204,75205,0,1,3
21571,5,3,75209,75209,75212,0,3,4
21572,6,2,75215,75215,75217,0,2,3
21573,6,2,75221,75221,75223,0,2,4
21574,3,3,75224,75224,75227,0,3,1
21575,4,1,75228,75228,75229,0,1,1
21576,3,3,75231,75231,75234,0,3,2
21577,6,3,75237,75237,75240,0,3,3
21578,2,3,75239,75240,75243,1,4,0
21579,4,3,75243,75243,75246,0,3,0
21580,4,3,75247,75247,75250,0,3,1
21581,6,3,75253,75253,75256,0,3,3
21582,3,2,75256,75256,75258,0,2,0
21583,2,3,75258,75258,75261,0,3,0
21584,1,1,75259,75261,75262,2,3,0
21585,6,3,75265,75265,75268,0,3,3
21586,5,2,75270,75270,75272,0,2,2
21587,2,3,75272,75272,75275,0,3,0
21588,1,2,75273,75275,75277,2,4,0
21589,6,1,75279,75279,75280,0,1,2
21590,1,1,75280,75280,75281,0,1,0
21591,4,3,75284,75284,75287,0,3,3
21592,3,1,75287,75287,75288,0,1,0
21593,4,2,75291,75291,75293,0,2,3
21594,6,1,75297,75297,75298,0,1,4
21595,2,1,75299,75299,75300,0,1,1
21596,6,3,75305,75305,75308,0,3,5
21597,5,2,75310,75310,75312,0,2,2
21598,2,2,75312,75312,75314,0,2,0
21599,6,3,75318,75318,75321,0,3,4
21600,4,2,75322,75322,75324,0,2,1
21601,2,3,75324,75324,75327,0,3,0
21602,2,2,75326,75327,75329,1,3,0
21603,2,2,75328,75329,75331,1,3,0
21604,3,2,75331,75331,75333,0,2,0
21605,3,1,75334,75334,75335,0,1,1
21606,1,3,75335,75335,75338,0,3,0
21607,1,1,75336,75338,75339,2,3,0
21608,6,3,75342,75342,75345,0,3,3
21609,3,1,75345,75345,75346,0,1,0
21610,1,2,75346,75346,75348,0,2,0
21611,3,1,75349,75349,75350,0,1,1
21612,3,3,75352,75352,75355,0,3,2
21613,3,3,75355,75355,75358,0,3,0
21614,2,2,75357,75358,75360,1,3,0
21615,3,2,75360,75360,75362,0,2,0
21616,2,2,75362,75362,75364,0,2,0
21617,5,3,75367,75367,75370,0,3,3
21618,2,1,75369,75370,75371,1,2,0
21619,3,3,75372,75372,75375,0,3,1
21620,6,3,75378,75378,75381,0,3,3
21621,1,2,75379,75381,75383,2,4,0
21622,6,2,75385,75385,75387,0,2,2
21623,6,3,75391,75391,75394,0,3,4
21624,1,1,75392,75394,75395,2,3,0
21625,2,1,75394,75395,75396,1,2,0
21626,4,3,75398,75398,75401,0,3,2
21627,1,1,75399,75401,75402,2,3,0
21628,2,1,75401,75402,75403,1,2,0
21629,2,1,75403,75403,75404,0,1,0
21630,5,3,75408,75408,75411,0,3,4
21631,3,1,75411,75411,75412,0,1,0
21632,3,1,75414,75414,75415,0,1,2
21633,5,1,75419,75419,75420,0,1,4
21634,4,2,75423,75423,75425,0,2,3
21635,6,1,75429,75429,75430,0,1,4
21636,5,2,75434,75434,75436,0,2,4
21637,2,2,75436,75436,75438,0,2,0
21638,2,3,75438,75438,75441,0,3,0
21639,5,1,75443,75443,75444,0,1,2
21640,2,3,75445,75445,75448,0,3,1
21641,1,3,75446,75448,75451,2,5,0
21642,5,1,75451,75451,75452,0,1,0
21643,4,2,75455,75455,75457,0,2,3
21644,3,3,75458,75458,75461,0,3,1
21645,2,1,75460,75461,75462,1,2,0
21646,4,1,75464,75464,75465,0,1,2
21647,1,2,75465,75465,75467,0,2,0
21648,3,3,75468,75468,75471,0,3,1
21649,1,3,75469,75471,75474,2,5,0
21650,4,3,75473,75474,75477,1,4,0
21651,4,2,75477,75477,75479,0,2,0
21652,2,3,75479,75479,75482,0,3,0
21653,5,1,75484,75484,75485,0,1,2
21654,6,3,75490,75490,75493,0,3,5
21655,2,1,75492,75493,75494,1,2,0
21656,1,2,75493,75494,75496,1,3,0
21657,5,2,75498,75498,75500,0,2,2
21658,2,1,75500,75500,75501,0,1,0
21659,4,3,75504,75504,75507,0,3,3
21660,2,1,75506,75507,75508,1,2,0
21661,1,3,75507,75508,75511,1,4,0
21662,3,1,75510,75511,75512,1,2,0
21663,5,1,75515,75515,75516,0,1,3
21664,2,2,75517,75517,75519,0,2,1
21665,1,2,75518,75519,75521,1,3,0
21666,5,2,75523,75523,75525,0,2,2
21667,6,2,75529,75529,75531,0,2,4
21668,6,1,75535,75535,75536,0,1,4
21669,1,1,75536,75536,75537,0,1,0
21670,4,1,75540,75540,75541,0,1,3
21671,4,2,75544,75544,75546,0,2,3
21672,3,1,75547,75547,75548,0,1,1
21673,3,1,75550,75550,75551,0,1,2
21674,2,1,75552,75552,75553,0,1,1
21675,3,3,75555,75555,75558,0,3,2
21676,6,2,75561,75561,75563,0,2,3
21677,1,3,75562,75563,75566,1,4,0
21678,1,2,75563,75566,75568,3,5,0
21679,1,2,75564,75568,75570,4,6,0
21680,2,2,75566,75570,75572,4,6,0
21681,1,1,75567,75572,75573,5,6,0
21682,5,3,75572,75573,75576,1,4,0
21683,1,3,75573,75576,75579,3,6,0
21684,3,2,75576,75579,75581,3,5,0
21685,4,2,75580,75581,75583,1,3,0
21686,2,1,75582,75583,75584,1,2,0
21687,5,1,75587,75587,75588,0,1,3
21688,3,2,75590,75590,75592,0,2,2
21689,6,2,75596,75596,75598,0,2,4
21690,6,1,75602,75602,75603,0,1,4
21691,1,3,75603,75603,75606,0,3,0
21692,6,1,75609,75609,75610,0,1,3
21693,5,1,75614,75614,75615,0,1,4
21694,4,3,75618,75618,75621,0,3,3
21695,4,1,75622,75622,75623,0,1,1
21696,5,1,75627,75627,75628,0,1,4
21697,2,1,75629,75629,75630,0,1,1
21698,1,1,75630,75630,75631,0,1,0
21699,1,3,75631,75631,75634,0,3,0
21700,2,3,75633,75634,75637,1,4,0
21701,4,2,75637,75637,75639,0,2,0
21702,6,2,75643,75643,75645,0,2,4
21703,1,3,75644,75645,75648,1,4,0
21704,3,2,75647,75648,75650,1,3,0
21705,4,1,75651,75651,75652,0,1,1
21706,3,3,75654,75654,75657,0,3,2
21707,3,2,75657,75657,75659,0,2,0
21708,4,2,75661,75661,75663,0,2,2
21709,4,2,75665,75665,75667,0,2,2
21710,6,3,75671,75671,75674,0,3,4
21711,5,2,75676,75676,75678,0,2,2
21712,6,2,75682,75682,75684,0,2,4
21713,1,1,75683,75684,75685,1,2,0
21714,6,2,75689,75689,75691,0,2,4
21715,3,2,75692,75692,75694,0,2,1
21716,4,2,75696,75696,75698,0,2,2
21717,1,2,75697,75698,75700,1,3,0
21718,5,3,75702,75702,75705,0,3,2
21719,2,1,75704,75705,75706,1,2,0
21720,1,1,75705,75706,75707,1,2,0
21721,6,1,75711,75711,75712,0,1,4
21722,4,3,75715,75715,75718,0,3,3
21723,4,1,75719,75719,75720,0,1,1
21724,1,3,75720,75720,75723,0,3,0
21725,5,3,75725,75725,75728,0,3,2
21726,2,2,75727,75728,75730,1,3,0
21727,1,2,75728,75730,75732,2,4,0
21728,2,3,75730,75732,75735,2,5,0
21729,4,3,75734,75735,75738,1,4,0
21730,3,1,75737,75738,75739,1,2,0
21731,4,2,75741,75741,75743,0,2,2
21732,2,2,75743,75743,75745,0,2,0
21733,2,3,75745,75745,75748,0,3,0
21734,5,1,75750,75750,75751,0,1,2
21735,1,3,75751,75751,75754,0,3,0
21736,5,2,75756,75756,75758,0,2,2
21737,4,3,75760,75760,75763,0,3,2
21738,1,2,75761,75763,75765,2,4,0
21739,1,2,75762,75765,75767,3,5,0
21740,1,3,75763,75767,75770,4,7,0
21741,5,1,75768,75770,75771,2,3,0
21742,3,2,75771,75771,75773,0,2,0
21743,5,2,75776,75776,75778,0,2,3
21744,1,2,75777,75778,75780,1,3,0
21745,2,2,75779,75780,75782,1,3,0
21746,6,1,75785,75785,75786,0,1,3
21747,4,3,75789,75789,75792,0,3,3
21748,4,1,75793,75793,75794,0,1,1
21749,2,1,75795,75795,75796,0,1,1
21750,6,3,75801,75801,75804,0,3,5
21751,1,1,75802,75804,75805,2,3,0
21752,2,1,75804,75805,75806,1,2,0
21753,3,1,75807,75807,75808,0,1,1
21754,3,2,75810,75810,75812,0,2,2
21755,3,3,75813,75813,75816,0,3,1
21756,1,3,75814,75816,75819,2,5,0
21757,2,3,75816,75819,75822,3,6,0
21758,3,1,75819,75822,75823,3,4,0
21759,3,1,75822,75823,75824,1,2,0
21760,5,2,75827,75827,75829,0,2,3
21761,4,3,75831,75831,75834,0,3,2
21762,2,1,75833,75834,75835,1,2,0
21763,1,3,75834,75835,75838,1,4,0
21764,5,1,75839,75839,75840,0,1,1
21765,3,3,75842,75842,75845,0,3,2
21766,1,2,75843,75845,75847,2,4,0
21767,3,2,75846,75847,75849,1,3,0
21768,3,3,75849,75849,75852,0,3,0
21769,3,1,75852,75852,75853,0,1,0
21770,3,1,75855,75855,75856,0,1,2
21771,4,3,75859,75859,75862,0,3,3
21772,3,1,75862,75862,75863,0,1,0
21773,2,1,75864,75864,75865,0,1,1
21774,3,1,75867,75867,75868,0,1,2
21775,3,3,75870,75870,75873,0,3,2
21776,4,3,75874,75874,75877,0,3,1
21777,2,2,75876,75877,75879,1,3,0
21778,3,1,75879,75879,75880,0,1,0
21779,4,1,75883,75883,75884,0,1,3
21780,2,1,75885,75885,75886,0,1,1
21781,4,3,75889,75889,75892,0,3,3
21782,5,2,75894,75894,75896,0,2,2
21783,6,1,75900,75900,75901,0,1,4
21784,1,2,75901,75901,75903,0,2,0
21785,2,2,75903,75903,75905,0,2,0
21786,5,2,75908,75908,75910,0,2,3
21787,2,3,75910,75910,75913,0,3,0
21788,6,3,75916,75916,75919,0,3,3
21789,3,3,75919,75919,75922,0,3,0
21790,4,2,75923,75923,75925,0,2,1
21791,5,3,75928,75928,75931,0,3,3
21792,1,1,75929,75931,75932,2,3,0
21793,4,2,75933,75933,75935,0,2,1
21794,3,2,75936,75936,75938,0,2,1
21795,4,1,75940,75940,75941,0,1,2
21796,6,2,75946,75946,75948,0,2,5
21797,3,1,75949,75949,75950,0,1,1
21798,4,2,75953,75953,75955,0,2,3
21799,6,2,75959,75959,75961,0,2,4
21800,1,3,75960,75961,75964,1,4,0
21801,5,2,75965,75965,75967,0,2,1
21802,3,3,75968,75968,75971,0,3,1
21803,2,1,75970,75971,75972,1,2,0
21804,6,1,75976,75976,75977,0,1,4
21805,3,2,75979,75979,75981,0,2,2
21806,6,2,75985,75985,75987,0,2,4
21807,1,3,75986,75987,75990,1,4,0
21808,1,2,75987,75990,75992,3,5,0
21809,3,2,75990,75992,75994,2,4,0
21810,3,3,75993,75994,75997,1,4,0
21811,5,2,75998,75998,76000,0,2,1
21812,5,3,76003,76003,76006,0,3,3
21813,5,1,76008,76008,76009,0,1,2
21814,1,1,76009,76009,76010,0,1,0
21815,3,3,76012,76012,76015,0,3,2
21816,1,1,76013,76015,76016,2,3,0
21817,1,2,76014,76016,76018,2,4,0
21818,2,1,76016,76018,76019,2,3,0
21819,6,2,76022,76022,76024,0,2,3
21820,5,1,76027,76027,76028,0,1,3
21821,6,3,76033,76033,76036,0,3,5
21822,4,1,76037,76037,76038,0,1,1
21823,2,1,76039,76039,76040,0,1,1
21824,3,2,76042,76042,76044,0,2,2
21825,4,2,76046,76046,76048,0,2,2
21826,2,2,76048,76048,76050,0,2,0
21827,1,1,76049,76050,76051,1,2,0
21828,6,2,76055,76055,76057,0,2,4
21829,3,1,76058,76058,76059,0,1,1
21830,4,1,76062,76062,76063,0,1,3
21831,4,1,76066,76066,76067,0,1,3
21832,6,3,76072,76072,76075,0,3,5
21833,4,3,76076,76076,76079,0,3,1
21834,2,1,76078,76079,76080,1,2,0
21835,5,2,76083,76083,76085,0,2,3
21836,2,1,76085,76085,76086,0,1,0
21837,3,2,76088,76088,76090,0,2,2
21838,2,1,76090,76090,76091,0,1,0
21839,1,2,76091,76091,76093,0,2,0
21840,4,2,76095,76095,76097,0,2,2
21841,4,3,76099,76099,76102,0,3,2
21842,2,1,76101,76102,76103,1,2,0
21843,5,1,76106,76106,76107,0,1,3
21844,3,1,76109,76109,76110,0,1,2
21845,6,3,76115,76115,76118,0,3,5
21846,6,3,76121,76121,76124,0,3,3
21847,5,2,76126,76126,76128,0,2,2
21848,6,2,76132,76132,76134,0,2,4
21849,5,1,76137,76137,76138,0,1,3
21850,3,1,76140,76140,76141,0,1,2
21851,2,1,76142,76142,76143,0,1,1
21852,2,3,76144,76144,76147,0,3,1
21853,1,1,76145,76147,76148,2,3,0
21854,2,3,76147,76148,76151,1,4,0
21855,1,3,76148,76151,76154,3,6,0
21856,6,2,76154,76154,76156,0,2,0
21857,3,2,76157,76157,76159,0,2,1
21858,1,2,76158,76159,76161,1,3,0
21859,4,3,76162,76162,76165,0,3,1
21860,3,2,76165,76165,76167,0,2,0
21861,1,2,76166,76167,76169,1,3,0
21862,4,1,76170,76170,76171,0,1,1
21863,6,1,76176,76176,76177,0,1,5
21864,4,3,76180,76180,76183,0,3,3
21865,3,3,76183,76183,76186,0,3,0
21866,4,1,76187,76187,76188,0,1,1
21867,6,3,76193,76193,76196,0,3,5
21868,3,3,76196,76196,76199,0,3,0
21869,2,1,76198,76199,76200,1,2,0
21870,5,3,76203,76203,76206,0,3,3
21871,5,3,76208,76208,76211,0,3,2
21872,3,2,76211,76211,76213,0,2,0
21873,6,2,76217,76217,76219,0,2,4
21874,5,1,76222,76222,76223,0,1,3
21875,4,3,76226,76226,76229,0,3,3
21876,2,2,76228,76229,76231,1,3,0
21877,4,1,76232,76232,76233,0,1,1
21878,3,3,76235,76235,76238,0,3,2
21879,5,3,76240,76240,76243,0,3,2
21880,4,2,76244,76244,76246,0,2,1
21881,6,3,76250,76250,76253,0,3,4
21882,4,2,76254,76254,76256,0,2,1
21883,2,2,76256,76256,76258,0,2,0
21884,1,1,76257,76258,76259,1,2,0
21885,1,3,76258,76259,76262,1,4,0
21886,6,2,76264,76264,76266,0,2,2
21887,2,3,76266,76266,76269,0,3,0
21888,6,3,76272,76272,76275,0,3,3
21889,1,3,76273,76275,76278,2,5,0
21890,4,3,76277,76278,76281,1,4,0
21891,3,2,76280,76281,76283,1,3,0
21892,6,3,76286,76286,76289,0,3,3
21893,1,1,76287,76289,76290,2,3,0
21894,6,3,76293,76293,76296,0,3,3
21895,6,2,76299,76299,76301,0,2,3
21896,1,2,76300,76301,76303,1,3,0
21897,5,2,76305,76305,76307,0,2,2
21898,2,1,76307,76307,76308,0,1,0
21899,3,3,76310,76310,76313,0,3,2
21900,4,3,76314,76314,76317,0,3,1
21901,6,1,76320,76320,76321,0,1,3
21902,3,1,76323,76323,76324,0,1,2
21903,4,2,76327,76327,76329,0,2,3
21904,2,3,76329,76329,76332,0,3,0
21905,1,1,76330,76332,76333,2,3,0
21906,6,2,76336,76336,76338,0,2,3
21907,1,1,76337,76338,76339,1,2,0
21908,6,1,76343,76343,76344,0,1,4
21909,5,3,76348,76348,76351,0,3,4
21910,5,3,76353,76353,76356,0,3,2
21911,6,2,76359,76359,76361,0,2,3
21912,6,1,76365,76365,76366,0,1,4
21913,6,1,76371,76371,76372,0,1,5
21914,4,1,76375,76375,76376,0,1,3
21915,6,1,76381,76381,76382,0,1,5
21916,5,1,76386,76386,76387,0,1,4
21917,1,1,76387,76387,76388,0,1,0
21918,4,1,76391,76391,76392,0,1,3
21919,4,2,76395,76395,76397,0,2,3
21920,3,3,76398,76398,76401,0,3,1
21921,3,2,76401,76401,76403,0,2,0
21922,3,1,76404,76404,76405,0,1,1
21923,1,3,76405,76405,76408,0,3,0
21924,3,3,76408,76408,76411,0,3,0
21925,1,1,76409,76411,76412,2,3,0
21926,6,3,76415,76415,76418,0,3,3
21927,6,1,76421,76421,76422,0,1,3
21928,6,1,76427,76427,76428,0,1,5
21929,6,2,76433,76433,76435,0,2,5
21930,5,1,76438,76438,76439,0,1,3
21931,4,3,76442,76442,76445,0,3,3
21932,6,1,76448,76448,76449,0,1,3
21933,2,3,76450,76450,76453,0,3,1
21934,6,2,76456,76456,76458,0,2,3
21935,4,2,76460,76460,76462,0,2,2
21936,3,1,76463,76463,76464,0,1,1
21937,2,2,76465,76465,76467,0,2,1
21938,2,2,76467,76467,76469,0,2,0
21939,4,2,76471,76471,76473,0,2,2
21940,3,3,76474,76474,76477,0,3,1
21941,2,2,76476,76477,76479,1,3,0
21942,4,2,76480,76480,76482,0,2,1
21943,5,3,76485,76485,76488,0,3,3
21944,5,2,76490,76490,76492,0,2,2
21945,6,2,76496,76496,76498,0,2,4
21946,2,1,76498,76498,76499,0,1,0
21947,6,3,76504,76504,76507,0,3,5
21948,3,1,76507,76507,76508,0,1,0
21949,3,2,76510,76510,76512,0,2,2
21950,2,1,76512,76512,76513,0,1,0
21951,1,3,76513,76513,76516,0,3,0
21952,3,2,76516,76516,76518,0,2,0
21953,1,3,76517,76518,76521,1,4,0
21954,6,3,76523,76523,76526,0,3,2
21955,1,2,76524,76526,76528,2,4,0
21956,2,3,76526,76528,76531,2,5,0
21957,5,1,76531,76531,76532,0,1,0
21958,4,2,76535,76535,76537,0,2,3
21959,2,2,76537,76537,76539,0,2,0
21960,3,1,76540,76540,76541,0,1,1
21961,1,3,76541,76541,76544,0,3,0
21962,6,2,76547,76547,76549,0,2,3
21963,1,3,76548,76549,76552,1,4,0
21964,4,1,76552,76552,76553,0,1,0
21965,3,3,76555,76555,76558,0,3,2
21966,4,1,76559,76559,76560,0,1,1
21967,1,1,76560,76560,76561,0,1,0
21968,6,1,76566,76566,76567,0,1,5
21969,6,3,76572,76572,76575,0,3,5
21970,4,1,76576,76576,76577,0,1,1
21971,4,2,76580,76580,76582,0,2,3
21972,6,1,76586,76586,76587,0,1,4
21973,2,2,76588,76588,76590,0,2,1
21974,4,3,76592,76592,76595,0,3,2
21975,4,2,76596,76596,76598,0,2,1
21976,1,3,76597,76598,76601,1,4,0
21977,5,1,76602,76602,76603,0,1,1
21978,1,3,76603,76603,76606,0,3,0
21979,4,1,76607,76607,76608,0,1,1
21980,1,3,76608,76608,76611,0,3,0
21981,6,1,76614,76614,76615,0,1,3
21982,2,1,76616,76616,76617,0,1,1
21983,5,2,76621,76621,76623,0,2,4
21984,1,3,76622,76623,76626,1,4,0
21985,6,3,76628,76628,76631,0,3,2
21986,6,3,76634,76634,76637,0,3,3
21987,4,3,76638,76638,76641,0,3,1
21988,6,1,76644,76644,76645,0,1,3
21989,3,1,76647,76647,76648,0,1,2
21990,4,2,76651,76651,76653,0,2,3
21991,5,1,76656,76656,76657,0,1,3
21992,6,1,76662,76662,76663,0,1,5
21993,3,2,76665,76665,76667,0,2,2
21994,5,2,76670,76670,76672,0,2,3
21995,4,1,76674,76674,76675,0,1,2
21996,6,2,76680,76680,76682,0,2,5
21997,3,3,76683,76683,76686,0,3,1
21998,2,3,76685,76686,76689,1,4,0
21999,5,1,76690,76690,76691,0,1,1
22000,5,1,76695,76695,76696,0,1,4
22001,2,3,76697,76697,76700,0,3,1
22002,3,2,76700,76700,76702,0,2,0
22003,4,1,76704,76704,76705,0,1,2
22004,6,1,76710,76710,76711,0,1,5
22005,3,2,76713,76713,76715,0,2,2
22006,2,2,76715,76715,76717,0,2,0
22007,4,3,76719,76719,76722,0,3,2
22008,6,2,76725,76725,76727,0,2,3
22009,1,1,76726,76727,76728,1,2,0
22010,4,1,76730,76730,76731,0,1,2
22011,2,3,76732,76732,76735,0,3,1
22012,1,1,76733,76735,76736,2,3,0
22013,6,3,76739,76739,76742,0,3,3
22014,2,1,76741,76742,76743,1,2,0
22015,2,2,76743,76743,76745,0,2,0
22016,3,2,76746,76746,76748,0,2,1
22017,2,1,76748,76748,76749,0,1,0
22018,3,3,76751,76751,76754,0,3,2
22019,4,3,76755,76755,76758,0,3,1
22020,4,1,76759,76759,76760,0,1,1
22021,4,2,76763,76763,76765,0,2,3
22022,6,1,76769,76769,76770,0,1,4
22023,1,1,76770,76770,76771,0,1,0
22024,5,1,76775,76775,76776,0,1,4
22025,4,3,76779,76779,76782,0,3,3
22026,5,3,76784,76784,76787,0,3,2
22027,2,1,76786,76787,76788,1,2,0
22028,2,2,76788,76788,76790,0,2,0
22029,3,2,76791,76791,76793,0,2,1
22030,4,1,76795,76795,76796,0,1,2
22031,2,2,76797,76797,76799,0,2,1
22032,6,3,76803,76803,76806,0,3,4
22033,4,3,76807,76807,76810,0,3,1
22034,4,2,76811,76811,76813,0,2,1
22035,1,2,76812,76813,76815,1,3,0
22036,6,1,76818,76818,76819,0,1,3
22037,2,2,76820,76820,76822,0,2,1
22038,1,1,76821,76822,76823,1,2,0
22039,6,2,76827,76827,76829,0,2,4
22040,4,1,76831,76831,76832,0,1,2
22041,2,2,76833,76833,76835,0,2,1
22042,1,3,76834,76835,76838,1,4,0
22043,2,2,76836,76838,76840,2,4,0
22044,2,1,76838,76840,76841,2,3,0
22045,1,2,76839,76841,76843,2,4,0
22046,6,2,76845,76845,76847,0,2,2
22047,1,1,76846,76847,76848,1,2,0
22048,1,3,76847,76848,76851,1,4,0
22049,2,1,76849,76851,76852,2,3,0
22050,1,3,76850,76852,76855,2,5,0
22051,2,1,76852,76855,76856,3,4,0
22052,2,3,76854,76856,76859,2,5,0
22053,2,1,76856,76859,76860,3,4,0
22054,3,3,76859,76860,76863,1,4,0
22055,1,3,76860,76863,76866,3,6,0
22056,3,1,76863,76866,76867,3,4,0
22057,5,3,76868,76868,76871,0,3,1
22058,6,3,76874,76874,76877,0,3,3
22059,5,2,76879,76879,76881,0,2,2
22060,5,2,76884,76884,76886,0,2,3
22061,4,3,76888,76888,76891,0,3,2
22062,2,1,76890,76891,76892,1,2,0
22063,3,1,76893,76893,76894,0,1,1
22064,4,2,76897,76897,76899,0,2,3
22065,6,3,76903,76903,76906,0,3,4
22066,2,3,76905,76906,76909,1,4,0
22067,6,3,76911,76911,76914,0,3,2
22068,3,3,76914,76914,76917,0,3,0
22069,2,3,76916,76917,76920,1,4,0
22070,2,3,76918,76920,76923,2,5,0
22071,2,3,76920,76923,76926,3,6,0
22072,3,3,76923,76926,76929,3,6,0
22073,6,2,76929,76929,76931,0,2,0
22074,1,2,76930,76931,76933,1,3,0
22075,2,3,76932,76933,76936,1,4,0
22076,6,2,76938,76938,76940,0,2,2
22077,6,3,76944,76944,76947,0,3,4
22078,6,2,76950,76950,76952,0,2,3
22079,2,1,76952,76952,76953,0,1,0
22080,5,2,76957,76957,76959,0,2,4
22081,6,2,76963,76963,76965,0,2,4
22082,4,2,76967,76967,76969,0,2,2
22083,4,1,76971,76971,76972,0,1,2
22084,2,3,76973,76973,76976,0,3,1
22085,2,3,76975,76976,76979,1,4,0
22086,4,1,76979,76979,76980,0,1,0
22087,1,1,76980,76980,76981,0,1,0
22088,5,2,76985,76985,76987,0,2,4
22089,4,2,76989,76989,76991,0,2,2
22090,2,1,76991,76991,76992,0,1,0
22091,6,1,76997,76997,76998,0,1,5
22092,2,1,76999,76999,77000,0,1,1
22093,5,3,77004,77004,77007,0,3,4
22094,4,2,77008,77008,77010,0,2,1
22095,1,1,77009,77010,77011,1,2,0
22096,4,3,77013,77013,77016,0,3,2
22097,4,2,77017,77017,77019,0,2,1
22098,3,3,77020,77020,77023,0,3,1
22099,3,2,77023,77023,77025,0,2,0
22100,4,3,77027,77027,77030,0,3,2
22101,2,3,77029,77030,77033,1,4,0
22102,4,1,77033,77033,77034,0,1,0
22103,3,1,77036,77036,77037,0,1,2
22104,2,3,77038,77038,77041,0,3,1
22105,3,1,77041,77041,77042,0,1,0
22106,2,2,77043,77043,77045,0,2,1
22107,4,3,77047,77047,77050,0,3,2
22108,3,1,77050,77050,77051,0,1,0
22109,2,3,77052,77052,77055,0,3,1
22110,6,3,77058,77058,77061,0,3,3
22111,6,1,77064,77064,77065,0,1,3
22112,5,3,77069,77069,77072,0,3,4
22113,3,3,77072,77072,77075,0,3,0
22114,1,1,77073,77075,77076,2,3,0
22115,5,2,77078,77078,77080,0,2,2
22116,2,2,77080,77080,77082,0,2,0
22117,1,1,77081,77082,77083,1,2,0
22118,5,2,77086,77086,77088,0,2,3
22119,5,2,77091,77091,77093,0,2,3
22120,2,2,77093,77093,77095,0,2,0
22121,1,3,77094,77095,77098,1,4,0
22122,2,1,77096,77098,77099,2,3,0
22123,4,1,77100,77100,77101,0,1,1
22124,6,3,77106,77106,77109,0,3,5
22125,3,2,77109,77109,77111,0,2,0
22126,1,2,77110,77111,77113,1,3,0
22127,3,2,77113,77113,77115,0,2,0
22128,3,1,77116,77116,77117,0,1,1
22129,5,1,77121,77121,77122,0,1,4
22130,2,2,77123,77123,77125,0,2,1
22131,3,1,77126,77126,77127,0,1,1
22132,1,1,77127,77127,77128,0,1,0
22133,6,2,77133,77133,77135,0,2,5
22134,3,2,77136,77136,77138,0,2,1
22135,2,3,77138,77138,77141,0,3,0
22136,1,1,77139,77141,77142,2,3,0
22137,4,2,77143,77143,77145,0,2,1
22138,2,1,77145,77145,77146,0,1,0
22139,5,1,77150,77150,77151,0,1,4
22140,2,2,77152,77152,77154,0,2,1
22141,4,3,77156,77156,77159,0,3,2
22142,6,1,77162,77162,77163,0,1,3
22143,6,3,77168,77168,77171,0,3,5
22144,1,3,77169,77171,77174,2,5,0
22145,5,1,77174,77174,77175,0,1,0
22146,3,3,77177,77177,77180,0,3,2
22147,1,3,77178,77180,77183,2,5,0
22148,1,3,77179,77183,77186,4,7,0
22149,3,1,77182,77186,77187,4,5,0
22150,6,3,77188,77188,77191,0,3,1
22151,1,1,77189,77191,77192,2,3,0
22152,1,1,77190,77192,77193,2,3,0
22153,1,1,77191,77193,77194,2,3,0
22154,3,1,77194,77194,77195,0,1,0
22155,4,1,77198,77198,77199,0,1,3
22156,4,1,77202,77202,77203,0,1,3
22157,3,1,77205,77205,77206,0,1,2
22158,5,2,77210,77210,77212,0,2,4
22159,2,2,77212,77212,77214,0,2,0
22160,5,2,77217,77217,77219,0,2,3
22161,1,2,77218,77219,77221,1,3,0
22162,5,2,77223,77223,77225,0,2,2
22163,6,2,77229,77229,77231,0,2,4
22164,3,1,77232,77232,77233,0,1,1
22165,4,2,77236,77236,77238,0,2,3
22166,3,2,77239,77239,77241,0,2,1
22167,6,1,77245,77245,77246,0,1,4
22168,6,2,77251,77251,77253,0,2,5
22169,3,3,77254,77254,77257,0,3,1
22170,3,3,77257,77257,77260,0,3,0
22171,2,2,77259,77260,77262,1,3,0
22172,2,1,77261,77262,77263,1,2,0
22173,5,3,77266,77266,77269,0,3,3
22174,3,2,77269,77269,77271,0,2,0
22175,6,3,77275,77275,77278,0,3,4
22176,3,1,77278,77278,77279,0,1,0
22177,3,1,77281,77281,77282,0,1,2
22178,4,3,77285,77285,77288,0,3,3
22179,5,1,77290,77290,77291,0,1,2
22180,1,1,77291,77291,77292,0,1,0
22181,2,2,77293,77293,77295,0,2,1
22182,5,1,77298,77298,77299,0,1,3
22183,6,1,77304,77304,77305,0,1,5
22184,3,2,77307,77307,77309,0,2,2
22185,6,1,77313,77313,77314,0,1,4
22186,2,1,77315,77315,77316,0,1,1
22187,6,2,77321,77321,77323,0,2,5
22188,1,3,77322,77323,77326,1,4,0
22189,1,1,77323,77326,77327,3,4,0
22190,3,3,77326,77327,77330,1,4,0
22191,1,1,77327,77330,77331,3,4,0
22192,4,1,77331,77331,77332,0,1,0
22193,6,3,77337,77337,77340,0,3,5
22194,2,2,77339,77340,77342,1,3,0
22195,4,3,77343,77343,77346,0,3,1
22196,1,1,77344,77346,77347,2,3,0
22197,3,3,77347,77347,77350,0,3,0
22198,2,2,77349,77350,77352,1,3,0
22199,2,2,77351,77352,77354,1,3,0
22200,1,1,77352,77354,77355,2,3,0
22201,6,2,77358,77358,77360,0,2,3
22202,6,2,77364,77364,77366,0,2,4
22203,2,1,77366,77366,77367,0,1,0
22204,5,1,77371,77371,77372,0,1,4
22205,3,1,77374,77374,77375,0,1,2
22206,5,1,77379,77379,77380,0,1,4
22207,5,2,77384,77384,77386,0,2,4
22208,1,2,77385,77386,77388,1,3,0
22209,5,1,77390,77390,77391,0,1,2
22210,2,3,77392,77392,77395,0,3,1
22211,5,3,77397,77397,77400,0,3,2
22212,2,3,77399,77400,77403,1,4,0
22213,5,1,77404,77404,77405,0,1,1
22214,4,1,77408,77408,77409,0,1,3
22215,4,1,77412,77412,77413,0,1,3
22216,5,1,77417,77417,77418,0,1,4
22217,5,1,77422,77422,77423,0,1,4
22218,1,1,77423,77423,77424,0,1,0
22219,4,3,77427,77427,77430,0,3,3
22220,3,1,77430,77430,77431,0,1,0
22221,3,1,77433,77433,77434,0,1,2
22222,1,1,77434,77434,77435,0,1,0
22223,6,1,77440,77440,77441,0,1,5
22224,1,1,77441,77441,77442,0,1,0
22225,6,2,77447,77447,77449,0,2,5
22226,4,1,77451,77451,77452,0,1,2
22227,6,2,77457,77457,77459,0,2,5
22228,2,3,77459,77459,77462,0,3,0
22229,2,3,77461,77462,77465,1,4,0
22230,2,2,77463,77465,77467,2,4,0
22231,4,1,77467,77467,77468,0,1,0
22232,3,2,77470,77470,77472,0,2,2
22233,4,2,77474,77474,77476,0,2,2
22234,6,3,77480,77480,77483,0,3,4
22235,4,2,77484,77484,77486,0,2,1
22236,2,2,77486,77486,77488,0,2,0
22237,5,3,77491,77491,77494,0,3,3
22238,3,1,77494,77494,77495,0,1,0
22239,6,3,77500,77500,77503,0,3,5
22240,2,1,77502,77503,77504,1,2,0
22241,6,3,77508,77508,77511,0,3,4
22242,4,1,77512,77512,77513,0,1,1
22243,5,3,77517,77517,77520,0,3,4
22244,5,1,77522,77522,77523,0,1,2
22245,4,3,77526,77526,77529,0,3,3
22246,1,1,77527,77529,77530,2,3,0
22247,5,1,77532,77532,77533,0,1,2
22248,1,2,77533,77533,77535,0,2,0
22249,2,3,77535,77535,77538,0,3,0
22250,1,1,77536,77538,77539,2,3,0
22251,3,3,77539,77539,77542,0,3,0
22252,3,1,77542,77542,77543,0,1,0
22253,2,2,77544,77544,77546,0,2,1
22254,2,3,77546,77546,77549,0,3,0
22255,4,2,77550,77550,77552,0,2,1
22256,2,3,77552,77552,77555,0,3,0
22257,1,1,77553,77555,77556,2,3,0
22258,1,1,77554,77556,77557,2,3,0
22259,6,2,77560,77560,77562,0,2,3
22260,4,2,77564,77564,77566,0,2,2
22261,2,1,77566,77566,77567,0,1,0
22262,1,1,77567,77567,77568,0,1,0
22263,2,3,77569,77569,77572,0,3,1
22264,1,1,77570,77572,77573,2,3,0
22265,3,3,77573,77573,77576,0,3,0
22266,1,1,77574,77576,77577,2,3,0
22267,3,3,77577,77577,77580,0,3,0
22268,2,1,77579,77580,77581,1,2,0
22269,3,2,77582,77582,77584,0,2,1
22270,6,2,77588,77588,77590,0,2,4
22271,6,3,77594,77594,77597,0,3,4
22272,1,2,77595,77597,77599,2,4,0
22273,1,2,77596,77599,77601,3,5,0
22274,5,1,77601,77601,77602,0,1,0
22275,2,2,77603,77603,77605,0,2,1
22276,2,3,77605,77605,77608,0,3,0
22277,4,2,77609,77609,77611,0,2,1
22278,2,2,77611,77611,77613,0,2,0
22279,4,1,77615,77615,77616,0,1,2
22280,4,2,77619,77619,77621,0,2,3
22281,1,1,77620,77621,77622,1,2,0
22282,2,3,77622,77622,77625,0,3,0
22283,6,3,77628,77628,77631,0,3,3
22284,6,1,77634,77634,77635,0,1,3
22285,5,1,77639,77639,77640,0,1,4
22286,5,1,77644,77644,77645,0,1,4
22287,3,2,77647,77647,77649,0,2,2
22288,6,2,77653,77653,77655,0,2,4
22289,6,2,77659,77659,77661,0,2,4
22290,3,1,77662,77662,77663,0,1,1
22291,6,1,77668,77668,77669,0,1,5
22292,1,3,77669,77669,77672,0,3,0
22293,2,1,77671,77672,77673,1,2,0
22294,3,1,77674,77674,77675,0,1,1
22295,6,2,77680,77680,77682,0,2,5
22296,4,1,77684,77684,77685,0,1,2
22297,5,3,77689,77689,77692,0,3,4
22298,5,2,77694,77694,77696,0,2,2
22299,3,2,77697,77697,77699,0,2,1
22300,1,3,77698,77699,77702,1,4,0
22301,3,2,77701,77702,77704,1,3,0
22302,6,3,77707,77707,77710,0,3,3
22303,1,1,77708,77710,77711,2,3,0
22304,4,1,77712,77712,77713,0,1,1
22305,2,3,77714,77714,77717,0,3,1
22306,4,3,77718,77718,77721,0,3,1
22307,3,2,77721,77721,77723,0,2,0
22308,3,1,77724,77724,77725,0,1,1
22309,6,1,77730,77730,77731,0,1,5
22310,4,3,77734,77734,77737,0,3,3
22311,2,1,77736,77737,77738,1,2,0
22312,5,2,77741,77741,77743,0,2,3
22313,5,1,77746,77746,77747,0,1,3
22314,4,1,77750,77750,77751,0,1,3
22315,3,3,77753,77753,77756,0,3,2
22316,6,1,77759,77759,77760,0,1,3
22317,5,2,77764,77764,77766,0,2,4
22318,4,3,77768,77768,77771,0,3,2
22319,1,1,77769,77771,77772,2,3,0
22320,3,3,77772,77772,77775,0,3,0
22321,5,3,77777,77777,77780,0,3,2
22322,3,3,77780,77780,77783,0,3,0
22323,5,2,77785,77785,77787,0,2,2
22324,5,3,77790,77790,77793,0,3,3
22325,1,2,77791,77793,77795,2,4,0
22326,1,2,77792,77795,77797,3,5,0
22327,5,1,77797,77797,77798,0,1,0
22328,1,1,77798,77798,77799,0,1,0
22329,5,2,77803,77803,77805,0,2,4
22330,5,2,77808,77808,77810,0,2,3
22331,6,1,77814,77814,77815,0,1,4
22332,6,3,77820,77820,77823,0,3,5
22333,4,2,77824,77824,77826,0,2,1
22334,3,3,77827,77827,77830,0,3,1
22335,1,1,77828,77830,77831,2,3,0
22336,3,3,77831,77831,77834,0,3,0
22337,4,2,77835,77835,77837,0,2,1
22338,1,3,77836,77837,77840,1,4,0
22339,3,1,77839,77840,77841,1,2,0
22340,4,2,77843,77843,77845,0,2,2
22341,5,3,77848,77848,77851,0,3,3
22342,5,1,77853,77853,77854,0,1,2
22343,2,2,77855,77855,77857,0,2,1
22344,6,3,77861,77861,77864,0,3,4
22345,1,3,77862,77864,77867,2,5,0
22346,6,2,77868,77868,77870,0,2,1
22347,3,3,77871,77871,77874,0,3,1
22348,4,3,77875,77875,77878,0,3,1
22349,1,1,77876,77878,77879,2,3,0
22350,2,2,77878,77879,77881,1,3,0
22351,2,1,77880,77881,77882,1,2,0
22352,1,3,77881,77882,77885,1,4,0
22353,6,1,77887,77887,77888,0,1,2
22354,1,3,77888,77888,77891,0,3,0
22355,3,2,77891,77891,77893,0,2,0
22356,6,2,77897,77897,77899,0,2,4
22357,5,1,77902,77902,77903,0,1,3
22358,5,3,77907,77907,77910,0,3,4
22359,1,1,77908,77910,77911,2,3,0
22360,3,2,77911,77911,77913,0,2,0
22361,1,3,77912,77913,77916,1,4,0
22362,4,1,77916,77916,77917,0,1,0
22363,6,2,77922,77922,77924,0,2,5
22364,1,2,77923,77924,77926,1,3,0
22365,4,3,77927,77927,77930,0,3,1
22366,1,3,77928,77930,77933,2,5,0
22367,6,2,77934,77934,77936,0,2,1
22368,5,3,77939,77939,77942,0,3,3
22369,3,3,77942,77942,77945,0,3,0
22370,1,1,77943,77945,77946,2,3,0
22371,2,2,77945,77946,77948,1,3,0
22372,1,1,77946,77948,77949,2,3,0
22373,5,3,77951,77951,77954,0,3,2
22374,2,2,77953,77954,77956,1,3,0
22375,4,2,77957,77957,77959,0,2,1
22376,2,3,77959,77959,77962,0,3,0
22377,3,3,77962,77962,77965,0,3,0
22378,2,1,77964,77965,77966,1,2,0
22379,4,1,77968,77968,77969,0,1,2
22380,3,2,77971,77971,77973,0,2,2
22381,5,1,77976,77976,77977,0,1,3
22382,6,1,77982,77982,77983,0,1,5
22383,6,2,77988,77988,77990,0,2,5
22384,6,1,77994,77994,77995,0,1,4
22385,4,1,77998,77998,77999,0,1,3
22386,1,3,77999,77999,78002,0,3,0
22387,1,3,78000,78002,78005,2,5,0
22388,1,2,78001,78005,78007,4,6,0
22389,2,1,78003,78007,78008,4,5,0
22390,2,2,78005,78008,78010,3,5,0
22391,3,1,78008,78010,78011,2,3,0
22392,1,3,78009,78011,78014,2,5,0
22393,2,2,78011,78014,78016,3,5,0
22394,6,1,78017,78017,78018,0,1,1
22395,5,3,78022,78022,78025,0,3,4
22396,6,2,78028,78028,78030,0,2,3
22397,5,2,78033,78033,78035,0,2,3
22398,3,2,78036,78036,78038,0,2,1
22399,3,2,78039,78039,78041,0,2,1
22400,3,1,78042,78042,78043,0,1,1
22401,5,3,78047,78047,78050,0,3,4
22402,3,2,78050,78050,78052,0,2,0
22403,2,2,78052,78052,78054,0,2,0
22404,2,1,78054,78054,78055,0,1,0
22405,6,2,78060,78060,78062,0,2,5
22406,2,3,78062,78062,78065,0,3,0
22407,6,2,78068,78068,78070,0,2,3
22408,1,2,78069,78070,78072,1,3,0
22409,1,3,78070,78072,78075,2,5,0
22410,2,2,78072,78075,78077,3,5,0
22411,2,3,78074,78077,78080,3,6,0
22412,5,3,78079,78080,78083,1,4,0
22413,4,3,78083,78083,78086,0,3,0
22414,3,1,78086,78086,78087,0,1,0
22415,5,3,78091,78091,78094,0,3,4
22416,6,2,78097,78097,78099,0,2,3
22417,3,3,78100,78100,78103,0,3,1
22418,6,1,78106,78106,78107,0,1,3
22419,3,3,78109,78109,78112,0,3,2
22420,3,1,78112,78112,78113,0,1,0
22421,1,2,78113,78113,78115,0,2,0
22422,3,3,78116,78116,78119,0,3,1
22423,4,2,78120,78120,78122,0,2,1
22424,5,3,78125,78125,78128,0,3,3
22425,5,3,78130,78130,78133,0,3,2
22426,6,2,78136,78136,78138,0,2,3
22427,5,2,78141,78141,78143,0,2,3
22428,5,3,78146,78146,78149,0,3,3
22429,5,3,78151,78151,78154,0,3,2
22430,4,2,78155,78155,78157,0,2,1
22431,2,3,78157,78157,78160,0,3,0
22432,4,1,78161,78161,78162,0,1,1
22433,5,1,78166,78166,78167,0,1,4
22434,6,2,78172,78172,78174,0,2,5
22435,4,3,78176,78176,78179,0,3,2
22436,5,1,78181,78181,78182,0,1,2
22437,5,1,78186,78186,78187,0,1,4
22438,6,1,78192,78192,78193,0,1,5
22439,4,3,78196,78196,78199,0,3,3
22440,2,2,78198,78199,78201,1,3,0
22441,4,1,78202,78202,78203,0,1,1
22442,6,2,78208,78208,78210,0,2,5
22443,6,3,78214,78214,78217,0,3,4
22444,3,3,78217,78217,78220,0,3,0
22445,6,2,78223,78223,78225,0,2,3
22446,1,3,78224,78225,78228,1,4,0
22447,5,3,78229,78229,78232,0,3,1
22448,3,3,78232,78232,78235,0,3,0
22449,2,1,78234,78235,78236,1,2,0
22450,1,1,78235,78236,78237,1,2,0
22451,3,2,78238,78238,78240,0,2,1
22452,5,3,78243,78243,78246,0,3,3
22453,6,1,78249,78249,78250,0,1,3
22454,4,3,78253,78253,78256,0,3,3
22455,4,1,78257,78257,78258,0,1,1
22456,6,1,78263,78263,78264,0,1,5
22457,3,1,78266,78266,78267,0,1,2
22458,6,1,78272,78272,78273,0,1,5
22459,2,3,78274,78274,78277,0,3,1
22460,5,1,78279,78279,78280,0,1,2
22461,4,2,78283,78283,78285,0,2,3
22462,2,1,78285,78285,78286,0,1,0
22463,1,1,78286,78286,78287,0,1,0
22464,6,3,78292,78292,78295,0,3,5
22465,3,2,78295,78295,78297,0,2,0
22466,2,2,78297,78297,78299,0,2,0
22467,4,1,78301,78301,78302,0,1,2
22468,4,2,78305,78305,78307,0,2,3
22469,1,3,78306,78307,78310,1,4,0
22470,2,2,78308,78310,78312,2,4,0
22471,1,1,78309,78312,78313,3,4,0
22472,5,1,78314,78314,78315,0,1,1
22473,1,3,78315,78315,78318,0,3,0
22474,5,2,78320,78320,78322,0,2,2
22475,3,3,78323,78323,78326,0,3,1
22476,5,2,78328,78328,78330,0,2,2
22477,6,3,78334,78334,78337,0,3,4
22478,5,2,78339,78339,78341,0,2,2
22479,4,1,78343,78343,78344,0,1,2
22480,3,2,78346,78346,78348,0,2,2
22481,4,3,78350,78350,78353,0,3,2
22482,6,3,78356,78356,78359,0,3,3
22483,1,1,78357,78359,78360,2,3,0
22484,3,3,78360,78360,78363,0,3,0
22485,4,3,78364,78364,78367,0,3,1
22486,5,1,78369,78369,78370,0,1,2
22487,6,1,78375,78375,78376,0,1,5
22488,6,3,78381,78381,78384,0,3,5
22489,2,1,78383,78384,78385,1,2,0
22490,1,3,78384,78385,78388,1,4,0
22491,6,1,78390,78390,78391,0,1,2
22492,2,1,78392,78392,78393,0,1,1
22493,5,3,78397,78397,78400,0,3,4
22494,4,3,78401,78401,78404,0,3,1
22495,4,3,78405,78405,78408,0,3,1
22496,3,3,78408,78408,78411,0,3,0
22497,4,3,78412,78412,78415,0,3,1
22498,6,1,78418,78418,78419,0,1,3
22499,5,3,78423,78423,78426,0,3,4
22500,1,1,78424,78426,78427,2,3,0
22501,2,1,78426,78427,78428,1,2,0
22502,3,3,78429,78429,78432,0,3,1
22503,6,1,78435,78435,78436,0,1,3
22504,2,1,78437,78437,78438,0,1,1
22505,1,2,78438,78438,78440,0,2,0
22506,6,1,78444,78444,78445,0,1,4
22507,1,1,78445,78445,78446,0,1,0
22508,3,2,78448,78448,78450,0,2,2
22509,4,1,78452,78452,78453,0,1,2
22510,6,3,78458,78458,78461,0,3,5
22511,3,2,78461,78461,78463,0,2,0
22512,2,2,78463,78463,78465,0,2,0
22513,4,2,78467,78467,78469,0,2,2
22514,1,2,78468,78469,78471,1,3,0
22515,6,1,78474,78474,78475,0,1,3
22516,3,3,78477,78477,78480,0,3,2
22517,4,2,78481,78481,78483,0,2,1
22518,6,1,78487,78487,78488,0,1,4
22519,5,3,78492,78492,78495,0,3,4
22520,2,3,78494,78495,78498,1,4,0
22521,6,1,78500,78500,78501,0,1,2
22522,1,3,78501,78501,78504,0,3,0
22523,3,3,78504,78504,78507,0,3,0
22524,2,1,78506,78507,78508,1,2,0
22525,5,1,78511,78511,78512,0,1,3
22526,2,2,78513,78513,78515,0,2,1
22527,2,2,78515,78515,78517,0,2,0
22528,5,3,78520,78520,78523,0,3,3
22529,5,2,78525,78525,78527,0,2,2
22530,6,1,78531,78531,78532,0,1,4
22531,1,3,78532,78532,78535,0,3,0
22532,6,3,78538,78538,78541,0,3,3
22533,4,2,78542,78542,78544,0,2,1
22534,1,1,78543,78544,78545,1,2,0
22535,6,1,78549,78549,78550,0,1,4
22536,3,3,78552,78552,78555,0,3,2
22537,3,1,78555,78555,78556,0,1,0
22538,2,2,78557,78557,78559,0,2,1
22539,2,2,78559,78559,78561,0,2,0
22540,6,1,78565,78565,78566,0,1,4
22541,3,3,78568,78568,78571,0,3,2
22542,2,2,78570,78571,78573,1,3,0
22543,3,1,78573,78573,78574,0,1,0
22544,5,1,78578,78578,78579,0,1,4
22545,5,2,78583,78583,78585,0,2,4
22546,3,2,78586,78586,78588,0,2,1
22547,3,2,78589,78589,78591,0,2,1
22548,5,2,78594,78594,78596,0,2,3
22549,3,1,78597,78597,78598,0,1,1
22550,5,2,78602,78602,78604,0,2,4
22551,5,2,78607,78607,78609,0,2,3
22552,6,2,78613,78613,78615,0,2,4
22553,6,3,78619,78619,78622,0,3,4
22554,1,1,78620,78622,78623,2,3,0
22555,4,2,78624,78624,78626,0,2,1
22556,5,2,78629,78629,78631,0,2,3
22557,5,3,78634,78634,78637,0,3,3
22558,5,2,78639,78639,78641,0,2,2
22559,2,3,78641,78641,78644,0,3,0
22560,3,2,78644,78644,78646,0,2,0
22561,6,1,78650,78650,78651,0,1,4
22562,6,1,78656,78656,78657,0,1,5
22563,4,2,78660,78660,78662,0,2,3
22564,5,3,78665,78665,78668,0,3,3
22565,6,2,78671,78671,78673,0,2,3
22566,3,2,78674,78674,78676,0,2,1
22567,4,3,78678,78678,78681,0,3,2
22568,5,1,78683,78683,78684,0,1,2
22569,1,3,78684,78684,78687,0,3,0
22570,5,2,78689,78689,78691,0,2,2
22571,5,1,78694,78694,78695,0,1,3
22572,4,3,78698,78698,78701,0,3,3
22573,4,2,78702,78702,78704,0,2,1
22574,1,2,78703,78704,78706,1,3,0
22575,5,2,78708,78708,78710,0,2,2
22576,6,2,78714,78714,78716,0,2,4
22577,3,3,78717,78717,78720,0,3,1
22578,4,1,78721,78721,78722,0,1,1
22579,3,3,78724,78724,78727,0,3,2
22580,1,2,78725,78727,78729,2,4,0
22581,5,1,78730,78730,78731,0,1,1
22582,3,3,78733,78733,78736,0,3,2
22583,5,3,78738,78738,78741,0,3,2
22584,5,2,78743,78743,78745,0,2,2
22585,6,2,78749,78749,78751,0,2,4
22586,4,2,78753,78753,78755,0,2,2
22587,2,1,78755,78755,78756,0,1,0
22588,6,1,78761,78761,78762,0,1,5
22589,2,1,78763,78763,78764,0,1,1
22590,2,2,78765,78765,78767,0,2,1
22591,1,2,78766,78767,78769,1,3,0
22592,1,1,78767,78769,78770,2,3,0
22593,5,3,78772,78772,78775,0,3,2
22594,6,2,78778,78778,78780,0,2,3
22595,2,1,78780,78780,78781,0,1,0
22596,5,1,78785,78785,78786,0,1,4
22597,1,2,78786,78786,78788,0,2,0
22598,6,1,78792,78792,78793,0,1,4
22599,2,2,78794,78794,78796,0,2,1
22600,6,1,78800,78800,78801,0,1,4
22601,5,2,78805,78805,78807,0,2,4
22602,4,1,78809,78809,78810,0,1,2
22603,3,1,78812,78812,78813,0,1,2
22604,3,2,78815,78815,78817,0,2,2
22605,5,1,78820,78820,78821,0,1,3
22606,2,2,78822,78822,78824,0,2,1
22607,1,3,78823,78824,78827,1,4,0
22608,4,1,78827,78827,78828,0,1,0
22609,1,2,78828,78828,78830,0,2,0
22610,6,3,78834,78834,78837,0,3,4
22611,5,1,78839,78839,78840,0,1,2
22612,3,1,78842,78842,78843,0,1,2
22613,1,2,78843,78843,78845,0,2,0
22614,4,2,78847,78847,78849,0,2,2
22615,3,2,78850,78850,78852,0,2,1
22616,5,2,78855,78855,78857,0,2,3
22617,5,1,78860,78860,78861,0,1,3
22618,2,3,78862,78862,78865,0,3,1
22619,1,2,78863,78865,78867,2,4,0
22620,5,1,78868,78868,78869,0,1,1
22621,1,3,78869,78869,78872,0,3,0
22622,5,1,78874,78874,78875,0,1,2
22623,1,1,78875,78875,78876,0,1,0
22624,3,1,78878,78878,78879,0,1,2
22625,1,3,78879,78879,78882,0,3,0
22626,6,2,78885,78885,78887,0,2,3
22627,3,3,78888,78888,78891,0,3,1
22628,5,2,78893,78893,78895,0,2,2
22629,1,2,78894,78895,78897,1,3,0
22630,2,2,78896,78897,78899,1,3,0
22631,3,3,78899,78899,78902,0,3,0
22632,5,1,78904,78904,78905,0,1,2
22633,6,3,78910,78910,78913,0,3,5
22634,4,3,78914,78914,78917,0,3,1
22635,5,1,78919,78919,78920,0,1,2
22636,5,1,78924,78924,78925,0,1,4
22637,2,2,78926,78926,78928,0,2,1
22638,1,2,78927,78928,78930,1,3,0
22639,6,3,78933,78933,78936,0,3,3
22640,5,3,78938,78938,78941,0,3,2
22641,3,1,78941,78941,78942,0,1,0
22642,6,1,78947,78947,78948,0,1,5
22643,2,2,78949,78949,78951,0,2,1
22644,4,2,78953,78953,78955,0,2,2
22645,1,2,78954,78955,78957,1,3,0
22646,5,3,78959,78959,78962,0,3,2
22647,5,2,78964,78964,78966,0,2,2
22648,4,2,78968,78968,78970,0,2,2
22649,2,2,78970,78970,78972,0,2,0
22650,5,1,78975,78975,78976,0,1,3
22651,4,1,78979,78979,78980,0,1,3
22652,3,1,78982,78982,78983,0,1,2
22653,5,2,78987,78987,78989,0,2,4
22654,6,2,78993,78993,78995,0,2,4
22655,5,3,78998,78998,79001,0,3,3
22656,6,1,79004,79004,79005,0,1,3
22657,6,3,79010,79010,79013,0,3,5
22658,6,1,79016,79016,79017,0,1,3
22659,3,2,79019,79019,79021,0,2,2
22660,1,2,79020,79021,79023,1,3,0
22661,4,2,79024,79024,79026,0,2,1
22662,4,3,79028,79028,79031,0,3,2
22663,2,3,79030,79031,79034,1,4,0
22664,3,2,79033,79034,79036,1,3,0
22665,2,2,79035,79036,79038,1,3,0
22666,4,1,79039,79039,79040,0,1,1
22667,2,1,79041,79041,79042,0,1,1
22668,6,3,79047,79047,79050,0,3,5
22669,6,2,79053,79053,79055,0,2,3
22670,4,2,79057,79057,79059,0,2,2
22671,1,2,79058,79059,79061,1,3,0
22672,5,2,79063,79063,79065,0,2,2
22673,6,3,79069,79069,79072,0,3,4
22674,1,2,79070,79072,79074,2,4,0
22675,5,1,79075,79075,79076,0,1,1
22676,3,3,79078,79078,79081,0,3,2
22677,6,3,79084,79084,79087,0,3,3
22678,1,3,79085,79087,79090,2,5,0
22679,6,1,79091,79091,79092,0,1,1
22680,4,1,79095,79095,79096,0,1,3
22681,3,2,79098,79098,79100,0,2,2
22682,4,3,79102,79102,79105,0,3,2
22683,2,3,79104,79105,79108,1,4,0
22684,4,3,79108,79108,79111,0,3,0
22685,2,1,79110,79111,79112,1,2,0
22686,4,2,79114,79114,79116,0,2,2
22687,1,1,79115,79116,79117,1,2,0
22688,4,1,79119,79119,79120,0,1,2
22689,5,2,79124,79124,79126,0,2,4
22690,6,3,79130,79130,79133,0,3,4
22691,2,2,79132,79133,79135,1,3,0
22692,1,3,79133,79135,79138,2,5,0
22693,5,3,79138,79138,79141,0,3,0
22694,2,1,79140,79141,79142,1,2,0
22695,3,3,79143,79143,79146,0,3,1
22696,2,3,79145,79146,79149,1,4,0
22697,6,2,79151,79151,79153,0,2,2
22698,3,2,79154,79154,79156,0,2,1
22699,6,1,79160,79160,79161,0,1,4
22700,5,3,79165,79165,79168,0,3,4
22701,5,1,79170,79170,79171,0,1,2
22702,2,2,79172,79172,79174,0,2,1
22703,4,1,79176,79176,79177,0,1,2
22704,1,2,79177,79177,79179,0,2,0
22705,4,1,79181,79181,79182,0,1,2
22706,1,1,79182,79182,79183,0,1,0
22707,4,3,79186,79186,79189,0,3,3
22708,6,3,79192,79192,79195,0,3,3
22709,4,1,79196,79196,79197,0,1,1
22710,1,2,79197,79197,79199,0,2,0
22711,3,3,79200,79200,79203,0,3,1
22712,5,3,79205,79205,79208,0,3,2
22713,2,1,79207,79208,79209,1,2,0
22714,4,3,79211,79211,79214,0,3,2
22715,1,2,79212,79214,79216,2,4,0
22716,5,2,79217,79217,79219,0,2,1
22717,6,3,79223,79223,79226,0,3,4
22718,4,3,79227,79227,79230,0,3,1
22719,6,1,79233,79233,79234,0,1,3
22720,5,3,79238,79238,79241,0,3,4
22721,2,3,79240,79241,79244,1,4,0
22722,4,2,79244,79244,79246,0,2,0
22723,1,1,79245,79246,79247,1,2,0
22724,3,3,79248,79248,79251,0,3,1
22725,4,2,79252,79252,79254,0,2,1
22726,4,1,79256,79256,79257,0,1,2
22727,1,3,79257,79257,79260,0,3,0
22728,6,1,79263,79263,79264,0,1,3
22729,3,1,79266,79266,79267,0,1,2
22730,6,3,79272,79272,79275,0,3,5
22731,3,2,79275,79275,79277,0,2,0
22732,4,3,79279,79279,79282,0,3,2
22733,5,3,79284,79284,79287,0,3,2
22734,3,1,79287,79287,79288,0,1,0
22735,4,3,79291,79291,79294,0,3,3
22736,6,3,79297,79297,79300,0,3,3
22737,3,1,79300,79300,79301,0,1,0
22738,3,3,79303,79303,79306,0,3,2
22739,2,1,79305,79306,79307,1,2,0
22740,6,3,79311,79311,79314,0,3,4
22741,2,2,79313,79314,79316,1,3,0
22742,6,2,79319,79319,79321,0,2,3
22743,5,3,79324,79324,79327,0,3,3
22744,4,1,79328,79328,79329,0,1,1
22745,2,1,79330,79330,79331,0,1,1
22746,2,2,79332,79332,79334,0,2,1
22747,2,3,79334,79334,79337,0,3,0
22748,2,2,79336,79337,79339,1,3,0
22749,4,2,79340,79340,79342,0,2,1
22750,5,3,79345,79345,79348,0,3,3
22751,4,1,79349,79349,79350,0,1,1
22752,1,1,79350,79350,79351,0,1,0
22753,4,3,79354,79354,79357,0,3,3
22754,2,3,79356,79357,79360,1,4,0
22755,3,3,79359,79360,79363,1,4,0
22756,5,2,79364,79364,79366,0,2,1
22757,3,3,79367,79367,79370,0,3,1
22758,4,2,79371,79371,79373,0,2,1
22759,6,1,79377,79377,79378,0,1,4
22760,3,3,79380,79380,79383,0,3,2
22761,4,3,79384,79384,79387,0,3,1
22762,6,1,79390,79390,79391,0,1,3
22763,3,3,79393,79393,79396,0,3,2
22764,5,3,79398,79398,79401,0,3,2
22765,6,2,79404,79404,79406,0,2,3
22766,5,2,79409,79409,79411,0,2,3
22767,3,1,79412,79412,79413,0,1,1
22768,5,1,79417,79417,79418,0,1,4
22769,3,3,79420,79420,79423,0,3,2
22770,4,3,79424,79424,79427,0,3,1
22771,1,3,79425,79427,79430,2,5,0
22772,1,1,79426,79430,79431,4,5,0
22773,5,1,79431,79431,79432,0,1,0
22774,6,3,79437,79437,79440,0,3,5
22775,5,3,79442,79442,79445,0,3,2
22776,6,1,79448,79448,79449,0,1,3
22777,1,1,79449,79449,79450,0,1,0
22778,3,1,79452,79452,79453,0,1,2
22779,3,1,79455,79455,79456,0,1,2
22780,6,2,79461,79461,79463,0,2,5
22781,5,2,79466,79466,79468,0,2,3
22782,5,2,79471,79471,79473,0,2,3
22783,5,2,79476,79476,79478,0,2,3
22784,3,2,79479,79479,79481,0,2,1
22785,6,2,79485,79485,79487,0,2,4
22786,2,1,79487,79487,79488,0,1,0
22787,3,2,79490,79490,79492,0,2,2
22788,2,3,79492,79492,79495,0,3,0
22789,5,3,79497,79497,79500,0,3,2
22790,4,1,79501,79501,79502,0,1,1
22791,5,1,79506,79506,79507,0,1,4
22792,3,2,79509,79509,79511,0,2,2
22793,6,1,79515,79515,79516,0,1,4
22794,3,3,79518,79518,79521,0,3,2
22795,1,3,79519,79521,79524,2,5,0
22796,5,3,79524,79524,79527,0,3,0
22797,6,2,79530,79530,79532,0,2,3
22798,1,2,79531,79532,79534,1,3,0
22799,3,3,79534,79534,79537,0,3,0
22800,3,1,79537,79537,79538,0,1,0
22801,2,1,79539,79539,79540,0,1,1
22802,3,2,79542,79542,79544,0,2,2
22803,6,3,79548,79548,79551,0,3,4
22804,5,2,79553,79553,79555,0,2,2
22805,5,2,79558,79558,79560,0,2,3
22806,2,1,79560,79560,79561,0,1,0
22807,4,1,79564,79564,79565,0,1,3
22808,1,3,79565,79565,79568,0,3,0
22809,3,2,79568,79568,79570,0,2,0
22810,3,2,79571,79571,79573,0,2,1
22811,1,1,79572,79573,79574,1,2,0
22812,1,3,79573,79574,79577,1,4,0
22813,3,2,79576,79577,79579,1,3,0
22814,6,1,79582,79582,79583,0,1,3
22815,1,1,79583,79583,79584,0,1,0
22816,5,3,79588,79588,79591,0,3,4
22817,2,1,79590,79591,79592,1,2,0
22818,2,2,79592,79592,79594,0,2,0
22819,3,1,79595,79595,79596,0,1,1
22820,5,3,79600,79600,79603,0,3,4
22821,4,3,79604,79604,79607,0,3,1
22822,2,2,79606,79607,79609,1,3,0
22823,1,3,79607,79609,79612,2,5,0
22824,5,3,79612,79612,79615,0,3,0
22825,1,2,79613,79615,79617,2,4,0
22826,5,1,79618,79618,79619,0,1,1
22827,6,1,79624,79624,79625,0,1,5
22828,2,2,79626,79626,79628,0,2,1
22829,1,1,79627,79628,79629,1,2,0
22830,4,1,79631,79631,79632,0,1,2
22831,5,1,79636,79636,79637,0,1,4
22832,6,2,79642,79642,79644,0,2,5
22833,4,3,79646,79646,79649,0,3,2
22834,2,1,79648,79649,79650,1,2,0
22835,1,2,79649,79650,79652,1,3,0
22836,2,3,79651,79652,79655,1,4,0
22837,1,1,79652,79655,79656,3,4,0
22838,3,3,79655,79656,79659,1,4,0
22839,3,1,79658,79659,79660,1,2,0
22840,6,1,79664,79664,79665,0,1,4
22841,1,2,79665,79665,79667,0,2,0
22842,4,3,79669,79669,79672,0,3,2
22843,2,1,79671,79672,79673,1,2,0
22844,1,1,79672,79673,79674,1,2,0
22845,5,1,79677,79677,79678,0,1,3
22846,5,3,79682,79682,79685,0,3,4
22847,6,3,79688,79688,79691,0,3,3
22848,3,3,79691,79691,79694,0,3,0
22849,6,2,79697,79697,79699,0,2,3
22850,1,1,79698,79699,79700,1,2,0
22851,4,1,79702,79702,79703,0,1,2
22852,2,2,79704,79704,79706,0,2,1
22853,4,2,79708,79708,79710,0,2,2
22854,6,3,79714,79714,79717,0,3,4
22855,4,1,79718,79718,79719,0,1,1
22856,6,1,79724,79724,79725,0,1,5
22857,1,3,79725,79725,79728,0,3,0
22858,2,3,79727,79728,79731,1,4,0
22859,1,1,79728,79731,79732,3,4,0
22860,1,1,79729,79732,79733,3,4,0
22861,3,2,79732,79733,79735,1,3,0
22862,4,3,79736,79736,79739,0,3,1
22863,1,1,79737,79739,79740,2,3,0
22864,6,1,79743,79743,79744,0,1,3
22865,1,3,79744,79744,79747,0,3,0
22866,4,1,79748,79748,79749,0,1,1
22867,3,1,79751,79751,79752,0,1,2
22868,4,3,79755,79755,79758,0,3,3
22869,5,2,79760,79760,79762,0,2,2
22870,6,3,79766,79766,79769,0,3,4
22871,6,1,79772,79772,79773,0,1,3
22872,6,2,79778,79778,79780,0,2,5
22873,4,2,79782,79782,79784,0,2,2
22874,1,2,79783,79784,79786,1,3,0
22875,4,3,79787,79787,79790,0,3,1
22876,5,3,79792,79792,79795,0,3,2
22877,5,1,79797,79797,79798,0,1,2
22878,6,3,79803,79803,79806,0,3,5
22879,2,1,79805,79806,79807,1,2,0
22880,5,3,79810,79810,79813,0,3,3
22881,2,1,79812,79813,79814,1,2,0
22882,3,3,79815,79815,79818,0,3,1
22883,3,3,79818,79818,79821,0,3,0
22884,4,1,79822,79822,79823,0,1,1
22885,5,1,79827,79827,79828,0,1,4
22886,6,2,79833,79833,79835,0,2,5
22887,3,3,79836,79836,79839,0,3,1
22888,4,2,79840,79840,79842,0,2,1
22889,3,3,79843,79843,79846,0,3,1
22890,5,3,79848,79848,79851,0,3,2
22891,5,3,79853,79853,79856,0,3,2
22892,3,1,79856,79856,79857,0,1,0
22893,3,3,79859,79859,79862,0,3,2
22894,5,2,79864,79864,79866,0,2,2
22895,5,2,79869,79869,79871,0,2,3
22896,6,3,79875,79875,79878,0,3,4
22897,3,1,79878,79878,79879,0,1,0
22898,1,1,79879,79879,79880,0,1,0
22899,3,2,79882,79882,79884,0,2,2
22900,2,2,79884,79884,79886,0,2,0
22901,4,3,79888,79888,79891,0,3,2
22902,3,1,79891,79891,79892,0,1,0
22903,1,2,79892,79892,79894,0,2,0
22904,1,3,79893,79894,79897,1,4,0
22905,4,1,79897,79897,79898,0,1,0
22906,6,3,79903,79903,79906,0,3,5
22907,1,2,79904,79906,79908,2,4,0
22908,4,1,79908,79908,79909,0,1,0
22909,2,3,79910,79910,79913,0,3,1
22910,6,1,79916,79916,79917,0,1,3
22911,6,2,79922,79922,79924,0,2,5
22912,2,2,79924,79924,79926,0,2,0
22913,5,2,79929,79929,79931,0,2,3
22914,2,2,79931,79931,79933,0,2,0
22915,5,1,79936,79936,79937,0,1,3
22916,3,1,79939,79939,79940,0,1,2
22917,2,3,79941,79941,79944,0,3,1
22918,3,1,79944,79944,79945,0,1,0
22919,3,1,79947,79947,79948,0,1,2
22920,6,2,79953,79953,79955,0,2,5
22921,2,3,79955,79955,79958,0,3,0
22922,2,1,79957,79958,79959,1,2,0
22923,4,2,79961,79961,79963,0,2,2
22924,4,1,79965,79965,79966,0,1,2
22925,2,1,79967,79967,79968,0,1,1
22926,6,3,79973,79973,79976,0,3,5
22927,2,2,79975,79976,79978,1,3,0
22928,4,2,79979,79979,79981,0,2,1
22929,6,2,79985,79985,79987,0,2,4
22930,6,2,79991,79991,79993,0,2,4
22931,2,3,79993,79993,79996,0,3,0
22932,4,2,79997,79997,79999,0,2,1
22933,6,2,80003,80003,80005,0,2,4
22934,4,2,80007,80007,80009,0,2,2
22935,4,2,80011,80011,80013,0,2,2
22936,3,1,80014,80014,80015,0,1,1
22937,4,2,80018,80018,80020,0,2,3
22938,1,1,80019,80020,80021,1,2,0
22939,2,2,80021,80021,80023,0,2,0
22940,2,3,80023,80023,80026,0,3,0
22941,6,1,80029,80029,80030,0,1,3
22942,1,3,80030,80030,80033,0,3,0
22943,6,3,80036,80036,80039,0,3,3
22944,3,2,80039,80039,80041,0,2,0
22945,5,1,80044,80044,80045,0,1,3
22946,4,1,80048,80048,80049,0,1,3
22947,3,3,80051,80051,80054,0,3,2
22948,5,1,80056,80056,80057,0,1,2
22949,6,2,80062,80062,80064,0,2,5
22950,1,1,80063,80064,80065,1,2,0
22951,1,3,80064,80065,80068,1,4,0
22952,4,3,80068,80068,80071,0,3,0
22953,3,1,80071,80071,80072,0,1,0
22954,6,1,80077,80077,80078,0,1,5
22955,2,2,80079,80079,80081,0,2,1
22956,4,2,80083,80083,80085,0,2,2
22957,4,1,80087,80087,80088,0,1,2
22958,6,1,80093,80093,80094,0,1,5
22959,1,1,80094,80094,80095,0,1,0
22960,3,1,80097,80097,80098,0,1,2
22961,5,1,80102,80102,80103,0,1,4
22962,3,2,80105,80105,80107,0,2,2
22963,6,2,80111,80111,80113,0,2,4
22964,2,2,80113,80113,80115,0,2,0
22965,4,3,80117,80117,80120,0,3,2
22966,2,3,80119,80120,80123,1,4,0
22967,2,3,80121,80123,80126,2,5,0
22968,6,3,80127,80127,80130,0,3,1
22969,3,2,80130,80130,80132,0,2,0
22970,1,1,80131,80132,80133,1,2,0
22971,5,1,80136,80136,80137,0,1,3
22972,2,2,80138,80138,80140,0,2,1
22973,3,1,80141,80141,80142,0,1,1
22974,3,3,80144,80144,80147,0,3,2
22975,1,1,80145,80147,80148,2,3,0
22976,2,2,80147,80148,80150,1,3,0
22977,4,2,80151,80151,80153,0,2,1
22978,1,1,80152,80153,80154,1,2,0
22979,2,2,80154,80154,80156,0,2,0
22980,4,3,80158,80158,80161,0,3,2
22981,6,2,80164,80164,80166,0,2,3
22982,6,1,80170,80170,80171,0,1,4
22983,2,2,80172,80172,80174,0,2,1
22984,1,3,80173,80174,80177,1,4,0
22985,6,3,80179,80179,80182,0,3,2
22986,4,1,80183,80183,80184,0,1,1
22987,2,1,80185,80185,80186,0,1,1
22988,5,3,80190,80190,80193,0,3,4
22989,5,1,80195,80195,80196,0,1,2
22990,4,3,80199,80199,80202,0,3,3
22991,2,2,80201,80202,80204,1,3,0
22992,4,3,80205,80205,80208,0,3,1
22993,6,2,80211,80211,80213,0,2,3
22994,6,1,80217,80217,80218,0,1,4
22995,4,3,80221,80221,80224,0,3,3
22996,4,3,80225,80225,80228,0,3,1
22997,2,1,80227,80228,80229,1,2,0
22998,1,1,80228,80229,80230,1,2,0
22999,6,2,80234,80234,80236,0,2,4
23000,6,3,80240,80240,80243,0,3,4
23001,4,1,80244,80244,80245,0,1,1
23002,6,1,80250,80250,80251,0,1,5
23003,4,1,80254,80254,80255,0,1,3
23004,5,2,80259,80259,80261,0,2,4
23005,4,1,80263,80263,80264,0,1,2
23006,5,3,80268,80268,80271,0,3,4
23007,4,2,80272,80272,80274,0,2,1
23008,3,3,80275,80275,80278,0,3,1
23009,3,2,80278,80278,80280,0,2,0
23010,5,1,80283,80283,80284,0,1,3
23011,1,3,80284,80284,80287,0,3,0
23012,6,2,80290,80290,80292,0,2,3
23013,5,2,80295,80295,80297,0,2,3
23014,4,3,80299,80299,80302,0,3,2
23015,5,1,80304,80304,80305,0,1,2
23016,3,1,80307,80307,80308,0,1,2
23017,2,2,80309,80309,80311,0,2,1
23018,4,1,80313,80313,80314,0,1,2
23019,2,2,80315,80315,80317,0,2,1
23020,5,1,80320,80320,80321,0,1,3
23021,6,2,80326,80326,80328,0,2,5
23022,5,3,80331,80331,80334,0,3,3
23023,5,3,80336,80336,80339,0,3,2
23024,1,1,80337,80339,80340,2,3,0
23025,4,3,80341,80341,80344,0,3,1
23026,4,2,80345,80345,80347,0,2,1
23027,1,2,80346,80347,80349,1,3,0
23028,3,2,80349,80349,80351,0,2,0
23029,6,1,80355,80355,80356,0,1,4
23030,3,1,80358,80358,80359,0,1,2
23031,2,1,80360,80360,80361,0,1,1
23032,2,2,80362,80362,80364,0,2,1
23033,2,3,80364,80364,80367,0,3,0
23034,5,2,80369,80369,80371,0,2,2
23035,1,1,80370,80371,80372,1,2,0
23036,4,1,80374,80374,80375,0,1,2
23037,4,3,80378,80378,80381,0,3,3
23038,2,2,80380,80381,80383,1,3,0
23039,2,1,80382,80383,80384,1,2,0
23040,4,2,80386,80386,80388,0,2,2
23041,2,2,80388,80388,80390,0,2,0
23042,3,1,80391,80391,80392,0,1,1
23043,4,3,80395,80395,80398,0,3,3
23044,1,1,80396,80398,80399,2,3,0
23045,1,2,80397,80399,80401,2,4,0
23046,1,3,80398,80401,80404,3,6,0
23047,6,3,80404,80404,80407,0,3,0
23048,1,3,80405,80407,80410,2,5,0
23049,4,3,80409,80410,80413,1,4,0
23050,2,3,80411,80413,80416,2,5,0
23051,1,2,80412,80416,80418,4,6,0
23052,2,1,80414,80418,80419,4,5,0
23053,6,3,80420,80420,80423,0,3,1
23054,5,3,80425,80425,80428,0,3,2
23055,4,2,80429,80429,80431,0,2,1
23056,6,1,80435,80435,80436,0,1,4
23057,4,1,80439,80439,80440,0,1,3
23058,6,1,80445,80445,80446,0,1,5
23059,6,1,80451,80451,80452,0,1,5
23060,3,2,80454,80454,80456,0,2,2
23061,2,3,80456,80456,80459,0,3,0
23062,3,3,80459,80459,80462,0,3,0
23063,2,1,80461,80462,80463,1,2,0
23064,3,2,80464,80464,80466,0,2,1
23065,3,3,80467,80467,80470,0,3,1
23066,1,2,80468,80470,80472,2,4,0
23067,4,3,80472,80472,80475,0,3,0
23068,1,1,80473,80475,80476,2,3,0
23069,4,2,80477,80477,80479,0,2,1
23070,2,1,80479,80479,80480,0,1,0
23071,4,2,80483,80483,80485,0,2,3
23072,5,2,80488,80488,80490,0,2,3
23073,4,1,80492,80492,80493,0,1,2
23074,6,1,80498,80498,80499,0,1,5
23075,1,1,80499,80499,80500,0,1,0
23076,5,2,80504,80504,80506,0,2,4
23077,1,1,80505,80506,80507,1,2,0
23078,3,3,80508,80508,80511,0,3,1
23079,2,1,80510,80511,80512,1,2,0
23080,4,2,80514,80514,80516,0,2,2
23081,3,1,80517,80517,80518,0,1,1
23082,5,2,80522,80522,80524,0,2,4
23083,5,3,80527,80527,80530,0,3,3
23084,2,3,80529,80530,80533,1,4,0
23085,2,2,80531,80533,80535,2,4,0
23086,1,3,80532,80535,80538,3,6,0
23087,5,3,80537,80538,80541,1,4,0
23088,2,2,80539,80541,80543,2,4,0
23089,6,3,80545,80545,80548,0,3,2
23090,5,2,80550,80550,80552,0,2,2
23091,1,1,80551,80552,80553,1,2,0
23092,1,1,80552,80553,80554,1,2,0
23093,6,2,80558,80558,80560,0,2,4
23094,6,3,80564,80564,80567,0,3,4
23095,6,1,80570,80570,80571,0,1,3
23096,5,2,80575,80575,80577,0,2,4
23097,3,1,80578,80578,80579,0,1,1
23098,1,2,80579,80579,80581,0,2,0
23099,2,2,80581,80581,80583,0,2,0
23100,3,1,80584,80584,80585,0,1,1
23101,3,2,80587,80587,80589,0,2,2
23102,6,3,80593,80593,80596,0,3,4
23103,1,3,80594,80596,80599,2,5,0
23104,4,1,80598,80599,80600,1,2,0
23105,3,2,80601,80601,80603,0,2,1
23106,3,1,80604,80604,80605,0,1,1
23107,1,1,80605,80605,80606,0,1,0
23108,6,1,80611,80611,80612,0,1,5
23109,4,3,80615,80615,80618,0,3,3
23110,4,1,80619,80619,80620,0,1,1
23111,3,3,80622,80622,80625,0,3,2
23112,1,2,80623,80625,80627,2,4,0
23113,3,1,80626,80627,80628,1,2,0
23114,6,1,80632,80632,80633,0,1,4
23115,2,1,80634,80634,80635,0,1,1
23116,3,3,80637,80637,80640,0,3,2
23117,3,1,80640,80640,80641,0,1,0
23118,2,1,80642,80642,80643,0,1,1
23119,6,3,80648,80648,80651,0,3,5
23120,4,3,80652,80652,80655,0,3,1
23121,6,2,80658,80658,80660,0,2,3
23122,6,2,80664,80664,80666,0,2,4
23123,2,3,80666,80666,80669,0,3,0
23124,6,3,80672,80672,80675,0,3,3
23125,1,3,80673,80675,80678,2,5,0
23126,1,2,80674,80678,80680,4,6,0
23127,6,1,80680,80680,80681,0,1,0
23128,2,1,80682,80682,80683,0,1,1
23129,3,1,80685,80685,80686,0,1,2
23130,2,2,80687,80687,80689,0,2,1
23131,3,3,80690,80690,80693,0,3,1
23132,6,1,80696,80696,80697,0,1,3
23133,6,1,80702,80702,80703,0,1,5
23134,4,3,80706,80706,80709,0,3,3
23135,1,1,80707,80709,80710,2,3,0
23136,4,2,80711,80711,80713,0,2,1
23137,4,1,80715,80715,80716,0,1,2
23138,2,2,80717,80717,80719,0,2,1
23139,6,2,80723,80723,80725,0,2,4
23140,6,1,80729,80729,80730,0,1,4
23141,1,1,80730,80730,80731,0,1,0
23142,2,1,80732,80732,80733,0,1,1
23143,5,1,80737,80737,80738,0,1,4
23144,5,3,80742,80742,80745,0,3,4
23145,2,2,80744,80745,80747,1,3,0
23146,6,2,80750,80750,80752,0,2,3
23147,4,1,80754,80754,80755,0,1,2
23148,5,1,80759,80759,80760,0,1,4
23149,3,2,80762,80762,80764,0,2,2
23150,5,3,80767,80767,80770,0,3,3
23151,1,1,80768,80770,80771,2,3,0
23152,4,2,80772,80772,80774,0,2,1
23153,2,2,80774,80774,80776,0,2,0
23154,3,1,80777,80777,80778,0,1,1
23155,1,1,80778,80778,80779,0,1,0
23156,2,2,80780,80780,80782,0,2,1
23157,2,1,80782,80782,80783,0,1,0
23158,1,2,80783,80783,80785,0,2,0
23159,3,2,80786,80786,80788,0,2,1
23160,5,3,80791,80791,80794,0,3,3
23161,3,1,80794,80794,80795,0,1,0
23162,2,2,80796,80796,80798,0,2,1
23163,5,3,80801,80801,80804,0,3,3
23164,6,1,80807,80807,80808,0,1,3
23165,6,3,80813,80813,80816,0,3,5
23166,3,1,80816,80816,80817,0,1,0
23167,5,1,80821,80821,80822,0,1,4
23168,4,2,80825,80825,80827,0,2,3
23169,4,1,80829,80829,80830,0,1,2
23170,3,2,80832,80832,80834,0,2,2
23171,4,1,80836,80836,80837,0,1,2
23172,6,2,80842,80842,80844,0,2,5
23173,6,3,80848,80848,80851,0,3,4
23174,5,2,80853,80853,80855,0,2,2
23175,1,1,80854,80855,80856,1,2,0
23176,5,1,80859,80859,80860,0,1,3
23177,3,1,80862,80862,80863,0,1,2
23178,3,1,80865,80865,80866,0,1,2
23179,3,1,80868,80868,80869,0,1,2
23180,5,3,80873,80873,80876,0,3,4
23181,1,2,80874,80876,80878,2,4,0
23182,5,2,80879,80879,80881,0,2,1
23183,6,3,80885,80885,80888,0,3,4
23184,4,3,80889,80889,80892,0,3,1
23185,6,2,80895,80895,80897,0,2,3
23186,6,1,80901,80901,80902,0,1,4
23187,6,1,80907,80907,80908,0,1,5
23188,2,3,80909,80909,80912,0,3,1
23189,2,3,80911,80912,80915,1,4,0
23190,1,2,80912,80915,80917,3,5,0
23191,5,3,80917,80917,80920,0,3,0
23192,3,1,80920,80920,80921,0,1,0
23193,4,3,80924,80924,80927,0,3,3
23194,1,3,80925,80927,80930,2,5,0
23195,4,2,80929,80930,80932,1,3,0
23196,4,1,80933,80933,80934,0,1,1
23197,2,3,80935,80935,80938,0,3,1
23198,2,1,80937,80938,80939,1,2,0
23199,5,2,80942,80942,80944,0,2,3
23200,4,2,80946,80946,80948,0,2,2
23201,5,2,80951,80951,80953,0,2,3
23202,4,2,80955,80955,80957,0,2,2
23203,1,3,80956,80957,80960,1,4,0
23204,6,1,80962,80962,80963,0,1,2
23205,4,3,80966,80966,80969,0,3,3
23206,2,1,80968,80969,80970,1,2,0
23207,6,2,80974,80974,80976,0,2,4
23208,3,2,80977,80977,80979,0,2,1
23209,2,3,80979,80979,80982,0,3,0
23210,3,3,80982,80982,80985,0,3,0
23211,6,1,80988,80988,80989,0,1,3
23212,2,2,80990,80990,80992,0,2,1
23213,3,1,80993,80993,80994,0,1,1
23214,4,2,80997,80997,80999,0,2,3
23215,5,1,81002,81002,81003,0,1,3
23216,2,3,81004,81004,81007,0,3,1
23217,1,2,81005,81007,81009,2,4,0
23218,3,2,81008,81009,81011,1,3,0
23219,2,2,81010,81011,81013,1,3,0
23220,4,2,81014,81014,81016,0,2,1
23221,4,3,81018,81018,81021,0,3,2
23222,1,1,81019,81021,81022,2,3,0
23223,5,2,81024,81024,81026,0,2,2
23224,6,1,81030,81030,81031,0,1,4
23225,2,2,81032,81032,81034,0,2,1
23226,2,1,81034,81034,81035,0,1,0
23227,6,2,81040,81040,81042,0,2,5
23228,6,2,81046,81046,81048,0,2,4
23229,6,1,81052,81052,81053,0,1,4
23230,2,1,81054,81054,81055,0,1,1
23231,1,3,81055,81055,81058,0,3,0
23232,6,1,81061,81061,81062,0,1,3
23233,5,2,81066,81066,81068,0,2,4
23234,4,1,81070,81070,81071,0,1,2
23235,5,2,81075,81075,81077,0,2,4
23236,2,2,81077,81077,81079,0,2,0
23237,4,1,81081,81081,81082,0,1,2
23238,1,2,81082,81082,81084,0,2,0
23239,2,3,81084,81084,81087,0,3,0
23240,1,1,81085,81087,81088,2,3,0
23241,4,2,81089,81089,81091,0,2,1
23242,2,1,81091,81091,81092,0,1,0
23243,1,1,81092,81092,81093,0,1,0
23244,5,3,81097,81097,81100,0,3,4
23245,1,3,81098,81100,81103,2,5,0
23246,1,1,81099,81103,81104,4,5,0
23247,3,1,81102,81104,81105,2,3,0
23248,6,2,81108,81108,81110,0,2,3
23249,4,2,81112,81112,81114,0,2,2
23250,3,1,81115,81115,81116,0,1,1
23251,3,3,81118,81118,81121,0,3,2
23252,5,3,81123,81123,81126,0,3,2
23253,4,1,81127,81127,81128,0,1,1
23254,3,3,81130,81130,81133,0,3,2
23255,3,1,81133,81133,81134,0,1,0
23256,6,1,81139,81139,81140,0,1,5
23257,6,2,81145,81145,81147,0,2,5
23258,2,3,81147,81147,81150,0,3,0
23259,5,1,81152,81152,81153,0,1,2
23260,3,3,81155,81155,81158,0,3,2
23261,4,3,81159,81159,81162,0,3,1
23262,3,1,81162,81162,81163,0,1,0
23263,4,2,81166,81166,81168,0,2,3
23264,1,2,81167,81168,81170,1,3,0
23265,2,2,81169,81170,81172,1,3,0
23266,3,2,81172,81172,81174,0,2,0
23267,2,2,81174,81174,81176,0,2,0
23268,6,1,81180,81180,81181,0,1,4
23269,6,2,81186,81186,81188,0,2,5
23270,5,3,81191,81191,81194,0,3,3
23271,1,1,81192,81194,81195,2,3,0
23272,4,3,81196,81196,81199,0,3,1
23273,5,1,81201,81201,81202,0,1,2
23274,6,2,81207,81207,81209,0,2,5
23275,2,1,81209,81209,81210,0,1,0
23276,3,1,81212,81212,81213,0,1,2
23277,4,1,81216,81216,81217,0,1,3
23278,5,1,81221,81221,81222,0,1,4
23279,5,3,81226,81226,81229,0,3,4
23280,4,3,81230,81230,81233,0,3,1
23281,6,1,81236,81236,81237,0,1,3
23282,2,3,81238,81238,81241,0,3,1
23283,6,2,81244,81244,81246,0,2,3
23284,6,1,81250,81250,81251,0,1,4
23285,5,2,81255,81255,81257,0,2,4
23286,3,2,81258,81258,81260,0,2,1
23287,1,2,81259,81260,81262,1,3,0
23288,1,1,81260,81262,81263,2,3,0
23289,5,3,81265,81265,81268,0,3,2
23290,1,2,81266,81268,81270,2,4,0
23291,5,2,81271,81271,81273,0,2,1
23292,4,2,81275,81275,81277,0,2,2
23293,4,3,81279,81279,81282,0,3,2
23294,5,3,81284,81284,81287,0,3,2
23295,6,2,81290,81290,81292,0,2,3
23296,5,3,81295,81295,81298,0,3,3
23297,3,2,81298,81298,81300,0,2,0
23298,2,1,81300,81300,81301,0,1,0
23299,1,2,81301,81301,81303,0,2,0
23300,1,3,81302,81303,81306,1,4,0
23301,2,1,81304,81306,81307,2,3,0
23302,3,2,81307,81307,81309,0,2,0
23303,5,2,81312,81312,81314,0,2,3
23304,2,2,81314,81314,81316,0,2,0
23305,1,3,81315,81316,81319,1,4,0
23306,6,3,81321,81321,81324,0,3,2
23307,1,1,81322,81324,81325,2,3,0
23308,4,2,81326,81326,81328,0,2,1
23309,4,2,81330,81330,81332,0,2,2
23310,6,2,81336,81336,81338,0,2,4
23311,6,1,81342,81342,81343,0,1,4
23312,4,2,81346,81346,81348,0,2,3
23313,3,3,81349,81349,81352,0,3,1
23314,1,2,81350,81352,81354,2,4,0
23315,1,2,81351,81354,81356,3,5,0
23316,1,3,81352,81356,81359,4,7,0
23317,4,2,81356,81359,81361,3,5,0
23318,4,2,81360,81361,81363,1,3,0
23319,3,3,81363,81363,81366,0,3,0
23320,3,3,81366,81366,81369,0,3,0
23321,4,3,81370,81370,81373,0,3,1
23322,2,2,81372,81373,81375,1,3,0
23323,5,3,81377,81377,81380,0,3,2
23324,5,2,81382,81382,81384,0,2,2
23325,3,2,81385,81385,81387,0,2,1
23326,6,3,81391,81391,81394,0,3,4
23327,6,3,81397,81397,81400,0,3,3
23328,1,3,81398,81400,81403,2,5,0
23329,3,2,81401,81403,81405,2,4,0
23330,6,2,81407,81407,81409,0,2,2
23331,2,1,81409,81409,81410,0,1,0
23332,3,3,81412,81412,81415,0,3,2
23333,5,1,81417,81417,81418,0,1,2
23334,1,1,81418,81418,81419,0,1,0
23335,3,2,81421,81421,81423,0,2,2
23336,5,1,81426,81426,81427,0,1,3
23337,4,2,81430,81430,81432,0,2,3
23338,4,1,81434,81434,81435,0,1,2
23339,5,2,81439,81439,81441,0,2,4
23340,6,1,81445,81445,81446,0,1,4
23341,6,3,81451,81451,81454,0,3,5
23342,5,1,81456,81456,81457,0,1,2
23343,6,3,81462,81462,81465,0,3,5
23344,4,2,81466,81466,81468,0,2,1
23345,6,1,81472,81472,81473,0,1,4
23346,6,2,81478,81478,81480,0,2,5
23347,6,1,81484,81484,81485,0,1,4
23348,6,2,81490,81490,81492,0,2,5
23349,6,2,81496,81496,81498,0,2,4
23350,5,2,81501,81501,81503,0,2,3
23351,2,3,81503,81503,81506,0,3,0
23352,2,2,81505,81506,81508,1,3,0
23353,2,1,81507,81508,81509,1,2,0
23354,4,3,81511,81511,81514,0,3,2
23355,2,1,81513,81514,81515,1,2,0
23356,4,3,81517,81517,81520,0,3,2
23357,1,3,81518,81520,81523,2,5,0
23358,6,2,81524,81524,81526,0,2,1
23359,6,1,81530,81530,81531,0,1,4
23360,5,3,81535,81535,81538,0,3,4
23361,5,3,81540,81540,81543,0,3,2
23362,3,1,81543,81543,81544,0,1,0
23363,4,3,81547,81547,81550,0,3,3
23364,4,3,81551,81551,81554,0,3,1
23365,4,3,81555,81555,81558,0,3,1
23366,6,1,81561,81561,81562,0,1,3
23367,6,2,81567,81567,81569,0,2,5
23368,5,2,81572,81572,81574,0,2,3
23369,3,2,81575,81575,81577,0,2,1
23370,5,1,81580,81580,81581,0,1,3
23371,3,1,81583,81583,81584,0,1,2
23372,6,1,81589,81589,81590,0,1,5
23373,3,2,81592,81592,81594,0,2,2
23374,6,2,81598,81598,81600,0,2,4
23375,4,3,81602,81602,81605,0,3,2
23376,3,3,81605,81605,81608,0,3,0
23377,4,3,81609,81609,81612,0,3,1
23378,4,3,81613,81613,81616,0,3,1
23379,3,3,81616,81616,81619,0,3,0
23380,1,1,81617,81619,81620,2,3,0
23381,2,3,81619,81620,81623,1,4,0
23382,5,2,81624,81624,81626,0,2,1
23383,3,1,81627,81627,81628,0,1,1
23384,1,1,81628,81628,81629,0,1,0
23385,4,3,81632,81632,81635,0,3,3
23386,1,3,81633,81635,81638,2,5,0
23387,5,2,81638,81638,81640,0,2,0
23388,1,3,81639,81640,81643,1,4,0
23389,3,1,81642,81643,81644,1,2,0
23390,6,3,81648,81648,81651,0,3,4
23391,2,2,81650,81651,81653,1,3,0
23392,3,3,81653,81653,81656,0,3,0
23393,4,1,81657,81657,81658,0,1,1
23394,6,3,81663,81663,81666,0,3,5
23395,4,2,81667,81667,81669,0,2,1
23396,4,3,81671,81671,81674,0,3,2
23397,4,1,81675,81675,81676,0,1,1
23398,1,3,81676,81676,81679,0,3,0
23399,4,1,81680,81680,81681,0,1,1
23400,5,2,81685,81685,81687,0,2,4
23401,2,2,81687,81687,81689,0,2,0
23402,4,1,81691,81691,81692,0,1,2
23403,2,1,81693,81693,81694,0,1,1
23404,3,2,81696,81696,81698,0,2,2
23405,6,2,81702,81702,81704,0,2,4
23406,5,2,81707,81707,81709,0,2,3
23407,4,3,81711,81711,81714,0,3,2
23408,5,3,81716,81716,81719,0,3,2
23409,4,2,81720,81720,81722,0,2,1
23410,4,1,81724,81724,81725,0,1,2
23411,4,1,81728,81728,81729,0,1,3
23412,3,1,81731,81731,81732,0,1,2
23413,1,3,81732,81732,81735,0,3,0
23414,4,3,81736,81736,81739,0,3,1
23415,4,3,81740,81740,81743,0,3,1
23416,5,1,81745,81745,81746,0,1,2
23417,2,1,81747,81747,81748,0,1,1
23418,4,3,81751,81751,81754,0,3,3
23419,1,1,81752,81754,81755,2,3,0
23420,5,1,81757,81757,81758,0,1,2
23421,5,1,81762,81762,81763,0,1,4
23422,2,1,81764,81764,81765,0,1,1
23423,5,3,81769,81769,81772,0,3,4
23424,6,2,81775,81775,81777,0,2,3
23425,2,2,81777,81777,81779,0,2,0
23426,6,2,81783,81783,81785,0,2,4
23427,6,3,81789,81789,81792,0,3,4
23428,1,3,81790,81792,81795,2,5,0
23429,4,3,81794,81795,81798,1,4,0
23430,6,1,81800,81800,81801,0,1,2
23431,2,3,81802,81802,81805,0,3,1
23432,4,1,81806,81806,81807,0,1,1
23433,6,2,81812,81812,81814,0,2,5
23434,5,3,81817,81817,81820,0,3,3
23435,2,1,81819,81820,81821,1,2,0
23436,2,1,81821,81821,81822,0,1,0
23437,3,1,81824,81824,81825,0,1,2
23438,6,3,81830,81830,81833,0,3,5
23439,2,2,81832,81833,81835,1,3,0
23440,3,3,81835,81835,81838,0,3,0
23441,5,3,81840,81840,81843,0,3,2
23442,3,2,81843,81843,81845,0,2,0
23443,2,2,81845,81845,81847,0,2,0
23444,6,1,81851,81851,81852,0,1,4
23445,1,1,81852,81852,81853,0,1,0
23446,6,3,81858,81858,81861,0,3,5
23447,2,3,81860,81861,81864,1,4,0
23448,1,1,81861,81864,81865,3,4,0
23449,2,3,81863,81865,81868,2,5,0
23450,1,3,81864,81868,81871,4,7,0
23451,6,3,81870,81871,81874,1,4,0
23452,1,1,81871,81874,81875,3,4,0
23453,2,1,81873,81875,81876,2,3,0
23454,4,2,81877,81877,81879,0,2,1
23455,3,2,81880,81880,81882,0,2,1
23456,4,3,81884,81884,81887,0,3,2
23457,4,3,81888,81888,81891,0,3,1
23458,3,3,81891,81891,81894,0,3,0
23459,3,1,81894,81894,81895,0,1,0
23460,2,2,81896,81896,81898,0,2,1
23461,2,3,81898,81898,81901,0,3,0
23462,5,2,81903,81903,81905,0,2,2
23463,4,2,81907,81907,81909,0,2,2
23464,4,3,81911,81911,81914,0,3,2
23465,4,3,81915,81915,81918,0,3,1
23466,3,2,81918,81918,81920,0,2,0
23467,3,3,81921,81921,81924,0,3,1
23468,2,2,81923,81924,81926,1,3,0
23469,6,3,81929,81929,81932,0,3,3
23470,6,3,81935,81935,81938,0,3,3
23471,2,3,81937,81938,81941,1,4,0
23472,2,1,81939,81941,81942,2,3,0
23473,3,1,81942,81942,81943,0,1,0
23474,5,1,81947,81947,81948,0,1,4
23475,6,1,81953,81953,81954,0,1,5
23476,1,1,81954,81954,81955,0,1,0
23477,4,1,81958,81958,81959,0,1,3
23478,3,2,81961,81961,81963,0,2,2
23479,6,2,81967,81967,81969,0,2,4
23480,1,1,81968,81969,81970,1,2,0
23481,6,1,81974,81974,81975,0,1,4
23482,4,3,81978,81978,81981,0,3,3
23483,6,3,81984,81984,81987,0,3,3
23484,1,3,81985,81987,81990,2,5,0
23485,4,2,81989,81990,81992,1,3,0
23486,3,3,81992,81992,81995,0,3,0
23487,1,1,81993,81995,81996,2,3,0
23488,5,3,81998,81998,82001,0,3,2
23489,1,1,81999,82001,82002,2,3,0
23490,2,2,82001,82002,82004,1,3,0
23491,5,2,82006,82006,82008,0,2,2
23492,6,1,82012,82012,82013,0,1,4
23493,4,3,82016,82016,82019,0,3,3
23494,2,2,82018,82019,82021,1,3,0
23495,3,3,82021,82021,82024,0,3,0
23496,5,1,82026,82026,82027,0,1,2
23497,4,3,82030,82030,82033,0,3,3
23498,6,2,82036,82036,82038,0,2,3
23499,5,3,82041,82041,82044,0,3,3
23500,1,3,82042,82044,82047,2,5,0
23501,6,2,82048,82048,82050,0,2,1
23502,2,2,82050,82050,82052,0,2,0
23503,5,2,82055,82055,82057,0,2,3
23504,4,1,82059,82059,82060,0,1,2
23505,4,3,82063,82063,82066,0,3,3
23506,3,3,82066,82066,82069,0,3,0
23507,5,1,82071,82071,82072,0,1,2
23508,6,1,82077,82077,82078,0,1,5
23509,1,2,82078,82078,82080,0,2,0
23510,2,3,82080,82080,82083,0,3,0
23511,6,2,82086,82086,82088,0,2,3
23512,2,1,82088,82088,82089,0,1,0
23513,3,2,82091,82091,82093,0,2,2
23514,4,3,82095,82095,82098,0,3,2
23515,1,3,82096,82098,82101,2,5,0
23516,4,1,82100,82101,82102,1,2,0
23517,1,2,82101,82102,82104,1,3,0
23518,3,3,82104,82104,82107,0,3,0
23519,4,2,82108,82108,82110,0,2,1
23520,2,2,82110,82110,82112,0,2,0
23521,3,3,82113,82113,82116,0,3,1
23522,5,1,82118,82118,82119,0,1,2
23523,3,3,82121,82121,82124,0,3,2
23524,1,3,82122,82124,82127,2,5,0
23525,2,1,82124,82127,82128,3,4,0
23526,2,1,82126,82128,82129,2,3,0
23527,5,3,82131,82131,82134,0,3,2
23528,3,2,82134,82134,82136,0,2,0
23529,1,1,82135,82136,82137,1,2,0
23530,1,3,82136,82137,82140,1,4,0
23531,2,1,82138,82140,82141,2,3,0
23532,1,2,82139,82141,82143,2,4,0
23533,2,3,82141,82143,82146,2,5,0
23534,1,2,82142,82146,82148,4,6,0
23535,3,2,82145,82148,82150,3,5,0
23536,6,1,82151,82151,82152,0,1,1
23537,2,2,82153,82153,82155,0,2,1
23538,4,2,82157,82157,82159,0,2,2
23539,2,3,82159,82159,82162,0,3,0
23540,6,1,82165,82165,82166,0,1,3
23541,6,3,82171,82171,82174,0,3,5
23542,3,1,82174,82174,82175,0,1,0
23543,5,3,82179,82179,82182,0,3,4
23544,2,3,82181,82182,82185,1,4,0
23545,4,1,82185,82185,82186,0,1,0
23546,3,1,82188,82188,82189,0,1,2
23547,5,2,82193,82193,82195,0,2,4
23548,2,2,82195,82195,82197,0,2,0
23549,5,1,82200,82200,82201,0,1,3
23550,4,1,82204,82204,82205,0,1,3
23551,5,1,82209,82209,82210,0,1,4
23552,6,2,82215,82215,82217,0,2,5
23553,5,2,82220,82220,82222,0,2,3
23554,2,3,82222,82222,82225,0,3,0
23555,6,2,82228,82228,82230,0,2,3
23556,6,2,82234,82234,82236,0,2,4
23557,4,3,82238,82238,82241,0,3,2
23558,3,2,82241,82241,82243,0,2,0
23559,2,1,82243,82243,82244,0,1,0
23560,4,1,82247,82247,82248,0,1,3
23561,6,2,82253,82253,82255,0,2,5
23562,5,1,82258,82258,82259,0,1,3
23563,2,3,82260,82260,82263,0,3,1
23564,2,3,82262,82263,82266,1,4,0
23565,4,3,82266,82266,82269,0,3,0
23566,4,3,82270,82270,82273,0,3,1
23567,1,3,82271,82273,82276,2,5,0
23568,1,2,82272,82276,82278,4,6,0
23569,4,2,82276,82278,82280,2,4,0
23570,6,3,82282,82282,82285,0,3,2
23571,5,1,82287,82287,82288,0,1,2
23572,5,1,82292,82292,82293,0,1,4
23573,2,3,82294,82294,82297,0,3,1
23574,4,2,82298,82298,82300,0,2,1
23575,4,3,82302,82302,82305,0,3,2
23576,1,2,82303,82305,82307,2,4,0
23577,6,1,82309,82309,82310,0,1,2
23578,3,2,82312,82312,82314,0,2,2
23579,5,2,82317,82317,82319,0,2,3
23580,6,3,82323,82323,82326,0,3,4
23581,5,1,82328,82328,82329,0,1,2
23582,5,1,82333,82333,82334,0,1,4
23583,2,1,82335,82335,82336,0,1,1
23584,6,1,82341,82341,82342,0,1,5
23585,3,2,82344,82344,82346,0,2,2
23586,4,3,82348,82348,82351,0,3,2
23587,3,1,82351,82351,82352,0,1,0
23588,1,3,82352,82352,82355,0,3,0
23589,2,1,82354,82355,82356,1,2,0
23590,4,2,82358,82358,82360,0,2,2
23591,5,2,82363,82363,82365,0,2,3
23592,6,2,82369,82369,82371,0,2,4
23593,2,1,82371,82371,82372,0,1,0
23594,2,1,82373,82373,82374,0,1,1
23595,2,1,82375,82375,82376,0,1,1
23596,1,3,82376,82376,82379,0,3,0
23597,4,1,82380,82380,82381,0,1,1
23598,4,2,82384,82384,82386,0,2,3
23599,2,3,82386,82386,82389,0,3,0
23600,5,2,82391,82391,82393,0,2,2
23601,1,1,82392,82393,82394,1,2,0
23602,1,1,82393,82394,82395,1,2,0
23603,5,2,82398,82398,82400,0,2,3
23604,2,2,82400,82400,82402,0,2,0
23605,6,1,82406,82406,82407,0,1,4
23606,2,1,82408,82408,82409,0,1,1
23607,3,3,82411,82411,82414,0,3,2
23608,4,3,82415,82415,82418,0,3,1
23609,2,3,82417,82418,82421,1,4,0
23610,5,3,82422,82422,82425,0,3,1
23611,3,1,82425,82425,82426,0,1,0
23612,3,2,82428,82428,82430,0,2,2
23613,6,3,82434,82434,82437,0,3,4
23614,1,3,82435,82437,82440,2,5,0
23615,1,2,82436,82440,82442,4,6,0
23616,5,1,82441,82442,82443,1,2,0
23617,1,1,82442,82443,82444,1,2,0
23618,3,1,82445,82445,82446,0,1,1
23619,1,3,82446,82446,82449,0,3,0
23620,5,3,82451,82451,82454,0,3,2
23621,6,3,82457,82457,82460,0,3,3
23622,2,2,82459,82460,82462,1,3,0
23623,4,3,82463,82463,82466,0,3,1
23624,3,3,82466,82466,82469,0,3,0
23625,1,1,82467,82469,82470,2,3,0
23626,1,2,82468,82470,82472,2,4,0
23627,5,2,82473,82473,82475,0,2,1
23628,1,1,82474,82475,82476,1,2,0
23629,4,3,82478,82478,82481,0,3,2
23630,1,3,82479,82481,82484,2,5,0
23631,1,1,82480,82484,82485,4,5,0
23632,3,2,82483,82485,82487,2,4,0
23633,3,3,82486,82487,82490,1,4,0
23634,3,1,82489,82490,82491,1,2,0
23635,4,2,82493,82493,82495,0,2,2
23636,4,3,82497,82497,82500,0,3,2
23637,3,1,82500,82500,82501,0,1,0
23638,2,3,82502,82502,82505,0,3,1
23639,5,3,82507,82507,82510,0,3,2
23640,6,2,82513,82513,82515,0,2,3
23641,4,2,82517,82517,82519,0,2,2
23642,5,2,82522,82522,82524,0,2,3
23643,5,3,82527,82527,82530,0,3,3
23644,1,1,82528,82530,82531,2,3,0
23645,6,3,82534,82534,82537,0,3,3
23646,3,3,82537,82537,82540,0,3,0
23647,1,1,82538,82540,82541,2,3,0
23648,1,3,82539,82541,82544,2,5,0
23649,3,3,82542,82544,82547,2,5,0
23650,6,3,82548,82548,82551,0,3,1
23651,6,3,82554,82554,82557,0,3,3
23652,5,3,82559,82559,82562,0,3,2
23653,4,3,82563,82563,82566,0,3,1
23654,4,1,82567,82567,82568,0,1,1
23655,2,2,82569,82569,82571,0,2,1
23656,2,2,82571,82571,82573,0,2,0
23657,5,1,82576,82576,82577,0,1,3
23658,2,1,82578,82578,82579,0,1,1
23659,2,1,82580,82580,82581,0,1,1
23660,5,3,82585,82585,82588,0,3,4
23661,1,3,82586,82588,82591,2,5,0
23662,6,1,82592,82592,82593,0,1,1
23663,6,3,82598,82598,82601,0,3,5
23664,2,2,82600,82601,82603,1,3,0
23665,4,3,82604,82604,82607,0,3,1
23666,1,2,82605,82607,82609,2,4,0
23667,6,1,82611,82611,82612,0,1,2
23668,4,1,82615,82615,82616,0,1,3
23669,3,3,82618,82618,82621,0,3,2
23670,6,2,82624,82624,82626,0,2,3
23671,4,2,82628,82628,82630,0,2,2
23672,1,2,82629,82630,82632,1,3,0
23673,5,2,82634,82634,82636,0,2,2
23674,4,2,82638,82638,82640,0,2,2
23675,1,3,82639,82640,82643,1,4,0
23676,6,2,82645,82645,82647,0,2,2
23677,6,2,82651,82651,82653,0,2,4
23678,1,2,82652,82653,82655,1,3,0
23679,6,1,82658,82658,82659,0,1,3
23680,5,1,82663,82663,82664,0,1,4
23681,2,1,82665,82665,82666,0,1,1
23682,2,3,82667,82667,82670,0,3,1
23683,1,1,82668,82670,82671,2,3,0
23684,4,3,82672,82672,82675,0,3,1
23685,3,1,82675,82675,82676,0,1,0
23686,6,3,82681,82681,82684,0,3,5
23687,4,3,82685,82685,82688,0,3,1
23688,1,1,82686,82688,82689,2,3,0
23689,2,3,82688,82689,82692,1,4,0
23690,5,1,82693,82693,82694,0,1,1
23691,4,2,82697,82697,82699,0,2,3
23692,5,1,82702,82702,82703,0,1,3
23693,1,3,82703,82703,82706,0,3,0
23694,6,1,82709,82709,82710,0,1,3
23695,1,1,82710,82710,82711,0,1,0
23696,6,2,82716,82716,82718,0,2,5
23697,4,1,82720,82720,82721,0,1,2
23698,3,2,82723,82723,82725,0,2,2
23699,5,3,82728,82728,82731,0,3,3
23700,2,2,82730,82731,82733,1,3,0
23701,1,3,82731,82733,82736,2,5,0
23702,1,1,82732,82736,82737,4,5,0
23703,6,1,82738,82738,82739,0,1,1
23704,5,2,82743,82743,82745,0,2,4
23705,2,1,82745,82745,82746,0,1,0
23706,2,1,82747,82747,82748,0,1,1
23707,3,2,82750,82750,82752,0,2,2
23708,4,2,82754,82754,82756,0,2,2
23709,1,2,82755,82756,82758,1,3,0
23710,3,1,82758,82758,82759,0,1,0
23711,5,2,82763,82763,82765,0,2,4
23712,5,1,82768,82768,82769,0,1,3
23713,6,2,82774,82774,82776,0,2,5
23714,6,1,82780,82780,82781,0,1,4
23715,1,1,82781,82781,82782,0,1,0
23716,5,2,82786,82786,82788,0,2,4
23717,2,1,82788,82788,82789,0,1,0
23718,6,2,82794,82794,82796,0,2,5
23719,4,2,82798,82798,82800,0,2,2
23720,2,3,82800,82800,82803,0,3,0
23721,5,3,82805,82805,82808,0,3,2
23722,2,2,82807,82808,82810,1,3,0
23723,6,3,82813,82813,82816,0,3,3
23724,4,3,82817,82817,82820,0,3,1
23725,6,2,82823,82823,82825,0,2,3
23726,4,1,82827,82827,82828,0,1,2
23727,1,1,82828,82828,82829,0,1,0
23728,6,1,82834,82834,82835,0,1,5
23729,4,3,82838,82838,82841,0,3,3
23730,5,1,82843,82843,82844,0,1,2
23731,2,3,82845,82845,82848,0,3,1
23732,1,1,82846,82848,82849,2,3,0
23733,6,1,82852,82852,82853,0,1,3
23734,6,1,82858,82858,82859,0,1,5
23735,1,2,82859,82859,82861,0,2,0
23736,1,3,82860,82861,82864,1,4,0
23737,3,2,82863,82864,82866,1,3,0
23738,2,3,82865,82866,82869,1,4,0
23739,3,2,82868,82869,82871,1,3,0
23740,5,2,82873,82873,82875,0,2,2
23741,3,2,82876,82876,82878,0,2,1
23742,6,1,82882,82882,82883,0,1,4
23743,6,3,82888,82888,82891,0,3,5
23744,2,3,82890,82891,82894,1,4,0
23745,4,1,82894,82894,82895,0,1,0
23746,5,1,82899,82899,82900,0,1,4
23747,5,1,82904,82904,82905,0,1,4
23748,3,2,82907,82907,82909,0,2,2
23749,4,3,82911,82911,82914,0,3,2
23750,6,3,82917,82917,82920,0,3,3
23751,4,1,82921,82921,82922,0,1,1
23752,1,2,82922,82922,82924,0,2,0
23753,4,2,82926,82926,82928,0,2,2
23754,6,3,82932,82932,82935,0,3,4
23755,1,2,82933,82935,82937,2,4,0
23756,6,3,82939,82939,82942,0,3,2
23757,1,2,82940,82942,82944,2,4,0
23758,3,3,82943,82944,82947,1,4,0
23759,4,3,82947,82947,82950,0,3,0
23760,4,2,82951,82951,82953,0,2,1
23761,1,1,82952,82953,82954,1,2,0
23762,4,2,82956,82956,82958,0,2,2
23763,1,2,82957,82958,82960,1,3,0
23764,4,1,82961,82961,82962,0,1,1
23765,3,3,82964,82964,82967,0,3,2
23766,2,1,82966,82967,82968,1,2,0
23767,2,2,82968,82968,82970,0,2,0
23768,4,2,82972,82972,82974,0,2,2
23769,4,2,82976,82976,82978,0,2,2
23770,2,2,82978,82978,82980,0,2,0
23771,3,3,82981,82981,82984,0,3,1
23772,5,3,82986,82986,82989,0,3,2
23773,1,3,82987,82989,82992,2,5,0
23774,3,1,82990,82992,82993,2,3,0
23775,1,2,82991,82993,82995,2,4,0
23776,4,3,82995,82995,82998,0,3,0
23777,4,3,82999,82999,83002,0,3,1
23778,3,1,83002,83002,83003,0,1,0
23779,4,1,83006,83006,83007,0,1,3
23780,3,1,83009,83009,83010,0,1,2
23781,1,1,83010,83010,83011,0,1,0
23782,1,3,83011,83011,83014,0,3,0
23783,3,3,83014,83014,83017,0,3,0
23784,4,2,83018,83018,83020,0,2,1
23785,2,2,83020,83020,83022,0,2,0
23786,6,3,83026,83026,83029,0,3,4
23787,3,1,83029,83029,83030,0,1,0
23788,4,1,83033,83033,83034,0,1,3
23789,3,2,83036,83036,83038,0,2,2
23790,5,2,83041,83041,83043,0,2,3
23791,5,2,83046,83046,83048,0,2,3
23792,1,1,83047,83048,83049,1,2,0
23793,1,1,83048,83049,83050,1,2,0
23794,6,3,83054,83054,83057,0,3,4
23795,6,3,83060,83060,83063,0,3,3
23796,2,1,83062,83063,83064,1,2,0
23797,1,1,83063,83064,83065,1,2,0
23798,1,2,83064,83065,83067,1,3,0
23799,2,1,83066,83067,83068,1,2,0
23800,5,3,83071,83071,83074,0,3,3
23801,2,1,83073,83074,83075,1,2,0
23802,5,3,83078,83078,83081,0,3,3
23803,6,1,83084,83084,83085,0,1,3
23804,2,1,83086,83086,83087,0,1,1
23805,3,2,83089,83089,83091,0,2,2
23806,1,2,83090,83091,83093,1,3,0
23807,5,1,83095,83095,83096,0,1,2
23808,4,1,83099,83099,83100,0,1,3
23809,3,3,83102,83102,83105,0,3,2
23810,4,2,83106,83106,83108,0,2,1
23811,4,2,83110,83110,83112,0,2,2
23812,6,2,83116,83116,83118,0,2,4
23813,1,3,83117,83118,83121,1,4,0
23814,5,3,83122,83122,83125,0,3,1
23815,1,3,83123,83125,83128,2,5,0
23816,4,1,83127,83128,83129,1,2,0
23817,4,2,83131,83131,83133,0,2,2
23818,4,3,83135,83135,83138,0,3,2
23819,2,1,83137,83138,83139,1,2,0
23820,2,2,83139,83139,83141,0,2,0
23821,4,2,83143,83143,83145,0,2,2
23822,1,3,83144,83145,83148,1,4,0
23823,3,2,83147,83148,83150,1,3,0
23824,1,2,83148,83150,83152,2,4,0
23825,1,1,83149,83152,83153,3,4,0
23826,2,1,83151,83153,83154,2,3,0
23827,4,3,83155,83155,83158,0,3,1
23828,6,2,83161,83161,83163,0,2,3
23829,2,1,83163,83163,83164,0,1,0
23830,1,3,83164,83164,83167,0,3,0
23831,6,2,83170,83170,83172,0,2,3
23832,1,2,83171,83172,83174,1,3,0
23833,6,1,83177,83177,83178,0,1,3
23834,2,2,83179,83179,83181,0,2,1
23835,6,3,83185,83185,83188,0,3,4
23836,2,3,83187,83188,83191,1,4,0
23837,6,3,83193,83193,83196,0,3,2
23838,3,2,83196,83196,83198,0,2,0
23839,2,3,83198,83198,83201,0,3,0
23840,6,3,83204,83204,83207,0,3,3
23841,2,2,83206,83207,83209,1,3,0
23842,2,2,83208,83209,83211,1,3,0
23843,5,3,83213,83213,83216,0,3,2
23844,1,2,83214,83216,83218,2,4,0
23845,2,2,83216,83218,83220,2,4,0
23846,6,2,83222,83222,83224,0,2,2
23847,4,2,83226,83226,83228,0,2,2
23848,1,3,83227,83228,83231,1,4,0
23849,1,3,83228,83231,83234,3,6,0
23850,3,1,83231,83234,83235,3,4,0
23851,6,3,83237,83237,83240,0,3,2
23852,1,2,83238,83240,83242,2,4,0
23853,5,3,83243,83243,83246,0,3,1
23854,2,3,83245,83246,83249,1,4,0
23855,1,3,83246,83249,83252,3,6,0
23856,6,1,83252,83252,83253,0,1,0
23857,3,2,83255,83255,83257,0,2,2
23858,6,1,83261,83261,83262,0,1,4
23859,5,2,83266,83266,83268,0,2,4
23860,4,2,83270,83270,83272,0,2,2
23861,2,1,83272,83272,83273,0,1,0
23862,2,1,83274,83274,83275,0,1,1
23863,2,3,83276,83276,83279,0,3,1
23864,6,1,83282,83282,83283,0,1,3
23865,6,2,83288,83288,83290,0,2,5
23866,5,2,83293,83293,83295,0,2,3
23867,4,2,83297,83297,83299,0,2,2
23868,2,3,83299,83299,83302,0,3,0
23869,1,2,83300,83302,83304,2,4,0
23870,5,3,83305,83305,83308,0,3,1
23871,4,3,83309,83309,83312,0,3,1
23872,5,1,83314,83314,83315,0,1,2
23873,1,2,83315,83315,83317,0,2,0
23874,2,2,83317,83317,83319,0,2,0
23875,5,3,83322,83322,83325,0,3,3
23876,1,1,83323,83325,83326,2,3,0
23877,4,2,83327,83327,83329,0,2,1
23878,4,1,83331,83331,83332,0,1,2
23879,3,2,83334,83334,83336,0,2,2
23880,1,2,83335,83336,83338,1,3,0
23881,5,3,83340,83340,83343,0,3,2
23882,2,2,83342,83343,83345,1,3,0
23883,5,2,83347,83347,83349,0,2,2
23884,2,2,83349,83349,83351,0,2,0
23885,4,2,83353,83353,83355,0,2,2
23886,6,1,83359,83359,83360,0,1,4
23887,2,3,83361,83361,83364,0,3,1
23888,2,2,83363,83364,83366,1,3,0
23889,5,2,83368,83368,83370,0,2,2
23890,5,1,83373,83373,83374,0,1,3
23891,5,1,83378,83378,83379,0,1,4
23892,1,2,83379,83379,83381,0,2,0
23893,4,3,83383,83383,83386,0,3,2
23894,6,2,83389,83389,83391,0,2,3
23895,6,1,83395,83395,83396,0,1,4
23896,1,1,83396,83396,83397,0,1,0
23897,5,3,83401,83401,83404,0,3,4
23898,6,2,83407,83407,83409,0,2,3
23899,2,3,83409,83409,83412,0,3,0
23900,2,1,83411,83412,83413,1,2,0
23901,5,1,83416,83416,83417,0,1,3
23902,6,1,83422,83422,83423,0,1,5
23903,1,1,83423,83423,83424,0,1,0
23904,2,3,83425,83425,83428,0,3,1
23905,1,1,83426,83428,83429,2,3,0
23906,3,3,83429,83429,83432,0,3,0
23907,6,1,83435,83435,83436,0,1,3
23908,5,1,83440,83440,83441,0,1,4
23909,3,2,83443,83443,83445,0,2,2
23910,5,3,83448,83448,83451,0,3,3
23911,5,2,83453,83453,83455,0,2,2
23912,6,1,83459,83459,83460,0,1,4
23913,1,1,83460,83460,83461,0,1,0
23914,6,3,83466,83466,83469,0,3,5
23915,4,1,83470,83470,83471,0,1,1
23916,1,1,83471,83471,83472,0,1,0
23917,2,1,83473,83473,83474,0,1,1
23918,6,3,83479,83479,83482,0,3,5
23919,1,1,83480,83482,83483,2,3,0
23920,5,2,83485,83485,83487,0,2,2
23921,1,1,83486,83487,83488,1,2,0
23922,5,1,83491,83491,83492,0,1,3
23923,6,1,83497,83497,83498,0,1,5
23924,5,1,83502,83502,83503,0,1,4
23925,5,1,83507,83507,83508,0,1,4
23926,6,3,83513,83513,83516,0,3,5
23927,5,3,83518,83518,83521,0,3,2
23928,3,1,83521,83521,83522,0,1,0
23929,5,2,83526,83526,83528,0,2,4
23930,1,3,83527,83528,83531,1,4,0
23931,3,2,83530,83531,83533,1,3,0
23932,4,1,83534,83534,83535,0,1,1
23933,3,1,83537,83537,83538,0,1,2
23934,2,1,83539,83539,83540,0,1,1
23935,5,1,83544,83544,83545,0,1,4
23936,3,2,83547,83547,83549,0,2,2
23937,3,3,83550,83550,83553,0,3,1
23938,1,3,83551,83553,83556,2,5,0
23939,3,2,83554,83556,83558,2,4,0
23940,2,3,83556,83558,83561,2,5,0
23941,4,2,83560,83561,83563,1,3,0
23942,1,2,83561,83563,83565,2,4,0
23943,5,2,83566,83566,83568,0,2,1
23944,5,3,83571,83571,83574,0,3,3
23945,3,2,83574,83574,83576,0,2,0
23946,2,2,83576,83576,83578,0,2,0
23947,3,3,83579,83579,83582,0,3,1
23948,1,2,83580,83582,83584,2,4,0
23949,1,2,83581,83584,83586,3,5,0
23950,5,1,83586,83586,83587,0,1,0
23951,2,1,83588,83588,83589,0,1,1
23952,3,1,83591,83591,83592,0,1,2
23953,6,2,83597,83597,83599,0,2,5
23954,4,2,83601,83601,83603,0,2,2
23955,6,2,83607,83607,83609,0,2,4
23956,4,2,83611,83611,83613,0,2,2
23957,3,2,83614,83614,83616,0,2,1
23958,2,1,83616,83616,83617,0,1,0
23959,1,1,83617,83617,83618,0,1,0
23960,6,3,83623,83623,83626,0,3,5
23961,1,1,83624,83626,83627,2,3,0
23962,2,1,83626,83627,83628,1,2,0
23963,5,3,83631,83631,83634,0,3,3
23964,1,3,83632,83634,83637,2,5,0
23965,6,2,83638,83638,83640,0,2,1
23966,6,3,83644,83644,83647,0,3,4
23967,6,2,83650,83650,83652,0,2,3
23968,4,2,83654,83654,83656,0,2,2
23969,1,3,83655,83656,83659,1,4,0
23970,1,1,83656,83659,83660,3,4,0
23971,6,2,83662,83662,83664,0,2,2
23972,6,1,83668,83668,83669,0,1,4
23973,5,2,83673,83673,83675,0,2,4
23974,4,3,83677,83677,83680,0,3,2
23975,6,2,83683,83683,83685,0,2,3
23976,1,2,83684,83685,83687,1,3,0
23977,6,1,83690,83690,83691,0,1,3
23978,6,2,83696,83696,83698,0,2,5
23979,5,2,83701,83701,83703,0,2,3
23980,3,3,83704,83704,83707,0,3,1
23981,3,1,83707,83707,83708,0,1,0
23982,5,2,83712,83712,83714,0,2,4
23983,5,3,83717,83717,83720,0,3,3
23984,5,2,83722,83722,83724,0,2,2
23985,2,1,83724,83724,83725,0,1,0
23986,6,3,83730,83730,83733,0,3,5
23987,6,1,83736,83736,83737,0,1,3
23988,4,3,83740,83740,83743,0,3,3
23989,3,3,83743,83743,83746,0,3,0
23990,6,1,83749,83749,83750,0,1,3
23991,4,2,83753,83753,83755,0,2,3
23992,4,2,83757,83757,83759,0,2,2
23993,6,1,83763,83763,83764,0,1,4
23994,5,3,83768,83768,83771,0,3,4
23995,4,2,83772,83772,83774,0,2,1
23996,1,2,83773,83774,83776,1,3,0
23997,6,2,83779,83779,83781,0,2,3
23998,4,3,83783,83783,83786,0,3,2
23999,2,3,83785,83786,83789,1,4,0
24000,2,3,83787,83789,83792,2,5,0
24001,5,1,83792,83792,83793,0,1,0
24002,2,1,83794,83794,83795,0,1,1
24003,2,1,83796,83796,83797,0,1,1
24004,4,3,83800,83800,83803,0,3,3
24005,6,1,83806,83806,83807,0,1,3
24006,1,3,83807,83807,83810,0,3,0
24007,5,3,83812,83812,83815,0,3,2
24008,4,3,83816,83816,83819,0,3,1
24009,2,1,83818,83819,83820,1,2,0
24010,2,1,83820,83820,83821,0,1,0
24011,1,2,83821,83821,83823,0,2,0
24012,6,2,83827,83827,83829,0,2,4
24013,6,2,83833,83833,83835,0,2,4
24014,5,3,83838,83838,83841,0,3,3
24015,4,1,83842,83842,83843,0,1,1
24016,6,1,83848,83848,83849,0,1,5
24017,4,2,83852,83852,83854,0,2,3
24018,5,3,83857,83857,83860,0,3,3
24019,1,2,83858,83860,83862,2,4,0
24020,6,3,83864,83864,83867,0,3,2
24021,4,2,83868,83868,83870,0,2,1
24022,6,2,83874,83874,83876,0,2,4
24023,6,2,83880,83880,83882,0,2,4
24024,6,3,83886,83886,83889,0,3,4
24025,6,3,83892,83892,83895,0,3,3
24026,3,2,83895,83895,83897,0,2,0
24027,4,3,83899,83899,83902,0,3,2
24028,6,2,83905,83905,83907,0,2,3
24029,4,3,83909,83909,83912,0,3,2
24030,3,3,83912,83912,83915,0,3,0
24031,1,2,83913,83915,83917,2,4,0
24032,4,3,83917,83917,83920,0,3,0
24033,4,3,83921,83921,83924,0,3,1
24034,4,3,83925,83925,83928,0,3,1
24035,4,3,83929,83929,83932,0,3,1
24036,1,3,83930,83932,83935,2,5,0
24037,3,3,83933,83935,83938,2,5,0
24038,6,3,83939,83939,83942,0,3,1
24039,3,3,83942,83942,83945,0,3,0
24040,4,1,83946,83946,83947,0,1,1
24041,4,2,83950,83950,83952,0,2,3
24042,6,2,83956,83956,83958,0,2,4
24043,3,2,83959,83959,83961,0,2,1
24044,5,2,83964,83964,83966,0,2,3
24045,5,1,83969,83969,83970,0,1,3
24046,5,3,83974,83974,83977,0,3,4
24047,4,1,83978,83978,83979,0,1,1
24048,1,2,83979,83979,83981,0,2,0
24049,5,3,83984,83984,83987,0,3,3
24050,1,1,83985,83987,83988,2,3,0
24051,4,3,83989,83989,83992,0,3,1
24052,1,1,83990,83992,83993,2,3,0
24053,1,3,83991,83993,83996,2,5,0
24054,2,2,83993,83996,83998,3,5,0
24055,5,3,83998,83998,84001,0,3,0
24056,1,2,83999,84001,84003,2,4,0
24057,1,1,84000,84003,84004,3,4,0
24058,6,2,84006,84006,84008,0,2,2
24059,3,3,84009,84009,84012,0,3,1
24060,1,3,84010,84012,84015,2,5,0
24061,6,1,84016,84016,84017,0,1,1
24062,2,3,84018,84018,84021,0,3,1
24063,2,1,84020,84021,84022,1,2,0
24064,3,1,84023,84023,84024,0,1,1
24065,1,1,84024,84024,84025,0,1,0
24066,6,2,84030,84030,84032,0,2,5
24067,6,3,84036,84036,84039,0,3,4
24068,2,1,84038,84039,84040,1,2,0
24069,6,2,84044,84044,84046,0,2,4
24070,2,2,84046,84046,84048,0,2,0
24071,2,1,84048,84048,84049,0,1,0
24072,4,1,84052,84052,84053,0,1,3
24073,5,3,84057,84057,84060,0,3,4
24074,1,3,84058,84060,84063,2,5,0
24075,1,3,84059,84063,84066,4,7,0
24076,4,2,84063,84066,84068,3,5,0
24077,4,3,84067,84068,84071,1,4,0
24078,2,1,84069,84071,84072,2,3,0
24079,3,3,84072,84072,84075,0,3,0
24080,2,1,84074,84075,84076,1,2,0
24081,3,2,84077,84077,84079,0,2,1
24082,6,3,84083,84083,84086,0,3,4
24083,5,1,84088,84088,84089,0,1,2
24084,4,3,84092,84092,84095,0,3,3
24085,2,1,84094,84095,84096,1,2,0
24086,6,1,84100,84100,84101,0,1,4
24087,2,3,84102,84102,84105,0,3,1
24088,3,2,84105,84105,84107,0,2,0
24089,4,1,84109,84109,84110,0,1,2
24090,2,3,84111,84111,84114,0,3,1
24091,5,2,84116,84116,84118,0,2,2
24092,1,1,84117,84118,84119,1,2,0
24093,2,3,84119,84119,84122,0,3,0
24094,1,1,84120,84122,84123,2,3,0
24095,2,1,84122,84123,84124,1,2,0
24096,6,3,84128,84128,84131,0,3,4
24097,5,1,84133,84133,84134,0,1,2
24098,5,1,84138,84138,84139,0,1,4
24099,5,3,84143,84143,84146,0,3,4
24100,2,1,84145,84146,84147,1,2,0
24101,5,3,84150,84150,84153,0,3,3
24102,3,1,84153,84153,84154,0,1,0
24103,5,1,84158,84158,84159,0,1,4
24104,5,1,84163,84163,84164,0,1,4
24105,6,2,84169,84169,84171,0,2,5
24106,1,3,84170,84171,84174,1,4,0
24107,3,1,84173,84174,84175,1,2,0
24108,6,3,84179,84179,84182,0,3,4
24109,6,2,84185,84185,84187,0,2,3
24110,5,1,84190,84190,84191,0,1,3
24111,6,1,84196,84196,84197,0,1,5
24112,3,1,84199,84199,84200,0,1,2
24113,2,3,84201,84201,84204,0,3,1
24114,5,1,84206,84206,84207,0,1,2
24115,3,1,84209,84209,84210,0,1,2
24116,1,2,84210,84210,84212,0,2,0
24117,4,2,84214,84214,84216,0,2,2
24118,2,3,84216,84216,84219,0,3,0
24119,6,2,84222,84222,84224,0,2,3
24120,2,2,84224,84224,84226,0,2,0
24121,5,2,84229,84229,84231,0,2,3
24122,4,1,84233,84233,84234,0,1,2
24123,3,1,84236,84236,84237,0,1,2
24124,3,2,84239,84239,84241,0,2,2
24125,5,3,84244,84244,84247,0,3,3
24126,6,2,84250,84250,84252,0,2,3
24127,5,2,84255,84255,84257,0,2,3
24128,4,2,84259,84259,84261,0,2,2
24129,6,2,84265,84265,84267,0,2,4
24130,2,2,84267,84267,84269,0,2,0
24131,6,2,84273,84273,84275,0,2,4
24132,2,2,84275,84275,84277,0,2,0
24133,5,2,84280,84280,84282,0,2,3
24134,6,2,84286,84286,84288,0,2,4
24135,4,1,84290,84290,84291,0,1,2
24136,6,2,84296,84296,84298,0,2,5
24137,2,2,84298,84298,84300,0,2,0
24138,2,2,84300,84300,84302,0,2,0
24139,5,1,84305,84305,84306,0,1,3
24140,6,2,84311,84311,84313,0,2,5
24141,3,2,84314,84314,84316,0,2,1
24142,1,3,84315,84316,84319,1,4,0
24143,6,3,84321,84321,84324,0,3,2
24144,2,1,84323,84324,84325,1,2,0
24145,1,2,84324,84325,84327,1,3,0
24146,1,1,84325,84327,84328,2,3,0
24147,3,2,84328,84328,84330,0,2,0
24148,5,3,84333,84333,84336,0,3,3
24149,2,1,84335,84336,84337,1,2,0
24150,1,1,84336,84337,84338,1,2,0
24151,3,1,84339,84339,84340,0,1,1
24152,3,3,84342,84342,84345,0,3,2
24153,4,2,84346,84346,84348,0,2,1
24154,2,3,84348,84348,84351,0,3,0
24155,6,1,84354,84354,84355,0,1,3
24156,1,1,84355,84355,84356,0,1,0
24157,1,3,84356,84356,84359,0,3,0
24158,1,2,84357,84359,84361,2,4,0
24159,6,2,84363,84363,84365,0,2,2
24160,2,1,84365,84365,84366,0,1,0
24161,2,2,84367,84367,84369,0,2,1
24162,2,2,84369,84369,84371,0,2,0
24163,6,3,84375,84375,84378,0,3,4
24164,3,3,84378,84378,84381,0,3,0
24165,5,3,84383,84383,84386,0,3,2
24166,6,3,84389,84389,84392,0,3,3
24167,2,1,84391,84392,84393,1,2,0
24168,1,2,84392,84393,84395,1,3,0
24169,5,3,84397,84397,84400,0,3,2
24170,6,2,84403,84403,84405,0,2,3
24171,6,2,84409,84409,84411,0,2,4
24172,1,2,84410,84411,84413,1,3,0
24173,6,3,84416,84416,84419,0,3,3
24174,2,3,84418,84419,84422,1,4,0
24175,1,1,84419,84422,84423,3,4,0
24176,4,1,84423,84423,84424,0,1,0
24177,3,2,84426,84426,84428,0,2,2
24178,3,3,84429,84429,84432,0,3,1
24179,1,2,84430,84432,84434,2,4,0
24180,5,2,84435,84435,84437,0,2,1
24181,2,3,84437,84437,84440,0,3,0
24182,6,1,84443,84443,84444,0,1,3
24183,3,1,84446,84446,84447,0,1,2
24184,2,2,84448,84448,84450,0,2,1
24185,1,2,84449,84450,84452,1,3,0
24186,2,1,84451,84452,84453,1,2,0
24187,2,3,84453,84453,84456,0,3,0
24188,4,1,84457,84457,84458,0,1,1
24189,4,1,84461,84461,84462,0,1,3
24190,1,1,84462,84462,84463,0,1,0
24191,4,2,84466,84466,84468,0,2,3
24192,1,1,84467,84468,84469,1,2,0
24193,2,1,84469,84469,84470,0,1,0
24194,2,2,84471,84471,84473,0,2,1
24195,5,1,84476,84476,84477,0,1,3
24196,5,2,84481,84481,84483,0,2,4
24197,6,1,84487,84487,84488,0,1,4
24198,5,2,84492,84492,84494,0,2,4
24199,2,3,84494,84494,84497,0,3,0
24200,1,3,84495,84497,84500,2,5,0
24201,4,3,84499,84500,84503,1,4,0
24202,5,3,84504,84504,84507,0,3,1
24203,5,1,84509,84509,84510,0,1,2
24204,5,3,84514,84514,84517,0,3,4
24205,1,1,84515,84517,84518,2,3,0
24206,4,1,84519,84519,84520,0,1,1
24207,3,1,84522,84522,84523,0,1,2
24208,6,3,84528,84528,84531,0,3,5
24209,4,3,84532,84532,84535,0,3,1
24210,1,1,84533,84535,84536,2,3,0
24211,1,1,84534,84536,84537,2,3,0
24212,1,1,84535,84537,84538,2,3,0
24213,4,1,84539,84539,84540,0,1,1
24214,1,2,84540,84540,84542,0,2,0
24215,5,1,84545,84545,84546,0,1,3
24216,1,2,84546,84546,84548,0,2,0
24217,4,2,84550,84550,84552,0,2,2
24218,6,2,84556,84556,84558,0,2,4
24219,6,3,84562,84562,84565,0,3,4
24220,4,1,84566,84566,84567,0,1,1
24221,3,1,84569,84569,84570,0,1,2
24222,5,2,84574,84574,84576,0,2,4
24223,6,1,84580,84580,84581,0,1,4
24224,2,3,84582,84582,84585,0,3,1
24225,6,3,84588,84588,84591,0,3,3
24226,4,3,84592,84592,84595,0,3,1
24227,6,2,84598,84598,84600,0,2,3
24228,2,2,84600,84600,84602,0,2,0
24229,4,1,84604,84604,84605,0,1,2
24230,5,2,84609,84609,84611,0,2,4
24231,4,3,84613,84613,84616,0,3,2
24232,5,3,84618,84618,84621,0,3,2
24233,3,1,84621,84621,84622,0,1,0
24234,3,3,84624,84624,84627,0,3,2
24235,4,3,84628,84628,84631,0,3,1
24236,3,1,84631,84631,84632,0,1,0
24237,2,2,84633,84633,84635,0,2,1
24238,5,1,84638,84638,84639,0,1,3
24239,6,3,84644,84644,84647,0,3,5
24240,5,2,84649,84649,84651,0,2,2
24241,6,1,84655,84655,84656,0,1,4
24242,5,2,84660,84660,84662,0,2,4
24243,4,2,84664,84664,84666,0,2,2
24244,6,3,84670,84670,84673,0,3,4
24245,6,1,84676,84676,84677,0,1,3
24246,3,3,84679,84679,84682,0,3,2
24247,5,2,84684,84684,84686,0,2,2
24248,1,3,84685,84686,84689,1,4,0
24249,5,3,84690,84690,84693,0,3,1
24250,1,2,84691,84693,84695,2,4,0
24251,1,3,84692,84695,84698,3,6,0
24252,5,2,84697,84698,84700,1,3,0
24253,4,3,84701,84701,84704,0,3,1
24254,6,3,84707,84707,84710,0,3,3
24255,1,1,84708,84710,84711,2,3,0
24256,1,1,84709,84711,84712,2,3,0
24257,4,1,84713,84713,84714,0,1,1
24258,2,2,84715,84715,84717,0,2,1
24259,3,2,84718,84718,84720,0,2,1
24260,2,1,84720,84720,84721,0,1,0
24261,1,2,84721,84721,84723,0,2,0
24262,6,1,84727,84727,84728,0,1,4
24263,3,1,84730,84730,84731,0,1,2
24264,4,2,84734,84734,84736,0,2,3
24265,6,2,84740,84740,84742,0,2,4
24266,3,3,84743,84743,84746,0,3,1
24267,2,2,84745,84746,84748,1,3,0
24268,4,3,84749,84749,84752,0,3,1
24269,1,2,84750,84752,84754,2,4,0
24270,2,3,84752,84754,84757,2,5,0
24271,4,3,84756,84757,84760,1,4,0
24272,5,1,84761,84761,84762,0,1,1
24273,2,1,84763,84763,84764,0,1,1
24274,6,3,84769,84769,84772,0,3,5
24275,4,2,84773,84773,84775,0,2,1
24276,2,1,84775,84775,84776,0,1,0
24277,4,2,84779,84779,84781,0,2,3
24278,5,1,84784,84784,84785,0,1,3
24279,6,1,84790,84790,84791,0,1,5
24280,2,1,84792,84792,84793,0,1,1
24281,6,3,84798,84798,84801,0,3,5
24282,1,2,84799,84801,84803,2,4,0
24283,4,3,84803,84803,84806,0,3,0
24284,2,1,84805,84806,84807,1,2,0
24285,6,3,84811,84811,84814,0,3,4
24286,2,1,84813,84814,84815,1,2,0
24287,4,3,84817,84817,84820,0,3,2
24288,6,2,84823,84823,84825,0,2,3
24289,6,1,84829,84829,84830,0,1,4
24290,4,1,84833,84833,84834,0,1,3
24291,5,3,84838,84838,84841,0,3,4
24292,5,2,84843,84843,84845,0,2,2
24293,2,2,84845,84845,84847,0,2,0
24294,4,1,84849,84849,84850,0,1,2
24295,1,3,84850,84850,84853,0,3,0
24296,1,2,84851,84853,84855,2,4,0
24297,3,3,84854,84855,84858,1,4,0
24298,1,1,84855,84858,84859,3,4,0
24299,4,3,84859,84859,84862,0,3,0
24300,3,3,84862,84862,84865,0,3,0
24301,5,2,84867,84867,84869,0,2,2
24302,2,1,84869,84869,84870,0,1,0
24303,3,1,84872,84872,84873,0,1,2
24304,3,3,84875,84875,84878,0,3,2
24305,3,3,84878,84878,84881,0,3,0
24306,6,2,84884,84884,84886,0,2,3
24307,5,3,84889,84889,84892,0,3,3
24308,5,1,84894,84894,84895,0,1,2
24309,6,3,84900,84900,84903,0,3,5
24310,4,1,84904,84904,84905,0,1,1
24311,3,3,84907,84907,84910,0,3,2
24312,6,1,84913,84913,84914,0,1,3
24313,1,2,84914,84914,84916,0,2,0
24314,2,2,84916,84916,84918,0,2,0
24315,1,1,84917,84918,84919,1,2,0
24316,5,1,84922,84922,84923,0,1,3
24317,3,1,84925,84925,84926,0,1,2
24318,1,1,84926,84926,84927,0,1,0
24319,1,3,84927,84927,84930,0,3,0
24320,3,1,84930,84930,84931,0,1,0
24321,5,2,84935,84935,84937,0,2,4
24322,1,1,84936,84937,84938,1,2,0
24323,1,2,84937,84938,84940,1,3,0
24324,4,1,84941,84941,84942,0,1,1
24325,6,3,84947,84947,84950,0,3,5
24326,4,2,84951,84951,84953,0,2,1
24327,4,1,84955,84955,84956,0,1,2
24328,6,2,84961,84961,84963,0,2,5
24329,1,3,84962,84963,84966,1,4,0
24330,3,2,84965,84966,84968,1,3,0
24331,5,1,84970,84970,84971,0,1,2
24332,3,2,84973,84973,84975,0,2,2
24333,1,3,84974,84975,84978,1,4,0
24334,2,3,84976,84978,84981,2,5,0
24335,6,2,84982,84982,84984,0,2,1
24336,3,2,84985,84985,84987,0,2,1
24337,5,2,84990,84990,84992,0,2,3
24338,6,3,84996,84996,84999,0,3,4
24339,6,1,85002,85002,85003,0,1,3
24340,4,2,85006,85006,85008,0,2,3
24341,3,2,85009,85009,85011,0,2,1
24342,3,1,85012,85012,85013,0,1,1
24343,1,3,85013,85013,85016,0,3,0
24344,5,3,85018,85018,85021,0,3,2
24345,6,3,85024,85024,85027,0,3,3
24346,1,1,85025,85027,85028,2,3,0
24347,4,2,85029,85029,85031,0,2,1
24348,1,1,85030,85031,85032,1,2,0
24349,2,2,85032,85032,85034,0,2,0
24350,6,2,85038,85038,85040,0,2,4
24351,5,2,85043,85043,85045,0,2,3
24352,4,2,85047,85047,85049,0,2,2
24353,1,2,85048,85049,85051,1,3,0
24354,6,2,85054,85054,85056,0,2,3
24355,2,3,85056,85056,85059,0,3,0
24356,1,2,85057,85059,85061,2,4,0
24357,1,3,85058,85061,85064,3,6,0
24358,4,1,85062,85064,85065,2,3,0
24359,1,1,85063,85065,85066,2,3,0
24360,3,3,85066,85066,85069,0,3,0
24361,1,1,85067,85069,85070,2,3,0
24362,6,1,85073,85073,85074,0,1,3
24363,3,3,85076,85076,85079,0,3,2
24364,5,3,85081,85081,85084,0,3,2
24365,5,2,85086,85086,85088,0,2,2
24366,2,2,85088,85088,85090,0,2,0
24367,5,2,85093,85093,85095,0,2,3
24368,4,3,85097,85097,85100,0,3,2
24369,6,2,85103,85103,85105,0,2,3
24370,2,2,85105,85105,85107,0,2,0
24371,1,2,85106,85107,85109,1,3,0
24372,2,1,85108,85109,85110,1,2,0
24373,6,3,85114,85114,85117,0,3,4
24374,6,3,85120,85120,85123,0,3,3
24375,2,2,85122,85123,85125,1,3,0
24376,3,1,85125,85125,85126,0,1,0
24377,3,1,85128,85128,85129,0,1,2
24378,1,3,85129,85129,85132,0,3,0
24379,4,2,85133,85133,85135,0,2,1
24380,3,3,85136,85136,85139,0,3,1
24381,4,1,85140,85140,85141,0,1,1
24382,3,2,85143,85143,85145,0,2,2
24383,2,1,85145,85145,85146,0,1,0
24384,2,2,85147,85147,85149,0,2,1
24385,6,2,85153,85153,85155,0,2,4
24386,6,3,85159,85159,85162,0,3,4
24387,1,1,85160,85162,85163,2,3,0
24388,5,2,85165,85165,85167,0,2,2
24389,4,1,85169,85169,85170,0,1,2
24390,6,3,85175,85175,85178,0,3,5
24391,2,1,85177,85178,85179,1,2,0
24392,5,3,85182,85182,85185,0,3,3
24393,1,1,85183,85185,85186,2,3,0
24394,6,3,85189,85189,85192,0,3,3
24395,5,1,85194,85194,85195,0,1,2
24396,6,2,85200,85200,85202,0,2,5
24397,4,3,85204,85204,85207,0,3,2
24398,3,1,85207,85207,85208,0,1,0
24399,2,1,85209,85209,85210,0,1,1
24400,5,2,85214,85214,85216,0,2,4
24401,3,3,85217,85217,85220,0,3,1
24402,6,3,85223,85223,85226,0,3,3
24403,1,1,85224,85226,85227,2,3,0
24404,6,3,85230,85230,85233,0,3,3
24405,6,3,85236,85236,85239,0,3,3
24406,1,1,85237,85239,85240,2,3,0
24407,2,1,85239,85240,85241,1,2,0
24408,2,2,85241,85241,85243,0,2,0
24409,3,1,85244,85244,85245,0,1,1
24410,4,3,85248,85248,85251,0,3,3
24411,1,1,85249,85251,85252,2,3,0
24412,6,2,85255,85255,85257,0,2,3
24413,6,2,85261,85261,85263,0,2,4
24414,5,1,85266,85266,85267,0,1,3
24415,2,1,85268,85268,85269,0,1,1
24416,5,3,85273,85273,85276,0,3,4
24417,6,1,85279,85279,85280,0,1,3
24418,3,2,85282,85282,85284,0,2,2
24419,5,2,85287,85287,85289,0,2,3
24420,3,2,85290,85290,85292,0,2,1
24421,2,3,85292,85292,85295,0,3,0
24422,5,3,85297,85297,85300,0,3,2
24423,6,3,85303,85303,85306,0,3,3
24424,1,2,85304,85306,85308,2,4,0
24425,3,3,85307,85308,85311,1,4,0
24426,6,3,85313,85313,85316,0,3,2
24427,3,1,85316,85316,85317,0,1,0
24428,5,1,85321,85321,85322,0,1,4
24429,3,2,85324,85324,85326,0,2,2
24430,4,3,85328,85328,85331,0,3,2
24431,5,2,85333,85333,85335,0,2,2
24432,5,1,85338,85338,85339,0,1,3
24433,2,2,85340,85340,85342,0,2,1
24434,3,1,85343,85343,85344,0,1,1
24435,2,3,85345,85345,85348,0,3,1
24436,2,3,85347,85348,85351,1,4,0
24437,5,3,85352,85352,85355,0,3,1
24438,3,1,85355,85355,85356,0,1,0
24439,5,2,85360,85360,85362,0,2,4
24440,6,2,85366,85366,85368,0,2,4
24441,4,1,85370,85370,85371,0,1,2
24442,4,3,85374,85374,85377,0,3,3
24443,6,2,85380,85380,85382,0,2,3
24444,1,2,85381,85382,85384,1,3,0
24445,2,3,85383,85384,85387,1,4,0
24446,2,1,85385,85387,85388,2,3,0
24447,4,1,85389,85389,85390,0,1,1
24448,5,3,85394,85394,85397,0,3,4
24449,6,1,85400,85400,85401,0,1,3
24450,3,3,85403,85403,85406,0,3,2
24451,5,1,85408,85408,85409,0,1,2
24452,5,1,85413,85413,85414,0,1,4
24453,5,2,85418,85418,85420,0,2,4
24454,5,3,85423,85423,85426,0,3,3
24455,1,3,85424,85426,85429,2,5,0
24456,1,2,85425,85429,85431,4,6,0
24457,6,3,85431,85431,85434,0,3,0
24458,1,3,85432,85434,85437,2,5,0
24459,6,3,85438,85438,85441,0,3,1
24460,5,3,85443,85443,85446,0,3,2
24461,6,1,85449,85449,85450,0,1,3
24462,2,2,85451,85451,85453,0,2,1
24463,5,2,85456,85456,85458,0,2,3
24464,2,1,85458,85458,85459,0,1,0
24465,3,1,85461,85461,85462,0,1,2
24466,3,1,85464,85464,85465,0,1,2
24467,1,1,85465,85465,85466,0,1,0
24468,4,3,85469,85469,85472,0,3,3
24469,3,2,85472,85472,85474,0,2,0
24470,5,2,85477,85477,85479,0,2,3
24471,4,3,85481,85481,85484,0,3,2
24472,1,2,85482,85484,85486,2,4,0
24473,2,1,85484,85486,85487,2,3,0
24474,6,1,85490,85490,85491,0,1,3
24475,5,3,85495,85495,85498,0,3,4
24476,4,1,85499,85499,85500,0,1,1
24477,4,3,85503,85503,85506,0,3,3
24478,2,1,85505,85506,85507,1,2,0
24479,5,3,85510,85510,85513,0,3,3
24480,1,3,85511,85513,85516,2,5,0
24481,3,2,85514,85516,85518,2,4,0
24482,2,2,85516,85518,85520,2,4,0
24483,4,3,85520,85520,85523,0,3,0
24484,2,3,85522,85523,85526,1,4,0
24485,5,3,85527,85527,85530,0,3,1
24486,5,1,85532,85532,85533,0,1,2
24487,3,3,85535,85535,85538,0,3,2
24488,2,1,85537,85538,85539,1,2,0
24489,2,2,85539,85539,85541,0,2,0
24490,2,2,85541,85541,85543,0,2,0
24491,6,1,85547,85547,85548,0,1,4
24492,1,1,85548,85548,85549,0,1,0
24493,6,1,85554,85554,85555,0,1,5
24494,1,2,85555,85555,85557,0,2,0
24495,1,1,85556,85557,85558,1,2,0
24496,2,2,85558,85558,85560,0,2,0
24497,5,3,85563,85563,85566,0,3,3
24498,1,3,85564,85566,85569,2,5,0
24499,6,1,85570,85570,85571,0,1,1
24500,6,1,85576,85576,85577,0,1,5
24501,5,2,85581,85581,85583,0,2,4
24502,1,1,85582,85583,85584,1,2,0
24503,2,2,85584,85584,85586,0,2,0
24504,2,2,85586,85586,85588,0,2,0
24505,4,1,85590,85590,85591,0,1,2
24506,5,1,85595,85595,85596,0,1,4
24507,4,2,85599,85599,85601,0,2,3
24508,4,1,85603,85603,85604,0,1,2
24509,1,2,85604,85604,85606,0,2,0
24510,6,3,85610,85610,85613,0,3,4
24511,3,1,85613,85613,85614,0,1,0
24512,5,2,85618,85618,85620,0,2,4
24513,6,2,85624,85624,85626,0,2,4
24514,2,1,85626,85626,85627,0,1,0
24515,1,2,85627,85627,85629,0,2,0
24516,2,2,85629,85629,85631,0,2,0
24517,6,2,85635,85635,85637,0,2,4
24518,6,1,85641,85641,85642,0,1,4
24519,4,3,85645,85645,85648,0,3,3
24520,2,1,85647,85648,85649,1,2,0
24521,2,1,85649,85649,85650,0,1,0
24522,4,2,85653,85653,85655,0,2,3
24523,5,1,85658,85658,85659,0,1,3
24524,6,1,85664,85664,85665,0,1,5
24525,4,1,85668,85668,85669,0,1,3
24526,1,3,85669,85669,85672,0,3,0
24527,3,2,85672,85672,85674,0,2,0
24528,3,3,85675,85675,85678,0,3,1
24529,2,3,85677,85678,85681,1,4,0
24530,6,1,85683,85683,85684,0,1,2
24531,5,3,85688,85688,85691,0,3,4
24532,4,2,85692,85692,85694,0,2,1
24533,5,2,85697,85697,85699,0,2,3
24534,6,3,85703,85703,85706,0,3,4
24535,4,1,85707,85707,85708,0,1,1
24536,2,2,85709,85709,85711,0,2,1
24537,5,2,85714,85714,85716,0,2,3
24538,4,3,85718,85718,85721,0,3,2
24539,1,1,85719,85721,85722,2,3,0
24540,5,2,85724,85724,85726,0,2,2
24541,3,3,85727,85727,85730,0,3,1
24542,3,2,85730,85730,85732,0,2,0
24543,1,3,85731,85732,85735,1,4,0
24544,5,3,85736,85736,85739,0,3,1
24545,1,3,85737,85739,85742,2,5,0
24546,1,2,85738,85742,85744,4,6,0
24547,4,2,85742,85744,85746,2,4,0
24548,1,1,85743,85746,85747,3,4,0
24549,5,2,85748,85748,85750,0,2,1
24550,1,2,85749,85750,85752,1,3,0
24551,1,1,85750,85752,85753,2,3,0
24552,4,1,85754,85754,85755,0,1,1
24553,1,2,85755,85755,85757,0,2,0
24554,4,2,85759,85759,85761,0,2,2
24555,4,2,85763,85763,85765,0,2,2
24556,5,2,85768,85768,85770,0,2,3
24557,2,3,85770,85770,85773,0,3,0
24558,6,3,85776,85776,85779,0,3,3
24559,3,2,85779,85779,85781,0,2,0
24560,2,1,85781,85781,85782,0,1,0
24561,6,1,85787,85787,85788,0,1,5
24562,1,1,85788,85788,85789,0,1,0
24563,6,1,85794,85794,85795,0,1,5
24564,6,3,85800,85800,85803,0,3,5
24565,1,2,85801,85803,85805,2,4,0
24566,2,3,85803,85805,85808,2,5,0
24567,6,2,85809,85809,85811,0,2,1
24568,1,2,85810,85811,85813,1,3,0
24569,3,3,85813,85813,85816,0,3,0
24570,1,2,85814,85816,85818,2,4,0
24571,2,3,85816,85818,85821,2,5,0
24572,3,1,85819,85821,85822,2,3,0
24573,5,2,85824,85824,85826,0,2,2
24574,4,1,85828,85828,85829,0,1,2
24575,1,1,85829,85829,85830,0,1,0
24576,3,2,85832,85832,85834,0,2,2
24577,2,3,85834,85834,85837,0,3,0
24578,2,2,85836,85837,85839,1,3,0
24579,3,2,85839,85839,85841,0,2,0
24580,5,3,85844,85844,85847,0,3,3
24581,4,2,85848,85848,85850,0,2,1
24582,5,1,85853,85853,85854,0,1,3
24583,4,2,85857,85857,85859,0,2,3
24584,3,3,85860,85860,85863,0,3,1
24585,2,2,85862,85863,85865,1,3,0
24586,5,2,85867,85867,85869,0,2,2
24587,1,3,85868,85869,85872,1,4,0
24588,5,2,85873,85873,85875,0,2,1
24589,1,3,85874,85875,85878,1,4,0
24590,1,1,85875,85878,85879,3,4,0
24591,1,1,85876,85879,85880,3,4,0
24592,3,2,85879,85880,85882,1,3,0
24593,4,1,85883,85883,85884,0,1,1
24594,1,1,85884,85884,85885,0,1,0
24595,5,3,85889,85889,85892,0,3,4
24596,6,3,85895,85895,85898,0,3,3
24597,3,1,85898,85898,85899,0,1,0
24598,3,2,85901,85901,85903,0,2,2
24599,6,3,85907,85907,85910,0,3,4
24600,3,1,85910,85910,85911,0,1,0
24601,3,1,85913,85913,85914,0,1,2
24602,5,3,85918,85918,85921,0,3,4
24603,2,2,85920,85921,85923,1,3,0
24604,1,2,85921,85923,85925,2,4,0
24605,5,2,85926,85926,85928,0,2,1
24606,2,3,85928,85928,85931,0,3,0
24607,4,3,85932,85932,85935,0,3,1
24608,2,3,85934,85935,85938,1,4,0
24609,2,2,85936,85938,85940,2,4,0
24610,1,3,85937,85940,85943,3,6,0
24611,3,2,85940,85943,85945,3,5,0
24612,3,1,85943,85945,85946,2,3,0
24613,2,2,85945,85946,85948,1,3,0
24614,4,2,85949,85949,85951,0,2,1
24615,3,3,85952,85952,85955,0,3,1
24616,5,2,85957,85957,85959,0,2,2
24617,5,2,85962,85962,85964,0,2,3
24618,6,3,85968,85968,85971,0,3,4
24619,2,2,85970,85971,85973,1,3,0
24620,2,2,85972,85973,85975,1,3,0
24621,1,2,85973,85975,85977,2,4,0
24622,1,3,85974,85977,85980,3,6,0
24623,4,1,85978,85980,85981,2,3,0
24624,6,1,85984,85984,85985,0,1,3
24625,4,2,85988,85988,85990,0,2,3
24626,3,2,85991,85991,85993,0,2,1
24627,4,2,85995,85995,85997,0,2,2
24628,4,1,85999,85999,86000,0,1,2
24629,1,1,86000,86000,86001,0,1,0
24630,1,3,86001,86001,86004,0,3,0
24631,6,1,86007,86007,86008,0,1,3
24632,6,3,86013,86013,86016,0,3,5
24633,6,2,86019,86019,86021,0,2,3
24634,1,3,86020,86021,86024,1,4,0
24635,3,3,86023,86024,86027,1,4,0
24636,2,2,86025,86027,86029,2,4,0
24637,5,1,86030,86030,86031,0,1,1
24638,2,1,86032,86032,86033,0,1,1
24639,6,1,86038,86038,86039,0,1,5
24640,2,3,86040,86040,86043,0,3,1
24641,2,3,86042,86043,86046,1,4,0
24642,3,1,86045,86046,86047,1,2,0
24643,2,3,86047,86047,86050,0,3,0
24644,4,2,86051,86051,86053,0,2,1
24645,2,2,86053,86053,86055,0,2,0
24646,5,2,86058,86058,86060,0,2,3
24647,2,2,86060,86060,86062,0,2,0
24648,3,3,86063,86063,86066,0,3,1
24649,1,3,86064,86066,86069,2,5,0
24650,3,1,86067,86069,86070,2,3,0
24651,5,2,86072,86072,86074,0,2,2
24652,5,2,86077,86077,86079,0,2,3
24653,5,3,86082,86082,86085,0,3,3
24654,4,1,86086,86086,86087,0,1,1
24655,1,2,86087,86087,86089,0,2,0
24656,1,2,86088,86089,86091,1,3,0
24657,4,1,86092,86092,86093,0,1,1
24658,4,1,86096,86096,86097,0,1,3
24659,1,3,86097,86097,86100,0,3,0
24660,2,3,86099,86100,86103,1,4,0
24661,1,2,86100,86103,86105,3,5,0
24662,4,2,86104,86105,86107,1,3,0
24663,3,1,86107,86107,86108,0,1,0
24664,6,1,86113,86113,86114,0,1,5
24665,1,1,86114,86114,86115,0,1,0
24666,3,3,86117,86117,86120,0,3,2
24667,6,2,86123,86123,86125,0,2,3
24668,4,2,86127,86127,86129,0,2,2
24669,3,2,86130,86130,86132,0,2,1
24670,1,1,86131,86132,86133,1,2,0
24671,2,3,86133,86133,86136,0,3,0
24672,1,1,86134,86136,86137,2,3,0
24673,4,2,86138,86138,86140,0,2,1
24674,4,3,86142,86142,86145,0,3,2
24675,6,3,86148,86148,86151,0,3,3
24676,6,1,86154,86154,86155,0,1,3
24677,1,3,86155,86155,86158,0,3,0
24678,4,1,86159,86159,86160,0,1,1
24679,1,3,86160,86160,86163,0,3,0
24680,6,3,86166,86166,86169,0,3,3
24681,1,1,86167,86169,86170,2,3,0
24682,4,1,86171,86171,86172,0,1,1
24683,1,2,86172,86172,86174,0,2,0
24684,3,3,86175,86175,86178,0,3,1
24685,5,1,86180,86180,86181,0,1,2
24686,2,1,86182,86182,86183,0,1,1
24687,2,2,86184,86184,86186,0,2,1
24688,4,1,86188,86188,86189,0,1,2
24689,3,1,86191,86191,86192,0,1,2
24690,6,1,86197,86197,86198,0,1,5
24691,3,3,86200,86200,86203,0,3,2
24692,6,2,86206,86206,86208,0,2,3
24693,3,2,86209,86209,86211,0,2,1
24694,4,2,86213,86213,86215,0,2,2
24695,2,1,86215,86215,86216,0,1,0
24696,1,1,86216,86216,86217,0,1,0
24697,1,1,86217,86217,86218,0,1,0
24698,4,3,86221,86221,86224,0,3,3
24699,6,1,86227,86227,86228,0,1,3
24700,5,3,86232,86232,86235,0,3,4
24701,3,2,86235,86235,86237,0,2,0
24702,2,3,86237,86237,86240,0,3,0
24703,5,1,86242,86242,86243,0,1,2
24704,2,2,86244,86244,86246,0,2,1
24705,6,1,86250,86250,86251,0,1,4
24706,2,3,86252,86252,86255,0,3,1
24707,6,2,86258,86258,86260,0,2,3
24708,6,3,86264,86264,86267,0,3,4
24709,4,3,86268,86268,86271,0,3,1
24710,2,3,86270,86271,86274,1,4,0
24711,3,3,86273,86274,86277,1,4,0
24712,5,1,86278,86278,86279,0,1,1
24713,3,3,86281,86281,86284,0,3,2
24714,3,2,86284,86284,86286,0,2,0
24715,1,3,86285,86286,86289,1,4,0
24716,5,3,86290,86290,86293,0,3,1
24717,4,1,86294,86294,86295,0,1,1
24718,2,2,86296,86296,86298,0,2,1
24719,5,1,86301,86301,86302,0,1,3
24720,5,1,86306,86306,86307,0,1,4
24721,6,1,86312,86312,86313,0,1,5
24722,1,1,86313,86313,86314,0,1,0
24723,6,2,86319,86319,86321,0,2,5
24724,6,3,86325,86325,86328,0,3,4
24725,4,2,86329,86329,86331,0,2,1
24726,3,1,86332,86332,86333,0,1,1
24727,5,2,86337,86337,86339,0,2,4
24728,1,1,86338,86339,86340,1,2,0
24729,5,3,86343,86343,86346,0,3,3
24730,4,2,86347,86347,86349,0,2,1
24731,6,2,86353,86353,86355,0,2,4
24732,5,2,86358,86358,86360,0,2,3
24733,3,1,86361,86361,86362,0,1,1
24734,3,2,86364,86364,86366,0,2,2
24735,3,2,86367,86367,86369,0,2,1
24736,5,2,86372,86372,86374,0,2,3
24737,6,3,86378,86378,86381,0,3,4
24738,6,1,86384,86384,86385,0,1,3
24739,4,3,86388,86388,86391,0,3,3
24740,3,1,86391,86391,86392,0,1,0
24741,4,3,86395,86395,86398,0,3,3
24742,1,2,86396,86398,86400,2,4,0
24743,6,2,86402,86402,86404,0,2,2
24744,5,3,86407,86407,86410,0,3,3
24745,3,2,86410,86410,86412,0,2,0
24746,3,3,86413,86413,86416,0,3,1
24747,6,1,86419,86419,86420,0,1,3
24748,3,3,86422,86422,86425,0,3,2
24749,6,2,86428,86428,86430,0,2,3
24750,2,1,86430,86430,86431,0,1,0
24751,5,1,86435,86435,86436,0,1,4
24752,4,2,86439,86439,86441,0,2,3
24753,6,1,86445,86445,86446,0,1,4
24754,4,1,86449,86449,86450,0,1,3
24755,3,1,86452,86452,86453,0,1,2
24756,3,1,86455,86455,86456,0,1,2
24757,2,3,86457,86457,86460,0,3,1
24758,3,2,86460,86460,86462,0,2,0
24759,6,2,86466,86466,86468,0,2,4
24760,1,2,86467,86468,86470,1,3,0
24761,6,1,86473,86473,86474,0,1,3
24762,6,1,86479,86479,86480,0,1,5
24763,4,3,86483,86483,86486,0,3,3
24764,2,1,86485,86486,86487,1,2,0
24765,3,3,86488,86488,86491,0,3,1
24766,5,2,86493,86493,86495,0,2,2
24767,2,1,86495,86495,86496,0,1,0
24768,5,1,86500,86500,86501,0,1,4
24769,4,1,86504,86504,86505,0,1,3
24770,1,2,86505,86505,86507,0,2,0
24771,2,3,86507,86507,86510,0,3,0
24772,2,1,86509,86510,86511,1,2,0
24773,4,3,86513,86513,86516,0,3,2
24774,1,2,86514,86516,86518,2,4,0
24775,1,1,86515,86518,86519,3,4,0
24776,6,3,86521,86521,86524,0,3,2
24777,3,3,86524,86524,86527,0,3,0
24778,6,3,86530,86530,86533,0,3,3
24779,1,1,86531,86533,86534,2,3,0
24780,2,1,86533,86534,86535,1,2,0
24781,3,1,86536,86536,86537,0,1,1
24782,1,1,86537,86537,86538,0,1,0
24783,2,1,86539,86539,86540,0,1,1
24784,6,2,86545,86545,86547,0,2,5
24785,2,1,86547,86547,86548,0,1,0
24786,1,2,86548,86548,86550,0,2,0
24787,3,2,86551,86551,86553,0,2,1
24788,6,3,86557,86557,86560,0,3,4
24789,4,2,86561,86561,86563,0,2,1
24790,3,1,86564,86564,86565,0,1,1
24791,2,3,86566,86566,86569,0,3,1
24792,1,3,86567,86569,86572,2,5,0
24793,1,1,86568,86572,86573,4,5,0
24794,4,2,86572,86573,86575,1,3,0
24795,5,1,86577,86577,86578,0,1,2
24796,4,3,86581,86581,86584,0,3,3
24797,2,2,86583,86584,86586,1,3,0
24798,3,3,86586,86586,86589,0,3,0
24799,2,3,86588,86589,86592,1,4,0
24800,3,1,86591,86592,86593,1,2,0
24801,6,1,86597,86597,86598,0,1,4
24802,5,2,86602,86602,86604,0,2,4
24803,1,3,86603,86604,86607,1,4,0
24804,1,1,86604,86607,86608,3,4,0
24805,1,2,86605,86608,86610,3,5,0
24806,6,2,86611,86611,86613,0,2,1
24807,4,2,86615,86615,86617,0,2,2
24808,4,2,86619,86619,86621,0,2,2
24809,6,1,86625,86625,86626,0,1,4
24810,3,2,86628,86628,86630,0,2,2
24811,1,1,86629,86630,86631,1,2,0
24812,4,3,86633,86633,86636,0,3,2
24813,3,2,86636,86636,86638,0,2,0
24814,2,3,86638,86638,86641,0,3,0
24815,3,3,86641,86641,86644,0,3,0
24816,3,2,86644,86644,86646,0,2,0
24817,1,2,86645,86646,86648,1,3,0
24818,1,3,86646,86648,86651,2,5,0
24819,6,1,86652,86652,86653,0,1,1
24820,6,2,86658,86658,86660,0,2,5
24821,5,2,86663,86663,86665,0,2,3
24822,6,3,86669,86669,86672,0,3,4
24823,2,3,86671,86672,86675,1,4,0
24824,2,1,86673,86675,86676,2,3,0
24825,6,1,86679,86679,86680,0,1,3
24826,1,2,86680,86680,86682,0,2,0
24827,4,2,86684,86684,86686,0,2,2
24828,2,2,86686,86686,86688,0,2,0
24829,2,3,86688,86688,86691,0,3,0
24830,4,3,86692,86692,86695,0,3,1
24831,1,2,86693,86695,86697,2,4,0
24832,2,2,86695,86697,86699,2,4,0
24833,1,2,86696,86699,86701,3,5,0
24834,4,1,86700,86701,86702,1,2,0
24835,1,2,86701,86702,86704,1,3,0
24836,5,3,86706,86706,86709,0,3,2
24837,2,2,86708,86709,86711,1,3,0
24838,6,3,86714,86714,86717,0,3,3
24839,4,2,86718,86718,86720,0,2,1
24840,6,1,86724,86724,86725,0,1,4
24841,3,1,86727,86727,86728,0,1,2
24842,3,2,86730,86730,86732,0,2,2
24843,2,3,86732,86732,86735,0,3,0
24844,4,1,86736,86736,86737,0,1,1
24845,1,2,86737,86737,86739,0,2,0
24846,6,3,86743,86743,86746,0,3,4
24847,4,2,86747,86747,86749,0,2,1
24848,3,2,86750,86750,86752,0,2,1
24849,2,2,86752,86752,86754,0,2,0
24850,4,3,86756,86756,86759,0,3,2
24851,3,2,86759,86759,86761,0,2,0
24852,1,1,86760,86761,86762,1,2,0
24853,4,3,86764,86764,86767,0,3,2
24854,4,2,86768,86768,86770,0,2,1
24855,1,3,86769,86770,86773,1,4,0
24856,6,1,86775,86775,86776,0,1,2
24857,6,1,86781,86781,86782,0,1,5
24858,1,3,86782,86782,86785,0,3,0
24859,5,2,86787,86787,86789,0,2,2
24860,4,3,86791,86791,86794,0,3,2
24861,3,1,86794,86794,86795,0,1,0
24862,5,3,86799,86799,86802,0,3,4
24863,2,1,86801,86802,86803,1,2,0
24864,2,2,86803,86803,86805,0,2,0
24865,3,3,86806,86806,86809,0,3,1
24866,6,1,86812,86812,86813,0,1,3
24867,3,1,86815,86815,86816,0,1,2
24868,5,2,86820,86820,86822,0,2,4
24869,4,3,86824,86824,86827,0,3,2
24870,2,1,86826,86827,86828,1,2,0
24871,1,1,86827,86828,86829,1,2,0
24872,6,1,86833,86833,86834,0,1,4
24873,1,3,86834,86834,86837,0,3,0
24874,3,1,86837,86837,86838,0,1,0
24875,4,2,86841,86841,86843,0,2,3
24876,4,2,86845,86845,86847,0,2,2
24877,3,1,86848,86848,86849,0,1,1
24878,3,3,86851,86851,86854,0,3,2
24879,1,1,86852,86854,86855,2,3,0
24880,5,3,86857,86857,86860,0,3,2
24881,3,1,86860,86860,86861,0,1,0
24882,5,3,86865,86865,86868,0,3,4
24883,2,1,86867,86868,86869,1,2,0
24884,5,2,86872,86872,86874,0,2,3
24885,6,1,86878,86878,86879,0,1,4
24886,2,3,86880,86880,86883,0,3,1
24887,4,1,86884,86884,86885,0,1,1
24888,5,1,86889,86889,86890,0,1,4
24889,4,1,86893,86893,86894,0,1,3
24890,3,1,86896,86896,86897,0,1,2
24891,4,2,86900,86900,86902,0,2,3
24892,1,2,86901,86902,86904,1,3,0
24893,2,3,86903,86904,86907,1,4,0
24894,4,1,86907,86907,86908,0,1,0
24895,2,3,86909,86909,86912,0,3,1
24896,5,2,86914,86914,86916,0,2,2
24897,4,2,86918,86918,86920,0,2,2
24898,4,2,86922,86922,86924,0,2,2
24899,5,3,86927,86927,86930,0,3,3
24900,2,2,86929,86930,86932,1,3,0
24901,2,2,86931,86932,86934,1,3,0
24902,1,1,86932,86934,86935,2,3,0
24903,4,3,86936,86936,86939,0,3,1
24904,1,2,86937,86939,86941,2,4,0
24905,2,2,86939,86941,86943,2,4,0
24906,1,1,86940,86943,86944,3,4,0
24907,3,1,86943,86944,86945,1,2,0
24908,6,3,86949,86949,86952,0,3,4
24909,1,3,86950,86952,86955,2,5,0
24910,5,3,86955,86955,86958,0,3,0
24911,5,3,86960,86960,86963,0,3,2
24912,5,2,86965,86965,86967,0,2,2
24913,1,3,86966,86967,86970,1,4,0
24914,1,2,86967,86970,86972,3,5,0
24915,6,2,86973,86973,86975,0,2,1
24916,5,3,86978,86978,86981,0,3,3
24917,4,2,86982,86982,86984,0,2,1
24918,6,3,86988,86988,86991,0,3,4
24919,6,1,86994,86994,86995,0,1,3
24920,5,1,86999,86999,87000,0,1,4
24921,4,1,87003,87003,87004,0,1,3
24922,5,3,87008,87008,87011,0,3,4
24923,6,2,87014,87014,87016,0,2,3
24924,2,3,87016,87016,87019,0,3,0
24925,4,1,87020,87020,87021,0,1,1
24926,4,3,87024,87024,87027,0,3,3
24927,6,2,87030,87030,87032,0,2,3
24928,6,1,87036,87036,87037,0,1,4
24929,2,3,87038,87038,87041,0,3,1
24930,4,1,87042,87042,87043,0,1,1
24931,1,3,87043,87043,87046,0,3,0
24932,6,1,87049,87049,87050,0,1,3
24933,6,3,87055,87055,87058,0,3,5
24934,5,2,87060,87060,87062,0,2,2
24935,2,3,87062,87062,87065,0,3,0
24936,5,1,87067,87067,87068,0,1,2
24937,1,1,87068,87068,87069,0,1,0
24938,5,3,87073,87073,87076,0,3,4
24939,6,2,87079,87079,87081,0,2,3
24940,2,1,87081,87081,87082,0,1,0
24941,3,2,87084,87084,87086,0,2,2
24942,4,3,87088,87088,87091,0,3,2
24943,4,3,87092,87092,87095,0,3,1
24944,4,2,87096,87096,87098,0,2,1
24945,1,2,87097,87098,87100,1,3,0
24946,6,2,87103,87103,87105,0,2,3
24947,1,2,87104,87105,87107,1,3,0
24948,4,1,87108,87108,87109,0,1,1
24949,4,1,87112,87112,87113,0,1,3
24950,2,2,87114,87114,87116,0,2,1
24951,3,2,87117,87117,87119,0,2,1
24952,4,2,87121,87121,87123,0,2,2
24953,1,3,87122,87123,87126,1,4,0
24954,2,2,87124,87126,87128,2,4,0
24955,1,1,87125,87128,87129,3,4,0
24956,6,2,87131,87131,87133,0,2,2
24957,6,1,87137,87137,87138,0,1,4
24958,3,3,87140,87140,87143,0,3,2
24959,4,1,87144,87144,87145,0,1,1
24960,5,3,87149,87149,87152,0,3,4
24961,5,1,87154,87154,87155,0,1,2
24962,4,2,87158,87158,87160,0,2,3
24963,4,3,87162,87162,87165,0,3,2
24964,3,1,87165,87165,87166,0,1,0
24965,3,3,87168,87168,87171,0,3,2
24966,1,2,87169,87171,87173,2,4,0
24967,2,1,87171,87173,87174,2,3,0
24968,2,1,87173,87174,87175,1,2,0
24969,2,1,87175,87175,87176,0,1,0
24970,1,3,87176,87176,87179,0,3,0
24971,6,2,87182,87182,87184,0,2,3
24972,2,1,87184,87184,87185,0,1,0
24973,4,3,87188,87188,87191,0,3,3
24974,2,3,87190,87191,87194,1,4,0
24975,5,3,87195,87195,87198,0,3,1
24976,2,1,87197,87198,87199,1,2,0
24977,6,3,87203,87203,87206,0,3,4
24978,2,1,87205,87206,87207,1,2,0
24979,3,2,87208,87208,87210,0,2,1
24980,4,2,87212,87212,87214,0,2,2
24981,1,3,87213,87214,87217,1,4,0
24982,5,2,87218,87218,87220,0,2,1
24983,3,2,87221,87221,87223,0,2,1
24984,2,2,87223,87223,87225,0,2,0
24985,5,1,87228,87228,87229,0,1,3
24986,4,3,87232,87232,87235,0,3,3
24987,6,2,87238,87238,87240,0,2,3
24988,2,1,87240,87240,87241,0,1,0
24989,2,1,87242,87242,87243,0,1,1
24990,1,3,87243,87243,87246,0,3,0
24991,6,2,87249,87249,87251,0,2,3
24992,6,1,87255,87255,87256,0,1,4
24993,5,1,87260,87260,87261,0,1,4
24994,2,2,87262,87262,87264,0,2,1
24995,5,3,87267,87267,87270,0,3,3
24996,3,2,87270,87270,87272,0,2,0
24997,6,3,87276,87276,87279,0,3,4
24998,4,3,87280,87280,87283,0,3,1
24999,3,2,87283,87283,87285,0,2,0
25000,1,3,87284,87285,87288,1,4,0
25001,6,1,87290,87290,87291,0,1,2
25002,1,1,87291,87291,87292,0,1,0
25003,5,3,87296,87296,87299,0,3,4
25004,1,1,87297,87299,87300,2,3,0
25005,2,2,87299,87300,87302,1,3,0
25006,2,2,87301,87302,87304,1,3,0
25007,6,3,87307,87307,87310,0,3,3
25008,6,2,87313,87313,87315,0,2,3
25009,5,1,87318,87318,87319,0,1,3
25010,1,1,87319,87319,87320,0,1,0
25011,3,1,87322,87322,87323,0,1,2
25012,6,3,87328,87328,87331,0,3,5
25013,1,3,87329,87331,87334,2,5,0
25014,5,1,87334,87334,87335,0,1,0
25015,3,1,87337,87337,87338,0,1,2
25016,3,1,87340,87340,87341,0,1,2
25017,4,1,87344,87344,87345,0,1,3
25018,3,3,87347,87347,87350,0,3,2
25019,2,1,87349,87350,87351,1,2,0
25020,2,1,87351,87351,87352,0,1,0
25021,2,3,87353,87353,87356,0,3,1
25022,5,2,87358,87358,87360,0,2,2
25023,6,1,87364,87364,87365,0,1,4
25024,4,3,87368,87368,87371,0,3,3
25025,5,2,87373,87373,87375,0,2,2
25026,1,1,87374,87375,87376,1,2,0
25027,4,1,87378,87378,87379,0,1,2
25028,2,1,87380,87380,87381,0,1,1
25029,4,1,87384,87384,87385,0,1,3
25030,3,2,87387,87387,87389,0,2,2
25031,2,3,87389,87389,87392,0,3,0
25032,4,2,87393,87393,87395,0,2,1
25033,4,2,87397,87397,87399,0,2,2
25034,2,1,87399,87399,87400,0,1,0
25035,3,3,87402,87402,87405,0,3,2
25036,1,2,87403,87405,87407,2,4,0
25037,5,1,87408,87408,87409,0,1,1
25038,5,2,87413,87413,87415,0,2,4
25039,1,1,87414,87415,87416,1,2,0
25040,6,3,87420,87420,87423,0,3,4
25041,5,3,87425,87425,87428,0,3,2
25042,6,3,87431,87431,87434,0,3,3
25043,2,3,87433,87434,87437,1,4,0
25044,1,2,87434,87437,87439,3,5,0
25045,2,1,87436,87439,87440,3,4,0
25046,4,1,87440,87440,87441,0,1,0
25047,4,1,87444,87444,87445,0,1,3
25048,5,1,87449,87449,87450,0,1,4
25049,1,3,87450,87450,87453,0,3,0
25050,6,3,87456,87456,87459,0,3,3
25051,6,2,87462,87462,87464,0,2,3
25052,3,1,87465,87465,87466,0,1,1
25053,1,1,87466,87466,87467,0,1,0
25054,6,3,87472,87472,87475,0,3,5
25055,4,2,87476,87476,87478,0,2,1
25056,3,2,87479,87479,87481,0,2,1
25057,1,3,87480,87481,87484,1,4,0
25058,3,3,87483,87484,87487,1,4,0
25059,2,1,87485,87487,87488,2,3,0
25060,1,1,87486,87488,87489,2,3,0
25061,1,2,87487,87489,87491,2,4,0
25062,3,1,87490,87491,87492,1,2,0
25063,2,3,87492,87492,87495,0,3,0
25064,6,2,87498,87498,87500,0,2,3
25065,4,3,87502,87502,87505,0,3,2
25066,3,2,87505,87505,87507,0,2,0
25067,4,2,87509,87509,87511,0,2,2
25068,6,1,87515,87515,87516,0,1,4
25069,5,3,87520,87520,87523,0,3,4
25070,5,3,87525,87525,87528,0,3,2
25071,5,2,87530,87530,87532,0,2,2
25072,2,1,87532,87532,87533,0,1,0
25073,5,3,87537,87537,87540,0,3,4
25074,4,1,87541,87541,87542,0,1,1
25075,3,3,87544,87544,87547,0,3,2
25076,4,2,87548,87548,87550,0,2,1
25077,4,1,87552,87552,87553,0,1,2
25078,6,3,87558,87558,87561,0,3,5
25079,6,1,87564,87564,87565,0,1,3
25080,6,1,87570,87570,87571,0,1,5
25081,3,1,87573,87573,87574,0,1,2
25082,3,2,87576,87576,87578,0,2,2
25083,1,2,87577,87578,87580,1,3,0
25084,4,3,87581,87581,87584,0,3,1
25085,5,2,87586,87586,87588,0,2,2
25086,4,3,87590,87590,87593,0,3,2
25087,4,1,87594,87594,87595,0,1,1
25088,1,2,87595,87595,87597,0,2,0
25089,6,3,87601,87601,87604,0,3,4
25090,2,1,87603,87604,87605,1,2,0
25091,6,3,87609,87609,87612,0,3,4
25092,4,1,87613,87613,87614,0,1,1
25093,5,3,87618,87618,87621,0,3,4
25094,1,2,87619,87621,87623,2,4,0
25095,1,3,87620,87623,87626,3,6,0
25096,1,1,87621,87626,87627,5,6,0
25097,1,2,87622,87627,87629,5,7,0
25098,4,1,87626,87629,87630,3,4,0
25099,4,1,87630,87630,87631,0,1,0
25100,2,2,87632,87632,87634,0,2,1
25101,5,3,87637,87637,87640,0,3,3
25102,1,3,87638,87640,87643,2,5,0
25103,2,3,87640,87643,87646,3,6,0
25104,3,2,87643,87646,87648,3,5,0
25105,3,3,87646,87648,87651,2,5,0
25106,4,1,87650,87651,87652,1,2,0
25107,4,1,87654,87654,87655,0,1,2
25108,6,1,87660,87660,87661,0,1,5
25109,1,1,87661,87661,87662,0,1,0
25110,1,2,87662,87662,87664,0,2,0
25111,2,2,87664,87664,87666,0,2,0
25112,1,3,87665,87666,87669,1,4,0
25113,4,1,87669,87669,87670,0,1,0
25114,3,1,87672,87672,87673,0,1,2
25115,5,3,87677,87677,87680,0,3,4
25116,3,3,87680,87680,87683,0,3,0
25117,4,3,87684,87684,87687,0,3,1
25118,2,2,87686,87687,87689,1,3,0
25119,5,1,87691,87691,87692,0,1,2
25120,2,2,87693,87693,87695,0,2,1
25121,3,1,87696,87696,87697,0,1,1
25122,2,1,87698,87698,87699,0,1,1
25123,4,2,87702,87702,87704,0,2,3
25124,1,2,87703,87704,87706,1,3,0
25125,4,2,87707,87707,87709,0,2,1
25126,4,2,87711,87711,87713,0,2,2
25127,2,1,87713,87713,87714,0,1,0
25128,3,3,87716,87716,87719,0,3,2
25129,2,2,87718,87719,87721,1,3,0
25130,2,3,87720,87721,87724,1,4,0
25131,2,1,87722,87724,87725,2,3,0
25132,5,3,87727,87727,87730,0,3,2
25133,3,2,87730,87730,87732,0,2,0
25134,6,1,87736,87736,87737,0,1,4
25135,6,2,87742,87742,87744,0,2,5
25136,6,3,87748,87748,87751,0,3,4
25137,6,2,87754,87754,87756,0,2,3
25138,4,3,87758,87758,87761,0,3,2
25139,4,1,87762,87762,87763,0,1,1
25140,4,3,87766,87766,87769,0,3,3
25141,3,1,87769,87769,87770,0,1,0
25142,5,1,87774,87774,87775,0,1,4
25143,5,3,87779,87779,87782,0,3,4
25144,3,3,87782,87782,87785,0,3,0
25145,5,2,87787,87787,87789,0,2,2
25146,2,2,87789,87789,87791,0,2,0
25147,6,2,87795,87795,87797,0,2,4
25148,3,2,87798,87798,87800,0,2,1
25149,2,2,87800,87800,87802,0,2,0
25150,1,1,87801,87802,87803,1,2,0
25151,5,2,87806,87806,87808,0,2,3
25152,4,2,87810,87810,87812,0,2,2
25153,4,3,87814,87814,87817,0,3,2
25154,5,2,87819,87819,87821,0,2,2
25155,4,3,87823,87823,87826,0,3,2
25156,3,2,87826,87826,87828,0,2,0
25157,2,1,87828,87828,87829,0,1,0
25158,3,2,87831,87831,87833,0,2,2
25159,3,1,87834,87834,87835,0,1,1
25160,5,1,87839,87839,87840,0,1,4
25161,6,3,87845,87845,87848,0,3,5
25162,2,3,87847,87848,87851,1,4,0
25163,5,3,87852,87852,87855,0,3,1
25164,1,2,87853,87855,87857,2,4,0
25165,5,3,87858,87858,87861,0,3,1
25166,6,2,87864,87864,87866,0,2,3
25167,4,1,87868,87868,87869,0,1,2
25168,1,1,87869,87869,87870,0,1,0
25169,5,3,87874,87874,87877,0,3,4
25170,4,2,87878,87878,87880,0,2,1
25171,2,2,87880,87880,87882,0,2,0
25172,1,2,87881,87882,87884,1,3,0
25173,1,3,87882,87884,87887,2,5,0
25174,1,1,87883,87887,87888,4,5,0
25175,4,1,87887,87888,87889,1,2,0
25176,3,1,87890,87890,87891,0,1,1
25177,6,3,87896,87896,87899,0,3,5
25178,6,1,87902,87902,87903,0,1,3
25179,3,3,87905,87905,87908,0,3,2
25180,5,2,87910,87910,87912,0,2,2
25181,6,1,87916,87916,87917,0,1,4
25182,6,2,87922,87922,87924,0,2,5
25183,2,1,87924,87924,87925,0,1,0
25184,5,3,87929,87929,87932,0,3,4
25185,5,3,87934,87934,87937,0,3,2
25186,4,1,87938,87938,87939,0,1,1
25187,2,3,87940,87940,87943,0,3,1
25188,4,3,87944,87944,87947,0,3,1
25189,1,2,87945,87947,87949,2,4,0
25190,5,1,87950,87950,87951,0,1,1
25191,2,2,87952,87952,87954,0,2,1
25192,6,1,87958,87958,87959,0,1,4
25193,1,1,87959,87959,87960,0,1,0
25194,4,1,87963,87963,87964,0,1,3
25195,3,3,87966,87966,87969,0,3,2
25196,4,2,87970,87970,87972,0,2,1
25197,1,1,87971,87972,87973,1,2,0
25198,2,2,87973,87973,87975,0,2,0
25199,4,3,87977,87977,87980,0,3,2
25200,2,1,87979,87980,87981,1,2,0
25201,2,3,87981,87981,87984,0,3,0
25202,4,3,87985,87985,87988,0,3,1
25203,6,3,87991,87991,87994,0,3,3
25204,6,1,87997,87997,87998,0,1,3
25205,5,1,88002,88002,88003,0,1,4
25206,4,2,88006,88006,88008,0,2,3
25207,1,2,88007,88008,88010,1,3,0
25208,3,2,88010,88010,88012,0,2,0
25209,3,3,88013,88013,88016,0,3,1
25210,3,3,88016,88016,88019,0,3,0
25211,2,2,88018,88019,88021,1,3,0
25212,5,3,88023,88023,88026,0,3,2
25213,5,3,88028,88028,88031,0,3,2
25214,3,3,88031,88031,88034,0,3,0
25215,3,1,88034,88034,88035,0,1,0
25216,4,2,88038,88038,88040,0,2,3
25217,4,1,88042,88042,88043,0,1,2
25218,6,2,88048,88048,88050,0,2,5
25219,3,1,88051,88051,88052,0,1,1
25220,5,1,88056,88056,88057,0,1,4
25221,4,3,88060,88060,88063,0,3,3
25222,6,3,88066,88066,88069,0,3,3
25223,5,2,88071,88071,88073,0,2,2
25224,2,3,88073,88073,88076,0,3,0
25225,2,1,88075,88076,88077,1,2,0
25226,3,3,88078,88078,88081,0,3,1
25227,3,2,88081,88081,88083,0,2,0
25228,2,2,88083,88083,88085,0,2,0
25229,3,2,88086,88086,88088,0,2,1
25230,1,2,88087,88088,88090,1,3,0
25231,5,2,88092,88092,88094,0,2,2
25232,5,1,88097,88097,88098,0,1,3
25233,3,1,88100,88100,88101,0,1,2
25234,3,1,88103,88103,88104,0,1,2
25235,3,1,88106,88106,88107,0,1,2
25236,4,3,88110,88110,88113,0,3,3
25237,4,1,88114,88114,88115,0,1,1
25238,5,2,88119,88119,88121,0,2,4
25239,4,3,88123,88123,88126,0,3,2
25240,5,3,88128,88128,88131,0,3,2
25241,1,3,88129,88131,88134,2,5,0
25242,5,2,88134,88134,88136,0,2,0
25243,5,1,88139,88139,88140,0,1,3
25244,6,2,88145,88145,88147,0,2,5
25245,4,1,88149,88149,88150,0,1,2
25246,3,3,88152,88152,88155,0,3,2
25247,4,1,88156,88156,88157,0,1,1
25248,4,2,88160,88160,88162,0,2,3
25249,5,2,88165,88165,88167,0,2,3
25250,3,2,88168,88168,88170,0,2,1
25251,3,3,88171,88171,88174,0,3,1
25252,2,2,88173,88174,88176,1,3,0
25253,5,1,88178,88178,88179,0,1,2
25254,2,1,88180,88180,88181,0,1,1
25255,5,2,88185,88185,88187,0,2,4
25256,3,2,88188,88188,88190,0,2,1
25257,1,2,88189,88190,88192,1,3,0
25258,2,2,88191,88192,88194,1,3,0
25259,3,3,88194,88194,88197,0,3,0
25260,2,3,88196,88197,88200,1,4,0
25261,5,3,88201,88201,88204,0,3,1
25262,3,3,88204,88204,88207,0,3,0
25263,5,2,88209,88209,88211,0,2,2
25264,4,1,88213,88213,88214,0,1,2
25265,6,2,88219,88219,88221,0,2,5
25266,3,3,88222,88222,88225,0,3,1
25267,2,1,88224,88225,88226,1,2,0
25268,5,1,88229,88229,88230,0,1,3
25269,4,2,88233,88233,88235,0,2,3
25270,5,3,88238,88238,88241,0,3,3
25271,5,2,88243,88243,88245,0,2,2
25272,3,3,88246,88246,88249,0,3,1
25273,2,2,88248,88249,88251,1,3,0
25274,2,3,88250,88251,88254,1,4,0
25275,3,2,88253,88254,88256,1,3,0
25276,6,1,88259,88259,88260,0,1,3
25277,2,1,88261,88261,88262,0,1,1
25278,4,2,88265,88265,88267,0,2,3
25279,1,1,88266,88267,88268,1,2,0
25280,4,2,88270,88270,88272,0,2,2
25281,3,2,88273,88273,88275,0,2,1
25282,3,2,88276,88276,88278,0,2,1
25283,6,2,88282,88282,88284,0,2,4
25284,2,2,88284,88284,88286,0,2,0
25285,3,2,88287,88287,88289,0,2,1
25286,2,2,88289,88289,88291,0,2,0
25287,2,1,88291,88291,88292,0,1,0
25288,4,3,88295,88295,88298,0,3,3
25289,4,1,88299,88299,88300,0,1,1
25290,4,3,88303,88303,88306,0,3,3
25291,5,1,88308,88308,88309,0,1,2
25292,2,3,88310,88310,88313,0,3,1
25293,5,1,88315,88315,88316,0,1,2
25294,3,1,88318,88318,88319,0,1,2
25295,6,2,88324,88324,88326,0,2,5
25296,2,3,88326,88326,88329,0,3,0
25297,3,3,88329,88329,88332,0,3,0
25298,5,1,88334,88334,88335,0,1,2
25299,1,1,88335,88335,88336,0,1,0
25300,2,2,88337,88337,88339,0,2,1
25301,6,1,88343,88343,88344,0,1,4
25302,1,3,88344,88344,88347,0,3,0
25303,2,1,88346,88347,88348,1,2,0
25304,5,3,88351,88351,88354,0,3,3
25305,6,1,88357,88357,88358,0,1,3
25306,2,3,88359,88359,88362,0,3,1
25307,3,2,88362,88362,88364,0,2,0
25308,4,2,88366,88366,88368,0,2,2
25309,6,3,88372,88372,88375,0,3,4
25310,6,3,88378,88378,88381,0,3,3
25311,6,1,88384,88384,88385,0,1,3
25312,5,2,88389,88389,88391,0,2,4
25313,5,1,88394,88394,88395,0,1,3
25314,3,2,88397,88397,88399,0,2,2
25315,5,2,88402,88402,88404,0,2,3
25316,6,3,88408,88408,88411,0,3,4
25317,6,1,88414,88414,88415,0,1,3
25318,3,2,88417,88417,88419,0,2,2
25319,4,2,88421,88421,88423,0,2,2
25320,3,2,88424,88424,88426,0,2,1
25321,2,1,88426,88426,88427,0,1,0
25322,4,3,88430,88430,88433,0,3,3
25323,5,1,88435,88435,88436,0,1,2
25324,3,1,88438,88438,88439,0,1,2
25325,6,1,88444,88444,88445,0,1,5
25326,4,3,88448,88448,88451,0,3,3
25327,6,1,88454,88454,88455,0,1,3
25328,6,3,88460,88460,88463,0,3,5
25329,1,1,88461,88463,88464,2,3,0
25330,3,2,88464,88464,88466,0,2,0
25331,5,1,88469,88469,88470,0,1,3
25332,4,3,88473,88473,88476,0,3,3
25333,2,3,88475,88476,88479,1,4,0
25334,4,2,88479,88479,88481,0,2,0
25335,3,1,88482,88482,88483,0,1,1
25336,5,3,88487,88487,88490,0,3,4
25337,3,2,88490,88490,88492,0,2,0
25338,5,3,88495,88495,88498,0,3,3
25339,6,3,88501,88501,88504,0,3,3
25340,1,3,88502,88504,88507,2,5,0
25341,6,3,88508,88508,88511,0,3,1
25342,2,2,88510,88511,88513,1,3,0
25343,5,3,88515,88515,88518,0,3,2
25344,4,1,88519,88519,88520,0,1,1
25345,4,1,88523,88523,88524,0,1,3
25346,1,3,88524,88524,88527,0,3,0
25347,3,3,88527,88527,88530,0,3,0
25348,3,2,88530,88530,88532,0,2,0
25349,2,1,88532,88532,88533,0,1,0
25350,5,1,88537,88537,88538,0,1,4
25351,4,3,88541,88541,88544,0,3,3
25352,6,2,88547,88547,88549,0,2,3
25353,5,1,88552,88552,88553,0,1,3
25354,1,2,88553,88553,88555,0,2,0
25355,6,3,88559,88559,88562,0,3,4
25356,4,3,88563,88563,88566,0,3,1
25357,2,3,88565,88566,88569,1,4,0
25358,6,1,88571,88571,88572,0,1,2
25359,4,1,88575,88575,88576,0,1,3
25360,6,2,88581,88581,88583,0,2,5
25361,6,1,88587,88587,88588,0,1,4
25362,6,2,88593,88593,88595,0,2,5
25363,3,3,88596,88596,88599,0,3,1
25364,2,3,88598,88599,88602,1,4,0
25365,5,2,88603,88603,88605,0,2,1
25366,3,3,88606,88606,88609,0,3,1
25367,2,2,88608,88609,88611,1,3,0
25368,2,1,88610,88611,88612,1,2,0
25369,4,3,88614,88614,88617,0,3,2
25370,2,3,88616,88617,88620,1,4,0
25371,6,1,88622,88622,88623,0,1,2
25372,1,2,88623,88623,88625,0,2,0
25373,4,1,88627,88627,88628,0,1,2
25374,6,2,88633,88633,88635,0,2,5
25375,2,1,88635,88635,88636,0,1,0
25376,5,1,88640,88640,88641,0,1,4
25377,4,2,88644,88644,88646,0,2,3
25378,4,3,88648,88648,88651,0,3,2
25379,5,1,88653,88653,88654,0,1,2
25380,4,1,88657,88657,88658,0,1,3
25381,6,3,88663,88663,88666,0,3,5
25382,4,1,88667,88667,88668,0,1,1
25383,5,3,88672,88672,88675,0,3,4
25384,4,3,88676,88676,88679,0,3,1
25385,2,3,88678,88679,88682,1,4,0
25386,6,1,88684,88684,88685,0,1,2
25387,1,2,88685,88685,88687,0,2,0
25388,6,2,88691,88691,88693,0,2,4
25389,4,1,88695,88695,88696,0,1,2
25390,3,1,88698,88698,88699,0,1,2
25391,1,3,88699,88699,88702,0,3,0
25392,1,1,88700,88702,88703,2,3,0
25393,3,3,88703,88703,88706,0,3,0
25394,1,3,88704,88706,88709,2,5,0
25395,4,1,88708,88709,88710,1,2,0
25396,1,1,88709,88710,88711,1,2,0
25397,5,3,88714,88714,88717,0,3,3
25398,5,3,88719,88719,88722,0,3,2
25399,1,2,88720,88722,88724,2,4,0
25400,3,3,88723,88724,88727,1,4,0
25401,6,3,88729,88729,88732,0,3,2
25402,5,3,88734,88734,88737,0,3,2
25403,3,2,88737,88737,88739,0,2,0
25404,6,1,88743,88743,88744,0,1,4
25405,6,1,88749,88749,88750,0,1,5
25406,3,3,88752,88752,88755,0,3,2
25407,6,1,88758,88758,88759,0,1,3
25408,2,2,88760,88760,88762,0,2,1
25409,5,1,88765,88765,88766,0,1,3
25410,2,1,88767,88767,88768,0,1,1
25411,5,2,88772,88772,88774,0,2,4
25412,6,3,88778,88778,88781,0,3,4
25413,3,1,88781,88781,88782,0,1,0
25414,6,1,88787,88787,88788,0,1,5
25415,6,1,88793,88793,88794,0,1,5
25416,6,3,88799,88799,88802,0,3,5
25417,1,3,88800,88802,88805,2,5,0
25418,4,3,88804,88805,88808,1,4,0
25419,1,3,88805,88808,88811,3,6,0
25420,4,1,88809,88811,88812,2,3,0
25421,5,1,88814,88814,88815,0,1,2
25422,4,3,88818,88818,88821,0,3,3
25423,1,1,88819,88821,88822,2,3,0
25424,3,3,88822,88822,88825,0,3,0
25425,6,1,88828,88828,88829,0,1,3
25426,1,1,88829,88829,88830,0,1,0
25427,6,3,88835,88835,88838,0,3,5
25428,1,1,88836,88838,88839,2,3,0
25429,3,1,88839,88839,88840,0,1,0
25430,2,1,88841,88841,88842,0,1,1
25431,1,3,88842,88842,88845,0,3,0
25432,2,3,88844,88845,88848,1,4,0
25433,1,3,88845,88848,88851,3,6,0
25434,4,2,88849,88851,88853,2,4,0
25435,4,1,88853,88853,88854,0,1,0
25436,2,1,88855,88855,88856,0,1,1
25437,4,3,88859,88859,88862,0,3,3
25438,3,1,88862,88862,88863,0,1,0
25439,1,2,88863,88863,88865,0,2,0
25440,1,1,88864,88865,88866,1,2,0
25441,4,1,88868,88868,88869,0,1,2
25442,1,3,88869,88869,88872,0,3,0
25443,4,3,88873,88873,88876,0,3,1
25444,4,2,88877,88877,88879,0,2,1
25445,3,2,88880,88880,88882,0,2,1
25446,6,2,88886,88886,88888,0,2,4
25447,1,2,88887,88888,88890,1,3,0
25448,6,2,88893,88893,88895,0,2,3
25449,2,3,88895,88895,88898,0,3,0
25450,3,1,88898,88898,88899,0,1,0
25451,4,1,88902,88902,88903,0,1,3
25452,2,2,88904,88904,88906,0,2,1
25453,4,1,88908,88908,88909,0,1,2
25454,3,1,88911,88911,88912,0,1,2
25455,2,1,88913,88913,88914,0,1,1
25456,5,3,88918,88918,88921,0,3,4
25457,5,3,88923,88923,88926,0,3,2
25458,6,1,88929,88929,88930,0,1,3
25459,4,3,88933,88933,88936,0,3,3
25460,4,3,88937,88937,88940,0,3,1
25461,3,2,88940,88940,88942,0,2,0
25462,4,3,88944,88944,88947,0,3,2
25463,3,3,88947,88947,88950,0,3,0
25464,4,3,88951,88951,88954,0,3,1
25465,4,2,88955,88955,88957,0,2,1
25466,1,3,88956,88957,88960,1,4,0
25467,1,3,88957,88960,88963,3,6,0
25468,2,1,88959,88963,88964,4,5,0
25469,6,1,88965,88965,88966,0,1,1
25470,1,1,88966,88966,88967,0,1,0
25471,5,2,88971,88971,88973,0,2,4
25472,5,2,88976,88976,88978,0,2,3
25473,6,2,88982,88982,88984,0,2,4
25474,5,2,88987,88987,88989,0,2,3
25475,2,3,88989,88989,88992,0,3,0
25476,5,1,88994,88994,88995,0,1,2
25477,6,2,89000,89000,89002,0,2,5
25478,2,3,89002,89002,89005,0,3,0
25479,5,2,89007,89007,89009,0,2,2
25480,2,2,89009,89009,89011,0,2,0
25481,4,3,89013,89013,89016,0,3,2
25482,2,3,89015,89016,89019,1,4,0
25483,3,3,89018,89019,89022,1,4,0
25484,1,2,89019,89022,89024,3,5,0
25485,4,2,89023,89024,89026,1,3,0
25486,6,3,89029,89029,89032,0,3,3
25487,3,3,89032,89032,89035,0,3,0
25488,4,3,89036,89036,89039,0,3,1
25489,3,1,89039,89039,89040,0,1,0
25490,6,2,89045,89045,89047,0,2,5
25491,1,2,89046,89047,89049,1,3,0
25492,4,2,89050,89050,89052,0,2,1
25493,6,1,89056,89056,89057,0,1,4
25494,1,1,89057,89057,89058,0,1,0
25495,1,2,89058,89058,89060,0,2,0
25496,5,2,89063,89063,89065,0,2,3
25497,2,3,89065,89065,89068,0,3,0
25498,6,1,89071,89071,89072,0,1,3
25499,2,1,89073,89073,89074,0,1,1
25500,4,1,89077,89077,89078,0,1,3
25501,4,2,89081,89081,89083,0,2,3
25502,6,1,89087,89087,89088,0,1,4
25503,3,1,89090,89090,89091,0,1,2
25504,2,1,89092,89092,89093,0,1,1
25505,2,1,89094,89094,89095,0,1,1
25506,3,2,89097,89097,89099,0,2,2
25507,2,1,89099,89099,89100,0,1,0
25508,4,3,89103,89103,89106,0,3,3
25509,6,1,89109,89109,89110,0,1,3
25510,4,1,89113,89113,89114,0,1,3
25511,2,1,89115,89115,89116,0,1,1
25512,2,3,89117,89117,89120,0,3,1
25513,3,2,89120,89120,89122,0,2,0
25514,2,3,89122,89122,89125,0,3,0
25515,2,2,89124,89125,89127,1,3,0
25516,1,2,89125,89127,89129,2,4,0
25517,3,3,89128,89129,89132,1,4,0
25518,2,1,89130,89132,89133,2,3,0
25519,4,2,89134,89134,89136,0,2,1
25520,4,3,89138,89138,89141,0,3,2
25521,6,1,89144,89144,89145,0,1,3
25522,3,2,89147,89147,89149,0,2,2
25523,1,1,89148,89149,89150,1,2,0
25524,2,2,89150,89150,89152,0,2,0
25525,4,2,89154,89154,89156,0,2,2
25526,4,1,89158,89158,89159,0,1,2
25527,4,2,89162,89162,89164,0,2,3
25528,3,3,89165,89165,89168,0,3,1
25529,1,1,89166,89168,89169,2,3,0
25530,1,3,89167,89169,89172,2,5,0
25531,5,2,89172,89172,89174,0,2,0
25532,5,3,89177,89177,89180,0,3,3
25533,5,3,89182,89182,89185,0,3,2
25534,6,2,89188,89188,89190,0,2,3
25535,5,1,89193,89193,89194,0,1,3
25536,1,3,89194,89194,89197,0,3,0
25537,6,1,89200,89200,89201,0,1,3
25538,1,3,89201,89201,89204,0,3,0
25539,1,3,89202,89204,89207,2,5,0
25540,4,3,89206,89207,89210,1,4,0
25541,6,3,89212,89212,89215,0,3,2
25542,2,1,89214,89215,89216,1,2,0
25543,4,2,89218,89218,89220,0,2,2
25544,2,3,89220,89220,89223,0,3,0
25545,5,3,89225,89225,89228,0,3,2
25546,3,3,89228,89228,89231,0,3,0
25547,1,3,89229,89231,89234,2,5,0
25548,3,1,89232,89234,89235,2,3,0
25549,1,1,89233,89235,89236,2,3,0
25550,6,2,89239,89239,89241,0,2,3
25551,6,3,89245,89245,89248,0,3,4
25552,2,2,89247,89248,89250,1,3,0
25553,5,3,89252,89252,89255,0,3,2
25554,5,3,89257,89257,89260,0,3,2
25555,1,1,89258,89260,89261,2,3,0
25556,2,3,89260,89261,89264,1,4,0
25557,6,1,89266,89266,89267,0,1,2
25558,2,3,89268,89268,89271,0,3,1
25559,5,3,89273,89273,89276,0,3,2
25560,6,1,89279,89279,89280,0,1,3
25561,4,3,89283,89283,89286,0,3,3
25562,1,3,89284,89286,89289,2,5,0
25563,4,2,89288,89289,89291,1,3,0
25564,1,3,89289,89291,89294,2,5,0
25565,5,1,89294,89294,89295,0,1,0
25566,2,2,89296,89296,89298,0,2,1
25567,5,1,89301,89301,89302,0,1,3
25568,1,3,89302,89302,89305,0,3,0
25569,6,2,89308,89308,89310,0,2,3
25570,6,1,89314,89314,89315,0,1,4
25571,2,2,89316,89316,89318,0,2,1
25572,4,1,89320,89320,89321,0,1,2
25573,3,2,89323,89323,89325,0,2,2
25574,3,1,89326,89326,89327,0,1,1
25575,6,2,89332,89332,89334,0,2,5
25576,5,2,89337,89337,89339,0,2,3
25577,1,3,89338,89339,89342,1,4,0
25578,2,3,89340,89342,89345,2,5,0
25579,4,3,89344,89345,89348,1,4,0
25580,2,3,89346,89348,89351,2,5,0
25581,2,3,89348,89351,89354,3,6,0
25582,1,3,89349,89354,89357,5,8,0
25583,4,1,89353,89357,89358,4,5,0
25584,2,3,89355,89358,89361,3,6,0
25585,3,2,89358,89361,89363,3,5,0
25586,4,2,89362,89363,89365,1,3,0
25587,6,3,89368,89368,89371,0,3,3
25588,3,1,89371,89371,89372,0,1,0
25589,4,3,89375,89375,89378,0,3,3
25590,6,2,89381,89381,89383,0,2,3
25591,1,2,89382,89383,89385,1,3,0
25592,3,3,89385,89385,89388,0,3,0
25593,6,1,89391,89391,89392,0,1,3
25594,3,2,89394,89394,89396,0,2,2
25595,6,2,89400,89400,89402,0,2,4
25596,4,2,89404,89404,89406,0,2,2
25597,2,2,89406,89406,89408,0,2,0
25598,2,2,89408,89408,89410,0,2,0
25599,4,2,89412,89412,89414,0,2,2
25600,2,3,89414,89414,89417,0,3,0
25601,2,2,89416,89417,89419,1,3,0
25602,4,1,89420,89420,89421,0,1,1
25603,3,1,89423,89423,89424,0,1,2
25604,2,3,89425,89425,89428,0,3,1
25605,1,3,89426,89428,89431,2,5,0
25606,6,3,89432,89432,89435,0,3,1
25607,1,3,89433,89435,89438,2,5,0
25608,6,3,89439,89439,89442,0,3,1
25609,5,2,89444,89444,89446,0,2,2
25610,6,3,89450,89450,89453,0,3,4
25611,1,3,89451,89453,89456,2,5,0
25612,5,1,89456,89456,89457,0,1,0
25613,3,2,89459,89459,89461,0,2,2
25614,6,1,89465,89465,89466,0,1,4
25615,1,1,89466,89466,89467,0,1,0
25616,6,1,89472,89472,89473,0,1,5
25617,3,3,89475,89475,89478,0,3,2
25618,3,1,89478,89478,89479,0,1,0
25619,1,2,89479,89479,89481,0,2,0
25620,6,2,89485,89485,89487,0,2,4
25621,6,1,89491,89491,89492,0,1,4
25622,2,1,89493,89493,89494,0,1,1
25623,6,3,89499,89499,89502,0,3,5
25624,6,3,89505,89505,89508,0,3,3
25625,2,3,89507,89508,89511,1,4,0
25626,2,2,89509,89511,89513,2,4,0
25627,2,2,89511,89513,89515,2,4,0
25628,1,3,89512,89515,89518,3,6,0
25629,1,2,89513,89518,89520,5,7,0
25630,2,2,89515,89520,89522,5,7,0
25631,3,2,89518,89522,89524,4,6,0
25632,5,2,89523,89524,89526,1,3,0
25633,5,3,89528,89528,89531,0,3,2
25634,1,1,89529,89531,89532,2,3,0
25635,2,2,89531,89532,89534,1,3,0
25636,4,1,89535,89535,89536,0,1,1
25637,6,2,89541,89541,89543,0,2,5
25638,6,2,89547,89547,89549,0,2,4
25639,5,3,89552,89552,89555,0,3,3
25640,5,2,89557,89557,89559,0,2,2
25641,2,3,89559,89559,89562,0,3,0
25642,2,1,89561,89562,89563,1,2,0
25643,2,2,89563,89563,89565,0,2,0
25644,1,2,89564,89565,89567,1,3,0
25645,5,2,89569,89569,89571,0,2,2
25646,4,2,89573,89573,89575,0,2,2
25647,6,2,89579,89579,89581,0,2,4
25648,2,3,89581,89581,89584,0,3,0
25649,3,1,89584,89584,89585,0,1,0
25650,5,1,89589,89589,89590,0,1,4
25651,3,1,89592,89592,89593,0,1,2
25652,6,1,89598,89598,89599,0,1,5
25653,5,1,89603,89603,89604,0,1,4
25654,5,3,89608,89608,89611,0,3,4
25655,3,1,89611,89611,89612,0,1,0
25656,2,3,89613,89613,89616,0,3,1
25657,3,1,89616,89616,89617,0,1,0
25658,4,3,89620,89620,89623,0,3,3
25659,2,3,89622,89623,89626,1,4,0
25660,3,1,89625,89626,89627,1,2,0
25661,3,3,89628,89628,89631,0,3,1
25662,2,2,89630,89631,89633,1,3,0
25663,3,3,89633,89633,89636,0,3,0
25664,5,1,89638,89638,89639,0,1,2
25665,6,3,89644,89644,89647,0,3,5
25666,5,2,89649,89649,89651,0,2,2
25667,3,1,89652,89652,89653,0,1,1
25668,6,1,89658,89658,89659,0,1,5
25669,1,2,89659,89659,89661,0,2,0
25670,4,3,89663,89663,89666,0,3,2
25671,2,3,89665,89666,89669,1,4,0
25672,5,1,89670,89670,89671,0,1,1
25673,5,1,89675,89675,89676,0,1,4
25674,5,1,89680,89680,89681,0,1,4
25675,2,2,89682,89682,89684,0,2,1
25676,2,3,89684,89684,89687,0,3,0
25677,6,2,89690,89690,89692,0,2,3
25678,6,1,89696,89696,89697,0,1,4
25679,4,2,89700,89700,89702,0,2,3
25680,5,3,89705,89705,89708,0,3,3
25681,5,3,89710,89710,89713,0,3,2
25682,3,1,89713,89713,89714,0,1,0
25683,1,1,89714,89714,89715,0,1,0
25684,1,2,89715,89715,89717,0,2,0
25685,2,1,89717,89717,89718,0,1,0
25686,4,2,89721,89721,89723,0,2,3
25687,6,2,89727,89727,89729,0,2,4
25688,5,3,89732,89732,89735,0,3,3
25689,6,1,89738,89738,89739,0,1,3
25690,3,3,89741,89741,89744,0,3,2
25691,1,1,89742,89744,89745,2,3,0
25692,2,1,89744,89745,89746,1,2,0
25693,4,3,89748,89748,89751,0,3,2
25694,6,2,89754,89754,89756,0,2,3
25695,3,3,89757,89757,89760,0,3,1
25696,2,1,89759,89760,89761,1,2,0
25697,3,1,89762,89762,89763,0,1,1
25698,5,2,89767,89767,89769,0,2,4
25699,4,1,89771,89771,89772,0,1,2
25700,6,2,89777,89777,89779,0,2,5
25701,4,1,89781,89781,89782,0,1,2
25702,6,1,89787,89787,89788,0,1,5
25703,6,3,89793,89793,89796,0,3,5
25704,2,2,89795,89796,89798,1,3,0
25705,6,3,89801,89801,89804,0,3,3
25706,5,2,89806,89806,89808,0,2,2
25707,5,1,89811,89811,89812,0,1,3
25708,4,2,89815,89815,89817,0,2,3
25709,6,1,89821,89821,89822,0,1,4
25710,2,2,89823,89823,89825,0,2,1
25711,2,2,89825,89825,89827,0,2,0
25712,6,2,89831,89831,89833,0,2,4
25713,1,3,89832,89833,89836,1,4,0
25714,3,2,89835,89836,89838,1,3,0
25715,3,2,89838,89838,89840,0,2,0
25716,5,1,89843,89843,89844,0,1,3
25717,2,3,89845,89845,89848,0,3,1
25718,3,1,89848,89848,89849,0,1,0
25719,3,2,89851,89851,89853,0,2,2
25720,5,2,89856,89856,89858,0,2,3
25721,5,1,89861,89861,89862,0,1,3
25722,4,3,89865,89865,89868,0,3,3
25723,6,1,89871,89871,89872,0,1,3
25724,2,1,89873,89873,89874,0,1,1
25725,2,2,89875,89875,89877,0,2,1
25726,5,3,89880,89880,89883,0,3,3
25727,6,3,89886,89886,89889,0,3,3
25728,4,2,89890,89890,89892,0,2,1
25729,6,2,89896,89896,89898,0,2,4
25730,1,3,89897,89898,89901,1,4,0
25731,6,1,89903,89903,89904,0,1,2
25732,4,3,89907,89907,89910,0,3,3
25733,2,3,89909,89910,89913,1,4,0
25734,5,2,89914,89914,89916,0,2,1
25735,4,2,89918,89918,89920,0,2,2
25736,5,3,89923,89923,89926,0,3,3
25737,6,2,89929,89929,89931,0,2,3
25738,3,2,89932,89932,89934,0,2,1
25739,5,1,89937,89937,89938,0,1,3
25740,6,3,89943,89943,89946,0,3,5
25741,6,3,89949,89949,89952,0,3,3
25742,5,3,89954,89954,89957,0,3,2
25743,1,2,89955,89957,89959,2,4,0
25744,4,2,89959,89959,89961,0,2,0
25745,1,3,89960,89961,89964,1,4,0
25746,5,1,89965,89965,89966,0,1,1
25747,5,1,89970,89970,89971,0,1,4
25748,3,3,89973,89973,89976,0,3,2
25749,2,3,89975,89976,89979,1,4,0
25750,6,2,89981,89981,89983,0,2,2
25751,5,3,89986,89986,89989,0,3,3
25752,3,2,89989,89989,89991,0,2,0
25753,2,2,89991,89991,89993,0,2,0
25754,1,1,89992,89993,89994,1,2,0
25755,4,3,89996,89996,89999,0,3,2
25756,1,3,89997,89999,90002,2,5,0
25757,1,1,89998,90002,90003,4,5,0
25758,2,2,90000,90003,90005,3,5,0
25759,5,3,90005,90005,90008,0,3,0
25760,1,3,90006,90008,90011,2,5,0
25761,5,2,90011,90011,90013,0,2,0
25762,3,3,90014,90014,90017,0,3,1
25763,3,1,90017,90017,90018,0,1,0
25764,2,3,90019,90019,90022,0,3,1
25765,6,2,90025,90025,90027,0,2,3
25766,2,2,90027,90027,90029,0,2,0
25767,3,3,90030,90030,90033,0,3,1
25768,4,2,90034,90034,90036,0,2,1
25769,3,2,90037,90037,90039,0,2,1
25770,5,3,90042,90042,90045,0,3,3
25771,6,1,90048,90048,90049,0,1,3
25772,6,3,90054,90054,90057,0,3,5
25773,5,2,90059,90059,90061,0,2,2
25774,6,1,90065,90065,90066,0,1,4
25775,3,1,90068,90068,90069,0,1,2
25776,4,1,90072,90072,90073,0,1,3
25777,4,2,90076,90076,90078,0,2,3
25778,1,1,90077,90078,90079,1,2,0
25779,3,1,90080,90080,90081,0,1,1
25780,4,1,90084,90084,90085,0,1,3
25781,1,3,90085,90085,90088,0,3,0
25782,2,2,90087,90088,90090,1,3,0
25783,5,3,90092,90092,90095,0,3,2
25784,1,1,90093,90095,90096,2,3,0
25785,4,3,90097,90097,90100,0,3,1
25786,4,1,90101,90101,90102,0,1,1
25787,5,1,90106,90106,90107,0,1,4
25788,1,3,90107,90107,90110,0,3,0
25789,5,3,90112,90112,90115,0,3,2
25790,1,1,90113,90115,90116,2,3,0
25791,4,3,90117,90117,90120,0,3,1
25792,5,3,90122,90122,90125,0,3,2
25793,1,2,90123,90125,90127,2,4,0
25794,3,1,90126,90127,90128,1,2,0
25795,6,3,90132,90132,90135,0,3,4
25796,4,2,90136,90136,90138,0,2,1
25797,4,3,90140,90140,90143,0,3,2
25798,2,1,90142,90143,90144,1,2,0
25799,6,3,90148,90148,90151,0,3,4
25800,6,3,90154,90154,90157,0,3,3
25801,5,1,90159,90159,90160,0,1,2
25802,1,3,90160,90160,90163,0,3,0
25803,4,1,90164,90164,90165,0,1,1
25804,3,2,90167,90167,90169,0,2,2
25805,4,2,90171,90171,90173,0,2,2
25806,1,3,90172,90173,90176,1,4,0
25807,3,3,90175,90176,90179,1,4,0
25808,3,3,90178,90179,90182,1,4,0
25809,3,1,90181,90182,90183,1,2,0
25810,1,2,90182,90183,90185,1,3,0
25811,6,1,90188,90188,90189,0,1,3
25812,6,3,90194,90194,90197,0,3,5
25813,5,3,90199,90199,90202,0,3,2
25814,6,3,90205,90205,90208,0,3,3
25815,3,3,90208,90208,90211,0,3,0
25816,2,2,90210,90211,90213,1,3,0
25817,4,2,90214,90214,90216,0,2,1
25818,4,3,90218,90218,90221,0,3,2
25819,4,3,90222,90222,90225,0,3,1
25820,3,1,90225,90225,90226,0,1,0
25821,1,2,90226,90226,90228,0,2,0
25822,3,3,90229,90229,90232,0,3,1
25823,4,2,90233,90233,90235,0,2,1
25824,5,3,90238,90238,90241,0,3,3
25825,3,1,90241,90241,90242,0,1,0
25826,2,2,90243,90243,90245,0,2,1
25827,3,2,90246,90246,90248,0,2,1
25828,3,1,90249,90249,90250,0,1,1
25829,2,1,90251,90251,90252,0,1,1
25830,1,1,90252,90252,90253,0,1,0
25831,4,2,90256,90256,90258,0,2,3
25832,6,3,90262,90262,90265,0,3,4
25833,6,1,90268,90268,90269,0,1,3
25834,5,1,90273,90273,90274,0,1,4
25835,6,1,90279,90279,90280,0,1,5
25836,3,2,90282,90282,90284,0,2,2
25837,4,2,90286,90286,90288,0,2,2
25838,6,1,90292,90292,90293,0,1,4
25839,4,3,90296,90296,90299,0,3,3
25840,4,3,90300,90300,90303,0,3,1
25841,3,3,90303,90303,90306,0,3,0
25842,1,2,90304,90306,90308,2,4,0
25843,1,2,90305,90308,90310,3,5,0
25844,3,2,90308,90310,90312,2,4,0
25845,2,3,90310,90312,90315,2,5,0
25846,3,3,90313,90315,90318,2,5,0
25847,2,3,90315,90318,90321,3,6,0
25848,6,3,90321,90321,90324,0,3,0
25849,5,3,90326,90326,90329,0,3,2
25850,3,3,90329,90329,90332,0,3,0
25851,5,3,90334,90334,90337,0,3,2
25852,3,1,90337,90337,90338,0,1,0
25853,1,2,90338,90338,90340,0,2,0
25854,2,2,90340,90340,90342,0,2,0
25855,4,3,90344,90344,90347,0,3,2
25856,2,2,90346,90347,90349,1,3,0
25857,5,2,90351,90351,90353,0,2,2
25858,6,1,90357,90357,90358,0,1,4
25859,4,2,90361,90361,90363,0,2,3
25860,3,1,90364,90364,90365,0,1,1
25861,1,1,90365,90365,90366,0,1,0
25862,3,1,90368,90368,90369,0,1,2
25863,4,3,90372,90372,90375,0,3,3
25864,1,2,90373,90375,90377,2,4,0
25865,1,2,90374,90377,90379,3,5,0
25866,2,2,90376,90379,90381,3,5,0
25867,6,1,90382,90382,90383,0,1,1
25868,1,2,90383,90383,90385,0,2,0
25869,3,2,90386,90386,90388,0,2,1
25870,1,2,90387,90388,90390,1,3,0
25871,3,3,90390,90390,90393,0,3,0
25872,1,3,90391,90393,90396,2,5,0
25873,2,1,90393,90396,90397,3,4,0
25874,1,3,90394,90397,90400,3,6,0
25875,2,2,90396,90400,90402,4,6,0
25876,5,1,90401,90402,90403,1,2,0
25877,1,3,90402,90403,90406,1,4,0
25878,6,1,90408,90408,90409,0,1,2
25879,5,1,90413,90413,90414,0,1,4
25880,2,3,90415,90415,90418,0,3,1
25881,2,2,90417,90418,90420,1,3,0
25882,2,2,90419,90420,90422,1,3,0
25883,6,2,90425,90425,90427,0,2,3
25884,6,1,90431,90431,90432,0,1,4
25885,5,3,90436,90436,90439,0,3,4
25886,6,1,90442,90442,90443,0,1,3
25887,3,1,90445,90445,90446,0,1,2
25888,4,3,90449,90449,90452,0,3,3
25889,1,2,90450,90452,90454,2,4,0
25890,2,3,90452,90454,90457,2,5,0
25891,6,3,90458,90458,90461,0,3,1
25892,5,1,90463,90463,90464,0,1,2
25893,4,1,90467,90467,90468,0,1,3
25894,4,3,90471,90471,90474,0,3,3
25895,2,1,90473,90474,90475,1,2,0
25896,2,3,90475,90475,90478,0,3,0
25897,4,3,90479,90479,90482,0,3,1
25898,4,1,90483,90483,90484,0,1,1
25899,3,1,90486,90486,90487,0,1,2
25900,4,2,90490,90490,90492,0,2,3
25901,5,1,90495,90495,90496,0,1,3
25902,1,1,90496,90496,90497,0,1,0
25903,1,3,90497,90497,90500,0,3,0
25904,5,2,90502,90502,90504,0,2,2
25905,3,2,90505,90505,90507,0,2,1
25906,6,2,90511,90511,90513,0,2,4
25907,6,2,90517,90517,90519,0,2,4
25908,4,2,90521,90521,90523,0,2,2
25909,5,1,90526,90526,90527,0,1,3
25910,4,1,90530,90530,90531,0,1,3
25911,3,1,90533,90533,90534,0,1,2
25912,4,3,90537,90537,90540,0,3,3
25913,3,1,90540,90540,90541,0,1,0
25914,6,2,90546,90546,90548,0,2,5
25915,5,2,90551,90551,90553,0,2,3
25916,6,1,90557,90557,90558,0,1,4
25917,5,2,90562,90562,90564,0,2,4
25918,1,1,90563,90564,90565,1,2,0
25919,3,2,90566,90566,90568,0,2,1
25920,4,3,90570,90570,90573,0,3,2
25921,2,3,90572,90573,90576,1,4,0
25922,1,2,90573,90576,90578,3,5,0
25923,2,1,90575,90578,90579,3,4,0
25924,3,1,90578,90579,90580,1,2,0
25925,3,3,90581,90581,90584,0,3,1
25926,5,3,90586,90586,90589,0,3,2
25927,6,3,90592,90592,90595,0,3,3
25928,2,3,90594,90595,90598,1,4,0
25929,1,3,90595,90598,90601,3,6,0
25930,6,2,90601,90601,90603,0,2,0
25931,2,1,90603,90603,90604,0,1,0
25932,1,1,90604,90604,90605,0,1,0
25933,1,3,90605,90605,90608,0,3,0
25934,4,1,90609,90609,90610,0,1,1
25935,6,3,90615,90615,90618,0,3,5
25936,4,3,90619,90619,90622,0,3,1
25937,5,2,90624,90624,90626,0,2,2
25938,3,1,90627,90627,90628,0,1,1
25939,1,2,90628,90628,90630,0,2,0
25940,2,3,90630,90630,90633,0,3,0
25941,3,1,90633,90633,90634,0,1,0
25942,5,3,90638,90638,90641,0,3,4
25943,4,1,90642,90642,90643,0,1,1
25944,1,1,90643,90643,90644,0,1,0
25945,2,2,90645,90645,90647,0,2,1
25946,5,2,90650,90650,90652,0,2,3
25947,5,1,90655,90655,90656,0,1,3
25948,6,2,90661,90661,90663,0,2,5
25949,5,3,90666,90666,90669,0,3,3
25950,2,1,90668,90669,90670,1,2,0
25951,3,1,90671,90671,90672,0,1,1
25952,1,3,90672,90672,90675,0,3,0
25953,2,2,90674,90675,90677,1,3,0
25954,5,1,90679,90679,90680,0,1,2
25955,1,3,90680,90680,90683,0,3,0
25956,5,2,90685,90685,90687,0,2,2
25957,5,1,90690,90690,90691,0,1,3
25958,5,2,90695,90695,90697,0,2,4
25959,3,3,90698,90698,90701,0,3,1
25960,6,2,90704,90704,90706,0,2,3
25961,5,1,90709,90709,90710,0,1,3
25962,2,2,90711,90711,90713,0,2,1
25963,4,1,90715,90715,90716,0,1,2
25964,6,3,90721,90721,90724,0,3,5
25965,5,1,90726,90726,90727,0,1,2
25966,1,1,90727,90727,90728,0,1,0
25967,6,1,90733,90733,90734,0,1,5
25968,1,2,90734,90734,90736,0,2,0
25969,2,1,90736,90736,90737,0,1,0
25970,5,2,90741,90741,90743,0,2,4
25971,1,3,90742,90743,90746,1,4,0
25972,3,2,90745,90746,90748,1,3,0
25973,3,3,90748,90748,90751,0,3,0
25974,5,1,90753,90753,90754,0,1,2
25975,2,3,90755,90755,90758,0,3,1
25976,1,1,90756,90758,90759,2,3,0
25977,6,2,90762,90762,90764,0,2,3
25978,5,3,90767,90767,90770,0,3,3
25979,4,2,90771,90771,90773,0,2,1
25980,1,2,90772,90773,90775,1,3,0
25981,5,2,90777,90777,90779,0,2,2
25982,5,1,90782,90782,90783,0,1,3
25983,3,2,90785,90785,90787,0,2,2
25984,3,2,90788,90788,90790,0,2,1
25985,5,2,90793,90793,90795,0,2,3
25986,1,2,90794,90795,90797,1,3,0
25987,2,1,90796,90797,90798,1,2,0
25988,3,1,90799,90799,90800,0,1,1
25989,1,2,90800,90800,90802,0,2,0
25990,5,1,90805,90805,90806,0,1,3
25991,5,3,90810,90810,90813,0,3,4
25992,5,3,90815,90815,90818,0,3,2
25993,4,3,90819,90819,90822,0,3,1
25994,4,2,90823,90823,90825,0,2,1
25995,5,3,90828,90828,90831,0,3,3
25996,2,2,90830,90831,90833,1,3,0
25997,5,1,90835,90835,90836,0,1,2
25998,6,1,90841,90841,90842,0,1,5
25999,1,3,90842,90842,90845,0,3,0
26000,6,3,90848,90848,90851,0,3,3
26001,3,1,90851,90851,90852,0,1,0
26002,3,2,90854,90854,90856,0,2,2
26003,4,3,90858,90858,90861,0,3,2
26004,2,2,90860,90861,90863,1,3,0
26005,3,2,90863,90863,90865,0,2,0
26006,2,1,90865,90865,90866,0,1,0
26007,3,2,90868,90868,90870,0,2,2
26008,6,1,90874,90874,90875,0,1,4
26009,1,1,90875,90875,90876,0,1,0
26010,3,2,90878,90878,90880,0,2,2
26011,2,3,90880,90880,90883,0,3,0
26012,2,1,90882,90883,90884,1,2,0
26013,3,2,90885,90885,90887,0,2,1
26014,2,3,90887,90887,90890,0,3,0
26015,6,2,90893,90893,90895,0,2,3
26016,3,1,90896,90896,90897,0,1,1
26017,3,3,90899,90899,90902,0,3,2
26018,5,3,90904,90904,90907,0,3,2
26019,3,1,90907,90907,90908,0,1,0
26020,5,2,90912,90912,90914,0,2,4
26021,3,3,90915,90915,90918,0,3,1
26022,3,3,90918,90918,90921,0,3,0
26023,5,3,90923,90923,90926,0,3,2
26024,1,2,90924,90926,90928,2,4,0
26025,5,1,90929,90929,90930,0,1,1
26026,3,2,90932,90932,90934,0,2,2
26027,3,2,90935,90935,90937,0,2,1
26028,6,3,90941,90941,90944,0,3,4
26029,6,2,90947,90947,90949,0,2,3
26030,3,3,90950,90950,90953,0,3,1
26031,6,1,90956,90956,90957,0,1,3
26032,4,2,90960,90960,90962,0,2,3
26033,2,2,90962,90962,90964,0,2,0
26034,3,3,90965,90965,90968,0,3,1
26035,2,2,90967,90968,90970,1,3,0
26036,4,1,90971,90971,90972,0,1,1
26037,2,1,90973,90973,90974,0,1,1
26038,6,3,90979,90979,90982,0,3,5
26039,1,1,90980,90982,90983,2,3,0
26040,6,2,90986,90986,90988,0,2,3
26041,3,3,90989,90989,90992,0,3,1
26042,3,3,90992,90992,90995,0,3,0
26043,4,1,90996,90996,90997,0,1,1
26044,1,1,90997,90997,90998,0,1,0
26045,2,2,90999,90999,91001,0,2,1
26046,3,1,91002,91002,91003,0,1,1
26047,5,3,91007,91007,91010,0,3,4
26048,5,2,91012,91012,91014,0,2,2
26049,1,3,91013,91014,91017,1,4,0
26050,4,3,91017,91017,91020,0,3,0
26051,2,3,91019,91020,91023,1,4,0
26052,1,2,91020,91023,91025,3,5,0
26053,6,2,91026,91026,91028,0,2,1
26054,6,2,91032,91032,91034,0,2,4
26055,1,3,91033,91034,91037,1,4,0
26056,2,3,91035,91037,91040,2,5,0
26057,4,1,91039,91040,91041,1,2,0
26058,6,1,91045,91045,91046,0,1,4
26059,2,1,91047,91047,91048,0,1,1
26060,4,3,91051,91051,91054,0,3,3
26061,1,1,91052,91054,91055,2,3,0
26062,5,3,91057,91057,91060,0,3,2
26063,3,2,91060,91060,91062,0,2,0
26064,4,3,91064,91064,91067,0,3,2
26065,3,3,91067,91067,91070,0,3,0
26066,2,1,91069,91070,91071,1,2,0
26067,3,2,91072,91072,91074,0,2,1
26068,5,1,91077,91077,91078,0,1,3
26069,3,3,91080,91080,91083,0,3,2
26070,3,1,91083,91083,91084,0,1,0
26071,4,1,91087,91087,91088,0,1,3
26072,4,1,91091,91091,91092,0,1,3
26073,2,3,91093,91093,91096,0,3,1
26074,2,3,91095,91096,91099,1,4,0
26075,2,3,91097,91099,91102,2,5,0
26076,5,1,91102,91102,91103,0,1,0
26077,2,3,91104,91104,91107,0,3,1
26078,2,3,91106,91107,91110,1,4,0
26079,3,2,91109,91110,91112,1,3,0
26080,3,1,91112,91112,91113,0,1,0
26081,4,2,91116,91116,91118,0,2,3
26082,5,1,91121,91121,91122,0,1,3
26083,3,2,91124,91124,91126,0,2,2
26084,1,1,91125,91126,91127,1,2,0
26085,2,3,91127,91127,91130,0,3,0
26086,5,2,91132,91132,91134,0,2,2
26087,5,1,91137,91137,91138,0,1,3
26088,1,3,91138,91138,91141,0,3,0
26089,2,2,91140,91141,91143,1,3,0
26090,2,1,91142,91143,91144,1,2,0
26091,3,1,91145,91145,91146,0,1,1
26092,5,3,91150,91150,91153,0,3,4
26093,1,3,91151,91153,91156,2,5,0
26094,1,1,91152,91156,91157,4,5,0
26095,2,2,91154,91157,91159,3,5,0
26096,1,1,91155,91159,91160,4,5,0
26097,5,1,91160,91160,91161,0,1,0
26098,5,1,91165,91165,91166,0,1,4
26099,5,1,91170,91170,91171,0,1,4
26100,3,3,91173,91173,91176,0,3,2
26101,4,2,91177,91177,91179,0,2,1
26102,5,1,91182,91182,91183,0,1,3
26103,4,3,91186,91186,91189,0,3,3
26104,2,3,91188,91189,91192,1,4,0
26105,1,3,91189,91192,91195,3,6,0
26106,5,3,91194,91195,91198,1,4,0
26107,6,2,91200,91200,91202,0,2,2
26108,4,2,91204,91204,91206,0,2,2
26109,3,3,91207,91207,91210,0,3,1
26110,6,2,91213,91213,91215,0,2,3
26111,6,1,91219,91219,91220,0,1,4
26112,5,2,91224,91224,91226,0,2,4
26113,3,1,91227,91227,91228,0,1,1
26114,5,2,91232,91232,91234,0,2,4
26115,2,1,91234,91234,91235,0,1,0
26116,4,1,91238,91238,91239,0,1,3
26117,2,3,91240,91240,91243,0,3,1
26118,5,2,91245,91245,91247,0,2,2
26119,6,3,91251,91251,91254,0,3,4
26120,4,3,91255,91255,91258,0,3,1
26121,5,1,91260,91260,91261,0,1,2
26122,4,2,91264,91264,91266,0,2,3
26123,3,3,91267,91267,91270,0,3,1
26124,1,1,91268,91270,91271,2,3,0
26125,4,2,91272,91272,91274,0,2,1
26126,3,3,91275,91275,91278,0,3,1
26127,5,2,91280,91280,91282,0,2,2
26128,4,2,91284,91284,91286,0,2,2
26129,1,1,91285,91286,91287,1,2,0
26130,6,2,91291,91291,91293,0,2,4
26131,4,2,91295,91295,91297,0,2,2
26132,3,1,91298,91298,91299,0,1,1
26133,6,2,91304,91304,91306,0,2,5
26134,4,1,91308,91308,91309,0,1,2
26135,5,2,91313,91313,91315,0,2,4
26136,6,2,91319,91319,91321,0,2,4
26137,5,2,91324,91324,91326,0,2,3
26138,2,1,91326,91326,91327,0,1,0
26139,3,3,91329,91329,91332,0,3,2
26140,2,3,91331,91332,91335,1,4,0
26141,2,1,91333,91335,91336,2,3,0
26142,5,3,91338,91338,91341,0,3,2
26143,1,1,91339,91341,91342,2,3,0
26144,6,1,91345,91345,91346,0,1,3
26145,6,3,91351,91351,91354,0,3,5
26146,1,1,91352,91354,91355,2,3,0
26147,3,3,91355,91355,91358,0,3,0
26148,3,2,91358,91358,91360,0,2,0
26149,3,1,91361,91361,91362,0,1,1
26150,2,1,91363,91363,91364,0,1,1
26151,4,3,91367,91367,91370,0,3,3
26152,6,1,91373,91373,91374,0,1,3
26153,3,3,91376,91376,91379,0,3,2
26154,3,2,91379,91379,91381,0,2,0
26155,6,2,91385,91385,91387,0,2,4
26156,2,2,91387,91387,91389,0,2,0
26157,6,2,91393,91393,91395,0,2,4
26158,3,3,91396,91396,91399,0,3,1
26159,1,3,91397,91399,91402,2,5,0
26160,1,2,91398,91402,91404,4,6,0
26161,3,2,91401,91404,91406,3,5,0
26162,4,2,91405,91406,91408,1,3,0
26163,1,2,91406,91408,91410,2,4,0
26164,1,2,91407,91410,91412,3,5,0
26165,4,1,91411,91412,91413,1,2,0
26166,6,3,91417,91417,91420,0,3,4
26167,3,3,91420,91420,91423,0,3,0
26168,6,3,91426,91426,91429,0,3,3
26169,6,3,91432,91432,91435,0,3,3
26170,2,1,91434,91435,91436,1,2,0
26171,6,3,91440,91440,91443,0,3,4
26172,4,2,91444,91444,91446,0,2,1
26173,5,2,91449,91449,91451,0,2,3
26174,1,2,91450,91451,91453,1,3,0
26175,2,2,91452,91453,91455,1,3,0
26176,3,2,91455,91455,91457,0,2,0
26177,1,3,91456,91457,91460,1,4,0
26178,3,1,91459,91460,91461,1,2,0
26179,3,3,91462,91462,91465,0,3,1
26180,1,1,91463,91465,91466,2,3,0
26181,1,1,91464,91466,91467,2,3,0
26182,2,3,91466,91467,91470,1,4,0
26183,3,3,91469,91470,91473,1,4,0
26184,1,2,91470,91473,91475,3,5,0
26185,4,1,91474,91475,91476,1,2,0
26186,6,3,91480,91480,91483,0,3,4
26187,6,2,91486,91486,91488,0,2,3
26188,1,1,91487,91488,91489,1,2,0
26189,1,3,91488,91489,91492,1,4,0
26190,6,3,91494,91494,91497,0,3,2
26191,3,3,91497,91497,91500,0,3,0
26192,5,3,91502,91502,91505,0,3,2
26193,3,3,91505,91505,91508,0,3,0
26194,1,3,91506,91508,91511,2,5,0
26195,1,2,91507,91511,91513,4,6,0
26196,6,1,91513,91513,91514,0,1,0
26197,6,3,91519,91519,91522,0,3,5
26198,4,2,91523,91523,91525,0,2,1
26199,6,2,91529,91529,91531,0,2,4
26200,2,2,91531,91531,91533,0,2,0
26201,3,3,91534,91534,91537,0,3,1
26202,2,3,91536,91537,91540,1,4,0
26203,3,2,91539,91540,91542,1,3,0
26204,4,3,91543,91543,91546,0,3,1
26205,6,1,91549,91549,91550,0,1,3
26206,1,2,91550,91550,91552,0,2,0
26207,5,1,91555,91555,91556,0,1,3
26208,3,2,91558,91558,91560,0,2,2
26209,4,2,91562,91562,91564,0,2,2
26210,5,1,91567,91567,91568,0,1,3
26211,1,2,91568,91568,91570,0,2,0
26212,5,2,91573,91573,91575,0,2,3
26213,1,2,91574,91575,91577,1,3,0
26214,5,2,91579,91579,91581,0,2,2
26215,5,1,91584,91584,91585,0,1,3
26216,6,3,91590,91590,91593,0,3,5
26217,5,3,91595,91595,91598,0,3,2
26218,3,1,91598,91598,91599,0,1,0
26219,3,3,91601,91601,91604,0,3,2
26220,2,1,91603,91604,91605,1,2,0
26221,6,1,91609,91609,91610,0,1,4
26222,6,2,91615,91615,91617,0,2,5
26223,5,2,91620,91620,91622,0,2,3
26224,4,1,91624,91624,91625,0,1,2
26225,5,1,91629,91629,91630,0,1,4
26226,2,3,91631,91631,91634,0,3,1
26227,4,1,91635,91635,91636,0,1,1
26228,1,1,91636,91636,91637,0,1,0
26229,2,3,91638,91638,91641,0,3,1
26230,1,2,91639,91641,91643,2,4,0
26231,6,2,91645,91645,91647,0,2,2
26232,6,3,91651,91651,91654,0,3,4
26233,4,2,91655,91655,91657,0,2,1
26234,3,3,91658,91658,91661,0,3,1
26235,6,1,91664,91664,91665,0,1,3
26236,1,1,91665,91665,91666,0,1,0
26237,6,1,91671,91671,91672,0,1,5
26238,3,3,91674,91674,91677,0,3,2
26239,1,1,91675,91677,91678,2,3,0
26240,1,3,91676,91678,91681,2,5,0
26241,5,2,91681,91681,91683,0,2,0
26242,2,1,91683,91683,91684,0,1,0
26243,4,2,91687,91687,91689,0,2,3
26244,2,3,91689,91689,91692,0,3,0
26245,1,3,91690,91692,91695,2,5,0
26246,4,2,91694,91695,91697,1,3,0
26247,1,1,91695,91697,91698,2,3,0
26248,1,1,91696,91698,91699,2,3,0
26249,6,1,91702,91702,91703,0,1,3
26250,4,3,91706,91706,91709,0,3,3
26251,3,1,91709,91709,91710,0,1,0
26252,6,1,91715,91715,91716,0,1,5
26253,2,2,91717,91717,91719,0,2,1
26254,1,1,91718,91719,91720,1,2,0
26255,4,2,91722,91722,91724,0,2,2
26256,1,3,91723,91724,91727,1,4,0
26257,6,2,91729,91729,91731,0,2,2
26258,2,2,91731,91731,91733,0,2,0
26259,3,2,91734,91734,91736,0,2,1
26260,3,1,91737,91737,91738,0,1,1
26261,1,1,91738,91738,91739,0,1,0
26262,6,1,91744,91744,91745,0,1,5
26263,4,1,91748,91748,91749,0,1,3
26264,6,2,91754,91754,91756,0,2,5
26265,2,3,91756,91756,91759,0,3,0
26266,2,1,91758,91759,91760,1,2,0
26267,3,1,91761,91761,91762,0,1,1
26268,4,3,91765,91765,91768,0,3,3
26269,1,1,91766,91768,91769,2,3,0
26270,2,3,91768,91769,91772,1,4,0
26271,6,1,91774,91774,91775,0,1,2
26272,3,2,91777,91777,91779,0,2,2
26273,3,2,91780,91780,91782,0,2,1
26274,3,3,91783,91783,91786,0,3,1
26275,6,2,91789,91789,91791,0,2,3
26276,5,3,91794,91794,91797,0,3,3
26277,6,1,91800,91800,91801,0,1,3
26278,4,1,91804,91804,91805,0,1,3
26279,1,2,91805,91805,91807,0,2,0
26280,6,1,91811,91811,91812,0,1,4
26281,4,2,91815,91815,91817,0,2,3
26282,3,2,91818,91818,91820,0,2,1
26283,1,2,91819,91820,91822,1,3,0
26284,3,1,91822,91822,91823,0,1,0
26285,2,3,91824,91824,91827,0,3,1
26286,1,3,91825,91827,91830,2,5,0
26287,6,1,91831,91831,91832,0,1,1
26288,6,2,91837,91837,91839,0,2,5
26289,4,3,91841,91841,91844,0,3,2
26290,6,3,91847,91847,91850,0,3,3
26291,2,2,91849,91850,91852,1,3,0
26292,6,1,91855,91855,91856,0,1,3
26293,5,1,91860,91860,91861,0,1,4
26294,2,1,91862,91862,91863,0,1,1
26295,2,3,91864,91864,91867,0,3,1
26296,5,1,91869,91869,91870,0,1,2
26297,6,1,91875,91875,91876,0,1,5
26298,3,3,91878,91878,91881,0,3,2
26299,5,1,91883,91883,91884,0,1,2
26300,1,2,91884,91884,91886,0,2,0
26301,3,3,91887,91887,91890,0,3,1
26302,3,2,91890,91890,91892,0,2,0
26303,5,3,91895,91895,91898,0,3,3
26304,3,1,91898,91898,91899,0,1,0
26305,5,2,91903,91903,91905,0,2,4
26306,4,1,91907,91907,91908,0,1,2
26307,2,1,91909,91909,91910,0,1,1
26308,1,1,91910,91910,91911,0,1,0
26309,6,3,91916,91916,91919,0,3,5
26310,3,1,91919,91919,91920,0,1,0
26311,6,1,91925,91925,91926,0,1,5
26312,6,3,91931,91931,91934,0,3,5
26313,2,3,91933,91934,91937,1,4,0
26314,3,1,91936,91937,91938,1,2,0
26315,3,3,91939,91939,91942,0,3,1
26316,2,2,91941,91942,91944,1,3,0
26317,2,2,91943,91944,91946,1,3,0
26318,2,2,91945,91946,91948,1,3,0
26319,6,1,91951,91951,91952,0,1,3
26320,4,3,91955,91955,91958,0,3,3
26321,4,3,91959,91959,91962,0,3,1
26322,6,1,91965,91965,91966,0,1,3
26323,4,1,91969,91969,91970,0,1,3
26324,2,2,91971,91971,91973,0,2,1
26325,5,3,91976,91976,91979,0,3,3
26326,3,1,91979,91979,91980,0,1,0
26327,4,1,91983,91983,91984,0,1,3
26328,2,1,91985,91985,91986,0,1,1
26329,2,2,91987,91987,91989,0,2,1
26330,1,3,91988,91989,91992,1,4,0
26331,1,3,91989,91992,91995,3,6,0
26332,3,3,91992,91995,91998,3,6,0
26333,5,2,91997,91998,92000,1,3,0
26334,2,1,91999,92000,92001,1,2,0
26335,5,3,92004,92004,92007,0,3,3
26336,5,1,92009,92009,92010,0,1,2
26337,6,3,92015,92015,92018,0,3,5
26338,5,2,92020,92020,92022,0,2,2
26339,5,3,92025,92025,92028,0,3,3
26340,5,1,92030,92030,92031,0,1,2
26341,3,3,92033,92033,92036,0,3,2
26342,5,1,92038,92038,92039,0,1,2
26343,6,2,92044,92044,92046,0,2,5
26344,4,3,92048,92048,92051,0,3,2
26345,5,3,92053,92053,92056,0,3,2
26346,2,1,92055,92056,92057,1,2,0
26347,5,2,92060,92060,92062,0,2,3
26348,6,1,92066,92066,92067,0,1,4
26349,5,2,92071,92071,92073,0,2,4
26350,6,1,92077,92077,92078,0,1,4
26351,4,1,92081,92081,92082,0,1,3
26352,5,1,92086,92086,92087,0,1,4
26353,3,1,92089,92089,92090,0,1,2
26354,6,2,92095,92095,92097,0,2,5
26355,5,1,92100,92100,92101,0,1,3
26356,5,1,92105,92105,92106,0,1,4
26357,2,2,92107,92107,92109,0,2,1
26358,4,1,92111,92111,92112,0,1,2
26359,4,1,92115,92115,92116,0,1,3
26360,6,1,92121,92121,92122,0,1,5
26361,5,2,92126,92126,92128,0,2,4
26362,4,1,92130,92130,92131,0,1,2
26363,1,3,92131,92131,92134,0,3,0
26364,3,2,92134,92134,92136,0,2,0
26365,2,2,92136,92136,92138,0,2,0
26366,5,1,92141,92141,92142,0,1,3
26367,5,1,92146,92146,92147,0,1,4
26368,4,1,92150,92150,92151,0,1,3
26369,3,1,92153,92153,92154,0,1,2
26370,6,2,92159,92159,92161,0,2,5
26371,6,1,92165,92165,92166,0,1,4
26372,6,3,92171,92171,92174,0,3,5
26373,1,1,92172,92174,92175,2,3,0
26374,4,1,92176,92176,92177,0,1,1
26375,4,2,92180,92180,92182,0,2,3
26376,4,1,92184,92184,92185,0,1,2
26377,5,2,92189,92189,92191,0,2,4
26378,5,1,92194,92194,92195,0,1,3
26379,3,1,92197,92197,92198,0,1,2
26380,5,1,92202,92202,92203,0,1,4
26381,5,2,92207,92207,92209,0,2,4
26382,4,1,92211,92211,92212,0,1,2
26383,6,1,92217,92217,92218,0,1,5
26384,3,1,92220,92220,92221,0,1,2
26385,1,3,92221,92221,92224,0,3,0
26386,6,3,92227,92227,92230,0,3,3
26387,5,1,92232,92232,92233,0,1,2
26388,5,2,92237,92237,92239,0,2,4
26389,5,3,92242,92242,92245,0,3,3
26390,6,3,92248,92248,92251,0,3,3
26391,4,1,92252,92252,92253,0,1,1
26392,5,3,92257,92257,92260,0,3,4
26393,2,2,92259,92260,92262,1,3,0
26394,4,1,92263,92263,92264,0,1,1
26395,2,1,92265,92265,92266,0,1,1
26396,2,3,92267,92267,92270,0,3,1
26397,2,2,92269,92270,92272,1,3,0
26398,2,3,92271,92272,92275,1,4,0
26399,3,3,92274,92275,92278,1,4,0
26400,1,3,92275,92278,92281,3,6,0
26401,3,2,92278,92281,92283,3,5,0
26402,1,3,92279,92283,92286,4,7,0
26403,1,3,92280,92286,92289,6,9,0
26404,1,2,92281,92289,92291,8,10,0
26405,1,3,92282,92291,92294,9,12,0
26406,6,1,92288,92294,92295,6,7,0
26407,2,3,92290,92295,92298,5,8,0
26408,5,3,92295,92298,92301,3,6,0
26409,3,3,92298,92301,92304,3,6,0
26410,1,1,92299,92304,92305,5,6,0
26411,1,1,92300,92305,92306,5,6,0
26412,2,1,92302,92306,92307,4,5,0
26413,3,2,92305,92307,92309,2,4,0
26414,2,1,92307,92309,92310,2,3,0
26415,6,2,92313,92313,92315,0,2,3
26416,2,3,92315,92315,92318,0,3,0
26417,4,2,92319,92319,92321,0,2,1
26418,1,2,92320,92321,92323,1,3,0
26419,5,1,92325,92325,92326,0,1,2
26420,5,2,92330,92330,92332,0,2,4
26421,5,3,92335,92335,92338,0,3,3
26422,2,3,92337,92338,92341,1,4,0
26423,4,3,92341,92341,92344,0,3,0
26424,1,1,92342,92344,92345,2,3,0
26425,1,1,92343,92345,92346,2,3,0
26426,1,2,92344,92346,92348,2,4,0
26427,1,3,92345,92348,92351,3,6,0
26428,1,3,92346,92351,92354,5,8,0
26429,1,1,92347,92354,92355,7,8,0
26430,3,2,92350,92355,92357,5,7,0
26431,3,1,92353,92357,92358,4,5,0
26432,3,2,92356,92358,92360,2,4,0
26433,1,2,92357,92360,92362,3,5,0
26434,3,1,92360,92362,92363,2,3,0
26435,1,2,92361,92363,92365,2,4,0
26436,1,2,92362,92365,92367,3,5,0
26437,1,1,92363,92367,92368,4,5,0
26438,2,2,92365,92368,92370,3,5,0
26439,3,1,92368,92370,92371,2,3,0
26440,6,3,92374,92374,92377,0,3,3
26441,6,3,92380,92380,92383,0,3,3
26442,6,3,92386,92386,92389,0,3,3
26443,1,3,92387,92389,92392,2,5,0
26444,3,3,92390,92392,92395,2,5,0
26445,2,1,92392,92395,92396,3,4,0
26446,6,2,92398,92398,92400,0,2,2
26447,1,3,92399,92400,92403,1,4,0
26448,3,3,92402,92403,92406,1,4,0
26449,1,3,92403,92406,92409,3,6,0
26450,3,3,92406,92409,92412,3,6,0
26451,5,3,92411,92412,92415,1,4,0
26452,4,1,92415,92415,92416,0,1,0
26453,2,2,92417,92417,92419,0,2,1
26454,5,2,92422,92422,92424,0,2,3
26455,4,3,92426,92426,92429,0,3,2
26456,2,1,92428,92429,92430,1,2,0
26457,5,3,92433,92433,92436,0,3,3
26458,6,3,92439,92439,92442,0,3,3
26459,3,3,92442,92442,92445,0,3,0
26460,1,3,92443,92445,92448,2,5,0
26461,5,3,92448,92448,92451,0,3,0
26462,1,1,92449,92451,92452,2,3,0
26463,4,2,92453,92453,92455,0,2,1
26464,3,2,92456,92456,92458,0,2,1
26465,1,1,92457,92458,92459,1,2,0
26466,6,2,92463,92463,92465,0,2,4
26467,6,2,92469,92469,92471,0,2,4
26468,2,2,92471,92471,92473,0,2,0
26469,3,3,92474,92474,92477,0,3,1
26470,4,2,92478,92478,92480,0,2,1
26471,5,3,92483,92483,92486,0,3,3
26472,6,1,92489,92489,92490,0,1,3
26473,4,2,92493,92493,92495,0,2,3
26474,1,3,92494,92495,92498,1,4,0
26475,4,1,92498,92498,92499,0,1,0
26476,6,1,92504,92504,92505,0,1,5
26477,3,1,92507,92507,92508,0,1,2
26478,4,2,92511,92511,92513,0,2,3
26479,1,2,92512,92513,92515,1,3,0
26480,3,2,92515,92515,92517,0,2,0
26481,1,3,92516,92517,92520,1,4,0
26482,3,2,92519,92520,92522,1,3,0
26483,3,2,92522,92522,92524,0,2,0
26484,6,1,92528,92528,92529,0,1,4
26485,3,2,92531,92531,92533,0,2,2
26486,2,1,92533,92533,92534,0,1,0
26487,4,1,92537,92537,92538,0,1,3
26488,3,2,92540,92540,92542,0,2,2
26489,1,3,92541,92542,92545,1,4,0
26490,6,1,92547,92547,92548,0,1,2
26491,2,2,92549,92549,92551,0,2,1
26492,2,1,92551,92551,92552,0,1,0
26493,6,3,92557,92557,92560,0,3,5
26494,2,3,92559,92560,92563,1,4,0
26495,2,1,92561,92563,92564,2,3,0
26496,6,1,92567,92567,92568,0,1,3
26497,6,3,92573,92573,92576,0,3,5
26498,6,1,92579,92579,92580,0,1,3
26499,4,2,92583,92583,92585,0,2,3
26500,2,1,92585,92585,92586,0,1,0
26501,1,2,92586,92586,92588,0,2,0
26502,1,3,92587,92588,92591,1,4,0
26503,3,2,92590,92591,92593,1,3,0
26504,3,2,92593,92593,92595,0,2,0
26505,6,1,92599,92599,92600,0,1,4
26506,4,1,92603,92603,92604,0,1,3
26507,4,1,92607,92607,92608,0,1,3
26508,2,2,92609,92609,92611,0,2,1
26509,5,3,92614,92614,92617,0,3,3
26510,5,3,92619,92619,92622,0,3,2
26511,6,1,92625,92625,92626,0,1,3
26512,5,1,92630,92630,92631,0,1,4
26513,1,2,92631,92631,92633,0,2,0
26514,1,3,92632,92633,92636,1,4,0
26515,3,3,92635,92636,92639,1,4,0
26516,1,1,92636,92639,92640,3,4,0
26517,5,1,92641,92641,92642,0,1,1
26518,6,3,92647,92647,92650,0,3,5
26519,1,2,92648,92650,92652,2,4,0
26520,1,2,92649,92652,92654,3,5,0
26521,6,1,92655,92655,92656,0,1,1
26522,1,3,92656,92656,92659,0,3,0
26523,2,3,92658,92659,92662,1,4,0
26524,4,2,92662,92662,92664,0,2,0
26525,3,1,92665,92665,92666,0,1,1
26526,4,1,92669,92669,92670,0,1,3
26527,4,2,92673,92673,92675,0,2,3
26528,5,3,92678,92678,92681,0,3,3
26529,4,3,92682,92682,92685,0,3,1
26530,2,3,92684,92685,92688,1,4,0
26531,1,1,92685,92688,92689,3,4,0
26532,1,3,92686,92689,92692,3,6,0
26533,6,3,92692,92692,92695,0,3,0
26534,4,3,92696,92696,92699,0,3,1
26535,3,3,92699,92699,92702,0,3,0
26536,3,2,92702,92702,92704,0,2,0
26537,3,1,92705,92705,92706,0,1,1
26538,2,3,92707,92707,92710,0,3,1
26539,6,2,92713,92713,92715,0,2,3
26540,3,3,92716,92716,92719,0,3,1
26541,5,1,92721,92721,92722,0,1,2
26542,1,3,92722,92722,92725,0,3,0
26543,4,3,92726,92726,92729,0,3,1
26544,1,1,92727,92729,92730,2,3,0
26545,1,2,92728,92730,92732,2,4,0
26546,3,1,92731,92732,92733,1,2,0
26547,2,3,92733,92733,92736,0,3,0
26548,3,3,92736,92736,92739,0,3,0
26549,3,2,92739,92739,92741,0,2,0
26550,3,2,92742,92742,92744,0,2,1
26551,4,2,92746,92746,92748,0,2,2
26552,1,3,92747,92748,92751,1,4,0
26553,6,3,92753,92753,92756,0,3,2
26554,2,2,92755,92756,92758,1,3,0
26555,6,2,92761,92761,92763,0,2,3
26556,1,2,92762,92763,92765,1,3,0
26557,5,3,92767,92767,92770,0,3,2
26558,1,2,92768,92770,92772,2,4,0
26559,3,2,92771,92772,92774,1,3,0
26560,3,1,92774,92774,92775,0,1,0
26561,4,1,92778,92778,92779,0,1,3
26562,6,3,92784,92784,92787,0,3,5
26563,3,3,92787,92787,92790,0,3,0
26564,1,3,92788,92790,92793,2,5,0
26565,1,3,92789,92793,92796,4,7,0
26566,3,2,92792,92796,92798,4,6,0
26567,5,3,92797,92798,92801,1,4,0
26568,3,2,92800,92801,92803,1,3,0
26569,2,1,92802,92803,92804,1,2,0
26570,5,1,92807,92807,92808,0,1,3
26571,3,2,92810,92810,92812,0,2,2
26572,4,2,92814,92814,92816,0,2,2
26573,1,2,92815,92816,92818,1,3,0
26574,3,1,92818,92818,92819,0,1,0
26575,5,2,92823,92823,92825,0,2,4
26576,4,2,92827,92827,92829,0,2,2
26577,4,3,92831,92831,92834,0,3,2
26578,6,2,92837,92837,92839,0,2,3
26579,6,1,92843,92843,92844,0,1,4
26580,3,1,92846,92846,92847,0,1,2
26581,6,2,92852,92852,92854,0,2,5
26582,6,1,92858,92858,92859,0,1,4
26583,4,2,92862,92862,92864,0,2,3
26584,4,1,92866,92866,92867,0,1,2
26585,2,2,92868,92868,92870,0,2,1
26586,5,3,92873,92873,92876,0,3,3
26587,1,3,92874,92876,92879,2,5,0
26588,1,3,92875,92879,92882,4,7,0
26589,3,1,92878,92882,92883,4,5,0
26590,4,2,92882,92883,92885,1,3,0
26591,3,3,92885,92885,92888,0,3,0
26592,1,2,92886,92888,92890,2,4,0
26593,2,3,92888,92890,92893,2,5,0
26594,3,1,92891,92893,92894,2,3,0
26595,4,2,92895,92895,92897,0,2,1
26596,2,3,92897,92897,92900,0,3,0
26597,2,2,92899,92900,92902,1,3,0
26598,4,2,92903,92903,92905,0,2,1
26599,5,1,92908,92908,92909,0,1,3
26600,5,1,92913,92913,92914,0,1,4
26601,3,3,92916,92916,92919,0,3,2
26602,5,1,92921,92921,92922,0,1,2
26603,4,1,92925,92925,92926,0,1,3
26604,4,3,92929,92929,92932,0,3,3
26605,6,2,92935,92935,92937,0,2,3
26606,4,2,92939,92939,92941,0,2,2
26607,6,3,92945,92945,92948,0,3,4
26608,3,2,92948,92948,92950,0,2,0
26609,3,2,92951,92951,92953,0,2,1
26610,4,3,92955,92955,92958,0,3,2
26611,4,3,92959,92959,92962,0,3,1
26612,6,2,92965,92965,92967,0,2,3
26613,3,2,92968,92968,92970,0,2,1
26614,5,1,92973,92973,92974,0,1,3
26615,2,2,92975,92975,92977,0,2,1
26616,3,1,92978,92978,92979,0,1,1
26617,5,2,92983,92983,92985,0,2,4
26618,2,1,92985,92985,92986,0,1,0
26619,5,2,92990,92990,92992,0,2,4
26620,4,2,92994,92994,92996,0,2,2
26621,5,2,92999,92999,93001,0,2,3
26622,1,3,93000,93001,93004,1,4,0
26623,6,2,93006,93006,93008,0,2,2
26624,6,2,93012,93012,93014,0,2,4
26625,1,1,93013,93014,93015,1,2,0
26626,1,1,93014,93015,93016,1,2,0
26627,3,3,93017,93017,93020,0,3,1
26628,1,2,93018,93020,93022,2,4,0
26629,6,2,93024,93024,93026,0,2,2
26630,5,2,93029,93029,93031,0,2,3
26631,2,3,93031,93031,93034,0,3,0
26632,4,2,93035,93035,93037,0,2,1
26633,4,1,93039,93039,93040,0,1,2
26634,4,2,93043,93043,93045,0,2,3
26635,5,1,93048,93048,93049,0,1,3
26636,5,2,93053,93053,93055,0,2,4
26637,6,1,93059,93059,93060,0,1,4
26638,3,2,93062,93062,93064,0,2,2
26639,4,3,93066,93066,93069,0,3,2
26640,6,3,93072,93072,93075,0,3,3
26641,5,3,93077,93077,93080,0,3,2
26642,3,1,93080,93080,93081,0,1,0
26643,1,2,93081,93081,93083,0,2,0
26644,1,1,93082,93083,93084,1,2,0
26645,3,3,93085,93085,93088,0,3,1
26646,1,1,93086,93088,93089,2,3,0
26647,2,3,93088,93089,93092,1,4,0
26648,2,2,93090,93092,93094,2,4,0
26649,5,1,93095,93095,93096,0,1,1
26650,6,2,93101,93101,93103,0,2,5
26651,1,3,93102,93103,93106,1,4,0
26652,4,1,93106,93106,93107,0,1,0
26653,5,3,93111,93111,93114,0,3,4
26654,1,3,93112,93114,93117,2,5,0
26655,1,1,93113,93117,93118,4,5,0
26656,3,2,93116,93118,93120,2,4,0
26657,4,1,93120,93120,93121,0,1,0
26658,2,2,93122,93122,93124,0,2,1
26659,6,3,93128,93128,93131,0,3,4
26660,4,3,93132,93132,93135,0,3,1
26661,2,3,93134,93135,93138,1,4,0
26662,5,2,93139,93139,93141,0,2,1
26663,5,1,93144,93144,93145,0,1,3
26664,2,2,93146,93146,93148,0,2,1
26665,4,3,93150,93150,93153,0,3,2
26666,2,2,93152,93153,93155,1,3,0
26667,2,3,93154,93155,93158,1,4,0
26668,2,3,93156,93158,93161,2,5,0
26669,2,3,93158,93161,93164,3,6,0
26670,3,1,93161,93164,93165,3,4,0
26671,3,2,93164,93165,93167,1,3,0
26672,6,2,93170,93170,93172,0,2,3
26673,6,3,93176,93176,93179,0,3,4
26674,1,1,93177,93179,93180,2,3,0
26675,1,2,93178,93180,93182,2,4,0
26676,6,2,93184,93184,93186,0,2,2
26677,2,3,93186,93186,93189,0,3,0
26678,2,3,93188,93189,93192,1,4,0
26679,1,2,93189,93192,93194,3,5,0
26680,2,1,93191,93194,93195,3,4,0
26681,4,3,93195,93195,93198,0,3,0
26682,2,3,93197,93198,93201,1,4,0
26683,3,3,93200,93201,93204,1,4,0
26684,5,2,93205,93205,93207,0,2,1
26685,6,1,93211,93211,93212,0,1,4
26686,4,2,93215,93215,93217,0,2,3
26687,6,3,93221,93221,93224,0,3,4
26688,5,3,93226,93226,93229,0,3,2
26689,4,1,93230,93230,93231,0,1,1
26690,4,2,93234,93234,93236,0,2,3
26691,2,2,93236,93236,93238,0,2,0
26692,6,2,93242,93242,93244,0,2,4
26693,1,3,93243,93244,93247,1,4,0
26694,1,3,93244,93247,93250,3,6,0
26695,1,2,93245,93250,93252,5,7,0
26696,4,3,93249,93252,93255,3,6,0
26697,4,1,93253,93255,93256,2,3,0
26698,3,1,93256,93256,93257,0,1,0
26699,3,1,93259,93259,93260,0,1,2
26700,1,1,93260,93260,93261,0,1,0
26701,6,1,93266,93266,93267,0,1,5
26702,6,1,93272,93272,93273,0,1,5
26703,5,1,93277,93277,93278,0,1,4
26704,5,3,93282,93282,93285,0,3,4
26705,5,3,93287,93287,93290,0,3,2
26706,2,3,93289,93290,93293,1,4,0
26707,6,1,93295,93295,93296,0,1,2
26708,1,2,93296,93296,93298,0,2,0
26709,3,3,93299,93299,93302,0,3,1
26710,3,3,93302,93302,93305,0,3,0
26711,5,3,93307,93307,93310,0,3,2
26712,4,3,93311,93311,93314,0,3,1
26713,1,1,93312,93314,93315,2,3,0
26714,3,1,93315,93315,93316,0,1,0
26715,1,3,93316,93316,93319,0,3,0
26716,2,3,93318,93319,93322,1,4,0
26717,2,3,93320,93322,93325,2,5,0
26718,4,3,93324,93325,93328,1,4,0
26719,6,3,93330,93330,93333,0,3,2
26720,1,3,93331,93333,93336,2,5,0
26721,4,1,93335,93336,93337,1,2,0
26722,5,1,93340,93340,93341,0,1,3
26723,2,1,93342,93342,93343,0,1,1
26724,2,2,93344,93344,93346,0,2,1
26725,3,3,93347,93347,93350,0,3,1
26726,5,1,93352,93352,93353,0,1,2
26727,4,2,93356,93356,93358,0,2,3
26728,2,1,93358,93358,93359,0,1,0
26729,5,3,93363,93363,93366,0,3,4
26730,6,1,93369,93369,93370,0,1,3
26731,5,3,93374,93374,93377,0,3,4
26732,3,2,93377,93377,93379,0,2,0
26733,3,1,93380,93380,93381,0,1,1
26734,2,2,93382,93382,93384,0,2,1
26735,5,1,93387,93387,93388,0,1,3
26736,4,1,93391,93391,93392,0,1,3
26737,2,1,93393,93393,93394,0,1,1
26738,2,1,93395,93395,93396,0,1,1
26739,5,1,93400,93400,93401,0,1,4
26740,5,2,93405,93405,93407,0,2,4
26741,1,2,93406,93407,93409,1,3,0
26742,6,1,93412,93412,93413,0,1,3
26743,5,1,93417,93417,93418,0,1,4
26744,4,3,93421,93421,93424,0,3,3
26745,3,3,93424,93424,93427,0,3,0
26746,1,3,93425,93427,93430,2,5,0
26747,2,1,93427,93430,93431,3,4,0
26748,1,2,93428,93431,93433,3,5,0
26749,6,1,93434,93434,93435,0,1,1
26750,4,2,93438,93438,93440,0,2,3
26751,5,3,93443,93443,93446,0,3,3
26752,3,2,93446,93446,93448,0,2,0
26753,2,1,93448,93448,93449,0,1,0
26754,2,2,93450,93450,93452,0,2,1
26755,4,1,93454,93454,93455,0,1,2
26756,1,1,93455,93455,93456,0,1,0
26757,3,2,93458,93458,93460,0,2,2
26758,1,2,93459,93460,93462,1,3,0
26759,3,3,93462,93462,93465,0,3,0
26760,3,2,93465,93465,93467,0,2,0
26761,5,3,93470,93470,93473,0,3,3
26762,1,2,93471,93473,93475,2,4,0
26763,2,1,93473,93475,93476,2,3,0
26764,5,3,93478,93478,93481,0,3,2
26765,6,2,93484,93484,93486,0,2,3
26766,3,1,93487,93487,93488,0,1,1
26767,5,2,93492,93492,93494,0,2,4
26768,1,2,93493,93494,93496,1,3,0
26769,3,3,93496,93496,93499,0,3,0
26770,1,2,93497,93499,93501,2,4,0
26771,3,1,93500,93501,93502,1,2,0
26772,6,2,93506,93506,93508,0,2,4
26773,6,1,93512,93512,93513,0,1,4
26774,5,3,93517,93517,93520,0,3,4
26775,1,2,93518,93520,93522,2,4,0
26776,6,3,93524,93524,93527,0,3,2
26777,2,3,93526,93527,93530,1,4,0
26778,4,2,93530,93530,93532,0,2,0
26779,6,3,93536,93536,93539,0,3,4
26780,3,2,93539,93539,93541,0,2,0
26781,2,2,93541,93541,93543,0,2,0
26782,2,2,93543,93543,93545,0,2,0
26783,1,3,93544,93545,93548,1,4,0
26784,6,1,93550,93550,93551,0,1,2
26785,2,2,93552,93552,93554,0,2,1
26786,3,2,93555,93555,93557,0,2,1
26787,6,1,93561,93561,93562,0,1,4
26788,6,1,93567,93567,93568,0,1,5
26789,1,3,93568,93568,93571,0,3,0
26790,6,1,93574,93574,93575,0,1,3
26791,2,1,93576,93576,93577,0,1,1
26792,6,1,93582,93582,93583,0,1,5
26793,1,2,93583,93583,93585,0,2,0
26794,6,3,93589,93589,93592,0,3,4
26795,2,1,93591,93592,93593,1,2,0
26796,3,2,93594,93594,93596,0,2,1
26797,3,3,93597,93597,93600,0,3,1
26798,5,3,93602,93602,93605,0,3,2
26799,2,3,93604,93605,93608,1,4,0
26800,6,2,93610,93610,93612,0,2,2
26801,5,1,93615,93615,93616,0,1,3
26802,6,2,93621,93621,93623,0,2,5
26803,5,3,93626,93626,93629,0,3,3
26804,4,2,93630,93630,93632,0,2,1
26805,4,3,93634,93634,93637,0,3,2
26806,6,2,93640,93640,93642,0,2,3
26807,1,2,93641,93642,93644,1,3,0
26808,3,1,93644,93644,93645,0,1,0
26809,3,1,93647,93647,93648,0,1,2
26810,4,3,93651,93651,93654,0,3,3
26811,5,1,93656,93656,93657,0,1,2
26812,3,2,93659,93659,93661,0,2,2
26813,1,2,93660,93661,93663,1,3,0
26814,4,2,93664,93664,93666,0,2,1
26815,1,1,93665,93666,93667,1,2,0
26816,2,2,93667,93667,93669,0,2,0
26817,4,3,93671,93671,93674,0,3,2
26818,5,1,93676,93676,93677,0,1,2
26819,6,1,93682,93682,93683,0,1,5
26820,2,2,93684,93684,93686,0,2,1
26821,4,1,93688,93688,93689,0,1,2
26822,4,3,93692,93692,93695,0,3,3
26823,5,1,93697,93697,93698,0,1,2
26824,1,1,93698,93698,93699,0,1,0
26825,4,2,93702,93702,93704,0,2,3
26826,1,2,93703,93704,93706,1,3,0
26827,4,1,93707,93707,93708,0,1,1
26828,1,2,93708,93708,93710,0,2,0
26829,4,3,93712,93712,93715,0,3,2
26830,1,1,93713,93715,93716,2,3,0
26831,2,3,93715,93716,93719,1,4,0
26832,1,1,93716,93719,93720,3,4,0
26833,2,2,93718,93720,93722,2,4,0
26834,5,3,93723,93723,93726,0,3,1
26835,5,2,93728,93728,93730,0,2,2
26836,6,3,93734,93734,93737,0,3,4
26837,4,2,93738,93738,93740,0,2,1
26838,3,1,93741,93741,93742,0,1,1
26839,2,2,93743,93743,93745,0,2,1
26840,2,2,93745,93745,93747,0,2,0
26841,5,2,93750,93750,93752,0,2,3
26842,5,2,93755,93755,93757,0,2,3
26843,5,3,93760,93760,93763,0,3,3
26844,1,2,93761,93763,93765,2,4,0
26845,2,2,93763,93765,93767,2,4,0
26846,5,2,93768,93768,93770,0,2,1
26847,4,3,93772,93772,93775,0,3,2
26848,5,2,93777,93777,93779,0,2,2
26849,3,1,93780,93780,93781,0,1,1
26850,2,2,93782,93782,93784,0,2,1
26851,4,1,93786,93786,93787,0,1,2
26852,2,1,93788,93788,93789,0,1,1
26853,2,1,93790,93790,93791,0,1,1
26854,5,3,93795,93795,93798,0,3,4
26855,5,1,93800,93800,93801,0,1,2
26856,1,1,93801,93801,93802,0,1,0
26857,6,3,93807,93807,93810,0,3,5
26858,1,1,93808,93810,93811,2,3,0
26859,6,1,93814,93814,93815,0,1,3
26860,3,1,93817,93817,93818,0,1,2
26861,3,3,93820,93820,93823,0,3,2
26862,5,1,93825,93825,93826,0,1,2
26863,3,1,93828,93828,93829,0,1,2
26864,1,1,93829,93829,93830,0,1,0
26865,2,1,93831,93831,93832,0,1,1
26866,1,2,93832,93832,93834,0,2,0
26867,1,2,93833,93834,93836,1,3,0
26868,6,2,93839,93839,93841,0,2,3
26869,1,1,93840,93841,93842,1,2,0
26870,5,2,93845,93845,93847,0,2,3
26871,5,2,93850,93850,93852,0,2,3
26872,3,1,93853,93853,93854,0,1,1
26873,5,1,93858,93858,93859,0,1,4
26874,3,1,93861,93861,93862,0,1,2
26875,4,1,93865,93865,93866,0,1,3
26876,5,2,93870,93870,93872,0,2,4
26877,1,2,93871,93872,93874,1,3,0
26878,5,2,93876,93876,93878,0,2,2
26879,1,3,93877,93878,93881,1,4,0
26880,4,3,93881,93881,93884,0,3,0
26881,3,1,93884,93884,93885,0,1,0
26882,3,3,93887,93887,93890,0,3,2
26883,3,1,93890,93890,93891,0,1,0
26884,2,3,93892,93892,93895,0,3,1
26885,1,1,93893,93895,93896,2,3,0
26886,2,3,93895,93896,93899,1,4,0
26887,1,1,93896,93899,93900,3,4,0
26888,4,2,93900,93900,93902,0,2,0
26889,2,1,93902,93902,93903,0,1,0
26890,6,1,93908,93908,93909,0,1,5
26891,5,1,93913,93913,93914,0,1,4
26892,2,2,93915,93915,93917,0,2,1
26893,5,2,93920,93920,93922,0,2,3
26894,3,3,93923,93923,93926,0,3,1
26895,5,2,93928,93928,93930,0,2,2
26896,5,3,93933,93933,93936,0,3,3
26897,4,1,93937,93937,93938,0,1,1
26898,2,1,93939,93939,93940,0,1,1
26899,1,1,93940,93940,93941,0,1,0
26900,6,2,93946,93946,93948,0,2,5
26901,4,3,93950,93950,93953,0,3,2
26902,3,2,93953,93953,93955,0,2,0
26903,5,2,93958,93958,93960,0,2,3
26904,6,1,93964,93964,93965,0,1,4
26905,3,3,93967,93967,93970,0,3,2
26906,4,2,93971,93971,93973,0,2,1
26907,6,1,93977,93977,93978,0,1,4
26908,6,2,93983,93983,93985,0,2,5
26909,1,3,93984,93985,93988,1,4,0
26910,6,2,93990,93990,93992,0,2,2
26911,6,2,93996,93996,93998,0,2,4
26912,6,3,94002,94002,94005,0,3,4
26913,1,1,94003,94005,94006,2,3,0
26914,2,2,94005,94006,94008,1,3,0
26915,1,3,94006,94008,94011,2,5,0
26916,6,2,94012,94012,94014,0,2,1
26917,2,3,94014,94014,94017,0,3,0
26918,3,2,94017,94017,94019,0,2,0
26919,6,3,94023,94023,94026,0,3,4
26920,5,2,94028,94028,94030,0,2,2
26921,2,2,94030,94030,94032,0,2,0
26922,1,3,94031,94032,94035,1,4,0
26923,1,3,94032,94035,94038,3,6,0
26924,6,1,94038,94038,94039,0,1,0
26925,2,1,94040,94040,94041,0,1,1
26926,2,2,94042,94042,94044,0,2,1
26927,5,1,94047,94047,94048,0,1,3
26928,3,2,94050,94050,94052,0,2,2
26929,1,1,94051,94052,94053,1,2,0
26930,2,1,94053,94053,94054,0,1,0
26931,2,3,94055,94055,94058,0,3,1
26932,1,1,94056,94058,94059,2,3,0
26933,6,3,94062,94062,94065,0,3,3
26934,1,3,94063,94065,94068,2,5,0
26935,4,3,94067,94068,94071,1,4,0
26936,4,1,94071,94071,94072,0,1,0
26937,2,3,94073,94073,94076,0,3,1
26938,2,3,94075,94076,94079,1,4,0
26939,2,3,94077,94079,94082,2,5,0
26940,5,1,94082,94082,94083,0,1,0
26941,5,3,94087,94087,94090,0,3,4
26942,1,1,94088,94090,94091,2,3,0
26943,5,3,94093,94093,94096,0,3,2
26944,3,1,94096,94096,94097,0,1,0
26945,5,1,94101,94101,94102,0,1,4
26946,5,2,94106,94106,94108,0,2,4
26947,2,2,94108,94108,94110,0,2,0
26948,3,2,94111,94111,94113,0,2,1
26949,1,1,94112,94113,94114,1,2,0
26950,1,1,94113,94114,94115,1,2,0
26951,1,1,94114,94115,94116,1,2,0
26952,4,3,94118,94118,94121,0,3,2
26953,1,3,94119,94121,94124,2,5,0
26954,2,2,94121,94124,94126,3,5,0
26955,2,2,94123,94126,94128,3,5,0
26956,3,3,94126,94128,94131,2,5,0
26957,6,3,94132,94132,94135,0,3,1
26958,1,1,94133,94135,94136,2,3,0
26959,6,2,94139,94139,94141,0,2,3
26960,1,1,94140,94141,94142,1,2,0
26961,3,3,94143,94143,94146,0,3,1
26962,2,2,94145,94146,94148,1,3,0
26963,4,2,94149,94149,94151,0,2,1
26964,5,2,94154,94154,94156,0,2,3
26965,1,1,94155,94156,94157,1,2,0
26966,2,2,94157,94157,94159,0,2,0
26967,5,1,94162,94162,94163,0,1,3
26968,4,3,94166,94166,94169,0,3,3
26969,5,3,94171,94171,94174,0,3,2
26970,1,2,94172,94174,94176,2,4,0
26971,3,1,94175,94176,94177,1,2,0
26972,1,1,94176,94177,94178,1,2,0
26973,1,3,94177,94178,94181,1,4,0
26974,2,2,94179,94181,94183,2,4,0
26975,6,2,94185,94185,94187,0,2,2
26976,6,3,94191,94191,94194,0,3,4
26977,2,3,94193,94194,94197,1,4,0
26978,3,2,94196,94197,94199,1,3,0
26979,4,2,94200,94200,94202,0,2,1
26980,4,2,94204,94204,94206,0,2,2
26981,2,2,94206,94206,94208,0,2,0
26982,1,2,94207,94208,94210,1,3,0
26983,6,2,94213,94213,94215,0,2,3
26984,2,1,94215,94215,94216,0,1,0
26985,4,1,94219,94219,94220,0,1,3
26986,4,2,94223,94223,94225,0,2,3
26987,1,1,94224,94225,94226,1,2,0
26988,1,3,94225,94226,94229,1,4,0
26989,5,2,94230,94230,94232,0,2,1
26990,4,3,94234,94234,94237,0,3,2
26991,4,3,94238,94238,94241,0,3,1
26992,4,1,94242,94242,94243,0,1,1
26993,6,1,94248,94248,94249,0,1,5
26994,1,2,94249,94249,94251,0,2,0
26995,6,1,94255,94255,94256,0,1,4
26996,6,3,94261,94261,94264,0,3,5
26997,5,3,94266,94266,94269,0,3,2
26998,5,2,94271,94271,94273,0,2,2
26999,1,3,94272,94273,94276,1,4,0
27000,6,3,94278,94278,94281,0,3,2
27001,5,3,94283,94283,94286,0,3,2
27002,2,3,94285,94286,94289,1,4,0
27003,6,3,94291,94291,94294,0,3,2
27004,1,1,94292,94294,94295,2,3,0
27005,6,1,94298,94298,94299,0,1,3
27006,1,1,94299,94299,94300,0,1,0
27007,5,1,94304,94304,94305,0,1,4
27008,3,3,94307,94307,94310,0,3,2
27009,6,3,94313,94313,94316,0,3,3
27010,2,2,94315,94316,94318,1,3,0
27011,6,1,94321,94321,94322,0,1,3
27012,5,1,94326,94326,94327,0,1,4
27013,1,2,94327,94327,94329,0,2,0
27014,2,2,94329,94329,94331,0,2,0
27015,1,1,94330,94331,94332,1,2,0
27016,4,1,94334,94334,94335,0,1,2
27017,3,1,94337,94337,94338,0,1,2
27018,6,1,94343,94343,94344,0,1,5
27019,5,1,94348,94348,94349,0,1,4
27020,3,2,94351,94351,94353,0,2,2
27021,3,2,94354,94354,94356,0,2,1
27022,2,1,94356,94356,94357,0,1,0
27023,4,2,94360,94360,94362,0,2,3
27024,6,3,94366,94366,94369,0,3,4
27025,2,3,94368,94369,94372,1,4,0
27026,2,1,94370,94372,94373,2,3,0
27027,4,3,94374,94374,94377,0,3,1
27028,2,2,94376,94377,94379,1,3,0
27029,5,1,94381,94381,94382,0,1,2
27030,1,1,94382,94382,94383,0,1,0
27031,6,1,94388,94388,94389,0,1,5
27032,1,2,94389,94389,94391,0,2,0
27033,4,3,94393,94393,94396,0,3,2
27034,5,2,94398,94398,94400,0,2,2
27035,3,2,94401,94401,94403,0,2,1
27036,5,3,94406,94406,94409,0,3,3
27037,2,1,94408,94409,94410,1,2,0
27038,2,3,94410,94410,94413,0,3,0
27039,6,2,94416,94416,94418,0,2,3
27040,3,3,94419,94419,94422,0,3,1
27041,4,2,94423,94423,94425,0,2,1
27042,6,1,94429,94429,94430,0,1,4
27043,2,1,94431,94431,94432,0,1,1
27044,4,3,94435,94435,94438,0,3,3
27045,1,3,94436,94438,94441,2,5,0
27046,5,2,94441,94441,94443,0,2,0
27047,5,1,94446,94446,94447,0,1,3
27048,5,1,94451,94451,94452,0,1,4
27049,3,1,94454,94454,94455,0,1,2
27050,4,2,94458,94458,94460,0,2,3
27051,6,3,94464,94464,94467,0,3,4
27052,3,2,94467,94467,94469,0,2,0
27053,3,1,94470,94470,94471,0,1,1
27054,3,3,94473,94473,94476,0,3,2
27055,1,1,94474,94476,94477,2,3,0
27056,4,3,94478,94478,94481,0,3,1
27057,3,3,94481,94481,94484,0,3,0
27058,1,1,94482,94484,94485,2,3,0
27059,5,3,94487,94487,94490,0,3,2
27060,3,3,94490,94490,94493,0,3,0
27061,1,1,94491,94493,94494,2,3,0
27062,3,3,94494,94494,94497,0,3,0
27063,6,2,94500,94500,94502,0,2,3
27064,4,2,94504,94504,94506,0,2,2
27065,1,1,94505,94506,94507,1,2,0
27066,1,2,94506,94507,94509,1,3,0
27067,1,2,94507,94509,94511,2,4,0
27068,3,1,94510,94511,94512,1,2,0
27069,3,3,94513,94513,94516,0,3,1
27070,3,1,94516,94516,94517,0,1,0
27071,2,1,94518,94518,94519,0,1,1
27072,4,2,94522,94522,94524,0,2,3
27073,6,1,94528,94528,94529,0,1,4
27074,5,2,94533,94533,94535,0,2,4
27075,2,1,94535,94535,94536,0,1,0
27076,3,3,94538,94538,94541,0,3,2
27077,3,2,94541,94541,94543,0,2,0
27078,6,2,94547,94547,94549,0,2,4
27079,6,3,94553,94553,94556,0,3,4
27080,2,1,94555,94556,94557,1,2,0
27081,6,3,94561,94561,94564,0,3,4
27082,5,3,94566,94566,94569,0,3,2
27083,4,1,94570,94570,94571,0,1,1
27084,2,1,94572,94572,94573,0,1,1
27085,5,1,94577,94577,94578,0,1,4
27086,6,3,94583,94583,94586,0,3,5
27087,4,1,94587,94587,94588,0,1,1
27088,4,3,94591,94591,94594,0,3,3
27089,5,1,94596,94596,94597,0,1,2
27090,5,2,94601,94601,94603,0,2,4
27091,3,2,94604,94604,94606,0,2,1
27092,1,3,94605,94606,94609,1,4,0
27093,1,1,94606,94609,94610,3,4,0
27094,5,3,94611,94611,94614,0,3,1
27095,1,2,94612,94614,94616,2,4,0
27096,1,3,94613,94616,94619,3,6,0
27097,3,1,94616,94619,94620,3,4,0
27098,6,1,94622,94622,94623,0,1,2
27099,1,2,94623,94623,94625,0,2,0
27100,5,1,94628,94628,94629,0,1,3
27101,6,3,94634,94634,94637,0,3,5
27102,6,3,94640,94640,94643,0,3,3
27103,5,2,94645,94645,94647,0,2,2
27104,5,2,94650,94650,94652,0,2,3
27105,5,3,94655,94655,94658,0,3,3
27106,1,2,94656,94658,94660,2,4,0
27107,3,3,94659,94660,94663,1,4,0
27108,1,3,94660,94663,94666,3,6,0
27109,1,1,94661,94666,94667,5,6,0
27110,5,3,94666,94667,94670,1,4,0
27111,2,2,94668,94670,94672,2,4,0
27112,5,2,94673,94673,94675,0,2,1
27113,5,3,94678,94678,94681,0,3,3
27114,2,3,94680,94681,94684,1,4,0
27115,6,2,94686,94686,94688,0,2,2
27116,5,3,94691,94691,94694,0,3,3
27117,3,1,94694,94694,94695,0,1,0
27118,3,3,94697,94697,94700,0,3,2
27119,5,2,94702,94702,94704,0,2,2
27120,2,3,94704,94704,94707,0,3,0
27121,3,2,94707,94707,94709,0,2,0
27122,3,1,94710,94710,94711,0,1,1
27123,6,2,94716,94716,94718,0,2,5
27124,3,2,94719,94719,94721,0,2,1
27125,1,1,94720,94721,94722,1,2,0
27126,1,3,94721,94722,94725,1,4,0
27127,5,3,94726,94726,94729,0,3,1
27128,6,1,94732,94732,94733,0,1,3
27129,3,1,94735,94735,94736,0,1,2
27130,1,1,94736,94736,94737,0,1,0
27131,2,3,94738,94738,94741,0,3,1
27132,6,1,94744,94744,94745,0,1,3
27133,3,2,94747,94747,94749,0,2,2
27134,5,3,94752,94752,94755,0,3,3
27135,6,3,94758,94758,94761,0,3,3
27136,5,3,94763,94763,94766,0,3,2
27137,1,3,94764,94766,94769,2,5,0
27138,5,3,94769,94769,94772,0,3,0
27139,5,1,94774,94774,94775,0,1,2
27140,6,3,94780,94780,94783,0,3,5
27141,2,2,94782,94783,94785,1,3,0
27142,4,3,94786,94786,94789,0,3,1
27143,4,2,94790,94790,94792,0,2,1
27144,2,2,94792,94792,94794,0,2,0
27145,2,2,94794,94794,94796,0,2,0
27146,5,3,94799,94799,94802,0,3,3
27147,6,3,94805,94805,94808,0,3,3
27148,2,1,94807,94808,94809,1,2,0
27149,3,3,94810,94810,94813,0,3,1
27150,5,2,94815,94815,94817,0,2,2
27151,1,1,94816,94817,94818,1,2,0
27152,5,2,94821,94821,94823,0,2,3
27153,2,3,94823,94823,94826,0,3,0
27154,2,2,94825,94826,94828,1,3,0
27155,1,2,94826,94828,94830,2,4,0
27156,5,3,94831,94831,94834,0,3,1
27157,1,2,94832,94834,94836,2,4,0
27158,1,2,94833,94836,94838,3,5,0
27159,3,1,94836,94838,94839,2,3,0
27160,4,3,94840,94840,94843,0,3,1
27161,3,2,94843,94843,94845,0,2,0
27162,1,1,94844,94845,94846,1,2,0
27163,5,3,94849,94849,94852,0,3,3
27164,3,3,94852,94852,94855,0,3,0
27165,1,3,94853,94855,94858,2,5,0
27166,5,2,94858,94858,94860,0,2,0
27167,2,3,94860,94860,94863,0,3,0
27168,4,2,94864,94864,94866,0,2,1
27169,3,2,94867,94867,94869,0,2,1
27170,6,3,94873,94873,94876,0,3,4
27171,3,2,94876,94876,94878,0,2,0
27172,6,1,94882,94882,94883,0,1,4
27173,4,3,94886,94886,94889,0,3,3
27174,4,1,94890,94890,94891,0,1,1
27175,4,2,94894,94894,94896,0,2,3
27176,6,2,94900,94900,94902,0,2,4
27177,2,3,94902,94902,94905,0,3,0
27178,1,1,94903,94905,94906,2,3,0
27179,4,2,94907,94907,94909,0,2,1
27180,6,3,94913,94913,94916,0,3,4
27181,5,1,94918,94918,94919,0,1,2
27182,1,2,94919,94919,94921,0,2,0
27183,1,1,94920,94921,94922,1,2,0
27184,4,1,94924,94924,94925,0,1,2
27185,1,2,94925,94925,94927,0,2,0
27186,4,2,94929,94929,94931,0,2,2
27187,2,2,94931,94931,94933,0,2,0
27188,1,2,94932,94933,94935,1,3,0
27189,1,1,94933,94935,94936,2,3,0
27190,4,2,94937,94937,94939,0,2,1
27191,1,1,94938,94939,94940,1,2,0
27192,5,2,94943,94943,94945,0,2,3
27193,6,3,94949,94949,94952,0,3,4
27194,3,1,94952,94952,94953,0,1,0
27195,5,1,94957,94957,94958,0,1,4
27196,2,3,94959,94959,94962,0,3,1
27197,4,1,94963,94963,94964,0,1,1
27198,3,1,94966,94966,94967,0,1,2
27199,2,2,94968,94968,94970,0,2,1
27200,3,1,94971,94971,94972,0,1,1
27201,2,3,94973,94973,94976,0,3,1
27202,6,2,94979,94979,94981,0,2,3
27203,2,2,94981,94981,94983,0,2,0
27204,4,1,94985,94985,94986,0,1,2
27205,6,3,94991,94991,94994,0,3,5
27206,1,1,94992,94994,94995,2,3,0
27207,4,3,94996,94996,94999,0,3,1
27208,4,3,95000,95000,95003,0,3,1
27209,4,3,95004,95004,95007,0,3,1
27210,3,2,95007,95007,95009,0,2,0
27211,5,1,95012,95012,95013,0,1,3
27212,4,2,95016,95016,95018,0,2,3
27213,2,1,95018,95018,95019,0,1,0
27214,1,1,95019,95019,95020,0,1,0
27215,4,2,95023,95023,95025,0,2,3
27216,3,2,95026,95026,95028,0,2,1
27217,1,2,95027,95028,95030,1,3,0
27218,3,2,95030,95030,95032,0,2,0
27219,2,2,95032,95032,95034,0,2,0
27220,2,3,95034,95034,95037,0,3,0
27221,5,3,95039,95039,95042,0,3,2
27222,1,1,95040,95042,95043,2,3,0
27223,2,3,95042,95043,95046,1,4,0
27224,2,2,95044,95046,95048,2,4,0
27225,4,2,95048,95048,95050,0,2,0
27226,1,2,95049,95050,95052,1,3,0
27227,6,3,95055,95055,95058,0,3,3
27228,3,2,95058,95058,95060,0,2,0
27229,3,1,95061,95061,95062,0,1,1
27230,2,1,95063,95063,95064,0,1,1
27231,3,1,95066,95066,95067,0,1,2
27232,3,1,95069,95069,95070,0,1,2
27233,3,2,95072,95072,95074,0,2,2
27234,3,2,95075,95075,95077,0,2,1
27235,5,2,95080,95080,95082,0,2,3
27236,2,1,95082,95082,95083,0,1,0
27237,2,3,95084,95084,95087,0,3,1
27238,2,3,95086,95087,95090,1,4,0
27239,1,1,95087,95090,95091,3,4,0
27240,5,1,95092,95092,95093,0,1,1
27241,1,3,95093,95093,95096,0,3,0
27242,5,2,95098,95098,95100,0,2,2
27243,1,3,95099,95100,95103,1,4,0
27244,2,2,95101,95103,95105,2,4,0
27245,2,1,95103,95105,95106,2,3,0
27246,4,1,95107,95107,95108,0,1,1
27247,2,2,95109,95109,95111,0,2,1
27248,1,3,95110,95111,95114,1,4,0
27249,6,2,95116,95116,95118,0,2,2
27250,3,1,95119,95119,95120,0,1,1
27251,3,2,95122,95122,95124,0,2,2
27252,2,1,95124,95124,95125,0,1,0
27253,2,3,95126,95126,95129,0,3,1
27254,2,1,95128,95129,95130,1,2,0
27255,1,2,95129,95130,95132,1,3,0
27256,3,3,95132,95132,95135,0,3,0
27257,1,3,95133,95135,95138,2,5,0
27258,2,3,95135,95138,95141,3,6,0
27259,2,3,95137,95141,95144,4,7,0
27260,2,1,95139,95144,95145,5,6,0
27261,3,3,95142,95145,95148,3,6,0
27262,4,2,95146,95148,95150,2,4,0
27263,1,3,95147,95150,95153,3,6,0
27264,2,1,95149,95153,95154,4,5,0
27265,1,1,95150,95154,95155,4,5,0
27266,6,3,95156,95156,95159,0,3,1
27267,1,2,95157,95159,95161,2,4,0
27268,1,3,95158,95161,95164,3,6,0
27269,1,3,95159,95164,95167,5,8,0
27270,3,2,95162,95167,95169,5,7,0
27271,3,1,95165,95169,95170,4,5,0
27272,3,3,95168,95170,95173,2,5,0
27273,2,1,95170,95173,95174,3,4,0
27274,2,2,95172,95174,95176,2,4,0
27275,4,3,95176,95176,95179,0,3,0
27276,5,3,95181,95181,95184,0,3,2
27277,4,1,95185,95185,95186,0,1,1
27278,6,2,95191,95191,95193,0,2,5
27279,3,3,95194,95194,95197,0,3,1
27280,6,1,95200,95200,95201,0,1,3
27281,5,1,95205,95205,95206,0,1,4
27282,6,3,95211,95211,95214,0,3,5
27283,6,2,95217,95217,95219,0,2,3
27284,1,3,95218,95219,95222,1,4,0
27285,5,2,95223,95223,95225,0,2,1
27286,1,2,95224,95225,95227,1,3,0
27287,3,2,95227,95227,95229,0,2,0
27288,6,3,95233,95233,95236,0,3,4
27289,4,1,95237,95237,95238,0,1,1
27290,5,2,95242,95242,95244,0,2,4
27291,3,3,95245,95245,95248,0,3,1
27292,5,3,95250,95250,95253,0,3,2
27293,2,1,95252,95253,95254,1,2,0
27294,4,1,95256,95256,95257,0,1,2
27295,4,3,95260,95260,95263,0,3,3
27296,4,3,95264,95264,95267,0,3,1
27297,3,1,95267,95267,95268,0,1,0
27298,4,1,95271,95271,95272,0,1,3
27299,4,3,95275,95275,95278,0,3,3
27300,1,3,95276,95278,95281,2,5,0
27301,5,3,95281,95281,95284,0,3,0
27302,2,3,95283,95284,95287,1,4,0
27303,1,2,95284,95287,95289,3,5,0
27304,5,2,95289,95289,95291,0,2,0
27305,2,2,95291,95291,95293,0,2,0
27306,5,3,95296,95296,95299,0,3,3
27307,4,1,95300,95300,95301,0,1,1
27308,3,2,95303,95303,95305,0,2,2
27309,6,2,95309,95309,95311,0,2,4
27310,1,2,95310,95311,95313,1,3,0
27311,3,2,95313,95313,95315,0,2,0
27312,2,1,95315,95315,95316,0,1,0
27313,3,1,95318,95318,95319,0,1,2
27314,4,1,95322,95322,95323,0,1,3
27315,1,3,95323,95323,95326,0,3,0
27316,6,3,95329,95329,95332,0,3,3
27317,2,3,95331,95332,95335,1,4,0
27318,1,3,95332,95335,95338,3,6,0
27319,2,2,95334,95338,95340,4,6,0
27320,5,2,95339,95340,95342,1,3,0
27321,3,2,95342,95342,95344,0,2,0
27322,6,2,95348,95348,95350,0,2,4
27323,5,3,95353,95353,95356,0,3,3
27324,1,3,95354,95356,95359,2,5,0
27325,3,1,95357,95359,95360,2,3,0
27326,2,3,95359,95360,95363,1,4,0
27327,5,3,95364,95364,95367,0,3,1
27328,6,1,95370,95370,95371,0,1,3
27329,1,2,95371,95371,95373,0,2,0
27330,6,3,95377,95377,95380,0,3,4
27331,1,1,95378,95380,95381,2,3,0
27332,1,2,95379,95381,95383,2,4,0
27333,4,1,95383,95383,95384,0,1,0
27334,6,3,95389,95389,95392,0,3,5
27335,5,2,95394,95394,95396,0,2,2
27336,6,3,95400,95400,95403,0,3,4
27337,5,2,95405,95405,95407,0,2,2
27338,2,1,95407,95407,95408,0,1,0
27339,1,2,95408,95408,95410,0,2,0
27340,3,2,95411,95411,95413,0,2,1
27341,2,1,95413,95413,95414,0,1,0
27342,6,3,95419,95419,95422,0,3,5
27343,6,3,95425,95425,95428,0,3,3
27344,6,3,95431,95431,95434,0,3,3
27345,6,2,95437,95437,95439,0,2,3
27346,6,2,95443,95443,95445,0,2,4
27347,6,3,95449,95449,95452,0,3,4
27348,6,3,95455,95455,95458,0,3,3
27349,5,3,95460,95460,95463,0,3,2
27350,4,3,95464,95464,95467,0,3,1
27351,3,1,95467,95467,95468,0,1,0
27352,1,1,95468,95468,95469,0,1,0
27353,4,2,95472,95472,95474,0,2,3
27354,3,2,95475,95475,95477,0,2,1
27355,6,1,95481,95481,95482,0,1,4
27356,1,1,95482,95482,95483,0,1,0
27357,3,2,95485,95485,95487,0,2,2
27358,5,3,95490,95490,95493,0,3,3
27359,6,2,95496,95496,95498,0,2,3
27360,5,3,95501,95501,95504,0,3,3
27361,5,3,95506,95506,95509,0,3,2
27362,2,1,95508,95509,95510,1,2,0
27363,1,3,95509,95510,95513,1,4,0
27364,1,2,95510,95513,95515,3,5,0
27365,4,2,95514,95515,95517,1,3,0
27366,2,1,95516,95517,95518,1,2,0
27367,1,2,95517,95518,95520,1,3,0
27368,6,3,95523,95523,95526,0,3,3
27369,5,1,95528,95528,95529,0,1,2
27370,5,1,95533,95533,95534,0,1,4
27371,4,1,95537,95537,95538,0,1,3
27372,4,3,95541,95541,95544,0,3,3
27373,2,1,95543,95544,95545,1,2,0
27374,4,2,95547,95547,95549,0,2,2
27375,1,1,95548,95549,95550,1,2,0
27376,1,1,95549,95550,95551,1,2,0
27377,2,1,95551,95551,95552,0,1,0
27378,6,3,95557,95557,95560,0,3,5
27379,4,3,95561,95561,95564,0,3,1
27380,2,1,95563,95564,95565,1,2,0
27381,3,3,95566,95566,95569,0,3,1
27382,2,1,95568,95569,95570,1,2,0
27383,1,3,95569,95570,95573,1,4,0
27384,5,1,95574,95574,95575,0,1,1
27385,3,3,95577,95577,95580,0,3,2
27386,6,3,95583,95583,95586,0,3,3
27387,3,2,95586,95586,95588,0,2,0
27388,6,3,95592,95592,95595,0,3,4
27389,4,3,95596,95596,95599,0,3,1
27390,6,3,95602,95602,95605,0,3,3
27391,6,2,95608,95608,95610,0,2,3
27392,2,2,95610,95610,95612,0,2,0
27393,6,1,95616,95616,95617,0,1,4
27394,3,1,95619,95619,95620,0,1,2
27395,1,2,95620,95620,95622,0,2,0
27396,6,2,95626,95626,95628,0,2,4
27397,2,2,95628,95628,95630,0,2,0
27398,2,2,95630,95630,95632,0,2,0
27399,1,1,95631,95632,95633,1,2,0
27400,5,2,95636,95636,95638,0,2,3
27401,2,3,95638,95638,95641,0,3,0
27402,5,3,95643,95643,95646,0,3,2
27403,2,3,95645,95646,95649,1,4,0
27404,5,3,95650,95650,95653,0,3,1
27405,5,3,95655,95655,95658,0,3,2
27406,4,3,95659,95659,95662,0,3,1
27407,5,2,95664,95664,95666,0,2,2
27408,1,2,95665,95666,95668,1,3,0
27409,6,1,95671,95671,95672,0,1,3
27410,4,2,95675,95675,95677,0,2,3
27411,1,1,95676,95677,95678,1,2,0
27412,3,3,95679,95679,95682,0,3,1
27413,5,2,95684,95684,95686,0,2,2
27414,6,1,95690,95690,95691,0,1,4
27415,5,2,95695,95695,95697,0,2,4
27416,5,2,95700,95700,95702,0,2,3
27417,1,1,95701,95702,95703,1,2,0
27418,1,1,95702,95703,95704,1,2,0
27419,6,3,95708,95708,95711,0,3,4
27420,4,3,95712,95712,95715,0,3,1
27421,4,1,95716,95716,95717,0,1,1
27422,1,2,95717,95717,95719,0,2,0
27423,6,2,95723,95723,95725,0,2,4
27424,1,1,95724,95725,95726,1,2,0
27425,2,2,95726,95726,95728,0,2,0
27426,2,1,95728,95728,95729,0,1,0
27427,2,2,95730,95730,95732,0,2,1
27428,4,1,95734,95734,95735,0,1,2
27429,6,2,95740,95740,95742,0,2,5
27430,5,3,95745,95745,95748,0,3,3
27431,6,2,95751,95751,95753,0,2,3
27432,3,1,95754,95754,95755,0,1,1
27433,3,3,95757,95757,95760,0,3,2
27434,5,2,95762,95762,95764,0,2,2
27435,5,1,95767,95767,95768,0,1,3
27436,6,2,95773,95773,95775,0,2,5
27437,2,2,95775,95775,95777,0,2,0
27438,2,2,95777,95777,95779,0,2,0
27439,2,3,95779,95779,95782,0,3,0
27440,6,2,95785,95785,95787,0,2,3
27441,3,3,95788,95788,95791,0,3,1
27442,6,3,95794,95794,95797,0,3,3
27443,4,2,95798,95798,95800,0,2,1
27444,1,2,95799,95800,95802,1,3,0
27445,5,3,95804,95804,95807,0,3,2
27446,2,1,95806,95807,95808,1,2,0
27447,4,2,95810,95810,95812,0,2,2
27448,1,3,95811,95812,95815,1,4,0
27449,3,2,95814,95815,95817,1,3,0
27450,3,2,95817,95817,95819,0,2,0
27451,4,1,95821,95821,95822,0,1,2
27452,4,3,95825,95825,95828,0,3,3
27453,2,1,95827,95828,95829,1,2,0
27454,2,2,95829,95829,95831,0,2,0
27455,5,3,95834,95834,95837,0,3,3
27456,4,2,95838,95838,95840,0,2,1
27457,1,2,95839,95840,95842,1,3,0
27458,6,3,95845,95845,95848,0,3,3
27459,6,3,95851,95851,95854,0,3,3
27460,6,1,95857,95857,95858,0,1,3
27461,3,2,95860,95860,95862,0,2,2
27462,1,1,95861,95862,95863,1,2,0
27463,5,1,95866,95866,95867,0,1,3
27464,6,3,95872,95872,95875,0,3,5
27465,1,1,95873,95875,95876,2,3,0
27466,6,3,95879,95879,95882,0,3,3
27467,4,2,95883,95883,95885,0,2,1
27468,2,3,95885,95885,95888,0,3,0
27469,4,3,95889,95889,95892,0,3,1
27470,6,1,95895,95895,95896,0,1,3
27471,3,2,95898,95898,95900,0,2,2
27472,4,3,95902,95902,95905,0,3,2
27473,5,2,95907,95907,95909,0,2,2
27474,5,1,95912,95912,95913,0,1,3
27475,3,3,95915,95915,95918,0,3,2
27476,1,3,95916,95918,95921,2,5,0
27477,4,2,95920,95921,95923,1,3,0
27478,6,1,95926,95926,95927,0,1,3
27479,4,1,95930,95930,95931,0,1,3
27480,4,1,95934,95934,95935,0,1,3
27481,5,1,95939,95939,95940,0,1,4
27482,4,3,95943,95943,95946,0,3,3
27483,6,3,95949,95949,95952,0,3,3
27484,2,2,95951,95952,95954,1,3,0
27485,2,1,95953,95954,95955,1,2,0
27486,3,1,95956,95956,95957,0,1,1
27487,3,1,95959,95959,95960,0,1,2
27488,5,3,95964,95964,95967,0,3,4
27489,1,1,95965,95967,95968,2,3,0
27490,3,1,95968,95968,95969,0,1,0
27491,2,1,95970,95970,95971,0,1,1
27492,6,3,95976,95976,95979,0,3,5
27493,2,2,95978,95979,95981,1,3,0
27494,2,2,95980,95981,95983,1,3,0
27495,2,2,95982,95983,95985,1,3,0
27496,6,3,95988,95988,95991,0,3,3
27497,5,3,95993,95993,95996,0,3,2
27498,1,3,95994,95996,95999,2,5,0
27499,2,2,95996,95999,96001,3,5,0
27500,6,2,96002,96002,96004,0,2,1
27501,5,2,96007,96007,96009,0,2,3
27502,6,3,96013,96013,96016,0,3,4
27503,6,2,96019,96019,96021,0,2,3
27504,6,3,96025,96025,96028,0,3,4
27505,5,2,96030,96030,96032,0,2,2
27506,5,3,96035,96035,96038,0,3,3
27507,1,1,96036,96038,96039,2,3,0
27508,2,2,96038,96039,96041,1,3,0
27509,2,2,96040,96041,96043,1,3,0
27510,2,1,96042,96043,96044,1,2,0
27511,1,3,96043,96044,96047,1,4,0
27512,4,2,96047,96047,96049,0,2,0
27513,3,3,96050,96050,96053,0,3,1
27514,6,3,96056,96056,96059,0,3,3
27515,4,2,96060,96060,96062,0,2,1
27516,1,1,96061,96062,96063,1,2,0
27517,2,3,96063,96063,96066,0,3,0
27518,6,3,96069,96069,96072,0,3,3
27519,2,2,96071,96072,96074,1,3,0
27520,1,1,96072,96074,96075,2,3,0
27521,5,3,96077,96077,96080,0,3,2
27522,3,3,96080,96080,96083,0,3,0
27523,2,3,96082,96083,96086,1,4,0
27524,6,3,96088,96088,96091,0,3,2
27525,6,3,96094,96094,96097,0,3,3
27526,2,3,96096,96097,96100,1,4,0
27527,6,2,96102,96102,96104,0,2,2
27528,4,2,96106,96106,96108,0,2,2
27529,1,2,96107,96108,96110,1,3,0
27530,3,3,96110,96110,96113,0,3,0
27531,3,1,96113,96113,96114,0,1,0
27532,3,3,96116,96116,96119,0,3,2
27533,2,1,96118,96119,96120,1,2,0
27534,1,1,96119,96120,96121,1,2,0
27535,4,3,96123,96123,96126,0,3,2
27536,1,2,96124,96126,96128,2,4,0
27537,4,1,96128,96128,96129,0,1,0
27538,4,1,96132,96132,96133,0,1,3
27539,3,3,96135,96135,96138,0,3,2
27540,5,1,96140,96140,96141,0,1,2
27541,5,1,96145,96145,96146,0,1,4
27542,2,1,96147,96147,96148,0,1,1
27543,5,2,96152,96152,96154,0,2,4
27544,2,2,96154,96154,96156,0,2,0
27545,6,1,96160,96160,96161,0,1,4
27546,3,1,96163,96163,96164,0,1,2
27547,1,3,96164,96164,96167,0,3,0
27548,3,3,96167,96167,96170,0,3,0
27549,5,3,96172,96172,96175,0,3,2
27550,4,2,96176,96176,96178,0,2,1
27551,6,1,96182,96182,96183,0,1,4
27552,1,3,96183,96183,96186,0,3,0
27553,3,2,96186,96186,96188,0,2,0
27554,6,2,96192,96192,96194,0,2,4
27555,1,2,96193,96194,96196,1,3,0
27556,2,1,96195,96196,96197,1,2,0
27557,2,2,96197,96197,96199,0,2,0
27558,2,3,96199,96199,96202,0,3,0
27559,1,3,96200,96202,96205,2,5,0
27560,6,2,96206,96206,96208,0,2,1
27561,5,3,96211,96211,96214,0,3,3
27562,1,1,96212,96214,96215,2,3,0
27563,2,3,96214,96215,96218,1,4,0
27564,4,1,96218,96218,96219,0,1,0
27565,5,3,96223,96223,96226,0,3,4
27566,3,2,96226,96226,96228,0,2,0
27567,3,3,96229,96229,96232,0,3,1
27568,4,2,96233,96233,96235,0,2,1
27569,5,3,96238,96238,96241,0,3,3
27570,4,2,96242,96242,96244,0,2,1
27571,1,1,96243,96244,96245,1,2,0
27572,5,2,96248,96248,96250,0,2,3
27573,5,2,96253,96253,96255,0,2,3
27574,2,3,96255,96255,96258,0,3,0
27575,1,3,96256,96258,96261,2,5,0
27576,4,3,96260,96261,96264,1,4,0
27577,1,3,96261,96264,96267,3,6,0
27578,1,2,96262,96267,96269,5,7,0
27579,1,2,96263,96269,96271,6,8,0
27580,1,2,96264,96271,96273,7,9,0
27581,4,1,96268,96273,96274,5,6,0
27582,1,1,96269,96274,96275,5,6,0
27583,1,2,96270,96275,96277,5,7,0
27584,2,2,96272,96277,96279,5,7,0
27585,1,3,96273,96279,96282,6,9,0
27586,3,1,96276,96282,96283,6,7,0
27587,4,2,96280,96283,96285,3,5,0
27588,4,1,96284,96285,96286,1,2,0
27589,3,2,96287,96287,96289,0,2,1
27590,6,1,96293,96293,96294,0,1,4
27591,1,1,96294,96294,96295,0,1,0
27592,4,3,96298,96298,96301,0,3,3
27593,4,2,96302,96302,96304,0,2,1
27594,3,1,96305,96305,96306,0,1,1
27595,4,3,96309,96309,96312,0,3,3
27596,5,2,96314,96314,96316,0,2,2
27597,4,1,96318,96318,96319,0,1,2
27598,1,3,96319,96319,96322,0,3,0
27599,1,3,96320,96322,96325,2,5,0
27600,3,2,96323,96325,96327,2,4,0
27601,4,2,96327,96327,96329,0,2,0
27602,6,2,96333,96333,96335,0,2,4
27603,3,3,96336,96336,96339,0,3,1
27604,2,3,96338,96339,96342,1,4,0
27605,3,2,96341,96342,96344,1,3,0
27606,4,3,96345,96345,96348,0,3,1
27607,5,1,96350,96350,96351,0,1,2
27608,5,3,96355,96355,96358,0,3,4
27609,1,2,96356,96358,96360,2,4,0
27610,6,3,96362,96362,96365,0,3,2
27611,3,3,96365,96365,96368,0,3,0
27612,1,3,96366,96368,96371,2,5,0
27613,1,3,96367,96371,96374,4,7,0
27614,6,2,96373,96374,96376,1,3,0
27615,2,1,96375,96376,96377,1,2,0
27616,1,2,96376,96377,96379,1,3,0
27617,1,3,96377,96379,96382,2,5,0
27618,4,1,96381,96382,96383,1,2,0
27619,3,3,96384,96384,96387,0,3,1
27620,3,1,96387,96387,96388,0,1,0
27621,1,2,96388,96388,96390,0,2,0
27622,2,2,96390,96390,96392,0,2,0
27623,3,1,96393,96393,96394,0,1,1
27624,1,2,96394,96394,96396,0,2,0
27625,1,3,96395,96396,96399,1,4,0
27626,3,2,96398,96399,96401,1,3,0
27627,3,1,96401,96401,96402,0,1,0
27628,1,3,96402,96402,96405,0,3,0
27629,6,1,96408,96408,96409,0,1,3
27630,2,3,96410,96410,96413,0,3,1
27631,3,1,96413,96413,96414,0,1,0
27632,2,1,96415,96415,96416,0,1,1
27633,1,1,96416,96416,96417,0,1,0
27634,3,3,96419,96419,96422,0,3,2
27635,4,1,96423,96423,96424,0,1,1
27636,4,1,96427,96427,96428,0,1,3
27637,5,2,96432,96432,96434,0,2,4
27638,6,1,96438,96438,96439,0,1,4
27639,2,1,96440,96440,96441,0,1,1
27640,1,3,96441,96441,96444,0,3,0
27641,3,3,96444,96444,96447,0,3,0
27642,1,1,96445,96447,96448,2,3,0
27643,6,2,96451,96451,96453,0,2,3
27644,6,3,96457,96457,96460,0,3,4
27645,4,1,96461,96461,96462,0,1,1
27646,4,1,96465,96465,96466,0,1,3
27647,1,3,96466,96466,96469,0,3,0
27648,4,1,96470,96470,96471,0,1,1
27649,1,1,96471,96471,96472,0,1,0
27650,5,1,96476,96476,96477,0,1,4
27651,2,3,96478,96478,96481,0,3,1
27652,1,2,96479,96481,96483,2,4,0
27653,3,2,96482,96483,96485,1,3,0
27654,6,1,96488,96488,96489,0,1,3
27655,1,3,96489,96489,96492,0,3,0
27656,3,1,96492,96492,96493,0,1,0
27657,6,2,96498,96498,96500,0,2,5
27658,3,1,96501,96501,96502,0,1,1
27659,4,2,96505,96505,96507,0,2,3
27660,2,3,96507,96507,96510,0,3,0
27661,1,1,96508,96510,96511,2,3,0
27662,6,3,96514,96514,96517,0,3,3
27663,1,1,96515,96517,96518,2,3,0
27664,2,2,96517,96518,96520,1,3,0
27665,1,2,96518,96520,96522,2,4,0
27666,1,3,96519,96522,96525,3,6,0
27667,3,1,96522,96525,96526,3,4,0
27668,3,3,96525,96526,96529,1,4,0
27669,5,1,96530,96530,96531,0,1,1
27670,2,1,96532,96532,96533,0,1,1
27671,6,2,96538,96538,96540,0,2,5
27672,5,2,96543,96543,96545,0,2,3
27673,3,2,96546,96546,96548,0,2,1
27674,2,3,96548,96548,96551,0,3,0
27675,5,1,96553,96553,96554,0,1,2
27676,4,2,96557,96557,96559,0,2,3
27677,5,3,96562,96562,96565,0,3,3
27678,3,1,96565,96565,96566,0,1,0
27679,5,3,96570,96570,96573,0,3,4
27680,5,1,96575,96575,96576,0,1,2
27681,2,3,96577,96577,96580,0,3,1
27682,4,3,96581,96581,96584,0,3,1
27683,4,3,96585,96585,96588,0,3,1
27684,2,2,96587,96588,96590,1,3,0
27685,3,1,96590,96590,96591,0,1,0
27686,2,1,96592,96592,96593,0,1,1
27687,6,3,96598,96598,96601,0,3,5
27688,5,1,96603,96603,96604,0,1,2
27689,5,1,96608,96608,96609,0,1,4
27690,1,1,96609,96609,96610,0,1,0
27691,4,1,96613,96613,96614,0,1,3
27692,5,2,96618,96618,96620,0,2,4
27693,2,2,96620,96620,96622,0,2,0
27694,5,1,96625,96625,96626,0,1,3
27695,4,3,96629,96629,96632,0,3,3
27696,4,1,96633,96633,96634,0,1,1
27697,3,2,96636,96636,96638,0,2,2
27698,2,2,96638,96638,96640,0,2,0
27699,3,3,96641,96641,96644,0,3,1
27700,3,1,96644,96644,96645,0,1,0
27701,2,1,96646,96646,96647,0,1,1
27702,6,2,96652,96652,96654,0,2,5
27703,1,1,96653,96654,96655,1,2,0
27704,2,2,96655,96655,96657,0,2,0
27705,5,2,96660,96660,96662,0,2,3
27706,5,3,96665,96665,96668,0,3,3
27707,1,3,96666,96668,96671,2,5,0
27708,1,1,96667,96671,96672,4,5,0
27709,4,2,96671,96672,96674,1,3,0
27710,1,2,96672,96674,96676,2,4,0
27711,5,3,96677,96677,96680,0,3,1
27712,2,3,96679,96680,96683,1,4,0
27713,5,2,96684,96684,96686,0,2,1
27714,1,2,96685,96686,96688,1,3,0
27715,2,3,96687,96688,96691,1,4,0
27716,4,2,96691,96691,96693,0,2,0
27717,6,1,96697,96697,96698,0,1,4
27718,6,2,96703,96703,96705,0,2,5
27719,6,1,96709,96709,96710,0,1,4
27720,6,1,96715,96715,96716,0,1,5
27721,1,3,96716,96716,96719,0,3,0
27722,3,3,96719,96719,96722,0,3,0
27723,4,1,96723,96723,96724,0,1,1
27724,5,2,96728,96728,96730,0,2,4
27725,5,1,96733,96733,96734,0,1,3
27726,3,1,96736,96736,96737,0,1,2
27727,5,3,96741,96741,96744,0,3,4
27728,2,3,96743,96744,96747,1,4,0
27729,4,1,96747,96747,96748,0,1,0
27730,1,1,96748,96748,96749,0,1,0
27731,3,3,96751,96751,96754,0,3,2
27732,4,1,96755,96755,96756,0,1,1
27733,1,1,96756,96756,96757,0,1,0
27734,2,2,96758,96758,96760,0,2,1
27735,5,2,96763,96763,96765,0,2,3
27736,2,1,96765,96765,96766,0,1,0
27737,5,2,96770,96770,96772,0,2,4
27738,4,3,96774,96774,96777,0,3,2
27739,1,1,96775,96777,96778,2,3,0
27740,2,3,96777,96778,96781,1,4,0
27741,4,1,96781,96781,96782,0,1,0
27742,2,1,96783,96783,96784,0,1,1
27743,6,1,96789,96789,96790,0,1,5
27744,4,3,96793,96793,96796,0,3,3
27745,1,2,96794,96796,96798,2,4,0
27746,6,3,96800,96800,96803,0,3,2
27747,5,1,96805,96805,96806,0,1,2
27748,3,3,96808,96808,96811,0,3,2
27749,1,3,96809,96811,96814,2,5,0
27750,6,2,96815,96815,96817,0,2,1
27751,4,2,96819,96819,96821,0,2,2
27752,1,1,96820,96821,96822,1,2,0
27753,1,3,96821,96822,96825,1,4,0
27754,2,1,96823,96825,96826,2,3,0
27755,6,2,96829,96829,96831,0,2,3
27756,2,3,96831,96831,96834,0,3,0
27757,4,2,96835,96835,96837,0,2,1
27758,5,3,96840,96840,96843,0,3,3
27759,1,2,96841,96843,96845,2,4,0
27760,4,2,96845,96845,96847,0,2,0
27761,4,1,96849,96849,96850,0,1,2
27762,3,1,96852,96852,96853,0,1,2
27763,6,1,96858,96858,96859,0,1,5
27764,1,3,96859,96859,96862,0,3,0
27765,5,2,96864,96864,96866,0,2,2
27766,2,2,96866,96866,96868,0,2,0
27767,1,2,96867,96868,96870,1,3,0
27768,2,2,96869,96870,96872,1,3,0
27769,1,2,96870,96872,96874,2,4,0
27770,5,3,96875,96875,96878,0,3,1
27771,1,2,96876,96878,96880,2,4,0
27772,2,1,96878,96880,96881,2,3,0
27773,2,2,96880,96881,96883,1,3,0
27774,1,1,96881,96883,96884,2,3,0
27775,5,2,96886,96886,96888,0,2,2
27776,4,1,96890,96890,96891,0,1,2
27777,5,1,96895,96895,96896,0,1,4
27778,2,3,96897,96897,96900,0,3,1
27779,6,1,96903,96903,96904,0,1,3
27780,4,1,96907,96907,96908,0,1,3
27781,5,3,96912,96912,96915,0,3,4
27782,2,1,96914,96915,96916,1,2,0
27783,3,2,96917,96917,96919,0,2,1
27784,6,3,96923,96923,96926,0,3,4
27785,1,2,96924,96926,96928,2,4,0
27786,5,1,96929,96929,96930,0,1,1
27787,6,3,96935,96935,96938,0,3,5
27788,3,2,96938,96938,96940,0,2,0
27789,2,3,96940,96940,96943,0,3,0
27790,3,3,96943,96943,96946,0,3,0
27791,3,3,96946,96946,96949,0,3,0
27792,2,1,96948,96949,96950,1,2,0
27793,4,2,96952,96952,96954,0,2,2
27794,4,3,96956,96956,96959,0,3,2
27795,6,2,96962,96962,96964,0,2,3
27796,5,2,96967,96967,96969,0,2,3
27797,1,3,96968,96969,96972,1,4,0
27798,6,2,96974,96974,96976,0,2,2
27799,4,2,96978,96978,96980,0,2,2
27800,3,3,96981,96981,96984,0,3,1
27801,4,1,96985,96985,96986,0,1,1
27802,2,1,96987,96987,96988,0,1,1
27803,5,2,96992,96992,96994,0,2,4
27804,3,2,96995,96995,96997,0,2,1
27805,5,1,97000,97000,97001,0,1,3
27806,5,2,97005,97005,97007,0,2,4
27807,5,2,97010,97010,97012,0,2,3
27808,3,1,97013,97013,97014,0,1,1
27809,1,3,97014,97014,97017,0,3,0
27810,4,1,97018,97018,97019,0,1,1
27811,4,1,97022,97022,97023,0,1,3
27812,2,3,97024,97024,97027,0,3,1
27813,1,3,97025,97027,97030,2,5,0
27814,5,2,97030,97030,97032,0,2,0
27815,1,1,97031,97032,97033,1,2,0
27816,3,1,97034,97034,97035,0,1,1
27817,2,2,97036,97036,97038,0,2,1
27818,3,1,97039,97039,97040,0,1,1
27819,6,3,97045,97045,97048,0,3,5
27820,1,2,97046,97048,97050,2,4,0
27821,5,1,97051,97051,97052,0,1,1
27822,6,1,97057,97057,97058,0,1,5
27823,5,3,97062,97062,97065,0,3,4
27824,4,2,97066,97066,97068,0,2,1
27825,3,2,97069,97069,97071,0,2,1
27826,5,3,97074,97074,97077,0,3,3
27827,6,2,97080,97080,97082,0,2,3
27828,6,3,97086,97086,97089,0,3,4
27829,4,2,97090,97090,97092,0,2,1
27830,6,2,97096,97096,97098,0,2,4
27831,5,2,97101,97101,97103,0,2,3
27832,5,1,97106,97106,97107,0,1,3
27833,6,1,97112,97112,97113,0,1,5
27834,6,1,97118,97118,97119,0,1,5
27835,6,2,97124,97124,97126,0,2,5
27836,2,3,97126,97126,97129,0,3,0
27837,2,3,97128,97129,97132,1,4,0
27838,6,2,97134,97134,97136,0,2,2
27839,1,3,97135,97136,97139,1,4,0
27840,6,2,97141,97141,97143,0,2,2
27841,4,1,97145,97145,97146,0,1,2
27842,6,1,97151,97151,97152,0,1,5
27843,4,2,97155,97155,97157,0,2,3
27844,1,2,97156,97157,97159,1,3,0
27845,5,1,97161,97161,97162,0,1,2
27846,3,2,97164,97164,97166,0,2,2
27847,5,3,97169,97169,97172,0,3,3
27848,3,3,97172,97172,97175,0,3,0
27849,1,2,97173,97175,97177,2,4,0
27850,6,1,97179,97179,97180,0,1,2
27851,6,2,97185,97185,97187,0,2,5
27852,2,1,97187,97187,97188,0,1,0
27853,2,3,97189,97189,97192,0,3,1
27854,5,3,97194,97194,97197,0,3,2
27855,4,2,97198,97198,97200,0,2,1
27856,1,3,97199,97200,97203,1,4,0
27857,4,1,97203,97203,97204,0,1,0
27858,3,2,97206,97206,97208,0,2,2
27859,4,2,97210,97210,97212,0,2,2
27860,4,1,97214,97214,97215,0,1,2
27861,2,1,97216,97216,97217,0,1,1
27862,5,3,97221,97221,97224,0,3,4
27863,3,1,97224,97224,97225,0,1,0
27864,6,1,97230,97230,97231,0,1,5
27865,1,2,97231,97231,97233,0,2,0
27866,6,1,97237,97237,97238,0,1,4
27867,6,2,97243,97243,97245,0,2,5
27868,5,2,97248,97248,97250,0,2,3
27869,1,1,97249,97250,97251,1,2,0
27870,6,3,97255,97255,97258,0,3,4
27871,2,2,97257,97258,97260,1,3,0
27872,1,2,97258,97260,97262,2,4,0
27873,4,2,97262,97262,97264,0,2,0
27874,1,2,97263,97264,97266,1,3,0
27875,5,1,97268,97268,97269,0,1,2
27876,4,2,97272,97272,97274,0,2,3
27877,1,1,97273,97274,97275,1,2,0
27878,5,3,97278,97278,97281,0,3,3
27879,6,3,97284,97284,97287,0,3,3
27880,1,3,97285,97287,97290,2,5,0
27881,2,3,97287,97290,97293,3,6,0
27882,1,1,97288,97293,97294,5,6,0
27883,1,3,97289,97294,97297,5,8,0
27884,6,3,97295,97297,97300,2,5,0
27885,3,2,97298,97300,97302,2,4,0
27886,3,3,97301,97302,97305,1,4,0
27887,3,2,97304,97305,97307,1,3,0
27888,2,2,97306,97307,97309,1,3,0
27889,3,3,97309,97309,97312,0,3,0
27890,2,2,97311,97312,97314,1,3,0
27891,1,3,97312,97314,97317,2,5,0
27892,4,2,97316,97317,97319,1,3,0
27893,4,3,97320,97320,97323,0,3,1
27894,3,3,97323,97323,97326,0,3,0
27895,5,3,97328,97328,97331,0,3,2
27896,4,3,97332,97332,97335,0,3,1
27897,5,1,97337,97337,97338,0,1,2
27898,2,2,97339,97339,97341,0,2,1
27899,4,1,97343,97343,97344,0,1,2
27900,3,2,97346,97346,97348,0,2,2
27901,3,2,97349,97349,97351,0,2,1
27902,1,3,97350,97351,97354,1,4,0
27903,1,2,97351,97354,97356,3,5,0
27904,4,2,97355,97356,97358,1,3,0
27905,5,1,97360,97360,97361,0,1,2
27906,2,2,97362,97362,97364,0,2,1
27907,4,2,97366,97366,97368,0,2,2
27908,4,1,97370,97370,97371,0,1,2
27909,4,2,97374,97374,97376,0,2,3
27910,1,3,97375,97376,97379,1,4,0
27911,2,3,97377,97379,97382,2,5,0
27912,4,2,97381,97382,97384,1,3,0
27913,1,3,97382,97384,97387,2,5,0
27914,5,3,97387,97387,97390,0,3,0
27915,3,2,97390,97390,97392,0,2,0
27916,1,1,97391,97392,97393,1,2,0
27917,4,3,97395,97395,97398,0,3,2
27918,4,3,97399,97399,97402,0,3,1
27919,4,1,97403,97403,97404,0,1,1
27920,5,3,97408,97408,97411,0,3,4
27921,2,1,97410,97411,97412,1,2,0
27922,1,1,97411,97412,97413,1,2,0
27923,1,3,97412,97413,97416,1,4,0
27924,5,2,97417,97417,97419,0,2,1
27925,6,3,97423,97423,97426,0,3,4
27926,2,1,97425,97426,97427,1,2,0
27927,5,3,97430,97430,97433,0,3,3
27928,6,3,97436,97436,97439,0,3,3
27929,6,3,97442,97442,97445,0,3,3
27930,6,3,97448,97448,97451,0,3,3
27931,2,1,97450,97451,97452,1,2,0
27932,5,2,97455,97455,97457,0,2,3
27933,5,1,97460,97460,97461,0,1,3
27934,6,3,97466,97466,97469,0,3,5
27935,1,2,97467,97469,97471,2,4,0
27936,3,3,97470,97471,97474,1,4,0
27937,5,2,97475,97475,97477,0,2,1
27938,1,1,97476,97477,97478,1,2,0
27939,1,3,97477,97478,97481,1,4,0
27940,2,1,97479,97481,97482,2,3,0
27941,1,2,97480,97482,97484,2,4,0
27942,6,3,97486,97486,97489,0,3,2
27943,5,2,97491,97491,97493,0,2,2
27944,6,2,97497,97497,97499,0,2,4
27945,3,3,97500,97500,97503,0,3,1
27946,5,1,97505,97505,97506,0,1,2
27947,3,2,97508,97508,97510,0,2,2
27948,2,2,97510,97510,97512,0,2,0
27949,2,2,97512,97512,97514,0,2,0
27950,5,2,97517,97517,97519,0,2,3
27951,2,2,97519,97519,97521,0,2,0
27952,4,2,97523,97523,97525,0,2,2
27953,3,2,97526,97526,97528,0,2,1
27954,3,1,97529,97529,97530,0,1,1
27955,1,2,97530,97530,97532,0,2,0
27956,5,1,97535,97535,97536,0,1,3
27957,4,2,97539,97539,97541,0,2,3
27958,3,3,97542,97542,97545,0,3,1
27959,2,1,97544,97545,97546,1,2,0
27960,4,3,97548,97548,97551,0,3,2
27961,1,3,97549,97551,97554,2,5,0
27962,3,2,97552,97554,97556,2,4,0
27963,1,1,97553,97556,97557,3,4,0
27964,6,1,97559,97559,97560,0,1,2
27965,6,1,97565,97565,97566,0,1,5
27966,1,2,97566,97566,97568,0,2,0
27967,4,1,97570,97570,97571,0,1,2
27968,6,1,97576,97576,97577,0,1,5
27969,5,3,97581,97581,97584,0,3,4
27970,4,1,97585,97585,97586,0,1,1
27971,2,2,97587,97587,97589,0,2,1
27972,3,1,97590,97590,97591,0,1,1
27973,1,3,97591,97591,97594,0,3,0
27974,1,2,97592,97594,97596,2,4,0
27975,1,2,97593,97596,97598,3,5,0
27976,6,2,97599,97599,97601,0,2,1
27977,4,1,97603,97603,97604,0,1,2
27978,6,2,97609,97609,97611,0,2,5
27979,2,2,97611,97611,97613,0,2,0
27980,4,2,97615,97615,97617,0,2,2
27981,4,1,97619,97619,97620,0,1,2
27982,1,3,97620,97620,97623,0,3,0
27983,1,3,97621,97623,97626,2,5,0
27984,1,3,97622,97626,97629,4,7,0
27985,4,2,97626,97629,97631,3,5,0
27986,1,2,97627,97631,97633,4,6,0
27987,1,1,97628,97633,97634,5,6,0
27988,1,2,97629,97634,97636,5,7,0
27989,4,2,97633,97636,97638,3,5,0
27990,1,2,97634,97638,97640,4,6,0
27991,1,3,97635,97640,97643,5,8,0
27992,3,3,97638,97643,97646,5,8,0
27993,4,1,97642,97646,97647,4,5,0
27994,5,3,97647,97647,97650,0,3,0
27995,1,3,97648,97650,97653,2,5,0
27996,5,1,97653,97653,97654,0,1,0
27997,3,1,97656,97656,97657,0,1,2
27998,4,1,97660,97660,97661,0,1,3
27999,6,1,97666,97666,97667,0,1,5
28000,6,1,97672,97672,97673,0,1,5
28001,2,3,97674,97674,97677,0,3,1
28002,1,2,97675,97677,97679,2,4,0
28003,1,3,97676,97679,97682,3,6,0
28004,5,1,97681,97682,97683,1,2,0
28005,3,1,97684,97684,97685,0,1,1
28006,2,3,97686,97686,97689,0,3,1
28007,6,2,97692,97692,97694,0,2,3
28008,2,3,97694,97694,97697,0,3,0
28009,5,3,97699,97699,97702,0,3,2
28010,6,3,97705,97705,97708,0,3,3
28011,2,2,97707,97708,97710,1,3,0
28012,2,1,97709,97710,97711,1,2,0
28013,6,3,97715,97715,97718,0,3,4
28014,3,1,97718,97718,97719,0,1,0
28015,4,1,97722,97722,97723,0,1,3
28016,5,2,97727,97727,97729,0,2,4
28017,2,1,97729,97729,97730,0,1,0
28018,6,1,97735,97735,97736,0,1,5
28019,1,2,97736,97736,97738,0,2,0
28020,3,3,97739,97739,97742,0,3,1
28021,2,3,97741,97742,97745,1,4,0
28022,2,1,97743,97745,97746,2,3,0
28023,3,3,97746,97746,97749,0,3,0
28024,5,2,97751,97751,97753,0,2,2
28025,6,3,97757,97757,97760,0,3,4
28026,6,2,97763,97763,97765,0,2,3
28027,1,2,97764,97765,97767,1,3,0
28028,4,1,97768,97768,97769,0,1,1
28029,3,1,97771,97771,97772,0,1,2
28030,4,2,97775,97775,97777,0,2,3
28031,6,3,97781,97781,97784,0,3,4
28032,3,2,97784,97784,97786,0,2,0
28033,4,2,97788,97788,97790,0,2,2
28034,6,3,97794,97794,97797,0,3,4
28035,3,3,97797,97797,97800,0,3,0
28036,6,1,97803,97803,97804,0,1,3
28037,3,3,97806,97806,97809,0,3,2
28038,2,1,97808,97809,97810,1,2,0
28039,2,2,97810,97810,97812,0,2,0
28040,4,3,97814,97814,97817,0,3,2
28041,1,3,97815,97817,97820,2,5,0
28042,1,1,97816,97820,97821,4,5,0
28043,3,1,97819,97821,97822,2,3,0
28044,4,3,97823,97823,97826,0,3,1
28045,2,1,97825,97826,97827,1,2,0
28046,6,1,97831,97831,97832,0,1,4
28047,3,3,97834,97834,97837,0,3,2
28048,4,2,97838,97838,97840,0,2,1
28049,6,1,97844,97844,97845,0,1,4
28050,6,1,97850,97850,97851,0,1,5
28051,3,3,97853,97853,97856,0,3,2
28052,5,1,97858,97858,97859,0,1,2
28053,3,3,97861,97861,97864,0,3,2
28054,3,1,97864,97864,97865,0,1,0
28055,6,1,97870,97870,97871,0,1,5
28056,3,2,97873,97873,97875,0,2,2
28057,1,2,97874,97875,97877,1,3,0
28058,3,1,97877,97877,97878,0,1,0
28059,2,1,97879,97879,97880,0,1,1
28060,5,1,97884,97884,97885,0,1,4
28061,4,2,97888,97888,97890,0,2,3
28062,4,3,97892,97892,97895,0,3,2
28063,1,2,97893,97895,97897,2,4,0
28064,6,1,97899,97899,97900,0,1,2
28065,5,2,97904,97904,97906,0,2,4
28066,5,3,97909,97909,97912,0,3,3
28067,5,1,97914,97914,97915,0,1,2
28068,3,2,97917,97917,97919,0,2,2
28069,4,2,97921,97921,97923,0,2,2
28070,1,2,97922,97923,97925,1,3,0
28071,3,3,97925,97925,97928,0,3,0
28072,2,1,97927,97928,97929,1,2,0
28073,6,3,97933,97933,97936,0,3,4
28074,6,3,97939,97939,97942,0,3,3
28075,2,1,97941,97942,97943,1,2,0
28076,6,3,97947,97947,97950,0,3,4
28077,2,2,97949,97950,97952,1,3,0
28078,2,2,97951,97952,97954,1,3,0
28079,6,3,97957,97957,97960,0,3,3
28080,5,1,97962,97962,97963,0,1,2
28081,4,3,97966,97966,97969,0,3,3
28082,6,1,97972,97972,97973,0,1,3
28083,6,3,97978,97978,97981,0,3,5
28084,6,1,97984,97984,97985,0,1,3
28085,5,1,97989,97989,97990,0,1,4
28086,5,3,97994,97994,97997,0,3,4
28087,5,1,97999,97999,98000,0,1,2
28088,6,2,98005,98005,98007,0,2,5
28089,6,3,98011,98011,98014,0,3,4
28090,4,2,98015,98015,98017,0,2,1
28091,1,1,98016,98017,98018,1,2,0
28092,3,3,98019,98019,98022,0,3,1
28093,3,2,98022,98022,98024,0,2,0
28094,2,1,98024,98024,98025,0,1,0
28095,4,3,98028,98028,98031,0,3,3
28096,4,2,98032,98032,98034,0,2,1
28097,4,3,98036,98036,98039,0,3,2
28098,6,1,98042,98042,98043,0,1,3
28099,6,3,98048,98048,98051,0,3,5
28100,2,3,98050,98051,98054,1,4,0
28101,5,3,98055,98055,98058,0,3,1
28102,1,3,98056,98058,98061,2,5,0
28103,3,1,98059,98061,98062,2,3,0
28104,3,2,98062,98062,98064,0,2,0
28105,6,3,98068,98068,98071,0,3,4
28106,6,3,98074,98074,98077,0,3,3
28107,3,1,98077,98077,98078,0,1,0
28108,5,2,98082,98082,98084,0,2,4
28109,2,2,98084,98084,98086,0,2,0
28110,1,2,98085,98086,98088,1,3,0
28111,4,2,98089,98089,98091,0,2,1
28112,3,2,98092,98092,98094,0,2,1
28113,5,2,98097,98097,98099,0,2,3
28114,1,3,98098,98099,98102,1,4,0
28115,3,3,98101,98102,98105,1,4,0
28116,2,1,98103,98105,98106,2,3,0
28117,1,1,98104,98106,98107,2,3,0
28118,1,1,98105,98107,98108,2,3,0
28119,1,1,98106,98108,98109,2,3,0
28120,4,3,98110,98110,98113,0,3,1
28121,1,2,98111,98113,98115,2,4,0
28122,6,1,98117,98117,98118,0,1,2
28123,6,1,98123,98123,98124,0,1,5
28124,2,3,98125,98125,98128,0,3,1
28125,4,2,98129,98129,98131,0,2,1
28126,5,2,98134,98134,98136,0,2,3
28127,2,1,98136,98136,98137,0,1,0
28128,2,3,98138,98138,98141,0,3,1
28129,3,1,98141,98141,98142,0,1,0
28130,1,3,98142,98142,98145,0,3,0
28131,3,2,98145,98145,98147,0,2,0
28132,3,3,98148,98148,98151,0,3,1
28133,1,3,98149,98151,98154,2,5,0
28134,6,3,98155,98155,98158,0,3,1
28135,2,2,98157,98158,98160,1,3,0
28136,2,1,98159,98160,98161,1,2,0
28137,6,2,98165,98165,98167,0,2,4
28138,5,2,98170,98170,98172,0,2,3
28139,1,2,98171,98172,98174,1,3,0
28140,6,1,98177,98177,98178,0,1,3
28141,2,1,98179,98179,98180,0,1,1
28142,3,2,98182,98182,98184,0,2,2
28143,4,3,98186,98186,98189,0,3,2
28144,5,1,98191,98191,98192,0,1,2
28145,6,2,98197,98197,98199,0,2,5
28146,3,3,98200,98200,98203,0,3,1
28147,4,3,98204,98204,98207,0,3,1
28148,5,2,98209,98209,98211,0,2,2
28149,3,2,98212,98212,98214,0,2,1
28150,3,2,98215,98215,98217,0,2,1
28151,4,1,98219,98219,98220,0,1,2
28152,2,3,98221,98221,98224,0,3,1
28153,6,2,98227,98227,98229,0,2,3
28154,3,3,98230,98230,98233,0,3,1
28155,4,1,98234,98234,98235,0,1,1
28156,2,2,98236,98236,98238,0,2,1
28157,4,2,98240,98240,98242,0,2,2
28158,2,1,98242,98242,98243,0,1,0
28159,4,1,98246,98246,98247,0,1,3
28160,1,2,98247,98247,98249,0,2,0
28161,4,2,98251,98251,98253,0,2,2
28162,1,2,98252,98253,98255,1,3,0
28163,3,3,98255,98255,98258,0,3,0
28164,2,2,98257,98258,98260,1,3,0
28165,1,2,98258,98260,98262,2,4,0
28166,2,1,98260,98262,98263,2,3,0
28167,1,1,98261,98263,98264,2,3,0
28168,1,1,98262,98264,98265,2,3,0
28169,3,1,98265,98265,98266,0,1,0
28170,4,1,98269,98269,98270,0,1,3
28171,4,2,98273,98273,98275,0,2,3
28172,1,3,98274,98275,98278,1,4,0
28173,1,1,98275,98278,98279,3,4,0
28174,6,3,98281,98281,98284,0,3,2
28175,5,1,98286,98286,98287,0,1,2
28176,1,2,98287,98287,98289,0,2,0
28177,6,1,98293,98293,98294,0,1,4
28178,6,3,98299,98299,98302,0,3,5
28179,5,3,98304,98304,98307,0,3,2
28180,1,1,98305,98307,98308,2,3,0
28181,2,3,98307,98308,98311,1,4,0
28182,4,1,98311,98311,98312,0,1,0
28183,6,2,98317,98317,98319,0,2,5
28184,4,2,98321,98321,98323,0,2,2
28185,3,3,98324,98324,98327,0,3,1
28186,2,3,98326,98327,98330,1,4,0
28187,2,3,98328,98330,98333,2,5,0
28188,2,2,98330,98333,98335,3,5,0
28189,3,1,98333,98335,98336,2,3,0
28190,5,1,98338,98338,98339,0,1,2
28191,1,1,98339,98339,98340,0,1,0
28192,1,1,98340,98340,98341,0,1,0
28193,3,2,98343,98343,98345,0,2,2
28194,6,1,98349,98349,98350,0,1,4
28195,5,2,98354,98354,98356,0,2,4
28196,5,1,98359,98359,98360,0,1,3
28197,1,1,98360,98360,98361,0,1,0
28198,1,3,98361,98361,98364,0,3,0
28199,5,1,98366,98366,98367,0,1,2
28200,1,3,98367,98367,98370,0,3,0
28201,5,1,98372,98372,98373,0,1,2
28202,3,2,98375,98375,98377,0,2,2
28203,6,2,98381,98381,98383,0,2,4
28204,3,1,98384,98384,98385,0,1,1
28205,6,1,98390,98390,98391,0,1,5
28206,1,3,98391,98391,98394,0,3,0
28207,3,1,98394,98394,98395,0,1,0
28208,2,2,98396,98396,98398,0,2,1
28209,1,1,98397,98398,98399,1,2,0
28210,3,3,98400,98400,98403,0,3,1
28211,5,1,98405,98405,98406,0,1,2
28212,2,3,98407,98407,98410,0,3,1
28213,3,1,98410,98410,98411,0,1,0
28214,2,3,98412,98412,98415,0,3,1
28215,2,3,98414,98415,98418,1,4,0
28216,4,1,98418,98418,98419,0,1,0
28217,2,1,98420,98420,98421,0,1,1
28218,5,2,98425,98425,98427,0,2,4
28219,5,2,98430,98430,98432,0,2,3
28220,4,1,98434,98434,98435,0,1,2
28221,6,2,98440,98440,98442,0,2,5
28222,2,3,98442,98442,98445,0,3,0
28223,3,3,98445,98445,98448,0,3,0
28224,5,3,98450,98450,98453,0,3,2
28225,5,3,98455,98455,98458,0,3,2
28226,6,3,98461,98461,98464,0,3,3
28227,3,2,98464,98464,98466,0,2,0
28228,2,1,98466,98466,98467,0,1,0
28229,3,2,98469,98469,98471,0,2,2
28230,1,1,98470,98471,98472,1,2,0
28231,6,3,98476,98476,98479,0,3,4
28232,6,2,98482,98482,98484,0,2,3
28233,6,1,98488,98488,98489,0,1,4
28234,1,1,98489,98489,98490,0,1,0
28235,2,1,98491,98491,98492,0,1,1
28236,4,2,98495,98495,98497,0,2,3
28237,3,3,98498,98498,98501,0,3,1
28238,5,1,98503,98503,98504,0,1,2
28239,4,3,98507,98507,98510,0,3,3
28240,2,3,98509,98510,98513,1,4,0
28241,3,2,98512,98513,98515,1,3,0
28242,4,3,98516,98516,98519,0,3,1
28243,6,3,98522,98522,98525,0,3,3
28244,2,1,98524,98525,98526,1,2,0
28245,1,2,98525,98526,98528,1,3,0
28246,3,1,98528,98528,98529,0,1,0
28247,1,3,98529,98529,98532,0,3,0
28248,3,1,98532,98532,98533,0,1,0
28249,3,1,98535,98535,98536,0,1,2
28250,2,1,98537,98537,98538,0,1,1
28251,3,2,98540,98540,98542,0,2,2
28252,4,2,98544,98544,98546,0,2,2
28253,4,1,98548,98548,98549,0,1,2
28254,6,2,98554,98554,98556,0,2,5
28255,5,1,98559,98559,98560,0,1,3
28256,5,2,98564,98564,98566,0,2,4
28257,5,1,98569,98569,98570,0,1,3
28258,6,2,98575,98575,98577,0,2,5
28259,5,3,98580,98580,98583,0,3,3
28260,3,2,98583,98583,98585,0,2,0
28261,6,2,98589,98589,98591,0,2,4
28262,1,2,98590,98591,98593,1,3,0
28263,6,2,98596,98596,98598,0,2,3
28264,5,3,98601,98601,98604,0,3,3
28265,4,2,98605,98605,98607,0,2,1
28266,6,2,98611,98611,98613,0,2,4
28267,2,2,98613,98613,98615,0,2,0
28268,5,2,98618,98618,98620,0,2,3
28269,1,2,98619,98620,98622,1,3,0
28270,2,2,98621,98622,98624,1,3,0
28271,5,1,98626,98626,98627,0,1,2
28272,5,1,98631,98631,98632,0,1,4
28273,3,1,98634,98634,98635,0,1,2
28274,5,3,98639,98639,98642,0,3,4
28275,6,1,98645,98645,98646,0,1,3
28276,1,2,98646,98646,98648,0,2,0
28277,3,1,98649,98649,98650,0,1,1
28278,2,2,98651,98651,98653,0,2,1
28279,4,2,98655,98655,98657,0,2,2
28280,4,3,98659,98659,98662,0,3,2
28281,4,1,98663,98663,98664,0,1,1
28282,6,3,98669,98669,98672,0,3,5
28283,5,2,98674,98674,98676,0,2,2
28284,3,3,98677,98677,98680,0,3,1
28285,5,1,98682,98682,98683,0,1,2
28286,2,3,98684,98684,98687,0,3,1
28287,2,3,98686,98687,98690,1,4,0
28288,6,2,98692,98692,98694,0,2,2
28289,6,3,98698,98698,98701,0,3,4
28290,3,1,98701,98701,98702,0,1,0
28291,3,2,98704,98704,98706,0,2,2
28292,3,3,98707,98707,98710,0,3,1
28293,1,3,98708,98710,98713,2,5,0
28294,4,3,98712,98713,98716,1,4,0
28295,2,3,98714,98716,98719,2,5,0
28296,6,2,98720,98720,98722,0,2,1
28297,6,3,98726,98726,98729,0,3,4
28298,6,1,98732,98732,98733,0,1,3
28299,2,3,98734,98734,98737,0,3,1
28300,2,3,98736,98737,98740,1,4,0
28301,1,2,98737,98740,98742,3,5,0
28302,4,3,98741,98742,98745,1,4,0
28303,5,3,98746,98746,98749,0,3,1
28304,6,1,98752,98752,98753,0,1,3
28305,2,3,98754,98754,98757,0,3,1
28306,4,2,98758,98758,98760,0,2,1
28307,4,1,98762,98762,98763,0,1,2
28308,5,2,98767,98767,98769,0,2,4
28309,1,2,98768,98769,98771,1,3,0
28310,5,2,98773,98773,98775,0,2,2
28311,6,1,98779,98779,98780,0,1,4
28312,2,3,98781,98781,98784,0,3,1
28313,4,3,98785,98785,98788,0,3,1
28314,2,3,98787,98788,98791,1,4,0
28315,2,1,98789,98791,98792,2,3,0
28316,6,1,98795,98795,98796,0,1,3
28317,4,1,98799,98799,98800,0,1,3
28318,1,1,98800,98800,98801,0,1,0
28319,1,3,98801,98801,98804,0,3,0
28320,4,3,98805,98805,98808,0,3,1
28321,6,2,98811,98811,98813,0,2,3
28322,5,1,98816,98816,98817,0,1,3
28323,3,3,98819,98819,98822,0,3,2
28324,3,1,98822,98822,98823,0,1,0
28325,5,1,98827,98827,98828,0,1,4
28326,1,3,98828,98828,98831,0,3,0
28327,1,1,98829,98831,98832,2,3,0
28328,4,1,98833,98833,98834,0,1,1
28329,4,1,98837,98837,98838,0,1,3
28330,2,3,98839,98839,98842,0,3,1
28331,6,2,98845,98845,98847,0,2,3
28332,5,3,98850,98850,98853,0,3,3
28333,1,2,98851,98853,98855,2,4,0
28334,4,1,98855,98855,98856,0,1,0
28335,5,3,98860,98860,98863,0,3,4
28336,6,3,98866,98866,98869,0,3,3
28337,2,2,98868,98869,98871,1,3,0
28338,1,2,98869,98871,98873,2,4,0
28339,2,1,98871,98873,98874,2,3,0
28340,2,2,98873,98874,98876,1,3,0
28341,6,2,98879,98879,98881,0,2,3
28342,5,1,98884,98884,98885,0,1,3
28343,5,1,98889,98889,98890,0,1,4
28344,4,3,98893,98893,98896,0,3,3
28345,3,3,98896,98896,98899,0,3,0
28346,4,2,98900,98900,98902,0,2,1
28347,6,2,98906,98906,98908,0,2,4
28348,3,2,98909,98909,98911,0,2,1
28349,6,1,98915,98915,98916,0,1,4
28350,3,2,98918,98918,98920,0,2,2
28351,1,1,98919,98920,98921,1,2,0
28352,4,1,98923,98923,98924,0,1,2
28353,3,3,98926,98926,98929,0,3,2
28354,2,3,98928,98929,98932,1,4,0
28355,6,3,98934,98934,98937,0,3,2
28356,1,2,98935,98937,98939,2,4,0
28357,2,2,98937,98939,98941,2,4,0
28358,4,2,98941,98941,98943,0,2,0
28359,4,3,98945,98945,98948,0,3,2
28360,5,1,98950,98950,98951,0,1,2
28361,4,1,98954,98954,98955,0,1,3
28362,5,3,98959,98959,98962,0,3,4
28363,4,3,98963,98963,98966,0,3,1
28364,6,1,98969,98969,98970,0,1,3
28365,2,3,98971,98971,98974,0,3,1
28366,2,3,98973,98974,98977,1,4,0
28367,6,3,98979,98979,98982,0,3,2
28368,3,1,98982,98982,98983,0,1,0
28369,2,2,98984,98984,98986,0,2,1
28370,5,1,98989,98989,98990,0,1,3
28371,3,1,98992,98992,98993,0,1,2
28372,5,2,98997,98997,98999,0,2,4
28373,1,2,98998,98999,99001,1,3,0
28374,6,2,99004,99004,99006,0,2,3
28375,5,3,99009,99009,99012,0,3,3
28376,4,2,99013,99013,99015,0,2,1
28377,4,3,99017,99017,99020,0,3,2
28378,4,2,99021,99021,99023,0,2,1
28379,1,1,99022,99023,99024,1,2,0
28380,2,1,99024,99024,99025,0,1,0
28381,5,3,99029,99029,99032,0,3,4
28382,1,1,99030,99032,99033,2,3,0
28383,1,2,99031,99033,99035,2,4,0
28384,2,1,99033,99035,99036,2,3,0
28385,3,3,99036,99036,99039,0,3,0
28386,2,2,99038,99039,99041,1,3,0
28387,3,2,99041,99041,99043,0,2,0
28388,4,3,99045,99045,99048,0,3,2
28389,5,2,99050,99050,99052,0,2,2
28390,5,3,99055,99055,99058,0,3,3
28391,3,2,99058,99058,99060,0,2,0
28392,2,1,99060,99060,99061,0,1,0
28393,3,2,99063,99063,99065,0,2,2
28394,1,1,99064,99065,99066,1,2,0
28395,1,1,99065,99066,99067,1,2,0
28396,4,3,99069,99069,99072,0,3,2
28397,5,1,99074,99074,99075,0,1,2
28398,2,1,99076,99076,99077,0,1,1
28399,1,1,99077,99077,99078,0,1,0
28400,4,3,99081,99081,99084,0,3,3
28401,2,1,99083,99084,99085,1,2,0
28402,1,1,99084,99085,99086,1,2,0
28403,4,1,99088,99088,99089,0,1,2
28404,1,3,99089,99089,99092,0,3,0
28405,2,2,99091,99092,99094,1,3,0
28406,6,3,99097,99097,99100,0,3,3
28407,1,1,99098,99100,99101,2,3,0
28408,2,2,99100,99101,99103,1,3,0
28409,5,3,99105,99105,99108,0,3,2
28410,6,2,99111,99111,99113,0,2,3
28411,2,2,99113,99113,99115,0,2,0
28412,3,1,99116,99116,99117,0,1,1
28413,6,3,99122,99122,99125,0,3,5
28414,2,1,99124,99125,99126,1,2,0
28415,3,1,99127,99127,99128,0,1,1
28416,6,2,99133,99133,99135,0,2,5
28417,4,2,99137,99137,99139,0,2,2
28418,2,3,99139,99139,99142,0,3,0
28419,2,3,99141,99142,99145,1,4,0
28420,2,2,99143,99145,99147,2,4,0
28421,5,1,99148,99148,99149,0,1,1
28422,6,3,99154,99154,99157,0,3,5
28423,3,2,99157,99157,99159,0,2,0
28424,6,2,99163,99163,99165,0,2,4
28425,2,1,99165,99165,99166,0,1,0
28426,6,3,99171,99171,99174,0,3,5
28427,1,2,99172,99174,99176,2,4,0
28428,2,2,99174,99176,99178,2,4,0
28429,3,1,99177,99178,99179,1,2,0
28430,4,1,99181,99181,99182,0,1,2
28431,3,2,99184,99184,99186,0,2,2
28432,2,3,99186,99186,99189,0,3,0
28433,3,3,99189,99189,99192,0,3,0
28434,3,2,99192,99192,99194,0,2,0
28435,3,2,99195,99195,99197,0,2,1
28436,2,2,99197,99197,99199,0,2,0
28437,2,3,99199,99199,99202,0,3,0
28438,5,3,99204,99204,99207,0,3,2
28439,2,2,99206,99207,99209,1,3,0
28440,2,1,99208,99209,99210,1,2,0
28441,4,3,99212,99212,99215,0,3,2
28442,6,3,99218,99218,99221,0,3,3
28443,6,2,99224,99224,99226,0,2,3
28444,3,1,99227,99227,99228,0,1,1
28445,4,3,99231,99231,99234,0,3,3
28446,2,3,99233,99234,99237,1,4,0
28447,4,2,99237,99237,99239,0,2,0
28448,3,1,99240,99240,99241,0,1,1
28449,1,2,99241,99241,99243,0,2,0
28450,2,1,99243,99243,99244,0,1,0
28451,1,1,99244,99244,99245,0,1,0
28452,2,1,99246,99246,99247,0,1,1
28453,6,2,99252,99252,99254,0,2,5
28454,2,1,99254,99254,99255,0,1,0
28455,4,1,99258,99258,99259,0,1,3
28456,5,3,99263,99263,99266,0,3,4
28457,1,3,99264,99266,99269,2,5,0
28458,4,2,99268,99269,99271,1,3,0
28459,2,2,99270,99271,99273,1,3,0
28460,5,2,99275,99275,99277,0,2,2
28461,1,2,99276,99277,99279,1,3,0
28462,4,3,99280,99280,99283,0,3,1
28463,2,3,99282,99283,99286,1,4,0
28464,2,2,99284,99286,99288,2,4,0
28465,5,1,99289,99289,99290,0,1,1
28466,1,2,99290,99290,99292,0,2,0
28467,2,2,99292,99292,99294,0,2,0
28468,6,2,99298,99298,99300,0,2,4
28469,1,3,99299,99300,99303,1,4,0
28470,6,3,99305,99305,99308,0,3,2
28471,5,3,99310,99310,99313,0,3,2
28472,1,1,99311,99313,99314,2,3,0
28473,1,2,99312,99314,99316,2,4,0
28474,3,1,99315,99316,99317,1,2,0
28475,1,1,99316,99317,99318,1,2,0
28476,4,3,99320,99320,99323,0,3,2
28477,4,3,99324,99324,99327,0,3,1
28478,5,1,99329,99329,99330,0,1,2
28479,3,2,99332,99332,99334,0,2,2
28480,5,2,99337,99337,99339,0,2,3
28481,5,2,99342,99342,99344,0,2,3
28482,6,2,99348,99348,99350,0,2,4
28483,4,2,99352,99352,99354,0,2,2
28484,3,1,99355,99355,99356,0,1,1
28485,5,2,99360,99360,99362,0,2,4
28486,6,3,99366,99366,99369,0,3,4
28487,2,2,99368,99369,99371,1,3,0
28488,4,1,99372,99372,99373,0,1,1
28489,4,1,99376,99376,99377,0,1,3
28490,5,2,99381,99381,99383,0,2,4
28491,1,3,99382,99383,99386,1,4,0
28492,3,3,99385,99386,99389,1,4,0
28493,4,1,99389,99389,99390,0,1,0
28494,6,3,99395,99395,99398,0,3,5
28495,1,1,99396,99398,99399,2,3,0
28496,1,3,99397,99399,99402,2,5,0
28497,5,1,99402,99402,99403,0,1,0
28498,5,1,99407,99407,99408,0,1,4
28499,3,3,99410,99410,99413,0,3,2
28500,3,2,99413,99413,99415,0,2,0
28501,6,1,99419,99419,99420,0,1,4
28502,6,1,99425,99425,99426,0,1,5
28503,4,2,99429,99429,99431,0,2,3
28504,1,3,99430,99431,99434,1,4,0
28505,3,3,99433,99434,99437,1,4,0
28506,6,3,99439,99439,99442,0,3,2
28507,6,2,99445,99445,99447,0,2,3
28508,2,3,99447,99447,99450,0,3,0
28509,1,2,99448,99450,99452,2,4,0
28510,6,2,99454,99454,99456,0,2,2
28511,1,1,99455,99456,99457,1,2,0
28512,4,3,99459,99459,99462,0,3,2
28513,4,2,99463,99463,99465,0,2,1
28514,6,2,99469,99469,99471,0,2,4
28515,1,1,99470,99471,99472,1,2,0
28516,5,3,99475,99475,99478,0,3,3
28517,6,3,99481,99481,99484,0,3,3
28518,5,2,99486,99486,99488,0,2,2
28519,3,1,99489,99489,99490,0,1,1
28520,6,3,99495,99495,99498,0,3,5
28521,1,1,99496,99498,99499,2,3,0
28522,6,2,99502,99502,99504,0,2,3
28523,3,1,99505,99505,99506,0,1,1
28524,3,1,99508,99508,99509,0,1,2
28525,2,1,99510,99510,99511,0,1,1
28526,3,2,99513,99513,99515,0,2,2
28527,4,1,99517,99517,99518,0,1,2
28528,1,3,99518,99518,99521,0,3,0
28529,6,1,99524,99524,99525,0,1,3
28530,6,2,99530,99530,99532,0,2,5
28531,5,1,99535,99535,99536,0,1,3
28532,1,3,99536,99536,99539,0,3,0
28533,6,3,99542,99542,99545,0,3,3
28534,6,3,99548,99548,99551,0,3,3
28535,2,3,99550,99551,99554,1,4,0
28536,5,2,99555,99555,99557,0,2,1
28537,2,1,99557,99557,99558,0,1,0
28538,2,3,99559,99559,99562,0,3,1
28539,5,3,99564,99564,99567,0,3,2
28540,4,3,99568,99568,99571,0,3,1
28541,3,3,99571,99571,99574,0,3,0
28542,4,3,99575,99575,99578,0,3,1
28543,6,3,99581,99581,99584,0,3,3
28544,2,2,99583,99584,99586,1,3,0
28545,3,3,99586,99586,99589,0,3,0
28546,2,2,99588,99589,99591,1,3,0
28547,1,2,99589,99591,99593,2,4,0
28548,3,3,99592,99593,99596,1,4,0
28549,1,3,99593,99596,99599,3,6,0
28550,3,1,99596,99599,99600,3,4,0
28551,1,2,99597,99600,99602,3,5,0
28552,4,3,99601,99602,99605,1,4,0
28553,1,2,99602,99605,99607,3,5,0
28554,1,1,99603,99607,99608,4,5,0
28555,4,3,99607,99608,99611,1,4,0
28556,1,1,99608,99611,99612,3,4,0
28557,2,3,99610,99612,99615,2,5,0
28558,2,2,99612,99615,99617,3,5,0
28559,6,1,99618,99618,99619,0,1,1
28560,1,3,99619,99619,99622,0,3,0
28561,5,2,99624,99624,99626,0,2,2
28562,3,1,99627,99627,99628,0,1,1
28563,6,1,99633,99633,99634,0,1,5
28564,3,1,99636,99636,99637,0,1,2
28565,4,3,99640,99640,99643,0,3,3
28566,3,1,99643,99643,99644,0,1,0
28567,2,3,99645,99645,99648,0,3,1
28568,4,3,99649,99649,99652,0,3,1
28569,6,2,99655,99655,99657,0,2,3
28570,3,1,99658,99658,99659,0,1,1
28571,2,3,99660,99660,99663,0,3,1
28572,6,3,99666,99666,99669,0,3,3
28573,4,2,99670,99670,99672,0,2,1
28574,3,3,99673,99673,99676,0,3,1
28575,2,2,99675,99676,99678,1,3,0
28576,3,1,99678,99678,99679,0,1,0
28577,6,2,99684,99684,99686,0,2,5
28578,1,3,99685,99686,99689,1,4,0
28579,2,1,99687,99689,99690,2,3,0
28580,5,1,99692,99692,99693,0,1,2
28581,3,1,99695,99695,99696,0,1,2
28582,6,2,99701,99701,99703,0,2,5
28583,3,3,99704,99704,99707,0,3,1
28584,3,1,99707,99707,99708,0,1,0
28585,3,1,99710,99710,99711,0,1,2
28586,6,3,99716,99716,99719,0,3,5
28587,1,3,99717,99719,99722,2,5,0
28588,2,3,99719,99722,99725,3,6,0
28589,6,2,99725,99725,99727,0,2,0
28590,5,3,99730,99730,99733,0,3,3
28591,2,2,99732,99733,99735,1,3,0
28592,1,2,99733,99735,99737,2,4,0
28593,2,3,99735,99737,99740,2,5,0
28594,1,2,99736,99740,99742,4,6,0
28595,6,2,99742,99742,99744,0,2,0
28596,5,2,99747,99747,99749,0,2,3
28597,4,2,99751,99751,99753,0,2,2
28598,2,2,99753,99753,99755,0,2,0
28599,6,1,99759,99759,99760,0,1,4
28600,5,3,99764,99764,99767,0,3,4
28601,5,1,99769,99769,99770,0,1,2
28602,3,1,99772,99772,99773,0,1,2
28603,1,2,99773,99773,99775,0,2,0
28604,6,1,99779,99779,99780,0,1,4
28605,2,3,99781,99781,99784,0,3,1
28606,1,1,99782,99784,99785,2,3,0
28607,2,3,99784,99785,99788,1,4,0
28608,6,1,99790,99790,99791,0,1,2
28609,1,3,99791,99791,99794,0,3,0
28610,2,1,99793,99794,99795,1,2,0
28611,6,1,99799,99799,99800,0,1,4
28612,5,1,99804,99804,99805,0,1,4
28613,2,1,99806,99806,99807,0,1,1
28614,5,3,99811,99811,99814,0,3,4
28615,4,2,99815,99815,99817,0,2,1
28616,6,2,99821,99821,99823,0,2,4
28617,6,2,99827,99827,99829,0,2,4
28618,6,3,99833,99833,99836,0,3,4
28619,6,1,99839,99839,99840,0,1,3
28620,6,3,99845,99845,99848,0,3,5
28621,2,1,99847,99848,99849,1,2,0
28622,1,3,99848,99849,99852,1,4,0
28623,5,3,99853,99853,99856,0,3,1
28624,5,2,99858,99858,99860,0,2,2
28625,5,1,99863,99863,99864,0,1,3
28626,5,3,99868,99868,99871,0,3,4
28627,1,2,99869,99871,99873,2,4,0
28628,3,3,99872,99873,99876,1,4,0
28629,5,3,99877,99877,99880,0,3,1
28630,1,2,99878,99880,99882,2,4,0
28631,5,3,99883,99883,99886,0,3,1
28632,1,2,99884,99886,99888,2,4,0
28633,3,3,99887,99888,99891,1,4,0
28634,5,3,99892,99892,99895,0,3,1
28635,3,3,99895,99895,99898,0,3,0
28636,4,1,99899,99899,99900,0,1,1
28637,5,1,99904,99904,99905,0,1,4
28638,6,2,99910,99910,99912,0,2,5
28639,5,2,99915,99915,99917,0,2,3
28640,3,3,99918,99918,99921,0,3,1
28641,1,2,99919,99921,99923,2,4,0
28642,6,2,99925,99925,99927,0,2,2
28643,3,3,99928,99928,99931,0,3,1
28644,4,1,99932,99932,99933,0,1,1
28645,4,2,99936,99936,99938,0,2,3
28646,6,2,99942,99942,99944,0,2,4
28647,5,1,99947,99947,99948,0,1,3
28648,2,1,99949,99949,99950,0,1,1
28649,3,2,99952,99952,99954,0,2,2
28650,4,2,99956,99956,99958,0,2,2
28651,6,1,99962,99962,99963,0,1,4
28652,3,2,99965,99965,99967,0,2,2
28653,3,2,99968,99968,99970,0,2,1
28654,2,3,99970,99970,99973,0,3,0
28655,6,3,99976,99976,99979,0,3,3
28656,5,2,99981,99981,99983,0,2,2
28657,3,1,99984,99984,99985,0,1,1
28658,1,2,99985,99985,99987,0,2,0
28659,1,3,99986,99987,99990,1,4,0
28660,5,2,99991,99991,99993,0,2,1
28661,4,1,99995,99995,99996,0,1,2
28662,1,2,99996,99996,99998,0,2,0
28663,2,3,99998,99998,100001,0,3,0
28664,3,2,100001,100001,100003,0,2,0
28665,5,1,100006,100006,100007,0,1,3
28666,5,2,100011,100011,100013,0,2,4
28667,3,2,100014,100014,100016,0,2,1
28668,2,2,100016,100016,100018,0,2,0
28669,4,3,100020,100020,100023,0,3,2
28670,6,1,100026,100026,100027,0,1,3
28671,2,2,100028,100028,100030,0,2,1
28672,4,1,100032,100032,100033,0,1,2
28673,2,2,100034,100034,100036,0,2,1
28674,1,1,100035,100036,100037,1,2,0
28675,4,3,100039,100039,100042,0,3,2
28676,2,1,100041,100042,100043,1,2,0
28677,6,1,100047,100047,100048,0,1,4
28678,5,3,100052,100052,100055,0,3,4
28679,4,1,100056,100056,100057,0,1,1
28680,2,2,100058,100058,100060,0,2,1
28681,6,2,100064,100064,100066,0,2,4
28682,5,3,100069,100069,100072,0,3,3
28683,2,2,100071,100072,100074,1,3,0
28684,6,1,100077,100077,100078,0,1,3
28685,6,3,100083,100083,100086,0,3,5
28686,4,2,100087,100087,100089,0,2,1
28687,4,2,100091,100091,100093,0,2,2
28688,3,3,100094,100094,100097,0,3,1
28689,4,2,100098,100098,100100,0,2,1
28690,3,1,100101,100101,100102,0,1,1
28691,5,1,100106,100106,100107,0,1,4
28692,1,1,100107,100107,100108,0,1,0
28693,5,1,100112,100112,100113,0,1,4
28694,6,2,100118,100118,100120,0,2,5
28695,4,3,100122,100122,100125,0,3,2
28696,3,3,100125,100125,100128,0,3,0
28697,5,3,100130,100130,100133,0,3,2
28698,1,3,100131,100133,100136,2,5,0
28699,4,2,100135,100136,100138,1,3,0
28700,5,1,100140,100140,100141,0,1,2
28701,1,2,100141,100141,100143,0,2,0
28702,3,3,100144,100144,100147,0,3,1
28703,5,2,100149,100149,100151,0,2,2
28704,1,2,100150,100151,100153,1,3,0
28705,3,3,100153,100153,100156,0,3,0
28706,5,3,100158,100158,100161,0,3,2
28707,5,2,100163,100163,100165,0,2,2
28708,6,1,100169,100169,100170,0,1,4
28709,5,2,100174,100174,100176,0,2,4
28710,2,3,100176,100176,100179,0,3,0
28711,6,3,100182,100182,100185,0,3,3
28712,2,1,100184,100185,100186,1,2,0
28713,5,1,100189,100189,100190,0,1,3
28714,2,1,100191,100191,100192,0,1,1
28715,3,2,100194,100194,100196,0,2,2
28716,6,2,100200,100200,100202,0,2,4
28717,1,1,100201,100202,100203,1,2,0
28718,2,1,100203,100203,100204,0,1,0
28719,4,2,100207,100207,100209,0,2,3
28720,2,2,100209,100209,100211,0,2,0
28721,5,3,100214,100214,100217,0,3,3
28722,3,3,100217,100217,100220,0,3,0
28723,6,1,100223,100223,100224,0,1,3
28724,5,2,100228,100228,100230,0,2,4
28725,1,2,100229,100230,100232,1,3,0
28726,2,3,100231,100232,100235,1,4,0
28727,1,2,100232,100235,100237,3,5,0
28728,1,1,100233,100237,100238,4,5,0
28729,5,3,100238,100238,100241,0,3,0
28730,3,3,100241,100241,100244,0,3,0
28731,1,2,100242,100244,100246,2,4,0
28732,3,3,100245,100246,100249,1,4,0
28733,6,1,100251,100251,100252,0,1,2
28734,3,1,100254,100254,100255,0,1,2
28735,4,1,100258,100258,100259,0,1,3
28736,6,2,100264,100264,100266,0,2,5
28737,4,3,100268,100268,100271,0,3,2
28738,1,3,100269,100271,100274,2,5,0
28739,5,3,100274,100274,100277,0,3,0
28740,5,2,100279,100279,100281,0,2,2
28741,1,3,100280,100281,100284,1,4,0
28742,5,2,100285,100285,100287,0,2,1
28743,5,1,100290,100290,100291,0,1,3
28744,6,3,100296,100296,100299,0,3,5
28745,3,3,100299,100299,100302,0,3,0
28746,1,2,100300,100302,100304,2,4,0
28747,2,1,100302,100304,100305,2,3,0
28748,4,3,100306,100306,100309,0,3,1
28749,5,3,100311,100311,100314,0,3,2
28750,4,3,100315,100315,100318,0,3,1
28751,3,2,100318,100318,100320,0,2,0
28752,5,2,100323,100323,100325,0,2,3
28753,1,3,100324,100325,100328,1,4,0
28754,4,1,100328,100328,100329,0,1,0
28755,4,2,100332,100332,100334,0,2,3
28756,3,3,100335,100335,100338,0,3,1
28757,5,3,100340,100340,100343,0,3,2
28758,3,2,100343,100343,100345,0,2,0
28759,2,2,100345,100345,100347,0,2,0
28760,6,3,100351,100351,100354,0,3,4
28761,3,2,100354,100354,100356,0,2,0
28762,6,1,100360,100360,100361,0,1,4
28763,5,2,100365,100365,100367,0,2,4
28764,5,1,100370,100370,100371,0,1,3
28765,5,3,100375,100375,100378,0,3,4
28766,6,1,100381,100381,100382,0,1,3
28767,6,1,100387,100387,100388,0,1,5
28768,5,1,100392,100392,100393,0,1,4
28769,5,2,100397,100397,100399,0,2,4
28770,1,1,100398,100399,100400,1,2,0
28771,2,2,100400,100400,100402,0,2,0
28772,4,1,100404,100404,100405,0,1,2
28773,3,3,100407,100407,100410,0,3,2
28774,1,3,100408,100410,100413,2,5,0
28775,3,2,100411,100413,100415,2,4,0
28776,4,2,100415,100415,100417,0,2,0
28777,5,1,100420,100420,100421,0,1,3
28778,2,1,100422,100422,100423,0,1,1
28779,2,2,100424,100424,100426,0,2,1
28780,5,1,100429,100429,100430,0,1,3
28781,5,2,100434,100434,100436,0,2,4
28782,4,2,100438,100438,100440,0,2,2
28783,4,3,100442,100442,100445,0,3,2
28784,1,2,100443,100445,100447,2,4,0
28785,2,3,100445,100447,100450,2,5,0
28786,2,2,100447,100450,100452,3,5,0
28787,5,3,100452,100452,100455,0,3,0
28788,3,1,100455,100455,100456,0,1,0
28789,4,3,100459,100459,100462,0,3,3
28790,1,2,100460,100462,100464,2,4,0
28791,5,1,100465,100465,100466,0,1,1
28792,3,3,100468,100468,100471,0,3,2
28793,4,3,100472,100472,100475,0,3,1
28794,5,2,100477,100477,100479,0,2,2
28795,4,3,100481,100481,100484,0,3,2
28796,3,3,100484,100484,100487,0,3,0
28797,1,3,100485,100487,100490,2,5,0
28798,4,3,100489,100490,100493,1,4,0
28799,6,2,100495,100495,100497,0,2,2
28800,5,1,100500,100500,100501,0,1,3
28801,4,3,100504,100504,100507,0,3,3
28802,4,3,100508,100508,100511,0,3,1
28803,1,2,100509,100511,100513,2,4,0
28804,5,3,100514,100514,100517,0,3,1
28805,6,3,100520,100520,100523,0,3,3
28806,2,3,100522,100523,100526,1,4,0
28807,3,2,100525,100526,100528,1,3,0
28808,6,2,100531,100531,100533,0,2,3
28809,6,2,100537,100537,100539,0,2,4
28810,4,1,100541,100541,100542,0,1,2
28811,1,3,100542,100542,100545,0,3,0
28812,1,3,100543,100545,100548,2,5,0
28813,4,1,100547,100548,100549,1,2,0
28814,3,3,100550,100550,100553,0,3,1
28815,4,1,100554,100554,100555,0,1,1
28816,2,2,100556,100556,100558,0,2,1
28817,1,2,100557,100558,100560,1,3,0
28818,5,2,100562,100562,100564,0,2,2
28819,5,3,100567,100567,100570,0,3,3
28820,4,3,100571,100571,100574,0,3,1
28821,1,2,100572,100574,100576,2,4,0
28822,6,1,100578,100578,100579,0,1,2
28823,2,1,100580,100580,100581,0,1,1
28824,3,3,100583,100583,100586,0,3,2
28825,6,2,100589,100589,100591,0,2,3
28826,4,3,100593,100593,100596,0,3,2
28827,1,1,100594,100596,100597,2,3,0
28828,1,1,100595,100597,100598,2,3,0
28829,4,2,100599,100599,100601,0,2,1
28830,4,2,100603,100603,100605,0,2,2
28831,5,1,100608,100608,100609,0,1,3
28832,4,3,100612,100612,100615,0,3,3
28833,1,2,100613,100615,100617,2,4,0
28834,1,1,100614,100617,100618,3,4,0
28835,1,3,100615,100618,100621,3,6,0
28836,6,3,100621,100621,100624,0,3,0
28837,4,3,100625,100625,100628,0,3,1
28838,3,2,100628,100628,100630,0,2,0
28839,6,2,100634,100634,100636,0,2,4
28840,4,1,100638,100638,100639,0,1,2
28841,1,1,100639,100639,100640,0,1,0
28842,1,3,100640,100640,100643,0,3,0
28843,1,2,100641,100643,100645,2,4,0
28844,5,2,100646,100646,100648,0,2,1
28845,3,1,100649,100649,100650,0,1,1
28846,4,3,100653,100653,100656,0,3,3
28847,3,3,100656,100656,100659,0,3,0
28848,1,1,100657,100659,100660,2,3,0
28849,1,1,100658,100660,100661,2,3,0
28850,1,3,100659,100661,100664,2,5,0
28851,1,1,100660,100664,100665,4,5,0
28852,1,1,100661,100665,100666,4,5,0
28853,1,1,100662,100666,100667,4,5,0
28854,3,2,100665,100667,100669,2,4,0
28855,6,1,100671,100671,100672,0,1,2
28856,4,3,100675,100675,100678,0,3,3
28857,6,3,100681,100681,100684,0,3,3
28858,5,2,100686,100686,100688,0,2,2
28859,2,2,100688,100688,100690,0,2,0
28860,2,2,100690,100690,100692,0,2,0
28861,4,3,100694,100694,100697,0,3,2
28862,2,2,100696,100697,100699,1,3,0
28863,4,3,100700,100700,100703,0,3,1
28864,1,2,100701,100703,100705,2,4,0
28865,3,3,100704,100705,100708,1,4,0
28866,1,3,100705,100708,100711,3,6,0
28867,6,3,100711,100711,100714,0,3,0
28868,4,2,100715,100715,100717,0,2,1
28869,5,3,100720,100720,100723,0,3,3
28870,4,1,100724,100724,100725,0,1,1
28871,6,1,100730,100730,100731,0,1,5
28872,2,3,100732,100732,100735,0,3,1
28873,5,2,100737,100737,100739,0,2,2
28874,6,3,100743,100743,100746,0,3,4
28875,3,3,100746,100746,100749,0,3,0
28876,2,1,100748,100749,100750,1,2,0
28877,5,2,100753,100753,100755,0,2,3
28878,1,3,100754,100755,100758,1,4,0
28879,6,3,100760,100760,100763,0,3,2
28880,2,2,100762,100763,100765,1,3,0
28881,6,3,100768,100768,100771,0,3,3
28882,5,3,100773,100773,100776,0,3,2
28883,1,1,100774,100776,100777,2,3,0
28884,5,1,100779,100779,100780,0,1,2
28885,3,2,100782,100782,100784,0,2,2
28886,6,1,100788,100788,100789,0,1,4
28887,2,2,100790,100790,100792,0,2,1
28888,4,2,100794,100794,100796,0,2,2
28889,5,2,100799,100799,100801,0,2,3
28890,1,2,100800,100801,100803,1,3,0
28891,4,2,100804,100804,100806,0,2,1
28892,5,3,100809,100809,100812,0,3,3
28893,1,1,100810,100812,100813,2,3,0
28894,2,3,100812,100813,100816,1,4,0
28895,2,3,100814,100816,100819,2,5,0
28896,1,3,100815,100819,100822,4,7,0
28897,3,2,100818,100822,100824,4,6,0
28898,2,3,100820,100824,100827,4,7,0
28899,6,2,100826,100827,100829,1,3,0
28900,2,2,100828,100829,100831,1,3,0
28901,3,2,100831,100831,100833,0,2,0
28902,1,1,100832,100833,100834,1,2,0
28903,2,1,100834,100834,100835,0,1,0
28904,5,2,100839,100839,100841,0,2,4
28905,2,3,100841,100841,100844,0,3,0
28906,1,2,100842,100844,100846,2,4,0
28907,1,1,100843,100846,100847,3,4,0
28908,5,2,100848,100848,100850,0,2,1
28909,2,2,100850,100850,100852,0,2,0
28910,1,3,100851,100852,100855,1,4,0
28911,1,3,100852,100855,100858,3,6,0
28912,5,2,100857,100858,100860,1,3,0
28913,1,3,100858,100860,100863,2,5,0
28914,2,3,100860,100863,100866,3,6,0
28915,6,3,100866,100866,100869,0,3,0
28916,4,2,100870,100870,100872,0,2,1
28917,2,2,100872,100872,100874,0,2,0
28918,4,2,100876,100876,100878,0,2,2
28919,6,3,100882,100882,100885,0,3,4
28920,3,3,100885,100885,100888,0,3,0
28921,5,3,100890,100890,100893,0,3,2
28922,6,3,100896,100896,100899,0,3,3
28923,2,1,100898,100899,100900,1,2,0
28924,2,3,100900,100900,100903,0,3,0
28925,1,3,100901,100903,100906,2,5,0
28926,3,2,100904,100906,100908,2,4,0
28927,2,2,100906,100908,100910,2,4,0
28928,2,1,100908,100910,100911,2,3,0
28929,1,2,100909,100911,100913,2,4,0
28930,5,2,100914,100914,100916,0,2,1
28931,3,3,100917,100917,100920,0,3,1
28932,6,1,100923,100923,100924,0,1,3
28933,2,1,100925,100925,100926,0,1,1
28934,2,2,100927,100927,100929,0,2,1
28935,6,2,100933,100933,100935,0,2,4
28936,1,3,100934,100935,100938,1,4,0
28937,1,3,100935,100938,100941,3,6,0
28938,3,1,100938,100941,100942,3,4,0
28939,2,3,100940,100942,100945,2,5,0
28940,5,3,100945,100945,100948,0,3,0
28941,4,1,100949,100949,100950,0,1,1
28942,3,1,100952,100952,100953,0,1,2
28943,4,1,100956,100956,100957,0,1,3
28944,6,1,100962,100962,100963,0,1,5
28945,2,2,100964,100964,100966,0,2,1
28946,5,2,100969,100969,100971,0,2,3
28947,4,2,100973,100973,100975,0,2,2
28948,6,1,100979,100979,100980,0,1,4
28949,1,1,100980,100980,100981,0,1,0
28950,2,2,100982,100982,100984,0,2,1
28951,6,2,100988,100988,100990,0,2,4
28952,6,1,100994,100994,100995,0,1,4
28953,6,1,101000,101000,101001,0,1,5
28954,1,3,101001,101001,101004,0,3,0
28955,2,3,101003,101004,101007,1,4,0
28956,1,2,101004,101007,101009,3,5,0
28957,2,3,101006,101009,101012,3,6,0
28958,5,1,101011,101012,101013,1,2,0
28959,6,3,101017,101017,101020,0,3,4
28960,6,3,101023,101023,101026,0,3,3
28961,2,1,101025,101026,101027,1,2,0
28962,6,1,101031,101031,101032,0,1,4
28963,5,1,101036,101036,101037,0,1,4
28964,3,3,101039,101039,101042,0,3,2
28965,1,2,101040,101042,101044,2,4,0
28966,3,1,101043,101044,101045,1,2,0
28967,2,3,101045,101045,101048,0,3,0
28968,2,2,101047,101048,101050,1,3,0
28969,3,3,101050,101050,101053,0,3,0
28970,1,2,101051,101053,101055,2,4,0
28971,5,2,101056,101056,101058,0,2,1
28972,4,3,101060,101060,101063,0,3,2
28973,5,1,101065,101065,101066,0,1,2
28974,6,1,101071,101071,101072,0,1,5
28975,2,1,101073,101073,101074,0,1,1
28976,6,3,101079,101079,101082,0,3,5
28977,3,1,101082,101082,101083,0,1,0
28978,5,3,101087,101087,101090,0,3,4
28979,5,1,101092,101092,101093,0,1,2
28980,6,3,101098,101098,101101,0,3,5
28981,4,2,101102,101102,101104,0,2,1
28982,2,3,101104,101104,101107,0,3,0
28983,2,3,101106,101107,101110,1,4,0
28984,5,2,101111,101111,101113,0,2,1
28985,6,3,101117,101117,101120,0,3,4
28986,1,1,101118,101120,101121,2,3,0
28987,1,2,101119,101121,101123,2,4,0
28988,1,1,101120,101123,101124,3,4,0
28989,5,1,101125,101125,101126,0,1,1
28990,4,3,101129,101129,101132,0,3,3
28991,5,3,101134,101134,101137,0,3,2
28992,2,1,101136,101137,101138,1,2,0
28993,4,1,101140,101140,101141,0,1,2
28994,2,1,101142,101142,101143,0,1,1
28995,4,3,101146,101146,101149,0,3,3
28996,4,1,101150,101150,101151,0,1,1
28997,1,2,101151,101151,101153,0,2,0
28998,2,2,101153,101153,101155,0,2,0
28999,5,2,101158,101158,101160,0,2,3
29000,3,2,101161,101161,101163,0,2,1
29001,2,1,101163,101163,101164,0,1,0
29002,6,3,101169,101169,101172,0,3,5
29003,5,2,101174,101174,101176,0,2,2
29004,2,1,101176,101176,101177,0,1,0
29005,4,1,101180,101180,101181,0,1,3
29006,6,3,101186,101186,101189,0,3,5
29007,1,3,101187,101189,101192,2,5,0
29008,4,3,101191,101192,101195,1,4,0
29009,3,2,101194,101195,101197,1,3,0
29010,3,3,101197,101197,101200,0,3,0
29011,6,2,101203,101203,101205,0,2,3
29012,3,2,101206,101206,101208,0,2,1
29013,4,1,101210,101210,101211,0,1,2
29014,3,2,101213,101213,101215,0,2,2
29015,4,2,101217,101217,101219,0,2,2
29016,3,1,101220,101220,101221,0,1,1
29017,1,1,101221,101221,101222,0,1,0
29018,5,3,101226,101226,101229,0,3,4
29019,3,3,101229,101229,101232,0,3,0
29020,4,3,101233,101233,101236,0,3,1
29021,6,3,101239,101239,101242,0,3,3
29022,2,1,101241,101242,101243,1,2,0
29023,3,1,101244,101244,101245,0,1,1
29024,2,2,101246,101246,101248,0,2,1
29025,2,2,101248,101248,101250,0,2,0
29026,5,3,101253,101253,101256,0,3,3
29027,3,1,101256,101256,101257,0,1,0
29028,5,1,101261,101261,101262,0,1,4
29029,5,1,101266,101266,101267,0,1,4
29030,2,3,101268,101268,101271,0,3,1
29031,4,1,101272,101272,101273,0,1,1
29032,3,2,101275,101275,101277,0,2,2
29033,6,1,101281,101281,101282,0,1,4
29034,2,1,101283,101283,101284,0,1,1
29035,3,1,101286,101286,101287,0,1,2
29036,6,3,101292,101292,101295,0,3,5
29037,1,2,101293,101295,101297,2,4,0
29038,2,2,101295,101297,101299,2,4,0
29039,6,1,101301,101301,101302,0,1,2
29040,4,3,101305,101305,101308,0,3,3
29041,4,2,101309,101309,101311,0,2,1
29042,4,3,101313,101313,101316,0,3,2
29043,2,2,101315,101316,101318,1,3,0
29044,6,1,101321,101321,101322,0,1,3
29045,2,3,101323,101323,101326,0,3,1
29046,6,3,101329,101329,101332,0,3,3
29047,1,1,101330,101332,101333,2,3,0
29048,6,1,101336,101336,101337,0,1,3
29049,2,1,101338,101338,101339,0,1,1
29050,1,2,101339,101339,101341,0,2,0
29051,3,1,101342,101342,101343,0,1,1
29052,6,1,101348,101348,101349,0,1,5
29053,2,1,101350,101350,101351,0,1,1
29054,2,2,101352,101352,101354,0,2,1
29055,6,1,101358,101358,101359,0,1,4
29056,5,3,101363,101363,101366,0,3,4
29057,1,1,101364,101366,101367,2,3,0
29058,4,1,101368,101368,101369,0,1,1
29059,1,2,101369,101369,101371,0,2,0
29060,5,1,101374,101374,101375,0,1,3
29061,1,1,101375,101375,101376,0,1,0
29062,1,1,101376,101376,101377,0,1,0
29063,6,2,101382,101382,101384,0,2,5
29064,4,2,101386,101386,101388,0,2,2
29065,3,2,101389,101389,101391,0,2,1
29066,5,2,101394,101394,101396,0,2,3
29067,6,3,101400,101400,101403,0,3,4
29068,3,3,101403,101403,101406,0,3,0
29069,2,1,101405,101406,101407,1,2,0
29070,2,1,101407,101407,101408,0,1,0
29071,2,3,101409,101409,101412,0,3,1
29072,4,2,101413,101413,101415,0,2,1
29073,6,2,101419,101419,101421,0,2,4
29074,1,3,101420,101421,101424,1,4,0
29075,2,3,101422,101424,101427,2,5,0
29076,3,2,101425,101427,101429,2,4,0
29077,2,3,101427,101429,101432,2,5,0
29078,1,2,101428,101432,101434,4,6,0
29079,6,2,101434,101434,101436,0,2,0
29080,5,2,101439,101439,101441,0,2,3
29081,4,1,101443,101443,101444,0,1,2
29082,1,2,101444,101444,101446,0,2,0
29083,6,3,101450,101450,101453,0,3,4
29084,4,2,101454,101454,101456,0,2,1
29085,1,3,101455,101456,101459,1,4,0
29086,4,2,101459,101459,101461,0,2,0
29087,6,3,101465,101465,101468,0,3,4
29088,6,1,101471,101471,101472,0,1,3
29089,4,1,101475,101475,101476,0,1,3
29090,1,1,101476,101476,101477,0,1,0
29091,4,3,101480,101480,101483,0,3,3
29092,2,2,101482,101483,101485,1,3,0
29093,3,2,101485,101485,101487,0,2,0
29094,6,2,101491,101491,101493,0,2,4
29095,6,1,101497,101497,101498,0,1,4
29096,6,2,101503,101503,101505,0,2,5
29097,5,2,101508,101508,101510,0,2,3
29098,3,2,101511,101511,101513,0,2,1
29099,2,1,101513,101513,101514,0,1,0
29100,6,2,101519,101519,101521,0,2,5
29101,4,1,101523,101523,101524,0,1,2
29102,3,2,101526,101526,101528,0,2,2
29103,1,1,101527,101528,101529,1,2,0
29104,6,2,101533,101533,101535,0,2,4
29105,1,3,101534,101535,101538,1,4,0
29106,6,1,101540,101540,101541,0,1,2
29107,6,3,101546,101546,101549,0,3,5
29108,1,3,101547,101549,101552,2,5,0
29109,5,3,101552,101552,101555,0,3,0
29110,5,2,101557,101557,101559,0,2,2
29111,6,1,101563,101563,101564,0,1,4
29112,5,3,101568,101568,101571,0,3,4
29113,5,3,101573,101573,101576,0,3,2
29114,5,3,101578,101578,101581,0,3,2
29115,4,1,101582,101582,101583,0,1,1
29116,1,3,101583,101583,101586,0,3,0
29117,6,2,101589,101589,101591,0,2,3
29118,3,2,101592,101592,101594,0,2,1
29119,4,3,101596,101596,101599,0,3,2
29120,3,1,101599,101599,101600,0,1,0
29121,5,2,101604,101604,101606,0,2,4
29122,6,3,101610,101610,101613,0,3,4
29123,2,1,101612,101613,101614,1,2,0
29124,3,3,101615,101615,101618,0,3,1
29125,1,2,101616,101618,101620,2,4,0
29126,6,1,101622,101622,101623,0,1,2
29127,6,3,101628,101628,101631,0,3,5
29128,1,3,101629,101631,101634,2,5,0
29129,1,3,101630,101634,101637,4,7,0
29130,1,3,101631,101637,101640,6,9,0
29131,6,1,101637,101640,101641,3,4,0
29132,6,2,101643,101643,101645,0,2,2
29133,2,3,101645,101645,101648,0,3,0
29134,1,3,101646,101648,101651,2,5,0
29135,1,1,101647,101651,101652,4,5,0
29136,2,3,101649,101652,101655,3,6,0
29137,5,2,101654,101655,101657,1,3,0
29138,3,2,101657,101657,101659,0,2,0
29139,3,3,101660,101660,101663,0,3,1
29140,2,1,101662,101663,101664,1,2,0
29141,5,3,101667,101667,101670,0,3,3
29142,1,3,101668,101670,101673,2,5,0
29143,2,2,101670,101673,101675,3,5,0
29144,1,1,101671,101675,101676,4,5,0
29145,2,2,101673,101676,101678,3,5,0
29146,2,3,101675,101678,101681,3,6,0
29147,6,1,101681,101681,101682,0,1,0
29148,5,2,101686,101686,101688,0,2,4
29149,5,3,101691,101691,101694,0,3,3
29150,4,3,101695,101695,101698,0,3,1
29151,1,2,101696,101698,101700,2,4,0
29152,5,2,101701,101701,101703,0,2,1
29153,6,1,101707,101707,101708,0,1,4
29154,2,2,101709,101709,101711,0,2,1
29155,3,1,101712,101712,101713,0,1,1
29156,4,2,101716,101716,101718,0,2,3
29157,3,3,101719,101719,101722,0,3,1
29158,1,3,101720,101722,101725,2,5,0
29159,3,3,101723,101725,101728,2,5,0
29160,3,1,101726,101728,101729,2,3,0
29161,5,1,101731,101731,101732,0,1,2
29162,1,1,101732,101732,101733,0,1,0
29163,4,3,101736,101736,101739,0,3,3
29164,6,3,101742,101742,101745,0,3,3
29165,3,3,101745,101745,101748,0,3,0
29166,2,2,101747,101748,101750,1,3,0
29167,1,3,101748,101750,101753,2,5,0
29168,2,1,101750,101753,101754,3,4,0
29169,6,3,101756,101756,101759,0,3,2
29170,5,1,101761,101761,101762,0,1,2
29171,4,2,101765,101765,101767,0,2,3
29172,5,2,101770,101770,101772,0,2,3
29173,2,2,101772,101772,101774,0,2,0
29174,2,3,101774,101774,101777,0,3,0
29175,6,2,101780,101780,101782,0,2,3
29176,2,2,101782,101782,101784,0,2,0
29177,5,1,101787,101787,101788,0,1,3
29178,3,1,101790,101790,101791,0,1,2
29179,1,3,101791,101791,101794,0,3,0
29180,2,2,101793,101794,101796,1,3,0
29181,3,1,101796,101796,101797,0,1,0
29182,2,3,101798,101798,101801,0,3,1
29183,4,2,101802,101802,101804,0,2,1
29184,2,3,101804,101804,101807,0,3,0
29185,4,3,101808,101808,101811,0,3,1
29186,4,2,101812,101812,101814,0,2,1
29187,6,1,101818,101818,101819,0,1,4
29188,6,1,101824,101824,101825,0,1,5
29189,4,2,101828,101828,101830,0,2,3
29190,6,3,101834,101834,101837,0,3,4
29191,1,2,101835,101837,101839,2,4,0
29192,6,2,101841,101841,101843,0,2,2
29193,6,1,101847,101847,101848,0,1,4
29194,3,2,101850,101850,101852,0,2,2
29195,1,2,101851,101852,101854,1,3,0
29196,4,2,101855,101855,101857,0,2,1
29197,5,3,101860,101860,101863,0,3,3
29198,4,3,101864,101864,101867,0,3,1
29199,2,2,101866,101867,101869,1,3,0
29200,6,2,101872,101872,101874,0,2,3
29201,3,1,101875,101875,101876,0,1,1
29202,4,1,101879,101879,101880,0,1,3
29203,1,2,101880,101880,101882,0,2,0
29204,1,1,101881,101882,101883,1,2,0
29205,6,2,101887,101887,101889,0,2,4
29206,6,3,101893,101893,101896,0,3,4
29207,5,3,101898,101898,101901,0,3,2
29208,2,2,101900,101901,101903,1,3,0
29209,3,2,101903,101903,101905,0,2,0
29210,3,1,101906,101906,101907,0,1,1
29211,4,1,101910,101910,101911,0,1,3
29212,1,2,101911,101911,101913,0,2,0
29213,4,2,101915,101915,101917,0,2,2
29214,2,3,101917,101917,101920,0,3,0
29215,3,1,101920,101920,101921,0,1,0
29216,6,1,101926,101926,101927,0,1,5
29217,6,2,101932,101932,101934,0,2,5
29218,1,1,101933,101934,101935,1,2,0
29219,6,2,101939,101939,101941,0,2,4
29220,1,2,101940,101941,101943,1,3,0
29221,1,3,101941,101943,101946,2,5,0
29222,4,3,101945,101946,101949,1,4,0
29223,1,1,101946,101949,101950,3,4,0
29224,4,3,101950,101950,101953,0,3,0
29225,4,1,101954,101954,101955,0,1,1
29226,6,3,101960,101960,101963,0,3,5
29227,6,1,101966,101966,101967,0,1,3
29228,6,1,101972,101972,101973,0,1,5
29229,5,1,101977,101977,101978,0,1,4
29230,4,2,101981,101981,101983,0,2,3
29231,1,2,101982,101983,101985,1,3,0
29232,6,2,101988,101988,101990,0,2,3
29233,4,2,101992,101992,101994,0,2,2
29234,5,2,101997,101997,101999,0,2,3
29235,2,3,101999,101999,102002,0,3,0
29236,6,2,102005,102005,102007,0,2,3
29237,4,1,102009,102009,102010,0,1,2
29238,6,2,102015,102015,102017,0,2,5
29239,3,3,102018,102018,102021,0,3,1
29240,6,2,102024,102024,102026,0,2,3
29241,2,2,102026,102026,102028,0,2,0
29242,6,2,102032,102032,102034,0,2,4
29243,2,1,102034,102034,102035,0,1,0
29244,3,1,102037,102037,102038,0,1,2
29245,6,3,102043,102043,102046,0,3,5
29246,2,3,102045,102046,102049,1,4,0
29247,6,2,102051,102051,102053,0,2,2
29248,6,3,102057,102057,102060,0,3,4
29249,4,3,102061,102061,102064,0,3,1
29250,3,1,102064,102064,102065,0,1,0
29251,2,3,102066,102066,102069,0,3,1
29252,1,2,102067,102069,102071,2,4,0
29253,6,3,102073,102073,102076,0,3,2
29254,3,2,102076,102076,102078,0,2,0
29255,6,3,102082,102082,102085,0,3,4
29256,6,3,102088,102088,102091,0,3,3
29257,4,2,102092,102092,102094,0,2,1
29258,1,1,102093,102094,102095,1,2,0
29259,6,2,102099,102099,102101,0,2,4
29260,6,3,102105,102105,102108,0,3,4
29261,1,2,102106,102108,102110,2,4,0
29262,3,1,102109,102110,102111,1,2,0
29263,6,3,102115,102115,102118,0,3,4
29264,1,2,102116,102118,102120,2,4,0
29265,1,3,102117,102120,102123,3,6,0
29266,2,3,102119,102123,102126,4,7,0
29267,5,2,102124,102126,102128,2,4,0
29268,6,2,102130,102130,102132,0,2,2
29269,6,1,102136,102136,102137,0,1,4
29270,3,1,102139,102139,102140,0,1,2
29271,6,2,102145,102145,102147,0,2,5
29272,4,2,102149,102149,102151,0,2,2
29273,2,2,102151,102151,102153,0,2,0
29274,2,1,102153,102153,102154,0,1,0
29275,6,1,102159,102159,102160,0,1,5
29276,1,1,102160,102160,102161,0,1,0
29277,4,3,102164,102164,102167,0,3,3
29278,3,2,102167,102167,102169,0,2,0
29279,2,2,102169,102169,102171,0,2,0
29280,3,3,102172,102172,102175,0,3,1
29281,5,3,102177,102177,102180,0,3,2
29282,5,1,102182,102182,102183,0,1,2
29283,1,1,102183,102183,102184,0,1,0
29284,3,1,102186,102186,102187,0,1,2
29285,1,1,102187,102187,102188,0,1,0
29286,3,3,102190,102190,102193,0,3,2
29287,2,3,102192,102193,102196,1,4,0
29288,3,2,102195,102196,102198,1,3,0
29289,3,3,102198,102198,102201,0,3,0
29290,5,2,102203,102203,102205,0,2,2
29291,5,1,102208,102208,102209,0,1,3
29292,5,3,102213,102213,102216,0,3,4
29293,5,3,102218,102218,102221,0,3,2
29294,5,3,102223,102223,102226,0,3,2
29295,4,2,102227,102227,102229,0,2,1
29296,1,1,102228,102229,102230,1,2,0
29297,5,3,102233,102233,102236,0,3,3
29298,4,3,102237,102237,102240,0,3,1
29299,2,1,102239,102240,102241,1,2,0
29300,1,3,102240,102241,102244,1,4,0
29301,5,2,102245,102245,102247,0,2,1
29302,3,2,102248,102248,102250,0,2,1
29303,2,2,102250,102250,102252,0,2,0
29304,4,2,102254,102254,102256,0,2,2
29305,2,3,102256,102256,102259,0,3,0
29306,1,1,102257,102259,102260,2,3,0
29307,1,3,102258,102260,102263,2,5,0
29308,4,2,102262,102263,102265,1,3,0
29309,1,1,102263,102265,102266,2,3,0
29310,2,1,102265,102266,102267,1,2,0
29311,3,1,102268,102268,102269,0,1,1
29312,4,1,102272,102272,102273,0,1,3
29313,1,3,102273,102273,102276,0,3,0
29314,3,3,102276,102276,102279,0,3,0
29315,3,2,102279,102279,102281,0,2,0
29316,4,3,102283,102283,102286,0,3,2
29317,5,3,102288,102288,102291,0,3,2
29318,5,1,102293,102293,102294,0,1,2
29319,2,2,102295,102295,102297,0,2,1
29320,2,2,102297,102297,102299,0,2,0
29321,1,2,102298,102299,102301,1,3,0
29322,1,1,102299,102301,102302,2,3,0
29323,1,1,102300,102302,102303,2,3,0
29324,1,2,102301,102303,102305,2,4,0
29325,2,3,102303,102305,102308,2,5,0
29326,5,1,102308,102308,102309,0,1,0
29327,5,2,102313,102313,102315,0,2,4
29328,1,1,102314,102315,102316,1,2,0
29329,1,2,102315,102316,102318,1,3,0
29330,3,1,102318,102318,102319,0,1,0
29331,6,3,102324,102324,102327,0,3,5
29332,6,2,102330,102330,102332,0,2,3
29333,4,2,102334,102334,102336,0,2,2
29334,3,3,102337,102337,102340,0,3,1
29335,1,2,102338,102340,102342,2,4,0
29336,3,2,102341,102342,102344,1,3,0
29337,4,1,102345,102345,102346,0,1,1
29338,2,2,102347,102347,102349,0,2,1
29339,6,1,102353,102353,102354,0,1,4
29340,6,2,102359,102359,102361,0,2,5
29341,5,1,102364,102364,102365,0,1,3
29342,5,1,102369,102369,102370,0,1,4
29343,5,2,102374,102374,102376,0,2,4
29344,3,3,102377,102377,102380,0,3,1
29345,2,2,102379,102380,102382,1,3,0
29346,1,3,102380,102382,102385,2,5,0
29347,5,2,102385,102385,102387,0,2,0
29348,2,2,102387,102387,102389,0,2,0
29349,5,2,102392,102392,102394,0,2,3
29350,2,2,102394,102394,102396,0,2,0
29351,6,1,102400,102400,102401,0,1,4
29352,6,3,102406,102406,102409,0,3,5
29353,6,1,102412,102412,102413,0,1,3
29354,6,1,102418,102418,102419,0,1,5
29355,4,2,102422,102422,102424,0,2,3
29356,1,2,102423,102424,102426,1,3,0
29357,2,2,102425,102426,102428,1,3,0
29358,1,3,102426,102428,102431,2,5,0
29359,6,1,102432,102432,102433,0,1,1
29360,1,2,102433,102433,102435,0,2,0
29361,6,3,102439,102439,102442,0,3,4
29362,3,1,102442,102442,102443,0,1,0
29363,4,2,102446,102446,102448,0,2,3
29364,1,3,102447,102448,102451,1,4,0
29365,3,3,102450,102451,102454,1,4,0
29366,1,3,102451,102454,102457,3,6,0
29367,3,2,102454,102457,102459,3,5,0
29368,3,2,102457,102459,102461,2,4,0
29369,3,1,102460,102461,102462,1,2,0
29370,2,1,102462,102462,102463,0,1,0
29371,2,3,102464,102464,102467,0,3,1
29372,4,1,102468,102468,102469,0,1,1
29373,4,2,102472,102472,102474,0,2,3
29374,4,1,102476,102476,102477,0,1,2
29375,6,3,102482,102482,102485,0,3,5
29376,5,3,102487,102487,102490,0,3,2
29377,1,2,102488,102490,102492,2,4,0
29378,1,3,102489,102492,102495,3,6,0
29379,6,1,102495,102495,102496,0,1,0
29380,2,3,102497,102497,102500,0,3,1
29381,6,1,102503,102503,102504,0,1,3
29382,1,1,102504,102504,102505,0,1,0
29383,3,1,102507,102507,102508,0,1,2
29384,2,2,102509,102509,102511,0,2,1
29385,5,1,102514,102514,102515,0,1,3
29386,2,3,102516,102516,102519,0,3,1
29387,1,1,102517,102519,102520,2,3,0
29388,5,1,102522,102522,102523,0,1,2
29389,2,1,102524,102524,102525,0,1,1
29390,5,2,102529,102529,102531,0,2,4
29391,3,1,102532,102532,102533,0,1,1
29392,1,1,102533,102533,102534,0,1,0
29393,3,3,102536,102536,102539,0,3,2
29394,6,2,102542,102542,102544,0,2,3
29395,2,1,102544,102544,102545,0,1,0
29396,4,1,102548,102548,102549,0,1,3
29397,3,3,102551,102551,102554,0,3,2
29398,5,2,102556,102556,102558,0,2,2
29399,5,3,102561,102561,102564,0,3,3
29400,5,3,102566,102566,102569,0,3,2
29401,4,1,102570,102570,102571,0,1,1
29402,2,1,102572,102572,102573,0,1,1
29403,3,3,102575,102575,102578,0,3,2
29404,6,2,102581,102581,102583,0,2,3
29405,2,2,102583,102583,102585,0,2,0
29406,4,2,102587,102587,102589,0,2,2
29407,5,1,102592,102592,102593,0,1,3
29408,6,1,102598,102598,102599,0,1,5
29409,5,3,102603,102603,102606,0,3,4
29410,1,1,102604,102606,102607,2,3,0
29411,3,1,102607,102607,102608,0,1,0
29412,1,3,102608,102608,102611,0,3,0
29413,5,2,102613,102613,102615,0,2,2
29414,6,2,102619,102619,102621,0,2,4
29415,1,2,102620,102621,102623,1,3,0
29416,1,3,102621,102623,102626,2,5,0
29417,3,3,102624,102626,102629,2,5,0
29418,2,3,102626,102629,102632,3,6,0
29419,4,1,102630,102632,102633,2,3,0
29420,1,1,102631,102633,102634,2,3,0
29421,5,1,102636,102636,102637,0,1,2
29422,1,3,102637,102637,102640,0,3,0
29423,4,3,102641,102641,102644,0,3,1
29424,1,1,102642,102644,102645,2,3,0
29425,5,1,102647,102647,102648,0,1,2
29426,5,3,102652,102652,102655,0,3,4
29427,3,3,102655,102655,102658,0,3,0
29428,2,3,102657,102658,102661,1,4,0
29429,6,1,102663,102663,102664,0,1,2
29430,6,1,102669,102669,102670,0,1,5
29431,6,3,102675,102675,102678,0,3,5
29432,2,2,102677,102678,102680,1,3,0
29433,3,1,102680,102680,102681,0,1,0
29434,5,3,102685,102685,102688,0,3,4
29435,2,2,102687,102688,102690,1,3,0
29436,6,1,102693,102693,102694,0,1,3
29437,5,2,102698,102698,102700,0,2,4
29438,2,1,102700,102700,102701,0,1,0
29439,2,2,102702,102702,102704,0,2,1
29440,3,2,102705,102705,102707,0,2,1
29441,6,1,102711,102711,102712,0,1,4
29442,1,3,102712,102712,102715,0,3,0
29443,4,1,102716,102716,102717,0,1,1
29444,3,3,102719,102719,102722,0,3,2
29445,2,3,102721,102722,102725,1,4,0
29446,6,1,102727,102727,102728,0,1,2
29447,1,3,102728,102728,102731,0,3,0
29448,3,2,102731,102731,102733,0,2,0
29449,3,1,102734,102734,102735,0,1,1
29450,3,2,102737,102737,102739,0,2,2
29451,6,2,102743,102743,102745,0,2,4
29452,2,2,102745,102745,102747,0,2,0
29453,2,3,102747,102747,102750,0,3,0
29454,4,3,102751,102751,102754,0,3,1
29455,2,3,102753,102754,102757,1,4,0
29456,5,1,102758,102758,102759,0,1,1
29457,3,2,102761,102761,102763,0,2,2
29458,3,3,102764,102764,102767,0,3,1
29459,5,3,102769,102769,102772,0,3,2
29460,3,1,102772,102772,102773,0,1,0
29461,1,2,102773,102773,102775,0,2,0
29462,3,3,102776,102776,102779,0,3,1
29463,4,2,102780,102780,102782,0,2,1
29464,4,3,102784,102784,102787,0,3,2
29465,5,3,102789,102789,102792,0,3,2
29466,5,3,102794,102794,102797,0,3,2
29467,1,3,102795,102797,102800,2,5,0
29468,2,3,102797,102800,102803,3,6,0
29469,2,3,102799,102803,102806,4,7,0
29470,5,3,102804,102806,102809,2,5,0
29471,2,2,102806,102809,102811,3,5,0
29472,3,1,102809,102811,102812,2,3,0
29473,5,1,102814,102814,102815,0,1,2
29474,4,2,102818,102818,102820,0,2,3
29475,3,3,102821,102821,102824,0,3,1
29476,1,3,102822,102824,102827,2,5,0
29477,6,2,102828,102828,102830,0,2,1
29478,3,2,102831,102831,102833,0,2,1
29479,6,3,102837,102837,102840,0,3,4
29480,4,1,102841,102841,102842,0,1,1
29481,1,1,102842,102842,102843,0,1,0
29482,1,3,102843,102843,102846,0,3,0
29483,3,2,102846,102846,102848,0,2,0
29484,5,1,102851,102851,102852,0,1,3
29485,3,2,102854,102854,102856,0,2,2
29486,6,2,102860,102860,102862,0,2,4
29487,1,2,102861,102862,102864,1,3,0
29488,6,2,102867,102867,102869,0,2,3
29489,2,3,102869,102869,102872,0,3,0
29490,4,1,102873,102873,102874,0,1,1
29491,1,1,102874,102874,102875,0,1,0
29492,6,3,102880,102880,102883,0,3,5
29493,5,2,102885,102885,102887,0,2,2
29494,2,1,102887,102887,102888,0,1,0
29495,4,2,102891,102891,102893,0,2,3
29496,2,1,102893,102893,102894,0,1,0
29497,6,2,102899,102899,102901,0,2,5
29498,6,1,102905,102905,102906,0,1,4
29499,5,3,102910,102910,102913,0,3,4
29500,5,3,102915,102915,102918,0,3,2
29501,1,1,102916,102918,102919,2,3,0
29502,2,3,102918,102919,102922,1,4,0
29503,5,3,102923,102923,102926,0,3,1
29504,1,2,102924,102926,102928,2,4,0
29505,2,3,102926,102928,102931,2,5,0
29506,6,3,102932,102932,102935,0,3,1
29507,5,3,102937,102937,102940,0,3,2
29508,4,3,102941,102941,102944,0,3,1
29509,6,1,102947,102947,102948,0,1,3
29510,1,3,102948,102948,102951,0,3,0
29511,4,2,102952,102952,102954,0,2,1
29512,5,1,102957,102957,102958,0,1,3
29513,1,1,102958,102958,102959,0,1,0
29514,1,3,102959,102959,102962,0,3,0
29515,6,1,102965,102965,102966,0,1,3
29516,6,2,102971,102971,102973,0,2,5
29517,3,2,102974,102974,102976,0,2,1
29518,3,3,102977,102977,102980,0,3,1
29519,5,2,102982,102982,102984,0,2,2
29520,6,3,102988,102988,102991,0,3,4
29521,2,1,102990,102991,102992,1,2,0
29522,2,3,102992,102992,102995,0,3,0
29523,1,2,102993,102995,102997,2,4,0
29524,3,3,102996,102997,103000,1,4,0
29525,3,3,102999,103000,103003,1,4,0
29526,6,1,103005,103005,103006,0,1,2
29527,6,2,103011,103011,103013,0,2,5
29528,3,2,103014,103014,103016,0,2,1
29529,5,2,103019,103019,103021,0,2,3
29530,6,2,103025,103025,103027,0,2,4
29531,5,3,103030,103030,103033,0,3,3
29532,2,3,103032,103033,103036,1,4,0
29533,1,2,103033,103036,103038,3,5,0
29534,6,1,103039,103039,103040,0,1,1
29535,6,2,103045,103045,103047,0,2,5
29536,5,3,103050,103050,103053,0,3,3
29537,2,2,103052,103053,103055,1,3,0
29538,3,1,103055,103055,103056,0,1,0
29539,2,1,103057,103057,103058,0,1,1
29540,1,1,103058,103058,103059,0,1,0
29541,3,2,103061,103061,103063,0,2,2
29542,2,1,103063,103063,103064,0,1,0
29543,1,3,103064,103064,103067,0,3,0
29544,1,3,103065,103067,103070,2,5,0
29545,6,1,103071,103071,103072,0,1,1
29546,3,3,103074,103074,103077,0,3,2
29547,1,2,103075,103077,103079,2,4,0
29548,5,2,103080,103080,103082,0,2,1
29549,4,1,103084,103084,103085,0,1,2
29550,3,2,103087,103087,103089,0,2,2
29551,5,3,103092,103092,103095,0,3,3
29552,5,3,103097,103097,103100,0,3,2
29553,5,3,103102,103102,103105,0,3,2
29554,6,2,103108,103108,103110,0,2,3
29555,1,1,103109,103110,103111,1,2,0
29556,1,2,103110,103111,103113,1,3,0
29557,1,2,103111,103113,103115,2,4,0
29558,1,3,103112,103115,103118,3,6,0
29559,5,3,103117,103118,103121,1,4,0
29560,6,3,103123,103123,103126,0,3,2
29561,6,3,103129,103129,103132,0,3,3
29562,2,3,103131,103132,103135,1,4,0
29563,3,1,103134,103135,103136,1,2,0
29564,3,2,103137,103137,103139,0,2,1
29565,2,1,103139,103139,103140,0,1,0
29566,3,3,103142,103142,103145,0,3,2
29567,5,3,103147,103147,103150,0,3,2
29568,6,2,103153,103153,103155,0,2,3
29569,2,1,103155,103155,103156,0,1,0
29570,6,2,103161,103161,103163,0,2,5
29571,6,2,103167,103167,103169,0,2,4
29572,4,1,103171,103171,103172,0,1,2
29573,2,3,103173,103173,103176,0,3,1
29574,4,1,103177,103177,103178,0,1,1
29575,3,3,103180,103180,103183,0,3,2
29576,4,2,103184,103184,103186,0,2,1
29577,5,2,103189,103189,103191,0,2,3
29578,3,3,103192,103192,103195,0,3,1
29579,1,1,103193,103195,103196,2,3,0
29580,4,2,103197,103197,103199,0,2,1
29581,6,1,103203,103203,103204,0,1,4
29582,6,3,103209,103209,103212,0,3,5
29583,3,1,103212,103212,103213,0,1,0
29584,2,3,103214,103214,103217,0,3,1
29585,5,2,103219,103219,103221,0,2,2
29586,6,1,103225,103225,103226,0,1,4
29587,2,3,103227,103227,103230,0,3,1
29588,4,3,103231,103231,103234,0,3,1
29589,1,2,103232,103234,103236,2,4,0
29590,5,3,103237,103237,103240,0,3,1
29591,3,2,103240,103240,103242,0,2,0
29592,2,2,103242,103242,103244,0,2,0
29593,5,3,103247,103247,103250,0,3,3
29594,1,2,103248,103250,103252,2,4,0
29595,4,1,103252,103252,103253,0,1,0
29596,3,3,103255,103255,103258,0,3,2
29597,6,2,103261,103261,103263,0,2,3
29598,6,3,103267,103267,103270,0,3,4
29599,1,3,103268,103270,103273,2,5,0
29600,4,3,103272,103273,103276,1,4,0
29601,5,3,103277,103277,103280,0,3,1
29602,1,3,103278,103280,103283,2,5,0
29603,2,2,103280,103283,103285,3,5,0
29604,5,1,103285,103285,103286,0,1,0
29605,1,2,103286,103286,103288,0,2,0
29606,6,2,103292,103292,103294,0,2,4
29607,5,3,103297,103297,103300,0,3,3
29608,6,3,103303,103303,103306,0,3,3
29609,6,1,103309,103309,103310,0,1,3
29610,2,2,103311,103311,103313,0,2,1
29611,2,3,103313,103313,103316,0,3,0
29612,3,1,103316,103316,103317,0,1,0
29613,4,3,103320,103320,103323,0,3,3
29614,3,3,103323,103323,103326,0,3,0
29615,1,2,103324,103326,103328,2,4,0
29616,6,3,103330,103330,103333,0,3,2
29617,6,3,103336,103336,103339,0,3,3
29618,5,3,103341,103341,103344,0,3,2
29619,2,1,103343,103344,103345,1,2,0
29620,5,3,103348,103348,103351,0,3,3
29621,3,1,103351,103351,103352,0,1,0
29622,5,3,103356,103356,103359,0,3,4
29623,3,3,103359,103359,103362,0,3,0
29624,1,3,103360,103362,103365,2,5,0
29625,6,3,103366,103366,103369,0,3,1
29626,2,1,103368,103369,103370,1,2,0
29627,6,3,103374,103374,103377,0,3,4
29628,3,1,103377,103377,103378,0,1,0
29629,6,2,103383,103383,103385,0,2,5
29630,3,1,103386,103386,103387,0,1,1
29631,2,2,103388,103388,103390,0,2,1
29632,1,1,103389,103390,103391,1,2,0
29633,2,3,103391,103391,103394,0,3,0
29634,4,2,103395,103395,103397,0,2,1
29635,4,2,103399,103399,103401,0,2,2
29636,1,3,103400,103401,103404,1,4,0
29637,5,1,103405,103405,103406,0,1,1
29638,4,1,103409,103409,103410,0,1,3
29639,2,1,103411,103411,103412,0,1,1
29640,2,3,103413,103413,103416,0,3,1
29641,6,1,103419,103419,103420,0,1,3
29642,5,1,103424,103424,103425,0,1,4
29643,3,3,103427,103427,103430,0,3,2
29644,4,2,103431,103431,103433,0,2,1
29645,2,3,103433,103433,103436,0,3,0
29646,5,3,103438,103438,103441,0,3,2
29647,5,3,103443,103443,103446,0,3,2
29648,4,2,103447,103447,103449,0,2,1
29649,6,2,103453,103453,103455,0,2,4
29650,1,1,103454,103455,103456,1,2,0
29651,2,2,103456,103456,103458,0,2,0
29652,5,1,103461,103461,103462,0,1,3
29653,4,3,103465,103465,103468,0,3,3
29654,4,2,103469,103469,103471,0,2,1
29655,5,2,103474,103474,103476,0,2,3
29656,1,1,103475,103476,103477,1,2,0
29657,2,1,103477,103477,103478,0,1,0
29658,6,3,103483,103483,103486,0,3,5
29659,2,2,103485,103486,103488,1,3,0
29660,2,1,103487,103488,103489,1,2,0
29661,2,2,103489,103489,103491,0,2,0
29662,5,1,103494,103494,103495,0,1,3
29663,1,2,103495,103495,103497,0,2,0
29664,6,2,103501,103501,103503,0,2,4
29665,2,2,103503,103503,103505,0,2,0
29666,6,3,103509,103509,103512,0,3,4
29667,3,2,103512,103512,103514,0,2,0
29668,4,2,103516,103516,103518,0,2,2
29669,5,3,103521,103521,103524,0,3,3
29670,4,3,103525,103525,103528,0,3,1
29671,1,2,103526,103528,103530,2,4,0
29672,3,2,103529,103530,103532,1,3,0
29673,6,2,103535,103535,103537,0,2,3
29674,4,1,103539,103539,103540,0,1,2
29675,1,1,103540,103540,103541,0,1,0
29676,5,2,103545,103545,103547,0,2,4
29677,3,3,103548,103548,103551,0,3,1
29678,4,2,103552,103552,103554,0,2,1
29679,2,1,103554,103554,103555,0,1,0
29680,6,2,103560,103560,103562,0,2,5
29681,6,3,103566,103566,103569,0,3,4
29682,3,1,103569,103569,103570,0,1,0
29683,5,1,103574,103574,103575,0,1,4
29684,4,1,103578,103578,103579,0,1,3
29685,6,3,103584,103584,103587,0,3,5
29686,4,1,103588,103588,103589,0,1,1
29687,5,1,103593,103593,103594,0,1,4
29688,5,2,103598,103598,103600,0,2,4
29689,6,1,103604,103604,103605,0,1,4
29690,1,2,103605,103605,103607,0,2,0
29691,5,2,103610,103610,103612,0,2,3
29692,6,2,103616,103616,103618,0,2,4
29693,2,3,103618,103618,103621,0,3,0
29694,4,1,103622,103622,103623,0,1,1
29695,1,3,103623,103623,103626,0,3,0
29696,6,3,103629,103629,103632,0,3,3
29697,5,3,103634,103634,103637,0,3,2
29698,1,2,103635,103637,103639,2,4,0
29699,4,3,103639,103639,103642,0,3,0
29700,2,2,103641,103642,103644,1,3,0
29701,6,2,103647,103647,103649,0,2,3
29702,6,3,103653,103653,103656,0,3,4
29703,3,3,103656,103656,103659,0,3,0
29704,4,1,103660,103660,103661,0,1,1
29705,4,3,103664,103664,103667,0,3,3
29706,5,1,103669,103669,103670,0,1,2
29707,6,3,103675,103675,103678,0,3,5
29708,3,1,103678,103678,103679,0,1,0
29709,4,2,103682,103682,103684,0,2,3
29710,5,2,103687,103687,103689,0,2,3
29711,1,2,103688,103689,103691,1,3,0
29712,1,1,103689,103691,103692,2,3,0
29713,6,3,103695,103695,103698,0,3,3
29714,5,1,103700,103700,103701,0,1,2
29715,4,1,103704,103704,103705,0,1,3
29716,6,1,103710,103710,103711,0,1,5
29717,3,1,103713,103713,103714,0,1,2
29718,1,3,103714,103714,103717,0,3,0
29719,4,1,103718,103718,103719,0,1,1
29720,2,3,103720,103720,103723,0,3,1
29721,2,1,103722,103723,103724,1,2,0
29722,2,2,103724,103724,103726,0,2,0
29723,1,1,103725,103726,103727,1,2,0
29724,5,2,103730,103730,103732,0,2,3
29725,3,3,103733,103733,103736,0,3,1
29726,2,3,103735,103736,103739,1,4,0
29727,5,2,103740,103740,103742,0,2,1
29728,1,3,103741,103742,103745,1,4,0
29729,5,2,103746,103746,103748,0,2,1
29730,3,2,103749,103749,103751,0,2,1
29731,6,2,103755,103755,103757,0,2,4
29732,3,3,103758,103758,103761,0,3,1
29733,2,2,103760,103761,103763,1,3,0
29734,4,1,103764,103764,103765,0,1,1
29735,4,1,103768,103768,103769,0,1,3
29736,6,1,103774,103774,103775,0,1,5
29737,4,1,103778,103778,103779,0,1,3
29738,2,3,103780,103780,103783,0,3,1
29739,2,1,103782,103783,103784,1,2,0
29740,1,2,103783,103784,103786,1,3,0
29741,2,3,103785,103786,103789,1,4,0
29742,6,2,103791,103791,103793,0,2,2
29743,5,2,103796,103796,103798,0,2,3
29744,2,1,103798,103798,103799,0,1,0
29745,4,3,103802,103802,103805,0,3,3
29746,6,2,103808,103808,103810,0,2,3
29747,6,3,103814,103814,103817,0,3,4
29748,2,1,103816,103817,103818,1,2,0
29749,4,1,103820,103820,103821,0,1,2
29750,5,3,103825,103825,103828,0,3,4
29751,2,2,103827,103828,103830,1,3,0
29752,1,3,103828,103830,103833,2,5,0
29753,6,2,103834,103834,103836,0,2,1
29754,2,2,103836,103836,103838,0,2,0
29755,6,2,103842,103842,103844,0,2,4
29756,6,2,103848,103848,103850,0,2,4
29757,5,1,103853,103853,103854,0,1,3
29758,3,1,103856,103856,103857,0,1,2
29759,3,1,103859,103859,103860,0,1,2
29760,5,2,103864,103864,103866,0,2,4
29761,5,2,103869,103869,103871,0,2,3
29762,6,2,103875,103875,103877,0,2,4
29763,4,2,103879,103879,103881,0,2,2
29764,3,2,103882,103882,103884,0,2,1
29765,2,2,103884,103884,103886,0,2,0
29766,6,3,103890,103890,103893,0,3,4
29767,5,1,103895,103895,103896,0,1,2
29768,1,1,103896,103896,103897,0,1,0
29769,1,2,103897,103897,103899,0,2,0
29770,2,2,103899,103899,103901,0,2,0
29771,2,3,103901,103901,103904,0,3,0
29772,4,2,103905,103905,103907,0,2,1
29773,2,1,103907,103907,103908,0,1,0
29774,3,1,103910,103910,103911,0,1,2
29775,3,1,103913,103913,103914,0,1,2
29776,2,1,103915,103915,103916,0,1,1
29777,6,1,103921,103921,103922,0,1,5
29778,5,1,103926,103926,103927,0,1,4
29779,3,3,103929,103929,103932,0,3,2
29780,1,1,103930,103932,103933,2,3,0
29781,5,2,103935,103935,103937,0,2,2
29782,1,1,103936,103937,103938,1,2,0
29783,3,1,103939,103939,103940,0,1,1
29784,1,1,103940,103940,103941,0,1,0
29785,6,3,103946,103946,103949,0,3,5
29786,6,3,103952,103952,103955,0,3,3
29787,4,3,103956,103956,103959,0,3,1
29788,3,2,103959,103959,103961,0,2,0
29789,4,2,103963,103963,103965,0,2,2
29790,4,3,103967,103967,103970,0,3,2
29791,5,1,103972,103972,103973,0,1,2
29792,4,1,103976,103976,103977,0,1,3
29793,6,2,103982,103982,103984,0,2,5
29794,5,3,103987,103987,103990,0,3,3
29795,4,3,103991,103991,103994,0,3,1
29796,5,1,103996,103996,103997,0,1,2
29797,5,2,104001,104001,104003,0,2,4
29798,4,2,104005,104005,104007,0,2,2
29799,5,3,104010,104010,104013,0,3,3
29800,2,1,104012,104013,104014,1,2,0
29801,6,2,104018,104018,104020,0,2,4
29802,3,3,104021,104021,104024,0,3,1
29803,4,3,104025,104025,104028,0,3,1
29804,2,2,104027,104028,104030,1,3,0
29805,6,2,104033,104033,104035,0,2,3
29806,2,2,104035,104035,104037,0,2,0
29807,2,1,104037,104037,104038,0,1,0
29808,6,1,104043,104043,104044,0,1,5
29809,2,2,104045,104045,104047,0,2,1
29810,1,3,104046,104047,104050,1,4,0
29811,3,3,104049,104050,104053,1,4,0
29812,6,1,104055,104055,104056,0,1,2
29813,3,1,104058,104058,104059,0,1,2
29814,5,2,104063,104063,104065,0,2,4
29815,5,2,104068,104068,104070,0,2,3
29816,6,3,104074,104074,104077,0,3,4
29817,2,1,104076,104077,104078,1,2,0
29818,4,1,104080,104080,104081,0,1,2
29819,3,2,104083,104083,104085,0,2,2
29820,6,1,104089,104089,104090,0,1,4
29821,2,3,104091,104091,104094,0,3,1
29822,2,2,104093,104094,104096,1,3,0
29823,1,3,104094,104096,104099,2,5,0
29824,3,1,104097,104099,104100,2,3,0
29825,4,1,104101,104101,104102,0,1,1
29826,5,2,104106,104106,104108,0,2,4
29827,6,2,104112,104112,104114,0,2,4
29828,5,2,104117,104117,104119,0,2,3
29829,1,2,104118,104119,104121,1,3,0
29830,3,3,104121,104121,104124,0,3,0
29831,1,2,104122,104124,104126,2,4,0
29832,3,3,104125,104126,104129,1,4,0
29833,2,2,104127,104129,104131,2,4,0
29834,6,2,104133,104133,104135,0,2,2
29835,2,2,104135,104135,104137,0,2,0
29836,4,3,104139,104139,104142,0,3,2
29837,1,3,104140,104142,104145,2,5,0
29838,1,1,104141,104145,104146,4,5,0
29839,1,2,104142,104146,104148,4,6,0
29840,6,2,104148,104148,104150,0,2,0
29841,1,2,104149,104150,104152,1,3,0
29842,1,2,104150,104152,104154,2,4,0
29843,3,3,104153,104154,104157,1,4,0
29844,4,3,104157,104157,104160,0,3,0
29845,4,3,104161,104161,104164,0,3,1
29846,1,3,104162,104164,104167,2,5,0
29847,2,1,104164,104167,104168,3,4,0
29848,6,3,104170,104170,104173,0,3,2
29849,2,1,104172,104173,104174,1,2,0
29850,3,1,104175,104175,104176,0,1,1
29851,2,1,104177,104177,104178,0,1,1
29852,4,2,104181,104181,104183,0,2,3
29853,2,2,104183,104183,104185,0,2,0
29854,6,1,104189,104189,104190,0,1,4
29855,3,3,104192,104192,104195,0,3,2
29856,1,1,104193,104195,104196,2,3,0
29857,4,3,104197,104197,104200,0,3,1
29858,5,1,104202,104202,104203,0,1,2
29859,6,1,104208,104208,104209,0,1,5
29860,2,3,104210,104210,104213,0,3,1
29861,3,2,104213,104213,104215,0,2,0
29862,5,1,104218,104218,104219,0,1,3
29863,5,1,104223,104223,104224,0,1,4
29864,5,1,104228,104228,104229,0,1,4
29865,6,3,104234,104234,104237,0,3,5
29866,1,1,104235,104237,104238,2,3,0
29867,2,2,104237,104238,104240,1,3,0
29868,1,3,104238,104240,104243,2,5,0
29869,6,2,104244,104244,104246,0,2,1
29870,1,1,104245,104246,104247,1,2,0
29871,4,1,104249,104249,104250,0,1,2
29872,4,1,104253,104253,104254,0,1,3
29873,6,1,104259,104259,104260,0,1,5
29874,6,2,104265,104265,104267,0,2,5
29875,4,2,104269,104269,104271,0,2,2
29876,5,3,104274,104274,104277,0,3,3
29877,2,3,104276,104277,104280,1,4,0
29878,5,1,104281,104281,104282,0,1,1
29879,1,3,104282,104282,104285,0,3,0
29880,5,2,104287,104287,104289,0,2,2
29881,2,2,104289,104289,104291,0,2,0
29882,2,2,104291,104291,104293,0,2,0
29883,2,2,104293,104293,104295,0,2,0
29884,5,3,104298,104298,104301,0,3,3
29885,6,2,104304,104304,104306,0,2,3
29886,6,1,104310,104310,104311,0,1,4
29887,4,2,104314,104314,104316,0,2,3
29888,2,2,104316,104316,104318,0,2,0
29889,1,3,104317,104318,104321,1,4,0
29890,1,2,104318,104321,104323,3,5,0
29891,6,2,104324,104324,104326,0,2,1
29892,1,1,104325,104326,104327,1,2,0
29893,4,3,104329,104329,104332,0,3,2
29894,4,2,104333,104333,104335,0,2,1
29895,3,2,104336,104336,104338,0,2,1
29896,2,3,104338,104338,104341,0,3,0
29897,1,1,104339,104341,104342,2,3,0
29898,4,3,104343,104343,104346,0,3,1
29899,6,2,104349,104349,104351,0,2,3
29900,1,2,104350,104351,104353,1,3,0
29901,1,1,104351,104353,104354,2,3,0
29902,2,1,104353,104354,104355,1,2,0
29903,3,1,104356,104356,104357,0,1,1
29904,3,1,104359,104359,104360,0,1,2
29905,5,1,104364,104364,104365,0,1,4
29906,5,1,104369,104369,104370,0,1,4
29907,4,3,104373,104373,104376,0,3,3
29908,1,2,104374,104376,104378,2,4,0
29909,4,1,104378,104378,104379,0,1,0
29910,5,1,104383,104383,104384,0,1,4
29911,3,2,104386,104386,104388,0,2,2
29912,1,3,104387,104388,104391,1,4,0
29913,6,2,104393,104393,104395,0,2,2
29914,5,3,104398,104398,104401,0,3,3
29915,1,1,104399,104401,104402,2,3,0
29916,4,3,104403,104403,104406,0,3,1
29917,6,2,104409,104409,104411,0,2,3
29918,1,3,104410,104411,104414,1,4,0
29919,1,1,104411,104414,104415,3,4,0
29920,3,2,104414,104415,104417,1,3,0
29921,6,3,104420,104420,104423,0,3,3
29922,1,3,104421,104423,104426,2,5,0
29923,1,2,104422,104426,104428,4,6,0
29924,3,1,104425,104428,104429,3,4,0
29925,6,1,104431,104431,104432,0,1,2
29926,3,3,104434,104434,104437,0,3,2
29927,3,1,104437,104437,104438,0,1,0
29928,1,3,104438,104438,104441,0,3,0
29929,5,2,104443,104443,104445,0,2,2
29930,6,3,104449,104449,104452,0,3,4
29931,5,1,104454,104454,104455,0,1,2
29932,1,1,104455,104455,104456,0,1,0
29933,2,2,104457,104457,104459,0,2,1
29934,4,1,104461,104461,104462,0,1,2
29935,4,1,104465,104465,104466,0,1,3
29936,6,3,104471,104471,104474,0,3,5
29937,3,3,104474,104474,104477,0,3,0
29938,2,1,104476,104477,104478,1,2,0
29939,6,1,104482,104482,104483,0,1,4
29940,3,1,104485,104485,104486,0,1,2
29941,6,3,104491,104491,104494,0,3,5
29942,2,2,104493,104494,104496,1,3,0
29943,2,2,104495,104496,104498,1,3,0
29944,1,1,104496,104498,104499,2,3,0
29945,2,3,104498,104499,104502,1,4,0
29946,5,1,104503,104503,104504,0,1,1
29947,5,2,104508,104508,104510,0,2,4
29948,3,3,104511,104511,104514,0,3,1
29949,3,3,104514,104514,104517,0,3,0
29950,2,2,104516,104517,104519,1,3,0
29951,1,3,104517,104519,104522,2,5,0
29952,6,1,104523,104523,104524,0,1,1
29953,6,2,104529,104529,104531,0,2,5
29954,4,1,104533,104533,104534,0,1,2
29955,3,3,104536,104536,104539,0,3,2
29956,2,2,104538,104539,104541,1,3,0
29957,4,1,104542,104542,104543,0,1,1
29958,1,2,104543,104543,104545,0,2,0
29959,5,2,104548,104548,104550,0,2,3
29960,4,2,104552,104552,104554,0,2,2
29961,3,1,104555,104555,104556,0,1,1
29962,4,2,104559,104559,104561,0,2,3
29963,6,3,104565,104565,104568,0,3,4
29964,5,2,104570,104570,104572,0,2,2
29965,3,3,104573,104573,104576,0,3,1
29966,1,1,104574,104576,104577,2,3,0
29967,4,3,104578,104578,104581,0,3,1
29968,2,3,104580,104581,104584,1,4,0
29969,1,1,104581,104584,104585,3,4,0
29970,3,1,104584,104585,104586,1,2,0
29971,3,2,104587,104587,104589,0,2,1
29972,5,3,104592,104592,104595,0,3,3
29973,3,3,104595,104595,104598,0,3,0
29974,1,1,104596,104598,104599,2,3,0
29975,1,3,104597,104599,104602,2,5,0
29976,2,1,104599,104602,104603,3,4,0
29977,5,3,104604,104604,104607,0,3,1
29978,5,2,104609,104609,104611,0,2,2
29979,5,3,104614,104614,104617,0,3,3
29980,4,3,104618,104618,104621,0,3,1
29981,2,2,104620,104621,104623,1,3,0
29982,3,2,104623,104623,104625,0,2,0
29983,1,1,104624,104625,104626,1,2,0
29984,5,3,104629,104629,104632,0,3,3
29985,2,1,104631,104632,104633,1,2,0
29986,3,2,104634,104634,104636,0,2,1
29987,5,2,104639,104639,104641,0,2,3
29988,2,1,104641,104641,104642,0,1,0
29989,5,2,104646,104646,104648,0,2,4
29990,5,3,104651,104651,104654,0,3,3
29991,6,3,104657,104657,104660,0,3,3
29992,3,2,104660,104660,104662,0,2,0
29993,3,3,104663,104663,104666,0,3,1
29994,4,1,104667,104667,104668,0,1,1
29995,4,1,104671,104671,104672,0,1,3
29996,6,3,104677,104677,104680,0,3,5
29997,3,3,104680,104680,104683,0,3,0
29998,6,1,104686,104686,104687,0,1,3
29999,1,3,104687,104687,104690,0,3,0
30000,6,1,104693,104693,104694,0,1,3
30001,6,2,104699,104699,104701,0,2,5
30002,1,2,104700,104701,104703,1,3,0
30003,1,2,104701,104703,104705,2,4,0
30004,2,3,104703,104705,104708,2,5,0
30005,5,1,104708,104708,104709,0,1,0
30006,1,3,104709,104709,104712,0,3,0
30007,5,3,104714,104714,104717,0,3,2
30008,4,3,104718,104718,104721,0,3,1
30009,4,3,104722,104722,104725,0,3,1
30010,1,2,104723,104725,104727,2,4,0
30011,3,3,104726,104727,104730,1,4,0
30012,3,2,104729,104730,104732,1,3,0
30013,1,3,104730,104732,104735,2,5,0
30014,5,1,104735,104735,104736,0,1,0
30015,1,3,104736,104736,104739,0,3,0
30016,6,3,104742,104742,104745,0,3,3
30017,4,1,104746,104746,104747,0,1,1
30018,4,2,104750,104750,104752,0,2,3
30019,3,2,104753,104753,104755,0,2,1
30020,5,1,104758,104758,104759,0,1,3
30021,1,1,104759,104759,104760,0,1,0
30022,3,1,104762,104762,104763,0,1,2
30023,2,3,104764,104764,104767,0,3,1
30024,6,1,104770,104770,104771,0,1,3
30025,4,3,104774,104774,104777,0,3,3
30026,3,3,104777,104777,104780,0,3,0
30027,4,1,104781,104781,104782,0,1,1
30028,5,3,104786,104786,104789,0,3,4
30029,1,2,104787,104789,104791,2,4,0
30030,3,2,104790,104791,104793,1,3,0
30031,4,1,104794,104794,104795,0,1,1
30032,6,2,104800,104800,104802,0,2,5
30033,4,2,104804,104804,104806,0,2,2
30034,3,1,104807,104807,104808,0,1,1
30035,3,2,104810,104810,104812,0,2,2
30036,6,3,104816,104816,104819,0,3,4
30037,6,3,104822,104822,104825,0,3,3
30038,1,1,104823,104825,104826,2,3,0
30039,1,1,104824,104826,104827,2,3,0
30040,3,1,104827,104827,104828,0,1,0
30041,6,2,104833,104833,104835,0,2,5
30042,1,3,104834,104835,104838,1,4,0
30043,3,1,104837,104838,104839,1,2,0
30044,1,1,104838,104839,104840,1,2,0
30045,3,3,104841,104841,104844,0,3,1
30046,1,1,104842,104844,104845,2,3,0
30047,4,1,104846,104846,104847,0,1,1
30048,3,3,104849,104849,104852,0,3,2
30049,4,3,104853,104853,104856,0,3,1
30050,1,1,104854,104856,104857,2,3,0
30051,6,3,104860,104860,104863,0,3,3
30052,4,1,104864,104864,104865,0,1,1
30053,5,3,104869,104869,104872,0,3,4
30054,3,2,104872,104872,104874,0,2,0
30055,4,2,104876,104876,104878,0,2,2
30056,2,2,104878,104878,104880,0,2,0
30057,2,1,104880,104880,104881,0,1,0
30058,4,1,104884,104884,104885,0,1,3
30059,5,3,104889,104889,104892,0,3,4
30060,3,3,104892,104892,104895,0,3,0
30061,4,1,104896,104896,104897,0,1,1
30062,6,2,104902,104902,104904,0,2,5
30063,1,2,104903,104904,104906,1,3,0
30064,4,1,104907,104907,104908,0,1,1
30065,1,2,104908,104908,104910,0,2,0
30066,2,1,104910,104910,104911,0,1,0
30067,1,3,104911,104911,104914,0,3,0
30068,1,1,104912,104914,104915,2,3,0
30069,3,1,104915,104915,104916,0,1,0
30070,1,3,104916,104916,104919,0,3,0
30071,2,2,104918,104919,104921,1,3,0
30072,3,3,104921,104921,104924,0,3,0
30073,5,3,104926,104926,104929,0,3,2
30074,6,3,104932,104932,104935,0,3,3
30075,1,2,104933,104935,104937,2,4,0
30076,3,2,104936,104937,104939,1,3,0
30077,4,3,104940,104940,104943,0,3,1
30078,3,3,104943,104943,104946,0,3,0
30079,6,3,104949,104949,104952,0,3,3
30080,1,2,104950,104952,104954,2,4,0
30081,4,3,104954,104954,104957,0,3,0
30082,2,2,104956,104957,104959,1,3,0
30083,4,2,104960,104960,104962,0,2,1
30084,5,1,104965,104965,104966,0,1,3
30085,3,3,104968,104968,104971,0,3,2
30086,1,1,104969,104971,104972,2,3,0
30087,5,1,104974,104974,104975,0,1,2
30088,6,1,104980,104980,104981,0,1,5
30089,2,1,104982,104982,104983,0,1,1
30090,1,2,104983,104983,104985,0,2,0
30091,5,3,104988,104988,104991,0,3,3
30092,6,2,104994,104994,104996,0,2,3
30093,6,3,105000,105000,105003,0,3,4
30094,2,3,105002,105003,105006,1,4,0
30095,6,3,105008,105008,105011,0,3,2
30096,5,2,105013,105013,105015,0,2,2
30097,2,3,105015,105015,105018,0,3,0
30098,1,2,105016,105018,105020,2,4,0
30099,6,1,105022,105022,105023,0,1,2
30100,1,3,105023,105023,105026,0,3,0
30101,3,2,105026,105026,105028,0,2,0
30102,3,2,105029,105029,105031,0,2,1
30103,5,2,105034,105034,105036,0,2,3
30104,6,3,105040,105040,105043,0,3,4
30105,5,1,105045,105045,105046,0,1,2
30106,5,3,105050,105050,105053,0,3,4
30107,2,1,105052,105053,105054,1,2,0
30108,3,1,105055,105055,105056,0,1,1
30109,6,2,105061,105061,105063,0,2,5
30110,5,3,105066,105066,105069,0,3,3
30111,3,3,105069,105069,105072,0,3,0
30112,4,1,105073,105073,105074,0,1,1
30113,4,3,105077,105077,105080,0,3,3
30114,3,3,105080,105080,105083,0,3,0
30115,6,3,105086,105086,105089,0,3,3
30116,5,2,105091,105091,105093,0,2,2
30117,4,3,105095,105095,105098,0,3,2
30118,5,2,105100,105100,105102,0,2,2
30119,4,2,105104,105104,105106,0,2,2
30120,3,2,105107,105107,105109,0,2,1
30121,3,1,105110,105110,105111,0,1,1
30122,4,3,105114,105114,105117,0,3,3
30123,5,3,105119,105119,105122,0,3,2
30124,3,3,105122,105122,105125,0,3,0
30125,3,3,105125,105125,105128,0,3,0
30126,6,2,105131,105131,105133,0,2,3
30127,2,1,105133,105133,105134,0,1,0
30128,5,1,105138,105138,105139,0,1,4
30129,4,3,105142,105142,105145,0,3,3
30130,1,3,105143,105145,105148,2,5,0
30131,3,3,105146,105148,105151,2,5,0
30132,3,2,105149,105151,105153,2,4,0
30133,3,1,105152,105153,105154,1,2,0
30134,4,1,105156,105156,105157,0,1,2
30135,6,1,105162,105162,105163,0,1,5
30136,2,3,105164,105164,105167,0,3,1
30137,4,2,105168,105168,105170,0,2,1
30138,2,2,105170,105170,105172,0,2,0
30139,6,2,105176,105176,105178,0,2,4
30140,6,2,105182,105182,105184,0,2,4
30141,3,2,105185,105185,105187,0,2,1
30142,1,2,105186,105187,105189,1,3,0
30143,2,1,105188,105189,105190,1,2,0
30144,5,3,105193,105193,105196,0,3,3
30145,2,2,105195,105196,105198,1,3,0
30146,4,2,105199,105199,105201,0,2,1
30147,6,3,105205,105205,105208,0,3,4
30148,6,2,105211,105211,105213,0,2,3
30149,6,2,105217,105217,105219,0,2,4
30150,5,2,105222,105222,105224,0,2,3
30151,6,1,105228,105228,105229,0,1,4
30152,3,2,105231,105231,105233,0,2,2
30153,2,1,105233,105233,105234,0,1,0
30154,3,1,105236,105236,105237,0,1,2
30155,5,2,105241,105241,105243,0,2,4
30156,3,3,105244,105244,105247,0,3,1
30157,6,3,105250,105250,105253,0,3,3
30158,2,3,105252,105253,105256,1,4,0
30159,1,2,105253,105256,105258,3,5,0
30160,5,1,105258,105258,105259,0,1,0
30161,4,3,105262,105262,105265,0,3,3
30162,1,3,105263,105265,105268,2,5,0
30163,5,1,105268,105268,105269,0,1,0
30164,3,2,105271,105271,105273,0,2,2
30165,2,2,105273,105273,105275,0,2,0
30166,2,3,105275,105275,105278,0,3,0
30167,5,1,105280,105280,105281,0,1,2
30168,3,2,105283,105283,105285,0,2,2
30169,3,2,105286,105286,105288,0,2,1
30170,3,1,105289,105289,105290,0,1,1
30171,3,3,105292,105292,105295,0,3,2
30172,3,1,105295,105295,105296,0,1,0
30173,4,3,105299,105299,105302,0,3,3
30174,4,3,105303,105303,105306,0,3,1
30175,4,3,105307,105307,105310,0,3,1
30176,4,1,105311,105311,105312,0,1,1
30177,4,2,105315,105315,105317,0,2,3
30178,6,2,105321,105321,105323,0,2,4
30179,6,1,105327,105327,105328,0,1,4
30180,4,2,105331,105331,105333,0,2,3
30181,6,1,105337,105337,105338,0,1,4
30182,1,2,105338,105338,105340,0,2,0
30183,1,3,105339,105340,105343,1,4,0
30184,4,2,105343,105343,105345,0,2,0
30185,2,1,105345,105345,105346,0,1,0
30186,1,2,105346,105346,105348,0,2,0
30187,5,3,105351,105351,105354,0,3,3
30188,6,2,105357,105357,105359,0,2,3
30189,1,3,105358,105359,105362,1,4,0
30190,2,1,105360,105362,105363,2,3,0
30191,3,1,105363,105363,105364,0,1,0
30192,1,3,105364,105364,105367,0,3,0
30193,1,3,105365,105367,105370,2,5,0
30194,2,1,105367,105370,105371,3,4,0
30195,6,3,105373,105373,105376,0,3,2
30196,6,3,105379,105379,105382,0,3,3
30197,3,3,105382,105382,105385,0,3,0
30198,6,2,105388,105388,105390,0,2,3
30199,3,3,105391,105391,105394,0,3,1
30200,5,1,105396,105396,105397,0,1,2
30201,3,2,105399,105399,105401,0,2,2
30202,1,3,105400,105401,105404,1,4,0
30203,5,2,105405,105405,105407,0,2,1
30204,2,2,105407,105407,105409,0,2,0
30205,2,3,105409,105409,105412,0,3,0
30206,3,2,105412,105412,105414,0,2,0
30207,2,1,105414,105414,105415,0,1,0
30208,2,1,105416,105416,105417,0,1,1
30209,1,1,105417,105417,105418,0,1,0
30210,1,3,105418,105418,105421,0,3,0
30211,4,3,105422,105422,105425,0,3,1
30212,5,2,105427,105427,105429,0,2,2
30213,2,1,105429,105429,105430,0,1,0
30214,4,2,105433,105433,105435,0,2,3
30215,1,1,105434,105435,105436,1,2,0
30216,5,2,105439,105439,105441,0,2,3
30217,1,1,105440,105441,105442,1,2,0
30218,3,3,105443,105443,105446,0,3,1
30219,1,1,105444,105446,105447,2,3,0
30220,4,3,105448,105448,105451,0,3,1
30221,1,1,105449,105451,105452,2,3,0
30222,3,3,105452,105452,105455,0,3,0
30223,6,2,105458,105458,105460,0,2,3
30224,2,2,105460,105460,105462,0,2,0
30225,5,3,105465,105465,105468,0,3,3
30226,4,3,105469,105469,105472,0,3,1
30227,3,2,105472,105472,105474,0,2,0
30228,6,1,105478,105478,105479,0,1,4
30229,1,2,105479,105479,105481,0,2,0
30230,6,1,105485,105485,105486,0,1,4
30231,6,2,105491,105491,105493,0,2,5
30232,5,1,105496,105496,105497,0,1,3
30233,1,2,105497,105497,105499,0,2,0
30234,4,2,105501,105501,105503,0,2,2
30235,6,3,105507,105507,105510,0,3,4
30236,4,3,105511,105511,105514,0,3,1
30237,6,3,105517,105517,105520,0,3,3
30238,5,1,105522,105522,105523,0,1,2
30239,3,3,105525,105525,105528,0,3,2
30240,1,2,105526,105528,105530,2,4,0
30241,6,2,105532,105532,105534,0,2,2
30242,3,3,105535,105535,105538,0,3,1
30243,2,2,105537,105538,105540,1,3,0
30244,1,1,105538,105540,105541,2,3,0
30245,1,1,105539,105541,105542,2,3,0
30246,1,1,105540,105542,105543,2,3,0
30247,4,1,105544,105544,105545,0,1,1
30248,1,3,105545,105545,105548,0,3,0
30249,1,2,105546,105548,105550,2,4,0
30250,2,1,105548,105550,105551,2,3,0
30251,6,1,105554,105554,105555,0,1,3
30252,4,3,105558,105558,105561,0,3,3
30253,1,1,105559,105561,105562,2,3,0
30254,2,2,105561,105562,105564,1,3,0
30255,3,1,105564,105564,105565,0,1,0
30256,1,2,105565,105565,105567,0,2,0
30257,5,1,105570,105570,105571,0,1,3
30258,5,2,105575,105575,105577,0,2,4
30259,4,3,105579,105579,105582,0,3,2
30260,2,3,105581,105582,105585,1,4,0
30261,1,2,105582,105585,105587,3,5,0
30262,4,3,105586,105587,105590,1,4,0
30263,4,2,105590,105590,105592,0,2,0
30264,2,2,105592,105592,105594,0,2,0
30265,2,1,105594,105594,105595,0,1,0
30266,4,3,105598,105598,105601,0,3,3
30267,2,1,105600,105601,105602,1,2,0
30268,2,2,105602,105602,105604,0,2,0
30269,6,2,105608,105608,105610,0,2,4
30270,1,1,105609,105610,105611,1,2,0
30271,1,2,105610,105611,105613,1,3,0
30272,5,1,105615,105615,105616,0,1,2
30273,4,3,105619,105619,105622,0,3,3
30274,4,1,105623,105623,105624,0,1,1
30275,4,2,105627,105627,105629,0,2,3
30276,6,2,105633,105633,105635,0,2,4
30277,3,1,105636,105636,105637,0,1,1
30278,1,2,105637,105637,105639,0,2,0
30279,5,2,105642,105642,105644,0,2,3
30280,4,1,105646,105646,105647,0,1,2
30281,6,1,105652,105652,105653,0,1,5
30282,3,2,105655,105655,105657,0,2,2
30283,4,3,105659,105659,105662,0,3,2
30284,5,3,105664,105664,105667,0,3,2
30285,5,1,105669,105669,105670,0,1,2
30286,5,2,105674,105674,105676,0,2,4
30287,3,1,105677,105677,105678,0,1,1
30288,6,2,105683,105683,105685,0,2,5
30289,1,2,105684,105685,105687,1,3,0
30290,5,2,105689,105689,105691,0,2,2
30291,2,1,105691,105691,105692,0,1,0
30292,5,1,105696,105696,105697,0,1,4
30293,3,3,105699,105699,105702,0,3,2
30294,2,2,105701,105702,105704,1,3,0
30295,6,1,105707,105707,105708,0,1,3
30296,4,1,105711,105711,105712,0,1,3
30297,6,1,105717,105717,105718,0,1,5
30298,2,3,105719,105719,105722,0,3,1
30299,3,1,105722,105722,105723,0,1,0
30300,5,3,105727,105727,105730,0,3,4
30301,5,1,105732,105732,105733,0,1,2
30302,3,3,105735,105735,105738,0,3,2
30303,5,2,105740,105740,105742,0,2,2
30304,4,3,105744,105744,105747,0,3,2
30305,2,1,105746,105747,105748,1,2,0
30306,1,1,105747,105748,105749,1,2,0
30307,1,2,105748,105749,105751,1,3,0
30308,2,1,105750,105751,105752,1,2,0
30309,5,2,105755,105755,105757,0,2,3
30310,3,1,105758,105758,105759,0,1,1
30311,3,3,105761,105761,105764,0,3,2
30312,6,2,105767,105767,105769,0,2,3
30313,1,3,105768,105769,105772,1,4,0
30314,3,1,105771,105772,105773,1,2,0
30315,6,1,105777,105777,105778,0,1,4
30316,5,2,105782,105782,105784,0,2,4
30317,2,3,105784,105784,105787,0,3,0
30318,1,3,105785,105787,105790,2,5,0
30319,3,1,105788,105790,105791,2,3,0
30320,5,3,105793,105793,105796,0,3,2
30321,4,2,105797,105797,105799,0,2,1
30322,3,1,105800,105800,105801,0,1,1
30323,6,3,105806,105806,105809,0,3,5
30324,3,2,105809,105809,105811,0,2,0
30325,6,1,105815,105815,105816,0,1,4
30326,2,1,105817,105817,105818,0,1,1
30327,6,2,105823,105823,105825,0,2,5
30328,5,1,105828,105828,105829,0,1,3
30329,4,3,105832,105832,105835,0,3,3
30330,6,2,105838,105838,105840,0,2,3
30331,6,3,105844,105844,105847,0,3,4
30332,3,2,105847,105847,105849,0,2,0
30333,2,2,105849,105849,105851,0,2,0
30334,3,1,105852,105852,105853,0,1,1
30335,2,1,105854,105854,105855,0,1,1
30336,4,3,105858,105858,105861,0,3,3
30337,4,3,105862,105862,105865,0,3,1
30338,1,1,105863,105865,105866,2,3,0
30339,5,3,105868,105868,105871,0,3,2
30340,1,3,105869,105871,105874,2,5,0
30341,4,2,105873,105874,105876,1,3,0
30342,2,2,105875,105876,105878,1,3,0
30343,1,3,105876,105878,105881,2,5,0
30344,1,2,105877,105881,105883,4,6,0
30345,3,2,105880,105883,105885,3,5,0
30346,2,1,105882,105885,105886,3,4,0
30347,3,3,105885,105886,105889,1,4,0
30348,1,2,105886,105889,105891,3,5,0
30349,1,2,105887,105891,105893,4,6,0
30350,3,1,105890,105893,105894,3,4,0
30351,4,2,105894,105894,105896,0,2,0
30352,5,1,105899,105899,105900,0,1,3
30353,3,2,105902,105902,105904,0,2,2
30354,4,3,105906,105906,105909,0,3,2
30355,4,1,105910,105910,105911,0,1,1
30356,4,2,105914,105914,105916,0,2,3
30357,5,2,105919,105919,105921,0,2,3
30358,3,1,105922,105922,105923,0,1,1
30359,6,2,105928,105928,105930,0,2,5
30360,3,3,105931,105931,105934,0,3,1
30361,6,2,105937,105937,105939,0,2,3
30362,3,3,105940,105940,105943,0,3,1
30363,5,1,105945,105945,105946,0,1,2
30364,1,2,105946,105946,105948,0,2,0
30365,6,2,105952,105952,105954,0,2,4
30366,2,1,105954,105954,105955,0,1,0
30367,2,2,105956,105956,105958,0,2,1
30368,6,3,105962,105962,105965,0,3,4
30369,4,1,105966,105966,105967,0,1,1
30370,2,1,105968,105968,105969,0,1,1
30371,2,1,105970,105970,105971,0,1,1
30372,2,1,105972,105972,105973,0,1,1
30373,4,2,105976,105976,105978,0,2,3
30374,1,1,105977,105978,105979,1,2,0
30375,4,3,105981,105981,105984,0,3,2
30376,6,1,105987,105987,105988,0,1,3
30377,2,1,105989,105989,105990,0,1,1
30378,6,1,105995,105995,105996,0,1,5
30379,2,3,105997,105997,106000,0,3,1
30380,5,1,106002,106002,106003,0,1,2
30381,5,2,106007,106007,106009,0,2,4
30382,4,1,106011,106011,106012,0,1,2
30383,6,2,106017,106017,106019,0,2,5
30384,2,2,106019,106019,106021,0,2,0
30385,3,3,106022,106022,106025,0,3,1
30386,4,3,106026,106026,106029,0,3,1
30387,4,2,106030,106030,106032,0,2,1
30388,1,1,106031,106032,106033,1,2,0
30389,6,1,106037,106037,106038,0,1,4
30390,3,2,106040,106040,106042,0,2,2
30391,2,1,106042,106042,106043,0,1,0
30392,3,3,106045,106045,106048,0,3,2
30393,4,1,106049,106049,106050,0,1,1
30394,3,3,106052,106052,106055,0,3,2
30395,6,3,106058,106058,106061,0,3,3
30396,3,3,106061,106061,106064,0,3,0
30397,1,1,106062,106064,106065,2,3,0
30398,6,3,106068,106068,106071,0,3,3
30399,1,3,106069,106071,106074,2,5,0
30400,1,1,106070,106074,106075,4,5,0
30401,2,2,106072,106075,106077,3,5,0
30402,2,2,106074,106077,106079,3,5,0
30403,5,1,106079,106079,106080,0,1,0
30404,1,3,106080,106080,106083,0,3,0
30405,4,1,106084,106084,106085,0,1,1
30406,2,3,106086,106086,106089,0,3,1
30407,1,1,106087,106089,106090,2,3,0
30408,2,3,106089,106090,106093,1,4,0
30409,1,2,106090,106093,106095,3,5,0
30410,5,1,106095,106095,106096,0,1,0
30411,1,1,106096,106096,106097,0,1,0
30412,1,3,106097,106097,106100,0,3,0
30413,2,2,106099,106100,106102,1,3,0
30414,1,2,106100,106102,106104,2,4,0
30415,1,3,106101,106104,106107,3,6,0
30416,4,2,106105,106107,106109,2,4,0
30417,2,1,106107,106109,106110,2,3,0
30418,4,2,106111,106111,106113,0,2,1
30419,6,1,106117,106117,106118,0,1,4
30420,6,3,106123,106123,106126,0,3,5
30421,2,2,106125,106126,106128,1,3,0
30422,4,1,106129,106129,106130,0,1,1
30423,2,1,106131,106131,106132,0,1,1
30424,2,1,106133,106133,106134,0,1,1
30425,5,3,106138,106138,106141,0,3,4
30426,3,1,106141,106141,106142,0,1,0
30427,5,2,106146,106146,106148,0,2,4
30428,6,3,106152,106152,106155,0,3,4
30429,4,3,106156,106156,106159,0,3,1
30430,1,2,106157,106159,106161,2,4,0
30431,6,2,106163,106163,106165,0,2,2
30432,6,1,106169,106169,106170,0,1,4
30433,3,2,106172,106172,106174,0,2,2
30434,1,1,106173,106174,106175,1,2,0
30435,6,2,106179,106179,106181,0,2,4
30436,5,1,106184,106184,106185,0,1,3
30437,6,1,106190,106190,106191,0,1,5
30438,2,1,106192,106192,106193,0,1,1
30439,6,2,106198,106198,106200,0,2,5
30440,4,2,106202,106202,106204,0,2,2
30441,3,2,106205,106205,106207,0,2,1
30442,5,2,106210,106210,106212,0,2,3
30443,6,2,106216,106216,106218,0,2,4
30444,6,3,106222,106222,106225,0,3,4
30445,6,2,106228,106228,106230,0,2,3
30446,1,1,106229,106230,106231,1,2,0
30447,1,1,106230,106231,106232,1,2,0
30448,1,2,106231,106232,106234,1,3,0
30449,1,3,106232,106234,106237,2,5,0
30450,3,2,106235,106237,106239,2,4,0
30451,5,3,106240,106240,106243,0,3,1
30452,5,1,106245,106245,106246,0,1,2
30453,4,2,106249,106249,106251,0,2,3
30454,1,2,106250,106251,106253,1,3,0
30455,2,2,106252,106253,106255,1,3,0
30456,1,1,106253,106255,106256,2,3,0
30457,4,2,106257,106257,106259,0,2,1
30458,3,2,106260,106260,106262,0,2,1
30459,1,3,106261,106262,106265,1,4,0
30460,1,3,106262,106265,106268,3,6,0
30461,3,2,106265,106268,106270,3,5,0
30462,4,3,106269,106270,106273,1,4,0
30463,6,3,106275,106275,106278,0,3,2
30464,5,2,106280,106280,106282,0,2,2
30465,3,3,106283,106283,106286,0,3,1
30466,2,2,106285,106286,106288,1,3,0
30467,3,1,106288,106288,106289,0,1,0
30468,1,3,106289,106289,106292,0,3,0
30469,6,2,106295,106295,106297,0,2,3
30470,5,1,106300,106300,106301,0,1,3
30471,5,3,106305,106305,106308,0,3,4
30472,2,1,106307,106308,106309,1,2,0
30473,5,2,106312,106312,106314,0,2,3
30474,4,3,106316,106316,106319,0,3,2
30475,3,2,106319,106319,106321,0,2,0
30476,6,1,106325,106325,106326,0,1,4
30477,2,3,106327,106327,106330,0,3,1
30478,4,2,106331,106331,106333,0,2,1
30479,4,2,106335,106335,106337,0,2,2
30480,1,1,106336,106337,106338,1,2,0
30481,6,2,106342,106342,106344,0,2,4
30482,3,3,106345,106345,106348,0,3,1
30483,6,1,106351,106351,106352,0,1,3
30484,6,3,106357,106357,106360,0,3,5
30485,2,1,106359,106360,106361,1,2,0
30486,5,2,106364,106364,106366,0,2,3
30487,3,1,106367,106367,106368,0,1,1
30488,4,2,106371,106371,106373,0,2,3
30489,6,3,106377,106377,106380,0,3,4
30490,4,3,106381,106381,106384,0,3,1
30491,6,2,106387,106387,106389,0,2,3
30492,4,1,106391,106391,106392,0,1,2
30493,3,1,106394,106394,106395,0,1,2
30494,6,1,106400,106400,106401,0,1,5
30495,2,3,106402,106402,106405,0,3,1
30496,1,3,106403,106405,106408,2,5,0
30497,3,3,106406,106408,106411,2,5,0
30498,4,1,106410,106411,106412,1,2,0
30499,2,3,106412,106412,106415,0,3,0
30500,4,1,106416,106416,106417,0,1,1
30501,2,1,106418,106418,106419,0,1,1
30502,2,3,106420,106420,106423,0,3,1
30503,4,1,106424,106424,106425,0,1,1
30504,6,3,106430,106430,106433,0,3,5
30505,5,3,106435,106435,106438,0,3,2
30506,4,1,106439,106439,106440,0,1,1
30507,1,1,106440,106440,106441,0,1,0
30508,5,1,106445,106445,106446,0,1,4
30509,5,1,106450,106450,106451,0,1,4
30510,1,3,106451,106451,106454,0,3,0
30511,4,2,106455,106455,106457,0,2,1
30512,3,2,106458,106458,106460,0,2,1
30513,5,3,106463,106463,106466,0,3,3
30514,5,3,106468,106468,106471,0,3,2
30515,4,3,106472,106472,106475,0,3,1
30516,3,3,106475,106475,106478,0,3,0
30517,3,2,106478,106478,106480,0,2,0
30518,1,2,106479,106480,106482,1,3,0
30519,4,3,106483,106483,106486,0,3,1
30520,5,1,106488,106488,106489,0,1,2
30521,5,3,106493,106493,106496,0,3,4
30522,4,2,106497,106497,106499,0,2,1
30523,1,1,106498,106499,106500,1,2,0
30524,5,1,106503,106503,106504,0,1,3
30525,1,3,106504,106504,106507,0,3,0
30526,4,3,106508,106508,106511,0,3,1
30527,2,3,106510,106511,106514,1,4,0
30528,3,2,106513,106514,106516,1,3,0
30529,3,1,106516,106516,106517,0,1,0
30530,1,1,106517,106517,106518,0,1,0
30531,6,3,106523,106523,106526,0,3,5
30532,4,1,106527,106527,106528,0,1,1
30533,2,2,106529,106529,106531,0,2,1
30534,1,2,106530,106531,106533,1,3,0
30535,6,1,106536,106536,106537,0,1,3
30536,1,1,106537,106537,106538,0,1,0
30537,6,2,106543,106543,106545,0,2,5
30538,4,3,106547,106547,106550,0,3,2
30539,1,3,106548,106550,106553,2,5,0
30540,2,3,106550,106553,106556,3,6,0
30541,4,1,106554,106556,106557,2,3,0
30542,1,1,106555,106557,106558,2,3,0
30543,5,3,106560,106560,106563,0,3,2
30544,2,1,106562,106563,106564,1,2,0
30545,5,3,106567,106567,106570,0,3,3
30546,2,1,106569,106570,106571,1,2,0
30547,3,3,106572,106572,106575,0,3,1
30548,4,1,106576,106576,106577,0,1,1
30549,4,2,106580,106580,106582,0,2,3
30550,5,2,106585,106585,106587,0,2,3
30551,5,2,106590,106590,106592,0,2,3
30552,5,1,106595,106595,106596,0,1,3
30553,6,1,106601,106601,106602,0,1,5
30554,4,1,106605,106605,106606,0,1,3
30555,5,3,106610,106610,106613,0,3,4
30556,3,1,106613,106613,106614,0,1,0
30557,1,1,106614,106614,106615,0,1,0
30558,2,2,106616,106616,106618,0,2,1
30559,6,3,106622,106622,106625,0,3,4
30560,5,3,106627,106627,106630,0,3,2
30561,1,3,106628,106630,106633,2,5,0
30562,4,1,106632,106633,106634,1,2,0
30563,3,3,106635,106635,106638,0,3,1
30564,6,2,106641,106641,106643,0,2,3
30565,5,2,106646,106646,106648,0,2,3
30566,4,3,106650,106650,106653,0,3,2
30567,2,2,106652,106653,106655,1,3,0
30568,4,3,106656,106656,106659,0,3,1
30569,6,2,106662,106662,106664,0,2,3
30570,4,3,106666,106666,106669,0,3,2
30571,1,3,106667,106669,106672,2,5,0
30572,4,3,106671,106672,106675,1,4,0
30573,4,2,106675,106675,106677,0,2,0
30574,5,1,106680,106680,106681,0,1,3
30575,3,3,106683,106683,106686,0,3,2
30576,2,2,106685,106686,106688,1,3,0
30577,2,2,106687,106688,106690,1,3,0
30578,5,1,106692,106692,106693,0,1,2
30579,1,2,106693,106693,106695,0,2,0
30580,1,1,106694,106695,106696,1,2,0
30581,5,3,106699,106699,106702,0,3,3
30582,5,1,106704,106704,106705,0,1,2
30583,6,1,106710,106710,106711,0,1,5
30584,3,2,106713,106713,106715,0,2,2
30585,1,2,106714,106715,106717,1,3,0
30586,4,1,106718,106718,106719,0,1,1
30587,2,2,106720,106720,106722,0,2,1
30588,2,3,106722,106722,106725,0,3,0
30589,6,3,106728,106728,106731,0,3,3
30590,5,1,106733,106733,106734,0,1,2
30591,3,3,106736,106736,106739,0,3,2
30592,2,1,106738,106739,106740,1,2,0
30593,1,2,106739,106740,106742,1,3,0
30594,4,2,106743,106743,106745,0,2,1
30595,3,3,106746,106746,106749,0,3,1
30596,6,1,106752,106752,106753,0,1,3
30597,3,3,106755,106755,106758,0,3,2
30598,5,1,106760,106760,106761,0,1,2
30599,1,1,106761,106761,106762,0,1,0
30600,1,2,106762,106762,106764,0,2,0
30601,5,2,106767,106767,106769,0,2,3
30602,2,2,106769,106769,106771,0,2,0
30603,3,3,106772,106772,106775,0,3,1
30604,6,3,106778,106778,106781,0,3,3
30605,4,3,106782,106782,106785,0,3,1
30606,5,3,106787,106787,106790,0,3,2
30607,2,2,106789,106790,106792,1,3,0
30608,2,1,106791,106792,106793,1,2,0
30609,1,1,106792,106793,106794,1,2,0
30610,5,3,106797,106797,106800,0,3,3
30611,4,1,106801,106801,106802,0,1,1
30612,4,3,106805,106805,106808,0,3,3
30613,1,1,106806,106808,106809,2,3,0
30614,3,2,106809,106809,106811,0,2,0
30615,4,2,106813,106813,106815,0,2,2
30616,5,3,106818,106818,106821,0,3,3
30617,3,1,106821,106821,106822,0,1,0
30618,4,1,106825,106825,106826,0,1,3
30619,3,1,106828,106828,106829,0,1,2
30620,6,1,106834,106834,106835,0,1,5
30621,4,2,106838,106838,106840,0,2,3
30622,5,1,106843,106843,106844,0,1,3
30623,3,3,106846,106846,106849,0,3,2
30624,1,1,106847,106849,106850,2,3,0
30625,6,2,106853,106853,106855,0,2,3
30626,5,3,106858,106858,106861,0,3,3
30627,5,1,106863,106863,106864,0,1,2
30628,2,1,106865,106865,106866,0,1,1
30629,1,3,106866,106866,106869,0,3,0
30630,2,1,106868,106869,106870,1,2,0
30631,4,2,106872,106872,106874,0,2,2
30632,5,2,106877,106877,106879,0,2,3
30633,1,2,106878,106879,106881,1,3,0
30634,2,2,106880,106881,106883,1,3,0
30635,3,3,106883,106883,106886,0,3,0
30636,6,2,106889,106889,106891,0,2,3
30637,4,3,106893,106893,106896,0,3,2
30638,3,2,106896,106896,106898,0,2,0
30639,4,1,106900,106900,106901,0,1,2
30640,6,3,106906,106906,106909,0,3,5
30641,1,2,106907,106909,106911,2,4,0
30642,3,2,106910,106911,106913,1,3,0
30643,2,2,106912,106913,106915,1,3,0
30644,5,2,106917,106917,106919,0,2,2
30645,2,3,106919,106919,106922,0,3,0
30646,6,2,106925,106925,106927,0,2,3
30647,4,3,106929,106929,106932,0,3,2
30648,1,2,106930,106932,106934,2,4,0
30649,2,1,106932,106934,106935,2,3,0
30650,6,1,106938,106938,106939,0,1,3
30651,1,2,106939,106939,106941,0,2,0
30652,6,1,106945,106945,106946,0,1,4
30653,3,1,106948,106948,106949,0,1,2
30654,5,1,106953,106953,106954,0,1,4
30655,1,2,106954,106954,106956,0,2,0
30656,1,1,106955,106956,106957,1,2,0
30657,4,2,106959,106959,106961,0,2,2
30658,6,3,106965,106965,106968,0,3,4
30659,6,2,106971,106971,106973,0,2,3
30660,5,3,106976,106976,106979,0,3,3
30661,4,2,106980,106980,106982,0,2,1
30662,6,1,106986,106986,106987,0,1,4
30663,1,1,106987,106987,106988,0,1,0
30664,2,1,106989,106989,106990,0,1,1
30665,1,3,106990,106990,106993,0,3,0
30666,1,1,106991,106993,106994,2,3,0
30667,2,3,106993,106994,106997,1,4,0
30668,3,2,106996,106997,106999,1,3,0
30669,6,1,107002,107002,107003,0,1,3
30670,3,1,107005,107005,107006,0,1,2
30671,6,1,107011,107011,107012,0,1,5
30672,3,1,107014,107014,107015,0,1,2
30673,1,2,107015,107015,107017,0,2,0
30674,6,3,107021,107021,107024,0,3,4
30675,6,3,107027,107027,107030,0,3,3
30676,1,3,107028,107030,107033,2,5,0
30677,6,1,107034,107034,107035,0,1,1
30678,2,2,107036,107036,107038,0,2,1
30679,2,3,107038,107038,107041,0,3,0
30680,3,1,107041,107041,107042,0,1,0
30681,5,1,107046,107046,107047,0,1,4
30682,2,1,107048,107048,107049,0,1,1
30683,6,2,107054,107054,107056,0,2,5
30684,6,2,107060,107060,107062,0,2,4
30685,6,2,107066,107066,107068,0,2,4
30686,4,3,107070,107070,107073,0,3,2
30687,3,3,107073,107073,107076,0,3,0
30688,6,1,107079,107079,107080,0,1,3
30689,1,2,107080,107080,107082,0,2,0
30690,2,1,107082,107082,107083,0,1,0
30691,1,1,107083,107083,107084,0,1,0
30692,2,2,107085,107085,107087,0,2,1
30693,5,2,107090,107090,107092,0,2,3
30694,3,3,107093,107093,107096,0,3,1
30695,2,1,107095,107096,107097,1,2,0
30696,1,2,107096,107097,107099,1,3,0
30697,5,1,107101,107101,107102,0,1,2
30698,3,1,107104,107104,107105,0,1,2
30699,6,3,107110,107110,107113,0,3,5
30700,5,3,107115,107115,107118,0,3,2
30701,3,1,107118,107118,107119,0,1,0
30702,3,3,107121,107121,107124,0,3,2
30703,1,3,107122,107124,107127,2,5,0
30704,3,1,107125,107127,107128,2,3,0
30705,2,2,107127,107128,107130,1,3,0
30706,4,3,107131,107131,107134,0,3,1
30707,6,1,107137,107137,107138,0,1,3
30708,5,2,107142,107142,107144,0,2,4
30709,1,3,107143,107144,107147,1,4,0
30710,2,3,107145,107147,107150,2,5,0
30711,1,3,107146,107150,107153,4,7,0
30712,1,3,107147,107153,107156,6,9,0
30713,2,1,107149,107156,107157,7,8,0
30714,1,2,107150,107157,107159,7,9,0
30715,3,2,107153,107159,107161,6,8,0
30716,4,2,107157,107161,107163,4,6,0
30717,1,2,107158,107163,107165,5,7,0
30718,6,3,107164,107165,107168,1,4,0
30719,3,2,107167,107168,107170,1,3,0
30720,3,2,107170,107170,107172,0,2,0
30721,6,2,107176,107176,107178,0,2,4
30722,4,1,107180,107180,107181,0,1,2
30723,1,1,107181,107181,107182,0,1,0
30724,3,1,107184,107184,107185,0,1,2
30725,2,1,107186,107186,107187,0,1,1
30726,2,1,107188,107188,107189,0,1,1
30727,5,1,107193,107193,107194,0,1,4
30728,2,3,107195,107195,107198,0,3,1
30729,1,3,107196,107198,107201,2,5,0
30730,3,1,107199,107201,107202,2,3,0
30731,4,2,107203,107203,107205,0,2,1
30732,3,3,107206,107206,107209,0,3,1
30733,5,3,107211,107211,107214,0,3,2
30734,3,3,107214,107214,107217,0,3,0
30735,5,3,107219,107219,107222,0,3,2
30736,5,3,107224,107224,107227,0,3,2
30737,5,3,107229,107229,107232,0,3,2
30738,1,2,107230,107232,107234,2,4,0
30739,4,3,107234,107234,107237,0,3,0
30740,1,3,107235,107237,107240,2,5,0
30741,1,2,107236,107240,107242,4,6,0
30742,4,1,107240,107242,107243,2,3,0
30743,2,1,107242,107243,107244,1,2,0
30744,1,3,107243,107244,107247,1,4,0
30745,6,1,107249,107249,107250,0,1,2
30746,4,3,107253,107253,107256,0,3,3
30747,3,2,107256,107256,107258,0,2,0
30748,3,2,107259,107259,107261,0,2,1
30749,5,3,107264,107264,107267,0,3,3
30750,1,3,107265,107267,107270,2,5,0
30751,3,1,107268,107270,107271,2,3,0
30752,6,3,107274,107274,107277,0,3,3
30753,2,1,107276,107277,107278,1,2,0
30754,5,1,107281,107281,107282,0,1,3
30755,2,3,107283,107283,107286,0,3,1
30756,6,1,107289,107289,107290,0,1,3
30757,2,1,107291,107291,107292,0,1,1
30758,5,1,107296,107296,107297,0,1,4
30759,2,2,107298,107298,107300,0,2,1
30760,2,2,107300,107300,107302,0,2,0
30761,4,1,107304,107304,107305,0,1,2
30762,5,3,107309,107309,107312,0,3,4
30763,5,2,107314,107314,107316,0,2,2
30764,1,1,107315,107316,107317,1,2,0
30765,1,1,107316,107317,107318,1,2,0
30766,4,1,107320,107320,107321,0,1,2
30767,3,3,107323,107323,107326,0,3,2
30768,2,3,107325,107326,107329,1,4,0
30769,2,2,107327,107329,107331,2,4,0
30770,4,3,107331,107331,107334,0,3,0
30771,1,3,107332,107334,107337,2,5,0
30772,4,3,107336,107337,107340,1,4,0
30773,5,2,107341,107341,107343,0,2,1
30774,4,2,107345,107345,107347,0,2,2
30775,3,3,107348,107348,107351,0,3,1
30776,3,3,107351,107351,107354,0,3,0
30777,3,3,107354,107354,107357,0,3,0
30778,3,3,107357,107357,107360,0,3,0
30779,5,2,107362,107362,107364,0,2,2
30780,3,1,107365,107365,107366,0,1,1
30781,4,1,107369,107369,107370,0,1,3
30782,4,1,107373,107373,107374,0,1,3
30783,3,1,107376,107376,107377,0,1,2
30784,4,3,107380,107380,107383,0,3,3
30785,4,2,107384,107384,107386,0,2,1
30786,4,2,107388,107388,107390,0,2,2
30787,6,3,107394,107394,107397,0,3,4
30788,3,2,107397,107397,107399,0,2,0
30789,6,3,107403,107403,107406,0,3,4
30790,2,3,107405,107406,107409,1,4,0
30791,2,1,107407,107409,107410,2,3,0
30792,5,3,107412,107412,107415,0,3,2
30793,1,3,107413,107415,107418,2,5,0
30794,5,1,107418,107418,107419,0,1,0
30795,1,3,107419,107419,107422,0,3,0
30796,3,3,107422,107422,107425,0,3,0
30797,6,3,107428,107428,107431,0,3,3
30798,1,2,107429,107431,107433,2,4,0
30799,5,2,107434,107434,107436,0,2,1
30800,2,3,107436,107436,107439,0,3,0
30801,2,3,107438,107439,107442,1,4,0
30802,6,2,107444,107444,107446,0,2,2
30803,6,1,107450,107450,107451,0,1,4
30804,4,1,107454,107454,107455,0,1,3
30805,4,2,107458,107458,107460,0,2,3
30806,3,3,107461,107461,107464,0,3,1
30807,2,1,107463,107464,107465,1,2,0
30808,5,1,107468,107468,107469,0,1,3
30809,2,3,107470,107470,107473,0,3,1
30810,5,1,107475,107475,107476,0,1,2
30811,6,3,107481,107481,107484,0,3,5
30812,2,1,107483,107484,107485,1,2,0
30813,5,3,107488,107488,107491,0,3,3
30814,1,2,107489,107491,107493,2,4,0
30815,1,2,107490,107493,107495,3,5,0
30816,4,1,107494,107495,107496,1,2,0
30817,6,2,107500,107500,107502,0,2,4
30818,3,3,107503,107503,107506,0,3,1
30819,1,3,107504,107506,107509,2,5,0
30820,5,2,107509,107509,107511,0,2,0
30821,3,2,107512,107512,107514,0,2,1
30822,4,1,107516,107516,107517,0,1,2
30823,3,2,107519,107519,107521,0,2,2
30824,4,1,107523,107523,107524,0,1,2
30825,6,1,107529,107529,107530,0,1,5
30826,2,1,107531,107531,107532,0,1,1
30827,3,2,107534,107534,107536,0,2,2
30828,4,2,107538,107538,107540,0,2,2
30829,4,2,107542,107542,107544,0,2,2
30830,4,1,107546,107546,107547,0,1,2
30831,4,2,107550,107550,107552,0,2,3
30832,4,3,107554,107554,107557,0,3,2
30833,4,3,107558,107558,107561,0,3,1
30834,3,1,107561,107561,107562,0,1,0
30835,5,3,107566,107566,107569,0,3,4
30836,5,1,107571,107571,107572,0,1,2
30837,6,2,107577,107577,107579,0,2,5
30838,1,3,107578,107579,107582,1,4,0
30839,3,1,107581,107582,107583,1,2,0
30840,3,2,107584,107584,107586,0,2,1
30841,5,1,107589,107589,107590,0,1,3
30842,2,3,107591,107591,107594,0,3,1
30843,5,1,107596,107596,107597,0,1,2
30844,2,3,107598,107598,107601,0,3,1
30845,1,1,107599,107601,107602,2,3,0
30846,4,2,107603,107603,107605,0,2,1
30847,6,3,107609,107609,107612,0,3,4
30848,4,1,107613,107613,107614,0,1,1
30849,5,1,107618,107618,107619,0,1,4
30850,5,1,107623,107623,107624,0,1,4
30851,5,1,107628,107628,107629,0,1,4
30852,3,1,107631,107631,107632,0,1,2
30853,1,3,107632,107632,107635,0,3,0
30854,5,3,107637,107637,107640,0,3,2
30855,5,3,107642,107642,107645,0,3,2
30856,3,3,107645,107645,107648,0,3,0
30857,5,3,107650,107650,107653,0,3,2
30858,4,1,107654,107654,107655,0,1,1
30859,4,2,107658,107658,107660,0,2,3
30860,3,1,107661,107661,107662,0,1,1
30861,6,2,107667,107667,107669,0,2,5
30862,1,2,107668,107669,107671,1,3,0
30863,4,2,107672,107672,107674,0,2,1
30864,6,3,107678,107678,107681,0,3,4
30865,5,2,107683,107683,107685,0,2,2
30866,2,1,107685,107685,107686,0,1,0
30867,5,2,107690,107690,107692,0,2,4
30868,3,3,107693,107693,107696,0,3,1
30869,6,1,107699,107699,107700,0,1,3
30870,3,2,107702,107702,107704,0,2,2
30871,2,3,107704,107704,107707,0,3,0
30872,2,1,107706,107707,107708,1,2,0
30873,3,3,107709,107709,107712,0,3,1
30874,3,3,107712,107712,107715,0,3,0
30875,3,3,107715,107715,107718,0,3,0
30876,5,1,107720,107720,107721,0,1,2
30877,2,3,107722,107722,107725,0,3,1
30878,1,2,107723,107725,107727,2,4,0
30879,4,2,107727,107727,107729,0,2,0
30880,5,1,107732,107732,107733,0,1,3
30881,6,2,107738,107738,107740,0,2,5
30882,3,2,107741,107741,107743,0,2,1
30883,5,1,107746,107746,107747,0,1,3
30884,2,1,107748,107748,107749,0,1,1
30885,2,3,107750,107750,107753,0,3,1
30886,5,2,107755,107755,107757,0,2,2
30887,6,3,107761,107761,107764,0,3,4
30888,3,1,107764,107764,107765,0,1,0
30889,6,1,107770,107770,107771,0,1,5
30890,3,1,107773,107773,107774,0,1,2
30891,2,3,107775,107775,107778,0,3,1
30892,6,3,107781,107781,107784,0,3,3
30893,6,2,107787,107787,107789,0,2,3
30894,3,3,107790,107790,107793,0,3,1
30895,2,3,107792,107793,107796,1,4,0
30896,4,3,107796,107796,107799,0,3,0
30897,5,1,107801,107801,107802,0,1,2
30898,3,2,107804,107804,107806,0,2,2
30899,3,1,107807,107807,107808,0,1,1
30900,1,2,107808,107808,107810,0,2,0
30901,6,3,107814,107814,107817,0,3,4
30902,5,2,107819,107819,107821,0,2,2
30903,3,1,107822,107822,107823,0,1,1
30904,6,1,107828,107828,107829,0,1,5
30905,4,3,107832,107832,107835,0,3,3
30906,5,2,107837,107837,107839,0,2,2
30907,6,2,107843,107843,107845,0,2,4
30908,1,1,107844,107845,107846,1,2,0
30909,5,2,107849,107849,107851,0,2,3
30910,1,1,107850,107851,107852,1,2,0
30911,2,3,107852,107852,107855,0,3,0
30912,6,1,107858,107858,107859,0,1,3
30913,4,2,107862,107862,107864,0,2,3
30914,1,3,107863,107864,107867,1,4,0
30915,4,3,107867,107867,107870,0,3,0
30916,1,2,107868,107870,107872,2,4,0
30917,1,3,107869,107872,107875,3,6,0
30918,6,2,107875,107875,107877,0,2,0
30919,2,2,107877,107877,107879,0,2,0
30920,4,3,107881,107881,107884,0,3,2
30921,3,2,107884,107884,107886,0,2,0
30922,6,1,107890,107890,107891,0,1,4
30923,6,1,107896,107896,107897,0,1,5
30924,6,3,107902,107902,107905,0,3,5
30925,1,1,107903,107905,107906,2,3,0
30926,1,2,107904,107906,107908,2,4,0
30927,1,1,107905,107908,107909,3,4,0
30928,4,1,107909,107909,107910,0,1,0
30929,2,2,107911,107911,107913,0,2,1
30930,1,3,107912,107913,107916,1,4,0
30931,3,1,107915,107916,107917,1,2,0
30932,5,1,107920,107920,107921,0,1,3
30933,3,1,107923,107923,107924,0,1,2
30934,5,3,107928,107928,107931,0,3,4
30935,3,1,107931,107931,107932,0,1,0
30936,3,2,107934,107934,107936,0,2,2
30937,2,3,107936,107936,107939,0,3,0
30938,4,2,107940,107940,107942,0,2,1
30939,3,1,107943,107943,107944,0,1,1
30940,3,1,107946,107946,107947,0,1,2
30941,3,2,107949,107949,107951,0,2,2
30942,6,1,107955,107955,107956,0,1,4
30943,4,1,107959,107959,107960,0,1,3
30944,2,3,107961,107961,107964,0,3,1
30945,2,1,107963,107964,107965,1,2,0
30946,1,1,107964,107965,107966,1,2,0
30947,1,2,107965,107966,107968,1,3,0
30948,4,2,107969,107969,107971,0,2,1
30949,5,1,107974,107974,107975,0,1,3
30950,3,3,107977,107977,107980,0,3,2
30951,6,1,107983,107983,107984,0,1,3
30952,2,1,107985,107985,107986,0,1,1
30953,6,2,107991,107991,107993,0,2,5
30954,5,1,107996,107996,107997,0,1,3
30955,4,2,108000,108000,108002,0,2,3
30956,4,2,108004,108004,108006,0,2,2
30957,1,3,108005,108006,108009,1,4,0
30958,6,3,108011,108011,108014,0,3,2
30959,6,3,108017,108017,108020,0,3,3
30960,3,1,108020,108020,108021,0,1,0
30961,4,2,108024,108024,108026,0,2,3
30962,1,2,108025,108026,108028,1,3,0
30963,2,2,108027,108028,108030,1,3,0
30964,6,2,108033,108033,108035,0,2,3
30965,1,3,108034,108035,108038,1,4,0
30966,4,3,108038,108038,108041,0,3,0
30967,1,1,108039,108041,108042,2,3,0
30968,4,1,108043,108043,108044,0,1,1
30969,5,2,108048,108048,108050,0,2,4
30970,1,2,108049,108050,108052,1,3,0
30971,6,3,108055,108055,108058,0,3,3
30972,6,1,108061,108061,108062,0,1,3
30973,2,1,108063,108063,108064,0,1,1
30974,5,1,108068,108068,108069,0,1,4
30975,2,1,108070,108070,108071,0,1,1
30976,4,1,108074,108074,108075,0,1,3
30977,4,2,108078,108078,108080,0,2,3
30978,2,1,108080,108080,108081,0,1,0
30979,2,2,108082,108082,108084,0,2,1
30980,2,2,108084,108084,108086,0,2,0
30981,6,1,108090,108090,108091,0,1,4
30982,3,1,108093,108093,108094,0,1,2
30983,1,3,108094,108094,108097,0,3,0
30984,6,2,108100,108100,108102,0,2,3
30985,3,3,108103,108103,108106,0,3,1
30986,4,2,108107,108107,108109,0,2,1
30987,3,1,108110,108110,108111,0,1,1
30988,4,1,108114,108114,108115,0,1,3
30989,3,2,108117,108117,108119,0,2,2
30990,5,2,108122,108122,108124,0,2,3
30991,2,3,108124,108124,108127,0,3,0
30992,3,2,108127,108127,108129,0,2,0
30993,3,1,108130,108130,108131,0,1,1
30994,6,1,108136,108136,108137,0,1,5
30995,1,2,108137,108137,108139,0,2,0
30996,3,3,108140,108140,108143,0,3,1
30997,4,3,108144,108144,108147,0,3,1
30998,6,3,108150,108150,108153,0,3,3
30999,4,3,108154,108154,108157,0,3,1
31000,4,3,108158,108158,108161,0,3,1
31001,2,1,108160,108161,108162,1,2,0
31002,5,2,108165,108165,108167,0,2,3
31003,1,2,108166,108167,108169,1,3,0
31004,4,2,108170,108170,108172,0,2,1
31005,2,3,108172,108172,108175,0,3,0
31006,5,2,108177,108177,108179,0,2,2
31007,6,3,108183,108183,108186,0,3,4
31008,5,1,108188,108188,108189,0,1,2
31009,6,1,108194,108194,108195,0,1,5
31010,2,1,108196,108196,108197,0,1,1
31011,6,2,108202,108202,108204,0,2,5
31012,5,3,108207,108207,108210,0,3,3
31013,6,1,108213,108213,108214,0,1,3
31014,6,2,108219,108219,108221,0,2,5
31015,1,2,108220,108221,108223,1,3,0
31016,3,1,108223,108223,108224,0,1,0
31017,2,1,108225,108225,108226,0,1,1
31018,4,3,108229,108229,108232,0,3,3
31019,2,3,108231,108232,108235,1,4,0
31020,5,1,108236,108236,108237,0,1,1
31021,5,1,108241,108241,108242,0,1,4
31022,1,3,108242,108242,108245,0,3,0
31023,5,3,108247,108247,108250,0,3,2
31024,4,3,108251,108251,108254,0,3,1
31025,6,3,108257,108257,108260,0,3,3
31026,2,3,108259,108260,108263,1,4,0
31027,1,3,108260,108263,108266,3,6,0
31028,4,3,108264,108266,108269,2,5,0
31029,4,3,108268,108269,108272,1,4,0
31030,2,1,108270,108272,108273,2,3,0
31031,1,2,108271,108273,108275,2,4,0
31032,5,3,108276,108276,108279,0,3,1
31033,1,3,108277,108279,108282,2,5,0
31034,5,1,108282,108282,108283,0,1,0
31035,6,2,108288,108288,108290,0,2,5
31036,4,1,108292,108292,108293,0,1,2
31037,5,3,108297,108297,108300,0,3,4
31038,2,1,108299,108300,108301,1,2,0
31039,6,1,108305,108305,108306,0,1,4
31040,3,2,108308,108308,108310,0,2,2
31041,6,1,108314,108314,108315,0,1,4
31042,3,1,108317,108317,108318,0,1,2
31043,4,1,108321,108321,108322,0,1,3
31044,4,2,108325,108325,108327,0,2,3
31045,6,3,108331,108331,108334,0,3,4
31046,6,2,108337,108337,108339,0,2,3
31047,4,1,108341,108341,108342,0,1,2
31048,5,3,108346,108346,108349,0,3,4
31049,4,3,108350,108350,108353,0,3,1
31050,1,1,108351,108353,108354,2,3,0
31051,1,2,108352,108354,108356,2,4,0
31052,3,3,108355,108356,108359,1,4,0
31053,2,1,108357,108359,108360,2,3,0
31054,2,1,108359,108360,108361,1,2,0
31055,5,2,108364,108364,108366,0,2,3
31056,5,2,108369,108369,108371,0,2,3
31057,4,2,108373,108373,108375,0,2,2
31058,6,1,108379,108379,108380,0,1,4
31059,4,2,108383,108383,108385,0,2,3
31060,5,1,108388,108388,108389,0,1,3
31061,6,2,108394,108394,108396,0,2,5
31062,4,1,108398,108398,108399,0,1,2
31063,6,1,108404,108404,108405,0,1,5
31064,6,3,108410,108410,108413,0,3,5
31065,1,2,108411,108413,108415,2,4,0
31066,2,1,108413,108415,108416,2,3,0
31067,6,3,108419,108419,108422,0,3,3
31068,6,3,108425,108425,108428,0,3,3
31069,5,2,108430,108430,108432,0,2,2
31070,4,1,108434,108434,108435,0,1,2
31071,4,3,108438,108438,108441,0,3,3
31072,4,3,108442,108442,108445,0,3,1
31073,1,3,108443,108445,108448,2,5,0
31074,5,3,108448,108448,108451,0,3,0
31075,5,2,108453,108453,108455,0,2,2
31076,5,1,108458,108458,108459,0,1,3
31077,5,3,108463,108463,108466,0,3,4
31078,1,1,108464,108466,108467,2,3,0
31079,6,3,108470,108470,108473,0,3,3
31080,5,1,108475,108475,108476,0,1,2
31081,5,1,108480,108480,108481,0,1,4
31082,2,2,108482,108482,108484,0,2,1
31083,1,1,108483,108484,108485,1,2,0
31084,2,1,108485,108485,108486,0,1,0
31085,3,3,108488,108488,108491,0,3,2
31086,4,3,108492,108492,108495,0,3,1
31087,5,2,108497,108497,108499,0,2,2
31088,2,3,108499,108499,108502,0,3,0
31089,1,3,108500,108502,108505,2,5,0
31090,3,3,108503,108505,108508,2,5,0
31091,2,2,108505,108508,108510,3,5,0
31092,1,3,108506,108510,108513,4,7,0
31093,1,1,108507,108513,108514,6,7,0
31094,3,3,108510,108514,108517,4,7,0
31095,3,1,108513,108517,108518,4,5,0
31096,6,1,108519,108519,108520,0,1,1
31097,4,1,108523,108523,108524,0,1,3
31098,4,2,108527,108527,108529,0,2,3
31099,4,3,108531,108531,108534,0,3,2
31100,4,2,108535,108535,108537,0,2,1
31101,4,3,108539,108539,108542,0,3,2
31102,1,2,108540,108542,108544,2,4,0
31103,6,2,108546,108546,108548,0,2,2
31104,4,1,108550,108550,108551,0,1,2
31105,2,1,108552,108552,108553,0,1,1
31106,3,1,108555,108555,108556,0,1,2
31107,5,2,108560,108560,108562,0,2,4
31108,5,3,108565,108565,108568,0,3,3
31109,1,1,108566,108568,108569,2,3,0
31110,5,2,108571,108571,108573,0,2,2
31111,5,3,108576,108576,108579,0,3,3
31112,4,3,108580,108580,108583,0,3,1
31113,4,3,108584,108584,108587,0,3,1
31114,4,3,108588,108588,108591,0,3,1
31115,5,2,108593,108593,108595,0,2,2
31116,4,3,108597,108597,108600,0,3,2
31117,1,1,108598,108600,108601,2,3,0
31118,3,2,108601,108601,108603,0,2,0
31119,4,1,108605,108605,108606,0,1,2
31120,6,1,108611,108611,108612,0,1,5
31121,1,1,108612,108612,108613,0,1,0
31122,2,3,108614,108614,108617,0,3,1
31123,1,3,108615,108617,108620,2,5,0
31124,3,1,108618,108620,108621,2,3,0
31125,1,2,108619,108621,108623,2,4,0
31126,6,2,108625,108625,108627,0,2,2
31127,2,3,108627,108627,108630,0,3,0
31128,2,3,108629,108630,108633,1,4,0
31129,3,2,108632,108633,108635,1,3,0
31130,6,3,108638,108638,108641,0,3,3
31131,1,1,108639,108641,108642,2,3,0
31132,4,2,108643,108643,108645,0,2,1
31133,6,3,108649,108649,108652,0,3,4
31134,4,1,108653,108653,108654,0,1,1
31135,5,3,108658,108658,108661,0,3,4
31136,3,3,108661,108661,108664,0,3,0
31137,2,3,108663,108664,108667,1,4,0
31138,2,3,108665,108667,108670,2,5,0
31139,6,1,108671,108671,108672,0,1,1
31140,1,2,108672,108672,108674,0,2,0
31141,3,2,108675,108675,108677,0,2,1
31142,6,2,108681,108681,108683,0,2,4
31143,1,1,108682,108683,108684,1,2,0
31144,2,2,108684,108684,108686,0,2,0
31145,6,3,108690,108690,108693,0,3,4
31146,5,2,108695,108695,108697,0,2,2
31147,1,3,108696,108697,108700,1,4,0
31148,6,1,108702,108702,108703,0,1,2
31149,2,3,108704,108704,108707,0,3,1
31150,5,2,108709,108709,108711,0,2,2
31151,6,3,108715,108715,108718,0,3,4
31152,1,2,108716,108718,108720,2,4,0
31153,3,3,108719,108720,108723,1,4,0
31154,6,1,108725,108725,108726,0,1,2
31155,1,3,108726,108726,108729,0,3,0
31156,3,1,108729,108729,108730,0,1,0
31157,5,1,108734,108734,108735,0,1,4
31158,1,3,108735,108735,108738,0,3,0
31159,1,1,108736,108738,108739,2,3,0
31160,2,1,108738,108739,108740,1,2,0
31161,4,1,108742,108742,108743,0,1,2
31162,6,2,108748,108748,108750,0,2,5
31163,4,3,108752,108752,108755,0,3,2
31164,2,2,108754,108755,108757,1,3,0
31165,4,1,108758,108758,108759,0,1,1
31166,6,2,108764,108764,108766,0,2,5
31167,3,1,108767,108767,108768,0,1,1
31168,4,1,108771,108771,108772,0,1,3
31169,2,1,108773,108773,108774,0,1,1
31170,4,2,108777,108777,108779,0,2,3
31171,3,2,108780,108780,108782,0,2,1
31172,2,2,108782,108782,108784,0,2,0
31173,5,1,108787,108787,108788,0,1,3
31174,1,2,108788,108788,108790,0,2,0
31175,6,3,108794,108794,108797,0,3,4
31176,6,3,108800,108800,108803,0,3,3
31177,6,2,108806,108806,108808,0,2,3
31178,2,2,108808,108808,108810,0,2,0
31179,2,3,108810,108810,108813,0,3,0
31180,3,3,108813,108813,108816,0,3,0
31181,1,2,108814,108816,108818,2,4,0
31182,3,2,108817,108818,108820,1,3,0
31183,1,2,108818,108820,108822,2,4,0
31184,3,2,108821,108822,108824,1,3,0
31185,2,1,108823,108824,108825,1,2,0
31186,4,1,108827,108827,108828,0,1,2
31187,3,3,108830,108830,108833,0,3,2
31188,4,2,108834,108834,108836,0,2,1
31189,5,2,108839,108839,108841,0,2,3
31190,4,2,108843,108843,108845,0,2,2
31191,5,1,108848,108848,108849,0,1,3
31192,4,2,108852,108852,108854,0,2,3
31193,4,3,108856,108856,108859,0,3,2
31194,1,1,108857,108859,108860,2,3,0
31195,3,3,108860,108860,108863,0,3,0
31196,3,1,108863,108863,108864,0,1,0
31197,1,1,108864,108864,108865,0,1,0
31198,2,1,108866,108866,108867,0,1,1
31199,4,2,108870,108870,108872,0,2,3
31200,6,3,108876,108876,108879,0,3,4
31201,4,3,108880,108880,108883,0,3,1
31202,4,3,108884,108884,108887,0,3,1
31203,1,2,108885,108887,108889,2,4,0
31204,1,2,108886,108889,108891,3,5,0
31205,3,1,108889,108891,108892,2,3,0
31206,3,2,108892,108892,108894,0,2,0
31207,4,3,108896,108896,108899,0,3,2
31208,3,3,108899,108899,108902,0,3,0
31209,3,2,108902,108902,108904,0,2,0
31210,3,2,108905,108905,108907,0,2,1
31211,4,3,108909,108909,108912,0,3,2
31212,1,2,108910,108912,108914,2,4,0
31213,5,1,108915,108915,108916,0,1,1
31214,6,3,108921,108921,108924,0,3,5
31215,1,3,108922,108924,108927,2,5,0
31216,1,3,108923,108927,108930,4,7,0
31217,6,2,108929,108930,108932,1,3,0
31218,6,1,108935,108935,108936,0,1,3
31219,2,2,108937,108937,108939,0,2,1
31220,1,3,108938,108939,108942,1,4,0
31221,5,3,108943,108943,108946,0,3,1
31222,5,1,108948,108948,108949,0,1,2
31223,5,3,108953,108953,108956,0,3,4
31224,3,1,108956,108956,108957,0,1,0
31225,6,3,108962,108962,108965,0,3,5
31226,1,1,108963,108965,108966,2,3,0
31227,6,3,108969,108969,108972,0,3,3
31228,2,1,108971,108972,108973,1,2,0
31229,2,1,108973,108973,108974,0,1,0
31230,2,2,108975,108975,108977,0,2,1
31231,4,1,108979,108979,108980,0,1,2
31232,4,3,108983,108983,108986,0,3,3
31233,3,3,108986,108986,108989,0,3,0
31234,3,3,108989,108989,108992,0,3,0
31235,3,3,108992,108992,108995,0,3,0
31236,1,1,108993,108995,108996,2,3,0
31237,4,3,108997,108997,109000,0,3,1
31238,4,1,109001,109001,109002,0,1,1
31239,1,3,109002,109002,109005,0,3,0
31240,4,1,109006,109006,109007,0,1,1
31241,6,2,109012,109012,109014,0,2,5
31242,2,1,109014,109014,109015,0,1,0
31243,3,2,109017,109017,109019,0,2,2
31244,2,2,109019,109019,109021,0,2,0
31245,5,3,109024,109024,109027,0,3,3
31246,3,1,109027,109027,109028,0,1,0
31247,5,2,109032,109032,109034,0,2,4
31248,2,1,109034,109034,109035,0,1,0
31249,1,1,109035,109035,109036,0,1,0
31250,6,2,109041,109041,109043,0,2,5
31251,5,1,109046,109046,109047,0,1,3
31252,5,3,109051,109051,109054,0,3,4
31253,3,1,109054,109054,109055,0,1,0
31254,3,3,109057,109057,109060,0,3,2
31255,5,3,109062,109062,109065,0,3,2
31256,6,3,109068,109068,109071,0,3,3
31257,5,2,109073,109073,109075,0,2,2
31258,6,3,109079,109079,109082,0,3,4
31259,1,2,109080,109082,109084,2,4,0
31260,1,2,109081,109084,109086,3,5,0
31261,1,1,109082,109086,109087,4,5,0
31262,6,2,109088,109088,109090,0,2,1
31263,6,2,109094,109094,109096,0,2,4
31264,5,2,109099,109099,109101,0,2,3
31265,5,1,109104,109104,109105,0,1,3
31266,5,3,109109,109109,109112,0,3,4
31267,5,2,109114,109114,109116,0,2,2
31268,4,1,109118,109118,109119,0,1,2
31269,3,3,109121,109121,109124,0,3,2
31270,5,2,109126,109126,109128,0,2,2
31271,4,1,109130,109130,109131,0,1,2
31272,4,1,109134,109134,109135,0,1,3
31273,2,3,109136,109136,109139,0,3,1
31274,2,1,109138,109139,109140,1,2,0
31275,2,2,109140,109140,109142,0,2,0
31276,1,1,109141,109142,109143,1,2,0
31277,5,3,109146,109146,109149,0,3,3
31278,1,3,109147,109149,109152,2,5,0
31279,3,3,109150,109152,109155,2,5,0
31280,6,3,109156,109156,109159,0,3,1
31281,4,2,109160,109160,109162,0,2,1
31282,2,3,109162,109162,109165,0,3,0
31283,5,2,109167,109167,109169,0,2,2
31284,5,1,109172,109172,109173,0,1,3
31285,4,1,109176,109176,109177,0,1,3
31286,6,3,109182,109182,109185,0,3,5
31287,5,3,109187,109187,109190,0,3,2
31288,3,2,109190,109190,109192,0,2,0
31289,3,2,109193,109193,109195,0,2,1
31290,1,2,109194,109195,109197,1,3,0
31291,1,3,109195,109197,109200,2,5,0
31292,3,1,109198,109200,109201,2,3,0
31293,3,3,109201,109201,109204,0,3,0
31294,6,1,109207,109207,109208,0,1,3
31295,6,3,109213,109213,109216,0,3,5
31296,5,3,109218,109218,109221,0,3,2
31297,1,1,109219,109221,109222,2,3,0
31298,6,1,109225,109225,109226,0,1,3
31299,3,2,109228,109228,109230,0,2,2
31300,1,2,109229,109230,109232,1,3,0
31301,4,1,109233,109233,109234,0,1,1
31302,4,2,109237,109237,109239,0,2,3
31303,3,1,109240,109240,109241,0,1,1
31304,2,3,109242,109242,109245,0,3,1
31305,3,3,109245,109245,109248,0,3,0
31306,3,1,109248,109248,109249,0,1,0
31307,4,1,109252,109252,109253,0,1,3
31308,4,1,109256,109256,109257,0,1,3
31309,2,2,109258,109258,109260,0,2,1
31310,4,2,109262,109262,109264,0,2,2
31311,3,2,109265,109265,109267,0,2,1
31312,6,3,109271,109271,109274,0,3,4
31313,3,1,109274,109274,109275,0,1,0
31314,2,3,109276,109276,109279,0,3,1
31315,4,2,109280,109280,109282,0,2,1
31316,6,2,109286,109286,109288,0,2,4
31317,4,3,109290,109290,109293,0,3,2
31318,3,2,109293,109293,109295,0,2,0
31319,1,3,109294,109295,109298,1,4,0
31320,5,3,109299,109299,109302,0,3,1
31321,3,2,109302,109302,109304,0,2,0
31322,1,1,109303,109304,109305,1,2,0
31323,6,3,109309,109309,109312,0,3,4
31324,6,1,109315,109315,109316,0,1,3
31325,4,3,109319,109319,109322,0,3,3
31326,2,2,109321,109322,109324,1,3,0
31327,6,2,109327,109327,109329,0,2,3
31328,5,3,109332,109332,109335,0,3,3
31329,5,2,109337,109337,109339,0,2,2
31330,2,1,109339,109339,109340,0,1,0
31331,5,3,109344,109344,109347,0,3,4
31332,3,2,109347,109347,109349,0,2,0
31333,1,2,109348,109349,109351,1,3,0
31334,6,1,109354,109354,109355,0,1,3
31335,2,3,109356,109356,109359,0,3,1
31336,4,3,109360,109360,109363,0,3,1
31337,5,2,109365,109365,109367,0,2,2
31338,6,3,109371,109371,109374,0,3,4
31339,6,3,109377,109377,109380,0,3,3
31340,2,3,109379,109380,109383,1,4,0
31341,5,3,109384,109384,109387,0,3,1
31342,4,2,109388,109388,109390,0,2,1
31343,3,1,109391,109391,109392,0,1,1
31344,4,2,109395,109395,109397,0,2,3
31345,4,1,109399,109399,109400,0,1,2
31346,6,2,109405,109405,109407,0,2,5
31347,6,2,109411,109411,109413,0,2,4
31348,3,2,109414,109414,109416,0,2,1
31349,5,2,109419,109419,109421,0,2,3
31350,1,3,109420,109421,109424,1,4,0
31351,3,3,109423,109424,109427,1,4,0
31352,4,2,109427,109427,109429,0,2,0
31353,4,1,109431,109431,109432,0,1,2
31354,6,3,109437,109437,109440,0,3,5
31355,4,3,109441,109441,109444,0,3,1
31356,2,3,109443,109444,109447,1,4,0
31357,2,1,109445,109447,109448,2,3,0
31358,5,3,109450,109450,109453,0,3,2
31359,6,1,109456,109456,109457,0,1,3
31360,2,2,109458,109458,109460,0,2,1
31361,2,1,109460,109460,109461,0,1,0
31362,1,2,109461,109461,109463,0,2,0
31363,3,3,109464,109464,109467,0,3,1
31364,4,3,109468,109468,109471,0,3,1
31365,4,3,109472,109472,109475,0,3,1
31366,3,3,109475,109475,109478,0,3,0
31367,4,3,109479,109479,109482,0,3,1
31368,6,2,109485,109485,109487,0,2,3
31369,6,3,109491,109491,109494,0,3,4
31370,2,1,109493,109494,109495,1,2,0
31371,6,2,109499,109499,109501,0,2,4
31372,5,3,109504,109504,109507,0,3,3
31373,2,1,109506,109507,109508,1,2,0
31374,1,3,109507,109508,109511,1,4,0
31375,2,1,109509,109511,109512,2,3,0
31376,3,3,109512,109512,109515,0,3,0
31377,5,2,109517,109517,109519,0,2,2
31378,3,1,109520,109520,109521,0,1,1
31379,5,2,109525,109525,109527,0,2,4
31380,5,2,109530,109530,109532,0,2,3
31381,5,2,109535,109535,109537,0,2,3
31382,1,3,109536,109537,109540,1,4,0
31383,2,2,109538,109540,109542,2,4,0
31384,1,1,109539,109542,109543,3,4,0
31385,2,3,109541,109543,109546,2,5,0
31386,1,1,109542,109546,109547,4,5,0
31387,3,2,109545,109547,109549,2,4,0
31388,5,1,109550,109550,109551,0,1,1
31389,1,1,109551,109551,109552,0,1,0
31390,4,3,109555,109555,109558,0,3,3
31391,1,2,109556,109558,109560,2,4,0
31392,4,2,109560,109560,109562,0,2,0
31393,5,1,109565,109565,109566,0,1,3
31394,4,3,109569,109569,109572,0,3,3
31395,2,1,109571,109572,109573,1,2,0
31396,6,3,109577,109577,109580,0,3,4
31397,5,3,109582,109582,109585,0,3,2
31398,6,1,109588,109588,109589,0,1,3
31399,6,3,109594,109594,109597,0,3,5
31400,3,3,109597,109597,109600,0,3,0
31401,2,1,109599,109600,109601,1,2,0
31402,3,2,109602,109602,109604,0,2,1
31403,5,2,109607,109607,109609,0,2,3
31404,5,2,109612,109612,109614,0,2,3
31405,5,1,109617,109617,109618,0,1,3
31406,6,3,109623,109623,109626,0,3,5
31407,3,3,109626,109626,109629,0,3,0
31408,2,3,109628,109629,109632,1,4,0
31409,4,2,109632,109632,109634,0,2,0
31410,5,2,109637,109637,109639,0,2,3
31411,3,1,109640,109640,109641,0,1,1
31412,1,3,109641,109641,109644,0,3,0
31413,3,3,109644,109644,109647,0,3,0
31414,1,1,109645,109647,109648,2,3,0
31415,5,2,109650,109650,109652,0,2,2
31416,2,3,109652,109652,109655,0,3,0
31417,3,1,109655,109655,109656,0,1,0
31418,3,3,109658,109658,109661,0,3,2
31419,3,2,109661,109661,109663,0,2,0
31420,6,1,109667,109667,109668,0,1,4
31421,2,2,109669,109669,109671,0,2,1
31422,2,2,109671,109671,109673,0,2,0
31423,3,1,109674,109674,109675,0,1,1
31424,4,1,109678,109678,109679,0,1,3
31425,5,3,109683,109683,109686,0,3,4
31426,4,1,109687,109687,109688,0,1,1
31427,1,3,109688,109688,109691,0,3,0
31428,3,2,109691,109691,109693,0,2,0
31429,5,2,109696,109696,109698,0,2,3
31430,2,3,109698,109698,109701,0,3,0
31431,6,2,109704,109704,109706,0,2,3
31432,5,3,109709,109709,109712,0,3,3
31433,2,2,109711,109712,109714,1,3,0
31434,5,1,109716,109716,109717,0,1,2
31435,2,1,109718,109718,109719,0,1,1
31436,5,1,109723,109723,109724,0,1,4
31437,1,3,109724,109724,109727,0,3,0
31438,4,3,109728,109728,109731,0,3,1
31439,4,2,109732,109732,109734,0,2,1
31440,3,3,109735,109735,109738,0,3,1
31441,5,2,109740,109740,109742,0,2,2
31442,2,1,109742,109742,109743,0,1,0
31443,2,3,109744,109744,109747,0,3,1
31444,3,1,109747,109747,109748,0,1,0
31445,2,3,109749,109749,109752,0,3,1
31446,6,1,109755,109755,109756,0,1,3
31447,4,2,109759,109759,109761,0,2,3
31448,2,3,109761,109761,109764,0,3,0
31449,5,2,109766,109766,109768,0,2,2
31450,4,2,109770,109770,109772,0,2,2
31451,6,1,109776,109776,109777,0,1,4
31452,5,3,109781,109781,109784,0,3,4
31453,6,1,109787,109787,109788,0,1,3
31454,6,1,109793,109793,109794,0,1,5
31455,4,3,109797,109797,109800,0,3,3
31456,3,1,109800,109800,109801,0,1,0
31457,1,2,109801,109801,109803,0,2,0
31458,6,3,109807,109807,109810,0,3,4
31459,4,1,109811,109811,109812,0,1,1
31460,4,2,109815,109815,109817,0,2,3
31461,4,2,109819,109819,109821,0,2,2
31462,4,2,109823,109823,109825,0,2,2
31463,6,1,109829,109829,109830,0,1,4
31464,3,3,109832,109832,109835,0,3,2
31465,1,3,109833,109835,109838,2,5,0
31466,3,3,109836,109838,109841,2,5,0
31467,3,2,109839,109841,109843,2,4,0
31468,4,3,109843,109843,109846,0,3,0
31469,4,1,109847,109847,109848,0,1,1
31470,5,1,109852,109852,109853,0,1,4
31471,3,1,109855,109855,109856,0,1,2
31472,2,2,109857,109857,109859,0,2,1
31473,3,3,109860,109860,109863,0,3,1
31474,5,1,109865,109865,109866,0,1,2
31475,1,2,109866,109866,109868,0,2,0
31476,1,1,109867,109868,109869,1,2,0
31477,5,3,109872,109872,109875,0,3,3
31478,5,1,109877,109877,109878,0,1,2
31479,3,3,109880,109880,109883,0,3,2
31480,4,3,109884,109884,109887,0,3,1
31481,4,2,109888,109888,109890,0,2,1
31482,5,1,109893,109893,109894,0,1,3
31483,6,3,109899,109899,109902,0,3,5
31484,1,3,109900,109902,109905,2,5,0
31485,6,2,109906,109906,109908,0,2,1
31486,3,3,109909,109909,109912,0,3,1
31487,5,2,109914,109914,109916,0,2,2
31488,5,2,109919,109919,109921,0,2,3
31489,3,1,109922,109922,109923,0,1,1
31490,2,3,109924,109924,109927,0,3,1
31491,4,1,109928,109928,109929,0,1,1
31492,4,3,109932,109932,109935,0,3,3
31493,6,1,109938,109938,109939,0,1,3
31494,2,3,109940,109940,109943,0,3,1
31495,4,2,109944,109944,109946,0,2,1
31496,4,2,109948,109948,109950,0,2,2
31497,4,2,109952,109952,109954,0,2,2
31498,6,1,109958,109958,109959,0,1,4
31499,5,1,109963,109963,109964,0,1,4
31500,1,3,109964,109964,109967,0,3,0
31501,3,1,109967,109967,109968,0,1,0
31502,4,2,109971,109971,109973,0,2,3
31503,5,2,109976,109976,109978,0,2,3
31504,3,2,109979,109979,109981,0,2,1
31505,5,1,109984,109984,109985,0,1,3
31506,6,1,109990,109990,109991,0,1,5
31507,4,1,109994,109994,109995,0,1,3
31508,6,2,110000,110000,110002,0,2,5
31509,4,3,110004,110004,110007,0,3,2
31510,1,2,110005,110007,110009,2,4,0
31511,2,3,110007,110009,110012,2,5,0
31512,1,1,110008,110012,110013,4,5,0
31513,4,1,110012,110013,110014,1,2,0
31514,2,1,110014,110014,110015,0,1,0
31515,6,3,110020,110020,110023,0,3,5
31516,6,3,110026,110026,110029,0,3,3
31517,2,3,110028,110029,110032,1,4,0
31518,6,1,110034,110034,110035,0,1,2
31519,3,2,110037,110037,110039,0,2,2
31520,3,1,110040,110040,110041,0,1,1
31521,5,3,110045,110045,110048,0,3,4
31522,3,2,110048,110048,110050,0,2,0
31523,5,1,110053,110053,110054,0,1,3
31524,4,3,110057,110057,110060,0,3,3
31525,2,2,110059,110060,110062,1,3,0
31526,2,3,110061,110062,110065,1,4,0
31527,1,2,110062,110065,110067,3,5,0
31528,2,1,110064,110067,110068,3,4,0
31529,1,2,110065,110068,110070,3,5,0
31530,6,1,110071,110071,110072,0,1,1
31531,6,1,110077,110077,110078,0,1,5
31532,6,2,110083,110083,110085,0,2,5
31533,1,2,110084,110085,110087,1,3,0
31534,4,1,110088,110088,110089,0,1,1
31535,2,2,110090,110090,110092,0,2,1
31536,4,3,110094,110094,110097,0,3,2
31537,2,3,110096,110097,110100,1,4,0
31538,3,3,110099,110100,110103,1,4,0
31539,5,1,110104,110104,110105,0,1,1
31540,3,2,110107,110107,110109,0,2,2
31541,5,3,110112,110112,110115,0,3,3
31542,1,3,110113,110115,110118,2,5,0
31543,3,1,110116,110118,110119,2,3,0
31544,4,2,110120,110120,110122,0,2,1
31545,2,2,110122,110122,110124,0,2,0
31546,1,3,110123,110124,110127,1,4,0
31547,5,2,110128,110128,110130,0,2,1
31548,2,3,110130,110130,110133,0,3,0
31549,3,3,110133,110133,110136,0,3,0
31550,1,1,110134,110136,110137,2,3,0
31551,6,3,110140,110140,110143,0,3,3
31552,2,2,110142,110143,110145,1,3,0
31553,5,1,110147,110147,110148,0,1,2
31554,3,3,110150,110150,110153,0,3,2
31555,3,3,110153,110153,110156,0,3,0
31556,1,2,110154,110156,110158,2,4,0
31557,1,3,110155,110158,110161,3,6,0
31558,5,3,110160,110161,110164,1,4,0
31559,3,2,110163,110164,110166,1,3,0
31560,1,3,110164,110166,110169,2,5,0
31561,5,3,110169,110169,110172,0,3,0
31562,6,1,110175,110175,110176,0,1,3
31563,6,2,110181,110181,110183,0,2,5
31564,3,2,110184,110184,110186,0,2,1
31565,2,2,110186,110186,110188,0,2,0
31566,1,3,110187,110188,110191,1,4,0
31567,3,1,110190,110191,110192,1,2,0
31568,1,1,110191,110192,110193,1,2,0
31569,3,2,110194,110194,110196,0,2,1
31570,2,1,110196,110196,110197,0,1,0
31571,3,1,110199,110199,110200,0,1,2
31572,5,1,110204,110204,110205,0,1,4
31573,1,3,110205,110205,110208,0,3,0
31574,5,3,110210,110210,110213,0,3,2
31575,3,2,110213,110213,110215,0,2,0
31576,5,1,110218,110218,110219,0,1,3
31577,3,2,110221,110221,110223,0,2,2
31578,6,3,110227,110227,110230,0,3,4
31579,3,3,110230,110230,110233,0,3,0
31580,6,1,110236,110236,110237,0,1,3
31581,1,3,110237,110237,110240,0,3,0
31582,2,2,110239,110240,110242,1,3,0
31583,1,3,110240,110242,110245,2,5,0
31584,1,2,110241,110245,110247,4,6,0
31585,1,3,110242,110247,110250,5,8,0
31586,6,1,110248,110250,110251,2,3,0
31587,2,2,110250,110251,110253,1,3,0
31588,1,1,110251,110253,110254,2,3,0
31589,2,2,110253,110254,110256,1,3,0
31590,1,1,110254,110256,110257,2,3,0
31591,6,3,110260,110260,110263,0,3,3
31592,5,3,110265,110265,110268,0,3,2
31593,1,3,110266,110268,110271,2,5,0
31594,4,1,110270,110271,110272,1,2,0
31595,4,1,110274,110274,110275,0,1,2
31596,6,2,110280,110280,110282,0,2,5
31597,2,2,110282,110282,110284,0,2,0
31598,6,2,110288,110288,110290,0,2,4
31599,1,3,110289,110290,110293,1,4,0
31600,5,3,110294,110294,110297,0,3,1
31601,4,2,110298,110298,110300,0,2,1
31602,2,2,110300,110300,110302,0,2,0
31603,4,2,110304,110304,110306,0,2,2
31604,6,1,110310,110310,110311,0,1,4
31605,1,2,110311,110311,110313,0,2,0
31606,3,3,110314,110314,110317,0,3,1
31607,1,2,110315,110317,110319,2,4,0
31608,6,2,110321,110321,110323,0,2,2
31609,6,3,110327,110327,110330,0,3,4
31610,1,1,110328,110330,110331,2,3,0
31611,2,2,110330,110331,110333,1,3,0
31612,4,2,110334,110334,110336,0,2,1
31613,2,3,110336,110336,110339,0,3,0
31614,1,1,110337,110339,110340,2,3,0
31615,5,1,110342,110342,110343,0,1,2
31616,1,3,110343,110343,110346,0,3,0
31617,3,3,110346,110346,110349,0,3,0
31618,1,3,110347,110349,110352,2,5,0
31619,6,3,110353,110353,110356,0,3,1
31620,2,3,110355,110356,110359,1,4,0
31621,4,2,110359,110359,110361,0,2,0
31622,3,2,110362,110362,110364,0,2,1
31623,1,2,110363,110364,110366,1,3,0
31624,4,3,110367,110367,110370,0,3,1
31625,2,3,110369,110370,110373,1,4,0
31626,4,1,110373,110373,110374,0,1,0
31627,6,3,110379,110379,110382,0,3,5
31628,5,2,110384,110384,110386,0,2,2
31629,3,1,110387,110387,110388,0,1,1
31630,4,1,110391,110391,110392,0,1,3
31631,1,2,110392,110392,110394,0,2,0
31632,4,3,110396,110396,110399,0,3,2
31633,3,2,110399,110399,110401,0,2,0
31634,6,3,110405,110405,110408,0,3,4
31635,5,2,110410,110410,110412,0,2,2
31636,5,1,110415,110415,110416,0,1,3
31637,5,3,110420,110420,110423,0,3,4
31638,3,3,110423,110423,110426,0,3,0
31639,4,3,110427,110427,110430,0,3,1
31640,4,3,110431,110431,110434,0,3,1
31641,2,2,110433,110434,110436,1,3,0
31642,2,1,110435,110436,110437,1,2,0
31643,1,1,110436,110437,110438,1,2,0
31644,6,3,110442,110442,110445,0,3,4
31645,1,2,110443,110445,110447,2,4,0
31646,6,2,110449,110449,110451,0,2,2
31647,2,1,110451,110451,110452,0,1,0
31648,3,3,110454,110454,110457,0,3,2
31649,6,3,110460,110460,110463,0,3,3
31650,6,3,110466,110466,110469,0,3,3
31651,6,1,110472,110472,110473,0,1,3
31652,4,1,110476,110476,110477,0,1,3
31653,6,3,110482,110482,110485,0,3,5
31654,4,3,110486,110486,110489,0,3,1
31655,4,2,110490,110490,110492,0,2,1
31656,4,2,110494,110494,110496,0,2,2
31657,6,1,110500,110500,110501,0,1,4
31658,3,3,110503,110503,110506,0,3,2
31659,2,1,110505,110506,110507,1,2,0
31660,2,3,110507,110507,110510,0,3,0
31661,2,1,110509,110510,110511,1,2,0
31662,5,3,110514,110514,110517,0,3,3
31663,1,3,110515,110517,110520,2,5,0
31664,6,2,110521,110521,110523,0,2,1
31665,2,3,110523,110523,110526,0,3,0
31666,4,1,110527,110527,110528,0,1,1
31667,5,3,110532,110532,110535,0,3,4
31668,1,3,110533,110535,110538,2,5,0
31669,5,3,110538,110538,110541,0,3,0
31670,2,1,110540,110541,110542,1,2,0
31671,1,3,110541,110542,110545,1,4,0
31672,1,1,110542,110545,110546,3,4,0
31673,6,1,110548,110548,110549,0,1,2
31674,4,2,110552,110552,110554,0,2,3
31675,1,1,110553,110554,110555,1,2,0
31676,1,3,110554,110555,110558,1,4,0
31677,3,1,110557,110558,110559,1,2,0
31678,1,2,110558,110559,110561,1,3,0
31679,2,1,110560,110561,110562,1,2,0
31680,4,1,110564,110564,110565,0,1,2
31681,4,3,110568,110568,110571,0,3,3
31682,3,2,110571,110571,110573,0,2,0
31683,3,1,110574,110574,110575,0,1,1
31684,3,3,110577,110577,110580,0,3,2
31685,4,2,110581,110581,110583,0,2,1
31686,5,3,110586,110586,110589,0,3,3
31687,6,3,110592,110592,110595,0,3,3
31688,4,2,110596,110596,110598,0,2,1
31689,2,3,110598,110598,110601,0,3,0
31690,2,1,110600,110601,110602,1,2,0
31691,2,1,110602,110602,110603,0,1,0
31692,2,2,110604,110604,110606,0,2,1
31693,6,1,110610,110610,110611,0,1,4
31694,6,1,110616,110616,110617,0,1,5
31695,3,3,110619,110619,110622,0,3,2
31696,1,3,110620,110622,110625,2,5,0
31697,2,3,110622,110625,110628,3,6,0
31698,5,3,110627,110628,110631,1,4,0
31699,5,2,110632,110632,110634,0,2,1
31700,1,3,110633,110634,110637,1,4,0
31701,3,2,110636,110637,110639,1,3,0
31702,2,2,110638,110639,110641,1,3,0
31703,5,3,110643,110643,110646,0,3,2
31704,4,1,110647,110647,110648,0,1,1
31705,6,3,110653,110653,110656,0,3,5
31706,5,1,110658,110658,110659,0,1,2
31707,6,3,110664,110664,110667,0,3,5
31708,1,3,110665,110667,110670,2,5,0
31709,5,1,110670,110670,110671,0,1,0
31710,6,1,110676,110676,110677,0,1,5
31711,5,1,110681,110681,110682,0,1,4
31712,4,2,110685,110685,110687,0,2,3
31713,3,3,110688,110688,110691,0,3,1
31714,3,1,110691,110691,110692,0,1,0
31715,1,1,110692,110692,110693,0,1,0
31716,5,1,110697,110697,110698,0,1,4
31717,4,3,110701,110701,110704,0,3,3
31718,6,2,110707,110707,110709,0,2,3
31719,3,2,110710,110710,110712,0,2,1
31720,1,3,110711,110712,110715,1,4,0
31721,2,2,110713,110715,110717,2,4,0
31722,5,2,110718,110718,110720,0,2,1
31723,2,1,110720,110720,110721,0,1,0
31724,3,3,110723,110723,110726,0,3,2
31725,5,3,110728,110728,110731,0,3,2
31726,2,1,110730,110731,110732,1,2,0
31727,5,3,110735,110735,110738,0,3,3
31728,6,1,110741,110741,110742,0,1,3
31729,6,3,110747,110747,110750,0,3,5
31730,4,1,110751,110751,110752,0,1,1
31731,5,2,110756,110756,110758,0,2,4
31732,3,2,110759,110759,110761,0,2,1
31733,1,1,110760,110761,110762,1,2,0
31734,1,3,110761,110762,110765,1,4,0
31735,2,2,110763,110765,110767,2,4,0
31736,5,1,110768,110768,110769,0,1,1
31737,6,1,110774,110774,110775,0,1,5
31738,6,1,110780,110780,110781,0,1,5
31739,1,1,110781,110781,110782,0,1,0
31740,6,1,110787,110787,110788,0,1,5
31741,2,1,110789,110789,110790,0,1,1
31742,3,2,110792,110792,110794,0,2,2
31743,4,2,110796,110796,110798,0,2,2
31744,6,3,110802,110802,110805,0,3,4
31745,1,2,110803,110805,110807,2,4,0
31746,3,2,110806,110807,110809,1,3,0
31747,3,1,110809,110809,110810,0,1,0
31748,2,2,110811,110811,110813,0,2,1
31749,4,3,110815,110815,110818,0,3,2
31750,4,3,110819,110819,110822,0,3,1
31751,3,3,110822,110822,110825,0,3,0
31752,3,1,110825,110825,110826,0,1,0
31753,2,2,110827,110827,110829,0,2,1
31754,4,2,110831,110831,110833,0,2,2
31755,1,3,110832,110833,110836,1,4,0
31756,5,3,110837,110837,110840,0,3,1
31757,5,3,110842,110842,110845,0,3,2
31758,1,1,110843,110845,110846,2,3,0
31759,2,1,110845,110846,110847,1,2,0
31760,1,2,110846,110847,110849,1,3,0
31761,6,1,110852,110852,110853,0,1,3
31762,1,2,110853,110853,110855,0,2,0
31763,1,2,110854,110855,110857,1,3,0
31764,5,2,110859,110859,110861,0,2,2
31765,1,2,110860,110861,110863,1,3,0
31766,2,1,110862,110863,110864,1,2,0
31767,4,1,110866,110866,110867,0,1,2
31768,4,2,110870,110870,110872,0,2,3
31769,3,1,110873,110873,110874,0,1,1
31770,1,3,110874,110874,110877,0,3,0
31771,4,3,110878,110878,110881,0,3,1
31772,5,1,110883,110883,110884,0,1,2
31773,3,2,110886,110886,110888,0,2,2
31774,4,2,110890,110890,110892,0,2,2
31775,5,3,110895,110895,110898,0,3,3
31776,1,2,110896,110898,110900,2,4,0
31777,2,1,110898,110900,110901,2,3,0
31778,5,3,110903,110903,110906,0,3,2
31779,4,2,110907,110907,110909,0,2,1
31780,5,1,110912,110912,110913,0,1,3
31781,3,3,110915,110915,110918,0,3,2
31782,6,2,110921,110921,110923,0,2,3
31783,4,1,110925,110925,110926,0,1,2
31784,3,1,110928,110928,110929,0,1,2
31785,6,3,110934,110934,110937,0,3,5
31786,3,1,110937,110937,110938,0,1,0
31787,4,1,110941,110941,110942,0,1,3
31788,4,1,110945,110945,110946,0,1,3
31789,4,1,110949,110949,110950,0,1,3
31790,2,2,110951,110951,110953,0,2,1
31791,1,2,110952,110953,110955,1,3,0
31792,4,3,110956,110956,110959,0,3,1
31793,6,2,110962,110962,110964,0,2,3
31794,3,1,110965,110965,110966,0,1,1
31795,4,1,110969,110969,110970,0,1,3
31796,5,3,110974,110974,110977,0,3,4
31797,2,3,110976,110977,110980,1,4,0
31798,3,3,110979,110980,110983,1,4,0
31799,1,2,110980,110983,110985,3,5,0
31800,1,3,110981,110985,110988,4,7,0
31801,3,1,110984,110988,110989,4,5,0
31802,3,3,110987,110989,110992,2,5,0
31803,5,1,110992,110992,110993,0,1,0
31804,4,1,110996,110996,110997,0,1,3
31805,1,1,110997,110997,110998,0,1,0
31806,1,3,110998,110998,111001,0,3,0
31807,4,3,111002,111002,111005,0,3,1
31808,1,3,111003,111005,111008,2,5,0
31809,5,2,111008,111008,111010,0,2,0
31810,6,1,111014,111014,111015,0,1,4
31811,6,3,111020,111020,111023,0,3,5
31812,2,1,111022,111023,111024,1,2,0
31813,2,3,111024,111024,111027,0,3,0
31814,3,2,111027,111027,111029,0,2,0
31815,3,1,111030,111030,111031,0,1,1
31816,3,1,111033,111033,111034,0,1,2
31817,3,3,111036,111036,111039,0,3,2
31818,6,2,111042,111042,111044,0,2,3
31819,3,1,111045,111045,111046,0,1,1
31820,6,2,111051,111051,111053,0,2,5
31821,4,3,111055,111055,111058,0,3,2
31822,2,3,111057,111058,111061,1,4,0
31823,4,2,111061,111061,111063,0,2,0
31824,2,1,111063,111063,111064,0,1,0
31825,5,2,111068,111068,111070,0,2,4
31826,2,1,111070,111070,111071,0,1,0
31827,5,2,111075,111075,111077,0,2,4
31828,2,1,111077,111077,111078,0,1,0
31829,4,3,111081,111081,111084,0,3,3
31830,4,1,111085,111085,111086,0,1,1
31831,4,3,111089,111089,111092,0,3,3
31832,5,3,111094,111094,111097,0,3,2
31833,5,1,111099,111099,111100,0,1,2
31834,1,2,111100,111100,111102,0,2,0
31835,3,2,111103,111103,111105,0,2,1
31836,6,1,111109,111109,111110,0,1,4
31837,2,1,111111,111111,111112,0,1,1
31838,4,1,111115,111115,111116,0,1,3
31839,3,2,111118,111118,111120,0,2,2
31840,5,2,111123,111123,111125,0,2,3
31841,5,1,111128,111128,111129,0,1,3
31842,5,3,111133,111133,111136,0,3,4
31843,2,1,111135,111136,111137,1,2,0
31844,1,3,111136,111137,111140,1,4,0
31845,5,1,111141,111141,111142,0,1,1
31846,6,2,111147,111147,111149,0,2,5
31847,4,1,111151,111151,111152,0,1,2
31848,6,1,111157,111157,111158,0,1,5
31849,5,3,111162,111162,111165,0,3,4
31850,5,3,111167,111167,111170,0,3,2
31851,6,3,111173,111173,111176,0,3,3
31852,3,2,111176,111176,111178,0,2,0
31853,3,3,111179,111179,111182,0,3,1
31854,3,3,111182,111182,111185,0,3,0
31855,3,3,111185,111185,111188,0,3,0
31856,2,3,111187,111188,111191,1,4,0
31857,5,2,111192,111192,111194,0,2,1
31858,1,3,111193,111194,111197,1,4,0
31859,2,1,111195,111197,111198,2,3,0
31860,5,3,111200,111200,111203,0,3,2
31861,6,1,111206,111206,111207,0,1,3
31862,3,1,111209,111209,111210,0,1,2
31863,1,1,111210,111210,111211,0,1,0
31864,2,1,111212,111212,111213,0,1,1
31865,5,3,111217,111217,111220,0,3,4
31866,2,2,111219,111220,111222,1,3,0
31867,3,1,111222,111222,111223,0,1,0
31868,5,1,111227,111227,111228,0,1,4
31869,5,3,111232,111232,111235,0,3,4
31870,2,1,111234,111235,111236,1,2,0
31871,5,3,111239,111239,111242,0,3,3
31872,4,3,111243,111243,111246,0,3,1
31873,4,1,111247,111247,111248,0,1,1
31874,1,2,111248,111248,111250,0,2,0
31875,6,2,111254,111254,111256,0,2,4
31876,5,2,111259,111259,111261,0,2,3
31877,5,2,111264,111264,111266,0,2,3
31878,4,3,111268,111268,111271,0,3,2
31879,1,2,111269,111271,111273,2,4,0
31880,3,3,111272,111273,111276,1,4,0
31881,1,2,111273,111276,111278,3,5,0
31882,5,3,111278,111278,111281,0,3,0
31883,6,2,111284,111284,111286,0,2,3
31884,2,2,111286,111286,111288,0,2,0
31885,3,3,111289,111289,111292,0,3,1
31886,2,3,111291,111292,111295,1,4,0
31887,6,1,111297,111297,111298,0,1,2
31888,3,1,111300,111300,111301,0,1,2
31889,2,1,111302,111302,111303,0,1,1
31890,1,2,111303,111303,111305,0,2,0
31891,6,1,111309,111309,111310,0,1,4
31892,5,1,111314,111314,111315,0,1,4
31893,2,2,111316,111316,111318,0,2,1
31894,1,3,111317,111318,111321,1,4,0
31895,2,1,111319,111321,111322,2,3,0
31896,6,1,111325,111325,111326,0,1,3
31897,4,3,111329,111329,111332,0,3,3
31898,4,2,111333,111333,111335,0,2,1
31899,6,3,111339,111339,111342,0,3,4
31900,1,3,111340,111342,111345,2,5,0
31901,2,2,111342,111345,111347,3,5,0
31902,3,1,111345,111347,111348,2,3,0
31903,6,3,111351,111351,111354,0,3,3
31904,1,2,111352,111354,111356,2,4,0
31905,6,3,111358,111358,111361,0,3,2
31906,5,1,111363,111363,111364,0,1,2
31907,4,1,111367,111367,111368,0,1,3
31908,1,3,111368,111368,111371,0,3,0
31909,6,1,111374,111374,111375,0,1,3
31910,6,3,111380,111380,111383,0,3,5
31911,6,3,111386,111386,111389,0,3,3
31912,3,1,111389,111389,111390,0,1,0
31913,4,2,111393,111393,111395,0,2,3
31914,5,3,111398,111398,111401,0,3,3
31915,2,3,111400,111401,111404,1,4,0
31916,1,1,111401,111404,111405,3,4,0
31917,6,2,111407,111407,111409,0,2,2
31918,5,1,111412,111412,111413,0,1,3
31919,2,1,111414,111414,111415,0,1,1
31920,1,1,111415,111415,111416,0,1,0
31921,5,1,111420,111420,111421,0,1,4
31922,4,1,111424,111424,111425,0,1,3
31923,5,1,111429,111429,111430,0,1,4
31924,1,2,111430,111430,111432,0,2,0
31925,3,1,111433,111433,111434,0,1,1
31926,2,2,111435,111435,111437,0,2,1
31927,3,2,111438,111438,111440,0,2,1
31928,4,1,111442,111442,111443,0,1,2
31929,6,3,111448,111448,111451,0,3,5
31930,5,1,111453,111453,111454,0,1,2
31931,2,3,111455,111455,111458,0,3,1
31932,3,1,111458,111458,111459,0,1,0
31933,4,2,111462,111462,111464,0,2,3
31934,5,3,111467,111467,111470,0,3,3
31935,4,1,111471,111471,111472,0,1,1
31936,6,3,111477,111477,111480,0,3,5
31937,6,3,111483,111483,111486,0,3,3
31938,3,2,111486,111486,111488,0,2,0
31939,3,3,111489,111489,111492,0,3,1
31940,2,3,111491,111492,111495,1,4,0
31941,1,2,111492,111495,111497,3,5,0
31942,5,1,111497,111497,111498,0,1,0
31943,5,1,111502,111502,111503,0,1,4
31944,2,1,111504,111504,111505,0,1,1
31945,2,1,111506,111506,111507,0,1,1
31946,2,2,111508,111508,111510,0,2,1
31947,1,2,111509,111510,111512,1,3,0
31948,4,3,111513,111513,111516,0,3,1
31949,3,3,111516,111516,111519,0,3,0
31950,5,3,111521,111521,111524,0,3,2
31951,3,2,111524,111524,111526,0,2,0
31952,2,2,111526,111526,111528,0,2,0
31953,5,2,111531,111531,111533,0,2,3
31954,6,2,111537,111537,111539,0,2,4
31955,3,1,111540,111540,111541,0,1,1
31956,4,3,111544,111544,111547,0,3,3
31957,5,2,111549,111549,111551,0,2,2
31958,6,3,111555,111555,111558,0,3,4
31959,5,3,111560,111560,111563,0,3,2
31960,3,2,111563,111563,111565,0,2,0
31961,2,3,111565,111565,111568,0,3,0
31962,6,3,111571,111571,111574,0,3,3
31963,2,3,111573,111574,111577,1,4,0
31964,6,2,111579,111579,111581,0,2,2
31965,6,2,111585,111585,111587,0,2,4
31966,4,2,111589,111589,111591,0,2,2
31967,1,2,111590,111591,111593,1,3,0
31968,4,2,111594,111594,111596,0,2,1
31969,5,2,111599,111599,111601,0,2,3
31970,5,2,111604,111604,111606,0,2,3
31971,1,2,111605,111606,111608,1,3,0
31972,5,3,111610,111610,111613,0,3,2
31973,6,2,111616,111616,111618,0,2,3
31974,6,2,111622,111622,111624,0,2,4
31975,4,1,111626,111626,111627,0,1,2
31976,3,2,111629,111629,111631,0,2,2
31977,4,2,111633,111633,111635,0,2,2
31978,5,1,111638,111638,111639,0,1,3
31979,5,3,111643,111643,111646,0,3,4
31980,2,1,111645,111646,111647,1,2,0
31981,1,3,111646,111647,111650,1,4,0
31982,5,3,111651,111651,111654,0,3,1
31983,6,1,111657,111657,111658,0,1,3
31984,2,2,111659,111659,111661,0,2,1
31985,5,3,111664,111664,111667,0,3,3
31986,1,2,111665,111667,111669,2,4,0
31987,4,2,111669,111669,111671,0,2,0
31988,3,3,111672,111672,111675,0,3,1
31989,5,3,111677,111677,111680,0,3,2
31990,5,3,111682,111682,111685,0,3,2
31991,3,1,111685,111685,111686,0,1,0
31992,2,1,111687,111687,111688,0,1,1
31993,5,2,111692,111692,111694,0,2,4
31994,6,2,111698,111698,111700,0,2,4
31995,2,3,111700,111700,111703,0,3,0
31996,3,1,111703,111703,111704,0,1,0
31997,2,3,111705,111705,111708,0,3,1
31998,1,2,111706,111708,111710,2,4,0
31999,1,2,111707,111710,111712,3,5,0
32000,5,2,111712,111712,111714,0,2,0
32001,2,3,111714,111714,111717,0,3,0
32002,5,2,111719,111719,111721,0,2,2
32003,1,2,111720,111721,111723,1,3,0
32004,5,2,111725,111725,111727,0,2,2
32005,4,1,111729,111729,111730,0,1,2
32006,2,2,111731,111731,111733,0,2,1
32007,3,1,111734,111734,111735,0,1,1
32008,1,1,111735,111735,111736,0,1,0
32009,6,1,111741,111741,111742,0,1,5
32010,1,2,111742,111742,111744,0,2,0
32011,4,3,111746,111746,111749,0,3,2
32012,5,1,111751,111751,111752,0,1,2
32013,6,1,111757,111757,111758,0,1,5
32014,4,1,111761,111761,111762,0,1,3
32015,4,1,111765,111765,111766,0,1,3
32016,4,2,111769,111769,111771,0,2,3
32017,1,3,111770,111771,111774,1,4,0
32018,6,3,111776,111776,111779,0,3,2
32019,1,2,111777,111779,111781,2,4,0
32020,4,2,111781,111781,111783,0,2,0
32021,3,1,111784,111784,111785,0,1,1
32022,4,3,111788,111788,111791,0,3,3
32023,1,1,111789,111791,111792,2,3,0
32024,4,3,111793,111793,111796,0,3,1
32025,2,1,111795,111796,111797,1,2,0
32026,2,1,111797,111797,111798,0,1,0
32027,1,2,111798,111798,111800,0,2,0
32028,1,2,111799,111800,111802,1,3,0
32029,4,3,111803,111803,111806,0,3,1
32030,2,2,111805,111806,111808,1,3,0
32031,6,1,111811,111811,111812,0,1,3
32032,5,3,111816,111816,111819,0,3,4
32033,1,3,111817,111819,111822,2,5,0
32034,1,3,111818,111822,111825,4,7,0
32035,2,3,111820,111825,111828,5,8,0
32036,5,3,111825,111828,111831,3,6,0
32037,1,1,111826,111831,111832,5,6,0
32038,3,1,111829,111832,111833,3,4,0
32039,2,1,111831,111833,111834,2,3,0
32040,5,3,111836,111836,111839,0,3,2
32041,5,3,111841,111841,111844,0,3,2
32042,2,3,111843,111844,111847,1,4,0
32043,3,1,111846,111847,111848,1,2,0
32044,4,2,111850,111850,111852,0,2,2
32045,5,3,111855,111855,111858,0,3,3
32046,4,3,111859,111859,111862,0,3,1
32047,5,2,111864,111864,111866,0,2,2
32048,5,1,111869,111869,111870,0,1,3
32049,3,1,111872,111872,111873,0,1,2
32050,1,1,111873,111873,111874,0,1,0
32051,6,3,111879,111879,111882,0,3,5
32052,1,3,111880,111882,111885,2,5,0
32053,1,2,111881,111885,111887,4,6,0
32054,3,2,111884,111887,111889,3,5,0
32055,4,3,111888,111889,111892,1,4,0
32056,6,3,111894,111894,111897,0,3,2
32057,5,1,111899,111899,111900,0,1,2
32058,4,2,111903,111903,111905,0,2,3
32059,6,3,111909,111909,111912,0,3,4
32060,2,2,111911,111912,111914,1,3,0
32061,2,2,111913,111914,111916,1,3,0
32062,5,3,111918,111918,111921,0,3,2
32063,3,3,111921,111921,111924,0,3,0
32064,6,1,111927,111927,111928,0,1,3
32065,4,3,111931,111931,111934,0,3,3
32066,2,3,111933,111934,111937,1,4,0
32067,2,2,111935,111937,111939,2,4,0
32068,6,2,111941,111941,111943,0,2,2
32069,3,2,111944,111944,111946,0,2,1
32070,3,2,111947,111947,111949,0,2,1
32071,1,1,111948,111949,111950,1,2,0
32072,2,1,111950,111950,111951,0,1,0
32073,6,1,111956,111956,111957,0,1,5
32074,2,2,111958,111958,111960,0,2,1
32075,3,3,111961,111961,111964,0,3,1
32076,6,3,111967,111967,111970,0,3,3
32077,6,2,111973,111973,111975,0,2,3
32078,1,2,111974,111975,111977,1,3,0
32079,5,1,111979,111979,111980,0,1,2
32080,1,3,111980,111980,111983,0,3,0
32081,4,1,111984,111984,111985,0,1,1
32082,4,2,111988,111988,111990,0,2,3
32083,1,1,111989,111990,111991,1,2,0
32084,5,2,111994,111994,111996,0,2,3
32085,4,1,111998,111998,111999,0,1,2
32086,6,1,112004,112004,112005,0,1,5
32087,3,1,112007,112007,112008,0,1,2
32088,5,1,112012,112012,112013,0,1,4
32089,1,2,112013,112013,112015,0,2,0
32090,4,2,112017,112017,112019,0,2,2
32091,4,2,112021,112021,112023,0,2,2
32092,6,2,112027,112027,112029,0,2,4
32093,5,1,112032,112032,112033,0,1,3
32094,4,1,112036,112036,112037,0,1,3
32095,1,1,112037,112037,112038,0,1,0
32096,5,2,112042,112042,112044,0,2,4
32097,3,1,112045,112045,112046,0,1,1
32098,1,2,112046,112046,112048,0,2,0
32099,3,3,112049,112049,112052,0,3,1
32100,2,3,112051,112052,112055,1,4,0
32101,3,3,112054,112055,112058,1,4,0
32102,5,2,112059,112059,112061,0,2,1
32103,5,2,112064,112064,112066,0,2,3
32104,1,1,112065,112066,112067,1,2,0
32105,4,1,112069,112069,112070,0,1,2
32106,4,3,112073,112073,112076,0,3,3
32107,1,3,112074,112076,112079,2,5,0
32108,4,2,112078,112079,112081,1,3,0
32109,6,2,112084,112084,112086,0,2,3
32110,3,2,112087,112087,112089,0,2,1
32111,2,1,112089,112089,112090,0,1,0
32112,5,2,112094,112094,112096,0,2,4
32113,3,2,112097,112097,112099,0,2,1
32114,1,3,112098,112099,112102,1,4,0
32115,3,1,112101,112102,112103,1,2,0
32116,4,2,112105,112105,112107,0,2,2
32117,1,1,112106,112107,112108,1,2,0
32118,4,2,112110,112110,112112,0,2,2
32119,6,2,112116,112116,112118,0,2,4
32120,6,3,112122,112122,112125,0,3,4
32121,6,3,112128,112128,112131,0,3,3
32122,1,1,112129,112131,112132,2,3,0
32123,1,1,112130,112132,112133,2,3,0
32124,3,2,112133,112133,112135,0,2,0
32125,3,3,112136,112136,112139,0,3,1
32126,3,3,112139,112139,112142,0,3,0
32127,1,1,112140,112142,112143,2,3,0
32128,3,1,112143,112143,112144,0,1,0
32129,1,3,112144,112144,112147,0,3,0
32130,1,3,112145,112147,112150,2,5,0
32131,6,1,112151,112151,112152,0,1,1
32132,1,1,112152,112152,112153,0,1,0
32133,3,1,112155,112155,112156,0,1,2
32134,2,2,112157,112157,112159,0,2,1
32135,2,3,112159,112159,112162,0,3,0
32136,5,3,112164,112164,112167,0,3,2
32137,4,2,112168,112168,112170,0,2,1
32138,2,1,112170,112170,112171,0,1,0
32139,6,2,112176,112176,112178,0,2,5
32140,4,3,112180,112180,112183,0,3,2
32141,3,3,112183,112183,112186,0,3,0
32142,2,1,112185,112186,112187,1,2,0
32143,6,1,112191,112191,112192,0,1,4
32144,6,2,112197,112197,112199,0,2,5
32145,6,2,112203,112203,112205,0,2,4
32146,3,1,112206,112206,112207,0,1,1
32147,6,3,112212,112212,112215,0,3,5
32148,1,2,112213,112215,112217,2,4,0
32149,5,1,112218,112218,112219,0,1,1
32150,1,2,112219,112219,112221,0,2,0
32151,5,2,112224,112224,112226,0,2,3
32152,1,3,112225,112226,112229,1,4,0
32153,1,3,112226,112229,112232,3,6,0
32154,4,2,112230,112232,112234,2,4,0
32155,3,2,112233,112234,112236,1,3,0
32156,1,3,112234,112236,112239,2,5,0
32157,3,1,112237,112239,112240,2,3,0
32158,5,3,112242,112242,112245,0,3,2
32159,3,2,112245,112245,112247,0,2,0
32160,3,2,112248,112248,112250,0,2,1
32161,5,2,112253,112253,112255,0,2,3
32162,1,2,112254,112255,112257,1,3,0
32163,6,1,112260,112260,112261,0,1,3
32164,3,3,112263,112263,112266,0,3,2
32165,5,3,112268,112268,112271,0,3,2
32166,2,2,112270,112271,112273,1,3,0
32167,6,2,112276,112276,112278,0,2,3
32168,6,2,112282,112282,112284,0,2,4
32169,1,2,112283,112284,112286,1,3,0
32170,1,1,112284,112286,112287,2,3,0
32171,6,3,112290,112290,112293,0,3,3
32172,6,1,112296,112296,112297,0,1,3
32173,3,1,112299,112299,112300,0,1,2
32174,6,1,112305,112305,112306,0,1,5
32175,2,2,112307,112307,112309,0,2,1
32176,6,2,112313,112313,112315,0,2,4
32177,4,1,112317,112317,112318,0,1,2
32178,5,2,112322,112322,112324,0,2,4
32179,2,2,112324,112324,112326,0,2,0
32180,5,3,112329,112329,112332,0,3,3
32181,6,1,112335,112335,112336,0,1,3
32182,2,3,112337,112337,112340,0,3,1
32183,4,2,112341,112341,112343,0,2,1
32184,3,2,112344,112344,112346,0,2,1
32185,6,2,112350,112350,112352,0,2,4
32186,3,1,112353,112353,112354,0,1,1
32187,3,1,112356,112356,112357,0,1,2
32188,5,3,112361,112361,112364,0,3,4
32189,2,1,112363,112364,112365,1,2,0
32190,4,3,112367,112367,112370,0,3,2
32191,3,3,112370,112370,112373,0,3,0
32192,6,1,112376,112376,112377,0,1,3
32193,2,2,112378,112378,112380,0,2,1
32194,3,1,112381,112381,112382,0,1,1
32195,5,2,112386,112386,112388,0,2,4
32196,4,2,112390,112390,112392,0,2,2
32197,2,1,112392,112392,112393,0,1,0
32198,4,3,112396,112396,112399,0,3,3
32199,5,2,112401,112401,112403,0,2,2
32200,4,3,112405,112405,112408,0,3,2
32201,6,2,112411,112411,112413,0,2,3
32202,1,2,112412,112413,112415,1,3,0
32203,4,1,112416,112416,112417,0,1,1
32204,6,3,112422,112422,112425,0,3,5
32205,2,1,112424,112425,112426,1,2,0
32206,3,1,112427,112427,112428,0,1,1
32207,3,3,112430,112430,112433,0,3,2
32208,3,3,112433,112433,112436,0,3,0
32209,4,1,112437,112437,112438,0,1,1
32210,4,3,112441,112441,112444,0,3,3
32211,4,2,112445,112445,112447,0,2,1
32212,3,3,112448,112448,112451,0,3,1
32213,2,1,112450,112451,112452,1,2,0
32214,5,1,112455,112455,112456,0,1,3
32215,2,3,112457,112457,112460,0,3,1
32216,4,3,112461,112461,112464,0,3,1
32217,6,1,112467,112467,112468,0,1,3
32218,5,3,112472,112472,112475,0,3,4
32219,2,1,112474,112475,112476,1,2,0
32220,1,3,112475,112476,112479,1,4,0
32221,5,3,112480,112480,112483,0,3,1
32222,2,2,112482,112483,112485,1,3,0
32223,1,2,112483,112485,112487,2,4,0
32224,5,1,112488,112488,112489,0,1,1
32225,5,2,112493,112493,112495,0,2,4
32226,1,2,112494,112495,112497,1,3,0
32227,6,1,112500,112500,112501,0,1,3
32228,2,3,112502,112502,112505,0,3,1
32229,4,1,112506,112506,112507,0,1,1
32230,5,1,112511,112511,112512,0,1,4
32231,4,3,112515,112515,112518,0,3,3
32232,1,1,112516,112518,112519,2,3,0
32233,2,1,112518,112519,112520,1,2,0
32234,3,3,112521,112521,112524,0,3,1
32235,6,2,112527,112527,112529,0,2,3
32236,1,3,112528,112529,112532,1,4,0
32237,4,1,112532,112532,112533,0,1,0
32238,3,2,112535,112535,112537,0,2,2
32239,2,1,112537,112537,112538,0,1,0
32240,5,3,112542,112542,112545,0,3,4
32241,2,2,112544,112545,112547,1,3,0
32242,5,1,112549,112549,112550,0,1,2
32243,5,2,112554,112554,112556,0,2,4
32244,6,3,112560,112560,112563,0,3,4
32245,1,2,112561,112563,112565,2,4,0
32246,3,2,112564,112565,112567,1,3,0
32247,6,1,112570,112570,112571,0,1,3
32248,6,2,112576,112576,112578,0,2,5
32249,2,3,112578,112578,112581,0,3,0
32250,3,2,112581,112581,112583,0,2,0
32251,4,1,112585,112585,112586,0,1,2
32252,6,1,112591,112591,112592,0,1,5
32253,4,3,112595,112595,112598,0,3,3
32254,3,1,112598,112598,112599,0,1,0
32255,2,2,112600,112600,112602,0,2,1
32256,5,2,112605,112605,112607,0,2,3
32257,5,3,112610,112610,112613,0,3,3
32258,4,3,112614,112614,112617,0,3,1
32259,3,1,112617,112617,112618,0,1,0
32260,1,3,112618,112618,112621,0,3,0
32261,3,3,112621,112621,112624,0,3,0
32262,3,1,112624,112624,112625,0,1,0
32263,2,1,112626,112626,112627,0,1,1
32264,5,2,112631,112631,112633,0,2,4
32265,4,1,112635,112635,112636,0,1,2
32266,6,2,112641,112641,112643,0,2,5
32267,4,2,112645,112645,112647,0,2,2
32268,1,1,112646,112647,112648,1,2,0
32269,4,1,112650,112650,112651,0,1,2
32270,6,3,112656,112656,112659,0,3,5
32271,3,3,112659,112659,112662,0,3,0
32272,5,3,112664,112664,112667,0,3,2
32273,5,1,112669,112669,112670,0,1,2
32274,4,2,112673,112673,112675,0,2,3
32275,4,1,112677,112677,112678,0,1,2
32276,1,3,112678,112678,112681,0,3,0
32277,2,3,112680,112681,112684,1,4,0
32278,5,1,112685,112685,112686,0,1,1
32279,6,3,112691,112691,112694,0,3,5
32280,5,1,112696,112696,112697,0,1,2
32281,2,3,112698,112698,112701,0,3,1
32282,6,1,112704,112704,112705,0,1,3
32283,1,2,112705,112705,112707,0,2,0
32284,3,2,112708,112708,112710,0,2,1
32285,4,3,112712,112712,112715,0,3,2
32286,5,1,112717,112717,112718,0,1,2
32287,4,1,112721,112721,112722,0,1,3
32288,2,2,112723,112723,112725,0,2,1
32289,5,2,112728,112728,112730,0,2,3
32290,6,3,112734,112734,112737,0,3,4
32291,1,3,112735,112737,112740,2,5,0
32292,4,2,112739,112740,112742,1,3,0
32293,2,2,112741,112742,112744,1,3,0
32294,4,1,112745,112745,112746,0,1,1
32295,5,3,112750,112750,112753,0,3,4
32296,6,2,112756,112756,112758,0,2,3
32297,3,3,112759,112759,112762,0,3,1
32298,2,3,112761,112762,112765,1,4,0
32299,4,1,112765,112765,112766,0,1,0
32300,6,2,112771,112771,112773,0,2,5
32301,6,2,112777,112777,112779,0,2,4
32302,3,3,112780,112780,112783,0,3,1
32303,5,1,112785,112785,112786,0,1,2
32304,3,1,112788,112788,112789,0,1,2
32305,4,2,112792,112792,112794,0,2,3
32306,2,3,112794,112794,112797,0,3,0
32307,3,1,112797,112797,112798,0,1,0
32308,5,3,112802,112802,112805,0,3,4
32309,5,1,112807,112807,112808,0,1,2
32310,6,3,112813,112813,112816,0,3,5
32311,3,1,112816,112816,112817,0,1,0
32312,5,3,112821,112821,112824,0,3,4
32313,1,1,112822,112824,112825,2,3,0
32314,2,1,112824,112825,112826,1,2,0
32315,5,1,112829,112829,112830,0,1,3
32316,1,2,112830,112830,112832,0,2,0
32317,4,1,112834,112834,112835,0,1,2
32318,4,1,112838,112838,112839,0,1,3
32319,4,2,112842,112842,112844,0,2,3
32320,6,2,112848,112848,112850,0,2,4
32321,2,1,112850,112850,112851,0,1,0
32322,4,1,112854,112854,112855,0,1,3
32323,4,1,112858,112858,112859,0,1,3
32324,3,2,112861,112861,112863,0,2,2
32325,2,3,112863,112863,112866,0,3,0
32326,6,3,112869,112869,112872,0,3,3
32327,6,3,112875,112875,112878,0,3,3
32328,4,2,112879,112879,112881,0,2,1
32329,1,1,112880,112881,112882,1,2,0
32330,1,2,112881,112882,112884,1,3,0
32331,2,1,112883,112884,112885,1,2,0
32332,1,2,112884,112885,112887,1,3,0
32333,3,2,112887,112887,112889,0,2,0
32334,6,1,112893,112893,112894,0,1,4
32335,3,3,112896,112896,112899,0,3,2
32336,3,1,112899,112899,112900,0,1,0
32337,5,3,112904,112904,112907,0,3,4
32338,5,3,112909,112909,112912,0,3,2
32339,3,2,112912,112912,112914,0,2,0
32340,2,3,112914,112914,112917,0,3,0
32341,3,1,112917,112917,112918,0,1,0
32342,3,2,112920,112920,112922,0,2,2
32343,4,1,112924,112924,112925,0,1,2
32344,2,1,112926,112926,112927,0,1,1
32345,4,1,112930,112930,112931,0,1,3
32346,2,3,112932,112932,112935,0,3,1
32347,4,2,112936,112936,112938,0,2,1
32348,5,1,112941,112941,112942,0,1,3
32349,5,1,112946,112946,112947,0,1,4
32350,1,2,112947,112947,112949,0,2,0
32351,6,1,112953,112953,112954,0,1,4
32352,3,1,112956,112956,112957,0,1,2
32353,4,3,112960,112960,112963,0,3,3
32354,3,2,112963,112963,112965,0,2,0
32355,6,2,112969,112969,112971,0,2,4
32356,6,2,112975,112975,112977,0,2,4
32357,6,1,112981,112981,112982,0,1,4
32358,1,3,112982,112982,112985,0,3,0
32359,3,2,112985,112985,112987,0,2,0
32360,5,1,112990,112990,112991,0,1,3
32361,6,2,112996,112996,112998,0,2,5
32362,3,3,112999,112999,113002,0,3,1
32363,4,3,113003,113003,113006,0,3,1
32364,1,3,113004,113006,113009,2,5,0
32365,4,2,113008,113009,113011,1,3,0
32366,2,3,113010,113011,113014,1,4,0
32367,4,2,113014,113014,113016,0,2,0
32368,2,2,113016,113016,113018,0,2,0
32369,3,1,113019,113019,113020,0,1,1
32370,1,2,113020,113020,113022,0,2,0
32371,2,3,113022,113022,113025,0,3,0
32372,4,2,113026,113026,113028,0,2,1
32373,2,1,113028,113028,113029,0,1,0
32374,2,1,113030,113030,113031,0,1,1
32375,3,1,113033,113033,113034,0,1,2
32376,1,1,113034,113034,113035,0,1,0
32377,5,3,113039,113039,113042,0,3,4
32378,6,3,113045,113045,113048,0,3,3
32379,2,2,113047,113048,113050,1,3,0
32380,1,2,113048,113050,113052,2,4,0
32381,5,3,113053,113053,113056,0,3,1
32382,2,3,113055,113056,113059,1,4,0
32383,2,2,113057,113059,113061,2,4,0
32384,3,2,113060,113061,113063,1,3,0
32385,1,2,113061,113063,113065,2,4,0
32386,4,3,113065,113065,113068,0,3,0
32387,3,2,113068,113068,113070,0,2,0
32388,5,3,113073,113073,113076,0,3,3
32389,1,1,113074,113076,113077,2,3,0
32390,4,3,113078,113078,113081,0,3,1
32391,6,2,113084,113084,113086,0,2,3
32392,2,3,113086,113086,113089,0,3,0
32393,1,1,113087,113089,113090,2,3,0
32394,2,1,113089,113090,113091,1,2,0
32395,4,3,113093,113093,113096,0,3,2
32396,1,3,113094,113096,113099,2,5,0
32397,4,1,113098,113099,113100,1,2,0
32398,6,3,113104,113104,113107,0,3,4
32399,3,3,113107,113107,113110,0,3,0
32400,4,3,113111,113111,113114,0,3,1
32401,6,1,113117,113117,113118,0,1,3
32402,2,1,113119,113119,113120,0,1,1
32403,6,1,113125,113125,113126,0,1,5
32404,5,3,113130,113130,113133,0,3,4
32405,1,2,113131,113133,113135,2,4,0
32406,4,3,113135,113135,113138,0,3,0
32407,4,2,113139,113139,113141,0,2,1
32408,6,3,113145,113145,113148,0,3,4
32409,4,1,113149,113149,113150,0,1,1
32410,2,3,113151,113151,113154,0,3,1
32411,1,1,113152,113154,113155,2,3,0
32412,2,2,113154,113155,113157,1,3,0
32413,2,2,113156,113157,113159,1,3,0
32414,6,3,113162,113162,113165,0,3,3
32415,1,2,113163,113165,113167,2,4,0
32416,2,2,113165,113167,113169,2,4,0
32417,5,1,113170,113170,113171,0,1,1
32418,2,2,113172,113172,113174,0,2,1
32419,4,2,113176,113176,113178,0,2,2
32420,1,2,113177,113178,113180,1,3,0
32421,5,3,113182,113182,113185,0,3,2
32422,2,3,113184,113185,113188,1,4,0
32423,6,2,113190,113190,113192,0,2,2
32424,2,3,113192,113192,113195,0,3,0
32425,5,3,113197,113197,113200,0,3,2
32426,2,2,113199,113200,113202,1,3,0
32427,3,3,113202,113202,113205,0,3,0
32428,6,1,113208,113208,113209,0,1,3
32429,6,2,113214,113214,113216,0,2,5
32430,1,3,113215,113216,113219,1,4,0
32431,6,1,113221,113221,113222,0,1,2
32432,6,3,113227,113227,113230,0,3,5
32433,3,3,113230,113230,113233,0,3,0
32434,5,1,113235,113235,113236,0,1,2
32435,5,1,113240,113240,113241,0,1,4
32436,6,1,113246,113246,113247,0,1,5
32437,1,2,113247,113247,113249,0,2,0
32438,1,2,113248,113249,113251,1,3,0
32439,4,2,113252,113252,113254,0,2,1
32440,2,3,113254,113254,113257,0,3,0
32441,6,1,113260,113260,113261,0,1,3
32442,1,3,113261,113261,113264,0,3,0
32443,4,3,113265,113265,113268,0,3,1
32444,2,2,113267,113268,113270,1,3,0
32445,5,2,113272,113272,113274,0,2,2
32446,4,3,113276,113276,113279,0,3,2
32447,6,2,113282,113282,113284,0,2,3
32448,6,2,113288,113288,113290,0,2,4
32449,6,2,113294,113294,113296,0,2,4
32450,3,2,113297,113297,113299,0,2,1
32451,4,2,113301,113301,113303,0,2,2
32452,6,1,113307,113307,113308,0,1,4
32453,4,2,113311,113311,113313,0,2,3
32454,4,3,113315,113315,113318,0,3,2
32455,5,3,113320,113320,113323,0,3,2
32456,6,1,113326,113326,113327,0,1,3
32457,6,2,113332,113332,113334,0,2,5
32458,3,1,113335,113335,113336,0,1,1
32459,3,3,113338,113338,113341,0,3,2
32460,6,1,113344,113344,113345,0,1,3
32461,1,3,113345,113345,113348,0,3,0
32462,1,3,113346,113348,113351,2,5,0
32463,5,1,113351,113351,113352,0,1,0
32464,6,1,113357,113357,113358,0,1,5
32465,6,2,113363,113363,113365,0,2,5
32466,4,1,113367,113367,113368,0,1,2
32467,5,1,113372,113372,113373,0,1,4
32468,1,3,113373,113373,113376,0,3,0
32469,1,1,113374,113376,113377,2,3,0
32470,4,3,113378,113378,113381,0,3,1
32471,1,2,113379,113381,113383,2,4,0
32472,3,2,113382,113383,113385,1,3,0
32473,6,2,113388,113388,113390,0,2,3
32474,2,1,113390,113390,113391,0,1,0
32475,4,2,113394,113394,113396,0,2,3
32476,4,2,113398,113398,113400,0,2,2
32477,3,2,113401,113401,113403,0,2,1
32478,4,1,113405,113405,113406,0,1,2
32479,2,3,113407,113407,113410,0,3,1
32480,2,3,113409,113410,113413,1,4,0
32481,4,2,113413,113413,113415,0,2,0
32482,3,2,113416,113416,113418,0,2,1
32483,6,2,113422,113422,113424,0,2,4
32484,6,2,113428,113428,113430,0,2,4
32485,2,1,113430,113430,113431,0,1,0
32486,5,2,113435,113435,113437,0,2,4
32487,5,3,113440,113440,113443,0,3,3
32488,1,2,113441,113443,113445,2,4,0
32489,6,1,113447,113447,113448,0,1,2
32490,3,3,113450,113450,113453,0,3,2
32491,6,1,113456,113456,113457,0,1,3
32492,1,3,113457,113457,113460,0,3,0
32493,2,1,113459,113460,113461,1,2,0
32494,3,1,113462,113462,113463,0,1,1
32495,4,1,113466,113466,113467,0,1,3
32496,6,3,113472,113472,113475,0,3,5
32497,5,1,113477,113477,113478,0,1,2
32498,4,2,113481,113481,113483,0,2,3
32499,6,2,113487,113487,113489,0,2,4
32500,1,1,113488,113489,113490,1,2,0
32501,2,1,113490,113490,113491,0,1,0
32502,3,3,113493,113493,113496,0,3,2
32503,4,2,113497,113497,113499,0,2,1
32504,6,2,113503,113503,113505,0,2,4
32505,6,3,113509,113509,113512,0,3,4
32506,3,2,113512,113512,113514,0,2,0
32507,1,2,113513,113514,113516,1,3,0
32508,1,2,113514,113516,113518,2,4,0
32509,2,3,113516,113518,113521,2,5,0
32510,6,3,113522,113522,113525,0,3,1
32511,4,3,113526,113526,113529,0,3,1
32512,2,3,113528,113529,113532,1,4,0
32513,5,2,113533,113533,113535,0,2,1
32514,4,3,113537,113537,113540,0,3,2
32515,4,1,113541,113541,113542,0,1,1
32516,2,3,113543,113543,113546,0,3,1
32517,6,2,113549,113549,113551,0,2,3
32518,4,3,113553,113553,113556,0,3,2
32519,1,2,113554,113556,113558,2,4,0
32520,3,1,113557,113558,113559,1,2,0
32521,2,1,113559,113559,113560,0,1,0
32522,2,1,113561,113561,113562,0,1,1
32523,3,3,113564,113564,113567,0,3,2
32524,5,2,113569,113569,113571,0,2,2
32525,3,2,113572,113572,113574,0,2,1
32526,4,2,113576,113576,113578,0,2,2
32527,1,2,113577,113578,113580,1,3,0
32528,2,3,113579,113580,113583,1,4,0
32529,1,1,113580,113583,113584,3,4,0
32530,4,3,113584,113584,113587,0,3,0
32531,5,3,113589,113589,113592,0,3,2
32532,1,2,113590,113592,113594,2,4,0
32533,1,1,113591,113594,113595,3,4,0
32534,1,1,113592,113595,113596,3,4,0
32535,3,3,113595,113596,113599,1,4,0
32536,2,2,113597,113599,113601,2,4,0
32537,2,2,113599,113601,113603,2,4,0
32538,1,1,113600,113603,113604,3,4,0
32539,4,1,113604,113604,113605,0,1,0
32540,4,3,113608,113608,113611,0,3,3
32541,5,2,113613,113613,113615,0,2,2
32542,2,1,113615,113615,113616,0,1,0
32543,1,3,113616,113616,113619,0,3,0
32544,3,1,113619,113619,113620,0,1,0
32545,3,1,113622,113622,113623,0,1,2
32546,5,1,113627,113627,113628,0,1,4
32547,2,1,113629,113629,113630,0,1,1
32548,2,2,113631,113631,113633,0,2,1
32549,1,2,113632,113633,113635,1,3,0
32550,5,1,113637,113637,113638,0,1,2
32551,2,3,113639,113639,113642,0,3,1
32552,1,1,113640,113642,113643,2,3,0
32553,4,1,113644,113644,113645,0,1,1
32554,1,1,113645,113645,113646,0,1,0
32555,4,3,113649,113649,113652,0,3,3
32556,6,1,113655,113655,113656,0,1,3
32557,4,2,113659,113659,113661,0,2,3
32558,6,2,113665,113665,113667,0,2,4
32559,4,1,113669,113669,113670,0,1,2
32560,3,2,113672,113672,113674,0,2,2
32561,4,3,113676,113676,113679,0,3,2
32562,3,1,113679,113679,113680,0,1,0
32563,3,3,113682,113682,113685,0,3,2
32564,5,3,113687,113687,113690,0,3,2
32565,3,3,113690,113690,113693,0,3,0
32566,2,1,113692,113693,113694,1,2,0
32567,2,1,113694,113694,113695,0,1,0
32568,3,3,113697,113697,113700,0,3,2
32569,6,2,113703,113703,113705,0,2,3
32570,2,3,113705,113705,113708,0,3,0
32571,1,3,113706,113708,113711,2,5,0
32572,5,3,113711,113711,113714,0,3,0
32573,2,3,113713,113714,113717,1,4,0
32574,5,2,113718,113718,113720,0,2,1
32575,3,1,113721,113721,113722,0,1,1
32576,4,1,113725,113725,113726,0,1,3
32577,6,3,113731,113731,113734,0,3,5
32578,5,1,113736,113736,113737,0,1,2
32579,5,3,113741,113741,113744,0,3,4
32580,5,1,113746,113746,113747,0,1,2
32581,2,1,113748,113748,113749,0,1,1
32582,2,1,113750,113750,113751,0,1,1
32583,5,1,113755,113755,113756,0,1,4
32584,6,1,113761,113761,113762,0,1,5
32585,6,3,113767,113767,113770,0,3,5
32586,6,3,113773,113773,113776,0,3,3
32587,3,1,113776,113776,113777,0,1,0
32588,6,3,113782,113782,113785,0,3,5
32589,5,1,113787,113787,113788,0,1,2
32590,4,3,113791,113791,113794,0,3,3
32591,5,3,113796,113796,113799,0,3,2
32592,4,3,113800,113800,113803,0,3,1
32593,1,1,113801,113803,113804,2,3,0
32594,2,1,113803,113804,113805,1,2,0
32595,4,1,113807,113807,113808,0,1,2
32596,2,3,113809,113809,113812,0,3,1
32597,6,2,113815,113815,113817,0,2,3
32598,5,1,113820,113820,113821,0,1,3
32599,4,1,113824,113824,113825,0,1,3
32600,5,2,113829,113829,113831,0,2,4
32601,3,3,113832,113832,113835,0,3,1
32602,1,1,113833,113835,113836,2,3,0
32603,6,3,113839,113839,113842,0,3,3
32604,4,1,113843,113843,113844,0,1,1
32605,3,2,113846,113846,113848,0,2,2
32606,2,1,113848,113848,113849,0,1,0
32607,5,2,113853,113853,113855,0,2,4
32608,1,3,113854,113855,113858,1,4,0
32609,4,2,113858,113858,113860,0,2,0
32610,6,3,113864,113864,113867,0,3,4
32611,6,2,113870,113870,113872,0,2,3
32612,5,2,113875,113875,113877,0,2,3
32613,6,3,113881,113881,113884,0,3,4
32614,4,3,113885,113885,113888,0,3,1
32615,1,3,113886,113888,113891,2,5,0
32616,6,2,113892,113892,113894,0,2,1
32617,5,2,113897,113897,113899,0,2,3
32618,1,3,113898,113899,113902,1,4,0
32619,4,2,113902,113902,113904,0,2,0
32620,3,1,113905,113905,113906,0,1,1
32621,4,2,113909,113909,113911,0,2,3
32622,6,1,113915,113915,113916,0,1,4
32623,3,2,113918,113918,113920,0,2,2
32624,2,3,113920,113920,113923,0,3,0
32625,6,1,113926,113926,113927,0,1,3
32626,1,2,113927,113927,113929,0,2,0
32627,3,1,113930,113930,113931,0,1,1
32628,5,3,113935,113935,113938,0,3,4
32629,1,1,113936,113938,113939,2,3,0
32630,1,1,113937,113939,113940,2,3,0
32631,3,3,113940,113940,113943,0,3,0
32632,5,1,113945,113945,113946,0,1,2
32633,6,2,113951,113951,113953,0,2,5
32634,2,2,113953,113953,113955,0,2,0
32635,3,3,113956,113956,113959,0,3,1
32636,3,2,113959,113959,113961,0,2,0
32637,3,1,113962,113962,113963,0,1,1
32638,4,3,113966,113966,113969,0,3,3
32639,6,3,113972,113972,113975,0,3,3
32640,6,3,113978,113978,113981,0,3,3
32641,3,2,113981,113981,113983,0,2,0
32642,3,1,113984,113984,113985,0,1,1
32643,3,3,113987,113987,113990,0,3,2
32644,3,1,113990,113990,113991,0,1,0
32645,2,1,113992,113992,113993,0,1,1
32646,4,1,113996,113996,113997,0,1,3
32647,1,2,113997,113997,113999,0,2,0
32648,5,2,114002,114002,114004,0,2,3
32649,3,3,114005,114005,114008,0,3,1
32650,4,3,114009,114009,114012,0,3,1
32651,6,1,114015,114015,114016,0,1,3
32652,2,1,114017,114017,114018,0,1,1
32653,6,3,114023,114023,114026,0,3,5
32654,6,1,114029,114029,114030,0,1,3
32655,6,2,114035,114035,114037,0,2,5
32656,5,1,114040,114040,114041,0,1,3
32657,1,3,114041,114041,114044,0,3,0
32658,3,2,114044,114044,114046,0,2,0
32659,1,1,114045,114046,114047,1,2,0
32660,3,2,114048,114048,114050,0,2,1
32661,2,3,114050,114050,114053,0,3,0
32662,6,2,114056,114056,114058,0,2,3
32663,5,3,114061,114061,114064,0,3,3
32664,5,3,114066,114066,114069,0,3,2
32665,5,3,114071,114071,114074,0,3,2
32666,4,2,114075,114075,114077,0,2,1
32667,3,3,114078,114078,114081,0,3,1
32668,5,2,114083,114083,114085,0,2,2
32669,5,2,114088,114088,114090,0,2,3
32670,6,2,114094,114094,114096,0,2,4
32671,1,2,114095,114096,114098,1,3,0
32672,4,2,114099,114099,114101,0,2,1
32673,2,2,114101,114101,114103,0,2,0
32674,4,3,114105,114105,114108,0,3,2
32675,5,1,114110,114110,114111,0,1,2
32676,1,2,114111,114111,114113,0,2,0
32677,2,2,114113,114113,114115,0,2,0
32678,4,1,114117,114117,114118,0,1,2
32679,4,3,114121,114121,114124,0,3,3
32680,2,2,114123,114124,114126,1,3,0
32681,3,1,114126,114126,114127,0,1,0
32682,6,2,114132,114132,114134,0,2,5
32683,3,3,114135,114135,114138,0,3,1
32684,4,1,114139,114139,114140,0,1,1
32685,5,2,114144,114144,114146,0,2,4
32686,4,3,114148,114148,114151,0,3,2
32687,1,3,114149,114151,114154,2,5,0
32688,5,1,114154,114154,114155,0,1,0
32689,5,1,114159,114159,114160,0,1,4
32690,4,1,114163,114163,114164,0,1,3
32691,5,3,114168,114168,114171,0,3,4
32692,5,1,114173,114173,114174,0,1,2
32693,4,3,114177,114177,114180,0,3,3
32694,6,2,114183,114183,114185,0,2,3
32695,6,3,114189,114189,114192,0,3,4
32696,4,3,114193,114193,114196,0,3,1
32697,3,3,114196,114196,114199,0,3,0
32698,2,1,114198,114199,114200,1,2,0
32699,5,3,114203,114203,114206,0,3,3
32700,1,3,114204,114206,114209,2,5,0
32701,4,2,114208,114209,114211,1,3,0
32702,5,3,114213,114213,114216,0,3,2
32703,4,2,114217,114217,114219,0,2,1
32704,2,2,114219,114219,114221,0,2,0
32705,4,2,114223,114223,114225,0,2,2
32706,4,3,114227,114227,114230,0,3,2
32707,5,2,114232,114232,114234,0,2,2
32708,1,2,114233,114234,114236,1,3,0
32709,2,3,114235,114236,114239,1,4,0
32710,6,3,114241,114241,114244,0,3,2
32711,3,3,114244,114244,114247,0,3,0
32712,6,3,114250,114250,114253,0,3,3
32713,3,1,114253,114253,114254,0,1,0
32714,2,2,114255,114255,114257,0,2,1
32715,4,2,114259,114259,114261,0,2,2
32716,2,2,114261,114261,114263,0,2,0
32717,3,2,114264,114264,114266,0,2,1
32718,6,3,114270,114270,114273,0,3,4
32719,5,3,114275,114275,114278,0,3,2
32720,6,1,114281,114281,114282,0,1,3
32721,3,2,114284,114284,114286,0,2,2
32722,5,3,114289,114289,114292,0,3,3
32723,3,2,114292,114292,114294,0,2,0
32724,3,3,114295,114295,114298,0,3,1
32725,1,1,114296,114298,114299,2,3,0
32726,4,1,114300,114300,114301,0,1,1
32727,2,3,114302,114302,114305,0,3,1
32728,1,1,114303,114305,114306,2,3,0
32729,3,1,114306,114306,114307,0,1,0
32730,6,1,114312,114312,114313,0,1,5
32731,6,2,114318,114318,114320,0,2,5
32732,2,1,114320,114320,114321,0,1,0
32733,2,3,114322,114322,114325,0,3,1
32734,1,3,114323,114325,114328,2,5,0
32735,4,1,114327,114328,114329,1,2,0
32736,3,1,114330,114330,114331,0,1,1
32737,1,3,114331,114331,114334,0,3,0
32738,5,1,114336,114336,114337,0,1,2
32739,3,3,114339,114339,114342,0,3,2
32740,2,1,114341,114342,114343,1,2,0
32741,1,3,114342,114343,114346,1,4,0
32742,5,3,114347,114347,114350,0,3,1
32743,5,2,114352,114352,114354,0,2,2
32744,1,1,114353,114354,114355,1,2,0
32745,5,3,114358,114358,114361,0,3,3
32746,2,1,114360,114361,114362,1,2,0
32747,4,1,114364,114364,114365,0,1,2
32748,1,3,114365,114365,114368,0,3,0
32749,1,1,114366,114368,114369,2,3,0
32750,2,1,114368,114369,114370,1,2,0
32751,2,2,114370,114370,114372,0,2,0
32752,6,3,114376,114376,114379,0,3,4
32753,4,3,114380,114380,114383,0,3,1
32754,5,1,114385,114385,114386,0,1,2
32755,3,1,114388,114388,114389,0,1,2
32756,3,3,114391,114391,114394,0,3,2
32757,3,2,114394,114394,114396,0,2,0
32758,1,1,114395,114396,114397,1,2,0
32759,5,2,114400,114400,114402,0,2,3
32760,2,3,114402,114402,114405,0,3,0
32761,5,2,114407,114407,114409,0,2,2
32762,2,1,114409,114409,114410,0,1,0
32763,3,2,114412,114412,114414,0,2,2
32764,4,3,114416,114416,114419,0,3,2
32765,2,1,114418,114419,114420,1,2,0
32766,2,3,114420,114420,114423,0,3,0
32767,4,1,114424,114424,114425,0,1,1
32768,4,3,114428,114428,114431,0,3,3
32769,3,1,114431,114431,114432,0,1,0
32770,4,1,114435,114435,114436,0,1,3
32771,5,2,114440,114440,114442,0,2,4
32772,5,1,114445,114445,114446,0,1,3
32773,2,3,114447,114447,114450,0,3,1
32774,5,1,114452,114452,114453,0,1,2
32775,5,1,114457,114457,114458,0,1,4
32776,6,3,114463,114463,114466,0,3,5
32777,2,2,114465,114466,114468,1,3,0
32778,1,1,114466,114468,114469,2,3,0
32779,4,2,114470,114470,114472,0,2,1
32780,4,1,114474,114474,114475,0,1,2
32781,5,2,114479,114479,114481,0,2,4
32782,2,1,114481,114481,114482,0,1,0
32783,2,3,114483,114483,114486,0,3,1
32784,5,1,114488,114488,114489,0,1,2
32785,3,2,114491,114491,114493,0,2,2
32786,3,3,114494,114494,114497,0,3,1
32787,5,1,114499,114499,114500,0,1,2
32788,2,3,114501,114501,114504,0,3,1
32789,6,3,114507,114507,114510,0,3,3
32790,2,3,114509,114510,114513,1,4,0
32791,4,3,114513,114513,114516,0,3,0
32792,5,1,114518,114518,114519,0,1,2
32793,5,3,114523,114523,114526,0,3,4
32794,1,3,114524,114526,114529,2,5,0
32795,4,3,114528,114529,114532,1,4,0
32796,2,3,114530,114532,114535,2,5,0
32797,4,3,114534,114535,114538,1,4,0
32798,5,3,114539,114539,114542,0,3,1
32799,2,2,114541,114542,114544,1,3,0
32800,1,3,114542,114544,114547,2,5,0
32801,2,3,114544,114547,114550,3,6,0
32802,1,2,114545,114550,114552,5,7,0
32803,2,1,114547,114552,114553,5,6,0
32804,6,2,114553,114553,114555,0,2,0
32805,6,3,114559,114559,114562,0,3,4
32806,3,1,114562,114562,114563,0,1,0
32807,5,1,114567,114567,114568,0,1,4
32808,6,2,114573,114573,114575,0,2,5
32809,5,2,114578,114578,114580,0,2,3
32810,3,2,114581,114581,114583,0,2,1
32811,3,3,114584,114584,114587,0,3,1
32812,4,1,114588,114588,114589,0,1,1
32813,3,2,114591,114591,114593,0,2,2
32814,1,2,114592,114593,114595,1,3,0
32815,1,3,114593,114595,114598,2,5,0
32816,5,2,114598,114598,114600,0,2,0
32817,1,3,114599,114600,114603,1,4,0
32818,2,1,114601,114603,114604,2,3,0
32819,3,2,114604,114604,114606,0,2,0
32820,5,3,114609,114609,114612,0,3,3
32821,2,3,114611,114612,114615,1,4,0
32822,4,1,114615,114615,114616,0,1,0
32823,3,3,114618,114618,114621,0,3,2
32824,3,1,114621,114621,114622,0,1,0
32825,6,1,114627,114627,114628,0,1,5
32826,1,1,114628,114628,114629,0,1,0
32827,2,1,114630,114630,114631,0,1,1
32828,3,2,114633,114633,114635,0,2,2
32829,4,3,114637,114637,114640,0,3,2
32830,3,1,114640,114640,114641,0,1,0
32831,5,2,114645,114645,114647,0,2,4
32832,6,3,114651,114651,114654,0,3,4
32833,2,1,114653,114654,114655,1,2,0
32834,1,3,114654,114655,114658,1,4,0
32835,6,1,114660,114660,114661,0,1,2
32836,2,1,114662,114662,114663,0,1,1
32837,2,3,114664,114664,114667,0,3,1
32838,2,1,114666,114667,114668,1,2,0
32839,2,2,114668,114668,114670,0,2,0
32840,1,1,114669,114670,114671,1,2,0
32841,3,3,114672,114672,114675,0,3,1
32842,1,2,114673,114675,114677,2,4,0
32843,4,2,114677,114677,114679,0,2,0
32844,3,1,114680,114680,114681,0,1,1
32845,5,1,114685,114685,114686,0,1,4
32846,3,3,114688,114688,114691,0,3,2
32847,5,3,114693,114693,114696,0,3,2
32848,5,2,114698,114698,114700,0,2,2
32849,4,2,114702,114702,114704,0,2,2
32850,4,3,114706,114706,114709,0,3,2
32851,6,1,114712,114712,114713,0,1,3
32852,1,1,114713,114713,114714,0,1,0
32853,4,3,114717,114717,114720,0,3,3
32854,4,1,114721,114721,114722,0,1,1
32855,5,3,114726,114726,114729,0,3,4
32856,1,3,114727,114729,114732,2,5,0
32857,2,2,114729,114732,114734,3,5,0
32858,5,2,114734,114734,114736,0,2,0
32859,1,1,114735,114736,114737,1,2,0
32860,3,1,114738,114738,114739,0,1,1
32861,1,1,114739,114739,114740,0,1,0
32862,2,2,114741,114741,114743,0,2,1
32863,4,1,114745,114745,114746,0,1,2
32864,6,1,114751,114751,114752,0,1,5
32865,1,2,114752,114752,114754,0,2,0
32866,5,1,114757,114757,114758,0,1,3
32867,5,1,114762,114762,114763,0,1,4
32868,3,2,114765,114765,114767,0,2,2
32869,3,2,114768,114768,114770,0,2,1
32870,6,1,114774,114774,114775,0,1,4
32871,4,3,114778,114778,114781,0,3,3
32872,6,2,114784,114784,114786,0,2,3
32873,4,1,114788,114788,114789,0,1,2
32874,3,3,114791,114791,114794,0,3,2
32875,1,2,114792,114794,114796,2,4,0
32876,2,1,114794,114796,114797,2,3,0
32877,4,1,114798,114798,114799,0,1,1
32878,1,1,114799,114799,114800,0,1,0
32879,4,3,114803,114803,114806,0,3,3
32880,4,2,114807,114807,114809,0,2,1
32881,6,3,114813,114813,114816,0,3,4
32882,4,1,114817,114817,114818,0,1,1
32883,3,1,114820,114820,114821,0,1,2
32884,2,1,114822,114822,114823,0,1,1
32885,5,1,114827,114827,114828,0,1,4
32886,3,1,114830,114830,114831,0,1,2
32887,4,2,114834,114834,114836,0,2,3
32888,4,3,114838,114838,114841,0,3,2
32889,6,1,114844,114844,114845,0,1,3
32890,4,1,114848,114848,114849,0,1,3
32891,2,2,114850,114850,114852,0,2,1
32892,2,2,114852,114852,114854,0,2,0
32893,3,3,114855,114855,114858,0,3,1
32894,1,3,114856,114858,114861,2,5,0
32895,3,1,114859,114861,114862,2,3,0
32896,6,2,114865,114865,114867,0,2,3
32897,3,2,114868,114868,114870,0,2,1
32898,1,3,114869,114870,114873,1,4,0
32899,2,1,114871,114873,114874,2,3,0
32900,5,1,114876,114876,114877,0,1,2
32901,6,2,114882,114882,114884,0,2,5
32902,4,3,114886,114886,114889,0,3,2
32903,1,3,114887,114889,114892,2,5,0
32904,4,1,114891,114892,114893,1,2,0
32905,6,1,114897,114897,114898,0,1,4
32906,3,3,114900,114900,114903,0,3,2
32907,3,1,114903,114903,114904,0,1,0
32908,4,1,114907,114907,114908,0,1,3
32909,2,1,114909,114909,114910,0,1,1
32910,2,1,114911,114911,114912,0,1,1
32911,6,2,114917,114917,114919,0,2,5
32912,3,3,114920,114920,114923,0,3,1
32913,3,1,114923,114923,114924,0,1,0
32914,6,3,114929,114929,114932,0,3,5
32915,4,3,114933,114933,114936,0,3,1
32916,1,3,114934,114936,114939,2,5,0
32917,2,2,114936,114939,114941,3,5,0
32918,4,2,114940,114941,114943,1,3,0
32919,6,3,114946,114946,114949,0,3,3
32920,1,2,114947,114949,114951,2,4,0
32921,3,3,114950,114951,114954,1,4,0
32922,1,3,114951,114954,114957,3,6,0
32923,4,1,114955,114957,114958,2,3,0
32924,4,1,114959,114959,114960,0,1,1
32925,2,1,114961,114961,114962,0,1,1
32926,6,2,114967,114967,114969,0,2,5
32927,2,3,114969,114969,114972,0,3,0
32928,5,2,114974,114974,114976,0,2,2
32929,4,2,114978,114978,114980,0,2,2
32930,4,1,114982,114982,114983,0,1,2
32931,1,2,114983,114983,114985,0,2,0
32932,6,2,114989,114989,114991,0,2,4
32933,2,2,114991,114991,114993,0,2,0
32934,1,1,114992,114993,114994,1,2,0
32935,2,1,114994,114994,114995,0,1,0
32936,3,2,114997,114997,114999,0,2,2
32937,6,1,115003,115003,115004,0,1,4
32938,1,2,115004,115004,115006,0,2,0
32939,2,2,115006,115006,115008,0,2,0
32940,6,2,115012,115012,115014,0,2,4
32941,2,2,115014,115014,115016,0,2,0
32942,3,1,115017,115017,115018,0,1,1
32943,4,2,115021,115021,115023,0,2,3
32944,6,3,115027,115027,115030,0,3,4
32945,2,2,115029,115030,115032,1,3,0
32946,6,1,115035,115035,115036,0,1,3
32947,6,2,115041,115041,115043,0,2,5
32948,2,3,115043,115043,115046,0,3,0
32949,4,2,115047,115047,115049,0,2,1
32950,6,1,115053,115053,115054,0,1,4
32951,5,3,115058,115058,115061,0,3,4
32952,3,1,115061,115061,115062,0,1,0
32953,2,1,115063,115063,115064,0,1,1
32954,4,2,115067,115067,115069,0,2,3
32955,1,2,115068,115069,115071,1,3,0
32956,4,2,115072,115072,115074,0,2,1
32957,4,1,115076,115076,115077,0,1,2
32958,4,3,115080,115080,115083,0,3,3
32959,6,3,115086,115086,115089,0,3,3
32960,4,1,115090,115090,115091,0,1,1
32961,5,1,115095,115095,115096,0,1,4
32962,2,1,115097,115097,115098,0,1,1
32963,6,1,115103,115103,115104,0,1,5
32964,3,1,115106,115106,115107,0,1,2
32965,6,2,115112,115112,115114,0,2,5
32966,4,2,115116,115116,115118,0,2,2
32967,4,1,115120,115120,115121,0,1,2
32968,4,3,115124,115124,115127,0,3,3
32969,5,1,115129,115129,115130,0,1,2
32970,5,2,115134,115134,115136,0,2,4
32971,2,1,115136,115136,115137,0,1,0
32972,4,1,115140,115140,115141,0,1,3
32973,2,3,115142,115142,115145,0,3,1
32974,2,1,115144,115145,115146,1,2,0
32975,1,3,115145,115146,115149,1,4,0
32976,3,2,115148,115149,115151,1,3,0
32977,6,3,115154,115154,115157,0,3,3
32978,4,2,115158,115158,115160,0,2,1
32979,6,1,115164,115164,115165,0,1,4
32980,1,3,115165,115165,115168,0,3,0
32981,4,2,115169,115169,115171,0,2,1
32982,5,1,115174,115174,115175,0,1,3
32983,4,2,115178,115178,115180,0,2,3
32984,5,2,115183,115183,115185,0,2,3
32985,5,2,115188,115188,115190,0,2,3
32986,1,3,115189,115190,115193,1,4,0
32987,1,3,115190,115193,115196,3,6,0
32988,1,2,115191,115196,115198,5,7,0
32989,4,2,115195,115198,115200,3,5,0
32990,2,1,115197,115200,115201,3,4,0
32991,2,1,115199,115201,115202,2,3,0
32992,2,2,115201,115202,115204,1,3,0
32993,1,1,115202,115204,115205,2,3,0
32994,4,2,115206,115206,115208,0,2,1
32995,2,1,115208,115208,115209,0,1,0
32996,1,2,115209,115209,115211,0,2,0
32997,4,2,115213,115213,115215,0,2,2
32998,5,3,115218,115218,115221,0,3,3
32999,6,1,115224,115224,115225,0,1,3
33000,5,3,115229,115229,115232,0,3,4
33001,5,1,115234,115234,115235,0,1,2
33002,4,1,115238,115238,115239,0,1,3
33003,3,2,115241,115241,115243,0,2,2
33004,1,3,115242,115243,115246,1,4,0
33005,2,3,115244,115246,115249,2,5,0
33006,4,3,115248,115249,115252,1,4,0
33007,4,2,115252,115252,115254,0,2,0
33008,5,2,115257,115257,115259,0,2,3
33009,4,2,115261,115261,115263,0,2,2
33010,6,1,115267,115267,115268,0,1,4
33011,5,2,115272,115272,115274,0,2,4
33012,3,1,115275,115275,115276,0,1,1
33013,1,3,115276,115276,115279,0,3,0
33014,4,1,115280,115280,115281,0,1,1
33015,4,3,115284,115284,115287,0,3,3
33016,4,1,115288,115288,115289,0,1,1
33017,2,3,115290,115290,115293,0,3,1
33018,3,2,115293,115293,115295,0,2,0
33019,6,3,115299,115299,115302,0,3,4
33020,4,1,115303,115303,115304,0,1,1
33021,5,2,115308,115308,115310,0,2,4
33022,1,2,115309,115310,115312,1,3,0
33023,6,2,115315,115315,115317,0,2,3
33024,5,2,115320,115320,115322,0,2,3
33025,5,1,115325,115325,115326,0,1,3
33026,5,2,115330,115330,115332,0,2,4
33027,3,2,115333,115333,115335,0,2,1
33028,1,3,115334,115335,115338,1,4,0
33029,4,3,115338,115338,115341,0,3,0
33030,3,1,115341,115341,115342,0,1,0
33031,1,3,115342,115342,115345,0,3,0
33032,5,3,115347,115347,115350,0,3,2
33033,1,3,115348,115350,115353,2,5,0
33034,1,3,115349,115353,115356,4,7,0
33035,6,3,115355,115356,115359,1,4,0
33036,5,1,115360,115360,115361,0,1,1
33037,5,3,115365,115365,115368,0,3,4
33038,6,1,115371,115371,115372,0,1,3
33039,2,1,115373,115373,115374,0,1,1
33040,6,2,115379,115379,115381,0,2,5
33041,6,2,115385,115385,115387,0,2,4
33042,5,3,115390,115390,115393,0,3,3
33043,3,1,115393,115393,115394,0,1,0
33044,3,2,115396,115396,115398,0,2,2
33045,4,2,115400,115400,115402,0,2,2
33046,1,3,115401,115402,115405,1,4,0
33047,4,3,115405,115405,115408,0,3,0
33048,5,1,115410,115410,115411,0,1,2
33049,4,2,115414,115414,115416,0,2,3
33050,2,2,115416,115416,115418,0,2,0
33051,6,2,115422,115422,115424,0,2,4
33052,4,2,115426,115426,115428,0,2,2
33053,1,2,115427,115428,115430,1,3,0
33054,3,2,115430,115430,115432,0,2,0
33055,1,3,115431,115432,115435,1,4,0
33056,1,3,115432,115435,115438,3,6,0
33057,6,3,115438,115438,115441,0,3,0
33058,1,3,115439,115441,115444,2,5,0
33059,3,1,115442,115444,115445,2,3,0
33060,2,3,115444,115445,115448,1,4,0
33061,4,2,115448,115448,115450,0,2,0
33062,6,1,115454,115454,115455,0,1,4
33063,1,1,115455,115455,115456,0,1,0
33064,4,2,115459,115459,115461,0,2,3
33065,3,3,115462,115462,115465,0,3,1
33066,2,2,115464,115465,115467,1,3,0
33067,3,2,115467,115467,115469,0,2,0
33068,3,1,115470,115470,115471,0,1,1
33069,1,2,115471,115471,115473,0,2,0
33070,4,3,115475,115475,115478,0,3,2
33071,2,1,115477,115478,115479,1,2,0
33072,3,3,115480,115480,115483,0,3,1
33073,5,2,115485,115485,115487,0,2,2
33074,2,1,115487,115487,115488,0,1,0
33075,6,1,115493,115493,115494,0,1,5
33076,6,3,115499,115499,115502,0,3,5
33077,5,1,115504,115504,115505,0,1,2
33078,4,2,115508,115508,115510,0,2,3
33079,4,3,115512,115512,115515,0,3,2
33080,3,1,115515,115515,115516,0,1,0
33081,5,2,115520,115520,115522,0,2,4
33082,6,1,115526,115526,115527,0,1,4
33083,5,1,115531,115531,115532,0,1,4
33084,5,3,115536,115536,115539,0,3,4
33085,5,3,115541,115541,115544,0,3,2
33086,2,3,115543,115544,115547,1,4,0
33087,4,1,115547,115547,115548,0,1,0
33088,4,1,115551,115551,115552,0,1,3
33089,3,2,115554,115554,115556,0,2,2
33090,1,2,115555,115556,115558,1,3,0
33091,3,2,115558,115558,115560,0,2,0
33092,4,1,115562,115562,115563,0,1,2
33093,5,3,115567,115567,115570,0,3,4
33094,4,2,115571,115571,115573,0,2,1
33095,5,3,115576,115576,115579,0,3,3
33096,5,3,115581,115581,115584,0,3,2
33097,3,1,115584,115584,115585,0,1,0
33098,1,3,115585,115585,115588,0,3,0
33099,1,1,115586,115588,115589,2,3,0
33100,6,1,115592,115592,115593,0,1,3
33101,1,3,115593,115593,115596,0,3,0
33102,3,1,115596,115596,115597,0,1,0
33103,1,2,115597,115597,115599,0,2,0
33104,1,2,115598,115599,115601,1,3,0
33105,6,2,115604,115604,115606,0,2,3
33106,1,1,115605,115606,115607,1,2,0
33107,5,1,115610,115610,115611,0,1,3
33108,6,2,115616,115616,115618,0,2,5
33109,6,1,115622,115622,115623,0,1,4
33110,6,1,115628,115628,115629,0,1,5
33111,6,2,115634,115634,115636,0,2,5
33112,1,2,115635,115636,115638,1,3,0
33113,4,1,115639,115639,115640,0,1,1
33114,5,1,115644,115644,115645,0,1,4
33115,3,1,115647,115647,115648,0,1,2
33116,1,3,115648,115648,115651,0,3,0
33117,2,2,115650,115651,115653,1,3,0
33118,5,3,115655,115655,115658,0,3,2
33119,6,2,115661,115661,115663,0,2,3
33120,5,1,115666,115666,115667,0,1,3
33121,3,2,115669,115669,115671,0,2,2
33122,5,2,115674,115674,115676,0,2,3
33123,2,3,115676,115676,115679,0,3,0
33124,4,2,115680,115680,115682,0,2,1
33125,1,3,115681,115682,115685,1,4,0
33126,2,2,115683,115685,115687,2,4,0
33127,6,2,115689,115689,115691,0,2,2
33128,1,1,115690,115691,115692,1,2,0
33129,6,2,115696,115696,115698,0,2,4
33130,4,2,115700,115700,115702,0,2,2
33131,5,3,115705,115705,115708,0,3,3
33132,1,3,115706,115708,115711,2,5,0
33133,5,3,115711,115711,115714,0,3,0
33134,2,3,115713,115714,115717,1,4,0
33135,3,2,115716,115717,115719,1,3,0
33136,3,1,115719,115719,115720,0,1,0
33137,5,3,115724,115724,115727,0,3,4
33138,2,2,115726,115727,115729,1,3,0
33139,3,1,115729,115729,115730,0,1,0
33140,5,3,115734,115734,115737,0,3,4
33141,4,3,115738,115738,115741,0,3,1
33142,4,2,115742,115742,115744,0,2,1
33143,3,3,115745,115745,115748,0,3,1
33144,6,3,115751,115751,115754,0,3,3
33145,2,1,115753,115754,115755,1,2,0
33146,3,2,115756,115756,115758,0,2,1
33147,4,3,115760,115760,115763,0,3,2
33148,1,3,115761,115763,115766,2,5,0
33149,3,2,115764,115766,115768,2,4,0
33150,4,2,115768,115768,115770,0,2,0
33151,3,2,115771,115771,115773,0,2,1
33152,5,2,115776,115776,115778,0,2,3
33153,4,1,115780,115780,115781,0,1,2
33154,2,1,115782,115782,115783,0,1,1
33155,2,2,115784,115784,115786,0,2,1
33156,5,1,115789,115789,115790,0,1,3
33157,5,1,115794,115794,115795,0,1,4
33158,4,1,115798,115798,115799,0,1,3
33159,6,1,115804,115804,115805,0,1,5
33160,1,2,115805,115805,115807,0,2,0
33161,6,2,115811,115811,115813,0,2,4
33162,1,3,115812,115813,115816,1,4,0
33163,3,3,115815,115816,115819,1,4,0
33164,6,3,115821,115821,115824,0,3,2
33165,5,2,115826,115826,115828,0,2,2
33166,2,2,115828,115828,115830,0,2,0
33167,3,2,115831,115831,115833,0,2,1
33168,4,1,115835,115835,115836,0,1,2
33169,6,3,115841,115841,115844,0,3,5
33170,3,2,115844,115844,115846,0,2,0
33171,6,1,115850,115850,115851,0,1,4
33172,4,2,115854,115854,115856,0,2,3
33173,3,3,115857,115857,115860,0,3,1
33174,2,2,115859,115860,115862,1,3,0
33175,5,1,115864,115864,115865,0,1,2
33176,4,2,115868,115868,115870,0,2,3
33177,4,1,115872,115872,115873,0,1,2
33178,1,3,115873,115873,115876,0,3,0
33179,1,1,115874,115876,115877,2,3,0
33180,4,1,115878,115878,115879,0,1,1
33181,2,3,115880,115880,115883,0,3,1
33182,5,2,115885,115885,115887,0,2,2
33183,3,3,115888,115888,115891,0,3,1
33184,4,2,115892,115892,115894,0,2,1
33185,3,1,115895,115895,115896,0,1,1
33186,2,2,115897,115897,115899,0,2,1
33187,3,1,115900,115900,115901,0,1,1
33188,3,1,115903,115903,115904,0,1,2
33189,2,1,115905,115905,115906,0,1,1
33190,2,2,115907,115907,115909,0,2,1
33191,3,1,115910,115910,115911,0,1,1
33192,5,1,115915,115915,115916,0,1,4
33193,5,3,115920,115920,115923,0,3,4
33194,2,3,115922,115923,115926,1,4,0
33195,6,1,115928,115928,115929,0,1,2
33196,6,1,115934,115934,115935,0,1,5
33197,6,2,115940,115940,115942,0,2,5
33198,4,2,115944,115944,115946,0,2,2
33199,3,2,115947,115947,115949,0,2,1
33200,5,2,115952,115952,115954,0,2,3
33201,5,3,115957,115957,115960,0,3,3
33202,3,1,115960,115960,115961,0,1,0
33203,1,2,115961,115961,115963,0,2,0
33204,2,3,115963,115963,115966,0,3,0
33205,5,2,115968,115968,115970,0,2,2
33206,6,3,115974,115974,115977,0,3,4
33207,1,2,115975,115977,115979,2,4,0
33208,6,1,115981,115981,115982,0,1,2
33209,1,3,115982,115982,115985,0,3,0
33210,2,1,115984,115985,115986,1,2,0
33211,1,2,115985,115986,115988,1,3,0
33212,4,3,115989,115989,115992,0,3,1
33213,2,3,115991,115992,115995,1,4,0
33214,6,1,115997,115997,115998,0,1,2
33215,2,1,115999,115999,116000,0,1,1
33216,4,2,116003,116003,116005,0,2,3
33217,4,2,116007,116007,116009,0,2,2
33218,5,3,116012,116012,116015,0,3,3
33219,4,1,116016,116016,116017,0,1,1
33220,5,3,116021,116021,116024,0,3,4
33221,2,3,116023,116024,116027,1,4,0
33222,5,2,116028,116028,116030,0,2,1
33223,1,3,116029,116030,116033,1,4,0
33224,3,3,116032,116033,116036,1,4,0
33225,5,2,116037,116037,116039,0,2,1
33226,2,3,116039,116039,116042,0,3,0
33227,5,2,116044,116044,116046,0,2,2
33228,5,1,116049,116049,116050,0,1,3
33229,6,3,116055,116055,116058,0,3,5
33230,3,2,116058,116058,116060,0,2,0
33231,6,2,116064,116064,116066,0,2,4
33232,2,2,116066,116066,116068,0,2,0
33233,6,3,116072,116072,116075,0,3,4
33234,3,1,116075,116075,116076,0,1,0
33235,1,1,116076,116076,116077,0,1,0
33236,1,1,116077,116077,116078,0,1,0
33237,3,3,116080,116080,116083,0,3,2
33238,6,3,116086,116086,116089,0,3,3
33239,4,1,116090,116090,116091,0,1,1
33240,2,3,116092,116092,116095,0,3,1
33241,6,1,116098,116098,116099,0,1,3
33242,6,2,116104,116104,116106,0,2,5
33243,2,1,116106,116106,116107,0,1,0
33244,5,1,116111,116111,116112,0,1,4
33245,3,3,116114,116114,116117,0,3,2
33246,6,3,116120,116120,116123,0,3,3
33247,2,3,116122,116123,116126,1,4,0
33248,3,3,116125,116126,116129,1,4,0
33249,6,1,116131,116131,116132,0,1,2
33250,3,3,116134,116134,116137,0,3,2
33251,6,2,116140,116140,116142,0,2,3
33252,5,1,116145,116145,116146,0,1,3
33253,3,3,116148,116148,116151,0,3,2
33254,1,2,116149,116151,116153,2,4,0
33255,1,2,116150,116153,116155,3,5,0
33256,3,3,116153,116155,116158,2,5,0
33257,2,1,116155,116158,116159,3,4,0
33258,4,3,116159,116159,116162,0,3,0
33259,3,3,116162,116162,116165,0,3,0
33260,6,1,116168,116168,116169,0,1,3
33261,2,1,116170,116170,116171,0,1,1
33262,1,3,116171,116171,116174,0,3,0
33263,4,3,116175,116175,116178,0,3,1
33264,4,3,116179,116179,116182,0,3,1
33265,6,3,116185,116185,116188,0,3,3
33266,4,1,116189,116189,116190,0,1,1
33267,2,1,116191,116191,116192,0,1,1
33268,6,1,116197,116197,116198,0,1,5
33269,6,2,116203,116203,116205,0,2,5
33270,1,2,116204,116205,116207,1,3,0
33271,3,2,116207,116207,116209,0,2,0
33272,5,3,116212,116212,116215,0,3,3
33273,4,1,116216,116216,116217,0,1,1
33274,3,2,116219,116219,116221,0,2,2
33275,1,2,116220,116221,116223,1,3,0
33276,5,3,116225,116225,116228,0,3,2
33277,1,2,116226,116228,116230,2,4,0
33278,4,3,116230,116230,116233,0,3,0
33279,1,1,116231,116233,116234,2,3,0
33280,4,2,116235,116235,116237,0,2,1
33281,2,1,116237,116237,116238,0,1,0
33282,5,3,116242,116242,116245,0,3,4
33283,4,1,116246,116246,116247,0,1,1
33284,5,3,116251,116251,116254,0,3,4
33285,3,3,116254,116254,116257,0,3,0
33286,1,2,116255,116257,116259,2,4,0
33287,6,1,116261,116261,116262,0,1,2
33288,6,3,116267,116267,116270,0,3,5
33289,4,1,116271,116271,116272,0,1,1
33290,4,2,116275,116275,116277,0,2,3
33291,3,3,116278,116278,116281,0,3,1
33292,4,1,116282,116282,116283,0,1,1
33293,1,1,116283,116283,116284,0,1,0
33294,5,1,116288,116288,116289,0,1,4
33295,1,3,116289,116289,116292,0,3,0
33296,2,2,116291,116292,116294,1,3,0
33297,1,3,116292,116294,116297,2,5,0
33298,2,2,116294,116297,116299,3,5,0
33299,1,1,116295,116299,116300,4,5,0
33300,4,3,116299,116300,116303,1,4,0
33301,5,2,116304,116304,116306,0,2,1
33302,6,1,116310,116310,116311,0,1,4
33303,4,3,116314,116314,116317,0,3,3
33304,6,3,116320,116320,116323,0,3,3
33305,6,1,116326,116326,116327,0,1,3
33306,1,3,116327,116327,116330,0,3,0
33307,4,3,116331,116331,116334,0,3,1
33308,3,2,116334,116334,116336,0,2,0
33309,3,1,116337,116337,116338,0,1,1
33310,4,2,116341,116341,116343,0,2,3
33311,3,1,116344,116344,116345,0,1,1
33312,5,1,116349,116349,116350,0,1,4
33313,1,1,116350,116350,116351,0,1,0
33314,1,3,116351,116351,116354,0,3,0
33315,4,2,116355,116355,116357,0,2,1
33316,3,1,116358,116358,116359,0,1,1
33317,4,3,116362,116362,116365,0,3,3
33318,1,3,116363,116365,116368,2,5,0
33319,1,2,116364,116368,116370,4,6,0
33320,2,2,116366,116370,116372,4,6,0
33321,4,1,116370,116372,116373,2,3,0
33322,4,1,116374,116374,116375,0,1,1
33323,4,3,116378,116378,116381,0,3,3
33324,5,2,116383,116383,116385,0,2,2
33325,6,3,116389,116389,116392,0,3,4
33326,1,1,116390,116392,116393,2,3,0
33327,5,3,116395,116395,116398,0,3,2
33328,1,1,116396,116398,116399,2,3,0
33329,3,2,116399,116399,116401,0,2,0
33330,2,1,116401,116401,116402,0,1,0
33331,1,2,116402,116402,116404,0,2,0
33332,2,2,116404,116404,116406,0,2,0
33333,4,3,116408,116408,116411,0,3,2
33334,6,1,116414,116414,116415,0,1,3
33335,6,1,116420,116420,116421,0,1,5
33336,2,3,116422,116422,116425,0,3,1
33337,5,2,116427,116427,116429,0,2,2
33338,1,1,116428,116429,116430,1,2,0
33339,2,3,116430,116430,116433,0,3,0
33340,4,2,116434,116434,116436,0,2,1
33341,4,1,116438,116438,116439,0,1,2
33342,6,2,116444,116444,116446,0,2,5
33343,4,3,116448,116448,116451,0,3,2
33344,1,3,116449,116451,116454,2,5,0
33345,3,1,116452,116454,116455,2,3,0
33346,1,3,116453,116455,116458,2,5,0
33347,6,1,116459,116459,116460,0,1,1
33348,2,1,116461,116461,116462,0,1,1
33349,2,3,116463,116463,116466,0,3,1
33350,4,3,116467,116467,116470,0,3,1
33351,2,1,116469,116470,116471,1,2,0
33352,1,1,116470,116471,116472,1,2,0
33353,4,1,116474,116474,116475,0,1,2
33354,6,1,116480,116480,116481,0,1,5
33355,6,1,116486,116486,116487,0,1,5
33356,1,3,116487,116487,116490,0,3,0
33357,5,2,116492,116492,116494,0,2,2
33358,6,3,116498,116498,116501,0,3,4
33359,5,2,116503,116503,116505,0,2,2
33360,4,3,116507,116507,116510,0,3,2
33361,5,2,116512,116512,116514,0,2,2
33362,2,3,116514,116514,116517,0,3,0
33363,3,2,116517,116517,116519,0,2,0
33364,2,3,116519,116519,116522,0,3,0
33365,6,1,116525,116525,116526,0,1,3
33366,4,3,116529,116529,116532,0,3,3
33367,4,3,116533,116533,116536,0,3,1
33368,3,1,116536,116536,116537,0,1,0
33369,2,3,116538,116538,116541,0,3,1
33370,3,3,116541,116541,116544,0,3,0
33371,4,3,116545,116545,116548,0,3,1
33372,5,1,116550,116550,116551,0,1,2
33373,6,3,116556,116556,116559,0,3,5
33374,1,3,116557,116559,116562,2,5,0
33375,3,3,116560,116562,116565,2,5,0
33376,3,3,116563,116565,116568,2,5,0
33377,4,1,116567,116568,116569,1,2,0
33378,1,1,116568,116569,116570,1,2,0
33379,3,2,116571,116571,116573,0,2,1
33380,4,1,116575,116575,116576,0,1,2
33381,2,1,116577,116577,116578,0,1,1
33382,3,1,116580,116580,116581,0,1,2
33383,6,1,116586,116586,116587,0,1,5
33384,2,1,116588,116588,116589,0,1,1
33385,5,3,116593,116593,116596,0,3,4
33386,2,1,116595,116596,116597,1,2,0
33387,1,2,116596,116597,116599,1,3,0
33388,6,1,116602,116602,116603,0,1,3
33389,5,3,116607,116607,116610,0,3,4
33390,2,3,116609,116610,116613,1,4,0
33391,5,3,116614,116614,116617,0,3,1
33392,6,2,116620,116620,116622,0,2,3
33393,6,2,116626,116626,116628,0,2,4
33394,4,3,116630,116630,116633,0,3,2
33395,2,3,116632,116633,116636,1,4,0
33396,2,2,116634,116636,116638,2,4,0
33397,3,1,116637,116638,116639,1,2,0
33398,4,2,116641,116641,116643,0,2,2
33399,4,2,116645,116645,116647,0,2,2
33400,1,2,116646,116647,116649,1,3,0
33401,5,1,116651,116651,116652,0,1,2
33402,6,3,116657,116657,116660,0,3,5
33403,1,3,116658,116660,116663,2,5,0
33404,5,1,116663,116663,116664,0,1,0
33405,6,2,116669,116669,116671,0,2,5
33406,5,1,116674,116674,116675,0,1,3
33407,4,3,116678,116678,116681,0,3,3
33408,4,3,116682,116682,116685,0,3,1
33409,5,1,116687,116687,116688,0,1,2
33410,3,2,116690,116690,116692,0,2,2
33411,4,1,116694,116694,116695,0,1,2
33412,5,1,116699,116699,116700,0,1,4
33413,2,1,116701,116701,116702,0,1,1
33414,1,3,116702,116702,116705,0,3,0
33415,4,2,116706,116706,116708,0,2,1
33416,3,1,116709,116709,116710,0,1,1
33417,6,3,116715,116715,116718,0,3,5
33418,4,3,116719,116719,116722,0,3,1
33419,6,3,116725,116725,116728,0,3,3
33420,4,2,116729,116729,116731,0,2,1
33421,5,3,116734,116734,116737,0,3,3
33422,3,1,116737,116737,116738,0,1,0
33423,5,1,116742,116742,116743,0,1,4
33424,2,3,116744,116744,116747,0,3,1
33425,3,3,116747,116747,116750,0,3,0
33426,1,3,116748,116750,116753,2,5,0
33427,3,2,116751,116753,116755,2,4,0
33428,6,3,116757,116757,116760,0,3,2
33429,1,2,116758,116760,116762,2,4,0
33430,6,3,116764,116764,116767,0,3,2
33431,4,3,116768,116768,116771,0,3,1
33432,3,1,116771,116771,116772,0,1,0
33433,2,1,116773,116773,116774,0,1,1
33434,2,2,116775,116775,116777,0,2,1
33435,3,2,116778,116778,116780,0,2,1
33436,2,2,116780,116780,116782,0,2,0
33437,3,1,116783,116783,116784,0,1,1
33438,2,1,116785,116785,116786,0,1,1
33439,3,1,116788,116788,116789,0,1,2
33440,6,3,116794,116794,116797,0,3,5
33441,4,2,116798,116798,116800,0,2,1
33442,1,1,116799,116800,116801,1,2,0
33443,1,3,116800,116801,116804,1,4,0
33444,5,2,116805,116805,116807,0,2,1
33445,3,2,116808,116808,116810,0,2,1
33446,4,3,116812,116812,116815,0,3,2
33447,3,1,116815,116815,116816,0,1,0
33448,2,3,116817,116817,116820,0,3,1
33449,4,1,116821,116821,116822,0,1,1
33450,1,1,116822,116822,116823,0,1,0
33451,5,3,116827,116827,116830,0,3,4
33452,2,2,116829,116830,116832,1,3,0
33453,1,3,116830,116832,116835,2,5,0
33454,5,1,116835,116835,116836,0,1,0
33455,1,1,116836,116836,116837,0,1,0
33456,2,2,116838,116838,116840,0,2,1
33457,6,3,116844,116844,116847,0,3,4
33458,6,1,116850,116850,116851,0,1,3
33459,5,2,116855,116855,116857,0,2,4
33460,4,3,116859,116859,116862,0,3,2
33461,3,1,116862,116862,116863,0,1,0
33462,6,2,116868,116868,116870,0,2,5
33463,2,3,116870,116870,116873,0,3,0
33464,1,1,116871,116873,116874,2,3,0
33465,3,2,116874,116874,116876,0,2,0
33466,5,1,116879,116879,116880,0,1,3
33467,3,3,116882,116882,116885,0,3,2
33468,2,2,116884,116885,116887,1,3,0
33469,4,1,116888,116888,116889,0,1,1
33470,6,2,116894,116894,116896,0,2,5
33471,5,2,116899,116899,116901,0,2,3
33472,3,2,116902,116902,116904,0,2,1
33473,5,2,116907,116907,116909,0,2,3
33474,6,3,116913,116913,116916,0,3,4
33475,5,1,116918,116918,116919,0,1,2
33476,4,3,116922,116922,116925,0,3,3
33477,2,1,116924,116925,116926,1,2,0
33478,4,2,116928,116928,116930,0,2,2
33479,2,1,116930,116930,116931,0,1,0
33480,3,3,116933,116933,116936,0,3,2
33481,1,2,116934,116936,116938,2,4,0
33482,5,1,116939,116939,116940,0,1,1
33483,6,1,116945,116945,116946,0,1,5
33484,1,2,116946,116946,116948,0,2,0
33485,3,2,116949,116949,116951,0,2,1
33486,2,3,116951,116951,116954,0,3,0
33487,3,2,116954,116954,116956,0,2,0
33488,3,1,116957,116957,116958,0,1,1
33489,1,1,116958,116958,116959,0,1,0
33490,6,2,116964,116964,116966,0,2,5
33491,1,2,116965,116966,116968,1,3,0
33492,5,2,116970,116970,116972,0,2,2
33493,2,2,116972,116972,116974,0,2,0
33494,4,3,116976,116976,116979,0,3,2
33495,6,3,116982,116982,116985,0,3,3
33496,6,2,116988,116988,116990,0,2,3
33497,2,3,116990,116990,116993,0,3,0
33498,6,3,116996,116996,116999,0,3,3
33499,2,1,116998,116999,117000,1,2,0
33500,3,3,117001,117001,117004,0,3,1
33501,6,3,117007,117007,117010,0,3,3
33502,4,3,117011,117011,117014,0,3,1
33503,1,2,117012,117014,117016,2,4,0
33504,2,2,117014,117016,117018,2,4,0
33505,6,2,117020,117020,117022,0,2,2
33506,3,1,117023,117023,117024,0,1,1
33507,3,1,117026,117026,117027,0,1,2
33508,1,3,117027,117027,117030,0,3,0
33509,3,2,117030,117030,117032,0,2,0
33510,3,2,117033,117033,117035,0,2,1
33511,1,3,117034,117035,117038,1,4,0
33512,5,1,117039,117039,117040,0,1,1
33513,6,3,117045,117045,117048,0,3,5
33514,6,3,117051,117051,117054,0,3,3
33515,1,3,117052,117054,117057,2,5,0
33516,6,3,117058,117058,117061,0,3,1
33517,6,1,117064,117064,117065,0,1,3
33518,4,1,117068,117068,117069,0,1,3
33519,2,1,117070,117070,117071,0,1,1
33520,5,1,117075,117075,117076,0,1,4
33521,3,1,117078,117078,117079,0,1,2
33522,2,3,117080,117080,117083,0,3,1
33523,6,2,117086,117086,117088,0,2,3
33524,2,1,117088,117088,117089,0,1,0
33525,3,2,117091,117091,117093,0,2,2
33526,1,3,117092,117093,117096,1,4,0
33527,3,3,117095,117096,117099,1,4,0
33528,6,2,117101,117101,117103,0,2,2
33529,4,3,117105,117105,117108,0,3,2
33530,3,3,117108,117108,117111,0,3,0
33531,6,1,117114,117114,117115,0,1,3
33532,1,3,117115,117115,117118,0,3,0
33533,6,3,117121,117121,117124,0,3,3
33534,1,1,117122,117124,117125,2,3,0
33535,5,3,117127,117127,117130,0,3,2
33536,2,2,117129,117130,117132,1,3,0
33537,4,3,117133,117133,117136,0,3,1
33538,6,2,117139,117139,117141,0,2,3
33539,5,2,117144,117144,117146,0,2,3
33540,1,3,117145,117146,117149,1,4,0
33541,1,3,117146,117149,117152,3,6,0
33542,1,1,117147,117152,117153,5,6,0
33543,4,1,117151,117153,117154,2,3,0
33544,2,3,117153,117154,117157,1,4,0
33545,3,3,117156,117157,117160,1,4,0
33546,2,1,117158,117160,117161,2,3,0
33547,1,2,117159,117161,117163,2,4,0
33548,6,2,117165,117165,117167,0,2,2
33549,3,2,117168,117168,117170,0,2,1
33550,6,1,117174,117174,117175,0,1,4
33551,5,3,117179,117179,117182,0,3,4
33552,1,3,117180,117182,117185,2,5,0
33553,6,2,117186,117186,117188,0,2,1
33554,1,1,117187,117188,117189,1,2,0
33555,2,1,117189,117189,117190,0,1,0
33556,5,3,117194,117194,117197,0,3,4
33557,4,1,117198,117198,117199,0,1,1
33558,4,3,117202,117202,117205,0,3,3
33559,4,2,117206,117206,117208,0,2,1
33560,1,1,117207,117208,117209,1,2,0
33561,2,3,117209,117209,117212,0,3,0
33562,5,1,117214,117214,117215,0,1,2
33563,6,3,117220,117220,117223,0,3,5
33564,2,1,117222,117223,117224,1,2,0
33565,4,2,117226,117226,117228,0,2,2
33566,4,1,117230,117230,117231,0,1,2
33567,5,1,117235,117235,117236,0,1,4
33568,2,2,117237,117237,117239,0,2,1
33569,1,1,117238,117239,117240,1,2,0
33570,4,2,117242,117242,117244,0,2,2
33571,1,1,117243,117244,117245,1,2,0
33572,1,2,117244,117245,117247,1,3,0
33573,3,2,117247,117247,117249,0,2,0
33574,2,2,117249,117249,117251,0,2,0
33575,5,3,117254,117254,117257,0,3,3
33576,4,1,117258,117258,117259,0,1,1
33577,1,2,117259,117259,117261,0,2,0
33578,4,2,117263,117263,117265,0,2,2
33579,3,3,117266,117266,117269,0,3,1
33580,6,3,117272,117272,117275,0,3,3
33581,1,3,117273,117275,117278,2,5,0
33582,5,1,117278,117278,117279,0,1,0
33583,3,3,117281,117281,117284,0,3,2
33584,1,2,117282,117284,117286,2,4,0
33585,6,3,117288,117288,117291,0,3,2
33586,6,1,117294,117294,117295,0,1,3
33587,4,1,117298,117298,117299,0,1,3
33588,1,2,117299,117299,117301,0,2,0
33589,5,2,117304,117304,117306,0,2,3
33590,3,2,117307,117307,117309,0,2,1
33591,3,2,117310,117310,117312,0,2,1
33592,1,3,117311,117312,117315,1,4,0
33593,5,3,117316,117316,117319,0,3,1
33594,1,1,117317,117319,117320,2,3,0
33595,2,2,117319,117320,117322,1,3,0
33596,3,1,117322,117322,117323,0,1,0
33597,6,1,117328,117328,117329,0,1,5
33598,6,1,117334,117334,117335,0,1,5
33599,2,3,117336,117336,117339,0,3,1
33600,6,1,117342,117342,117343,0,1,3
33601,4,2,117346,117346,117348,0,2,3
33602,1,3,117347,117348,117351,1,4,0
33603,4,2,117351,117351,117353,0,2,0
33604,1,2,117352,117353,117355,1,3,0
33605,3,3,117355,117355,117358,0,3,0
33606,1,1,117356,117358,117359,2,3,0
33607,4,2,117360,117360,117362,0,2,1
33608,1,2,117361,117362,117364,1,3,0
33609,6,1,117367,117367,117368,0,1,3
33610,4,1,117371,117371,117372,0,1,3
33611,1,3,117372,117372,117375,0,3,0
33612,2,1,117374,117375,117376,1,2,0
33613,4,3,117378,117378,117381,0,3,2
33614,5,1,117383,117383,117384,0,1,2
33615,3,2,117386,117386,117388,0,2,2
33616,6,2,117392,117392,117394,0,2,4
33617,4,2,117396,117396,117398,0,2,2
33618,3,3,117399,117399,117402,0,3,1
33619,3,2,117402,117402,117404,0,2,0
33620,1,3,117403,117404,117407,1,4,0
33621,2,1,117405,117407,117408,2,3,0
33622,5,3,117410,117410,117413,0,3,2
33623,1,1,117411,117413,117414,2,3,0
33624,3,3,117414,117414,117417,0,3,0
33625,2,2,117416,117417,117419,1,3,0
33626,5,3,117421,117421,117424,0,3,2
33627,2,3,117423,117424,117427,1,4,0
33628,2,3,117425,117427,117430,2,5,0
33629,3,3,117428,117430,117433,2,5,0
33630,2,1,117430,117433,117434,3,4,0
33631,6,1,117436,117436,117437,0,1,2
33632,5,1,117441,117441,117442,0,1,4
33633,1,3,117442,117442,117445,0,3,0
33634,4,3,117446,117446,117449,0,3,1
33635,5,1,117451,117451,117452,0,1,2
33636,5,1,117456,117456,117457,0,1,4
33637,3,1,117459,117459,117460,0,1,2
33638,1,2,117460,117460,117462,0,2,0
33639,6,3,117466,117466,117469,0,3,4
33640,6,1,117472,117472,117473,0,1,3
33641,2,1,117474,117474,117475,0,1,1
33642,2,1,117476,117476,117477,0,1,1
33643,5,2,117481,117481,117483,0,2,4
33644,2,3,117483,117483,117486,0,3,0
33645,4,3,117487,117487,117490,0,3,1
33646,1,2,117488,117490,117492,2,4,0
33647,5,1,117493,117493,117494,0,1,1
33648,3,1,117496,117496,117497,0,1,2
33649,6,2,117502,117502,117504,0,2,5
33650,6,1,117508,117508,117509,0,1,4
33651,1,3,117509,117509,117512,0,3,0
33652,1,1,117510,117512,117513,2,3,0
33653,4,3,117514,117514,117517,0,3,1
33654,2,1,117516,117517,117518,1,2,0
33655,6,3,117522,117522,117525,0,3,4
33656,2,3,117524,117525,117528,1,4,0
33657,1,3,117525,117528,117531,3,6,0
33658,5,3,117530,117531,117534,1,4,0
33659,6,1,117536,117536,117537,0,1,2
33660,1,2,117537,117537,117539,0,2,0
33661,3,1,117540,117540,117541,0,1,1
33662,1,1,117541,117541,117542,0,1,0
33663,3,2,117544,117544,117546,0,2,2
33664,5,2,117549,117549,117551,0,2,3
33665,1,3,117550,117551,117554,1,4,0
33666,1,1,117551,117554,117555,3,4,0
33667,1,1,117552,117555,117556,3,4,0
33668,4,2,117556,117556,117558,0,2,0
33669,2,2,117558,117558,117560,0,2,0
33670,6,3,117564,117564,117567,0,3,4
33671,3,1,117567,117567,117568,0,1,0
33672,3,3,117570,117570,117573,0,3,2
33673,6,1,117576,117576,117577,0,1,3
33674,5,1,117581,117581,117582,0,1,4
33675,2,2,117583,117583,117585,0,2,1
33676,5,2,117588,117588,117590,0,2,3
33677,4,3,117592,117592,117595,0,3,2
33678,4,2,117596,117596,117598,0,2,1
33679,4,2,117600,117600,117602,0,2,2
33680,3,1,117603,117603,117604,0,1,1
33681,1,1,117604,117604,117605,0,1,0
33682,3,2,117607,117607,117609,0,2,2
33683,4,1,117611,117611,117612,0,1,2
33684,4,2,117615,117615,117617,0,2,3
33685,3,3,117618,117618,117621,0,3,1
33686,1,2,117619,117621,117623,2,4,0
33687,6,2,117625,117625,117627,0,2,2
33688,6,2,117631,117631,117633,0,2,4
33689,3,1,117634,117634,117635,0,1,1
33690,5,1,117639,117639,117640,0,1,4
33691,4,2,117643,117643,117645,0,2,3
33692,5,3,117648,117648,117651,0,3,3
33693,3,1,117651,117651,117652,0,1,0
33694,3,1,117654,117654,117655,0,1,2
33695,5,3,117659,117659,117662,0,3,4
33696,4,2,117663,117663,117665,0,2,1
33697,6,3,117669,117669,117672,0,3,4
33698,2,3,117671,117672,117675,1,4,0
33699,6,2,117677,117677,117679,0,2,2
33700,3,1,117680,117680,117681,0,1,1
33701,4,1,117684,117684,117685,0,1,3
33702,1,3,117685,117685,117688,0,3,0
33703,5,1,117690,117690,117691,0,1,2
33704,1,2,117691,117691,117693,0,2,0
33705,6,2,117697,117697,117699,0,2,4
33706,3,2,117700,117700,117702,0,2,1
33707,5,1,117705,117705,117706,0,1,3
33708,3,1,117708,117708,117709,0,1,2
33709,1,1,117709,117709,117710,0,1,0
33710,1,2,117710,117710,117712,0,2,0
33711,6,2,117716,117716,117718,0,2,4
33712,1,3,117717,117718,117721,1,4,0
33713,4,3,117721,117721,117724,0,3,0
33714,3,1,117724,117724,117725,0,1,0
33715,6,3,117730,117730,117733,0,3,5
33716,2,3,117732,117733,117736,1,4,0
33717,3,2,117735,117736,117738,1,3,0
33718,3,3,117738,117738,117741,0,3,0
33719,5,3,117743,117743,117746,0,3,2
33720,3,2,117746,117746,117748,0,2,0
33721,1,2,117747,117748,117750,1,3,0
33722,5,3,117752,117752,117755,0,3,2
33723,6,2,117758,117758,117760,0,2,3
33724,3,2,117761,117761,117763,0,2,1
33725,6,1,117767,117767,117768,0,1,4
33726,1,3,117768,117768,117771,0,3,0
33727,5,2,117773,117773,117775,0,2,2
33728,1,2,117774,117775,117777,1,3,0
33729,3,3,117777,117777,117780,0,3,0
33730,6,2,117783,117783,117785,0,2,3
33731,1,1,117784,117785,117786,1,2,0
33732,2,2,117786,117786,117788,0,2,0
33733,2,2,117788,117788,117790,0,2,0
33734,5,2,117793,117793,117795,0,2,3
33735,5,2,117798,117798,117800,0,2,3
33736,5,3,117803,117803,117806,0,3,3
33737,1,3,117804,117806,117809,2,5,0
33738,1,2,117805,117809,117811,4,6,0
33739,5,1,117810,117811,117812,1,2,0
33740,4,1,117814,117814,117815,0,1,2
33741,6,2,117820,117820,117822,0,2,5
33742,2,1,117822,117822,117823,0,1,0
33743,6,1,117828,117828,117829,0,1,5
33744,2,2,117830,117830,117832,0,2,1
33745,3,2,117833,117833,117835,0,2,1
33746,1,1,117834,117835,117836,1,2,0
33747,5,3,117839,117839,117842,0,3,3
33748,3,2,117842,117842,117844,0,2,0
33749,6,3,117848,117848,117851,0,3,4
33750,3,2,117851,117851,117853,0,2,0
33751,4,1,117855,117855,117856,0,1,2
33752,2,1,117857,117857,117858,0,1,1
33753,6,2,117863,117863,117865,0,2,5
33754,6,1,117869,117869,117870,0,1,4
33755,4,3,117873,117873,117876,0,3,3
33756,5,2,117878,117878,117880,0,2,2
33757,6,2,117884,117884,117886,0,2,4
33758,5,2,117889,117889,117891,0,2,3
33759,3,3,117892,117892,117895,0,3,1
33760,1,2,117893,117895,117897,2,4,0
33761,3,2,117896,117897,117899,1,3,0
33762,4,3,117900,117900,117903,0,3,1
33763,6,3,117906,117906,117909,0,3,3
33764,3,2,117909,117909,117911,0,2,0
33765,2,3,117911,117911,117914,0,3,0
33766,1,3,117912,117914,117917,2,5,0
33767,6,2,117918,117918,117920,0,2,1
33768,5,1,117923,117923,117924,0,1,3
33769,2,1,117925,117925,117926,0,1,1
33770,5,2,117930,117930,117932,0,2,4
33771,3,3,117933,117933,117936,0,3,1
33772,1,2,117934,117936,117938,2,4,0
33773,6,1,117940,117940,117941,0,1,2
33774,4,2,117944,117944,117946,0,2,3
33775,4,1,117948,117948,117949,0,1,2
33776,4,2,117952,117952,117954,0,2,3
33777,3,3,117955,117955,117958,0,3,1
33778,3,2,117958,117958,117960,0,2,0
33779,1,3,117959,117960,117963,1,4,0
33780,5,3,117964,117964,117967,0,3,1
33781,3,1,117967,117967,117968,0,1,0
33782,1,2,117968,117968,117970,0,2,0
33783,6,1,117974,117974,117975,0,1,4
33784,1,3,117975,117975,117978,0,3,0
33785,2,2,117977,117978,117980,1,3,0
33786,3,3,117980,117980,117983,0,3,0
33787,6,1,117986,117986,117987,0,1,3
33788,3,1,117989,117989,117990,0,1,2
33789,1,3,117990,117990,117993,0,3,0
33790,5,2,117995,117995,117997,0,2,2
33791,5,2,118000,118000,118002,0,2,3
33792,3,2,118003,118003,118005,0,2,1
33793,2,2,118005,118005,118007,0,2,0
33794,5,2,118010,118010,118012,0,2,3
33795,4,3,118014,118014,118017,0,3,2
33796,5,3,118019,118019,118022,0,3,2
33797,5,1,118024,118024,118025,0,1,2
33798,2,2,118026,118026,118028,0,2,1
33799,1,1,118027,118028,118029,1,2,0
33800,2,1,118029,118029,118030,0,1,0
33801,2,1,118031,118031,118032,0,1,1
33802,4,3,118035,118035,118038,0,3,3
33803,5,1,118040,118040,118041,0,1,2
33804,2,3,118042,118042,118045,0,3,1
33805,1,2,118043,118045,118047,2,4,0
33806,2,1,118045,118047,118048,2,3,0
33807,5,1,118050,118050,118051,0,1,2
33808,6,1,118056,118056,118057,0,1,5
33809,2,3,118058,118058,118061,0,3,1
33810,4,3,118062,118062,118065,0,3,1
33811,6,2,118068,118068,118070,0,2,3
33812,3,3,118071,118071,118074,0,3,1
33813,1,2,118072,118074,118076,2,4,0
33814,2,2,118074,118076,118078,2,4,0
33815,1,2,118075,118078,118080,3,5,0
33816,1,3,118076,118080,118083,4,7,0
33817,1,2,118077,118083,118085,6,8,0
33818,6,2,118083,118085,118087,2,4,0
33819,4,1,118087,118087,118088,0,1,0
33820,1,1,118088,118088,118089,0,1,0
33821,2,2,118090,118090,118092,0,2,1
33822,4,3,118094,118094,118097,0,3,2
33823,6,1,118100,118100,118101,0,1,3
33824,2,2,118102,118102,118104,0,2,1
33825,6,1,118108,118108,118109,0,1,4
33826,1,1,118109,118109,118110,0,1,0
33827,6,3,118115,118115,118118,0,3,5
33828,6,3,118121,118121,118124,0,3,3
33829,4,3,118125,118125,118128,0,3,1
33830,2,3,118127,118128,118131,1,4,0
33831,5,3,118132,118132,118135,0,3,1
33832,6,2,118138,118138,118140,0,2,3
33833,2,1,118140,118140,118141,0,1,0
33834,3,2,118143,118143,118145,0,2,2
33835,6,1,118149,118149,118150,0,1,4
33836,5,2,118154,118154,118156,0,2,4
33837,4,3,118158,118158,118161,0,3,2
33838,1,3,118159,118161,118164,2,5,0
33839,3,2,118162,118164,118166,2,4,0
33840,2,1,118164,118166,118167,2,3,0
33841,2,1,118166,118167,118168,1,2,0
33842,5,3,118171,118171,118174,0,3,3
33843,3,2,118174,118174,118176,0,2,0
33844,5,1,118179,118179,118180,0,1,3
33845,6,2,118185,118185,118187,0,2,5
33846,6,3,118191,118191,118194,0,3,4
33847,6,2,118197,118197,118199,0,2,3
33848,2,3,118199,118199,118202,0,3,0
33849,5,3,118204,118204,118207,0,3,2
33850,3,1,118207,118207,118208,0,1,0
33851,3,2,118210,118210,118212,0,2,2
33852,4,3,118214,118214,118217,0,3,2
33853,5,2,118219,118219,118221,0,2,2
33854,6,1,118225,118225,118226,0,1,4
33855,5,1,118230,118230,118231,0,1,4
33856,4,3,118234,118234,118237,0,3,3
33857,1,2,118235,118237,118239,2,4,0
33858,3,2,118238,118239,118241,1,3,0
33859,1,3,118239,118241,118244,2,5,0
33860,6,2,118245,118245,118247,0,2,1
33861,3,2,118248,118248,118250,0,2,1
33862,6,3,118254,118254,118257,0,3,4
33863,6,1,118260,118260,118261,0,1,3
33864,5,2,118265,118265,118267,0,2,4
33865,4,3,118269,118269,118272,0,3,2
33866,1,1,118270,118272,118273,2,3,0
33867,2,2,118272,118273,118275,1,3,0
33868,5,1,118277,118277,118278,0,1,2
33869,6,3,118283,118283,118286,0,3,5
33870,1,3,118284,118286,118289,2,5,0
33871,4,1,118288,118289,118290,1,2,0
33872,2,1,118290,118290,118291,0,1,0
33873,2,2,118292,118292,118294,0,2,1
33874,3,2,118295,118295,118297,0,2,1
33875,3,2,118298,118298,118300,0,2,1
33876,1,3,118299,118300,118303,1,4,0
33877,4,3,118303,118303,118306,0,3,0
33878,3,2,118306,118306,118308,0,2,0
33879,4,3,118310,118310,118313,0,3,2
33880,4,2,118314,118314,118316,0,2,1
33881,2,3,118316,118316,118319,0,3,0
33882,2,2,118318,118319,118321,1,3,0
33883,3,2,118321,118321,118323,0,2,0
33884,2,1,118323,118323,118324,0,1,0
33885,6,1,118329,118329,118330,0,1,5
33886,2,1,118331,118331,118332,0,1,1
33887,4,2,118335,118335,118337,0,2,3
33888,3,1,118338,118338,118339,0,1,1
33889,4,1,118342,118342,118343,0,1,3
33890,1,3,118343,118343,118346,0,3,0
33891,2,2,118345,118346,118348,1,3,0
33892,2,3,118347,118348,118351,1,4,0
33893,2,2,118349,118351,118353,2,4,0
33894,1,1,118350,118353,118354,3,4,0
33895,2,3,118352,118354,118357,2,5,0
33896,1,3,118353,118357,118360,4,7,0
33897,2,1,118355,118360,118361,5,6,0
33898,6,3,118361,118361,118364,0,3,0
33899,6,2,118367,118367,118369,0,2,3
33900,2,2,118369,118369,118371,0,2,0
33901,1,3,118370,118371,118374,1,4,0
33902,3,1,118373,118374,118375,1,2,0
33903,6,3,118379,118379,118382,0,3,4
33904,4,1,118383,118383,118384,0,1,1
33905,1,3,118384,118384,118387,0,3,0
33906,1,2,118385,118387,118389,2,4,0
33907,3,2,118388,118389,118391,1,3,0
33908,2,2,118390,118391,118393,1,3,0
33909,2,1,118392,118393,118394,1,2,0
33910,2,1,118394,118394,118395,0,1,0
33911,6,3,118400,118400,118403,0,3,5
33912,1,3,118401,118403,118406,2,5,0
33913,5,2,118406,118406,118408,0,2,0
33914,2,1,118408,118408,118409,0,1,0
33915,6,3,118414,118414,118417,0,3,5
33916,2,2,118416,118417,118419,1,3,0
33917,3,1,118419,118419,118420,0,1,0
33918,2,1,118421,118421,118422,0,1,1
33919,1,1,118422,118422,118423,0,1,0
33920,6,2,118428,118428,118430,0,2,5
33921,1,2,118429,118430,118432,1,3,0
33922,3,1,118432,118432,118433,0,1,0
33923,3,3,118435,118435,118438,0,3,2
33924,5,3,118440,118440,118443,0,3,2
33925,4,3,118444,118444,118447,0,3,1
33926,2,3,118446,118447,118450,1,4,0
33927,3,1,118449,118450,118451,1,2,0
33928,5,3,118454,118454,118457,0,3,3
33929,6,2,118460,118460,118462,0,2,3
33930,1,2,118461,118462,118464,1,3,0
33931,1,2,118462,118464,118466,2,4,0
33932,5,3,118467,118467,118470,0,3,1
33933,5,1,118472,118472,118473,0,1,2
33934,4,3,118476,118476,118479,0,3,3
33935,2,2,118478,118479,118481,1,3,0
33936,5,1,118483,118483,118484,0,1,2
33937,4,3,118487,118487,118490,0,3,3
33938,4,1,118491,118491,118492,0,1,1
33939,1,3,118492,118492,118495,0,3,0
33940,3,3,118495,118495,118498,0,3,0
33941,1,1,118496,118498,118499,2,3,0
33942,6,1,118502,118502,118503,0,1,3
33943,3,1,118505,118505,118506,0,1,2
33944,6,2,118511,118511,118513,0,2,5
33945,3,2,118514,118514,118516,0,2,1
33946,5,2,118519,118519,118521,0,2,3
33947,4,3,118523,118523,118526,0,3,2
33948,2,3,118525,118526,118529,1,4,0
33949,6,1,118531,118531,118532,0,1,2
33950,1,1,118532,118532,118533,0,1,0
33951,2,1,118534,118534,118535,0,1,1
33952,4,1,118538,118538,118539,0,1,3
33953,1,1,118539,118539,118540,0,1,0
33954,1,1,118540,118540,118541,0,1,0
33955,6,3,118546,118546,118549,0,3,5
33956,3,1,118549,118549,118550,0,1,0
33957,1,3,118550,118550,118553,0,3,0
33958,4,3,118554,118554,118557,0,3,1
33959,6,1,118560,118560,118561,0,1,3
33960,1,1,118561,118561,118562,0,1,0
33961,2,3,118563,118563,118566,0,3,1
33962,3,3,118566,118566,118569,0,3,0
33963,5,1,118571,118571,118572,0,1,2
33964,2,3,118573,118573,118576,0,3,1
33965,4,3,118577,118577,118580,0,3,1
33966,6,2,118583,118583,118585,0,2,3
33967,3,2,118586,118586,118588,0,2,1
33968,6,2,118592,118592,118594,0,2,4
33969,5,3,118597,118597,118600,0,3,3
33970,6,3,118603,118603,118606,0,3,3
33971,5,1,118608,118608,118609,0,1,2
33972,4,1,118612,118612,118613,0,1,3
33973,3,2,118615,118615,118617,0,2,2
33974,2,2,118617,118617,118619,0,2,0
33975,3,3,118620,118620,118623,0,3,1
33976,6,3,118626,118626,118629,0,3,3
33977,1,1,118627,118629,118630,2,3,0
33978,5,1,118632,118632,118633,0,1,2
33979,5,2,118637,118637,118639,0,2,4
33980,5,2,118642,118642,118644,0,2,3
33981,1,1,118643,118644,118645,1,2,0
33982,5,1,118648,118648,118649,0,1,3
33983,1,2,118649,118649,118651,0,2,0
33984,4,2,118653,118653,118655,0,2,2
33985,6,1,118659,118659,118660,0,1,4
33986,2,1,118661,118661,118662,0,1,1
33987,2,1,118663,118663,118664,0,1,1
33988,2,3,118665,118665,118668,0,3,1
33989,4,3,118669,118669,118672,0,3,1
33990,4,3,118673,118673,118676,0,3,1
33991,5,1,118678,118678,118679,0,1,2
33992,1,2,118679,118679,118681,0,2,0
33993,5,2,118684,118684,118686,0,2,3
33994,6,2,118690,118690,118692,0,2,4
33995,4,3,118694,118694,118697,0,3,2
33996,4,3,118698,118698,118701,0,3,1
33997,5,1,118703,118703,118704,0,1,2
33998,6,2,118709,118709,118711,0,2,5
33999,1,3,118710,118711,118714,1,4,0
34000,4,3,118714,118714,118717,0,3,0
34001,2,3,118716,118717,118720,1,4,0
34002,3,2,118719,118720,118722,1,3,0
34003,6,3,118725,118725,118728,0,3,3
34004,6,2,118731,118731,118733,0,2,3
34005,1,3,118732,118733,118736,1,4,0
34006,4,2,118736,118736,118738,0,2,0
34007,3,2,118739,118739,118741,0,2,1
34008,2,2,118741,118741,118743,0,2,0
34009,6,1,118747,118747,118748,0,1,4
34010,2,2,118749,118749,118751,0,2,1
34011,4,1,118753,118753,118754,0,1,2
34012,2,3,118755,118755,118758,0,3,1
34013,4,1,118759,118759,118760,0,1,1
34014,1,2,118760,118760,118762,0,2,0
34015,2,2,118762,118762,118764,0,2,0
34016,3,3,118765,118765,118768,0,3,1
34017,5,3,118770,118770,118773,0,3,2
34018,5,2,118775,118775,118777,0,2,2
34019,1,2,118776,118777,118779,1,3,0
34020,5,2,118781,118781,118783,0,2,2
34021,6,2,118787,118787,118789,0,2,4
34022,6,3,118793,118793,118796,0,3,4
34023,1,2,118794,118796,118798,2,4,0
34024,6,1,118800,118800,118801,0,1,2
34025,3,3,118803,118803,118806,0,3,2
34026,5,1,118808,118808,118809,0,1,2
34027,3,1,118811,118811,118812,0,1,2
34028,5,3,118816,118816,118819,0,3,4
34029,5,2,118821,118821,118823,0,2,2
34030,4,1,118825,118825,118826,0,1,2
34031,1,2,118826,118826,118828,0,2,0
34032,6,1,118832,118832,118833,0,1,4
34033,2,1,118834,118834,118835,0,1,1
34034,1,3,118835,118835,118838,0,3,0
34035,2,2,118837,118838,118840,1,3,0
34036,4,3,118841,118841,118844,0,3,1
34037,3,3,118844,118844,118847,0,3,0
34038,4,3,118848,118848,118851,0,3,1
34039,2,1,118850,118851,118852,1,2,0
34040,1,1,118851,118852,118853,1,2,0
34041,2,2,118853,118853,118855,0,2,0
34042,3,3,118856,118856,118859,0,3,1
34043,4,3,118860,118860,118863,0,3,1
34044,2,2,118862,118863,118865,1,3,0
34045,1,1,118863,118865,118866,2,3,0
34046,1,2,118864,118866,118868,2,4,0
34047,1,2,118865,118868,118870,3,5,0
34048,2,3,118867,118870,118873,3,6,0
34049,1,1,118868,118873,118874,5,6,0
34050,5,1,118873,118874,118875,1,2,0
34051,3,1,118876,118876,118877,0,1,1
34052,3,1,118879,118879,118880,0,1,2
34053,5,2,118884,118884,118886,0,2,4
34054,4,1,118888,118888,118889,0,1,2
34055,6,3,118894,118894,118897,0,3,5
34056,3,2,118897,118897,118899,0,2,0
34057,1,1,118898,118899,118900,1,2,0
34058,3,3,118901,118901,118904,0,3,1
34059,2,3,118903,118904,118907,1,4,0
34060,3,2,118906,118907,118909,1,3,0
34061,6,2,118912,118912,118914,0,2,3
34062,4,3,118916,118916,118919,0,3,2
34063,4,3,118920,118920,118923,0,3,1
34064,3,3,118923,118923,118926,0,3,0
34065,4,2,118927,118927,118929,0,2,1
34066,2,3,118929,118929,118932,0,3,0
34067,6,1,118935,118935,118936,0,1,3
34068,4,2,118939,118939,118941,0,2,3
34069,2,3,118941,118941,118944,0,3,0
34070,3,3,118944,118944,118947,0,3,0
34071,4,2,118948,118948,118950,0,2,1
34072,3,2,118951,118951,118953,0,2,1
34073,6,2,118957,118957,118959,0,2,4
34074,2,2,118959,118959,118961,0,2,0
34075,4,2,118963,118963,118965,0,2,2
34076,4,1,118967,118967,118968,0,1,2
34077,6,2,118973,118973,118975,0,2,5
34078,1,2,118974,118975,118977,1,3,0
34079,1,2,118975,118977,118979,2,4,0
34080,2,2,118977,118979,118981,2,4,0
34081,6,3,118983,118983,118986,0,3,2
34082,5,2,118988,118988,118990,0,2,2
34083,3,1,118991,118991,118992,0,1,1
34084,6,1,118997,118997,118998,0,1,5
34085,5,2,119002,119002,119004,0,2,4
34086,5,2,119007,119007,119009,0,2,3
34087,2,3,119009,119009,119012,0,3,0
34088,1,2,119010,119012,119014,2,4,0
34089,3,1,119013,119014,119015,1,2,0
34090,1,2,119014,119015,119017,1,3,0
34091,1,1,119015,119017,119018,2,3,0
34092,6,3,119021,119021,119024,0,3,3
34093,1,2,119022,119024,119026,2,4,0
34094,2,1,119024,119026,119027,2,3,0
34095,6,3,119030,119030,119033,0,3,3
34096,5,2,119035,119035,119037,0,2,2
34097,4,3,119039,119039,119042,0,3,2
34098,5,3,119044,119044,119047,0,3,2
34099,5,1,119049,119049,119050,0,1,2
34100,4,1,119053,119053,119054,0,1,3
34101,4,3,119057,119057,119060,0,3,3
34102,5,2,119062,119062,119064,0,2,2
34103,3,3,119065,119065,119068,0,3,1
34104,3,1,119068,119068,119069,0,1,0
34105,3,2,119071,119071,119073,0,2,2
34106,2,1,119073,119073,119074,0,1,0
34107,6,3,119079,119079,119082,0,3,5
34108,6,3,119085,119085,119088,0,3,3
34109,4,3,119089,119089,119092,0,3,1
34110,5,1,119094,119094,119095,0,1,2
34111,6,3,119100,119100,119103,0,3,5
34112,1,2,119101,119103,119105,2,4,0
34113,1,3,119102,119105,119108,3,6,0
34114,3,3,119105,119108,119111,3,6,0
34115,2,2,119107,119111,119113,4,6,0
34116,1,2,119108,119113,119115,5,7,0
34117,1,1,119109,119115,119116,6,7,0
34118,6,3,119115,119116,119119,1,4,0
34119,5,2,119120,119120,119122,0,2,1
34120,4,2,119124,119124,119126,0,2,2
34121,4,3,119128,119128,119131,0,3,2
34122,4,2,119132,119132,119134,0,2,1
34123,6,2,119138,119138,119140,0,2,4
34124,4,2,119142,119142,119144,0,2,2
34125,3,1,119145,119145,119146,0,1,1
34126,3,3,119148,119148,119151,0,3,2
34127,6,3,119154,119154,119157,0,3,3
34128,6,2,119160,119160,119162,0,2,3
34129,4,2,119164,119164,119166,0,2,2
34130,1,3,119165,119166,119169,1,4,0
34131,3,3,119168,119169,119172,1,4,0
34132,4,1,119172,119172,119173,0,1,0
34133,4,2,119176,119176,119178,0,2,3
34134,1,2,119177,119178,119180,1,3,0
34135,4,2,119181,119181,119183,0,2,1
34136,5,1,119186,119186,119187,0,1,3
34137,6,2,119192,119192,119194,0,2,5
34138,5,3,119197,119197,119200,0,3,3
34139,1,3,119198,119200,119203,2,5,0
34140,6,3,119204,119204,119207,0,3,1
34141,3,2,119207,119207,119209,0,2,0
34142,4,2,119211,119211,119213,0,2,2
34143,3,3,119214,119214,119217,0,3,1
34144,2,2,119216,119217,119219,1,3,0
34145,2,1,119218,119219,119220,1,2,0
34146,1,2,119219,119220,119222,1,3,0
34147,5,2,119224,119224,119226,0,2,2
34148,3,2,119227,119227,119229,0,2,1
34149,3,1,119230,119230,119231,0,1,1
34150,3,3,119233,119233,119236,0,3,2
34151,5,3,119238,119238,119241,0,3,2
34152,1,1,119239,119241,119242,2,3,0
34153,6,1,119245,119245,119246,0,1,3
34154,1,1,119246,119246,119247,0,1,0
34155,6,1,119252,119252,119253,0,1,5
34156,2,3,119254,119254,119257,0,3,1
34157,2,1,119256,119257,119258,1,2,0
34158,2,1,119258,119258,119259,0,1,0
34159,2,3,119260,119260,119263,0,3,1
34160,1,3,119261,119263,119266,2,5,0
34161,5,2,119266,119266,119268,0,2,0
34162,1,2,119267,119268,119270,1,3,0
34163,4,1,119271,119271,119272,0,1,1
34164,2,1,119273,119273,119274,0,1,1
34165,3,1,119276,119276,119277,0,1,2
34166,5,3,119281,119281,119284,0,3,4
34167,5,3,119286,119286,119289,0,3,2
34168,6,2,119292,119292,119294,0,2,3
34169,3,3,119295,119295,119298,0,3,1
34170,2,3,119297,119298,119301,1,4,0
34171,5,1,119302,119302,119303,0,1,1
34172,5,3,119307,119307,119310,0,3,4
34173,4,3,119311,119311,119314,0,3,1
34174,4,1,119315,119315,119316,0,1,1
34175,6,3,119321,119321,119324,0,3,5
34176,1,2,119322,119324,119326,2,4,0
34177,2,3,119324,119326,119329,2,5,0
34178,3,2,119327,119329,119331,2,4,0
34179,3,3,119330,119331,119334,1,4,0
34180,4,3,119334,119334,119337,0,3,0
34181,6,1,119340,119340,119341,0,1,3
34182,5,1,119345,119345,119346,0,1,4
34183,5,2,119350,119350,119352,0,2,4
34184,2,2,119352,119352,119354,0,2,0
34185,3,2,119355,119355,119357,0,2,1
34186,2,1,119357,119357,119358,0,1,0
34187,1,1,119358,119358,119359,0,1,0
34188,5,2,119363,119363,119365,0,2,4
34189,6,3,119369,119369,119372,0,3,4
34190,6,2,119375,119375,119377,0,2,3
34191,5,2,119380,119380,119382,0,2,3
34192,5,1,119385,119385,119386,0,1,3
34193,5,1,119390,119390,119391,0,1,4
34194,4,2,119394,119394,119396,0,2,3
34195,6,3,119400,119400,119403,0,3,4
34196,2,2,119402,119403,119405,1,3,0
34197,6,1,119408,119408,119409,0,1,3
34198,2,3,119410,119410,119413,0,3,1
34199,3,1,119413,119413,119414,0,1,0
34200,1,3,119414,119414,119417,0,3,0
34201,4,2,119418,119418,119420,0,2,1
34202,2,3,119420,119420,119423,0,3,0
34203,3,1,119423,119423,119424,0,1,0
34204,2,3,119425,119425,119428,0,3,1
34205,3,1,119428,119428,119429,0,1,0
34206,2,3,119430,119430,119433,0,3,1
34207,3,2,119433,119433,119435,0,2,0
34208,6,1,119439,119439,119440,0,1,4
34209,4,2,119443,119443,119445,0,2,3
34210,1,3,119444,119445,119448,1,4,0
34211,2,2,119446,119448,119450,2,4,0
34212,1,2,119447,119450,119452,3,5,0
34213,1,3,119448,119452,119455,4,7,0
34214,3,1,119451,119455,119456,4,5,0
34215,5,1,119456,119456,119457,0,1,0
34216,6,1,119462,119462,119463,0,1,5
34217,2,2,119464,119464,119466,0,2,1
34218,4,3,119468,119468,119471,0,3,2
34219,4,3,119472,119472,119475,0,3,1
34220,4,3,119476,119476,119479,0,3,1
34221,4,2,119480,119480,119482,0,2,1
34222,2,1,119482,119482,119483,0,1,0
34223,3,1,119485,119485,119486,0,1,2
34224,3,3,119488,119488,119491,0,3,2
34225,3,3,119491,119491,119494,0,3,0
34226,5,2,119496,119496,119498,0,2,2
34227,3,2,119499,119499,119501,0,2,1
34228,1,1,119500,119501,119502,1,2,0
34229,5,3,119505,119505,119508,0,3,3
34230,6,1,119511,119511,119512,0,1,3
34231,5,2,119516,119516,119518,0,2,4
34232,2,3,119518,119518,119521,0,3,0
34233,5,3,119523,119523,119526,0,3,2
34234,1,3,119524,119526,119529,2,5,0
34235,2,2,119526,119529,119531,3,5,0
34236,4,1,119530,119531,119532,1,2,0
34237,4,3,119534,119534,119537,0,3,2
34238,4,3,119538,119538,119541,0,3,1
34239,6,1,119544,119544,119545,0,1,3
34240,5,3,119549,119549,119552,0,3,4
34241,5,1,119554,119554,119555,0,1,2
34242,4,2,119558,119558,119560,0,2,3
34243,3,1,119561,119561,119562,0,1,1
34244,1,3,119562,119562,119565,0,3,0
34245,4,1,119566,119566,119567,0,1,1
34246,6,2,119572,119572,119574,0,2,5
34247,5,3,119577,119577,119580,0,3,3
34248,2,2,119579,119580,119582,1,3,0
34249,4,2,119583,119583,119585,0,2,1
34250,1,3,119584,119585,119588,1,4,0
34251,6,1,119590,119590,119591,0,1,2
34252,6,2,119596,119596,119598,0,2,5
34253,3,2,119599,119599,119601,0,2,1
34254,1,3,119600,119601,119604,1,4,0
34255,4,3,119604,119604,119607,0,3,0
34256,2,3,119606,119607,119610,1,4,0
34257,1,2,119607,119610,119612,3,5,0
34258,4,1,119611,119612,119613,1,2,0
34259,4,1,119615,119615,119616,0,1,2
34260,4,2,119619,119619,119621,0,2,3
34261,1,1,119620,119621,119622,1,2,0
34262,2,3,119622,119622,119625,0,3,0
34263,5,3,119627,119627,119630,0,3,2
34264,4,1,119631,119631,119632,0,1,1
34265,1,3,119632,119632,119635,0,3,0
34266,2,1,119634,119635,119636,1,2,0
34267,1,2,119635,119636,119638,1,3,0
34268,2,3,119637,119638,119641,1,4,0
34269,1,3,119638,119641,119644,3,6,0
34270,4,3,119642,119644,119647,2,5,0
34271,2,3,119644,119647,119650,3,6,0
34272,3,3,119647,119650,119653,3,6,0
34273,1,3,119648,119653,119656,5,8,0
34274,5,2,119653,119656,119658,3,5,0
34275,1,2,119654,119658,119660,4,6,0
34276,1,3,119655,119660,119663,5,8,0
34277,4,2,119659,119663,119665,4,6,0
34278,2,2,119661,119665,119667,4,6,0
34279,4,3,119665,119667,119670,2,5,0
34280,2,1,119667,119670,119671,3,4,0
34281,1,1,119668,119671,119672,3,4,0
34282,5,2,119673,119673,119675,0,2,1
34283,2,3,119675,119675,119678,0,3,0
34284,3,3,119678,119678,119681,0,3,0
34285,2,2,119680,119681,119683,1,3,0
34286,6,1,119686,119686,119687,0,1,3
34287,2,1,119688,119688,119689,0,1,1
34288,2,2,119690,119690,119692,0,2,1
34289,2,2,119692,119692,119694,0,2,0
34290,4,1,119696,119696,119697,0,1,2
34291,2,1,119698,119698,119699,0,1,1
34292,2,2,119700,119700,119702,0,2,1
34293,2,3,119702,119702,119705,0,3,0
34294,5,2,119707,119707,119709,0,2,2
34295,6,1,119713,119713,119714,0,1,4
34296,6,1,119719,119719,119720,0,1,5
34297,2,2,119721,119721,119723,0,2,1
34298,4,3,119725,119725,119728,0,3,2
34299,2,2,119727,119728,119730,1,3,0
34300,4,3,119731,119731,119734,0,3,1
34301,5,3,119736,119736,119739,0,3,2
34302,5,1,119741,119741,119742,0,1,2
34303,5,1,119746,119746,119747,0,1,4
34304,1,3,119747,119747,119750,0,3,0
34305,6,3,119753,119753,119756,0,3,3
34306,5,1,119758,119758,119759,0,1,2
34307,2,1,119760,119760,119761,0,1,1
34308,4,3,119764,119764,119767,0,3,3
34309,2,3,119766,119767,119770,1,4,0
34310,5,2,119771,119771,119773,0,2,1
34311,5,2,119776,119776,119778,0,2,3
34312,6,2,119782,119782,119784,0,2,4
34313,4,1,119786,119786,119787,0,1,2
34314,4,2,119790,119790,119792,0,2,3
34315,5,3,119795,119795,119798,0,3,3
34316,5,3,119800,119800,119803,0,3,2
34317,4,3,119804,119804,119807,0,3,1
34318,6,1,119810,119810,119811,0,1,3
34319,2,1,119812,119812,119813,0,1,1
34320,5,1,119817,119817,119818,0,1,4
34321,3,1,119820,119820,119821,0,1,2
34322,6,1,119826,119826,119827,0,1,5
34323,5,2,119831,119831,119833,0,2,4
34324,6,2,119837,119837,119839,0,2,4
34325,2,3,119839,119839,119842,0,3,0
34326,3,2,119842,119842,119844,0,2,0
34327,4,1,119846,119846,119847,0,1,2
34328,3,2,119849,119849,119851,0,2,2
34329,3,2,119852,119852,119854,0,2,1
34330,1,2,119853,119854,119856,1,3,0
34331,5,2,119858,119858,119860,0,2,2
34332,3,1,119861,119861,119862,0,1,1
34333,6,2,119867,119867,119869,0,2,5
34334,2,2,119869,119869,119871,0,2,0
34335,5,3,119874,119874,119877,0,3,3
34336,4,2,119878,119878,119880,0,2,1
34337,6,3,119884,119884,119887,0,3,4
34338,4,2,119888,119888,119890,0,2,1
34339,4,2,119892,119892,119894,0,2,2
34340,5,1,119897,119897,119898,0,1,3
34341,5,2,119902,119902,119904,0,2,4
34342,2,1,119904,119904,119905,0,1,0
34343,6,1,119910,119910,119911,0,1,5
34344,1,2,119911,119911,119913,0,2,0
34345,3,3,119914,119914,119917,0,3,1
34346,1,1,119915,119917,119918,2,3,0
34347,3,3,119918,119918,119921,0,3,0
34348,2,2,119920,119921,119923,1,3,0
34349,4,3,119924,119924,119927,0,3,1
34350,1,1,119925,119927,119928,2,3,0
34351,6,2,119931,119931,119933,0,2,3
34352,2,2,119933,119933,119935,0,2,0
34353,2,2,119935,119935,119937,0,2,0
34354,5,3,119940,119940,119943,0,3,3
34355,1,1,119941,119943,119944,2,3,0
34356,1,3,119942,119944,119947,2,5,0
34357,1,2,119943,119947,119949,4,6,0
34358,3,3,119946,119949,119952,3,6,0
34359,5,2,119951,119952,119954,1,3,0
34360,5,2,119956,119956,119958,0,2,2
34361,2,1,119958,119958,119959,0,1,0
34362,5,3,119963,119963,119966,0,3,4
34363,2,2,119965,119966,119968,1,3,0
34364,6,3,119971,119971,119974,0,3,3
34365,6,1,119977,119977,119978,0,1,3
34366,4,2,119981,119981,119983,0,2,3
34367,2,1,119983,119983,119984,0,1,0
34368,5,3,119988,119988,119991,0,3,4
34369,5,3,119993,119993,119996,0,3,2
34370,2,3,119995,119996,119999,1,4,0
34371,5,1,120000,120000,120001,0,1,1
34372,6,1,120006,120006,120007,0,1,5
34373,1,3,120007,120007,120010,0,3,0
34374,1,2,120008,120010,120012,2,4,0
34375,2,2,120010,120012,120014,2,4,0
34376,4,1,120014,120014,120015,0,1,0
34377,3,3,120017,120017,120020,0,3,2
34378,2,1,120019,120020,120021,1,2,0
34379,5,2,120024,120024,120026,0,2,3
34380,3,2,120027,120027,120029,0,2,1
34381,6,3,120033,120033,120036,0,3,4
34382,1,3,120034,120036,120039,2,5,0
34383,1,3,120035,120039,120042,4,7,0
34384,3,2,120038,120042,120044,4,6,0
34385,3,1,120041,120044,120045,3,4,0
34386,6,3,120047,120047,120050,0,3,2
34387,2,2,120049,120050,120052,1,3,0
34388,5,3,120054,120054,120057,0,3,2
34389,6,3,120060,120060,120063,0,3,3
34390,2,2,120062,120063,120065,1,3,0
34391,6,3,120068,120068,120071,0,3,3
34392,4,1,120072,120072,120073,0,1,1
34393,4,1,120076,120076,120077,0,1,3
34394,3,1,120079,120079,120080,0,1,2
34395,5,2,120084,120084,120086,0,2,4
34396,3,1,120087,120087,120088,0,1,1
34397,4,3,120091,120091,120094,0,3,3
34398,3,3,120094,120094,120097,0,3,0
34399,5,2,120099,120099,120101,0,2,2
34400,2,3,120101,120101,120104,0,3,0
34401,2,3,120103,120104,120107,1,4,0
34402,2,3,120105,120107,120110,2,5,0
34403,1,3,120106,120110,120113,4,7,0
34404,3,2,120109,120113,120115,4,6,0
34405,3,1,120112,120115,120116,3,4,0
34406,4,1,120116,120116,120117,0,1,0
34407,1,2,120117,120117,120119,0,2,0
34408,1,3,120118,120119,120122,1,4,0
34409,2,3,120120,120122,120125,2,5,0
34410,6,2,120126,120126,120128,0,2,1
34411,1,1,120127,120128,120129,1,2,0
34412,3,1,120130,120130,120131,0,1,1
34413,1,2,120131,120131,120133,0,2,0
34414,5,2,120136,120136,120138,0,2,3
34415,4,2,120140,120140,120142,0,2,2
34416,4,1,120144,120144,120145,0,1,2
34417,4,2,120148,120148,120150,0,2,3
34418,3,1,120151,120151,120152,0,1,1
34419,3,2,120154,120154,120156,0,2,2
34420,6,3,120160,120160,120163,0,3,4
34421,5,2,120165,120165,120167,0,2,2
34422,4,3,120169,120169,120172,0,3,2
34423,3,1,120172,120172,120173,0,1,0
34424,1,2,120173,120173,120175,0,2,0
34425,3,2,120176,120176,120178,0,2,1
34426,1,3,120177,120178,120181,1,4,0
34427,5,2,120182,120182,120184,0,2,1
34428,1,3,120183,120184,120187,1,4,0
34429,4,3,120187,120187,120190,0,3,0
34430,3,3,120190,120190,120193,0,3,0
34431,3,1,120193,120193,120194,0,1,0
34432,5,1,120198,120198,120199,0,1,4
34433,5,1,120203,120203,120204,0,1,4
34434,2,2,120205,120205,120207,0,2,1
34435,6,1,120211,120211,120212,0,1,4
34436,5,3,120216,120216,120219,0,3,4
34437,4,3,120220,120220,120223,0,3,1
34438,6,2,120226,120226,120228,0,2,3
34439,4,3,120230,120230,120233,0,3,2
34440,5,2,120235,120235,120237,0,2,2
34441,5,2,120240,120240,120242,0,2,3
34442,1,1,120241,120242,120243,1,2,0
34443,3,3,120244,120244,120247,0,3,1
34444,3,1,120247,120247,120248,0,1,0
34445,5,1,120252,120252,120253,0,1,4
34446,3,1,120255,120255,120256,0,1,2
34447,6,1,120261,120261,120262,0,1,5
34448,6,2,120267,120267,120269,0,2,5
34449,5,3,120272,120272,120275,0,3,3
34450,6,1,120278,120278,120279,0,1,3
34451,1,2,120279,120279,120281,0,2,0
34452,6,3,120285,120285,120288,0,3,4
34453,6,3,120291,120291,120294,0,3,3
34454,1,3,120292,120294,120297,2,5,0
34455,5,3,120297,120297,120300,0,3,0
34456,3,3,120300,120300,120303,0,3,0
34457,4,2,120304,120304,120306,0,2,1
34458,6,2,120310,120310,120312,0,2,4
34459,5,2,120315,120315,120317,0,2,3
34460,5,1,120320,120320,120321,0,1,3
34461,1,1,120321,120321,120322,0,1,0
34462,4,2,120325,120325,120327,0,2,3
34463,1,1,120326,120327,120328,1,2,0
34464,3,2,120329,120329,120331,0,2,1
34465,2,2,120331,120331,120333,0,2,0
34466,6,3,120337,120337,120340,0,3,4
34467,1,2,120338,120340,120342,2,4,0
34468,5,2,120343,120343,120345,0,2,1
34469,6,1,120349,120349,120350,0,1,4
34470,2,1,120351,120351,120352,0,1,1
34471,6,2,120357,120357,120359,0,2,5
34472,5,3,120362,120362,120365,0,3,3
34473,5,2,120367,120367,120369,0,2,2
34474,6,3,120373,120373,120376,0,3,4
34475,1,2,120374,120376,120378,2,4,0
34476,6,1,120380,120380,120381,0,1,2
34477,4,1,120384,120384,120385,0,1,3
34478,6,1,120390,120390,120391,0,1,5
34479,6,2,120396,120396,120398,0,2,5
34480,6,1,120402,120402,120403,0,1,4
34481,4,1,120406,120406,120407,0,1,3
34482,4,1,120410,120410,120411,0,1,3
34483,2,1,120412,120412,120413,0,1,1
34484,4,1,120416,120416,120417,0,1,3
34485,2,3,120418,120418,120421,0,3,1
34486,6,1,120424,120424,120425,0,1,3
34487,6,2,120430,120430,120432,0,2,5
34488,2,1,120432,120432,120433,0,1,0
34489,2,1,120434,120434,120435,0,1,1
34490,4,3,120438,120438,120441,0,3,3
34491,1,3,120439,120441,120444,2,5,0
34492,3,1,120442,120444,120445,2,3,0
34493,1,2,120443,120445,120447,2,4,0
34494,4,1,120447,120447,120448,0,1,0
34495,3,2,120450,120450,120452,0,2,2
34496,1,2,120451,120452,120454,1,3,0
34497,5,2,120456,120456,120458,0,2,2
34498,3,1,120459,120459,120460,0,1,1
34499,5,3,120464,120464,120467,0,3,4
34500,3,3,120467,120467,120470,0,3,0
34501,6,1,120473,120473,120474,0,1,3
34502,6,3,120479,120479,120482,0,3,5
34503,3,1,120482,120482,120483,0,1,0
34504,6,3,120488,120488,120491,0,3,5
34505,3,1,120491,120491,120492,0,1,0
34506,1,3,120492,120492,120495,0,3,0
34507,5,1,120497,120497,120498,0,1,2
34508,5,2,120502,120502,120504,0,2,4
34509,3,2,120505,120505,120507,0,2,1
34510,3,3,120508,120508,120511,0,3,1
34511,2,2,120510,120511,120513,1,3,0
34512,1,1,120511,120513,120514,2,3,0
34513,1,1,120512,120514,120515,2,3,0
34514,5,3,120517,120517,120520,0,3,2
34515,4,3,120521,120521,120524,0,3,1
34516,4,3,120525,120525,120528,0,3,1
34517,5,2,120530,120530,120532,0,2,2
34518,2,1,120532,120532,120533,0,1,0
34519,5,1,120537,120537,120538,0,1,4
34520,4,3,120541,120541,120544,0,3,3
34521,2,2,120543,120544,120546,1,3,0
34522,6,2,120549,120549,120551,0,2,3
34523,3,1,120552,120552,120553,0,1,1
34524,4,3,120556,120556,120559,0,3,3
34525,3,3,120559,120559,120562,0,3,0
34526,4,3,120563,120563,120566,0,3,1
34527,5,1,120568,120568,120569,0,1,2
34528,6,3,120574,120574,120577,0,3,5
34529,2,2,120576,120577,120579,1,3,0
34530,6,2,120582,120582,120584,0,2,3
34531,1,2,120583,120584,120586,1,3,0
34532,5,3,120588,120588,120591,0,3,2
34533,4,1,120592,120592,120593,0,1,1
34534,1,3,120593,120593,120596,0,3,0
34535,4,2,120597,120597,120599,0,2,1
34536,4,2,120601,120601,120603,0,2,2
34537,2,2,120603,120603,120605,0,2,0
34538,1,1,120604,120605,120606,1,2,0
34539,4,1,120608,120608,120609,0,1,2
34540,5,3,120613,120613,120616,0,3,4
34541,4,1,120617,120617,120618,0,1,1
34542,6,2,120623,120623,120625,0,2,5
34543,3,2,120626,120626,120628,0,2,1
34544,6,3,120632,120632,120635,0,3,4
34545,4,3,120636,120636,120639,0,3,1
34546,6,1,120642,120642,120643,0,1,3
34547,2,1,120644,120644,120645,0,1,1
34548,5,3,120649,120649,120652,0,3,4
34549,2,3,120651,120652,120655,1,4,0
34550,1,2,120652,120655,120657,3,5,0
34551,2,3,120654,120657,120660,3,6,0
34552,3,1,120657,120660,120661,3,4,0
34553,2,1,120659,120661,120662,2,3,0
34554,4,1,120663,120663,120664,0,1,1
34555,4,1,120667,120667,120668,0,1,3
34556,5,3,120672,120672,120675,0,3,4
34557,1,2,120673,120675,120677,2,4,0
34558,2,3,120675,120677,120680,2,5,0
34559,2,2,120677,120680,120682,3,5,0
34560,3,1,120680,120682,120683,2,3,0
34561,6,2,120686,120686,120688,0,2,3
34562,2,1,120688,120688,120689,0,1,0
34563,5,2,120693,120693,120695,0,2,4
34564,2,3,120695,120695,120698,0,3,0
34565,5,1,120700,120700,120701,0,1,2
34566,1,3,120701,120701,120704,0,3,0
34567,2,2,120703,120704,120706,1,3,0
34568,3,1,120706,120706,120707,0,1,0
34569,6,2,120712,120712,120714,0,2,5
34570,4,1,120716,120716,120717,0,1,2
34571,1,3,120717,120717,120720,0,3,0
34572,2,1,120719,120720,120721,1,2,0
34573,1,1,120720,120721,120722,1,2,0
34574,1,1,120721,120722,120723,1,2,0
34575,4,1,120725,120725,120726,0,1,2
34576,3,1,120728,120728,120729,0,1,2
34577,4,1,120732,120732,120733,0,1,3
34578,4,3,120736,120736,120739,0,3,3
34579,4,1,120740,120740,120741,0,1,1
34580,1,3,120741,120741,120744,0,3,0
34581,4,2,120745,120745,120747,0,2,1
34582,6,2,120751,120751,120753,0,2,4
34583,5,1,120756,120756,120757,0,1,3
34584,3,2,120759,120759,120761,0,2,2
34585,3,1,120762,120762,120763,0,1,1
34586,6,1,120768,120768,120769,0,1,5
34587,3,2,120771,120771,120773,0,2,2
34588,3,3,120774,120774,120777,0,3,1
34589,4,1,120778,120778,120779,0,1,1
34590,4,3,120782,120782,120785,0,3,3
34591,5,2,120787,120787,120789,0,2,2
34592,1,1,120788,120789,120790,1,2,0
34593,3,2,120791,120791,120793,0,2,1
34594,5,2,120796,120796,120798,0,2,3
34595,5,3,120801,120801,120804,0,3,3
34596,3,2,120804,120804,120806,0,2,0
34597,6,3,120810,120810,120813,0,3,4
34598,3,3,120813,120813,120816,0,3,0
34599,2,1,120815,120816,120817,1,2,0
34600,1,3,120816,120817,120820,1,4,0
34601,4,1,120820,120820,120821,0,1,0
34602,4,1,120824,120824,120825,0,1,3
34603,2,3,120826,120826,120829,0,3,1
34604,6,2,120832,120832,120834,0,2,3
34605,2,1,120834,120834,120835,0,1,0
34606,2,3,120836,120836,120839,0,3,1
34607,4,3,120840,120840,120843,0,3,1
34608,6,2,120846,120846,120848,0,2,3
34609,1,2,120847,120848,120850,1,3,0
34610,4,1,120851,120851,120852,0,1,1
34611,5,1,120856,120856,120857,0,1,4
34612,6,3,120862,120862,120865,0,3,5
34613,1,1,120863,120865,120866,2,3,0
34614,1,2,120864,120866,120868,2,4,0
34615,3,3,120867,120868,120871,1,4,0
34616,5,1,120872,120872,120873,0,1,1
34617,1,2,120873,120873,120875,0,2,0
34618,2,1,120875,120875,120876,0,1,0
34619,4,2,120879,120879,120881,0,2,3
34620,3,2,120882,120882,120884,0,2,1
34621,4,1,120886,120886,120887,0,1,2
34622,2,1,120888,120888,120889,0,1,1
34623,4,2,120892,120892,120894,0,2,3
34624,4,3,120896,120896,120899,0,3,2
34625,5,3,120901,120901,120904,0,3,2
34626,5,1,120906,120906,120907,0,1,2
34627,3,3,120909,120909,120912,0,3,2
34628,5,1,120914,120914,120915,0,1,2
34629,2,2,120916,120916,120918,0,2,1
34630,1,2,120917,120918,120920,1,3,0
34631,4,1,120921,120921,120922,0,1,1
34632,2,2,120923,120923,120925,0,2,1
34633,2,3,120925,120925,120928,0,3,0
34634,2,3,120927,120928,120931,1,4,0
34635,4,1,120931,120931,120932,0,1,0
34636,5,3,120936,120936,120939,0,3,4
34637,6,3,120942,120942,120945,0,3,3
34638,4,1,120946,120946,120947,0,1,1
34639,4,2,120950,120950,120952,0,2,3
34640,2,3,120952,120952,120955,0,3,0
34641,6,2,120958,120958,120960,0,2,3
34642,4,2,120962,120962,120964,0,2,2
34643,6,3,120968,120968,120971,0,3,4
34644,5,2,120973,120973,120975,0,2,2
34645,5,2,120978,120978,120980,0,2,3
34646,4,3,120982,120982,120985,0,3,2
34647,4,1,120986,120986,120987,0,1,1
34648,4,1,120990,120990,120991,0,1,3
34649,6,3,120996,120996,120999,0,3,5
34650,4,3,121000,121000,121003,0,3,1
34651,2,1,121002,121003,121004,1,2,0
34652,6,2,121008,121008,121010,0,2,4
34653,5,1,121013,121013,121014,0,1,3
34654,1,1,121014,121014,121015,0,1,0
34655,5,3,121019,121019,121022,0,3,4
34656,1,3,121020,121022,121025,2,5,0
34657,1,1,121021,121025,121026,4,5,0
34658,3,2,121024,121026,121028,2,4,0
34659,4,1,121028,121028,121029,0,1,0
34660,5,2,121033,121033,121035,0,2,4
34661,5,3,121038,121038,121041,0,3,3
34662,3,1,121041,121041,121042,0,1,0
34663,2,3,121043,121043,121046,0,3,1
34664,4,3,121047,121047,121050,0,3,1
34665,1,3,121048,121050,121053,2,5,0
34666,2,2,121050,121053,121055,3,5,0
34667,5,2,121055,121055,121057,0,2,0
34668,3,3,121058,121058,121061,0,3,1
34669,6,2,121064,121064,121066,0,2,3
34670,3,2,121067,121067,121069,0,2,1
34671,2,1,121069,121069,121070,0,1,0
34672,1,1,121070,121070,121071,0,1,0
34673,6,2,121076,121076,121078,0,2,5
34674,4,3,121080,121080,121083,0,3,2
34675,3,2,121083,121083,121085,0,2,0
34676,6,2,121089,121089,121091,0,2,4
34677,4,1,121093,121093,121094,0,1,2
34678,3,3,121096,121096,121099,0,3,2
34679,3,2,121099,121099,121101,0,2,0
34680,6,2,121105,121105,121107,0,2,4
34681,6,1,121111,121111,121112,0,1,4
34682,1,1,121112,121112,121113,0,1,0
34683,2,1,121114,121114,121115,0,1,1
34684,2,3,121116,121116,121119,0,3,1
34685,2,1,121118,121119,121120,1,2,0
34686,3,1,121121,121121,121122,0,1,1
34687,4,1,121125,121125,121126,0,1,3
34688,2,1,121127,121127,121128,0,1,1
34689,1,2,121128,121128,121130,0,2,0
34690,5,1,121133,121133,121134,0,1,3
34691,1,2,121134,121134,121136,0,2,0
34692,4,3,121138,121138,121141,0,3,2
34693,2,1,121140,121141,121142,1,2,0
34694,5,2,121145,121145,121147,0,2,3
34695,5,2,121150,121150,121152,0,2,3
34696,6,3,121156,121156,121159,0,3,4
34697,2,1,121158,121159,121160,1,2,0
34698,5,3,121163,121163,121166,0,3,3
34699,4,2,121167,121167,121169,0,2,1
34700,5,3,121172,121172,121175,0,3,3
34701,6,1,121178,121178,121179,0,1,3
34702,3,1,121181,121181,121182,0,1,2
34703,6,2,121187,121187,121189,0,2,5
34704,5,3,121192,121192,121195,0,3,3
34705,6,1,121198,121198,121199,0,1,3
34706,6,3,121204,121204,121207,0,3,5
34707,2,3,121206,121207,121210,1,4,0
34708,4,3,121210,121210,121213,0,3,0
34709,2,3,121212,121213,121216,1,4,0
34710,2,2,121214,121216,121218,2,4,0
34711,2,1,121216,121218,121219,2,3,0
34712,4,3,121220,121220,121223,0,3,1
34713,4,1,121224,121224,121225,0,1,1
34714,2,2,121226,121226,121228,0,2,1
34715,5,1,121231,121231,121232,0,1,3
34716,5,2,121236,121236,121238,0,2,4
34717,2,3,121238,121238,121241,0,3,0
34718,4,2,121242,121242,121244,0,2,1
34719,6,2,121248,121248,121250,0,2,4
34720,3,2,121251,121251,121253,0,2,1
34721,1,3,121252,121253,121256,1,4,0
34722,6,2,121258,121258,121260,0,2,2
34723,4,3,121262,121262,121265,0,3,2
34724,1,2,121263,121265,121267,2,4,0
34725,2,3,121265,121267,121270,2,5,0
34726,5,3,121270,121270,121273,0,3,0
34727,1,2,121271,121273,121275,2,4,0
34728,1,2,121272,121275,121277,3,5,0
34729,6,2,121278,121278,121280,0,2,1
34730,4,3,121282,121282,121285,0,3,2
34731,3,3,121285,121285,121288,0,3,0
34732,5,3,121290,121290,121293,0,3,2
34733,4,1,121294,121294,121295,0,1,1
34734,4,1,121298,121298,121299,0,1,3
34735,3,3,121301,121301,121304,0,3,2
34736,2,3,121303,121304,121307,1,4,0
34737,4,1,121307,121307,121308,0,1,0
34738,4,2,121311,121311,121313,0,2,3
34739,1,1,121312,121313,121314,1,2,0
34740,5,1,121317,121317,121318,0,1,3
34741,2,3,121319,121319,121322,0,3,1
34742,1,3,121320,121322,121325,2,5,0
34743,5,2,121325,121325,121327,0,2,0
34744,5,2,121330,121330,121332,0,2,3
34745,1,2,121331,121332,121334,1,3,0
34746,5,2,121336,121336,121338,0,2,2
34747,3,3,121339,121339,121342,0,3,1
34748,3,3,121342,121342,121345,0,3,0
34749,4,3,121346,121346,121349,0,3,1
34750,2,3,121348,121349,121352,1,4,0
34751,1,3,121349,121352,121355,3,6,0
34752,5,2,121354,121355,121357,1,3,0
34753,1,1,121355,121357,121358,2,3,0
34754,3,2,121358,121358,121360,0,2,0
34755,2,3,121360,121360,121363,0,3,0
34756,2,2,121362,121363,121365,1,3,0
34757,2,3,121364,121365,121368,1,4,0
34758,1,1,121365,121368,121369,3,4,0
34759,3,2,121368,121369,121371,1,3,0
34760,6,1,121374,121374,121375,0,1,3
34761,1,3,121375,121375,121378,0,3,0
34762,2,1,121377,121378,121379,1,2,0
34763,5,1,121382,121382,121383,0,1,3
34764,2,2,121384,121384,121386,0,2,1
34765,1,1,121385,121386,121387,1,2,0
34766,5,2,121390,121390,121392,0,2,3
34767,3,3,121393,121393,121396,0,3,1
34768,4,2,121397,121397,121399,0,2,1
34769,4,1,121401,121401,121402,0,1,2
34770,5,2,121406,121406,121408,0,2,4
34771,6,2,121412,121412,121414,0,2,4
34772,3,3,121415,121415,121418,0,3,1
34773,3,2,121418,121418,121420,0,2,0
34774,1,2,121419,121420,121422,1,3,0
34775,6,3,121425,121425,121428,0,3,3
34776,5,1,121430,121430,121431,0,1,2
34777,5,3,121435,121435,121438,0,3,4
34778,5,3,121440,121440,121443,0,3,2
34779,1,2,121441,121443,121445,2,4,0
34780,6,3,121447,121447,121450,0,3,2
34781,3,1,121450,121450,121451,0,1,0
34782,6,2,121456,121456,121458,0,2,5
34783,2,2,121458,121458,121460,0,2,0
34784,6,2,121464,121464,121466,0,2,4
34785,2,2,121466,121466,121468,0,2,0
34786,4,3,121470,121470,121473,0,3,2
34787,2,2,121472,121473,121475,1,3,0
34788,6,3,121478,121478,121481,0,3,3
34789,6,1,121484,121484,121485,0,1,3
34790,6,1,121490,121490,121491,0,1,5
34791,5,2,121495,121495,121497,0,2,4
34792,5,1,121500,121500,121501,0,1,3
34793,4,1,121504,121504,121505,0,1,3
34794,1,2,121505,121505,121507,0,2,0
34795,4,2,121509,121509,121511,0,2,2
34796,6,1,121515,121515,121516,0,1,4
34797,2,3,121517,121517,121520,0,3,1
34798,3,2,121520,121520,121522,0,2,0
34799,3,2,121523,121523,121525,0,2,1
34800,4,3,121527,121527,121530,0,3,2
34801,3,2,121530,121530,121532,0,2,0
34802,6,1,121536,121536,121537,0,1,4
34803,3,3,121539,121539,121542,0,3,2
34804,4,1,121543,121543,121544,0,1,1
34805,1,2,121544,121544,121546,0,2,0
34806,2,1,121546,121546,121547,0,1,0
34807,6,3,121552,121552,121555,0,3,5
34808,2,3,121554,121555,121558,1,4,0
34809,4,3,121558,121558,121561,0,3,0
34810,5,3,121563,121563,121566,0,3,2
34811,6,1,121569,121569,121570,0,1,3
34812,1,3,121570,121570,121573,0,3,0
34813,5,3,121575,121575,121578,0,3,2
34814,4,3,121579,121579,121582,0,3,1
34815,5,2,121584,121584,121586,0,2,2
34816,2,2,121586,121586,121588,0,2,0
34817,6,2,121592,121592,121594,0,2,4
34818,4,3,121596,121596,121599,0,3,2
34819,3,3,121599,121599,121602,0,3,0
34820,4,2,121603,121603,121605,0,2,1
34821,1,2,121604,121605,121607,1,3,0
34822,1,1,121605,121607,121608,2,3,0
34823,6,1,121611,121611,121612,0,1,3
34824,5,1,121616,121616,121617,0,1,4
34825,3,3,121619,121619,121622,0,3,2
34826,3,1,121622,121622,121623,0,1,0
34827,6,2,121628,121628,121630,0,2,5
34828,4,1,121632,121632,121633,0,1,2
34829,3,3,121635,121635,121638,0,3,2
34830,4,1,121639,121639,121640,0,1,1
34831,5,3,121644,121644,121647,0,3,4
34832,6,3,121650,121650,121653,0,3,3
34833,6,3,121656,121656,121659,0,3,3
34834,1,2,121657,121659,121661,2,4,0
34835,5,1,121662,121662,121663,0,1,1
34836,4,1,121666,121666,121667,0,1,3
34837,3,3,121669,121669,121672,0,3,2
34838,3,1,121672,121672,121673,0,1,0
34839,5,3,121677,121677,121680,0,3,4
34840,2,3,121679,121680,121683,1,4,0
34841,4,3,121683,121683,121686,0,3,0
34842,6,3,121689,121689,121692,0,3,3
34843,4,2,121693,121693,121695,0,2,1
34844,3,1,121696,121696,121697,0,1,1
34845,1,2,121697,121697,121699,0,2,0
34846,5,1,121702,121702,121703,0,1,3
34847,4,3,121706,121706,121709,0,3,3
34848,1,3,121707,121709,121712,2,5,0
34849,5,2,121712,121712,121714,0,2,0
34850,2,2,121714,121714,121716,0,2,0
34851,3,1,121717,121717,121718,0,1,1
34852,2,3,121719,121719,121722,0,3,1
34853,5,1,121724,121724,121725,0,1,2
34854,5,2,121729,121729,121731,0,2,4
34855,3,3,121732,121732,121735,0,3,1
34856,4,2,121736,121736,121738,0,2,1
34857,3,1,121739,121739,121740,0,1,1
34858,3,1,121742,121742,121743,0,1,2
34859,2,1,121744,121744,121745,0,1,1
34860,5,1,121749,121749,121750,0,1,4
34861,5,2,121754,121754,121756,0,2,4
34862,5,1,121759,121759,121760,0,1,3
34863,6,2,121765,121765,121767,0,2,5
34864,3,1,121768,121768,121769,0,1,1
34865,5,1,121773,121773,121774,0,1,4
34866,3,3,121776,121776,121779,0,3,2
34867,2,3,121778,121779,121782,1,4,0
34868,5,3,121783,121783,121786,0,3,1
34869,2,3,121785,121786,121789,1,4,0
34870,2,1,121787,121789,121790,2,3,0
34871,4,3,121791,121791,121794,0,3,1
34872,6,1,121797,121797,121798,0,1,3
34873,2,3,121799,121799,121802,0,3,1
34874,1,1,121800,121802,121803,2,3,0
34875,2,2,121802,121803,121805,1,3,0
34876,4,2,121806,121806,121808,0,2,1
34877,4,1,121810,121810,121811,0,1,2
34878,2,1,121812,121812,121813,0,1,1
34879,3,2,121815,121815,121817,0,2,2
34880,6,1,121821,121821,121822,0,1,4
34881,4,3,121825,121825,121828,0,3,3
34882,4,3,121829,121829,121832,0,3,1
34883,1,2,121830,121832,121834,2,4,0
34884,2,2,121832,121834,121836,2,4,0
34885,4,1,121836,121836,121837,0,1,0
34886,3,2,121839,121839,121841,0,2,2
34887,2,3,121841,121841,121844,0,3,0
34888,4,3,121845,121845,121848,0,3,1
34889,4,2,121849,121849,121851,0,2,1
34890,5,3,121854,121854,121857,0,3,3
34891,1,1,121855,121857,121858,2,3,0
34892,6,3,121861,121861,121864,0,3,3
34893,2,3,121863,121864,121867,1,4,0
34894,1,1,121864,121867,121868,3,4,0
34895,4,2,121868,121868,121870,0,2,0
34896,1,1,121869,121870,121871,1,2,0
34897,5,3,121874,121874,121877,0,3,3
34898,5,1,121879,121879,121880,0,1,2
34899,3,3,121882,121882,121885,0,3,2
34900,6,1,121888,121888,121889,0,1,3
34901,1,3,121889,121889,121892,0,3,0
34902,6,2,121895,121895,121897,0,2,3
34903,1,2,121896,121897,121899,1,3,0
34904,3,1,121899,121899,121900,0,1,0
34905,1,1,121900,121900,121901,0,1,0
34906,3,3,121903,121903,121906,0,3,2
34907,4,2,121907,121907,121909,0,2,1
34908,6,1,121913,121913,121914,0,1,4
34909,6,2,121919,121919,121921,0,2,5
34910,4,1,121923,121923,121924,0,1,2
34911,6,3,121929,121929,121932,0,3,5
34912,3,1,121932,121932,121933,0,1,0
34913,5,2,121937,121937,121939,0,2,4
34914,1,2,121938,121939,121941,1,3,0
34915,5,2,121943,121943,121945,0,2,2
34916,4,1,121947,121947,121948,0,1,2
34917,3,1,121950,121950,121951,0,1,2
34918,1,2,121951,121951,121953,0,2,0
34919,2,1,121953,121953,121954,0,1,0
34920,4,2,121957,121957,121959,0,2,3
34921,2,3,121959,121959,121962,0,3,0
34922,3,3,121962,121962,121965,0,3,0
34923,5,2,121967,121967,121969,0,2,2
34924,1,2,121968,121969,121971,1,3,0
34925,6,1,121974,121974,121975,0,1,3
34926,1,2,121975,121975,121977,0,2,0
34927,3,3,121978,121978,121981,0,3,1
34928,2,3,121980,121981,121984,1,4,0
34929,3,1,121983,121984,121985,1,2,0
34930,2,2,121985,121985,121987,0,2,0
34931,4,1,121989,121989,121990,0,1,2
34932,5,2,121994,121994,121996,0,2,4
34933,4,2,121998,121998,122000,0,2,2
34934,3,3,122001,122001,122004,0,3,1
34935,3,2,122004,122004,122006,0,2,0
34936,1,1,122005,122006,122007,1,2,0
34937,1,2,122006,122007,122009,1,3,0
34938,6,2,122012,122012,122014,0,2,3
34939,6,2,122018,122018,122020,0,2,4
34940,4,2,122022,122022,122024,0,2,2
34941,2,1,122024,122024,122025,0,1,0
34942,1,3,122025,122025,122028,0,3,0
34943,2,1,122027,122028,122029,1,2,0
34944,5,2,122032,122032,122034,0,2,3
34945,4,2,122036,122036,122038,0,2,2
34946,3,1,122039,122039,122040,0,1,1
34947,4,1,122043,122043,122044,0,1,3
34948,1,3,122044,122044,122047,0,3,0
34949,3,2,122047,122047,122049,0,2,0
34950,6,3,122053,122053,122056,0,3,4
34951,5,2,122058,122058,122060,0,2,2
34952,6,3,122064,122064,122067,0,3,4
34953,2,3,122066,122067,122070,1,4,0
34954,5,2,122071,122071,122073,0,2,1
34955,4,1,122075,122075,122076,0,1,2
34956,2,2,122077,122077,122079,0,2,1
34957,5,2,122082,122082,122084,0,2,3
34958,4,3,122086,122086,122089,0,3,2
34959,1,1,122087,122089,122090,2,3,0
34960,4,2,122091,122091,122093,0,2,1
34961,4,1,122095,122095,122096,0,1,2
34962,5,3,122100,122100,122103,0,3,4
34963,2,1,122102,122103,122104,1,2,0
34964,4,3,122106,122106,122109,0,3,2
34965,2,3,122108,122109,122112,1,4,0
34966,2,1,122110,122112,122113,2,3,0
34967,2,2,122112,122113,122115,1,3,0
34968,4,1,122116,122116,122117,0,1,1
34969,4,3,122120,122120,122123,0,3,3
34970,5,3,122125,122125,122128,0,3,2
34971,3,2,122128,122128,122130,0,2,0
34972,1,1,122129,122130,122131,1,2,0
34973,5,3,122134,122134,122137,0,3,3
34974,4,3,122138,122138,122141,0,3,1
34975,2,1,122140,122141,122142,1,2,0
34976,4,1,122144,122144,122145,0,1,2
34977,1,2,122145,122145,122147,0,2,0
34978,6,3,122151,122151,122154,0,3,4
34979,3,2,122154,122154,122156,0,2,0
34980,6,1,122160,122160,122161,0,1,4
34981,5,3,122165,122165,122168,0,3,4
34982,1,3,122166,122168,122171,2,5,0
34983,5,2,122171,122171,122173,0,2,0
34984,6,3,122177,122177,122180,0,3,4
34985,2,3,122179,122180,122183,1,4,0
34986,2,2,122181,122183,122185,2,4,0
34987,4,3,122185,122185,122188,0,3,0
34988,5,2,122190,122190,122192,0,2,2
34989,2,1,122192,122192,122193,0,1,0
34990,5,1,122197,122197,122198,0,1,4
34991,5,1,122202,122202,122203,0,1,4
34992,6,1,122208,122208,122209,0,1,5
34993,3,3,122211,122211,122214,0,3,2
34994,6,3,122217,122217,122220,0,3,3
34995,2,3,122219,122220,122223,1,4,0
34996,3,1,122222,122223,122224,1,2,0
34997,4,2,122226,122226,122228,0,2,2
34998,3,2,122229,122229,122231,0,2,1
34999,6,3,122235,122235,122238,0,3,4
35000,2,3,122237,122238,122241,1,4,0
35001,1,2,122238,122241,122243,3,5,0
35002,2,3,122240,122243,122246,3,6,0
35003,6,3,122246,122246,122249,0,3,0
35004,6,3,122252,122252,122255,0,3,3
35005,4,2,122256,122256,122258,0,2,1
35006,1,1,122257,122258,122259,1,2,0
35007,2,2,122259,122259,122261,0,2,0
35008,4,2,122263,122263,122265,0,2,2
35009,6,1,122269,122269,122270,0,1,4
35010,4,3,122273,122273,122276,0,3,3
35011,4,1,122277,122277,122278,0,1,1
35012,1,2,122278,122278,122280,0,2,0
35013,4,2,122282,122282,122284,0,2,2
35014,6,2,122288,122288,122290,0,2,4
35015,1,2,122289,122290,122292,1,3,0
35016,5,2,122294,122294,122296,0,2,2
35017,5,2,122299,122299,122301,0,2,3
35018,4,1,122303,122303,122304,0,1,2
35019,5,2,122308,122308,122310,0,2,4
35020,1,3,122309,122310,122313,1,4,0
35021,3,1,122312,122313,122314,1,2,0
35022,5,3,122317,122317,122320,0,3,3
35023,6,2,122323,122323,122325,0,2,3
35024,6,3,122329,122329,122332,0,3,4
35025,6,3,122335,122335,122338,0,3,3
35026,4,1,122339,122339,122340,0,1,1
35027,1,2,122340,122340,122342,0,2,0
35028,1,3,122341,122342,122345,1,4,0
35029,4,3,122345,122345,122348,0,3,0
35030,2,2,122347,122348,122350,1,3,0
35031,2,3,122349,122350,122353,1,4,0
35032,2,1,122351,122353,122354,2,3,0
35033,6,2,122357,122357,122359,0,2,3
35034,1,3,122358,122359,122362,1,4,0
35035,4,3,122362,122362,122365,0,3,0
35036,4,3,122366,122366,122369,0,3,1
35037,3,3,122369,122369,122372,0,3,0
35038,5,3,122374,122374,122377,0,3,2
35039,1,1,122375,122377,122378,2,3,0
35040,1,3,122376,122378,122381,2,5,0
35041,5,2,122381,122381,122383,0,2,0
35042,2,3,122383,122383,122386,0,3,0
35043,3,1,122386,122386,122387,0,1,0
35044,4,1,122390,122390,122391,0,1,3
35045,5,1,122395,122395,122396,0,1,4
35046,6,2,122401,122401,122403,0,2,5
35047,3,3,122404,122404,122407,0,3,1
35048,1,3,122405,122407,122410,2,5,0
35049,4,2,122409,122410,122412,1,3,0
35050,3,3,122412,122412,122415,0,3,0
35051,4,1,122416,122416,122417,0,1,1
35052,1,2,122417,122417,122419,0,2,0
35053,5,1,122422,122422,122423,0,1,3
35054,4,1,122426,122426,122427,0,1,3
35055,2,3,122428,122428,122431,0,3,1
35056,4,1,122432,122432,122433,0,1,1
35057,5,3,122437,122437,122440,0,3,4
35058,1,3,122438,122440,122443,2,5,0
35059,5,2,122443,122443,122445,0,2,0
35060,6,2,122449,122449,122451,0,2,4
35061,5,1,122454,122454,122455,0,1,3
35062,3,3,122457,122457,122460,0,3,2
35063,5,2,122462,122462,122464,0,2,2
35064,3,3,122465,122465,122468,0,3,1
35065,1,3,122466,122468,122471,2,5,0
35066,5,2,122471,122471,122473,0,2,0
35067,2,2,122473,122473,122475,0,2,0
35068,3,2,122476,122476,122478,0,2,1
35069,3,1,122479,122479,122480,0,1,1
35070,6,2,122485,122485,122487,0,2,5
35071,5,3,122490,122490,122493,0,3,3
35072,2,2,122492,122493,122495,1,3,0
35073,2,2,122494,122495,122497,1,3,0
35074,3,2,122497,122497,122499,0,2,0
35075,2,2,122499,122499,122501,0,2,0
35076,6,2,122505,122505,122507,0,2,4
35077,3,2,122508,122508,122510,0,2,1
35078,3,1,122511,122511,122512,0,1,1
35079,1,2,122512,122512,122514,0,2,0
35080,5,2,122517,122517,122519,0,2,3
35081,3,3,122520,122520,122523,0,3,1
35082,1,3,122521,122523,122526,2,5,0
35083,4,3,122525,122526,122529,1,4,0
35084,4,2,122529,122529,122531,0,2,0
35085,6,1,122535,122535,122536,0,1,4
35086,3,2,122538,122538,122540,0,2,2
35087,5,2,122543,122543,122545,0,2,3
35088,5,1,122548,122548,122549,0,1,3
35089,1,1,122549,122549,122550,0,1,0
35090,6,1,122555,122555,122556,0,1,5
35091,4,1,122559,122559,122560,0,1,3
35092,5,2,122564,122564,122566,0,2,4
35093,5,1,122569,122569,122570,0,1,3
35094,2,3,122571,122571,122574,0,3,1
35095,3,2,122574,122574,122576,0,2,0
35096,6,3,122580,122580,122583,0,3,4
35097,2,1,122582,122583,122584,1,2,0
35098,5,3,122587,122587,122590,0,3,3
35099,2,2,122589,122590,122592,1,3,0
35100,5,3,122594,122594,122597,0,3,2
35101,3,1,122597,122597,122598,0,1,0
35102,1,3,122598,122598,122601,0,3,0
35103,1,1,122599,122601,122602,2,3,0
35104,5,2,122604,122604,122606,0,2,2
35105,2,1,122606,122606,122607,0,1,0
35106,2,3,122608,122608,122611,0,3,1
35107,2,1,122610,122611,122612,1,2,0
35108,1,3,122611,122612,122615,1,4,0
35109,4,1,122615,122615,122616,0,1,0
35110,3,2,122618,122618,122620,0,2,2
35111,5,1,122623,122623,122624,0,1,3
35112,6,1,122629,122629,122630,0,1,5
35113,3,2,122632,122632,122634,0,2,2
35114,5,2,122637,122637,122639,0,2,3
35115,5,3,122642,122642,122645,0,3,3
35116,1,1,122643,122645,122646,2,3,0
35117,4,1,122647,122647,122648,0,1,1
35118,6,1,122653,122653,122654,0,1,5
35119,5,3,122658,122658,122661,0,3,4
35120,6,1,122664,122664,122665,0,1,3
35121,5,3,122669,122669,122672,0,3,4
35122,5,3,122674,122674,122677,0,3,2
35123,2,3,122676,122677,122680,1,4,0
35124,2,1,122678,122680,122681,2,3,0
35125,1,2,122679,122681,122683,2,4,0
35126,4,3,122683,122683,122686,0,3,0
35127,5,2,122688,122688,122690,0,2,2
35128,6,2,122694,122694,122696,0,2,4
35129,5,1,122699,122699,122700,0,1,3
35130,3,3,122702,122702,122705,0,3,2
35131,6,2,122708,122708,122710,0,2,3
35132,1,3,122709,122710,122713,1,4,0
35133,4,3,122713,122713,122716,0,3,0
35134,5,1,122718,122718,122719,0,1,2
35135,6,1,122724,122724,122725,0,1,5
35136,3,2,122727,122727,122729,0,2,2
35137,2,3,122729,122729,122732,0,3,0
35138,6,3,122735,122735,122738,0,3,3
35139,3,3,122738,122738,122741,0,3,0
35140,2,3,122740,122741,122744,1,4,0
35141,3,1,122743,122744,122745,1,2,0
35142,3,2,122746,122746,122748,0,2,1
35143,2,1,122748,122748,122749,0,1,0
35144,1,2,122749,122749,122751,0,2,0
35145,4,3,122753,122753,122756,0,3,2
35146,1,1,122754,122756,122757,2,3,0
35147,3,1,122757,122757,122758,0,1,0
35148,4,2,122761,122761,122763,0,2,3
35149,6,1,122767,122767,122768,0,1,4
35150,1,2,122768,122768,122770,0,2,0
35151,1,3,122769,122770,122773,1,4,0
35152,3,1,122772,122773,122774,1,2,0
35153,3,3,122775,122775,122778,0,3,1
35154,4,3,122779,122779,122782,0,3,1
35155,3,1,122782,122782,122783,0,1,0
35156,3,3,122785,122785,122788,0,3,2
35157,2,1,122787,122788,122789,1,2,0
35158,6,2,122793,122793,122795,0,2,4
35159,6,3,122799,122799,122802,0,3,4
35160,6,2,122805,122805,122807,0,2,3
35161,3,2,122808,122808,122810,0,2,1
35162,1,2,122809,122810,122812,1,3,0
35163,1,2,122810,122812,122814,2,4,0
35164,3,1,122813,122814,122815,1,2,0
35165,3,1,122816,122816,122817,0,1,1
35166,2,2,122818,122818,122820,0,2,1
35167,3,3,122821,122821,122824,0,3,1
35168,1,3,122822,122824,122827,2,5,0
35169,2,3,122824,122827,122830,3,6,0
35170,4,1,122828,122830,122831,2,3,0
35171,1,3,122829,122831,122834,2,5,0
35172,4,1,122833,122834,122835,1,2,0
35173,2,3,122835,122835,122838,0,3,0
35174,6,2,122841,122841,122843,0,2,3
35175,6,1,122847,122847,122848,0,1,4
35176,1,3,122848,122848,122851,0,3,0
35177,5,3,122853,122853,122856,0,3,2
35178,3,2,122856,122856,122858,0,2,0
35179,2,3,122858,122858,122861,0,3,0
35180,5,3,122863,122863,122866,0,3,2
35181,1,2,122864,122866,122868,2,4,0
35182,1,2,122865,122868,122870,3,5,0
35183,4,1,122869,122870,122871,1,2,0
35184,6,3,122875,122875,122878,0,3,4
35185,3,2,122878,122878,122880,0,2,0
35186,3,3,122881,122881,122884,0,3,1
35187,3,3,122884,122884,122887,0,3,0
35188,4,3,122888,122888,122891,0,3,1
35189,6,3,122894,122894,122897,0,3,3
35190,2,2,122896,122897,122899,1,3,0
35191,2,3,122898,122899,122902,1,4,0
35192,6,1,122904,122904,122905,0,1,2
35193,6,3,122910,122910,122913,0,3,5
35194,2,3,122912,122913,122916,1,4,0
35195,6,3,122918,122918,122921,0,3,2
35196,5,2,122923,122923,122925,0,2,2
35197,3,1,122926,122926,122927,0,1,1
35198,3,1,122929,122929,122930,0,1,2
35199,3,2,122932,122932,122934,0,2,2
35200,4,3,122936,122936,122939,0,3,2
35201,5,3,122941,122941,122944,0,3,2
35202,5,2,122946,122946,122948,0,2,2
35203,6,3,122952,122952,122955,0,3,4
35204,5,1,122957,122957,122958,0,1,2
35205,6,3,122963,122963,122966,0,3,5
35206,1,2,122964,122966,122968,2,4,0
35207,3,2,122967,122968,122970,1,3,0
35208,5,1,122972,122972,122973,0,1,2
35209,3,2,122975,122975,122977,0,2,2
35210,6,3,122981,122981,122984,0,3,4
35211,5,3,122986,122986,122989,0,3,2
35212,4,3,122990,122990,122993,0,3,1
35213,4,1,122994,122994,122995,0,1,1
35214,2,1,122996,122996,122997,0,1,1
35215,2,1,122998,122998,122999,0,1,1
35216,3,1,123001,123001,123002,0,1,2
35217,2,3,123003,123003,123006,0,3,1
35218,2,2,123005,123006,123008,1,3,0
35219,5,1,123010,123010,123011,0,1,2
35220,5,2,123015,123015,123017,0,2,4
35221,3,2,123018,123018,123020,0,2,1
35222,3,3,123021,123021,123024,0,3,1
35223,1,1,123022,123024,123025,2,3,0
35224,4,2,123026,123026,123028,0,2,1
35225,1,1,123027,123028,123029,1,2,0
35226,5,3,123032,123032,123035,0,3,3
35227,5,1,123037,123037,123038,0,1,2
35228,2,3,123039,123039,123042,0,3,1
35229,3,3,123042,123042,123045,0,3,0
35230,6,2,123048,123048,123050,0,2,3
35231,3,3,123051,123051,123054,0,3,1
35232,5,2,123056,123056,123058,0,2,2
35233,5,3,123061,123061,123064,0,3,3
35234,5,3,123066,123066,123069,0,3,2
35235,3,2,123069,123069,123071,0,2,0
35236,4,1,123073,123073,123074,0,1,2
35237,6,2,123079,123079,123081,0,2,5
35238,6,3,123085,123085,123088,0,3,4
35239,2,3,123087,123088,123091,1,4,0
35240,5,1,123092,123092,123093,0,1,1
35241,1,1,123093,123093,123094,0,1,0
35242,3,1,123096,123096,123097,0,1,2
35243,6,3,123102,123102,123105,0,3,5
35244,1,3,123103,123105,123108,2,5,0
35245,1,3,123104,123108,123111,4,7,0
35246,6,2,123110,123111,123113,1,3,0
35247,6,2,123116,123116,123118,0,2,3
35248,3,1,123119,123119,123120,0,1,1
35249,2,2,123121,123121,123123,0,2,1
35250,3,1,123124,123124,123125,0,1,1
35251,2,1,123126,123126,123127,0,1,1
35252,6,1,123132,123132,123133,0,1,5
35253,2,3,123134,123134,123137,0,3,1
35254,1,1,123135,123137,123138,2,3,0
35255,1,1,123136,123138,123139,2,3,0
35256,3,1,123139,123139,123140,0,1,0
35257,2,1,123141,123141,123142,0,1,1
35258,4,2,123145,123145,123147,0,2,3
35259,5,3,123150,123150,123153,0,3,3
35260,1,2,123151,123153,123155,2,4,0
35261,3,1,123154,123155,123156,1,2,0
35262,5,1,123159,123159,123160,0,1,3
35263,1,3,123160,123160,123163,0,3,0
35264,3,1,123163,123163,123164,0,1,0
35265,3,2,123166,123166,123168,0,2,2
35266,6,1,123172,123172,123173,0,1,4
35267,5,2,123177,123177,123179,0,2,4
35268,6,1,123183,123183,123184,0,1,4
35269,5,2,123188,123188,123190,0,2,4
35270,4,1,123192,123192,123193,0,1,2
35271,4,2,123196,123196,123198,0,2,3
35272,5,2,123201,123201,123203,0,2,3
35273,6,3,123207,123207,123210,0,3,4
35274,1,1,123208,123210,123211,2,3,0
35275,3,1,123211,123211,123212,0,1,0
35276,2,1,123213,123213,123214,0,1,1
35277,2,1,123215,123215,123216,0,1,1
35278,2,3,123217,123217,123220,0,3,1
35279,2,1,123219,123220,123221,1,2,0
35280,3,1,123222,123222,123223,0,1,1
35281,3,1,123225,123225,123226,0,1,2
35282,4,3,123229,123229,123232,0,3,3
35283,1,2,123230,123232,123234,2,4,0
35284,2,1,123232,123234,123235,2,3,0
35285,5,2,123237,123237,123239,0,2,2
35286,5,3,123242,123242,123245,0,3,3
35287,1,1,123243,123245,123246,2,3,0
35288,1,2,123244,123246,123248,2,4,0
35289,1,1,123245,123248,123249,3,4,0
35290,3,3,123248,123249,123252,1,4,0
35291,3,1,123251,123252,123253,1,2,0
35292,2,3,123253,123253,123256,0,3,0
35293,6,2,123259,123259,123261,0,2,3
35294,5,1,123264,123264,123265,0,1,3
35295,5,2,123269,123269,123271,0,2,4
35296,6,1,123275,123275,123276,0,1,4
35297,4,2,123279,123279,123281,0,2,3
35298,1,1,123280,123281,123282,1,2,0
35299,1,3,123281,123282,123285,1,4,0
35300,2,2,123283,123285,123287,2,4,0
35301,1,1,123284,123287,123288,3,4,0
35302,3,1,123287,123288,123289,1,2,0
35303,4,3,123291,123291,123294,0,3,2
35304,6,2,123297,123297,123299,0,2,3
35305,1,1,123298,123299,123300,1,2,0
35306,3,2,123301,123301,123303,0,2,1
35307,4,1,123305,123305,123306,0,1,2
35308,3,1,123308,123308,123309,0,1,2
35309,2,3,123310,123310,123313,0,3,1
35310,1,3,123311,123313,123316,2,5,0
35311,4,1,123315,123316,123317,1,2,0
35312,2,1,123317,123317,123318,0,1,0
35313,6,1,123323,123323,123324,0,1,5
35314,2,2,123325,123325,123327,0,2,1
35315,1,2,123326,123327,123329,1,3,0
35316,4,2,123330,123330,123332,0,2,1
35317,4,1,123334,123334,123335,0,1,2
35318,5,2,123339,123339,123341,0,2,4
35319,1,2,123340,123341,123343,1,3,0
35320,5,3,123345,123345,123348,0,3,2
35321,4,1,123349,123349,123350,0,1,1
35322,6,3,123355,123355,123358,0,3,5
35323,5,2,123360,123360,123362,0,2,2
35324,6,3,123366,123366,123369,0,3,4
35325,3,1,123369,123369,123370,0,1,0
35326,5,1,123374,123374,123375,0,1,4
35327,6,2,123380,123380,123382,0,2,5
35328,1,1,123381,123382,123383,1,2,0
35329,6,2,123387,123387,123389,0,2,4
35330,4,2,123391,123391,123393,0,2,2
35331,5,1,123396,123396,123397,0,1,3
35332,4,1,123400,123400,123401,0,1,3
35333,6,3,123406,123406,123409,0,3,5
35334,5,3,123411,123411,123414,0,3,2
35335,3,3,123414,123414,123417,0,3,0
35336,2,1,123416,123417,123418,1,2,0
35337,2,3,123418,123418,123421,0,3,0
35338,5,3,123423,123423,123426,0,3,2
35339,4,1,123427,123427,123428,0,1,1
35340,1,2,123428,123428,123430,0,2,0
35341,5,2,123433,123433,123435,0,2,3
35342,3,2,123436,123436,123438,0,2,1
35343,2,3,123438,123438,123441,0,3,0
35344,2,2,123440,123441,123443,1,3,0
35345,2,1,123442,123443,123444,1,2,0
35346,1,2,123443,123444,123446,1,3,0
35347,1,1,123444,123446,123447,2,3,0
35348,5,1,123449,123449,123450,0,1,2
35349,1,2,123450,123450,123452,0,2,0
35350,2,2,123452,123452,123454,0,2,0
35351,3,1,123455,123455,123456,0,1,1
35352,6,3,123461,123461,123464,0,3,5
35353,6,1,123467,123467,123468,0,1,3
35354,5,3,123472,123472,123475,0,3,4
35355,5,3,123477,123477,123480,0,3,2
35356,6,1,123483,123483,123484,0,1,3
35357,6,2,123489,123489,123491,0,2,5
35358,4,3,123493,123493,123496,0,3,2
35359,3,2,123496,123496,123498,0,2,0
35360,1,1,123497,123498,123499,1,2,0
35361,6,1,123503,123503,123504,0,1,4
35362,6,2,123509,123509,123511,0,2,5
35363,6,1,123515,123515,123516,0,1,4
35364,5,3,123520,123520,123523,0,3,4
35365,1,3,123521,123523,123526,2,5,0
35366,3,2,123524,123526,123528,2,4,0
35367,1,3,123525,123528,123531,3,6,0
35368,5,2,123530,123531,123533,1,3,0
35369,2,1,123532,123533,123534,1,2,0
35370,1,3,123533,123534,123537,1,4,0
35371,3,3,123536,123537,123540,1,4,0
35372,4,2,123540,123540,123542,0,2,0
35373,5,3,123545,123545,123548,0,3,3
35374,6,1,123551,123551,123552,0,1,3
35375,4,3,123555,123555,123558,0,3,3
35376,3,2,123558,123558,123560,0,2,0
35377,1,2,123559,123560,123562,1,3,0
35378,2,3,123561,123562,123565,1,4,0
35379,4,3,123565,123565,123568,0,3,0
35380,6,2,123571,123571,123573,0,2,3
35381,1,3,123572,123573,123576,1,4,0
35382,6,3,123578,123578,123581,0,3,2
35383,3,1,123581,123581,123582,0,1,0
35384,5,2,123586,123586,123588,0,2,4
35385,3,1,123589,123589,123590,0,1,1
35386,3,2,123592,123592,123594,0,2,2
35387,3,1,123595,123595,123596,0,1,1
35388,5,1,123600,123600,123601,0,1,4
35389,2,1,123602,123602,123603,0,1,1
35390,1,1,123603,123603,123604,0,1,0
35391,6,1,123609,123609,123610,0,1,5
35392,2,3,123611,123611,123614,0,3,1
35393,1,1,123612,123614,123615,2,3,0
35394,2,3,123614,123615,123618,1,4,0
35395,5,2,123619,123619,123621,0,2,1
35396,6,2,123625,123625,123627,0,2,4
35397,2,2,123627,123627,123629,0,2,0
35398,5,1,123632,123632,123633,0,1,3
35399,4,1,123636,123636,123637,0,1,3
35400,3,1,123639,123639,123640,0,1,2
35401,4,1,123643,123643,123644,0,1,3
35402,3,1,123646,123646,123647,0,1,2
35403,4,2,123650,123650,123652,0,2,3
35404,1,2,123651,123652,123654,1,3,0
35405,3,3,123654,123654,123657,0,3,0
35406,2,2,123656,123657,123659,1,3,0
35407,5,1,123661,123661,123662,0,1,2
35408,3,1,123664,123664,123665,0,1,2
35409,6,3,123670,123670,123673,0,3,5
35410,1,1,123671,123673,123674,2,3,0
35411,3,2,123674,123674,123676,0,2,0
35412,2,2,123676,123676,123678,0,2,0
35413,6,3,123682,123682,123685,0,3,4
35414,4,2,123686,123686,123688,0,2,1
35415,2,1,123688,123688,123689,0,1,0
35416,4,2,123692,123692,123694,0,2,3
35417,3,1,123695,123695,123696,0,1,1
35418,2,3,123697,123697,123700,0,3,1
35419,5,1,123702,123702,123703,0,1,2
35420,6,2,123708,123708,123710,0,2,5
35421,1,3,123709,123710,123713,1,4,0
35422,5,1,123714,123714,123715,0,1,1
35423,3,1,123717,123717,123718,0,1,2
35424,5,2,123722,123722,123724,0,2,4
35425,6,1,123728,123728,123729,0,1,4
35426,4,3,123732,123732,123735,0,3,3
35427,1,2,123733,123735,123737,2,4,0
35428,4,3,123737,123737,123740,0,3,0
35429,6,3,123743,123743,123746,0,3,3
35430,1,3,123744,123746,123749,2,5,0
35431,1,3,123745,123749,123752,4,7,0
35432,2,1,123747,123752,123753,5,6,0
35433,6,2,123753,123753,123755,0,2,0
35434,2,2,123755,123755,123757,0,2,0
35435,5,2,123760,123760,123762,0,2,3
35436,5,3,123765,123765,123768,0,3,3
35437,1,3,123766,123768,123771,2,5,0
35438,2,3,123768,123771,123774,3,6,0
35439,5,3,123773,123774,123777,1,4,0
35440,4,2,123777,123777,123779,0,2,0
35441,2,3,123779,123779,123782,0,3,0
35442,3,2,123782,123782,123784,0,2,0
35443,2,3,123784,123784,123787,0,3,0
35444,2,1,123786,123787,123788,1,2,0
35445,3,2,123789,123789,123791,0,2,1
35446,5,2,123794,123794,123796,0,2,3
35447,6,1,123800,123800,123801,0,1,4
35448,2,2,123802,123802,123804,0,2,1
35449,4,1,123806,123806,123807,0,1,2
35450,1,2,123807,123807,123809,0,2,0
35451,4,1,123811,123811,123812,0,1,2
35452,2,2,123813,123813,123815,0,2,1
35453,6,3,123819,123819,123822,0,3,4
35454,3,3,123822,123822,123825,0,3,0
35455,4,2,123826,123826,123828,0,2,1
35456,2,1,123828,123828,123829,0,1,0
35457,6,3,123834,123834,123837,0,3,5
35458,6,3,123840,123840,123843,0,3,3
35459,5,1,123845,123845,123846,0,1,2
35460,2,1,123847,123847,123848,0,1,1
35461,1,2,123848,123848,123850,0,2,0
35462,5,2,123853,123853,123855,0,2,3
35463,1,1,123854,123855,123856,1,2,0
35464,6,2,123860,123860,123862,0,2,4
35465,6,1,123866,123866,123867,0,1,4
35466,1,2,123867,123867,123869,0,2,0
35467,2,2,123869,123869,123871,0,2,0
35468,3,1,123872,123872,123873,0,1,1
35469,6,2,123878,123878,123880,0,2,5
35470,3,3,123881,123881,123884,0,3,1
35471,4,2,123885,123885,123887,0,2,1
35472,3,3,123888,123888,123891,0,3,1
35473,2,2,123890,123891,123893,1,3,0
35474,6,3,123896,123896,123899,0,3,3
35475,3,2,123899,123899,123901,0,2,0
35476,5,3,123904,123904,123907,0,3,3
35477,5,2,123909,123909,123911,0,2,2
35478,1,3,123910,123911,123914,1,4,0
35479,3,1,123913,123914,123915,1,2,0
35480,1,3,123914,123915,123918,1,4,0
35481,6,1,123920,123920,123921,0,1,2
35482,4,1,123924,123924,123925,0,1,3
35483,3,3,123927,123927,123930,0,3,2
35484,3,2,123930,123930,123932,0,2,0
35485,5,2,123935,123935,123937,0,2,3
35486,2,2,123937,123937,123939,0,2,0
35487,1,2,123938,123939,123941,1,3,0
35488,4,3,123942,123942,123945,0,3,1
35489,6,1,123948,123948,123949,0,1,3
35490,4,3,123952,123952,123955,0,3,3
35491,6,2,123958,123958,123960,0,2,3
35492,4,3,123962,123962,123965,0,3,2
35493,6,1,123968,123968,123969,0,1,3
35494,1,2,123969,123969,123971,0,2,0
35495,5,3,123974,123974,123977,0,3,3
35496,5,1,123979,123979,123980,0,1,2
35497,6,1,123985,123985,123986,0,1,5
35498,5,2,123990,123990,123992,0,2,4
35499,4,2,123994,123994,123996,0,2,2
35500,5,1,123999,123999,124000,0,1,3
35501,5,1,124004,124004,124005,0,1,4
35502,5,1,124009,124009,124010,0,1,4
35503,4,1,124013,124013,124014,0,1,3
35504,5,3,124018,124018,124021,0,3,4
35505,1,3,124019,124021,124024,2,5,0
35506,2,1,124021,124024,124025,3,4,0
35507,6,3,124027,124027,124030,0,3,2
35508,3,2,124030,124030,124032,0,2,0
35509,6,3,124036,124036,124039,0,3,4
35510,1,3,124037,124039,124042,2,5,0
35511,6,1,124043,124043,124044,0,1,1
35512,1,3,124044,124044,124047,0,3,0
35513,4,2,124048,124048,124050,0,2,1
35514,1,2,124049,124050,124052,1,3,0
35515,6,2,124055,124055,124057,0,2,3
35516,1,3,124056,124057,124060,1,4,0
35517,1,3,124057,124060,124063,3,6,0
35518,1,1,124058,124063,124064,5,6,0
35519,2,2,124060,124064,124066,4,6,0
35520,4,2,124064,124066,124068,2,4,0
35521,1,2,124065,124068,124070,3,5,0
35522,5,1,124070,124070,124071,0,1,0
35523,6,3,124076,124076,124079,0,3,5
35524,4,3,124080,124080,124083,0,3,1
35525,3,3,124083,124083,124086,0,3,0
35526,2,2,124085,124086,124088,1,3,0
35527,2,1,124087,124088,124089,1,2,0
35528,5,1,124092,124092,124093,0,1,3
35529,5,2,124097,124097,124099,0,2,4
35530,5,3,124102,124102,124105,0,3,3
35531,5,3,124107,124107,124110,0,3,2
35532,1,1,124108,124110,124111,2,3,0
35533,1,3,124109,124111,124114,2,5,0
35534,2,3,124111,124114,124117,3,6,0
35535,5,3,124116,124117,124120,1,4,0
35536,3,3,124119,124120,124123,1,4,0
35537,5,3,124124,124124,124127,0,3,1
35538,2,3,124126,124127,124130,1,4,0
35539,2,3,124128,124130,124133,2,5,0
35540,3,3,124131,124133,124136,2,5,0
35541,3,1,124134,124136,124137,2,3,0
35542,1,2,124135,124137,124139,2,4,0
35543,5,3,124140,124140,124143,0,3,1
35544,6,1,124146,124146,124147,0,1,3
35545,2,2,124148,124148,124150,0,2,1
35546,5,1,124153,124153,124154,0,1,3
35547,3,3,124156,124156,124159,0,3,2
35548,3,2,124159,124159,124161,0,2,0
35549,6,1,124165,124165,124166,0,1,4
35550,5,3,124170,124170,124173,0,3,4
35551,5,2,124175,124175,124177,0,2,2
35552,5,1,124180,124180,124181,0,1,3
35553,6,1,124186,124186,124187,0,1,5
35554,3,1,124189,124189,124190,0,1,2
35555,6,1,124195,124195,124196,0,1,5
35556,1,2,124196,124196,124198,0,2,0
35557,6,2,124202,124202,124204,0,2,4
35558,5,1,124207,124207,124208,0,1,3
35559,6,3,124213,124213,124216,0,3,5
35560,5,1,124218,124218,124219,0,1,2
35561,1,1,124219,124219,124220,0,1,0
35562,1,1,124220,124220,124221,0,1,0
35563,6,1,124226,124226,124227,0,1,5
35564,3,3,124229,124229,124232,0,3,2
35565,2,1,124231,124232,124233,1,2,0
35566,1,3,124232,124233,124236,1,4,0
35567,2,1,124234,124236,124237,2,3,0
35568,2,3,124236,124237,124240,1,4,0
35569,2,3,124238,124240,124243,2,5,0
35570,4,1,124242,124243,124244,1,2,0
35571,6,1,124248,124248,124249,0,1,4
35572,4,1,124252,124252,124253,0,1,3
35573,6,1,124258,124258,124259,0,1,5
35574,2,2,124260,124260,124262,0,2,1
35575,2,3,124262,124262,124265,0,3,0
35576,2,2,124264,124265,124267,1,3,0
35577,3,3,124267,124267,124270,0,3,0
35578,3,1,124270,124270,124271,0,1,0
35579,2,3,124272,124272,124275,0,3,1
35580,2,2,124274,124275,124277,1,3,0
35581,3,2,124277,124277,124279,0,2,0
35582,2,3,124279,124279,124282,0,3,0
35583,1,2,124280,124282,124284,2,4,0
35584,1,3,124281,124284,124287,3,6,0
35585,3,3,124284,124287,124290,3,6,0
35586,5,1,124289,124290,124291,1,2,0
35587,4,1,124293,124293,124294,0,1,2
35588,6,3,124299,124299,124302,0,3,5
35589,2,1,124301,124302,124303,1,2,0
35590,1,3,124302,124303,124306,1,4,0
35591,3,3,124305,124306,124309,1,4,0
35592,4,3,124309,124309,124312,0,3,0
35593,2,2,124311,124312,124314,1,3,0
35594,1,3,124312,124314,124317,2,5,0
35595,2,3,124314,124317,124320,3,6,0
35596,2,2,124316,124320,124322,4,6,0
35597,5,3,124321,124322,124325,1,4,0
35598,1,3,124322,124325,124328,3,6,0
35599,1,3,124323,124328,124331,5,8,0
35600,1,2,124324,124331,124333,7,9,0
35601,3,1,124327,124333,124334,6,7,0
35602,3,1,124330,124334,124335,4,5,0
35603,1,3,124331,124335,124338,4,7,0
35604,2,2,124333,124338,124340,5,7,0
35605,4,1,124337,124340,124341,3,4,0
35606,3,1,124340,124341,124342,1,2,0
35607,3,2,124343,124343,124345,0,2,1
35608,6,3,124349,124349,124352,0,3,4
35609,4,3,124353,124353,124356,0,3,1
35610,6,3,124359,124359,124362,0,3,3
35611,2,1,124361,124362,124363,1,2,0
35612,6,1,124367,124367,124368,0,1,4
35613,3,2,124370,124370,124372,0,2,2
35614,3,3,124373,124373,124376,0,3,1
35615,6,3,124379,124379,124382,0,3,3
35616,1,1,124380,124382,124383,2,3,0
35617,4,3,124384,124384,124387,0,3,1
35618,5,1,124389,124389,124390,0,1,2
35619,6,2,124395,124395,124397,0,2,5
35620,3,3,124398,124398,124401,0,3,1
35621,3,2,124401,124401,124403,0,2,0
35622,3,3,124404,124404,124407,0,3,1
35623,4,3,124408,124408,124411,0,3,1
35624,3,2,124411,124411,124413,0,2,0
35625,1,2,124412,124413,124415,1,3,0
35626,6,1,124418,124418,124419,0,1,3
35627,6,3,124424,124424,124427,0,3,5
35628,2,1,124426,124427,124428,1,2,0
35629,2,3,124428,124428,124431,0,3,0
35630,4,2,124432,124432,124434,0,2,1
35631,2,3,124434,124434,124437,0,3,0
35632,3,3,124437,124437,124440,0,3,0
35633,3,3,124440,124440,124443,0,3,0
35634,1,1,124441,124443,124444,2,3,0
35635,4,3,124445,124445,124448,0,3,1
35636,2,3,124447,124448,124451,1,4,0
35637,6,3,124453,124453,124456,0,3,2
35638,4,3,124457,124457,124460,0,3,1
35639,1,1,124458,124460,124461,2,3,0
35640,2,2,124460,124461,124463,1,3,0
35641,3,2,124463,124463,124465,0,2,0
35642,4,2,124467,124467,124469,0,2,2
35643,2,1,124469,124469,124470,0,1,0
35644,3,3,124472,124472,124475,0,3,2
35645,2,3,124474,124475,124478,1,4,0
35646,5,1,124479,124479,124480,0,1,1
35647,3,1,124482,124482,124483,0,1,2
35648,4,3,124486,124486,124489,0,3,3
35649,3,1,124489,124489,124490,0,1,0
35650,5,1,124494,124494,124495,0,1,4
35651,1,2,124495,124495,124497,0,2,0
35652,2,1,124497,124497,124498,0,1,0
35653,2,2,124499,124499,124501,0,2,1
35654,4,1,124503,124503,124504,0,1,2
35655,6,1,124509,124509,124510,0,1,5
35656,4,1,124513,124513,124514,0,1,3
35657,4,1,124517,124517,124518,0,1,3
35658,1,3,124518,124518,124521,0,3,0
35659,5,3,124523,124523,124526,0,3,2
35660,4,3,124527,124527,124530,0,3,1
35661,4,3,124531,124531,124534,0,3,1
35662,5,1,124536,124536,124537,0,1,2
35663,2,2,124538,124538,124540,0,2,1
35664,1,3,124539,124540,124543,1,4,0
35665,3,1,124542,124543,124544,1,2,0
35666,4,2,124546,124546,124548,0,2,2
35667,6,2,124552,124552,124554,0,2,4
35668,5,2,124557,124557,124559,0,2,3
35669,1,3,124558,124559,124562,1,4,0
35670,3,3,124561,124562,124565,1,4,0
35671,2,1,124563,124565,124566,2,3,0
35672,3,2,124566,124566,124568,0,2,0
35673,5,3,124571,124571,124574,0,3,3
35674,4,3,124575,124575,124578,0,3,1
35675,5,3,124580,124580,124583,0,3,2
35676,3,2,124583,124583,124585,0,2,0
35677,2,1,124585,124585,124586,0,1,0
35678,6,1,124591,124591,124592,0,1,5
35679,1,2,124592,124592,124594,0,2,0
35680,1,3,124593,124594,124597,1,4,0
35681,5,1,124598,124598,124599,0,1,1
35682,3,3,124601,124601,124604,0,3,2
35683,2,3,124603,124604,124607,1,4,0
35684,2,1,124605,124607,124608,2,3,0
35685,3,2,124608,124608,124610,0,2,0
35686,6,1,124614,124614,124615,0,1,4
35687,3,3,124617,124617,124620,0,3,2
35688,4,3,124621,124621,124624,0,3,1
35689,1,3,124622,124624,124627,2,5,0
35690,3,2,124625,124627,124629,2,4,0
35691,3,3,124628,124629,124632,1,4,0
35692,6,2,124634,124634,124636,0,2,2
35693,4,2,124638,124638,124640,0,2,2
35694,3,1,124641,124641,124642,0,1,1
35695,3,2,124644,124644,124646,0,2,2
35696,1,1,124645,124646,124647,1,2,0
35697,4,2,124649,124649,124651,0,2,2
35698,6,1,124655,124655,124656,0,1,4
35699,1,2,124656,124656,124658,0,2,0
35700,1,2,124657,124658,124660,1,3,0
35701,4,2,124661,124661,124663,0,2,1
35702,1,1,124662,124663,124664,1,2,0
35703,1,1,124663,124664,124665,1,2,0
35704,3,2,124666,124666,124668,0,2,1
35705,3,3,124669,124669,124672,0,3,1
35706,6,3,124675,124675,124678,0,3,3
35707,2,1,124677,124678,124679,1,2,0
35708,2,3,124679,124679,124682,0,3,0
35709,1,1,124680,124682,124683,2,3,0
35710,3,1,124683,124683,124684,0,1,0
35711,3,1,124686,124686,124687,0,1,2
35712,2,1,124688,124688,124689,0,1,1
35713,1,1,124689,124689,124690,0,1,0
35714,5,1,124694,124694,124695,0,1,4
35715,2,2,124696,124696,124698,0,2,1
35716,1,2,124697,124698,124700,1,3,0
35717,4,1,124701,124701,124702,0,1,1
35718,1,1,124702,124702,124703,0,1,0
35719,6,1,124708,124708,124709,0,1,5
35720,5,2,124713,124713,124715,0,2,4
35721,1,3,124714,124715,124718,1,4,0
35722,6,2,124720,124720,124722,0,2,2
35723,1,2,124721,124722,124724,1,3,0
35724,5,2,124726,124726,124728,0,2,2
35725,3,1,124729,124729,124730,0,1,1
35726,2,3,124731,124731,124734,0,3,1
35727,3,2,124734,124734,124736,0,2,0
35728,5,3,124739,124739,124742,0,3,3
35729,6,3,124745,124745,124748,0,3,3
35730,6,1,124751,124751,124752,0,1,3
35731,2,1,124753,124753,124754,0,1,1
35732,2,2,124755,124755,124757,0,2,1
35733,4,1,124759,124759,124760,0,1,2
35734,1,2,124760,124760,124762,0,2,0
35735,5,3,124765,124765,124768,0,3,3
35736,3,3,124768,124768,124771,0,3,0
35737,2,1,124770,124771,124772,1,2,0
35738,4,2,124774,124774,124776,0,2,2
35739,6,2,124780,124780,124782,0,2,4
35740,2,1,124782,124782,124783,0,1,0
35741,5,2,124787,124787,124789,0,2,4
35742,3,3,124790,124790,124793,0,3,1
35743,2,2,124792,124793,124795,1,3,0
35744,5,2,124797,124797,124799,0,2,2
35745,6,2,124803,124803,124805,0,2,4
35746,3,1,124806,124806,124807,0,1,1
35747,1,2,124807,124807,124809,0,2,0
35748,2,2,124809,124809,124811,0,2,0
35749,6,3,124815,124815,124818,0,3,4
35750,4,3,124819,124819,124822,0,3,1
35751,6,2,124825,124825,124827,0,2,3
35752,3,2,124828,124828,124830,0,2,1
35753,2,2,124830,124830,124832,0,2,0
35754,3,3,124833,124833,124836,0,3,1
35755,3,1,124836,124836,124837,0,1,0
35756,4,1,124840,124840,124841,0,1,3
35757,1,1,124841,124841,124842,0,1,0
35758,5,3,124846,124846,124849,0,3,4
35759,1,3,124847,124849,124852,2,5,0
35760,3,2,124850,124852,124854,2,4,0
35761,3,2,124853,124854,124856,1,3,0
35762,4,3,124857,124857,124860,0,3,1
35763,4,3,124861,124861,124864,0,3,1
35764,6,1,124867,124867,124868,0,1,3
35765,2,3,124869,124869,124872,0,3,1
35766,2,2,124871,124872,124874,1,3,0
35767,4,3,124875,124875,124878,0,3,1
35768,5,1,124880,124880,124881,0,1,2
35769,6,3,124886,124886,124889,0,3,5
35770,4,3,124890,124890,124893,0,3,1
35771,6,2,124896,124896,124898,0,2,3
35772,1,3,124897,124898,124901,1,4,0
35773,3,1,124900,124901,124902,1,2,0
35774,3,1,124903,124903,124904,0,1,1
35775,5,2,124908,124908,124910,0,2,4
35776,2,2,124910,124910,124912,0,2,0
35777,5,1,124915,124915,124916,0,1,3
35778,3,2,124918,124918,124920,0,2,2
35779,2,3,124920,124920,124923,0,3,0
35780,4,3,124924,124924,124927,0,3,1
35781,3,2,124927,124927,124929,0,2,0
35782,4,2,124931,124931,124933,0,2,2
35783,6,2,124937,124937,124939,0,2,4
35784,6,1,124943,124943,124944,0,1,4
35785,4,2,124947,124947,124949,0,2,3
35786,1,2,124948,124949,124951,1,3,0
35787,3,3,124951,124951,124954,0,3,0
35788,5,3,124956,124956,124959,0,3,2
35789,1,1,124957,124959,124960,2,3,0
35790,6,2,124963,124963,124965,0,2,3
35791,3,2,124966,124966,124968,0,2,1
35792,4,1,124970,124970,124971,0,1,2
35793,6,2,124976,124976,124978,0,2,5
35794,1,1,124977,124978,124979,1,2,0
35795,2,2,124979,124979,124981,0,2,0
35796,3,3,124982,124982,124985,0,3,1
35797,5,2,124987,124987,124989,0,2,2
35798,5,2,124992,124992,124994,0,2,3
35799,4,1,124996,124996,124997,0,1,2
35800,2,1,124998,124998,124999,0,1,1
35801,2,1,125000,125000,125001,0,1,1
35802,1,3,125001,125001,125004,0,3,0
35803,6,1,125007,125007,125008,0,1,3
35804,4,2,125011,125011,125013,0,2,3
35805,6,3,125017,125017,125020,0,3,4
35806,1,2,125018,125020,125022,2,4,0
35807,2,2,125020,125022,125024,2,4,0
35808,2,1,125022,125024,125025,2,3,0
35809,4,2,125026,125026,125028,0,2,1
35810,4,3,125030,125030,125033,0,3,2
35811,2,2,125032,125033,125035,1,3,0
35812,6,2,125038,125038,125040,0,2,3
35813,5,2,125043,125043,125045,0,2,3
35814,6,1,125049,125049,125050,0,1,4
35815,3,1,125052,125052,125053,0,1,2
35816,2,3,125054,125054,125057,0,3,1
35817,3,3,125057,125057,125060,0,3,0
35818,2,1,125059,125060,125061,1,2,0
35819,5,3,125064,125064,125067,0,3,3
35820,2,2,125066,125067,125069,1,3,0
35821,2,2,125068,125069,125071,1,3,0
35822,4,3,125072,125072,125075,0,3,1
35823,6,3,125078,125078,125081,0,3,3
35824,4,3,125082,125082,125085,0,3,1
35825,3,3,125085,125085,125088,0,3,0
35826,4,3,125089,125089,125092,0,3,1
35827,4,1,125093,125093,125094,0,1,1
35828,4,2,125097,125097,125099,0,2,3
35829,5,3,125102,125102,125105,0,3,3
35830,4,2,125106,125106,125108,0,2,1
35831,4,1,125110,125110,125111,0,1,2
35832,1,3,125111,125111,125114,0,3,0
35833,2,3,125113,125114,125117,1,4,0
35834,3,2,125116,125117,125119,1,3,0
35835,2,2,125118,125119,125121,1,3,0
35836,2,3,125120,125121,125124,1,4,0
35837,2,2,125122,125124,125126,2,4,0
35838,4,2,125126,125126,125128,0,2,0
35839,6,2,125132,125132,125134,0,2,4
35840,1,3,125133,125134,125137,1,4,0
35841,4,1,125137,125137,125138,0,1,0
35842,2,1,125139,125139,125140,0,1,1
35843,5,3,125144,125144,125147,0,3,4
35844,4,3,125148,125148,125151,0,3,1
35845,4,2,125152,125152,125154,0,2,1
35846,4,2,125156,125156,125158,0,2,2
35847,3,3,125159,125159,125162,0,3,1
35848,4,1,125163,125163,125164,0,1,1
35849,6,3,125169,125169,125172,0,3,5
35850,4,2,125173,125173,125175,0,2,1
35851,1,2,125174,125175,125177,1,3,0
35852,1,3,125175,125177,125180,2,5,0
35853,1,3,125176,125180,125183,4,7,0
35854,2,1,125178,125183,125184,5,6,0
35855,6,2,125184,125184,125186,0,2,0
35856,6,2,125190,125190,125192,0,2,4
35857,3,3,125193,125193,125196,0,3,1
35858,1,1,125194,125196,125197,2,3,0
35859,6,1,125200,125200,125201,0,1,3
35860,1,3,125201,125201,125204,0,3,0
35861,2,3,125203,125204,125207,1,4,0
35862,2,2,125205,125207,125209,2,4,0
35863,4,3,125209,125209,125212,0,3,0
35864,5,2,125214,125214,125216,0,2,2
35865,1,2,125215,125216,125218,1,3,0
35866,6,2,125221,125221,125223,0,2,3
35867,1,2,125222,125223,125225,1,3,0
35868,2,2,125224,125225,125227,1,3,0
35869,5,3,125229,125229,125232,0,3,2
35870,3,2,125232,125232,125234,0,2,0
35871,6,3,125238,125238,125241,0,3,4
35872,2,3,125240,125241,125244,1,4,0
35873,2,3,125242,125244,125247,2,5,0
35874,5,1,125247,125247,125248,0,1,0
35875,5,1,125252,125252,125253,0,1,4
35876,1,3,125253,125253,125256,0,3,0
35877,5,2,125258,125258,125260,0,2,2
35878,2,3,125260,125260,125263,0,3,0
35879,1,1,125261,125263,125264,2,3,0
35880,1,1,125262,125264,125265,2,3,0
35881,2,3,125264,125265,125268,1,4,0
35882,2,1,125266,125268,125269,2,3,0
35883,5,2,125271,125271,125273,0,2,2
35884,1,1,125272,125273,125274,1,2,0
35885,1,2,125273,125274,125276,1,3,0
35886,1,1,125274,125276,125277,2,3,0
35887,5,3,125279,125279,125282,0,3,2
35888,5,2,125284,125284,125286,0,2,2
35889,5,3,125289,125289,125292,0,3,3
35890,5,2,125294,125294,125296,0,2,2
35891,6,2,125300,125300,125302,0,2,4
35892,4,3,125304,125304,125307,0,3,2
35893,6,1,125310,125310,125311,0,1,3
35894,3,1,125313,125313,125314,0,1,2
35895,3,3,125316,125316,125319,0,3,2
35896,6,3,125322,125322,125325,0,3,3
35897,4,2,125326,125326,125328,0,2,1
35898,3,3,125329,125329,125332,0,3,1
35899,6,2,125335,125335,125337,0,2,3
35900,5,2,125340,125340,125342,0,2,3
35901,5,3,125345,125345,125348,0,3,3
35902,2,1,125347,125348,125349,1,2,0
35903,3,2,125350,125350,125352,0,2,1
35904,2,2,125352,125352,125354,0,2,0
35905,3,3,125355,125355,125358,0,3,1
35906,1,2,125356,125358,125360,2,4,0
35907,6,2,125362,125362,125364,0,2,2
35908,4,2,125366,125366,125368,0,2,2
35909,2,1,125368,125368,125369,0,1,0
35910,3,1,125371,125371,125372,0,1,2
35911,2,3,125373,125373,125376,0,3,1
35912,4,2,125377,125377,125379,0,2,1
35913,5,3,125382,125382,125385,0,3,3
35914,1,2,125383,125385,125387,2,4,0
35915,2,2,125385,125387,125389,2,4,0
35916,4,3,125389,125389,125392,0,3,0
35917,1,2,125390,125392,125394,2,4,0
35918,4,2,125394,125394,125396,0,2,0
35919,4,1,125398,125398,125399,0,1,2
35920,4,3,125402,125402,125405,0,3,3
35921,2,2,125404,125405,125407,1,3,0
35922,1,2,125405,125407,125409,2,4,0
35923,6,2,125411,125411,125413,0,2,2
35924,6,1,125417,125417,125418,0,1,4
35925,3,2,125420,125420,125422,0,2,2
35926,6,2,125426,125426,125428,0,2,4
35927,2,3,125428,125428,125431,0,3,0
35928,4,1,125432,125432,125433,0,1,1
35929,6,1,125438,125438,125439,0,1,5
35930,6,3,125444,125444,125447,0,3,5
35931,3,1,125447,125447,125448,0,1,0
35932,6,3,125453,125453,125456,0,3,5
35933,5,3,125458,125458,125461,0,3,2
35934,5,3,125463,125463,125466,0,3,2
35935,6,3,125469,125469,125472,0,3,3
35936,4,3,125473,125473,125476,0,3,1
35937,1,3,125474,125476,125479,2,5,0
35938,2,2,125476,125479,125481,3,5,0
35939,4,2,125480,125481,125483,1,3,0
35940,3,2,125483,125483,125485,0,2,0
35941,4,2,125487,125487,125489,0,2,2
35942,6,2,125493,125493,125495,0,2,4
35943,5,1,125498,125498,125499,0,1,3
35944,1,3,125499,125499,125502,0,3,0
35945,5,2,125504,125504,125506,0,2,2
35946,1,2,125505,125506,125508,1,3,0
35947,1,2,125506,125508,125510,2,4,0
35948,4,1,125510,125510,125511,0,1,0
35949,5,1,125515,125515,125516,0,1,4
35950,6,3,125521,125521,125524,0,3,5
35951,6,2,125527,125527,125529,0,2,3
35952,6,3,125533,125533,125536,0,3,4
35953,2,3,125535,125536,125539,1,4,0
35954,5,1,125540,125540,125541,0,1,1
35955,2,3,125542,125542,125545,0,3,1
35956,5,2,125547,125547,125549,0,2,2
35957,2,2,125549,125549,125551,0,2,0
35958,3,1,125552,125552,125553,0,1,1
35959,3,2,125555,125555,125557,0,2,2
35960,1,2,125556,125557,125559,1,3,0
35961,2,3,125558,125559,125562,1,4,0
35962,3,2,125561,125562,125564,1,3,0
35963,5,1,125566,125566,125567,0,1,2
35964,5,1,125571,125571,125572,0,1,4
35965,1,2,125572,125572,125574,0,2,0
35966,5,3,125577,125577,125580,0,3,3
35967,4,2,125581,125581,125583,0,2,1
35968,4,2,125585,125585,125587,0,2,2
35969,6,1,125591,125591,125592,0,1,4
35970,1,1,125592,125592,125593,0,1,0
35971,3,2,125595,125595,125597,0,2,2
35972,1,2,125596,125597,125599,1,3,0
35973,2,2,125598,125599,125601,1,3,0
35974,3,1,125601,125601,125602,0,1,0
35975,3,3,125604,125604,125607,0,3,2
35976,3,1,125607,125607,125608,0,1,0
35977,5,2,125612,125612,125614,0,2,4
35978,1,1,125613,125614,125615,1,2,0
35979,3,3,125616,125616,125619,0,3,1
35980,2,1,125618,125619,125620,1,2,0
35981,5,1,125623,125623,125624,0,1,3
35982,1,3,125624,125624,125627,0,3,0
35983,1,1,125625,125627,125628,2,3,0
35984,6,2,125631,125631,125633,0,2,3
35985,2,2,125633,125633,125635,0,2,0
35986,3,2,125636,125636,125638,0,2,1
35987,5,3,125641,125641,125644,0,3,3
35988,3,1,125644,125644,125645,0,1,0
35989,6,1,125650,125650,125651,0,1,5
35990,1,2,125651,125651,125653,0,2,0
35991,5,3,125656,125656,125659,0,3,3
35992,6,1,125662,125662,125663,0,1,3
35993,5,1,125667,125667,125668,0,1,4
35994,5,1,125672,125672,125673,0,1,4
35995,1,2,125673,125673,125675,0,2,0
35996,6,3,125679,125679,125682,0,3,4
35997,2,1,125681,125682,125683,1,2,0
35998,4,1,125685,125685,125686,0,1,2
35999,4,2,125689,125689,125691,0,2,3
36000,4,1,125693,125693,125694,0,1,2
36001,6,3,125699,125699,125702,0,3,5
36002,3,1,125702,125702,125703,0,1,0
36003,2,1,125704,125704,125705,0,1,1
36004,6,3,125710,125710,125713,0,3,5
36005,1,3,125711,125713,125716,2,5,0
36006,1,3,125712,125716,125719,4,7,0
36007,5,1,125717,125719,125720,2,3,0
36008,6,1,125723,125723,125724,0,1,3
36009,3,1,125726,125726,125727,0,1,2
36010,6,3,125732,125732,125735,0,3,5
36011,2,3,125734,125735,125738,1,4,0
36012,5,2,125739,125739,125741,0,2,1
36013,1,3,125740,125741,125744,1,4,0
36014,4,1,125744,125744,125745,0,1,0
36015,5,2,125749,125749,125751,0,2,4
36016,3,1,125752,125752,125753,0,1,1
36017,2,3,125754,125754,125757,0,3,1
36018,3,3,125757,125757,125760,0,3,0
36019,6,2,125763,125763,125765,0,2,3
36020,2,3,125765,125765,125768,0,3,0
36021,5,1,125770,125770,125771,0,1,2
36022,4,2,125774,125774,125776,0,2,3
36023,4,1,125778,125778,125779,0,1,2
36024,4,3,125782,125782,125785,0,3,3
36025,2,2,125784,125785,125787,1,3,0
36026,5,1,125789,125789,125790,0,1,2
36027,3,1,125792,125792,125793,0,1,2
36028,1,3,125793,125793,125796,0,3,0
36029,4,1,125797,125797,125798,0,1,1
36030,5,3,125802,125802,125805,0,3,4
36031,2,3,125804,125805,125808,1,4,0
36032,1,3,125805,125808,125811,3,6,0
36033,5,3,125810,125811,125814,1,4,0
36034,2,1,125812,125814,125815,2,3,0
36035,3,3,125815,125815,125818,0,3,0
36036,1,1,125816,125818,125819,2,3,0
36037,4,2,125820,125820,125822,0,2,1
36038,5,3,125825,125825,125828,0,3,3
36039,3,3,125828,125828,125831,0,3,0
36040,2,1,125830,125831,125832,1,2,0
36041,2,2,125832,125832,125834,0,2,0
36042,2,2,125834,125834,125836,0,2,0
36043,5,2,125839,125839,125841,0,2,3
36044,2,2,125841,125841,125843,0,2,0
36045,5,2,125846,125846,125848,0,2,3
36046,2,3,125848,125848,125851,0,3,0
36047,6,2,125854,125854,125856,0,2,3
36048,1,3,125855,125856,125859,1,4,0
36049,1,2,125856,125859,125861,3,5,0
36050,3,1,125859,125861,125862,2,3,0
36051,2,1,125861,125862,125863,1,2,0
36052,6,1,125867,125867,125868,0,1,4
36053,3,2,125870,125870,125872,0,2,2
36054,1,1,125871,125872,125873,1,2,0
36055,5,1,125876,125876,125877,0,1,3
36056,2,2,125878,125878,125880,0,2,1
36057,5,1,125883,125883,125884,0,1,3
36058,4,1,125887,125887,125888,0,1,3
36059,3,1,125890,125890,125891,0,1,2
36060,6,3,125896,125896,125899,0,3,5
36061,1,3,125897,125899,125902,2,5,0
36062,5,1,125902,125902,125903,0,1,0
36063,4,1,125906,125906,125907,0,1,3
36064,3,1,125909,125909,125910,0,1,2
36065,3,3,125912,125912,125915,0,3,2
36066,5,1,125917,125917,125918,0,1,2
36067,6,2,125923,125923,125925,0,2,5
36068,3,3,125926,125926,125929,0,3,1
36069,6,2,125932,125932,125934,0,2,3
36070,2,2,125934,125934,125936,0,2,0
36071,3,1,125937,125937,125938,0,1,1
36072,5,2,125942,125942,125944,0,2,4
36073,2,1,125944,125944,125945,0,1,0
36074,5,3,125949,125949,125952,0,3,4
36075,5,1,125954,125954,125955,0,1,2
36076,6,1,125960,125960,125961,0,1,5
36077,6,1,125966,125966,125967,0,1,5
36078,3,1,125969,125969,125970,0,1,2
36079,4,3,125973,125973,125976,0,3,3
36080,1,2,125974,125976,125978,2,4,0
36081,5,3,125979,125979,125982,0,3,1
36082,3,1,125982,125982,125983,0,1,0
36083,4,1,125986,125986,125987,0,1,3
36084,6,1,125992,125992,125993,0,1,5
36085,5,3,125997,125997,126000,0,3,4
36086,5,1,126002,126002,126003,0,1,2
36087,4,2,126006,126006,126008,0,2,3
36088,1,3,126007,126008,126011,1,4,0
36089,4,3,126011,126011,126014,0,3,0
36090,3,3,126014,126014,126017,0,3,0
36091,1,1,126015,126017,126018,2,3,0
36092,6,1,126021,126021,126022,0,1,3
36093,3,1,126024,126024,126025,0,1,2
36094,2,2,126026,126026,126028,0,2,1
36095,3,1,126029,126029,126030,0,1,1
36096,6,2,126035,126035,126037,0,2,5
36097,5,2,126040,126040,126042,0,2,3
36098,5,3,126045,126045,126048,0,3,3
36099,5,3,126050,126050,126053,0,3,2
36100,3,1,126053,126053,126054,0,1,0
36101,1,2,126054,126054,126056,0,2,0
36102,1,3,126055,126056,126059,1,4,0
36103,1,1,126056,126059,126060,3,4,0
36104,2,1,126058,126060,126061,2,3,0
36105,5,1,126063,126063,126064,0,1,2
36106,4,3,126067,126067,126070,0,3,3
36107,6,3,126073,126073,126076,0,3,3
36108,1,3,126074,126076,126079,2,5,0
36109,5,3,126079,126079,126082,0,3,0
36110,6,3,126085,126085,126088,0,3,3
36111,5,3,126090,126090,126093,0,3,2
36112,2,1,126092,126093,126094,1,2,0
36113,5,1,126097,126097,126098,0,1,3
36114,6,2,126103,126103,126105,0,2,5
36115,1,2,126104,126105,126107,1,3,0
36116,2,1,126106,126107,126108,1,2,0
36117,4,2,126110,126110,126112,0,2,2
36118,2,2,126112,126112,126114,0,2,0
36119,5,1,126117,126117,126118,0,1,3
36120,3,3,126120,126120,126123,0,3,2
36121,4,3,126124,126124,126127,0,3,1
36122,3,3,126127,126127,126130,0,3,0
36123,5,3,126132,126132,126135,0,3,2
36124,5,3,126137,126137,126140,0,3,2
36125,4,3,126141,126141,126144,0,3,1
36126,4,3,126145,126145,126148,0,3,1
36127,6,2,126151,126151,126153,0,2,3
36128,6,3,126157,126157,126160,0,3,4
36129,1,2,126158,126160,126162,2,4,0
36130,4,1,126162,126162,126163,0,1,0
36131,4,3,126166,126166,126169,0,3,3
36132,4,3,126170,126170,126173,0,3,1
36133,5,1,126175,126175,126176,0,1,2
36134,5,3,126180,126180,126183,0,3,4
36135,2,1,126182,126183,126184,1,2,0
36136,5,2,126187,126187,126189,0,2,3
36137,2,1,126189,126189,126190,0,1,0
36138,3,2,126192,126192,126194,0,2,2
36139,5,1,126197,126197,126198,0,1,3
36140,4,2,126201,126201,126203,0,2,3
36141,1,3,126202,126203,126206,1,4,0
36142,1,1,126203,126206,126207,3,4,0
36143,3,2,126206,126207,126209,1,3,0
36144,6,3,126212,126212,126215,0,3,3
36145,6,3,126218,126218,126221,0,3,3
36146,1,2,126219,126221,126223,2,4,0
36147,1,2,126220,126223,126225,3,5,0
36148,2,3,126222,126225,126228,3,6,0
36149,3,1,126225,126228,126229,3,4,0
36150,5,1,126230,126230,126231,0,1,1
36151,3,3,126233,126233,126236,0,3,2
36152,2,3,126235,126236,126239,1,4,0
36153,5,3,126240,126240,126243,0,3,1
36154,4,1,126244,126244,126245,0,1,1
36155,3,3,126247,126247,126250,0,3,2
36156,4,3,126251,126251,126254,0,3,1
36157,2,2,126253,126254,126256,1,3,0
36158,6,3,126259,126259,126262,0,3,3
36159,3,3,126262,126262,126265,0,3,0
36160,1,3,126263,126265,126268,2,5,0
36161,4,3,126267,126268,126271,1,4,0
36162,4,2,126271,126271,126273,0,2,0
36163,4,3,126275,126275,126278,0,3,2
36164,5,2,126280,126280,126282,0,2,2
36165,5,2,126285,126285,126287,0,2,3
36166,3,3,126288,126288,126291,0,3,1
36167,1,1,126289,126291,126292,2,3,0
36168,6,3,126295,126295,126298,0,3,3
36169,6,3,126301,126301,126304,0,3,3
36170,4,3,126305,126305,126308,0,3,1
36171,1,1,126306,126308,126309,2,3,0
36172,5,3,126311,126311,126314,0,3,2
36173,4,3,126315,126315,126318,0,3,1
36174,6,2,126321,126321,126323,0,2,3
36175,4,2,126325,126325,126327,0,2,2
36176,5,2,126330,126330,126332,0,2,3
36177,6,2,126336,126336,126338,0,2,4
36178,1,3,126337,126338,126341,1,4,0
36179,6,2,126343,126343,126345,0,2,2
36180,2,1,126345,126345,126346,0,1,0
36181,5,2,126350,126350,126352,0,2,4
36182,5,3,126355,126355,126358,0,3,3
36183,3,1,126358,126358,126359,0,1,0
36184,4,3,126362,126362,126365,0,3,3
36185,4,1,126366,126366,126367,0,1,1
36186,3,1,126369,126369,126370,0,1,2
36187,6,3,126375,126375,126378,0,3,5
36188,6,3,126381,126381,126384,0,3,3
36189,3,3,126384,126384,126387,0,3,0
36190,6,1,126390,126390,126391,0,1,3
36191,4,2,126394,126394,126396,0,2,3
36192,5,3,126399,126399,126402,0,3,3
36193,1,3,126400,126402,126405,2,5,0
36194,6,2,126406,126406,126408,0,2,1
36195,4,3,126410,126410,126413,0,3,2
36196,1,3,126411,126413,126416,2,5,0
36197,4,2,126415,126416,126418,1,3,0
36198,1,2,126416,126418,126420,2,4,0
36199,6,3,126422,126422,126425,0,3,2
36200,5,3,126427,126427,126430,0,3,2
36201,3,2,126430,126430,126432,0,2,0
36202,4,3,126434,126434,126437,0,3,2
36203,5,1,126439,126439,126440,0,1,2
36204,3,3,126442,126442,126445,0,3,2
36205,3,1,126445,126445,126446,0,1,0
36206,6,1,126451,126451,126452,0,1,5
36207,1,1,126452,126452,126453,0,1,0
36208,3,3,126455,126455,126458,0,3,2
36209,1,2,126456,126458,126460,2,4,0
36210,4,1,126460,126460,126461,0,1,0
36211,3,3,126463,126463,126466,0,3,2
36212,2,1,126465,126466,126467,1,2,0
36213,3,3,126468,126468,126471,0,3,1
36214,4,2,126472,126472,126474,0,2,1
36215,6,1,126478,126478,126479,0,1,4
36216,5,2,126483,126483,126485,0,2,4
36217,6,3,126489,126489,126492,0,3,4
36218,1,3,126490,126492,126495,2,5,0
36219,5,3,126495,126495,126498,0,3,0
36220,1,3,126496,126498,126501,2,5,0
36221,1,3,126497,126501,126504,4,7,0
36222,3,2,126500,126504,126506,4,6,0
36223,2,2,126502,126506,126508,4,6,0
36224,6,2,126508,126508,126510,0,2,0
36225,5,2,126513,126513,126515,0,2,3
36226,6,2,126519,126519,126521,0,2,4
36227,6,3,126525,126525,126528,0,3,4
36228,1,1,126526,126528,126529,2,3,0
36229,5,3,126531,126531,126534,0,3,2
36230,1,3,126532,126534,126537,2,5,0
36231,4,2,126536,126537,126539,1,3,0
36232,3,2,126539,126539,126541,0,2,0
36233,2,1,126541,126541,126542,0,1,0
36234,3,2,126544,126544,126546,0,2,2
36235,5,1,126549,126549,126550,0,1,3
36236,6,2,126555,126555,126557,0,2,5
36237,3,2,126558,126558,126560,0,2,1
36238,2,1,126560,126560,126561,0,1,0
36239,2,1,126562,126562,126563,0,1,1
36240,2,3,126564,126564,126567,0,3,1
36241,6,3,126570,126570,126573,0,3,3
36242,1,1,126571,126573,126574,2,3,0
36243,5,3,126576,126576,126579,0,3,2
36244,4,2,126580,126580,126582,0,2,1
36245,6,2,126586,126586,126588,0,2,4
36246,4,3,126590,126590,126593,0,3,2
36247,2,1,126592,126593,126594,1,2,0
36248,1,2,126593,126594,126596,1,3,0
36249,1,2,126594,126596,126598,2,4,0
36250,6,3,126600,126600,126603,0,3,2
36251,6,2,126606,126606,126608,0,2,3
36252,3,2,126609,126609,126611,0,2,1
36253,3,2,126612,126612,126614,0,2,1
36254,4,1,126616,126616,126617,0,1,2
36255,3,2,126619,126619,126621,0,2,2
36256,5,1,126624,126624,126625,0,1,3
36257,4,3,126628,126628,126631,0,3,3
36258,6,2,126634,126634,126636,0,2,3
36259,4,3,126638,126638,126641,0,3,2
36260,2,2,126640,126641,126643,1,3,0
36261,1,3,126641,126643,126646,2,5,0
36262,3,3,126644,126646,126649,2,5,0
36263,1,1,126645,126649,126650,4,5,0
36264,2,3,126647,126650,126653,3,6,0
36265,3,1,126650,126653,126654,3,4,0
36266,3,3,126653,126654,126657,1,4,0
36267,2,2,126655,126657,126659,2,4,0
36268,6,2,126661,126661,126663,0,2,2
36269,2,2,126663,126663,126665,0,2,0
36270,5,2,126668,126668,126670,0,2,3
36271,6,1,126674,126674,126675,0,1,4
36272,3,2,126677,126677,126679,0,2,2
36273,6,1,126683,126683,126684,0,1,4
36274,3,3,126686,126686,126689,0,3,2
36275,5,1,126691,126691,126692,0,1,2
36276,2,1,126693,126693,126694,0,1,1
36277,1,1,126694,126694,126695,0,1,0
36278,1,2,126695,126695,126697,0,2,0
36279,4,2,126699,126699,126701,0,2,2
36280,5,3,126704,126704,126707,0,3,3
36281,5,3,126709,126709,126712,0,3,2
36282,4,2,126713,126713,126715,0,2,1
36283,4,1,126717,126717,126718,0,1,2
36284,5,2,126722,126722,126724,0,2,4
36285,6,2,126728,126728,126730,0,2,4
36286,2,1,126730,126730,126731,0,1,0
36287,2,1,126732,126732,126733,0,1,1
36288,6,1,126738,126738,126739,0,1,5
36289,6,2,126744,126744,126746,0,2,5
36290,1,2,126745,126746,126748,1,3,0
36291,5,3,126750,126750,126753,0,3,2
36292,6,3,126756,126756,126759,0,3,3
36293,1,1,126757,126759,126760,2,3,0
36294,1,2,126758,126760,126762,2,4,0
36295,5,3,126763,126763,126766,0,3,1
36296,1,2,126764,126766,126768,2,4,0
36297,6,3,126770,126770,126773,0,3,2
36298,2,1,126772,126773,126774,1,2,0
36299,2,3,126774,126774,126777,0,3,0
36300,6,1,126780,126780,126781,0,1,3
36301,5,1,126785,126785,126786,0,1,4
36302,2,2,126787,126787,126789,0,2,1
36303,2,3,126789,126789,126792,0,3,0
36304,2,1,126791,126792,126793,1,2,0
36305,4,3,126795,126795,126798,0,3,2
36306,6,3,126801,126801,126804,0,3,3
36307,5,2,126806,126806,126808,0,2,2
36308,3,3,126809,126809,126812,0,3,1
36309,6,2,126815,126815,126817,0,2,3
36310,3,3,126818,126818,126821,0,3,1
36311,4,1,126822,126822,126823,0,1,1
36312,4,1,126826,126826,126827,0,1,3
36313,6,3,126832,126832,126835,0,3,5
36314,6,1,126838,126838,126839,0,1,3
36315,4,1,126842,126842,126843,0,1,3
36316,4,3,126846,126846,126849,0,3,3
36317,1,2,126847,126849,126851,2,4,0
36318,6,3,126853,126853,126856,0,3,2
36319,2,1,126855,126856,126857,1,2,0
36320,3,1,126858,126858,126859,0,1,1
36321,6,3,126864,126864,126867,0,3,5
36322,4,3,126868,126868,126871,0,3,1
36323,6,1,126874,126874,126875,0,1,3
36324,6,1,126880,126880,126881,0,1,5
36325,5,2,126885,126885,126887,0,2,4
36326,1,2,126886,126887,126889,1,3,0
36327,4,2,126890,126890,126892,0,2,1
36328,2,3,126892,126892,126895,0,3,0
36329,5,1,126897,126897,126898,0,1,2
36330,3,2,126900,126900,126902,0,2,2
36331,4,1,126904,126904,126905,0,1,2
36332,2,1,126906,126906,126907,0,1,1
36333,6,3,126912,126912,126915,0,3,5
36334,3,2,126915,126915,126917,0,2,0
36335,2,3,126917,126917,126920,0,3,0
36336,5,1,126922,126922,126923,0,1,2
36337,1,1,126923,126923,126924,0,1,0
36338,2,1,126925,126925,126926,0,1,1
36339,5,1,126930,126930,126931,0,1,4
36340,1,2,126931,126931,126933,0,2,0
36341,5,3,126936,126936,126939,0,3,3
36342,1,1,126937,126939,126940,2,3,0
36343,2,1,126939,126940,126941,1,2,0
36344,2,3,126941,126941,126944,0,3,0
36345,5,3,126946,126946,126949,0,3,2
36346,4,1,126950,126950,126951,0,1,1
36347,5,2,126955,126955,126957,0,2,4
36348,4,3,126959,126959,126962,0,3,2
36349,1,3,126960,126962,126965,2,5,0
36350,6,3,126966,126966,126969,0,3,1
36351,4,1,126970,126970,126971,0,1,1
36352,1,1,126971,126971,126972,0,1,0
36353,4,2,126975,126975,126977,0,2,3
36354,5,3,126980,126980,126983,0,3,3
36355,6,1,126986,126986,126987,0,1,3
36356,6,1,126992,126992,126993,0,1,5
36357,3,1,126995,126995,126996,0,1,2
36358,6,2,127001,127001,127003,0,2,5
36359,2,3,127003,127003,127006,0,3,0
36360,3,1,127006,127006,127007,0,1,0
36361,3,2,127009,127009,127011,0,2,2
36362,2,2,127011,127011,127013,0,2,0
36363,3,1,127014,127014,127015,0,1,1
36364,5,3,127019,127019,127022,0,3,4
36365,3,3,127022,127022,127025,0,3,0
36366,1,1,127023,127025,127026,2,3,0
36367,5,1,127028,127028,127029,0,1,2
36368,3,2,127031,127031,127033,0,2,2
36369,5,3,127036,127036,127039,0,3,3
36370,4,1,127040,127040,127041,0,1,1
36371,1,2,127041,127041,127043,0,2,0
36372,1,1,127042,127043,127044,1,2,0
36373,3,1,127045,127045,127046,0,1,1
36374,6,3,127051,127051,127054,0,3,5
36375,6,2,127057,127057,127059,0,2,3
36376,5,1,127062,127062,127063,0,1,3
36377,1,2,127063,127063,127065,0,2,0
36378,6,1,127069,127069,127070,0,1,4
36379,6,1,127075,127075,127076,0,1,5
36380,5,1,127080,127080,127081,0,1,4
36381,3,1,127083,127083,127084,0,1,2
36382,3,2,127086,127086,127088,0,2,2
36383,4,3,127090,127090,127093,0,3,2
36384,5,1,127095,127095,127096,0,1,2
36385,6,2,127101,127101,127103,0,2,5
36386,6,1,127107,127107,127108,0,1,4
36387,1,3,127108,127108,127111,0,3,0
36388,2,2,127110,127111,127113,1,3,0
36389,2,1,127112,127113,127114,1,2,0
36390,1,2,127113,127114,127116,1,3,0
36391,2,1,127115,127116,127117,1,2,0
36392,1,2,127116,127117,127119,1,3,0
36393,1,2,127117,127119,127121,2,4,0
36394,4,1,127121,127121,127122,0,1,0
36395,3,2,127124,127124,127126,0,2,2
36396,4,2,127128,127128,127130,0,2,2
36397,6,1,127134,127134,127135,0,1,4
36398,5,2,127139,127139,127141,0,2,4
36399,1,1,127140,127141,127142,1,2,0
36400,3,1,127143,127143,127144,0,1,1
36401,6,1,127149,127149,127150,0,1,5
36402,1,2,127150,127150,127152,0,2,0
36403,2,2,127152,127152,127154,0,2,0
36404,6,1,127158,127158,127159,0,1,4
36405,4,2,127162,127162,127164,0,2,3
36406,6,1,127168,127168,127169,0,1,4
36407,3,2,127171,127171,127173,0,2,2
36408,1,3,127172,127173,127176,1,4,0
36409,1,2,127173,127176,127178,3,5,0
36410,4,1,127177,127178,127179,1,2,0
36411,4,3,127181,127181,127184,0,3,2
36412,4,3,127185,127185,127188,0,3,1
36413,5,2,127190,127190,127192,0,2,2
36414,1,3,127191,127192,127195,1,4,0
36415,4,2,127195,127195,127197,0,2,0
36416,1,3,127196,127197,127200,1,4,0
36417,6,3,127202,127202,127205,0,3,2
36418,4,3,127206,127206,127209,0,3,1
36419,2,1,127208,127209,127210,1,2,0
36420,5,2,127213,127213,127215,0,2,3
36421,3,3,127216,127216,127219,0,3,1
36422,1,2,127217,127219,127221,2,4,0
36423,2,3,127219,127221,127224,2,5,0
36424,4,1,127223,127224,127225,1,2,0
36425,4,1,127227,127227,127228,0,1,2
36426,1,1,127228,127228,127229,0,1,0
36427,6,3,127234,127234,127237,0,3,5
36428,1,2,127235,127237,127239,2,4,0
36429,5,1,127240,127240,127241,0,1,1
36430,6,3,127246,127246,127249,0,3,5
36431,5,3,127251,127251,127254,0,3,2
36432,6,3,127257,127257,127260,0,3,3
36433,6,3,127263,127263,127266,0,3,3
36434,5,3,127268,127268,127271,0,3,2
36435,4,1,127272,127272,127273,0,1,1
36436,5,3,127277,127277,127280,0,3,4
36437,2,3,127279,127280,127283,1,4,0
36438,6,1,127285,127285,127286,0,1,2
36439,3,2,127288,127288,127290,0,2,2
36440,6,2,127294,127294,127296,0,2,4
36441,4,3,127298,127298,127301,0,3,2
36442,3,3,127301,127301,127304,0,3,0
36443,3,1,127304,127304,127305,0,1,0
36444,1,3,127305,127305,127308,0,3,0
36445,4,2,127309,127309,127311,0,2,1
36446,4,3,127313,127313,127316,0,3,2
36447,5,3,127318,127318,127321,0,3,2
36448,3,2,127321,127321,127323,0,2,0
36449,5,3,127326,127326,127329,0,3,3
36450,5,1,127331,127331,127332,0,1,2
36451,4,2,127335,127335,127337,0,2,3
36452,5,3,127340,127340,127343,0,3,3
36453,2,1,127342,127343,127344,1,2,0
36454,4,3,127346,127346,127349,0,3,2
36455,1,1,127347,127349,127350,2,3,0
36456,4,2,127351,127351,127353,0,2,1
36457,1,2,127352,127353,127355,1,3,0
36458,1,2,127353,127355,127357,2,4,0
36459,2,3,127355,127357,127360,2,5,0
36460,1,3,127356,127360,127363,4,7,0
36461,6,1,127362,127363,127364,1,2,0
36462,3,1,127365,127365,127366,0,1,1
36463,3,2,127368,127368,127370,0,2,2
36464,3,1,127371,127371,127372,0,1,1
36465,3,3,127374,127374,127377,0,3,2
36466,6,1,127380,127380,127381,0,1,3
36467,6,3,127386,127386,127389,0,3,5
36468,1,3,127387,127389,127392,2,5,0
36469,4,2,127391,127392,127394,1,3,0
36470,5,3,127396,127396,127399,0,3,2
36471,2,2,127398,127399,127401,1,3,0
36472,4,3,127402,127402,127405,0,3,1
36473,5,3,127407,127407,127410,0,3,2
36474,2,3,127409,127410,127413,1,4,0
36475,2,1,127411,127413,127414,2,3,0
36476,2,3,127413,127414,127417,1,4,0
36477,4,3,127417,127417,127420,0,3,0
36478,1,2,127418,127420,127422,2,4,0
36479,6,3,127424,127424,127427,0,3,2
36480,2,1,127426,127427,127428,1,2,0
36481,3,1,127429,127429,127430,0,1,1
36482,1,3,127430,127430,127433,0,3,0
36483,2,2,127432,127433,127435,1,3,0
36484,3,1,127435,127435,127436,0,1,0
36485,5,3,127440,127440,127443,0,3,4
36486,6,2,127446,127446,127448,0,2,3
36487,5,3,127451,127451,127454,0,3,3
36488,4,1,127455,127455,127456,0,1,1
36489,2,2,127457,127457,127459,0,2,1
36490,5,2,127462,127462,127464,0,2,3
36491,3,3,127465,127465,127468,0,3,1
36492,3,1,127468,127468,127469,0,1,0
36493,2,1,127470,127470,127471,0,1,1
36494,4,1,127474,127474,127475,0,1,3
36495,1,1,127475,127475,127476,0,1,0
36496,6,3,127481,127481,127484,0,3,5
36497,3,1,127484,127484,127485,0,1,0
36498,2,3,127486,127486,127489,0,3,1
36499,5,3,127491,127491,127494,0,3,2
36500,2,2,127493,127494,127496,1,3,0
36501,1,1,127494,127496,127497,2,3,0
36502,5,1,127499,127499,127500,0,1,2
36503,4,2,127503,127503,127505,0,2,3
36504,2,3,127505,127505,127508,0,3,0
36505,2,2,127507,127508,127510,1,3,0
36506,3,2,127510,127510,127512,0,2,0
36507,6,2,127516,127516,127518,0,2,4
36508,2,1,127518,127518,127519,0,1,0
36509,5,2,127523,127523,127525,0,2,4
36510,1,3,127524,127525,127528,1,4,0
36511,1,1,127525,127528,127529,3,4,0
36512,5,1,127530,127530,127531,0,1,1
36513,3,1,127533,127533,127534,0,1,2
36514,6,2,127539,127539,127541,0,2,5
36515,5,1,127544,127544,127545,0,1,3
36516,4,3,127548,127548,127551,0,3,3
36517,4,1,127552,127552,127553,0,1,1
36518,4,3,127556,127556,127559,0,3,3
36519,4,2,127560,127560,127562,0,2,1
36520,6,1,127566,127566,127567,0,1,4
36521,3,1,127569,127569,127570,0,1,2
36522,2,1,127571,127571,127572,0,1,1
36523,5,3,127576,127576,127579,0,3,4
36524,1,2,127577,127579,127581,2,4,0
36525,1,2,127578,127581,127583,3,5,0
36526,2,1,127580,127583,127584,3,4,0
36527,3,3,127583,127584,127587,1,4,0
36528,2,3,127585,127587,127590,2,5,0
36529,4,1,127589,127590,127591,1,2,0
36530,6,2,127595,127595,127597,0,2,4
36531,1,3,127596,127597,127600,1,4,0
36532,4,1,127600,127600,127601,0,1,0
36533,6,3,127606,127606,127609,0,3,5
36534,2,3,127608,127609,127612,1,4,0
36535,2,3,127610,127612,127615,2,5,0
36536,3,1,127613,127615,127616,2,3,0
36537,2,1,127615,127616,127617,1,2,0
36538,4,1,127619,127619,127620,0,1,2
36539,2,3,127621,127621,127624,0,3,1
36540,4,3,127625,127625,127628,0,3,1
36541,1,2,127626,127628,127630,2,4,0
36542,5,2,127631,127631,127633,0,2,1
36543,6,3,127637,127637,127640,0,3,4
36544,1,3,127638,127640,127643,2,5,0
36545,2,1,127640,127643,127644,3,4,0
36546,4,3,127644,127644,127647,0,3,0
36547,3,1,127647,127647,127648,0,1,0
36548,4,2,127651,127651,127653,0,2,3
36549,6,1,127657,127657,127658,0,1,4
36550,2,3,127659,127659,127662,0,3,1
36551,1,2,127660,127662,127664,2,4,0
36552,1,3,127661,127664,127667,3,6,0
36553,4,1,127665,127667,127668,2,3,0
36554,3,3,127668,127668,127671,0,3,0
36555,3,3,127671,127671,127674,0,3,0
36556,4,3,127675,127675,127678,0,3,1
36557,6,3,127681,127681,127684,0,3,3
36558,2,1,127683,127684,127685,1,2,0
36559,6,1,127689,127689,127690,0,1,4
36560,1,2,127690,127690,127692,0,2,0
36561,3,1,127693,127693,127694,0,1,1
36562,2,2,127695,127695,127697,0,2,1
36563,6,2,127701,127701,127703,0,2,4
36564,1,2,127702,127703,127705,1,3,0
36565,1,3,127703,127705,127708,2,5,0
36566,3,2,127706,127708,127710,2,4,0
36567,2,3,127708,127710,127713,2,5,0
36568,2,1,127710,127713,127714,3,4,0
36569,1,1,127711,127714,127715,3,4,0
36570,2,1,127713,127715,127716,2,3,0
36571,6,2,127719,127719,127721,0,2,3
36572,1,3,127720,127721,127724,1,4,0
36573,5,3,127725,127725,127728,0,3,1
36574,4,1,127729,127729,127730,0,1,1
36575,3,1,127732,127732,127733,0,1,2
36576,6,3,127738,127738,127741,0,3,5
36577,5,2,127743,127743,127745,0,2,2
36578,5,1,127748,127748,127749,0,1,3
36579,1,2,127749,127749,127751,0,2,0
36580,3,2,127752,127752,127754,0,2,1
36581,5,1,127757,127757,127758,0,1,3
36582,4,1,127761,127761,127762,0,1,3
36583,2,1,127763,127763,127764,0,1,1
36584,3,2,127766,127766,127768,0,2,2
36585,6,2,127772,127772,127774,0,2,4
36586,4,1,127776,127776,127777,0,1,2
36587,6,1,127782,127782,127783,0,1,5
36588,1,1,127783,127783,127784,0,1,0
36589,6,2,127789,127789,127791,0,2,5
36590,6,2,127795,127795,127797,0,2,4
36591,4,3,127799,127799,127802,0,3,2
36592,4,1,127803,127803,127804,0,1,1
36593,6,2,127809,127809,127811,0,2,5
36594,3,3,127812,127812,127815,0,3,1
36595,2,3,127814,127815,127818,1,4,0
36596,5,3,127819,127819,127822,0,3,1
36597,1,2,127820,127822,127824,2,4,0
36598,5,2,127825,127825,127827,0,2,1
36599,3,3,127828,127828,127831,0,3,1
36600,3,2,127831,127831,127833,0,2,0
36601,4,3,127835,127835,127838,0,3,2
36602,3,3,127838,127838,127841,0,3,0
36603,5,1,127843,127843,127844,0,1,2
36604,1,1,127844,127844,127845,0,1,0
36605,2,2,127846,127846,127848,0,2,1
36606,3,3,127849,127849,127852,0,3,1
36607,3,1,127852,127852,127853,0,1,0
36608,3,2,127855,127855,127857,0,2,2
36609,5,2,127860,127860,127862,0,2,3
36610,1,1,127861,127862,127863,1,2,0
36611,1,1,127862,127863,127864,1,2,0
36612,4,1,127866,127866,127867,0,1,2
36613,2,2,127868,127868,127870,0,2,1
36614,6,1,127874,127874,127875,0,1,4
36615,2,3,127876,127876,127879,0,3,1
36616,3,3,127879,127879,127882,0,3,0
36617,2,2,127881,127882,127884,1,3,0
36618,2,3,127883,127884,127887,1,4,0
36619,2,2,127885,127887,127889,2,4,0
36620,2,3,127887,127889,127892,2,5,0
36621,5,2,127892,127892,127894,0,2,0
36622,3,2,127895,127895,127897,0,2,1
36623,5,1,127900,127900,127901,0,1,3
36624,4,1,127904,127904,127905,0,1,3
36625,1,3,127905,127905,127908,0,3,0
36626,3,1,127908,127908,127909,0,1,0
36627,4,2,127912,127912,127914,0,2,3
36628,2,1,127914,127914,127915,0,1,0
36629,5,3,127919,127919,127922,0,3,4
36630,3,2,127922,127922,127924,0,2,0
36631,4,1,127926,127926,127927,0,1,2
36632,1,1,127927,127927,127928,0,1,0
36633,4,3,127931,127931,127934,0,3,3
36634,5,1,127936,127936,127937,0,1,2
36635,6,3,127942,127942,127945,0,3,5
36636,5,1,127947,127947,127948,0,1,2
36637,6,2,127953,127953,127955,0,2,5
36638,6,3,127959,127959,127962,0,3,4
36639,6,1,127965,127965,127966,0,1,3
36640,2,1,127967,127967,127968,0,1,1
36641,1,1,127968,127968,127969,0,1,0
36642,6,1,127974,127974,127975,0,1,5
36643,4,3,127978,127978,127981,0,3,3
36644,5,2,127983,127983,127985,0,2,2
36645,6,2,127989,127989,127991,0,2,4
36646,4,3,127993,127993,127996,0,3,2
36647,6,3,127999,127999,128002,0,3,3
36648,4,2,128003,128003,128005,0,2,1
36649,5,2,128008,128008,128010,0,2,3
36650,3,2,128011,128011,128013,0,2,1
36651,5,3,128016,128016,128019,0,3,3
36652,5,3,128021,128021,128024,0,3,2
36653,3,3,128024,128024,128027,0,3,0
36654,2,3,128026,128027,128030,1,4,0
36655,2,2,128028,128030,128032,2,4,0
36656,4,3,128032,128032,128035,0,3,0
36657,5,1,128037,128037,128038,0,1,2
36658,2,2,128039,128039,128041,0,2,1
36659,3,1,128042,128042,128043,0,1,1
36660,6,3,128048,128048,128051,0,3,5
36661,3,1,128051,128051,128052,0,1,0
36662,1,1,128052,128052,128053,0,1,0
36663,3,2,128055,128055,128057,0,2,2
36664,6,3,128061,128061,128064,0,3,4
36665,2,1,128063,128064,128065,1,2,0
36666,6,1,128069,128069,128070,0,1,4
36667,2,2,128071,128071,128073,0,2,1
36668,6,2,128077,128077,128079,0,2,4
36669,1,3,128078,128079,128082,1,4,0
36670,1,3,128079,128082,128085,3,6,0
36671,3,1,128082,128085,128086,3,4,0
36672,6,3,128088,128088,128091,0,3,2
36673,4,2,128092,128092,128094,0,2,1
36674,1,3,128093,128094,128097,1,4,0
36675,6,3,128099,128099,128102,0,3,2
36676,6,3,128105,128105,128108,0,3,3
36677,5,2,128110,128110,128112,0,2,2
36678,3,2,128113,128113,128115,0,2,1
36679,2,3,128115,128115,128118,0,3,0
36680,1,1,128116,128118,128119,2,3,0
36681,2,2,128118,128119,128121,1,3,0
36682,2,1,128120,128121,128122,1,2,0
36683,1,1,128121,128122,128123,1,2,0
36684,5,2,128126,128126,128128,0,2,3
36685,3,1,128129,128129,128130,0,1,1
36686,1,3,128130,128130,128133,0,3,0
36687,5,3,128135,128135,128138,0,3,2
36688,3,2,128138,128138,128140,0,2,0
36689,4,2,128142,128142,128144,0,2,2
36690,2,1,128144,128144,128145,0,1,0
36691,2,1,128146,128146,128147,0,1,1
36692,3,1,128149,128149,128150,0,1,2
36693,1,1,128150,128150,128151,0,1,0
36694,3,3,128153,128153,128156,0,3,2
36695,3,2,128156,128156,128158,0,2,0
36696,6,2,128162,128162,128164,0,2,4
36697,5,2,128167,128167,128169,0,2,3
36698,4,3,128171,128171,128174,0,3,2
36699,5,2,128176,128176,128178,0,2,2
36700,5,3,128181,128181,128184,0,3,3
36701,2,1,128183,128184,128185,1,2,0
36702,1,3,128184,128185,128188,1,4,0
36703,5,1,128189,128189,128190,0,1,1
36704,1,3,128190,128190,128193,0,3,0
36705,3,2,128193,128193,128195,0,2,0
36706,2,1,128195,128195,128196,0,1,0
36707,3,2,128198,128198,128200,0,2,2
36708,3,3,128201,128201,128204,0,3,1
36709,2,3,128203,128204,128207,1,4,0
36710,2,3,128205,128207,128210,2,5,0
36711,5,1,128210,128210,128211,0,1,0
36712,3,2,128213,128213,128215,0,2,2
36713,1,3,128214,128215,128218,1,4,0
36714,5,1,128219,128219,128220,0,1,1
36715,3,1,128222,128222,128223,0,1,2
36716,6,2,128228,128228,128230,0,2,5
36717,4,3,128232,128232,128235,0,3,2
36718,5,3,128237,128237,128240,0,3,2
36719,1,2,128238,128240,128242,2,4,0
36720,1,2,128239,128242,128244,3,5,0
36721,3,1,128242,128244,128245,2,3,0
36722,6,2,128248,128248,128250,0,2,3
36723,6,1,128254,128254,128255,0,1,4
36724,4,1,128258,128258,128259,0,1,3
36725,4,3,128262,128262,128265,0,3,3
36726,5,2,128267,128267,128269,0,2,2
36727,5,3,128272,128272,128275,0,3,3
36728,5,2,128277,128277,128279,0,2,2
36729,3,2,128280,128280,128282,0,2,1
36730,5,2,128285,128285,128287,0,2,3
36731,3,1,128288,128288,128289,0,1,1
36732,3,2,128291,128291,128293,0,2,2
36733,1,3,128292,128293,128296,1,4,0
36734,1,3,128293,128296,128299,3,6,0
36735,6,1,128299,128299,128300,0,1,0
36736,3,1,128302,128302,128303,0,1,2
36737,3,3,128305,128305,128308,0,3,2
36738,3,2,128308,128308,128310,0,2,0
36739,6,3,128314,128314,128317,0,3,4
36740,4,1,128318,128318,128319,0,1,1
36741,4,2,128322,128322,128324,0,2,3
36742,3,3,128325,128325,128328,0,3,1
36743,3,3,128328,128328,128331,0,3,0
36744,5,3,128333,128333,128336,0,3,2
36745,3,2,128336,128336,128338,0,2,0
36746,3,2,128339,128339,128341,0,2,1
36747,4,3,128343,128343,128346,0,3,2
36748,6,2,128349,128349,128351,0,2,3
36749,1,3,128350,128351,128354,1,4,0
36750,6,3,128356,128356,128359,0,3,2
36751,6,1,128362,128362,128363,0,1,3
36752,1,2,128363,128363,128365,0,2,0
36753,6,3,128369,128369,128372,0,3,4
36754,3,1,128372,128372,128373,0,1,0
36755,6,3,128378,128378,128381,0,3,5
36756,1,1,128379,128381,128382,2,3,0
36757,6,3,128385,128385,128388,0,3,3
36758,6,3,128391,128391,128394,0,3,3
36759,1,3,128392,128394,128397,2,5,0
36760,1,1,128393,128397,128398,4,5,0
36761,2,2,128395,128398,128400,3,5,0
36762,5,2,128400,128400,128402,0,2,0
36763,2,1,128402,128402,128403,0,1,0
36764,4,2,128406,128406,128408,0,2,3
36765,5,2,128411,128411,128413,0,2,3
36766,6,1,128417,128417,128418,0,1,4
36767,5,2,128422,128422,128424,0,2,4
36768,5,1,128427,128427,128428,0,1,3
36769,4,2,128431,128431,128433,0,2,3
36770,6,2,128437,128437,128439,0,2,4
36771,5,3,128442,128442,128445,0,3,3
36772,4,3,128446,128446,128449,0,3,1
36773,5,3,128451,128451,128454,0,3,2
36774,1,2,128452,128454,128456,2,4,0
36775,1,1,128453,128456,128457,3,4,0
36776,5,3,128458,128458,128461,0,3,1
36777,2,1,128460,128461,128462,1,2,0
36778,5,3,128465,128465,128468,0,3,3
36779,1,2,128466,128468,128470,2,4,0
36780,1,3,128467,128470,128473,3,6,0
36781,2,2,128469,128473,128475,4,6,0
36782,2,2,128471,128475,128477,4,6,0
36783,6,2,128477,128477,128479,0,2,0
36784,1,2,128478,128479,128481,1,3,0
36785,1,3,128479,128481,128484,2,5,0
36786,3,3,128482,128484,128487,2,5,0
36787,4,2,128486,128487,128489,1,3,0
36788,2,1,128488,128489,128490,1,2,0
36789,3,3,128491,128491,128494,0,3,1
36790,1,2,128492,128494,128496,2,4,0
36791,2,3,128494,128496,128499,2,5,0
36792,2,1,128496,128499,128500,3,4,0
36793,2,3,128498,128500,128503,2,5,0
36794,1,1,128499,128503,128504,4,5,0
36795,3,1,128502,128504,128505,2,3,0
36796,6,3,128508,128508,128511,0,3,3
36797,5,3,128513,128513,128516,0,3,2
36798,1,1,128514,128516,128517,2,3,0
36799,3,1,128517,128517,128518,0,1,0
36800,6,2,128523,128523,128525,0,2,5
36801,3,3,128526,128526,128529,0,3,1
36802,3,1,128529,128529,128530,0,1,0
36803,2,3,128531,128531,128534,0,3,1
36804,4,1,128535,128535,128536,0,1,1
36805,4,2,128539,128539,128541,0,2,3
36806,3,3,128542,128542,128545,0,3,1
36807,4,3,128546,128546,128549,0,3,1
36808,2,2,128548,128549,128551,1,3,0
36809,5,1,128553,128553,128554,0,1,2
36810,1,2,128554,128554,128556,0,2,0
36811,4,1,128558,128558,128559,0,1,2
36812,5,1,128563,128563,128564,0,1,4
36813,2,3,128565,128565,128568,0,3,1
36814,1,2,128566,128568,128570,2,4,0
36815,5,2,128571,128571,128573,0,2,1
36816,5,3,128576,128576,128579,0,3,3
36817,1,2,128577,128579,128581,2,4,0
36818,3,3,128580,128581,128584,1,4,0
36819,5,3,128585,128585,128588,0,3,1
36820,3,3,128588,128588,128591,0,3,0
36821,5,2,128593,128593,128595,0,2,2
36822,6,3,128599,128599,128602,0,3,4
36823,3,2,128602,128602,128604,0,2,0
36824,3,2,128605,128605,128607,0,2,1
36825,1,3,128606,128607,128610,1,4,0
36826,6,3,128612,128612,128615,0,3,2
36827,1,2,128613,128615,128617,2,4,0
36828,3,3,128616,128617,128620,1,4,0
36829,4,1,128620,128620,128621,0,1,0
36830,1,1,128621,128621,128622,0,1,0
36831,3,1,128624,128624,128625,0,1,2
36832,6,1,128630,128630,128631,0,1,5
36833,5,2,128635,128635,128637,0,2,4
36834,6,2,128641,128641,128643,0,2,4
36835,4,2,128645,128645,128647,0,2,2
36836,1,3,128646,128647,128650,1,4,0
36837,1,1,128647,128650,128651,3,4,0
36838,6,3,128653,128653,128656,0,3,2
36839,5,1,128658,128658,128659,0,1,2
36840,6,2,128664,128664,128666,0,2,5
36841,2,3,128666,128666,128669,0,3,0
36842,1,3,128667,128669,128672,2,5,0
36843,3,3,128670,128672,128675,2,5,0
36844,2,1,128672,128675,128676,3,4,0
36845,2,1,128674,128676,128677,2,3,0
36846,4,1,128678,128678,128679,0,1,1
36847,5,1,128683,128683,128684,0,1,4
36848,2,3,128685,128685,128688,0,3,1
36849,3,2,128688,128688,128690,0,2,0
36850,4,1,128692,128692,128693,0,1,2
36851,5,2,128697,128697,128699,0,2,4
36852,5,2,128702,128702,128704,0,2,3
36853,3,2,128705,128705,128707,0,2,1
36854,5,1,128710,128710,128711,0,1,3
36855,1,2,128711,128711,128713,0,2,0
36856,5,1,128716,128716,128717,0,1,3
36857,3,3,128719,128719,128722,0,3,2
36858,6,2,128725,128725,128727,0,2,3
36859,6,2,128731,128731,128733,0,2,4
36860,5,2,128736,128736,128738,0,2,3
36861,6,1,128742,128742,128743,0,1,4
36862,4,2,128746,128746,128748,0,2,3
36863,5,1,128751,128751,128752,0,1,3
36864,3,3,128754,128754,128757,0,3,2
36865,6,3,128760,128760,128763,0,3,3
36866,4,1,128764,128764,128765,0,1,1
36867,5,3,128769,128769,128772,0,3,4
36868,3,2,128772,128772,128774,0,2,0
36869,1,3,128773,128774,128777,1,4,0
36870,3,2,128776,128777,128779,1,3,0
36871,6,1,128782,128782,128783,0,1,3
36872,3,3,128785,128785,128788,0,3,2
36873,6,2,128791,128791,128793,0,2,3
36874,5,2,128796,128796,128798,0,2,3
36875,6,2,128802,128802,128804,0,2,4
36876,1,2,128803,128804,128806,1,3,0
36877,3,2,128806,128806,128808,0,2,0
36878,6,1,128812,128812,128813,0,1,4
36879,5,3,128817,128817,128820,0,3,4
36880,1,3,128818,128820,128823,2,5,0
36881,1,1,128819,128823,128824,4,5,0
36882,6,2,128825,128825,128827,0,2,1
36883,4,2,128829,128829,128831,0,2,2
36884,5,1,128834,128834,128835,0,1,3
36885,5,1,128839,128839,128840,0,1,4
36886,5,2,128844,128844,128846,0,2,4
36887,2,1,128846,128846,128847,0,1,0
36888,4,3,128850,128850,128853,0,3,3
36889,6,2,128856,128856,128858,0,2,3
36890,4,1,128860,128860,128861,0,1,2
36891,4,2,128864,128864,128866,0,2,3
36892,6,1,128870,128870,128871,0,1,4
36893,1,1,128871,128871,128872,0,1,0
36894,6,3,128877,128877,128880,0,3,5
36895,1,2,128878,128880,128882,2,4,0
36896,2,3,128880,128882,128885,2,5,0
36897,3,2,128883,128885,128887,2,4,0
36898,3,1,128886,128887,128888,1,2,0
36899,2,3,128888,128888,128891,0,3,0
36900,2,3,128890,128891,128894,1,4,0
36901,3,2,128893,128894,128896,1,3,0
36902,1,2,128894,128896,128898,2,4,0
36903,4,2,128898,128898,128900,0,2,0
36904,6,2,128904,128904,128906,0,2,4
36905,4,2,128908,128908,128910,0,2,2
36906,4,1,128912,128912,128913,0,1,2
36907,6,3,128918,128918,128921,0,3,5
36908,3,2,128921,128921,128923,0,2,0
36909,2,3,128923,128923,128926,0,3,0
36910,6,3,128929,128929,128932,0,3,3
36911,3,2,128932,128932,128934,0,2,0
36912,1,2,128933,128934,128936,1,3,0
36913,4,2,128937,128937,128939,0,2,1
36914,4,1,128941,128941,128942,0,1,2
36915,6,1,128947,128947,128948,0,1,5
36916,2,1,128949,128949,128950,0,1,1
36917,3,1,128952,128952,128953,0,1,2
36918,3,3,128955,128955,128958,0,3,2
36919,2,3,128957,128958,128961,1,4,0
36920,6,3,128963,128963,128966,0,3,2
36921,3,1,128966,128966,128967,0,1,0
36922,5,3,128971,128971,128974,0,3,4
36923,4,3,128975,128975,128978,0,3,1
36924,4,2,128979,128979,128981,0,2,1
36925,3,2,128982,128982,128984,0,2,1
36926,4,3,128986,128986,128989,0,3,2
36927,1,2,128987,128989,128991,2,4,0
36928,3,3,128990,128991,128994,1,4,0
36929,6,1,128996,128996,128997,0,1,2
36930,6,2,129002,129002,129004,0,2,5
36931,3,3,129005,129005,129008,0,3,1
36932,1,2,129006,129008,129010,2,4,0
36933,3,2,129009,129010,129012,1,3,0
36934,5,2,129014,129014,129016,0,2,2
36935,1,3,129015,129016,129019,1,4,0
36936,6,3,129021,129021,129024,0,3,2
36937,5,3,129026,129026,129029,0,3,2
36938,3,3,129029,129029,129032,0,3,0
36939,2,3,129031,129032,129035,1,4,0
36940,3,1,129034,129035,129036,1,2,0
36941,3,3,129037,129037,129040,0,3,1
36942,4,3,129041,129041,129044,0,3,1
36943,3,1,129044,129044,129045,0,1,0
36944,3,2,129047,129047,129049,0,2,2
36945,4,2,129051,129051,129053,0,2,2
36946,1,1,129052,129053,129054,1,2,0
36947,6,3,129058,129058,129061,0,3,4
36948,4,2,129062,129062,129064,0,2,1
36949,4,2,129066,129066,129068,0,2,2
36950,3,3,129069,129069,129072,0,3,1
36951,5,3,129074,129074,129077,0,3,2
36952,2,1,129076,129077,129078,1,2,0
36953,5,3,129081,129081,129084,0,3,3
36954,4,2,129085,129085,129087,0,2,1
36955,3,3,129088,129088,129091,0,3,1
36956,1,3,129089,129091,129094,2,5,0
36957,2,3,129091,129094,129097,3,6,0
36958,4,3,129095,129097,129100,2,5,0
36959,4,3,129099,129100,129103,1,4,0
36960,1,3,129100,129103,129106,3,6,0
36961,4,2,129104,129106,129108,2,4,0
36962,4,2,129108,129108,129110,0,2,0
36963,3,1,129111,129111,129112,0,1,1
36964,2,1,129113,129113,129114,0,1,1
36965,4,1,129117,129117,129118,0,1,3
36966,1,2,129118,129118,129120,0,2,0
36967,2,3,129120,129120,129123,0,3,0
36968,4,3,129124,129124,129127,0,3,1
36969,4,1,129128,129128,129129,0,1,1
36970,6,1,129134,129134,129135,0,1,5
36971,6,1,129140,129140,129141,0,1,5
36972,4,2,129144,129144,129146,0,2,3
36973,3,3,129147,129147,129150,0,3,1
36974,3,3,129150,129150,129153,0,3,0
36975,1,2,129151,129153,129155,2,4,0
36976,4,3,129155,129155,129158,0,3,0
36977,4,2,129159,129159,129161,0,2,1
36978,2,3,129161,129161,129164,0,3,0
36979,2,3,129163,129164,129167,1,4,0
36980,5,3,129168,129168,129171,0,3,1
36981,1,3,129169,129171,129174,2,5,0
36982,1,3,129170,129174,129177,4,7,0
36983,2,3,129172,129177,129180,5,8,0
36984,6,1,129178,129180,129181,2,3,0
36985,6,3,129184,129184,129187,0,3,3
36986,1,1,129185,129187,129188,2,3,0
36987,3,2,129188,129188,129190,0,2,0
36988,5,2,129193,129193,129195,0,2,3
36989,4,2,129197,129197,129199,0,2,2
36990,6,2,129203,129203,129205,0,2,4
36991,4,3,129207,129207,129210,0,3,2
36992,4,3,129211,129211,129214,0,3,1
36993,4,1,129215,129215,129216,0,1,1
36994,4,3,129219,129219,129222,0,3,3
36995,2,2,129221,129222,129224,1,3,0
36996,2,2,129223,129224,129226,1,3,0
36997,1,1,129224,129226,129227,2,3,0
36998,2,2,129226,129227,129229,1,3,0
36999,3,3,129229,129229,129232,0,3,0
37000,6,2,129235,129235,129237,0,2,3
37001,4,1,129239,129239,129240,0,1,2
37002,4,2,129243,129243,129245,0,2,3
37003,3,2,129246,129246,129248,0,2,1
37004,5,2,129251,129251,129253,0,2,3
37005,4,1,129255,129255,129256,0,1,2
37006,1,1,129256,129256,129257,0,1,0
37007,5,3,129261,129261,129264,0,3,4
37008,4,2,129265,129265,129267,0,2,1
37009,5,3,129270,129270,129273,0,3,3
37010,5,3,129275,129275,129278,0,3,2
37011,2,1,129277,129278,129279,1,2,0
37012,5,3,129282,129282,129285,0,3,3
37013,5,2,129287,129287,129289,0,2,2
37014,2,2,129289,129289,129291,0,2,0
37015,3,1,129292,129292,129293,0,1,1
37016,3,2,129295,129295,129297,0,2,2
37017,4,3,129299,129299,129302,0,3,2
37018,3,2,129302,129302,129304,0,2,0
37019,4,2,129306,129306,129308,0,2,2
37020,3,1,129309,129309,129310,0,1,1
37021,2,1,129311,129311,129312,0,1,1
37022,3,2,129314,129314,129316,0,2,2
37023,2,2,129316,129316,129318,0,2,0
37024,2,3,129318,129318,129321,0,3,0
37025,2,2,129320,129321,129323,1,3,0
37026,1,3,129321,129323,129326,2,5,0
37027,2,2,129323,129326,129328,3,5,0
37028,6,3,129329,129329,129332,0,3,1
37029,1,2,129330,129332,129334,2,4,0
37030,5,1,129335,129335,129336,0,1,1
37031,2,2,129337,129337,129339,0,2,1
37032,3,1,129340,129340,129341,0,1,1
37033,3,3,129343,129343,129346,0,3,2
37034,2,1,129345,129346,129347,1,2,0
37035,6,2,129351,129351,129353,0,2,4
37036,2,1,129353,129353,129354,0,1,0
37037,1,1,129354,129354,129355,0,1,0
37038,1,3,129355,129355,129358,0,3,0
37039,2,2,129357,129358,129360,1,3,0
37040,3,1,129360,129360,129361,0,1,0
37041,5,3,129365,129365,129368,0,3,4
37042,6,1,129371,129371,129372,0,1,3
37043,4,1,129375,129375,129376,0,1,3
37044,3,3,129378,129378,129381,0,3,2
37045,2,3,129380,129381,129384,1,4,0
37046,5,3,129385,129385,129388,0,3,1
37047,6,1,129391,129391,129392,0,1,3
37048,4,3,129395,129395,129398,0,3,3
37049,4,3,129399,129399,129402,0,3,1
37050,6,3,129405,129405,129408,0,3,3
37051,3,2,129408,129408,129410,0,2,0
37052,1,2,129409,129410,129412,1,3,0
37053,5,2,129414,129414,129416,0,2,2
37054,3,3,129417,129417,129420,0,3,1
37055,2,3,129419,129420,129423,1,4,0
37056,6,2,129425,129425,129427,0,2,2
37057,3,1,129428,129428,129429,0,1,1
37058,3,3,129431,129431,129434,0,3,2
37059,2,1,129433,129434,129435,1,2,0
37060,1,2,129434,129435,129437,1,3,0
37061,6,1,129440,129440,129441,0,1,3
37062,3,1,129443,129443,129444,0,1,2
37063,5,3,129448,129448,129451,0,3,4
37064,2,1,129450,129451,129452,1,2,0
37065,3,3,129453,129453,129456,0,3,1
37066,3,1,129456,129456,129457,0,1,0
37067,1,3,129457,129457,129460,0,3,0
37068,3,1,129460,129460,129461,0,1,0
37069,6,2,129466,129466,129468,0,2,5
37070,1,1,129467,129468,129469,1,2,0
37071,2,3,129469,129469,129472,0,3,0
37072,5,1,129474,129474,129475,0,1,2
37073,4,3,129478,129478,129481,0,3,3
37074,3,3,129481,129481,129484,0,3,0
37075,1,3,129482,129484,129487,2,5,0
37076,6,3,129488,129488,129491,0,3,1
37077,1,3,129489,129491,129494,2,5,0
37078,6,1,129495,129495,129496,0,1,1
37079,1,2,129496,129496,129498,0,2,0
37080,6,1,129502,129502,129503,0,1,4
37081,2,3,129504,129504,129507,0,3,1
37082,6,1,129510,129510,129511,0,1,3
37083,1,3,129511,129511,129514,0,3,0
37084,4,3,129515,129515,129518,0,3,1
37085,5,2,129520,129520,129522,0,2,2
37086,6,3,129526,129526,129529,0,3,4
37087,2,3,129528,129529,129532,1,4,0
37088,1,1,129529,129532,129533,3,4,0
37089,5,2,129534,129534,129536,0,2,1
37090,5,1,129539,129539,129540,0,1,3
37091,2,3,129541,129541,129544,0,3,1
37092,3,1,129544,129544,129545,0,1,0
37093,2,2,129546,129546,129548,0,2,1
37094,2,1,129548,129548,129549,0,1,0
37095,3,1,129551,129551,129552,0,1,2
37096,4,3,129555,129555,129558,0,3,3
37097,1,3,129556,129558,129561,2,5,0
37098,2,2,129558,129561,129563,3,5,0
37099,5,3,129563,129563,129566,0,3,0
37100,6,3,129569,129569,129572,0,3,3
37101,6,2,129575,129575,129577,0,2,3
37102,4,3,129579,129579,129582,0,3,2
37103,1,2,129580,129582,129584,2,4,0
37104,2,2,129582,129584,129586,2,4,0
37105,3,2,129585,129586,129588,1,3,0
37106,2,2,129587,129588,129590,1,3,0
37107,6,1,129593,129593,129594,0,1,3
37108,6,2,129599,129599,129601,0,2,5
37109,5,1,129604,129604,129605,0,1,3
37110,4,3,129608,129608,129611,0,3,3
37111,3,1,129611,129611,129612,0,1,0
37112,5,2,129616,129616,129618,0,2,4
37113,4,1,129620,129620,129621,0,1,2
37114,4,3,129624,129624,129627,0,3,3
37115,4,2,129628,129628,129630,0,2,1
37116,4,2,129632,129632,129634,0,2,2
37117,1,1,129633,129634,129635,1,2,0
37118,6,1,129639,129639,129640,0,1,4
37119,5,2,129644,129644,129646,0,2,4
37120,4,1,129648,129648,129649,0,1,2
37121,2,2,129650,129650,129652,0,2,1
37122,2,1,129652,129652,129653,0,1,0
37123,3,2,129655,129655,129657,0,2,2
37124,6,2,129661,129661,129663,0,2,4
37125,4,1,129665,129665,129666,0,1,2
37126,1,2,129666,129666,129668,0,2,0
37127,3,1,129669,129669,129670,0,1,1
37128,4,2,129673,129673,129675,0,2,3
37129,6,3,129679,129679,129682,0,3,4
37130,6,1,129685,129685,129686,0,1,3
37131,3,1,129688,129688,129689,0,1,2
37132,1,2,129689,129689,129691,0,2,0
37133,4,3,129693,129693,129696,0,3,2
37134,1,1,129694,129696,129697,2,3,0
37135,1,3,129695,129697,129700,2,5,0
37136,5,3,129700,129700,129703,0,3,0
37137,4,3,129704,129704,129707,0,3,1
37138,2,1,129706,129707,129708,1,2,0
37139,4,3,129710,129710,129713,0,3,2
37140,2,2,129712,129713,129715,1,3,0
37141,2,3,129714,129715,129718,1,4,0
37142,3,1,129717,129718,129719,1,2,0
37143,5,3,129722,129722,129725,0,3,3
37144,4,1,129726,129726,129727,0,1,1
37145,1,3,129727,129727,129730,0,3,0
37146,3,3,129730,129730,129733,0,3,0
37147,1,3,129731,129733,129736,2,5,0
37148,5,1,129736,129736,129737,0,1,0
37149,4,1,129740,129740,129741,0,1,3
37150,2,1,129742,129742,129743,0,1,1
37151,3,2,129745,129745,129747,0,2,2
37152,4,2,129749,129749,129751,0,2,2
37153,1,2,129750,129751,129753,1,3,0
37154,2,3,129752,129753,129756,1,4,0
37155,5,2,129757,129757,129759,0,2,1
37156,3,3,129760,129760,129763,0,3,1
37157,3,2,129763,129763,129765,0,2,0
37158,1,1,129764,129765,129766,1,2,0
37159,1,1,129765,129766,129767,1,2,0
37160,6,1,129771,129771,129772,0,1,4
37161,6,1,129777,129777,129778,0,1,5
37162,4,3,129781,129781,129784,0,3,3
37163,3,1,129784,129784,129785,0,1,0
37164,6,1,129790,129790,129791,0,1,5
37165,2,3,129792,129792,129795,0,3,1
37166,6,2,129798,129798,129800,0,2,3
37167,6,3,129804,129804,129807,0,3,4
37168,3,2,129807,129807,129809,0,2,0
37169,1,2,129808,129809,129811,1,3,0
37170,2,2,129810,129811,129813,1,3,0
37171,2,2,129812,129813,129815,1,3,0
37172,4,1,129816,129816,129817,0,1,1
37173,6,3,129822,129822,129825,0,3,5
37174,2,3,129824,129825,129828,1,4,0
37175,4,2,129828,129828,129830,0,2,0
37176,1,1,129829,129830,129831,1,2,0
37177,6,1,129835,129835,129836,0,1,4
37178,4,1,129839,129839,129840,0,1,3
37179,5,2,129844,129844,129846,0,2,4
37180,6,3,129850,129850,129853,0,3,4
37181,1,1,129851,129853,129854,2,3,0
37182,3,3,129854,129854,129857,0,3,0
37183,2,3,129856,129857,129860,1,4,0
37184,4,1,129860,129860,129861,0,1,0
37185,5,1,129865,129865,129866,0,1,4
37186,3,2,129868,129868,129870,0,2,2
37187,5,1,129873,129873,129874,0,1,3
37188,2,3,129875,129875,129878,0,3,1
37189,3,2,129878,129878,129880,0,2,0
37190,2,3,129880,129880,129883,0,3,0
37191,4,2,129884,129884,129886,0,2,1
37192,1,1,129885,129886,129887,1,2,0
37193,3,1,129888,129888,129889,0,1,1
37194,6,1,129894,129894,129895,0,1,5
37195,3,1,129897,129897,129898,0,1,2
37196,5,3,129902,129902,129905,0,3,4
37197,4,2,129906,129906,129908,0,2,1
37198,1,1,129907,129908,129909,1,2,0
37199,3,2,129910,129910,129912,0,2,1
37200,1,1,129911,129912,129913,1,2,0
37201,5,2,129916,129916,129918,0,2,3
37202,5,2,129921,129921,129923,0,2,3
37203,3,2,129924,129924,129926,0,2,1
37204,5,1,129929,129929,129930,0,1,3
37205,2,1,129931,129931,129932,0,1,1
37206,3,2,129934,129934,129936,0,2,2
37207,2,3,129936,129936,129939,0,3,0
37208,3,2,129939,129939,129941,0,2,0
37209,2,2,129941,129941,129943,0,2,0
37210,4,1,129945,129945,129946,0,1,2
37211,1,3,129946,129946,129949,0,3,0
37212,6,2,129952,129952,129954,0,2,3
37213,2,3,129954,129954,129957,0,3,0
37214,5,3,129959,129959,129962,0,3,2
37215,4,1,129963,129963,129964,0,1,1
37216,1,2,129964,129964,129966,0,2,0
37217,4,1,129968,129968,129969,0,1,2
37218,2,2,129970,129970,129972,0,2,1
37219,1,2,129971,129972,129974,1,3,0
37220,3,1,129974,129974,129975,0,1,0
37221,5,1,129979,129979,129980,0,1,4
37222,5,1,129984,129984,129985,0,1,4
37223,1,3,129985,129985,129988,0,3,0
37224,2,1,129987,129988,129989,1,2,0
37225,2,2,129989,129989,129991,0,2,0
37226,4,1,129993,129993,129994,0,1,2
37227,5,3,129998,129998,130001,0,3,4
37228,6,1,130004,130004,130005,0,1,3
37229,6,1,130010,130010,130011,0,1,5
37230,2,1,130012,130012,130013,0,1,1
37231,3,3,130015,130015,130018,0,3,2
37232,5,2,130020,130020,130022,0,2,2
37233,6,3,130026,130026,130029,0,3,4
37234,1,1,130027,130029,130030,2,3,0
37235,1,1,130028,130030,130031,2,3,0
37236,3,3,130031,130031,130034,0,3,0
37237,1,3,130032,130034,130037,2,5,0
37238,3,1,130035,130037,130038,2,3,0
37239,1,2,130036,130038,130040,2,4,0
37240,5,3,130041,130041,130044,0,3,1
37241,6,2,130047,130047,130049,0,2,3
37242,6,3,130053,130053,130056,0,3,4
37243,1,3,130054,130056,130059,2,5,0
37244,1,1,130055,130059,130060,4,5,0
37245,1,2,130056,130060,130062,4,6,0
37246,2,1,130058,130062,130063,4,5,0
37247,4,2,130062,130063,130065,1,3,0
37248,4,3,130066,130066,130069,0,3,1
37249,4,1,130070,130070,130071,0,1,1
37250,4,2,130074,130074,130076,0,2,3
37251,3,2,130077,130077,130079,0,2,1
37252,1,2,130078,130079,130081,1,3,0
37253,6,3,130084,130084,130087,0,3,3
37254,2,1,130086,130087,130088,1,2,0
37255,3,1,130089,130089,130090,0,1,1
37256,3,3,130092,130092,130095,0,3,2
37257,6,2,130098,130098,130100,0,2,3
37258,2,2,130100,130100,130102,0,2,0
37259,4,1,130104,130104,130105,0,1,2
37260,1,3,130105,130105,130108,0,3,0
37261,3,2,130108,130108,130110,0,2,0
37262,5,1,130113,130113,130114,0,1,3
37263,6,2,130119,130119,130121,0,2,5
37264,5,3,130124,130124,130127,0,3,3
37265,3,1,130127,130127,130128,0,1,0
37266,2,3,130129,130129,130132,0,3,1
37267,1,1,130130,130132,130133,2,3,0
37268,3,1,130133,130133,130134,0,1,0
37269,3,1,130136,130136,130137,0,1,2
37270,2,3,130138,130138,130141,0,3,1
37271,3,3,130141,130141,130144,0,3,0
37272,6,2,130147,130147,130149,0,2,3
37273,6,1,130153,130153,130154,0,1,4
37274,4,2,130157,130157,130159,0,2,3
37275,5,2,130162,130162,130164,0,2,3
37276,4,1,130166,130166,130167,0,1,2
37277,1,2,130167,130167,130169,0,2,0
37278,6,2,130173,130173,130175,0,2,4
37279,4,2,130177,130177,130179,0,2,2
37280,6,1,130183,130183,130184,0,1,4
37281,2,2,130185,130185,130187,0,2,1
37282,4,2,130189,130189,130191,0,2,2
37283,1,2,130190,130191,130193,1,3,0
37284,1,1,130191,130193,130194,2,3,0
37285,3,2,130194,130194,130196,0,2,0
37286,5,3,130199,130199,130202,0,3,3
37287,6,3,130205,130205,130208,0,3,3
37288,6,2,130211,130211,130213,0,2,3
37289,1,1,130212,130213,130214,1,2,0
37290,4,1,130216,130216,130217,0,1,2
37291,2,2,130218,130218,130220,0,2,1
37292,4,3,130222,130222,130225,0,3,2
37293,3,3,130225,130225,130228,0,3,0
37294,3,2,130228,130228,130230,0,2,0
37295,5,1,130233,130233,130234,0,1,3
37296,1,3,130234,130234,130237,0,3,0
37297,6,3,130240,130240,130243,0,3,3
37298,4,3,130244,130244,130247,0,3,1
37299,1,3,130245,130247,130250,2,5,0
37300,2,1,130247,130250,130251,3,4,0
37301,4,1,130251,130251,130252,0,1,0
37302,4,1,130255,130255,130256,0,1,3
37303,4,3,130259,130259,130262,0,3,3
37304,3,1,130262,130262,130263,0,1,0
37305,3,2,130265,130265,130267,0,2,2
37306,6,2,130271,130271,130273,0,2,4
37307,4,2,130275,130275,130277,0,2,2
37308,1,2,130276,130277,130279,1,3,0
37309,1,2,130277,130279,130281,2,4,0
37310,5,2,130282,130282,130284,0,2,1
37311,1,3,130283,130284,130287,1,4,0
37312,5,3,130288,130288,130291,0,3,1
37313,1,3,130289,130291,130294,2,5,0
37314,5,2,130294,130294,130296,0,2,0
37315,2,3,130296,130296,130299,0,3,0
37316,5,3,130301,130301,130304,0,3,2
37317,5,1,130306,130306,130307,0,1,2
37318,6,2,130312,130312,130314,0,2,5
37319,4,1,130316,130316,130317,0,1,2
37320,6,2,130322,130322,130324,0,2,5
37321,4,1,130326,130326,130327,0,1,2
37322,5,3,130331,130331,130334,0,3,4
37323,1,3,130332,130334,130337,2,5,0
37324,5,3,130337,130337,130340,0,3,0
37325,4,3,130341,130341,130344,0,3,1
37326,2,1,130343,130344,130345,1,2,0
37327,2,1,130345,130345,130346,0,1,0
37328,6,3,130351,130351,130354,0,3,5
37329,3,2,130354,130354,130356,0,2,0
37330,4,2,130358,130358,130360,0,2,2
37331,2,1,130360,130360,130361,0,1,0
37332,6,2,130366,130366,130368,0,2,5
37333,1,2,130367,130368,130370,1,3,0
37334,6,2,130373,130373,130375,0,2,3
37335,3,2,130376,130376,130378,0,2,1
37336,2,3,130378,130378,130381,0,3,0
37337,6,2,130384,130384,130386,0,2,3
37338,5,3,130389,130389,130392,0,3,3
37339,3,3,130392,130392,130395,0,3,0
37340,1,3,130393,130395,130398,2,5,0
37341,2,3,130395,130398,130401,3,6,0
37342,1,3,130396,130401,130404,5,8,0
37343,1,2,130397,130404,130406,7,9,0
37344,6,3,130403,130406,130409,3,6,0
37345,3,2,130406,130409,130411,3,5,0
37346,6,3,130412,130412,130415,0,3,1
37347,5,3,130417,130417,130420,0,3,2
37348,2,1,130419,130420,130421,1,2,0
37349,1,3,130420,130421,130424,1,4,0
37350,5,2,130425,130425,130427,0,2,1
37351,4,2,130429,130429,130431,0,2,2
37352,3,2,130432,130432,130434,0,2,1
37353,4,3,130436,130436,130439,0,3,2
37354,6,3,130442,130442,130445,0,3,3
37355,3,2,130445,130445,130447,0,2,0
37356,2,2,130447,130447,130449,0,2,0
37357,6,2,130453,130453,130455,0,2,4
37358,3,2,130456,130456,130458,0,2,1
37359,4,3,130460,130460,130463,0,3,2
37360,3,2,130463,130463,130465,0,2,0
37361,2,1,130465,130465,130466,0,1,0
37362,4,3,130469,130469,130472,0,3,3
37363,3,2,130472,130472,130474,0,2,0
37364,3,2,130475,130475,130477,0,2,1
37365,1,1,130476,130477,130478,1,2,0
37366,5,2,130481,130481,130483,0,2,3
37367,1,2,130482,130483,130485,1,3,0
37368,2,2,130484,130485,130487,1,3,0
37369,3,1,130487,130487,130488,0,1,0
37370,3,2,130490,130490,130492,0,2,2
37371,6,3,130496,130496,130499,0,3,4
37372,6,1,130502,130502,130503,0,1,3
37373,2,2,130504,130504,130506,0,2,1
37374,3,2,130507,130507,130509,0,2,1
37375,2,2,130509,130509,130511,0,2,0
37376,6,3,130515,130515,130518,0,3,4
37377,5,2,130520,130520,130522,0,2,2
37378,1,3,130521,130522,130525,1,4,0
37379,2,2,130523,130525,130527,2,4,0
37380,4,3,130527,130527,130530,0,3,0
37381,1,3,130528,130530,130533,2,5,0
37382,2,3,130530,130533,130536,3,6,0
37383,2,1,130532,130536,130537,4,5,0
37384,5,3,130537,130537,130540,0,3,0
37385,4,1,130541,130541,130542,0,1,1
37386,2,3,130543,130543,130546,0,3,1
37387,4,2,130547,130547,130549,0,2,1
37388,4,3,130551,130551,130554,0,3,2
37389,4,2,130555,130555,130557,0,2,1
37390,4,2,130559,130559,130561,0,2,2
37391,2,1,130561,130561,130562,0,1,0
37392,2,3,130563,130563,130566,0,3,1
37393,6,3,130569,130569,130572,0,3,3
37394,5,2,130574,130574,130576,0,2,2
37395,1,1,130575,130576,130577,1,2,0
37396,1,3,130576,130577,130580,1,4,0
37397,4,2,130580,130580,130582,0,2,0
37398,1,3,130581,130582,130585,1,4,0
37399,2,3,130583,130585,130588,2,5,0
37400,5,3,130588,130588,130591,0,3,0
37401,5,1,130593,130593,130594,0,1,2
37402,5,1,130598,130598,130599,0,1,4
37403,6,2,130604,130604,130606,0,2,5
37404,4,1,130608,130608,130609,0,1,2
37405,4,1,130612,130612,130613,0,1,3
37406,3,1,130615,130615,130616,0,1,2
37407,2,1,130617,130617,130618,0,1,1
37408,5,1,130622,130622,130623,0,1,4
37409,6,2,130628,130628,130630,0,2,5
37410,2,2,130630,130630,130632,0,2,0
37411,2,2,130632,130632,130634,0,2,0
37412,4,1,130636,130636,130637,0,1,2
37413,6,1,130642,130642,130643,0,1,5
37414,5,3,130647,130647,130650,0,3,4
37415,6,2,130653,130653,130655,0,2,3
37416,6,2,130659,130659,130661,0,2,4
37417,6,3,130665,130665,130668,0,3,4
37418,5,2,130670,130670,130672,0,2,2
37419,5,1,130675,130675,130676,0,1,3
37420,5,2,130680,130680,130682,0,2,4
37421,6,1,130686,130686,130687,0,1,4
37422,5,1,130691,130691,130692,0,1,4
37423,4,2,130695,130695,130697,0,2,3
37424,4,2,130699,130699,130701,0,2,2
37425,5,2,130704,130704,130706,0,2,3
37426,3,1,130707,130707,130708,0,1,1
37427,1,3,130708,130708,130711,0,3,0
37428,2,2,130710,130711,130713,1,3,0
37429,5,3,130715,130715,130718,0,3,2
37430,2,3,130717,130718,130721,1,4,0
37431,5,1,130722,130722,130723,0,1,1
37432,5,2,130727,130727,130729,0,2,4
37433,1,1,130728,130729,130730,1,2,0
37434,3,1,130731,130731,130732,0,1,1
37435,1,3,130732,130732,130735,0,3,0
37436,4,3,130736,130736,130739,0,3,1
37437,5,1,130741,130741,130742,0,1,2
37438,2,2,130743,130743,130745,0,2,1
37439,3,2,130746,130746,130748,0,2,1
37440,2,2,130748,130748,130750,0,2,0
37441,1,2,130749,130750,130752,1,3,0
37442,5,1,130754,130754,130755,0,1,2
37443,1,2,130755,130755,130757,0,2,0
37444,1,3,130756,130757,130760,1,4,0
37445,5,2,130761,130761,130763,0,2,1
37446,4,1,130765,130765,130766,0,1,2
37447,4,3,130769,130769,130772,0,3,3
37448,4,2,130773,130773,130775,0,2,1
37449,5,1,130778,130778,130779,0,1,3
37450,1,3,130779,130779,130782,0,3,0
37451,5,1,130784,130784,130785,0,1,2
37452,4,2,130788,130788,130790,0,2,3
37453,5,1,130793,130793,130794,0,1,3
37454,5,2,130798,130798,130800,0,2,4
37455,6,1,130804,130804,130805,0,1,4
37456,5,3,130809,130809,130812,0,3,4
37457,2,1,130811,130812,130813,1,2,0
37458,3,1,130814,130814,130815,0,1,1
37459,3,2,130817,130817,130819,0,2,2
37460,5,3,130822,130822,130825,0,3,3
37461,3,3,130825,130825,130828,0,3,0
37462,2,2,130827,130828,130830,1,3,0
37463,4,2,130831,130831,130833,0,2,1
37464,6,1,130837,130837,130838,0,1,4
37465,2,2,130839,130839,130841,0,2,1
37466,2,1,130841,130841,130842,0,1,0
37467,2,2,130843,130843,130845,0,2,1
37468,1,3,130844,130845,130848,1,4,0
37469,6,2,130850,130850,130852,0,2,2
37470,6,2,130856,130856,130858,0,2,4
37471,4,3,130860,130860,130863,0,3,2
37472,6,2,130866,130866,130868,0,2,3
37473,3,1,130869,130869,130870,0,1,1
37474,4,3,130873,130873,130876,0,3,3
37475,5,3,130878,130878,130881,0,3,2
37476,4,3,130882,130882,130885,0,3,1
37477,6,2,130888,130888,130890,0,2,3
37478,2,3,130890,130890,130893,0,3,0
37479,1,3,130891,130893,130896,2,5,0
37480,4,1,130895,130896,130897,1,2,0
37481,2,2,130897,130897,130899,0,2,0
37482,3,2,130900,130900,130902,0,2,1
37483,1,1,130901,130902,130903,1,2,0
37484,3,3,130904,130904,130907,0,3,1
37485,5,1,130909,130909,130910,0,1,2
37486,6,2,130915,130915,130917,0,2,5
37487,5,3,130920,130920,130923,0,3,3
37488,4,3,130924,130924,130927,0,3,1
37489,6,2,130930,130930,130932,0,2,3
37490,5,2,130935,130935,130937,0,2,3
37491,1,2,130936,130937,130939,1,3,0
37492,4,1,130940,130940,130941,0,1,1
37493,2,2,130942,130942,130944,0,2,1
37494,3,3,130945,130945,130948,0,3,1
37495,3,1,130948,130948,130949,0,1,0
37496,3,2,130951,130951,130953,0,2,2
37497,2,1,130953,130953,130954,0,1,0
37498,4,3,130957,130957,130960,0,3,3
37499,1,1,130958,130960,130961,2,3,0
37500,4,3,130962,130962,130965,0,3,1
37501,1,2,130963,130965,130967,2,4,0
37502,6,3,130969,130969,130972,0,3,2
37503,3,1,130972,130972,130973,0,1,0
37504,6,3,130978,130978,130981,0,3,5
37505,2,2,130980,130981,130983,1,3,0
37506,1,2,130981,130983,130985,2,4,0
37507,6,3,130987,130987,130990,0,3,2
37508,6,1,130993,130993,130994,0,1,3
37509,2,1,130995,130995,130996,0,1,1
37510,3,3,130998,130998,131001,0,3,2
37511,2,2,131000,131001,131003,1,3,0
37512,2,2,131002,131003,131005,1,3,0
37513,1,3,131003,131005,131008,2,5,0
37514,6,1,131009,131009,131010,0,1,1
37515,5,3,131014,131014,131017,0,3,4
37516,1,3,131015,131017,131020,2,5,0
37517,5,2,131020,131020,131022,0,2,0
37518,1,1,131021,131022,131023,1,2,0
37519,1,3,131022,131023,131026,1,4,0
37520,4,1,131026,131026,131027,0,1,0
37521,5,2,131031,131031,131033,0,2,4
37522,4,1,131035,131035,131036,0,1,2
37523,4,3,131039,131039,131042,0,3,3
37524,5,3,131044,131044,131047,0,3,2
37525,3,3,131047,131047,131050,0,3,0
37526,6,1,131053,131053,131054,0,1,3
37527,4,1,131057,131057,131058,0,1,3
37528,3,3,131060,131060,131063,0,3,2
37529,5,3,131065,131065,131068,0,3,2
37530,5,1,131070,131070,131071,0,1,2
37531,3,3,131073,131073,131076,0,3,2
37532,1,1,131074,131076,131077,2,3,0
37533,4,2,131078,131078,131080,0,2,1
37534,4,3,131082,131082,131085,0,3,2
37535,6,3,131088,131088,131091,0,3,3
37536,5,3,131093,131093,131096,0,3,2
37537,6,2,131099,131099,131101,0,2,3
37538,2,3,131101,131101,131104,0,3,0
37539,3,3,131104,131104,131107,0,3,0
37540,1,2,131105,131107,131109,2,4,0
37541,6,1,131111,131111,131112,0,1,2
37542,6,2,131117,131117,131119,0,2,5
37543,2,1,131119,131119,131120,0,1,0
37544,3,3,131122,131122,131125,0,3,2
37545,1,2,131123,131125,131127,2,4,0
37546,6,1,131129,131129,131130,0,1,2
37547,3,2,131132,131132,131134,0,2,2
37548,2,2,131134,131134,131136,0,2,0
37549,3,3,131137,131137,131140,0,3,1
37550,6,3,131143,131143,131146,0,3,3
37551,4,2,131147,131147,131149,0,2,1
37552,6,1,131153,131153,131154,0,1,4
37553,4,2,131157,131157,131159,0,2,3
37554,6,2,131163,131163,131165,0,2,4
37555,1,1,131164,131165,131166,1,2,0
37556,3,2,131167,131167,131169,0,2,1
37557,6,2,131173,131173,131175,0,2,4
37558,1,1,131174,131175,131176,1,2,0
37559,2,2,131176,131176,131178,0,2,0
37560,4,2,131180,131180,131182,0,2,2
37561,3,2,131183,131183,131185,0,2,1
37562,1,3,131184,131185,131188,1,4,0
37563,3,2,131187,131188,131190,1,3,0
37564,3,1,131190,131190,131191,0,1,0
37565,3,3,131193,131193,131196,0,3,2
37566,4,2,131197,131197,131199,0,2,1
37567,4,2,131201,131201,131203,0,2,2
37568,4,2,131205,131205,131207,0,2,2
37569,2,3,131207,131207,131210,0,3,0
37570,4,3,131211,131211,131214,0,3,1
37571,4,3,131215,131215,131218,0,3,1
37572,1,1,131216,131218,131219,2,3,0
37573,4,3,131220,131220,131223,0,3,1
37574,3,1,131223,131223,131224,0,1,0
37575,6,2,131229,131229,131231,0,2,5
37576,2,3,131231,131231,131234,0,3,0
37577,6,1,131237,131237,131238,0,1,3
37578,2,1,131239,131239,131240,0,1,1
37579,2,1,131241,131241,131242,0,1,1
37580,3,2,131244,131244,131246,0,2,2
37581,6,2,131250,131250,131252,0,2,4
37582,1,1,131251,131252,131253,1,2,0
37583,2,1,131253,131253,131254,0,1,0
37584,1,2,131254,131254,131256,0,2,0
37585,6,2,131260,131260,131262,0,2,4
37586,5,2,131265,131265,131267,0,2,3
37587,1,2,131266,131267,131269,1,3,0
37588,4,3,131270,131270,131273,0,3,1
37589,6,2,131276,131276,131278,0,2,3
37590,4,3,131280,131280,131283,0,3,2
37591,1,3,131281,131283,131286,2,5,0
37592,4,1,131285,131286,131287,1,2,0
37593,6,1,131291,131291,131292,0,1,4
37594,2,3,131293,131293,131296,0,3,1
37595,5,3,131298,131298,131301,0,3,2
37596,4,1,131302,131302,131303,0,1,1
37597,2,3,131304,131304,131307,0,3,1
37598,5,2,131309,131309,131311,0,2,2
37599,5,2,131314,131314,131316,0,2,3
37600,1,3,131315,131316,131319,1,4,0
37601,3,2,131318,131319,131321,1,3,0
37602,4,3,131322,131322,131325,0,3,1
37603,1,1,131323,131325,131326,2,3,0
37604,2,1,131325,131326,131327,1,2,0
37605,6,1,131331,131331,131332,0,1,4
37606,6,1,131337,131337,131338,0,1,5
37607,2,1,131339,131339,131340,0,1,1
37608,5,3,131344,131344,131347,0,3,4
37609,6,1,131350,131350,131351,0,1,3
37610,2,2,131352,131352,131354,0,2,1
37611,5,3,131357,131357,131360,0,3,3
37612,1,3,131358,131360,131363,2,5,0
37613,1,1,131359,131363,131364,4,5,0
37614,6,1,131365,131365,131366,0,1,1
37615,4,2,131369,131369,131371,0,2,3
37616,4,3,131373,131373,131376,0,3,2
37617,5,2,131378,131378,131380,0,2,2
37618,2,1,131380,131380,131381,0,1,0
37619,5,2,131385,131385,131387,0,2,4
37620,4,2,131389,131389,131391,0,2,2
37621,4,3,131393,131393,131396,0,3,2
37622,1,2,131394,131396,131398,2,4,0
37623,5,1,131399,131399,131400,0,1,1
37624,4,1,131403,131403,131404,0,1,3
37625,2,3,131405,131405,131408,0,3,1
37626,2,3,131407,131408,131411,1,4,0
37627,1,3,131408,131411,131414,3,6,0
37628,6,2,131414,131414,131416,0,2,0
37629,2,1,131416,131416,131417,0,1,0
37630,2,1,131418,131418,131419,0,1,1
37631,6,2,131424,131424,131426,0,2,5
37632,6,2,131430,131430,131432,0,2,4
37633,6,1,131436,131436,131437,0,1,4
37634,1,2,131437,131437,131439,0,2,0
37635,1,3,131438,131439,131442,1,4,0
37636,6,3,131444,131444,131447,0,3,2
37637,5,1,131449,131449,131450,0,1,2
37638,3,2,131452,131452,131454,0,2,2
37639,4,1,131456,131456,131457,0,1,2
37640,1,1,131457,131457,131458,0,1,0
37641,5,2,131462,131462,131464,0,2,4
37642,5,2,131467,131467,131469,0,2,3
37643,3,3,131470,131470,131473,0,3,1
37644,5,3,131475,131475,131478,0,3,2
37645,3,3,131478,131478,131481,0,3,0
37646,5,2,131483,131483,131485,0,2,2
37647,1,3,131484,131485,131488,1,4,0
37648,3,2,131487,131488,131490,1,3,0
37649,2,3,131489,131490,131493,1,4,0
37650,3,3,131492,131493,131496,1,4,0
37651,2,3,131494,131496,131499,2,5,0
37652,2,3,131496,131499,131502,3,6,0
37653,2,2,131498,131502,131504,4,6,0
37654,2,1,131500,131504,131505,4,5,0
37655,4,2,131504,131505,131507,1,3,0
37656,6,1,131510,131510,131511,0,1,3
37657,6,3,131516,131516,131519,0,3,5
37658,1,2,131517,131519,131521,2,4,0
37659,1,3,131518,131521,131524,3,6,0
37660,2,2,131520,131524,131526,4,6,0
37661,5,1,131525,131526,131527,1,2,0
37662,5,2,131530,131530,131532,0,2,3
37663,6,1,131536,131536,131537,0,1,4
37664,3,3,131539,131539,131542,0,3,2
37665,1,2,131540,131542,131544,2,4,0
37666,6,3,131546,131546,131549,0,3,2
37667,1,2,131547,131549,131551,2,4,0
37668,3,2,131550,131551,131553,1,3,0
37669,6,1,131556,131556,131557,0,1,3
37670,2,1,131558,131558,131559,0,1,1
37671,2,3,131560,131560,131563,0,3,1
37672,5,2,131565,131565,131567,0,2,2
37673,1,3,131566,131567,131570,1,4,0
37674,2,3,131568,131570,131573,2,5,0
37675,5,1,131573,131573,131574,0,1,0
37676,4,1,131577,131577,131578,0,1,3
37677,6,3,131583,131583,131586,0,3,5
37678,1,1,131584,131586,131587,2,3,0
37679,6,2,131590,131590,131592,0,2,3
37680,4,1,131594,131594,131595,0,1,2
37681,4,2,131598,131598,131600,0,2,3
37682,3,1,131601,131601,131602,0,1,1
37683,1,2,131602,131602,131604,0,2,0
37684,4,2,131606,131606,131608,0,2,2
37685,6,3,131612,131612,131615,0,3,4
37686,5,1,131617,131617,131618,0,1,2
37687,3,2,131620,131620,131622,0,2,2
37688,5,2,131625,131625,131627,0,2,3
37689,4,3,131629,131629,131632,0,3,2
37690,2,2,131631,131632,131634,1,3,0
37691,6,3,131637,131637,131640,0,3,3
37692,5,2,131642,131642,131644,0,2,2
37693,4,3,131646,131646,131649,0,3,2
37694,5,2,131651,131651,131653,0,2,2
37695,2,2,131653,131653,131655,0,2,0
37696,1,2,131654,131655,131657,1,3,0
37697,5,2,131659,131659,131661,0,2,2
37698,1,2,131660,131661,131663,1,3,0
37699,1,3,131661,131663,131666,2,5,0
37700,5,1,131666,131666,131667,0,1,0
37701,3,2,131669,131669,131671,0,2,2
37702,2,1,131671,131671,131672,0,1,0
37703,1,3,131672,131672,131675,0,3,0
37704,3,2,131675,131675,131677,0,2,0
37705,2,2,131677,131677,131679,0,2,0
37706,6,1,131683,131683,131684,0,1,4
37707,3,2,131686,131686,131688,0,2,2
37708,5,1,131691,131691,131692,0,1,3
37709,2,1,131693,131693,131694,0,1,1
37710,6,1,131699,131699,131700,0,1,5
37711,4,3,131703,131703,131706,0,3,3
37712,5,3,131708,131708,131711,0,3,2
37713,5,2,131713,131713,131715,0,2,2
37714,2,2,131715,131715,131717,0,2,0
37715,3,1,131718,131718,131719,0,1,1
37716,6,2,131724,131724,131726,0,2,5
37717,2,2,131726,131726,131728,0,2,0
37718,6,2,131732,131732,131734,0,2,4
37719,2,1,131734,131734,131735,0,1,0
37720,5,3,131739,131739,131742,0,3,4
37721,6,1,131745,131745,131746,0,1,3
37722,6,3,131751,131751,131754,0,3,5
37723,1,3,131752,131754,131757,2,5,0
37724,1,3,131753,131757,131760,4,7,0
37725,1,3,131754,131760,131763,6,9,0
37726,5,1,131759,131763,131764,4,5,0
37727,3,2,131762,131764,131766,2,4,0
37728,4,3,131766,131766,131769,0,3,0
37729,5,1,131771,131771,131772,0,1,2
37730,3,1,131774,131774,131775,0,1,2
37731,6,1,131780,131780,131781,0,1,5
37732,6,2,131786,131786,131788,0,2,5
37733,3,1,131789,131789,131790,0,1,1
37734,6,3,131795,131795,131798,0,3,5
37735,2,2,131797,131798,131800,1,3,0
37736,2,3,131799,131800,131803,1,4,0
37737,4,3,131803,131803,131806,0,3,0
37738,2,1,131805,131806,131807,1,2,0
37739,6,1,131811,131811,131812,0,1,4
37740,4,1,131815,131815,131816,0,1,3
37741,2,1,131817,131817,131818,0,1,1
37742,1,1,131818,131818,131819,0,1,0
37743,2,2,131820,131820,131822,0,2,1
37744,3,2,131823,131823,131825,0,2,1
37745,4,2,131827,131827,131829,0,2,2
37746,6,2,131833,131833,131835,0,2,4
37747,2,3,131835,131835,131838,0,3,0
37748,5,3,131840,131840,131843,0,3,2
37749,2,3,131842,131843,131846,1,4,0
37750,6,3,131848,131848,131851,0,3,2
37751,1,3,131849,131851,131854,2,5,0
37752,4,1,131853,131854,131855,1,2,0
37753,6,2,131859,131859,131861,0,2,4
37754,6,2,131865,131865,131867,0,2,4
37755,3,3,131868,131868,131871,0,3,1
37756,6,1,131874,131874,131875,0,1,3
37757,4,3,131878,131878,131881,0,3,3
37758,4,3,131882,131882,131885,0,3,1
37759,4,1,131886,131886,131887,0,1,1
37760,2,2,131888,131888,131890,0,2,1
37761,3,2,131891,131891,131893,0,2,1
37762,3,1,131894,131894,131895,0,1,1
37763,4,1,131898,131898,131899,0,1,3
37764,5,1,131903,131903,131904,0,1,4
37765,5,2,131908,131908,131910,0,2,4
37766,3,3,131911,131911,131914,0,3,1
37767,6,3,131917,131917,131920,0,3,3
37768,4,3,131921,131921,131924,0,3,1
37769,2,1,131923,131924,131925,1,2,0
37770,1,1,131924,131925,131926,1,2,0
37771,3,1,131927,131927,131928,0,1,1
37772,4,3,131931,131931,131934,0,3,3
37773,6,1,131937,131937,131938,0,1,3
37774,2,3,131939,131939,131942,0,3,1
37775,5,1,131944,131944,131945,0,1,2
37776,4,3,131948,131948,131951,0,3,3
37777,2,1,131950,131951,131952,1,2,0
37778,2,3,131952,131952,131955,0,3,0
37779,1,1,131953,131955,131956,2,3,0
37780,6,3,131959,131959,131962,0,3,3
37781,1,3,131960,131962,131965,2,5,0
37782,5,2,131965,131965,131967,0,2,0
37783,6,1,131971,131971,131972,0,1,4
37784,4,2,131975,131975,131977,0,2,3
37785,4,3,131979,131979,131982,0,3,2
37786,4,3,131983,131983,131986,0,3,1
37787,1,2,131984,131986,131988,2,4,0
37788,2,1,131986,131988,131989,2,3,0
37789,1,2,131987,131989,131991,2,4,0
37790,1,3,131988,131991,131994,3,6,0
37791,1,1,131989,131994,131995,5,6,0
37792,5,3,131994,131995,131998,1,4,0
37793,5,1,131999,131999,132000,0,1,1
37794,4,2,132003,132003,132005,0,2,3
37795,6,1,132009,132009,132010,0,1,4
37796,2,3,132011,132011,132014,0,3,1
37797,1,1,132012,132014,132015,2,3,0
37798,5,2,132017,132017,132019,0,2,2
37799,4,2,132021,132021,132023,0,2,2
37800,3,3,132024,132024,132027,0,3,1
37801,6,2,132030,132030,132032,0,2,3
37802,2,1,132032,132032,132033,0,1,0
37803,2,3,132034,132034,132037,0,3,1
37804,5,3,132039,132039,132042,0,3,2
37805,4,1,132043,132043,132044,0,1,1
37806,3,3,132046,132046,132049,0,3,2
37807,6,3,132052,132052,132055,0,3,3
37808,5,1,132057,132057,132058,0,1,2
37809,4,1,132061,132061,132062,0,1,3
37810,3,3,132064,132064,132067,0,3,2
37811,5,2,132069,132069,132071,0,2,2
37812,1,2,132070,132071,132073,1,3,0
37813,1,3,132071,132073,132076,2,5,0
37814,2,2,132073,132076,132078,3,5,0
37815,3,3,132076,132078,132081,2,5,0
37816,2,3,132078,132081,132084,3,6,0
37817,6,2,132084,132084,132086,0,2,0
37818,6,2,132090,132090,132092,0,2,4
37819,5,3,132095,132095,132098,0,3,3
37820,2,2,132097,132098,132100,1,3,0
37821,1,1,132098,132100,132101,2,3,0
37822,2,1,132100,132101,132102,1,2,0
37823,2,2,132102,132102,132104,0,2,0
37824,5,2,132107,132107,132109,0,2,3
37825,2,2,132109,132109,132111,0,2,0
37826,5,1,132114,132114,132115,0,1,3
37827,4,1,132118,132118,132119,0,1,3
37828,1,1,132119,132119,132120,0,1,0
37829,3,1,132122,132122,132123,0,1,2
37830,2,2,132124,132124,132126,0,2,1
37831,3,3,132127,132127,132130,0,3,1
37832,2,3,132129,132130,132133,1,4,0
37833,1,1,132130,132133,132134,3,4,0
37834,3,3,132133,132134,132137,1,4,0
37835,2,3,132135,132137,132140,2,5,0
37836,4,3,132139,132140,132143,1,4,0
37837,6,3,132145,132145,132148,0,3,2
37838,1,2,132146,132148,132150,2,4,0
37839,1,2,132147,132150,132152,3,5,0
37840,1,2,132148,132152,132154,4,6,0
37841,5,2,132153,132154,132156,1,3,0
37842,6,1,132159,132159,132160,0,1,3
37843,5,3,132164,132164,132167,0,3,4
37844,3,3,132167,132167,132170,0,3,0
37845,2,3,132169,132170,132173,1,4,0
37846,5,2,132174,132174,132176,0,2,1
37847,3,2,132177,132177,132179,0,2,1
37848,5,3,132182,132182,132185,0,3,3
37849,1,1,132183,132185,132186,2,3,0
37850,3,2,132186,132186,132188,0,2,0
37851,2,3,132188,132188,132191,0,3,0
37852,4,3,132192,132192,132195,0,3,1
37853,3,2,132195,132195,132197,0,2,0
37854,3,2,132198,132198,132200,0,2,1
37855,5,2,132203,132203,132205,0,2,3
37856,5,1,132208,132208,132209,0,1,3
37857,3,1,132211,132211,132212,0,1,2
37858,3,2,132214,132214,132216,0,2,2
37859,3,3,132217,132217,132220,0,3,1
37860,5,2,132222,132222,132224,0,2,2
37861,5,2,132227,132227,132229,0,2,3
37862,3,1,132230,132230,132231,0,1,1
37863,2,3,132232,132232,132235,0,3,1
37864,6,1,132238,132238,132239,0,1,3
37865,1,3,132239,132239,132242,0,3,0
37866,1,1,132240,132242,132243,2,3,0
37867,6,1,132246,132246,132247,0,1,3
37868,1,3,132247,132247,132250,0,3,0
37869,1,3,132248,132250,132253,2,5,0
37870,6,2,132254,132254,132256,0,2,1
37871,6,1,132260,132260,132261,0,1,4
37872,6,3,132266,132266,132269,0,3,5
37873,1,2,132267,132269,132271,2,4,0
37874,6,1,132273,132273,132274,0,1,2
37875,1,1,132274,132274,132275,0,1,0
37876,5,2,132279,132279,132281,0,2,4
37877,3,3,132282,132282,132285,0,3,1
37878,6,3,132288,132288,132291,0,3,3
37879,1,2,132289,132291,132293,2,4,0
37880,3,3,132292,132293,132296,1,4,0
37881,5,2,132297,132297,132299,0,2,1
37882,3,2,132300,132300,132302,0,2,1
37883,6,1,132306,132306,132307,0,1,4
37884,4,3,132310,132310,132313,0,3,3
37885,2,1,132312,132313,132314,1,2,0
37886,2,3,132314,132314,132317,0,3,0
37887,4,3,132318,132318,132321,0,3,1
37888,6,1,132324,132324,132325,0,1,3
37889,6,2,132330,132330,132332,0,2,5
37890,4,1,132334,132334,132335,0,1,2
37891,6,1,132340,132340,132341,0,1,5
37892,6,2,132346,132346,132348,0,2,5
37893,1,3,132347,132348,132351,1,4,0
37894,4,1,132351,132351,132352,0,1,0
37895,6,2,132357,132357,132359,0,2,5
37896,2,1,132359,132359,132360,0,1,0
37897,1,1,132360,132360,132361,0,1,0
37898,5,3,132365,132365,132368,0,3,4
37899,2,2,132367,132368,132370,1,3,0
37900,4,1,132371,132371,132372,0,1,1
37901,5,3,132376,132376,132379,0,3,4
37902,5,1,132381,132381,132382,0,1,2
37903,4,1,132385,132385,132386,0,1,3
37904,6,3,132391,132391,132394,0,3,5
37905,3,3,132394,132394,132397,0,3,0
37906,3,2,132397,132397,132399,0,2,0
37907,5,3,132402,132402,132405,0,3,3
37908,2,1,132404,132405,132406,1,2,0
37909,4,1,132408,132408,132409,0,1,2
37910,3,1,132411,132411,132412,0,1,2
37911,4,3,132415,132415,132418,0,3,3
37912,2,1,132417,132418,132419,1,2,0
37913,5,3,132422,132422,132425,0,3,3
37914,3,3,132425,132425,132428,0,3,0
37915,1,1,132426,132428,132429,2,3,0
37916,6,2,132432,132432,132434,0,2,3
37917,5,1,132437,132437,132438,0,1,3
37918,6,1,132443,132443,132444,0,1,5
37919,5,2,132448,132448,132450,0,2,4
37920,2,2,132450,132450,132452,0,2,0
37921,4,3,132454,132454,132457,0,3,2
37922,1,3,132455,132457,132460,2,5,0
37923,5,1,132460,132460,132461,0,1,0
37924,3,2,132463,132463,132465,0,2,2
37925,1,2,132464,132465,132467,1,3,0
37926,6,3,132470,132470,132473,0,3,3
37927,2,2,132472,132473,132475,1,3,0
37928,2,2,132474,132475,132477,1,3,0
37929,6,1,132480,132480,132481,0,1,3
37930,6,1,132486,132486,132487,0,1,5
37931,5,3,132491,132491,132494,0,3,4
37932,5,3,132496,132496,132499,0,3,2
37933,2,3,132498,132499,132502,1,4,0
37934,1,1,132499,132502,132503,3,4,0
37935,2,2,132501,132503,132505,2,4,0
37936,5,2,132506,132506,132508,0,2,1
37937,2,2,132508,132508,132510,0,2,0
37938,6,1,132514,132514,132515,0,1,4
37939,1,2,132515,132515,132517,0,2,0
37940,4,3,132519,132519,132522,0,3,2
37941,6,2,132525,132525,132527,0,2,3
37942,3,2,132528,132528,132530,0,2,1
37943,6,2,132534,132534,132536,0,2,4
37944,5,1,132539,132539,132540,0,1,3
37945,1,2,132540,132540,132542,0,2,0
37946,5,3,132545,132545,132548,0,3,3
37947,4,1,132549,132549,132550,0,1,1
37948,6,2,132555,132555,132557,0,2,5
37949,2,1,132557,132557,132558,0,1,0
37950,5,1,132562,132562,132563,0,1,4
37951,2,3,132564,132564,132567,0,3,1
37952,4,2,132568,132568,132570,0,2,1
37953,5,3,132573,132573,132576,0,3,3
37954,2,1,132575,132576,132577,1,2,0
37955,5,2,132580,132580,132582,0,2,3
37956,1,2,132581,132582,132584,1,3,0
37957,1,2,132582,132584,132586,2,4,0
37958,3,3,132585,132586,132589,1,4,0
37959,5,2,132590,132590,132592,0,2,1
37960,3,3,132593,132593,132596,0,3,1
37961,4,2,132597,132597,132599,0,2,1
37962,1,2,132598,132599,132601,1,3,0
37963,5,2,132603,132603,132605,0,2,2
37964,2,2,132605,132605,132607,0,2,0
37965,6,1,132611,132611,132612,0,1,4
37966,5,1,132616,132616,132617,0,1,4
37967,1,1,132617,132617,132618,0,1,0
37968,2,2,132619,132619,132621,0,2,1
37969,4,2,132623,132623,132625,0,2,2
37970,4,3,132627,132627,132630,0,3,2
37971,3,1,132630,132630,132631,0,1,0
37972,4,2,132634,132634,132636,0,2,3
37973,1,1,132635,132636,132637,1,2,0
37974,5,1,132640,132640,132641,0,1,3
37975,1,2,132641,132641,132643,0,2,0
37976,3,1,132644,132644,132645,0,1,1
37977,1,2,132645,132645,132647,0,2,0
37978,5,3,132650,132650,132653,0,3,3
37979,4,2,132654,132654,132656,0,2,1
37980,5,1,132659,132659,132660,0,1,3
37981,6,1,132665,132665,132666,0,1,5
37982,1,1,132666,132666,132667,0,1,0
37983,6,3,132672,132672,132675,0,3,5
37984,3,1,132675,132675,132676,0,1,0
37985,1,2,132676,132676,132678,0,2,0
37986,6,3,132682,132682,132685,0,3,4
37987,5,2,132687,132687,132689,0,2,2
37988,6,3,132693,132693,132696,0,3,4
37989,3,1,132696,132696,132697,0,1,0
37990,3,1,132699,132699,132700,0,1,2
37991,3,1,132702,132702,132703,0,1,2
37992,6,1,132708,132708,132709,0,1,5
37993,2,1,132710,132710,132711,0,1,1
37994,4,1,132714,132714,132715,0,1,3
37995,2,2,132716,132716,132718,0,2,1
37996,2,1,132718,132718,132719,0,1,0
37997,2,3,132720,132720,132723,0,3,1
37998,1,2,132721,132723,132725,2,4,0
37999,5,3,132726,132726,132729,0,3,1
38000,3,3,132729,132729,132732,0,3,0
38001,6,2,132735,132735,132737,0,2,3
38002,5,2,132740,132740,132742,0,2,3
38003,3,3,132743,132743,132746,0,3,1
38004,5,2,132748,132748,132750,0,2,2
38005,6,3,132754,132754,132757,0,3,4
38006,3,3,132757,132757,132760,0,3,0
38007,1,3,132758,132760,132763,2,5,0
38008,6,1,132764,132764,132765,0,1,1
38009,3,3,132767,132767,132770,0,3,2
38010,3,2,132770,132770,132772,0,2,0
38011,1,2,132771,132772,132774,1,3,0
38012,3,1,132774,132774,132775,0,1,0
38013,1,2,132775,132775,132777,0,2,0
38014,2,3,132777,132777,132780,0,3,0
38015,4,3,132781,132781,132784,0,3,1
38016,3,2,132784,132784,132786,0,2,0
38017,2,1,132786,132786,132787,0,1,0
38018,6,2,132792,132792,132794,0,2,5
38019,3,2,132795,132795,132797,0,2,1
38020,1,1,132796,132797,132798,1,2,0
38021,4,1,132800,132800,132801,0,1,2
38022,2,2,132802,132802,132804,0,2,1
38023,5,1,132807,132807,132808,0,1,3
38024,5,2,132812,132812,132814,0,2,4
38025,4,3,132816,132816,132819,0,3,2
38026,5,2,132821,132821,132823,0,2,2
38027,2,3,132823,132823,132826,0,3,0
38028,3,3,132826,132826,132829,0,3,0
38029,1,3,132827,132829,132832,2,5,0
38030,5,2,132832,132832,132834,0,2,0
38031,6,2,132838,132838,132840,0,2,4
38032,2,1,132840,132840,132841,0,1,0
38033,5,3,132845,132845,132848,0,3,4
38034,5,2,132850,132850,132852,0,2,2
38035,1,3,132851,132852,132855,1,4,0
38036,6,1,132857,132857,132858,0,1,2
38037,3,1,132860,132860,132861,0,1,2
38038,2,2,132862,132862,132864,0,2,1
38039,5,3,132867,132867,132870,0,3,3
38040,1,1,132868,132870,132871,2,3,0
38041,3,3,132871,132871,132874,0,3,0
38042,3,3,132874,132874,132877,0,3,0
38043,2,2,132876,132877,132879,1,3,0
38044,2,1,132878,132879,132880,1,2,0
38045,1,1,132879,132880,132881,1,2,0
38046,1,2,132880,132881,132883,1,3,0
38047,2,2,132882,132883,132885,1,3,0
38048,2,1,132884,132885,132886,1,2,0
38049,6,3,132890,132890,132893,0,3,4
38050,4,1,132894,132894,132895,0,1,1
38051,2,3,132896,132896,132899,0,3,1
38052,6,1,132902,132902,132903,0,1,3
38053,1,1,132903,132903,132904,0,1,0
38054,2,2,132905,132905,132907,0,2,1
38055,6,3,132911,132911,132914,0,3,4
38056,6,2,132917,132917,132919,0,2,3
38057,5,1,132922,132922,132923,0,1,3
38058,2,3,132924,132924,132927,0,3,1
38059,6,3,132930,132930,132933,0,3,3
38060,3,3,132933,132933,132936,0,3,0
38061,5,3,132938,132938,132941,0,3,2
38062,5,1,132943,132943,132944,0,1,2
38063,6,3,132949,132949,132952,0,3,5
38064,1,1,132950,132952,132953,2,3,0
38065,4,3,132954,132954,132957,0,3,1
38066,1,2,132955,132957,132959,2,4,0
38067,2,3,132957,132959,132962,2,5,0
38068,5,1,132962,132962,132963,0,1,0
38069,1,2,132963,132963,132965,0,2,0
38070,5,3,132968,132968,132971,0,3,3
38071,6,2,132974,132974,132976,0,2,3
38072,2,2,132976,132976,132978,0,2,0
38073,2,2,132978,132978,132980,0,2,0
38074,4,2,132982,132982,132984,0,2,2
38075,4,3,132986,132986,132989,0,3,2
38076,1,2,132987,132989,132991,2,4,0
38077,3,1,132990,132991,132992,1,2,0
38078,3,1,132993,132993,132994,0,1,1
38079,2,1,132995,132995,132996,0,1,1
38080,3,2,132998,132998,133000,0,2,2
38081,4,3,133002,133002,133005,0,3,2
38082,3,2,133005,133005,133007,0,2,0
38083,2,1,133007,133007,133008,0,1,0
38084,5,3,133012,133012,133015,0,3,4
38085,6,1,133018,133018,133019,0,1,3
38086,4,3,133022,133022,133025,0,3,3
38087,1,2,133023,133025,133027,2,4,0
38088,1,1,133024,133027,133028,3,4,0
38089,1,3,133025,133028,133031,3,6,0
38090,1,1,133026,133031,133032,5,6,0
38091,4,1,133030,133032,133033,2,3,0
38092,5,1,133035,133035,133036,0,1,2
38093,5,2,133040,133040,133042,0,2,4
38094,5,2,133045,133045,133047,0,2,3
38095,4,3,133049,133049,133052,0,3,2
38096,4,3,133053,133053,133056,0,3,1
38097,6,3,133059,133059,133062,0,3,3
38098,6,3,133065,133065,133068,0,3,3
38099,5,3,133070,133070,133073,0,3,2
38100,5,1,133075,133075,133076,0,1,2
38101,4,3,133079,133079,133082,0,3,3
38102,3,1,133082,133082,133083,0,1,0
38103,4,2,133086,133086,133088,0,2,3
38104,3,1,133089,133089,133090,0,1,1
38105,6,2,133095,133095,133097,0,2,5
38106,1,2,133096,133097,133099,1,3,0
38107,1,1,133097,133099,133100,2,3,0
38108,6,2,133103,133103,133105,0,2,3
38109,4,1,133107,133107,133108,0,1,2
38110,4,2,133111,133111,133113,0,2,3
38111,5,1,133116,133116,133117,0,1,3
38112,2,3,133118,133118,133121,0,3,1
38113,2,1,133120,133121,133122,1,2,0
38114,6,3,133126,133126,133129,0,3,4
38115,5,2,133131,133131,133133,0,2,2
38116,6,2,133137,133137,133139,0,2,4
38117,4,2,133141,133141,133143,0,2,2
38118,2,2,133143,133143,133145,0,2,0
38119,1,2,133144,133145,133147,1,3,0
38120,6,1,133150,133150,133151,0,1,3
38121,5,1,133155,133155,133156,0,1,4
38122,3,2,133158,133158,133160,0,2,2
38123,2,3,133160,133160,133163,0,3,0
38124,3,1,133163,133163,133164,0,1,0
38125,2,1,133165,133165,133166,0,1,1
38126,3,1,133168,133168,133169,0,1,2
38127,6,1,133174,133174,133175,0,1,5
38128,5,2,133179,133179,133181,0,2,4
38129,6,3,133185,133185,133188,0,3,4
38130,6,3,133191,133191,133194,0,3,3
38131,4,1,133195,133195,133196,0,1,1
38132,1,3,133196,133196,133199,0,3,0
38133,6,3,133202,133202,133205,0,3,3
38134,4,1,133206,133206,133207,0,1,1
38135,4,1,133210,133210,133211,0,1,3
38136,5,2,133215,133215,133217,0,2,4
38137,1,3,133216,133217,133220,1,4,0
38138,5,1,133221,133221,133222,0,1,1
38139,1,2,133222,133222,133224,0,2,0
38140,2,3,133224,133224,133227,0,3,0
38141,1,2,133225,133227,133229,2,4,0
38142,2,2,133227,133229,133231,2,4,0
38143,5,1,133232,133232,133233,0,1,1
38144,1,3,133233,133233,133236,0,3,0
38145,5,3,133238,133238,133241,0,3,2
38146,3,1,133241,133241,133242,0,1,0
38147,5,1,133246,133246,133247,0,1,4
38148,3,3,133249,133249,133252,0,3,2
38149,3,1,133252,133252,133253,0,1,0
38150,5,3,133257,133257,133260,0,3,4
38151,4,3,133261,133261,133264,0,3,1
38152,1,3,133262,133264,133267,2,5,0
38153,4,3,133266,133267,133270,1,4,0
38154,4,1,133270,133270,133271,0,1,0
38155,2,3,133272,133272,133275,0,3,1
38156,2,3,133274,133275,133278,1,4,0
38157,5,3,133279,133279,133282,0,3,1
38158,5,1,133284,133284,133285,0,1,2
38159,6,2,133290,133290,133292,0,2,5
38160,1,1,133291,133292,133293,1,2,0
38161,6,1,133297,133297,133298,0,1,4
38162,6,3,133303,133303,133306,0,3,5
38163,5,2,133308,133308,133310,0,2,2
38164,3,1,133311,133311,133312,0,1,1
38165,4,2,133315,133315,133317,0,2,3
38166,1,3,133316,133317,133320,1,4,0
38167,5,1,133321,133321,133322,0,1,1
38168,3,3,133324,133324,133327,0,3,2
38169,6,3,133330,133330,133333,0,3,3
38170,4,3,133334,133334,133337,0,3,1
38171,4,1,133338,133338,133339,0,1,1
38172,1,3,133339,133339,133342,0,3,0
38173,5,1,133344,133344,133345,0,1,2
38174,2,1,133346,133346,133347,0,1,1
38175,6,2,133352,133352,133354,0,2,5
38176,2,2,133354,133354,133356,0,2,0
38177,4,2,133358,133358,133360,0,2,2
38178,3,1,133361,133361,133362,0,1,1
38179,2,3,133363,133363,133366,0,3,1
38180,2,1,133365,133366,133367,1,2,0
38181,1,3,133366,133367,133370,1,4,0
38182,3,1,133369,133370,133371,1,2,0
38183,2,3,133371,133371,133374,0,3,0
38184,4,2,133375,133375,133377,0,2,1
38185,2,3,133377,133377,133380,0,3,0
38186,6,2,133383,133383,133385,0,2,3
38187,1,3,133384,133385,133388,1,4,0
38188,1,3,133385,133388,133391,3,6,0
38189,4,2,133389,133391,133393,2,4,0
38190,4,3,133393,133393,133396,0,3,0
38191,3,1,133396,133396,133397,0,1,0
38192,2,1,133398,133398,133399,0,1,1
38193,3,2,133401,133401,133403,0,2,2
38194,5,2,133406,133406,133408,0,2,3
38195,3,1,133409,133409,133410,0,1,1
38196,2,1,133411,133411,133412,0,1,1
38197,1,2,133412,133412,133414,0,2,0
38198,5,1,133417,133417,133418,0,1,3
38199,2,2,133419,133419,133421,0,2,1
38200,5,1,133424,133424,133425,0,1,3
38201,1,2,133425,133425,133427,0,2,0
38202,6,2,133431,133431,133433,0,2,4
38203,3,2,133434,133434,133436,0,2,1
38204,3,1,133437,133437,133438,0,1,1
38205,2,3,133439,133439,133442,0,3,1
38206,6,2,133445,133445,133447,0,2,3
38207,1,3,133446,133447,133450,1,4,0
38208,2,3,133448,133450,133453,2,5,0
38209,4,2,133452,133453,133455,1,3,0
38210,3,1,133455,133455,133456,0,1,0
38211,5,1,133460,133460,133461,0,1,4
38212,3,3,133463,133463,133466,0,3,2
38213,4,2,133467,133467,133469,0,2,1
38214,6,3,133473,133473,133476,0,3,4
38215,1,1,133474,133476,133477,2,3,0
38216,3,1,133477,133477,133478,0,1,0
38217,2,2,133479,133479,133481,0,2,1
38218,2,1,133481,133481,133482,0,1,0
38219,4,1,133485,133485,133486,0,1,3
38220,1,2,133486,133486,133488,0,2,0
38221,1,2,133487,133488,133490,1,3,0
38222,3,2,133490,133490,133492,0,2,0
38223,3,3,133493,133493,133496,0,3,1
38224,4,1,133497,133497,133498,0,1,1
38225,6,3,133503,133503,133506,0,3,5
38226,5,2,133508,133508,133510,0,2,2
38227,1,2,133509,133510,133512,1,3,0
38228,2,2,133511,133512,133514,1,3,0
38229,5,3,133516,133516,133519,0,3,2
38230,5,1,133521,133521,133522,0,1,2
38231,6,1,133527,133527,133528,0,1,5
38232,3,1,133530,133530,133531,0,1,2
38233,3,1,133533,133533,133534,0,1,2
38234,1,2,133534,133534,133536,0,2,0
38235,3,3,133537,133537,133540,0,3,1
38236,2,3,133539,133540,133543,1,4,0
38237,3,2,133542,133543,133545,1,3,0
38238,6,3,133548,133548,133551,0,3,3
38239,6,3,133554,133554,133557,0,3,3
38240,1,2,133555,133557,133559,2,4,0
38241,6,2,133561,133561,133563,0,2,2
38242,4,1,133565,133565,133566,0,1,2
38243,2,3,133567,133567,133570,0,3,1
38244,3,3,133570,133570,133573,0,3,0
38245,5,1,133575,133575,133576,0,1,2
38246,2,2,133577,133577,133579,0,2,1
38247,5,3,133582,133582,133585,0,3,3
38248,2,3,133584,133585,133588,1,4,0
38249,3,3,133587,133588,133591,1,4,0
38250,6,3,133593,133593,133596,0,3,2
38251,2,3,133595,133596,133599,1,4,0
38252,6,1,133601,133601,133602,0,1,2
38253,4,2,133605,133605,133607,0,2,3
38254,5,3,133610,133610,133613,0,3,3
38255,2,2,133612,133613,133615,1,3,0
38256,6,2,133618,133618,133620,0,2,3
38257,5,2,133623,133623,133625,0,2,3
38258,5,3,133628,133628,133631,0,3,3
38259,3,2,133631,133631,133633,0,2,0
38260,4,2,133635,133635,133637,0,2,2
38261,4,1,133639,133639,133640,0,1,2
38262,3,3,133642,133642,133645,0,3,2
38263,1,1,133643,133645,133646,2,3,0
38264,1,3,133644,133646,133649,2,5,0
38265,5,2,133649,133649,133651,0,2,0
38266,4,1,133653,133653,133654,0,1,2
38267,1,3,133654,133654,133657,0,3,0
38268,1,2,133655,133657,133659,2,4,0
38269,2,3,133657,133659,133662,2,5,0
38270,6,1,133663,133663,133664,0,1,1
38271,1,3,133664,133664,133667,0,3,0
38272,2,2,133666,133667,133669,1,3,0
38273,1,1,133667,133669,133670,2,3,0
38274,3,2,133670,133670,133672,0,2,0
38275,4,1,133674,133674,133675,0,1,2
38276,5,2,133679,133679,133681,0,2,4
38277,6,3,133685,133685,133688,0,3,4
38278,1,1,133686,133688,133689,2,3,0
38279,6,2,133692,133692,133694,0,2,3
38280,4,3,133696,133696,133699,0,3,2
38281,2,3,133698,133699,133702,1,4,0
38282,5,1,133703,133703,133704,0,1,1
38283,5,3,133708,133708,133711,0,3,4
38284,3,1,133711,133711,133712,0,1,0
38285,3,2,133714,133714,133716,0,2,2
38286,6,3,133720,133720,133723,0,3,4
38287,2,3,133722,133723,133726,1,4,0
38288,2,3,133724,133726,133729,2,5,0
38289,1,1,133725,133729,133730,4,5,0
38290,2,3,133727,133730,133733,3,6,0
38291,4,3,133731,133733,133736,2,5,0
38292,4,1,133735,133736,133737,1,2,0
38293,2,2,133737,133737,133739,0,2,0
38294,2,3,133739,133739,133742,0,3,0
38295,4,2,133743,133743,133745,0,2,1
38296,4,3,133747,133747,133750,0,3,2
38297,2,1,133749,133750,133751,1,2,0
38298,4,2,133753,133753,133755,0,2,2
38299,4,3,133757,133757,133760,0,3,2
38300,6,3,133763,133763,133766,0,3,3
38301,3,1,133766,133766,133767,0,1,0
38302,5,2,133771,133771,133773,0,2,4
38303,1,3,133772,133773,133776,1,4,0
38304,6,3,133778,133778,133781,0,3,2
38305,4,2,133782,133782,133784,0,2,1
38306,1,1,133783,133784,133785,1,2,0
38307,6,3,133789,133789,133792,0,3,4
38308,3,2,133792,133792,133794,0,2,0
38309,2,2,133794,133794,133796,0,2,0
38310,5,1,133799,133799,133800,0,1,3
38311,1,1,133800,133800,133801,0,1,0
38312,2,3,133802,133802,133805,0,3,1
38313,3,1,133805,133805,133806,0,1,0
38314,4,1,133809,133809,133810,0,1,3
38315,2,2,133811,133811,133813,0,2,1
38316,5,2,133816,133816,133818,0,2,3
38317,3,1,133819,133819,133820,0,1,1
38318,3,2,133822,133822,133824,0,2,2
38319,5,3,133827,133827,133830,0,3,3
38320,6,1,133833,133833,133834,0,1,3
38321,1,2,133834,133834,133836,0,2,0
38322,1,1,133835,133836,133837,1,2,0
38323,4,2,133839,133839,133841,0,2,2
38324,1,2,133840,133841,133843,1,3,0
38325,4,1,133844,133844,133845,0,1,1
38326,2,2,133846,133846,133848,0,2,1
38327,1,2,133847,133848,133850,1,3,0
38328,1,3,133848,133850,133853,2,5,0
38329,3,1,133851,133853,133854,2,3,0
38330,3,2,133854,133854,133856,0,2,0
38331,2,2,133856,133856,133858,0,2,0
38332,4,2,133860,133860,133862,0,2,2
38333,3,2,133863,133863,133865,0,2,1
38334,5,3,133868,133868,133871,0,3,3
38335,5,1,133873,133873,133874,0,1,2
38336,4,1,133877,133877,133878,0,1,3
38337,1,1,133878,133878,133879,0,1,0
38338,5,1,133883,133883,133884,0,1,4
38339,2,3,133885,133885,133888,0,3,1
38340,5,2,133890,133890,133892,0,2,2
38341,5,2,133895,133895,133897,0,2,3
38342,2,2,133897,133897,133899,0,2,0
38343,1,3,133898,133899,133902,1,4,0
38344,2,1,133900,133902,133903,2,3,0
38345,3,1,133903,133903,133904,0,1,0
38346,2,3,133905,133905,133908,0,3,1
38347,3,1,133908,133908,133909,0,1,0
38348,4,2,133912,133912,133914,0,2,3
38349,4,2,133916,133916,133918,0,2,2
38350,3,1,133919,133919,133920,0,1,1
38351,5,2,133924,133924,133926,0,2,4
38352,4,2,133928,133928,133930,0,2,2
38353,3,2,133931,133931,133933,0,2,1
38354,2,3,133933,133933,133936,0,3,0
38355,6,2,133939,133939,133941,0,2,3
38356,6,2,133945,133945,133947,0,2,4
38357,6,3,133951,133951,133954,0,3,4
38358,6,1,133957,133957,133958,0,1,3
38359,5,2,133962,133962,133964,0,2,4
38360,5,2,133967,133967,133969,0,2,3
38361,4,2,133971,133971,133973,0,2,2
38362,4,3,133975,133975,133978,0,3,2
38363,5,1,133980,133980,133981,0,1,2
38364,3,3,133983,133983,133986,0,3,2
38365,1,2,133984,133986,133988,2,4,0
38366,3,3,133987,133988,133991,1,4,0
38367,3,1,133990,133991,133992,1,2,0
38368,5,1,133995,133995,133996,0,1,3
38369,3,1,133998,133998,133999,0,1,2
38370,5,2,134003,134003,134005,0,2,4
38371,4,3,134007,134007,134010,0,3,2
38372,5,1,134012,134012,134013,0,1,2
38373,2,2,134014,134014,134016,0,2,1
38374,3,2,134017,134017,134019,0,2,1
38375,3,1,134020,134020,134021,0,1,1
38376,1,1,134021,134021,134022,0,1,0
38377,1,2,134022,134022,134024,0,2,0
38378,6,3,134028,134028,134031,0,3,4
38379,1,2,134029,134031,134033,2,4,0
38380,4,1,134033,134033,134034,0,1,0
38381,5,1,134038,134038,134039,0,1,4
38382,1,2,134039,134039,134041,0,2,0
38383,5,2,134044,134044,134046,0,2,3
38384,2,1,134046,134046,134047,0,1,0
38385,3,3,134049,134049,134052,0,3,2
38386,3,1,134052,134052,134053,0,1,0
38387,6,3,134058,134058,134061,0,3,5
38388,4,3,134062,134062,134065,0,3,1
38389,2,1,134064,134065,134066,1,2,0
38390,2,3,134066,134066,134069,0,3,0
38391,1,1,134067,134069,134070,2,3,0
38392,1,1,134068,134070,134071,2,3,0
38393,2,3,134070,134071,134074,1,4,0
38394,2,2,134072,134074,134076,2,4,0
38395,5,2,134077,134077,134079,0,2,1
38396,4,2,134081,134081,134083,0,2,2
38397,6,3,134087,134087,134090,0,3,4
38398,3,2,134090,134090,134092,0,2,0
38399,3,1,134093,134093,134094,0,1,1
38400,2,1,134095,134095,134096,0,1,1
38401,6,2,134101,134101,134103,0,2,5
38402,1,3,134102,134103,134106,1,4,0
38403,1,2,134103,134106,134108,3,5,0
38404,1,2,134104,134108,134110,4,6,0
38405,4,1,134108,134110,134111,2,3,0
38406,2,3,134110,134111,134114,1,4,0
38407,3,2,134113,134114,134116,1,3,0
38408,5,2,134118,134118,134120,0,2,2
38409,5,3,134123,134123,134126,0,3,3
38410,4,3,134127,134127,134130,0,3,1
38411,3,1,134130,134130,134131,0,1,0
38412,1,2,134131,134131,134133,0,2,0
38413,6,1,134137,134137,134138,0,1,4
38414,4,2,134141,134141,134143,0,2,3
38415,4,1,134145,134145,134146,0,1,2
38416,5,1,134150,134150,134151,0,1,4
38417,3,3,134153,134153,134156,0,3,2
38418,6,3,134159,134159,134162,0,3,3
38419,1,3,134160,134162,134165,2,5,0
38420,3,3,134163,134165,134168,2,5,0
38421,4,3,134167,134168,134171,1,4,0
38422,2,3,134169,134171,134174,2,5,0
38423,1,2,134170,134174,134176,4,6,0
38424,3,2,134173,134176,134178,3,5,0
38425,1,3,134174,134178,134181,4,7,0
38426,1,1,134175,134181,134182,6,7,0
38427,6,3,134181,134182,134185,1,4,0
38428,1,1,134182,134185,134186,3,4,0
38429,6,2,134188,134188,134190,0,2,2
38430,3,2,134191,134191,134193,0,2,1
38431,6,2,134197,134197,134199,0,2,4
38432,5,3,134202,134202,134205,0,3,3
38433,1,2,134203,134205,134207,2,4,0
38434,2,1,134205,134207,134208,2,3,0
38435,2,3,134207,134208,134211,1,4,0
38436,5,1,134212,134212,134213,0,1,1
38437,6,1,134218,134218,134219,0,1,5
38438,6,3,134224,134224,134227,0,3,5
38439,5,3,134229,134229,134232,0,3,2
38440,2,3,134231,134232,134235,1,4,0
38441,3,2,134234,134235,134237,1,3,0
38442,4,3,134238,134238,134241,0,3,1
38443,1,3,134239,134241,134244,2,5,0
38444,2,3,134241,134244,134247,3,6,0
38445,1,1,134242,134247,134248,5,6,0
38446,5,2,134247,134248,134250,1,3,0
38447,6,2,134253,134253,134255,0,2,3
38448,3,2,134256,134256,134258,0,2,1
38449,5,1,134261,134261,134262,0,1,3
38450,6,3,134267,134267,134270,0,3,5
38451,1,3,134268,134270,134273,2,5,0
38452,6,3,134274,134274,134277,0,3,1
38453,3,1,134277,134277,134278,0,1,0
38454,4,2,134281,134281,134283,0,2,3
38455,5,3,134286,134286,134289,0,3,3
38456,4,2,134290,134290,134292,0,2,1
38457,5,1,134295,134295,134296,0,1,3
38458,3,3,134298,134298,134301,0,3,2
38459,3,3,134301,134301,134304,0,3,0
38460,5,2,134306,134306,134308,0,2,2
38461,5,1,134311,134311,134312,0,1,3
38462,2,3,134313,134313,134316,0,3,1
38463,1,1,134314,134316,134317,2,3,0
38464,5,3,134319,134319,134322,0,3,2
38465,5,3,134324,134324,134327,0,3,2
38466,4,2,134328,134328,134330,0,2,1
38467,4,2,134332,134332,134334,0,2,2
38468,4,3,134336,134336,134339,0,3,2
38469,6,1,134342,134342,134343,0,1,3
38470,4,3,134346,134346,134349,0,3,3
38471,1,2,134347,134349,134351,2,4,0
38472,4,3,134351,134351,134354,0,3,0
38473,1,3,134352,134354,134357,2,5,0
38474,5,1,134357,134357,134358,0,1,0
38475,3,3,134360,134360,134363,0,3,2
38476,5,1,134365,134365,134366,0,1,2
38477,3,3,134368,134368,134371,0,3,2
38478,1,2,134369,134371,134373,2,4,0
38479,3,3,134372,134373,134376,1,4,0
38480,2,1,134374,134376,134377,2,3,0
38481,2,1,134376,134377,134378,1,2,0
38482,5,3,134381,134381,134384,0,3,3
38483,4,1,134385,134385,134386,0,1,1
38484,1,3,134386,134386,134389,0,3,0
38485,4,2,134390,134390,134392,0,2,1
38486,6,1,134396,134396,134397,0,1,4
38487,3,1,134399,134399,134400,0,1,2
38488,3,1,134402,134402,134403,0,1,2
38489,2,1,134404,134404,134405,0,1,1
38490,5,1,134409,134409,134410,0,1,4
38491,2,3,134411,134411,134414,0,3,1
38492,1,1,134412,134414,134415,2,3,0
38493,2,2,134414,134415,134417,1,3,0
38494,6,2,134420,134420,134422,0,2,3
38495,2,3,134422,134422,134425,0,3,0
38496,1,1,134423,134425,134426,2,3,0
38497,3,1,134426,134426,134427,0,1,0
38498,3,2,134429,134429,134431,0,2,2
38499,6,3,134435,134435,134438,0,3,4
38500,1,1,134436,134438,134439,2,3,0
38501,5,3,134441,134441,134444,0,3,2
38502,2,2,134443,134444,134446,1,3,0
38503,4,1,134447,134447,134448,0,1,1
38504,6,1,134453,134453,134454,0,1,5
38505,1,3,134454,134454,134457,0,3,0
38506,3,3,134457,134457,134460,0,3,0
38507,6,3,134463,134463,134466,0,3,3
38508,2,3,134465,134466,134469,1,4,0
38509,6,3,134471,134471,134474,0,3,2
38510,3,2,134474,134474,134476,0,2,0
38511,1,1,134475,134476,134477,1,2,0
38512,5,3,134480,134480,134483,0,3,3
38513,6,3,134486,134486,134489,0,3,3
38514,3,2,134489,134489,134491,0,2,0
38515,2,3,134491,134491,134494,0,3,0
38516,3,3,134494,134494,134497,0,3,0
38517,5,2,134499,134499,134501,0,2,2
38518,4,1,134503,134503,134504,0,1,2
38519,3,2,134506,134506,134508,0,2,2
38520,1,1,134507,134508,134509,1,2,0
38521,4,3,134511,134511,134514,0,3,2
38522,2,2,134513,134514,134516,1,3,0
38523,3,3,134516,134516,134519,0,3,0
38524,6,2,134522,134522,134524,0,2,3
38525,5,3,134527,134527,134530,0,3,3
38526,6,1,134533,134533,134534,0,1,3
38527,1,2,134534,134534,134536,0,2,0
38528,1,3,134535,134536,134539,1,4,0
38529,3,2,134538,134539,134541,1,3,0
38530,2,3,134540,134541,134544,1,4,0
38531,5,1,134545,134545,134546,0,1,1
38532,5,3,134550,134550,134553,0,3,4
38533,5,1,134555,134555,134556,0,1,2
38534,3,3,134558,134558,134561,0,3,2
38535,2,1,134560,134561,134562,1,2,0
38536,1,1,134561,134562,134563,1,2,0
38537,4,3,134565,134565,134568,0,3,2
38538,4,3,134569,134569,134572,0,3,1
38539,5,1,134574,134574,134575,0,1,2
38540,6,1,134580,134580,134581,0,1,5
38541,6,3,134586,134586,134589,0,3,5
38542,6,3,134592,134592,134595,0,3,3
38543,2,2,134594,134595,134597,1,3,0
38544,5,3,134599,134599,134602,0,3,2
38545,6,1,134605,134605,134606,0,1,3
38546,5,3,134610,134610,134613,0,3,4
38547,5,3,134615,134615,134618,0,3,2
38548,3,2,134618,134618,134620,0,2,0
38549,4,3,134622,134622,134625,0,3,2
38550,5,3,134627,134627,134630,0,3,2
38551,5,3,134632,134632,134635,0,3,2
38552,4,1,134636,134636,134637,0,1,1
38553,5,1,134641,134641,134642,0,1,4
38554,5,3,134646,134646,134649,0,3,4
38555,6,1,134652,134652,134653,0,1,3
38556,6,1,134658,134658,134659,0,1,5
38557,3,3,134661,134661,134664,0,3,2
38558,3,3,134664,134664,134667,0,3,0
38559,5,3,134669,134669,134672,0,3,2
38560,2,3,134671,134672,134675,1,4,0
38561,3,1,134674,134675,134676,1,2,0
38562,5,1,134679,134679,134680,0,1,3
38563,6,3,134685,134685,134688,0,3,5
38564,2,2,134687,134688,134690,1,3,0
38565,2,1,134689,134690,134691,1,2,0
38566,4,2,134693,134693,134695,0,2,2
38567,2,3,134695,134695,134698,0,3,0
38568,3,3,134698,134698,134701,0,3,0
38569,2,1,134700,134701,134702,1,2,0
38570,5,2,134705,134705,134707,0,2,3
38571,1,3,134706,134707,134710,1,4,0
38572,6,3,134712,134712,134715,0,3,2
38573,2,2,134714,134715,134717,1,3,0
38574,3,3,134717,134717,134720,0,3,0
38575,2,2,134719,134720,134722,1,3,0
38576,2,1,134721,134722,134723,1,2,0
38577,6,1,134727,134727,134728,0,1,4
38578,5,3,134732,134732,134735,0,3,4
38579,1,1,134733,134735,134736,2,3,0
38580,4,1,134737,134737,134738,0,1,1
38581,1,3,134738,134738,134741,0,3,0
38582,2,2,134740,134741,134743,1,3,0
38583,4,2,134744,134744,134746,0,2,1
38584,1,2,134745,134746,134748,1,3,0
38585,5,2,134750,134750,134752,0,2,2
38586,3,1,134753,134753,134754,0,1,1
38587,5,2,134758,134758,134760,0,2,4
38588,5,3,134763,134763,134766,0,3,3
38589,3,3,134766,134766,134769,0,3,0
38590,3,1,134769,134769,134770,0,1,0
38591,4,3,134773,134773,134776,0,3,3
38592,1,2,134774,134776,134778,2,4,0
38593,2,2,134776,134778,134780,2,4,0
38594,4,3,134780,134780,134783,0,3,0
38595,2,3,134782,134783,134786,1,4,0
38596,4,3,134786,134786,134789,0,3,0
38597,1,2,134787,134789,134791,2,4,0
38598,5,1,134792,134792,134793,0,1,1
38599,2,1,134794,134794,134795,0,1,1
38600,5,2,134799,134799,134801,0,2,4
38601,4,2,134803,134803,134805,0,2,2
38602,2,3,134805,134805,134808,0,3,0
38603,4,1,134809,134809,134810,0,1,1
38604,2,3,134811,134811,134814,0,3,1
38605,4,1,134815,134815,134816,0,1,1
38606,4,1,134819,134819,134820,0,1,3
38607,4,2,134823,134823,134825,0,2,3
38608,1,1,134824,134825,134826,1,2,0
38609,5,3,134829,134829,134832,0,3,3
38610,4,3,134833,134833,134836,0,3,1
38611,3,1,134836,134836,134837,0,1,0
38612,4,1,134840,134840,134841,0,1,3
38613,4,2,134844,134844,134846,0,2,3
38614,6,2,134850,134850,134852,0,2,4
38615,2,2,134852,134852,134854,0,2,0
38616,1,1,134853,134854,134855,1,2,0
38617,6,2,134859,134859,134861,0,2,4
38618,2,3,134861,134861,134864,0,3,0
38619,2,3,134863,134864,134867,1,4,0
38620,6,3,134869,134869,134872,0,3,2
38621,1,3,134870,134872,134875,2,5,0
38622,4,2,134874,134875,134877,1,3,0
38623,2,1,134876,134877,134878,1,2,0
38624,6,3,134882,134882,134885,0,3,4
38625,4,3,134886,134886,134889,0,3,1
38626,3,3,134889,134889,134892,0,3,0
38627,3,3,134892,134892,134895,0,3,0
38628,1,1,134893,134895,134896,2,3,0
38629,1,1,134894,134896,134897,2,3,0
38630,4,3,134898,134898,134901,0,3,1
38631,4,2,134902,134902,134904,0,2,1
38632,2,1,134904,134904,134905,0,1,0
38633,2,2,134906,134906,134908,0,2,1
38634,4,2,134910,134910,134912,0,2,2
38635,4,2,134914,134914,134916,0,2,2
38636,3,3,134917,134917,134920,0,3,1
38637,1,1,134918,134920,134921,2,3,0
38638,3,1,134921,134921,134922,0,1,0
38639,3,2,134924,134924,134926,0,2,2
38640,3,1,134927,134927,134928,0,1,1
38641,3,1,134930,134930,134931,0,1,2
38642,4,3,134934,134934,134937,0,3,3
38643,2,2,134936,134937,134939,1,3,0
38644,3,3,134939,134939,134942,0,3,0
38645,5,3,134944,134944,134947,0,3,2
38646,4,3,134948,134948,134951,0,3,1
38647,2,1,134950,134951,134952,1,2,0
38648,1,1,134951,134952,134953,1,2,0
38649,1,3,134952,134953,134956,1,4,0
38650,4,1,134956,134956,134957,0,1,0
38651,6,2,134962,134962,134964,0,2,5
38652,6,1,134968,134968,134969,0,1,4
38653,2,2,134970,134970,134972,0,2,1
38654,1,2,134971,134972,134974,1,3,0
38655,1,2,134972,134974,134976,2,4,0
38656,1,3,134973,134976,134979,3,6,0
38657,2,2,134975,134979,134981,4,6,0
38658,2,3,134977,134981,134984,4,7,0
38659,4,1,134981,134984,134985,3,4,0
38660,4,3,134985,134985,134988,0,3,0
38661,4,1,134989,134989,134990,0,1,1
38662,6,3,134995,134995,134998,0,3,5
38663,4,3,134999,134999,135002,0,3,1
38664,2,2,135001,135002,135004,1,3,0
38665,3,3,135004,135004,135007,0,3,0
38666,4,1,135008,135008,135009,0,1,1
38667,2,2,135010,135010,135012,0,2,1
38668,1,2,135011,135012,135014,1,3,0
38669,3,3,135014,135014,135017,0,3,0
38670,2,2,135016,135017,135019,1,3,0
38671,1,1,135017,135019,135020,2,3,0
38672,6,3,135023,135023,135026,0,3,3
38673,3,2,135026,135026,135028,0,2,0
38674,6,2,135032,135032,135034,0,2,4
38675,4,1,135036,135036,135037,0,1,2
38676,5,1,135041,135041,135042,0,1,4
38677,5,1,135046,135046,135047,0,1,4
38678,1,3,135047,135047,135050,0,3,0
38679,2,3,135049,135050,135053,1,4,0
38680,3,2,135052,135053,135055,1,3,0
38681,1,3,135053,135055,135058,2,5,0
38682,1,2,135054,135058,135060,4,6,0
38683,1,3,135055,135060,135063,5,8,0
38684,6,1,135061,135063,135064,2,3,0
38685,6,1,135067,135067,135068,0,1,3
38686,5,2,135072,135072,135074,0,2,4
38687,4,1,135076,135076,135077,0,1,2
38688,4,2,135080,135080,135082,0,2,3
38689,5,2,135085,135085,135087,0,2,3
38690,3,2,135088,135088,135090,0,2,1
38691,6,3,135094,135094,135097,0,3,4
38692,5,2,135099,135099,135101,0,2,2
38693,6,1,135105,135105,135106,0,1,4
38694,6,2,135111,135111,135113,0,2,5
38695,2,2,135113,135113,135115,0,2,0
38696,6,1,135119,135119,135120,0,1,4
38697,3,3,135122,135122,135125,0,3,2
38698,2,3,135124,135125,135128,1,4,0
38699,1,1,135125,135128,135129,3,4,0
38700,4,3,135129,135129,135132,0,3,0
38701,4,1,135133,135133,135134,0,1,1
38702,6,2,135139,135139,135141,0,2,5
38703,2,2,135141,135141,135143,0,2,0
38704,4,1,135145,135145,135146,0,1,2
38705,3,1,135148,135148,135149,0,1,2
38706,3,3,135151,135151,135154,0,3,2
38707,6,2,135157,135157,135159,0,2,3
38708,1,3,135158,135159,135162,1,4,0
38709,3,2,135161,135162,135164,1,3,0
38710,6,1,135167,135167,135168,0,1,3
38711,3,2,135170,135170,135172,0,2,2
38712,4,3,135174,135174,135177,0,3,2
38713,4,1,135178,135178,135179,0,1,1
38714,4,3,135182,135182,135185,0,3,3
38715,6,3,135188,135188,135191,0,3,3
38716,3,1,135191,135191,135192,0,1,0
38717,4,3,135195,135195,135198,0,3,3
38718,6,2,135201,135201,135203,0,2,3
38719,1,1,135202,135203,135204,1,2,0
38720,5,1,135207,135207,135208,0,1,3
38721,3,1,135210,135210,135211,0,1,2
38722,5,2,135215,135215,135217,0,2,4
38723,1,3,135216,135217,135220,1,4,0
38724,5,2,135221,135221,135223,0,2,1
38725,6,1,135227,135227,135228,0,1,4
38726,6,2,135233,135233,135235,0,2,5
38727,3,2,135236,135236,135238,0,2,1
38728,1,2,135237,135238,135240,1,3,0
38729,6,1,135243,135243,135244,0,1,3
38730,4,2,135247,135247,135249,0,2,3
38731,2,3,135249,135249,135252,0,3,0
38732,2,1,135251,135252,135253,1,2,0
38733,5,3,135256,135256,135259,0,3,3
38734,4,2,135260,135260,135262,0,2,1
38735,4,1,135264,135264,135265,0,1,2
38736,4,1,135268,135268,135269,0,1,3
38737,2,2,135270,135270,135272,0,2,1
38738,3,3,135273,135273,135276,0,3,1
38739,5,2,135278,135278,135280,0,2,2
38740,4,1,135282,135282,135283,0,1,2
38741,3,3,135285,135285,135288,0,3,2
38742,2,1,135287,135288,135289,1,2,0
38743,1,3,135288,135289,135292,1,4,0
38744,1,2,135289,135292,135294,3,5,0
38745,1,2,135290,135294,135296,4,6,0
38746,2,3,135292,135296,135299,4,7,0
38747,5,3,135297,135299,135302,2,5,0
38748,2,3,135299,135302,135305,3,6,0
38749,1,2,135300,135305,135307,5,7,0
38750,3,1,135303,135307,135308,4,5,0
38751,6,1,135309,135309,135310,0,1,1
38752,1,2,135310,135310,135312,0,2,0
38753,3,1,135313,135313,135314,0,1,1
38754,3,2,135316,135316,135318,0,2,2
38755,6,1,135322,135322,135323,0,1,4
38756,4,1,135326,135326,135327,0,1,3
38757,3,2,135329,135329,135331,0,2,2
38758,4,3,135333,135333,135336,0,3,2
38759,6,2,135339,135339,135341,0,2,3
38760,4,2,135343,135343,135345,0,2,2
38761,5,2,135348,135348,135350,0,2,3
38762,1,1,135349,135350,135351,1,2,0
38763,2,2,135351,135351,135353,0,2,0
38764,5,1,135356,135356,135357,0,1,3
38765,4,1,135360,135360,135361,0,1,3
38766,1,2,135361,135361,135363,0,2,0
38767,6,2,135367,135367,135369,0,2,4
38768,3,2,135370,135370,135372,0,2,1
38769,5,3,135375,135375,135378,0,3,3
38770,2,2,135377,135378,135380,1,3,0
38771,1,2,135378,135380,135382,2,4,0
38772,2,3,135380,135382,135385,2,5,0
38773,6,3,135386,135386,135389,0,3,1
38774,2,3,135388,135389,135392,1,4,0
38775,6,3,135394,135394,135397,0,3,2
38776,2,3,135396,135397,135400,1,4,0
38777,3,2,135399,135400,135402,1,3,0
38778,6,3,135405,135405,135408,0,3,3
38779,2,1,135407,135408,135409,1,2,0
38780,4,1,135411,135411,135412,0,1,2
38781,2,3,135413,135413,135416,0,3,1
38782,6,3,135419,135419,135422,0,3,3
38783,4,2,135423,135423,135425,0,2,1
38784,2,1,135425,135425,135426,0,1,0
38785,2,2,135427,135427,135429,0,2,1
38786,5,3,135432,135432,135435,0,3,3
38787,4,3,135436,135436,135439,0,3,1
38788,1,3,135437,135439,135442,2,5,0
38789,3,1,135440,135442,135443,2,3,0
38790,2,2,135442,135443,135445,1,3,0
38791,1,3,135443,135445,135448,2,5,0
38792,2,3,135445,135448,135451,3,6,0
38793,6,3,135451,135451,135454,0,3,0
38794,6,2,135457,135457,135459,0,2,3
38795,4,2,135461,135461,135463,0,2,2
38796,4,1,135465,135465,135466,0,1,2
38797,6,1,135471,135471,135472,0,1,5
38798,6,3,135477,135477,135480,0,3,5
38799,3,3,135480,135480,135483,0,3,0
38800,3,2,135483,135483,135485,0,2,0
38801,1,2,135484,135485,135487,1,3,0
38802,5,1,135489,135489,135490,0,1,2
38803,6,2,135495,135495,135497,0,2,5
38804,5,2,135500,135500,135502,0,2,3
38805,3,3,135503,135503,135506,0,3,1
38806,5,3,135508,135508,135511,0,3,2
38807,6,3,135514,135514,135517,0,3,3
38808,6,1,135520,135520,135521,0,1,3
38809,3,2,135523,135523,135525,0,2,2
38810,2,3,135525,135525,135528,0,3,0
38811,3,3,135528,135528,135531,0,3,0
38812,4,3,135532,135532,135535,0,3,1
38813,5,2,135537,135537,135539,0,2,2
38814,6,2,135543,135543,135545,0,2,4
38815,1,1,135544,135545,135546,1,2,0
38816,5,2,135549,135549,135551,0,2,3
38817,3,3,135552,135552,135555,0,3,1
38818,4,2,135556,135556,135558,0,2,1
38819,3,1,135559,135559,135560,0,1,1
38820,4,2,135563,135563,135565,0,2,3
38821,3,2,135566,135566,135568,0,2,1
38822,3,3,135569,135569,135572,0,3,1
38823,1,1,135570,135572,135573,2,3,0
38824,4,2,135574,135574,135576,0,2,1
38825,5,1,135579,135579,135580,0,1,3
38826,1,3,135580,135580,135583,0,3,0
38827,1,1,135581,135583,135584,2,3,0
38828,5,2,135586,135586,135588,0,2,2
38829,5,3,135591,135591,135594,0,3,3
38830,2,2,135593,135594,135596,1,3,0
38831,5,1,135598,135598,135599,0,1,2
38832,3,2,135601,135601,135603,0,2,2
38833,1,1,135602,135603,135604,1,2,0
38834,2,3,135604,135604,135607,0,3,0
38835,5,2,135609,135609,135611,0,2,2
38836,1,1,135610,135611,135612,1,2,0
38837,1,1,135611,135612,135613,1,2,0
38838,6,1,135617,135617,135618,0,1,4
38839,5,2,135622,135622,135624,0,2,4
38840,5,2,135627,135627,135629,0,2,3
38841,6,3,135633,135633,135636,0,3,4
38842,1,1,135634,135636,135637,2,3,0
38843,3,1,135637,135637,135638,0,1,0
38844,2,3,135639,135639,135642,0,3,1
38845,2,2,135641,135642,135644,1,3,0
38846,3,1,135644,135644,135645,0,1,0
38847,4,1,135648,135648,135649,0,1,3
38848,4,3,135652,135652,135655,0,3,3
38849,3,3,135655,135655,135658,0,3,0
38850,4,2,135659,135659,135661,0,2,1
38851,3,2,135662,135662,135664,0,2,1
38852,3,2,135665,135665,135667,0,2,1
38853,6,2,135671,135671,135673,0,2,4
38854,2,1,135673,135673,135674,0,1,0
38855,3,1,135676,135676,135677,0,1,2
38856,5,3,135681,135681,135684,0,3,4
38857,4,3,135685,135685,135688,0,3,1
38858,2,1,135687,135688,135689,1,2,0
38859,1,3,135688,135689,135692,1,4,0
38860,1,1,135689,135692,135693,3,4,0
38861,3,1,135692,135693,135694,1,2,0
38862,4,2,135696,135696,135698,0,2,2
38863,1,2,135697,135698,135700,1,3,0
38864,4,1,135701,135701,135702,0,1,1
38865,4,1,135705,135705,135706,0,1,3
38866,1,3,135706,135706,135709,0,3,0
38867,4,1,135710,135710,135711,0,1,1
38868,4,2,135714,135714,135716,0,2,3
38869,6,3,135720,135720,135723,0,3,4
38870,1,2,135721,135723,135725,2,4,0
38871,4,1,135725,135725,135726,0,1,0
38872,4,2,135729,135729,135731,0,2,3
38873,2,1,135731,135731,135732,0,1,0
38874,2,2,135733,135733,135735,0,2,1
38875,3,3,135736,135736,135739,0,3,1
38876,2,2,135738,135739,135741,1,3,0
38877,5,2,135743,135743,135745,0,2,2
38878,3,3,135746,135746,135749,0,3,1
38879,6,2,135752,135752,135754,0,2,3
38880,2,3,135754,135754,135757,0,3,0
38881,5,3,135759,135759,135762,0,3,2
38882,5,1,135764,135764,135765,0,1,2
38883,5,1,135769,135769,135770,0,1,4
38884,2,2,135771,135771,135773,0,2,1
38885,5,2,135776,135776,135778,0,2,3
38886,3,2,135779,135779,135781,0,2,1
38887,3,1,135782,135782,135783,0,1,1
38888,3,2,135785,135785,135787,0,2,2
38889,1,3,135786,135787,135790,1,4,0
38890,3,1,135789,135790,135791,1,2,0
38891,6,3,135795,135795,135798,0,3,4
38892,1,2,135796,135798,135800,2,4,0
38893,1,2,135797,135800,135802,3,5,0
38894,4,1,135801,135802,135803,1,2,0
38895,4,2,135805,135805,135807,0,2,2
38896,3,2,135808,135808,135810,0,2,1
38897,6,2,135814,135814,135816,0,2,4
38898,4,3,135818,135818,135821,0,3,2
38899,4,1,135822,135822,135823,0,1,1
38900,1,1,135823,135823,135824,0,1,0
38901,3,2,135826,135826,135828,0,2,2
38902,2,1,135828,135828,135829,0,1,0
38903,6,3,135834,135834,135837,0,3,5
38904,6,1,135840,135840,135841,0,1,3
38905,1,2,135841,135841,135843,0,2,0
38906,3,1,135844,135844,135845,0,1,1
38907,2,3,135846,135846,135849,0,3,1
38908,1,1,135847,135849,135850,2,3,0
38909,5,1,135852,135852,135853,0,1,2
38910,5,2,135857,135857,135859,0,2,4
38911,6,2,135863,135863,135865,0,2,4
38912,4,3,135867,135867,135870,0,3,2
38913,3,1,135870,135870,135871,0,1,0
38914,4,3,135874,135874,135877,0,3,3
38915,6,1,135880,135880,135881,0,1,3
38916,5,2,135885,135885,135887,0,2,4
38917,5,2,135890,135890,135892,0,2,3
38918,6,1,135896,135896,135897,0,1,4
38919,5,3,135901,135901,135904,0,3,4
38920,5,1,135906,135906,135907,0,1,2
38921,2,1,135908,135908,135909,0,1,1
38922,6,2,135914,135914,135916,0,2,5
38923,6,1,135920,135920,135921,0,1,4
38924,6,3,135926,135926,135929,0,3,5
38925,3,1,135929,135929,135930,0,1,0
38926,5,2,135934,135934,135936,0,2,4
38927,3,1,135937,135937,135938,0,1,1
38928,6,2,135943,135943,135945,0,2,5
38929,1,2,135944,135945,135947,1,3,0
38930,6,3,135950,135950,135953,0,3,3
38931,5,3,135955,135955,135958,0,3,2
38932,6,1,135961,135961,135962,0,1,3
38933,3,2,135964,135964,135966,0,2,2
38934,1,1,135965,135966,135967,1,2,0
38935,4,1,135969,135969,135970,0,1,2
38936,5,2,135974,135974,135976,0,2,4
38937,6,2,135980,135980,135982,0,2,4
38938,4,3,135984,135984,135987,0,3,2
38939,3,2,135987,135987,135989,0,2,0
38940,6,1,135993,135993,135994,0,1,4
38941,2,3,135995,135995,135998,0,3,1
38942,1,1,135996,135998,135999,2,3,0
38943,4,3,136000,136000,136003,0,3,1
38944,3,3,136003,136003,136006,0,3,0
38945,5,3,136008,136008,136011,0,3,2
38946,4,2,136012,136012,136014,0,2,1
38947,5,1,136017,136017,136018,0,1,3
38948,6,1,136023,136023,136024,0,1,5
38949,2,1,136025,136025,136026,0,1,1
38950,3,3,136028,136028,136031,0,3,2
38951,1,2,136029,136031,136033,2,4,0
38952,4,1,136033,136033,136034,0,1,0
38953,1,2,136034,136034,136036,0,2,0
38954,3,2,136037,136037,136039,0,2,1
38955,5,1,136042,136042,136043,0,1,3
38956,1,1,136043,136043,136044,0,1,0
38957,3,3,136046,136046,136049,0,3,2
38958,1,3,136047,136049,136052,2,5,0
38959,6,2,136053,136053,136055,0,2,1
38960,4,1,136057,136057,136058,0,1,2
38961,2,1,136059,136059,136060,0,1,1
38962,6,2,136065,136065,136067,0,2,5
38963,4,3,136069,136069,136072,0,3,2
38964,2,1,136071,136072,136073,1,2,0
38965,3,2,136074,136074,136076,0,2,1
38966,2,3,136076,136076,136079,0,3,0
38967,4,2,136080,136080,136082,0,2,1
38968,3,2,136083,136083,136085,0,2,1
38969,2,2,136085,136085,136087,0,2,0
38970,5,3,136090,136090,136093,0,3,3
38971,6,2,136096,136096,136098,0,2,3
38972,2,3,136098,136098,136101,0,3,0
38973,6,3,136104,136104,136107,0,3,3
38974,3,3,136107,136107,136110,0,3,0
38975,3,1,136110,136110,136111,0,1,0
38976,4,1,136114,136114,136115,0,1,3
38977,3,2,136117,136117,136119,0,2,2
38978,2,1,136119,136119,136120,0,1,0
38979,2,2,136121,136121,136123,0,2,1
38980,1,2,136122,136123,136125,1,3,0
38981,2,1,136124,136125,136126,1,2,0
38982,5,2,136129,136129,136131,0,2,3
38983,6,1,136135,136135,136136,0,1,4
38984,1,3,136136,136136,136139,0,3,0
38985,4,1,136140,136140,136141,0,1,1
38986,6,1,136146,136146,136147,0,1,5
38987,5,1,136151,136151,136152,0,1,4
38988,2,3,136153,136153,136156,0,3,1
38989,2,2,136155,136156,136158,1,3,0
38990,6,3,136161,136161,136164,0,3,3
38991,3,2,136164,136164,136166,0,2,0
38992,4,2,136168,136168,136170,0,2,2
38993,6,3,136174,136174,136177,0,3,4
38994,3,1,136177,136177,136178,0,1,0
38995,6,3,136183,136183,136186,0,3,5
38996,1,2,136184,136186,136188,2,4,0
38997,2,3,136186,136188,136191,2,5,0
38998,2,3,136188,136191,136194,3,6,0
38999,1,3,136189,136194,136197,5,8,0
39000,3,2,136192,136197,136199,5,7,0
39001,6,2,136198,136199,136201,1,3,0
39002,2,3,136200,136201,136204,1,4,0
39003,5,2,136205,136205,136207,0,2,1
39004,3,2,136208,136208,136210,0,2,1
39005,2,1,136210,136210,136211,0,1,0
39006,3,2,136213,136213,136215,0,2,2
39007,3,3,136216,136216,136219,0,3,1
39008,4,3,136220,136220,136223,0,3,1
39009,5,2,136225,136225,136227,0,2,2
39010,4,3,136229,136229,136232,0,3,2
39011,6,1,136235,136235,136236,0,1,3
39012,6,1,136241,136241,136242,0,1,5
39013,3,3,136244,136244,136247,0,3,2
39014,6,3,136250,136250,136253,0,3,3
39015,1,2,136251,136253,136255,2,4,0
39016,1,3,136252,136255,136258,3,6,0
39017,4,1,136256,136258,136259,2,3,0
39018,2,3,136258,136259,136262,1,4,0
39019,3,3,136261,136262,136265,1,4,0
39020,4,2,136265,136265,136267,0,2,0
39021,4,3,136269,136269,136272,0,3,2
39022,4,2,136273,136273,136275,0,2,1
39023,3,1,136276,136276,136277,0,1,1
39024,1,1,136277,136277,136278,0,1,0
39025,1,1,136278,136278,136279,0,1,0
39026,1,3,136279,136279,136282,0,3,0
39027,5,2,136284,136284,136286,0,2,2
39028,3,2,136287,136287,136289,0,2,1
39029,2,1,136289,136289,136290,0,1,0
39030,6,2,136295,136295,136297,0,2,5
39031,2,3,136297,136297,136300,0,3,0
39032,6,3,136303,136303,136306,0,3,3
39033,4,3,136307,136307,136310,0,3,1
39034,6,3,136313,136313,136316,0,3,3
39035,3,1,136316,136316,136317,0,1,0
39036,4,1,136320,136320,136321,0,1,3
39037,3,1,136323,136323,136324,0,1,2
39038,2,1,136325,136325,136326,0,1,1
39039,6,2,136331,136331,136333,0,2,5
39040,1,1,136332,136333,136334,1,2,0
39041,4,1,136336,136336,136337,0,1,2
39042,6,1,136342,136342,136343,0,1,5
39043,6,2,136348,136348,136350,0,2,5
39044,1,3,136349,136350,136353,1,4,0
39045,1,3,136350,136353,136356,3,6,0
39046,4,2,136354,136356,136358,2,4,0
39047,4,1,136358,136358,136359,0,1,0
39048,5,2,136363,136363,136365,0,2,4
39049,5,2,136368,136368,136370,0,2,3
39050,2,2,136370,136370,136372,0,2,0
39051,4,3,136374,136374,136377,0,3,2
39052,1,1,136375,136377,136378,2,3,0
39053,2,1,136377,136378,136379,1,2,0
39054,4,3,136381,136381,136384,0,3,2
39055,4,3,136385,136385,136388,0,3,1
39056,2,1,136387,136388,136389,1,2,0
39057,4,2,136391,136391,136393,0,2,2
39058,1,2,136392,136393,136395,1,3,0
39059,4,2,136396,136396,136398,0,2,1
39060,5,3,136401,136401,136404,0,3,3
39061,3,2,136404,136404,136406,0,2,0
39062,1,1,136405,136406,136407,1,2,0
39063,3,2,136408,136408,136410,0,2,1
39064,1,3,136409,136410,136413,1,4,0
39065,5,1,136414,136414,136415,0,1,1
39066,5,2,136419,136419,136421,0,2,4
39067,4,1,136423,136423,136424,0,1,2
39068,2,3,136425,136425,136428,0,3,1
39069,4,3,136429,136429,136432,0,3,1
39070,6,3,136435,136435,136438,0,3,3
39071,4,1,136439,136439,136440,0,1,1
39072,6,2,136445,136445,136447,0,2,5
39073,6,3,136451,136451,136454,0,3,4
39074,6,2,136457,136457,136459,0,2,3
39075,2,1,136459,136459,136460,0,1,0
39076,1,3,136460,136460,136463,0,3,0
39077,3,3,136463,136463,136466,0,3,0
39078,2,2,136465,136466,136468,1,3,0
39079,3,2,136468,136468,136470,0,2,0
39080,4,3,136472,136472,136475,0,3,2
39081,2,1,136474,136475,136476,1,2,0
39082,6,3,136480,136480,136483,0,3,4
39083,5,1,136485,136485,136486,0,1,2
39084,3,3,136488,136488,136491,0,3,2
39085,5,2,136493,136493,136495,0,2,2
39086,3,3,136496,136496,136499,0,3,1
39087,4,2,136500,136500,136502,0,2,1
39088,3,1,136503,136503,136504,0,1,1
39089,4,3,136507,136507,136510,0,3,3
39090,6,2,136513,136513,136515,0,2,3
39091,3,1,136516,136516,136517,0,1,1
39092,2,1,136518,136518,136519,0,1,1
39093,3,2,136521,136521,136523,0,2,2
39094,6,3,136527,136527,136530,0,3,4
39095,3,1,136530,136530,136531,0,1,0
39096,4,1,136534,136534,136535,0,1,3
39097,6,3,136540,136540,136543,0,3,5
39098,6,3,136546,136546,136549,0,3,3
39099,5,2,136551,136551,136553,0,2,2
39100,1,2,136552,136553,136555,1,3,0
39101,6,3,136558,136558,136561,0,3,3
39102,4,2,136562,136562,136564,0,2,1
39103,4,3,136566,136566,136569,0,3,2
39104,6,2,136572,136572,136574,0,2,3
39105,1,2,136573,136574,136576,1,3,0
39106,2,3,136575,136576,136579,1,4,0
39107,4,2,136579,136579,136581,0,2,0
39108,2,1,136581,136581,136582,0,1,0
39109,5,3,136586,136586,136589,0,3,4
39110,2,3,136588,136589,136592,1,4,0
39111,5,3,136593,136593,136596,0,3,1
39112,2,3,136595,136596,136599,1,4,0
39113,1,1,136596,136599,136600,3,4,0
39114,4,2,136600,136600,136602,0,2,0
39115,2,1,136602,136602,136603,0,1,0
39116,5,2,136607,136607,136609,0,2,4
39117,3,2,136610,136610,136612,0,2,1
39118,2,1,136612,136612,136613,0,1,0
39119,3,2,136615,136615,136617,0,2,2
39120,3,1,136618,136618,136619,0,1,1
39121,1,2,136619,136619,136621,0,2,0
39122,5,1,136624,136624,136625,0,1,3
39123,5,3,136629,136629,136632,0,3,4
39124,2,1,136631,136632,136633,1,2,0
39125,5,1,136636,136636,136637,0,1,3
39126,5,3,136641,136641,136644,0,3,4
39127,4,3,136645,136645,136648,0,3,1
39128,1,1,136646,136648,136649,2,3,0
39129,5,3,136651,136651,136654,0,3,2
39130,3,1,136654,136654,136655,0,1,0
39131,6,1,136660,136660,136661,0,1,5
39132,5,1,136665,136665,136666,0,1,4
39133,6,3,136671,136671,136674,0,3,5
39134,5,3,136676,136676,136679,0,3,2
39135,6,1,136682,136682,136683,0,1,3
39136,1,1,136683,136683,136684,0,1,0
39137,4,2,136687,136687,136689,0,2,3
39138,4,1,136691,136691,136692,0,1,2
39139,5,3,136696,136696,136699,0,3,4
39140,4,2,136700,136700,136702,0,2,1
39141,5,2,136705,136705,136707,0,2,3
39142,6,3,136711,136711,136714,0,3,4
39143,5,2,136716,136716,136718,0,2,2
39144,6,2,136722,136722,136724,0,2,4
39145,1,2,136723,136724,136726,1,3,0
39146,6,2,136729,136729,136731,0,2,3
39147,5,1,136734,136734,136735,0,1,3
39148,2,3,136736,136736,136739,0,3,1
39149,5,2,136741,136741,136743,0,2,2
39150,5,2,136746,136746,136748,0,2,3
39151,1,3,136747,136748,136751,1,4,0
39152,2,1,136749,136751,136752,2,3,0
39153,2,1,136751,136752,136753,1,2,0
39154,3,2,136754,136754,136756,0,2,1
39155,1,3,136755,136756,136759,1,4,0
39156,5,2,136760,136760,136762,0,2,1
39157,3,1,136763,136763,136764,0,1,1
39158,1,1,136764,136764,136765,0,1,0
39159,2,1,136766,136766,136767,0,1,1
39160,6,1,136772,136772,136773,0,1,5
39161,3,1,136775,136775,136776,0,1,2
39162,5,3,136780,136780,136783,0,3,4
39163,4,1,136784,136784,136785,0,1,1
39164,4,2,136788,136788,136790,0,2,3
39165,1,3,136789,136790,136793,1,4,0
39166,4,3,136793,136793,136796,0,3,0
39167,2,3,136795,136796,136799,1,4,0
39168,2,2,136797,136799,136801,2,4,0
39169,6,2,136803,136803,136805,0,2,2
39170,1,3,136804,136805,136808,1,4,0
39171,1,2,136805,136808,136810,3,5,0
39172,2,1,136807,136810,136811,3,4,0
39173,4,1,136811,136811,136812,0,1,0
39174,3,3,136814,136814,136817,0,3,2
39175,5,3,136819,136819,136822,0,3,2
39176,6,2,136825,136825,136827,0,2,3
39177,2,3,136827,136827,136830,0,3,0
39178,3,2,136830,136830,136832,0,2,0
39179,5,2,136835,136835,136837,0,2,3
39180,4,2,136839,136839,136841,0,2,2
39181,2,1,136841,136841,136842,0,1,0
39182,6,3,136847,136847,136850,0,3,5
39183,2,1,136849,136850,136851,1,2,0
39184,1,2,136850,136851,136853,1,3,0
39185,2,1,136852,136853,136854,1,2,0
39186,5,2,136857,136857,136859,0,2,3
39187,4,1,136861,136861,136862,0,1,2
39188,6,2,136867,136867,136869,0,2,5
39189,4,1,136871,136871,136872,0,1,2
39190,5,3,136876,136876,136879,0,3,4
39191,1,3,136877,136879,136882,2,5,0
39192,5,2,136882,136882,136884,0,2,0
39193,2,2,136884,136884,136886,0,2,0
39194,2,3,136886,136886,136889,0,3,0
39195,4,1,136890,136890,136891,0,1,1
39196,4,3,136894,136894,136897,0,3,3
39197,1,1,136895,136897,136898,2,3,0
39198,5,3,136900,136900,136903,0,3,2
39199,2,2,136902,136903,136905,1,3,0
39200,5,2,136907,136907,136909,0,2,2
39201,6,2,136913,136913,136915,0,2,4
39202,1,1,136914,136915,136916,1,2,0
39203,6,3,136920,136920,136923,0,3,4
39204,6,3,136926,136926,136929,0,3,3
39205,3,3,136929,136929,136932,0,3,0
39206,6,1,136935,136935,136936,0,1,3
39207,1,3,136936,136936,136939,0,3,0
39208,4,2,136940,136940,136942,0,2,1
39209,4,2,136944,136944,136946,0,2,2
39210,3,3,136947,136947,136950,0,3,1
39211,6,1,136953,136953,136954,0,1,3
39212,5,1,136958,136958,136959,0,1,4
39213,1,3,136959,136959,136962,0,3,0
39214,2,3,136961,136962,136965,1,4,0
39215,4,2,136965,136965,136967,0,2,0
39216,1,3,136966,136967,136970,1,4,0
39217,3,3,136969,136970,136973,1,4,0
39218,2,3,136971,136973,136976,2,5,0
39219,3,1,136974,136976,136977,2,3,0
39220,5,2,136979,136979,136981,0,2,2
39221,2,3,136981,136981,136984,0,3,0
39222,5,1,136986,136986,136987,0,1,2
39223,5,3,136991,136991,136994,0,3,4
39224,6,1,136997,136997,136998,0,1,3
39225,3,3,137000,137000,137003,0,3,2
39226,3,3,137003,137003,137006,0,3,0
39227,6,2,137009,137009,137011,0,2,3
39228,4,2,137013,137013,137015,0,2,2
39229,1,2,137014,137015,137017,1,3,0
39230,6,2,137020,137020,137022,0,2,3
39231,1,1,137021,137022,137023,1,2,0
39232,6,3,137027,137027,137030,0,3,4
39233,5,1,137032,137032,137033,0,1,2
39234,3,3,137035,137035,137038,0,3,2
39235,4,2,137039,137039,137041,0,2,1
39236,2,2,137041,137041,137043,0,2,0
39237,4,1,137045,137045,137046,0,1,2
39238,1,1,137046,137046,137047,0,1,0
39239,4,2,137050,137050,137052,0,2,3
39240,5,2,137055,137055,137057,0,2,3
39241,6,2,137061,137061,137063,0,2,4
39242,6,3,137067,137067,137070,0,3,4
39243,1,2,137068,137070,137072,2,4,0
39244,3,1,137071,137072,137073,1,2,0
39245,6,3,137077,137077,137080,0,3,4
39246,5,3,137082,137082,137085,0,3,2
39247,1,2,137083,137085,137087,2,4,0
39248,1,1,137084,137087,137088,3,4,0
39249,1,3,137085,137088,137091,3,6,0
39250,4,1,137089,137091,137092,2,3,0
39251,3,1,137092,137092,137093,0,1,0
39252,4,1,137096,137096,137097,0,1,3
39253,5,3,137101,137101,137104,0,3,4
39254,1,1,137102,137104,137105,2,3,0
39255,6,3,137108,137108,137111,0,3,3
39256,2,3,137110,137111,137114,1,4,0
39257,4,2,137114,137114,137116,0,2,0
39258,2,3,137116,137116,137119,0,3,0
39259,1,3,137117,137119,137122,2,5,0
39260,2,2,137119,137122,137124,3,5,0
39261,1,2,137120,137124,137126,4,6,0
39262,5,3,137125,137126,137129,1,4,0
39263,4,3,137129,137129,137132,0,3,0
39264,2,1,137131,137132,137133,1,2,0
39265,4,2,137135,137135,137137,0,2,2
39266,2,3,137137,137137,137140,0,3,0
39267,2,1,137139,137140,137141,1,2,0
39268,4,1,137143,137143,137144,0,1,2
39269,5,1,137148,137148,137149,0,1,4
39270,1,2,137149,137149,137151,0,2,0
39271,6,1,137155,137155,137156,0,1,4
39272,5,2,137160,137160,137162,0,2,4
39273,3,3,137163,137163,137166,0,3,1
39274,1,3,137164,137166,137169,2,5,0
39275,4,1,137168,137169,137170,1,2,0
39276,6,2,137174,137174,137176,0,2,4
39277,2,2,137176,137176,137178,0,2,0
39278,6,2,137182,137182,137184,0,2,4
39279,1,1,137183,137184,137185,1,2,0
39280,3,1,137186,137186,137187,0,1,1
39281,2,3,137188,137188,137191,0,3,1
39282,2,1,137190,137191,137192,1,2,0
39283,2,1,137192,137192,137193,0,1,0
39284,4,3,137196,137196,137199,0,3,3
39285,5,1,137201,137201,137202,0,1,2
39286,6,3,137207,137207,137210,0,3,5
39287,2,2,137209,137210,137212,1,3,0
39288,4,1,137213,137213,137214,0,1,1
39289,3,3,137216,137216,137219,0,3,2
39290,3,1,137219,137219,137220,0,1,0
39291,2,3,137221,137221,137224,0,3,1
39292,6,1,137227,137227,137228,0,1,3
39293,1,1,137228,137228,137229,0,1,0
39294,3,2,137231,137231,137233,0,2,2
39295,5,1,137236,137236,137237,0,1,3
39296,5,1,137241,137241,137242,0,1,4
39297,6,3,137247,137247,137250,0,3,5
39298,1,2,137248,137250,137252,2,4,0
39299,6,1,137254,137254,137255,0,1,2
39300,3,2,137257,137257,137259,0,2,2
39301,4,2,137261,137261,137263,0,2,2
39302,1,2,137262,137263,137265,1,3,0
39303,4,3,137266,137266,137269,0,3,1
39304,6,1,137272,137272,137273,0,1,3
39305,1,2,137273,137273,137275,0,2,0
39306,5,3,137278,137278,137281,0,3,3
39307,2,1,137280,137281,137282,1,2,0
39308,3,2,137283,137283,137285,0,2,1
39309,1,3,137284,137285,137288,1,4,0
39310,1,2,137285,137288,137290,3,5,0
39311,4,1,137289,137290,137291,1,2,0
39312,1,3,137290,137291,137294,1,4,0
39313,1,3,137291,137294,137297,3,6,0
39314,2,1,137293,137297,137298,4,5,0
39315,2,2,137295,137298,137300,3,5,0
39316,1,3,137296,137300,137303,4,7,0
39317,6,1,137302,137303,137304,1,2,0
39318,1,3,137303,137304,137307,1,4,0
39319,2,2,137305,137307,137309,2,4,0
39320,5,3,137310,137310,137313,0,3,1
39321,4,2,137314,137314,137316,0,2,1
39322,5,3,137319,137319,137322,0,3,3
39323,2,2,137321,137322,137324,1,3,0
39324,4,3,137325,137325,137328,0,3,1
39325,6,1,137331,137331,137332,0,1,3
39326,6,1,137337,137337,137338,0,1,5
39327,1,2,137338,137338,137340,0,2,0
39328,1,1,137339,137340,137341,1,2,0
39329,1,2,137340,137341,137343,1,3,0
39330,1,2,137341,137343,137345,2,4,0
39331,2,1,137343,137345,137346,2,3,0
39332,4,3,137347,137347,137350,0,3,1
39333,4,1,137351,137351,137352,0,1,1
39334,1,1,137352,137352,137353,0,1,0
39335,4,2,137356,137356,137358,0,2,3
39336,1,1,137357,137358,137359,1,2,0
39337,6,3,137363,137363,137366,0,3,4
39338,3,1,137366,137366,137367,0,1,0
39339,6,3,137372,137372,137375,0,3,5
39340,5,1,137377,137377,137378,0,1,2
39341,2,2,137379,137379,137381,0,2,1
39342,2,3,137381,137381,137384,0,3,0
39343,6,1,137387,137387,137388,0,1,3
39344,1,1,137388,137388,137389,0,1,0
39345,5,1,137393,137393,137394,0,1,4
39346,5,3,137398,137398,137401,0,3,4
39347,5,3,137403,137403,137406,0,3,2
39348,6,2,137409,137409,137411,0,2,3
39349,3,2,137412,137412,137414,0,2,1
39350,2,1,137414,137414,137415,0,1,0
39351,4,3,137418,137418,137421,0,3,3
39352,2,2,137420,137421,137423,1,3,0
39353,4,3,137424,137424,137427,0,3,1
39354,2,1,137426,137427,137428,1,2,0
39355,3,2,137429,137429,137431,0,2,1
39356,4,3,137433,137433,137436,0,3,2
39357,1,3,137434,137436,137439,2,5,0
39358,2,1,137436,137439,137440,3,4,0
39359,6,2,137442,137442,137444,0,2,2
39360,1,1,137443,137444,137445,1,2,0
39361,5,1,137448,137448,137449,0,1,3
39362,5,2,137453,137453,137455,0,2,4
39363,4,2,137457,137457,137459,0,2,2
39364,4,2,137461,137461,137463,0,2,2
39365,1,1,137462,137463,137464,1,2,0
39366,6,1,137468,137468,137469,0,1,4
39367,2,1,137470,137470,137471,0,1,1
39368,5,3,137475,137475,137478,0,3,4
39369,5,2,137480,137480,137482,0,2,2
39370,5,2,137485,137485,137487,0,2,3
39371,6,2,137491,137491,137493,0,2,4
39372,2,2,137493,137493,137495,0,2,0
39373,3,2,137496,137496,137498,0,2,1
39374,6,1,137502,137502,137503,0,1,4
39375,2,3,137504,137504,137507,0,3,1
39376,2,3,137506,137507,137510,1,4,0
39377,1,2,137507,137510,137512,3,5,0
39378,1,3,137508,137512,137515,4,7,0
39379,3,3,137511,137515,137518,4,7,0
39380,1,1,137512,137518,137519,6,7,0
39381,3,3,137515,137519,137522,4,7,0
39382,2,3,137517,137522,137525,5,8,0
39383,6,1,137523,137525,137526,2,3,0
39384,6,2,137529,137529,137531,0,2,3
39385,3,3,137532,137532,137535,0,3,1
39386,3,2,137535,137535,137537,0,2,0
39387,6,2,137541,137541,137543,0,2,4
39388,1,2,137542,137543,137545,1,3,0
39389,6,1,137548,137548,137549,0,1,3
39390,6,2,137554,137554,137556,0,2,5
39391,4,1,137558,137558,137559,0,1,2
39392,2,3,137560,137560,137563,0,3,1
39393,3,3,137563,137563,137566,0,3,0
39394,2,3,137565,137566,137569,1,4,0
39395,4,3,137569,137569,137572,0,3,0
39396,3,2,137572,137572,137574,0,2,0
39397,1,1,137573,137574,137575,1,2,0
39398,6,2,137579,137579,137581,0,2,4
39399,6,3,137585,137585,137588,0,3,4
39400,3,1,137588,137588,137589,0,1,0
39401,3,2,137591,137591,137593,0,2,2
39402,2,3,137593,137593,137596,0,3,0
39403,2,1,137595,137596,137597,1,2,0
39404,3,3,137598,137598,137601,0,3,1
39405,3,3,137601,137601,137604,0,3,0
39406,6,3,137607,137607,137610,0,3,3
39407,2,3,137609,137610,137613,1,4,0
39408,2,3,137611,137613,137616,2,5,0
39409,3,3,137614,137616,137619,2,5,0
39410,6,1,137620,137620,137621,0,1,1
39411,6,2,137626,137626,137628,0,2,5
39412,1,3,137627,137628,137631,1,4,0
39413,6,2,137633,137633,137635,0,2,2
39414,1,3,137634,137635,137638,1,4,0
39415,2,1,137636,137638,137639,2,3,0
39416,4,2,137640,137640,137642,0,2,1
39417,3,1,137643,137643,137644,0,1,1
39418,1,2,137644,137644,137646,0,2,0
39419,6,3,137650,137650,137653,0,3,4
39420,5,2,137655,137655,137657,0,2,2
39421,2,1,137657,137657,137658,0,1,0
39422,5,3,137662,137662,137665,0,3,4
39423,1,3,137663,137665,137668,2,5,0
39424,1,1,137664,137668,137669,4,5,0
39425,5,1,137669,137669,137670,0,1,0
39426,6,3,137675,137675,137678,0,3,5
39427,2,1,137677,137678,137679,1,2,0
39428,5,3,137682,137682,137685,0,3,3
39429,6,3,137688,137688,137691,0,3,3
39430,6,3,137694,137694,137697,0,3,3
39431,3,1,137697,137697,137698,0,1,0
39432,5,3,137702,137702,137705,0,3,4
39433,6,1,137708,137708,137709,0,1,3
39434,1,3,137709,137709,137712,0,3,0
39435,5,1,137714,137714,137715,0,1,2
39436,1,1,137715,137715,137716,0,1,0
39437,1,3,137716,137716,137719,0,3,0
39438,1,3,137717,137719,137722,2,5,0
39439,2,1,137719,137722,137723,3,4,0
39440,2,2,137721,137723,137725,2,4,0
39441,1,1,137722,137725,137726,3,4,0
39442,2,3,137724,137726,137729,2,5,0
39443,3,2,137727,137729,137731,2,4,0
39444,4,3,137731,137731,137734,0,3,0
39445,2,3,137733,137734,137737,1,4,0
39446,2,3,137735,137737,137740,2,5,0
39447,1,1,137736,137740,137741,4,5,0
39448,6,2,137742,137742,137744,0,2,1
39449,4,3,137746,137746,137749,0,3,2
39450,3,2,137749,137749,137751,0,2,0
39451,6,3,137755,137755,137758,0,3,4
39452,1,2,137756,137758,137760,2,4,0
39453,6,2,137762,137762,137764,0,2,2
39454,6,1,137768,137768,137769,0,1,4
39455,1,1,137769,137769,137770,0,1,0
39456,2,1,137771,137771,137772,0,1,1
39457,6,1,137777,137777,137778,0,1,5
39458,3,1,137780,137780,137781,0,1,2
39459,5,2,137785,137785,137787,0,2,4
39460,5,2,137790,137790,137792,0,2,3
39461,2,3,137792,137792,137795,0,3,0
39462,4,2,137796,137796,137798,0,2,1
39463,2,2,137798,137798,137800,0,2,0
39464,3,2,137801,137801,137803,0,2,1
39465,6,2,137807,137807,137809,0,2,4
39466,4,2,137811,137811,137813,0,2,2
39467,2,2,137813,137813,137815,0,2,0
39468,5,3,137818,137818,137821,0,3,3
39469,5,2,137823,137823,137825,0,2,2
39470,3,2,137826,137826,137828,0,2,1
39471,4,2,137830,137830,137832,0,2,2
39472,5,1,137835,137835,137836,0,1,3
39473,1,3,137836,137836,137839,0,3,0
39474,6,3,137842,137842,137845,0,3,3
39475,3,1,137845,137845,137846,0,1,0
39476,4,1,137849,137849,137850,0,1,3
39477,2,1,137851,137851,137852,0,1,1
39478,4,1,137855,137855,137856,0,1,3
39479,6,3,137861,137861,137864,0,3,5
39480,3,1,137864,137864,137865,0,1,0
39481,2,2,137866,137866,137868,0,2,1
39482,5,3,137871,137871,137874,0,3,3
39483,3,2,137874,137874,137876,0,2,0
39484,3,3,137877,137877,137880,0,3,1
39485,1,2,137878,137880,137882,2,4,0
39486,4,2,137882,137882,137884,0,2,0
39487,3,1,137885,137885,137886,0,1,1
39488,6,3,137891,137891,137894,0,3,5
39489,2,3,137893,137894,137897,1,4,0
39490,4,2,137897,137897,137899,0,2,0
39491,1,1,137898,137899,137900,1,2,0
39492,4,3,137902,137902,137905,0,3,2
39493,4,2,137906,137906,137908,0,2,1
39494,4,2,137910,137910,137912,0,2,2
39495,4,2,137914,137914,137916,0,2,2
39496,6,1,137920,137920,137921,0,1,4
39497,2,2,137922,137922,137924,0,2,1
39498,3,3,137925,137925,137928,0,3,1
39499,3,2,137928,137928,137930,0,2,0
39500,5,3,137933,137933,137936,0,3,3
39501,6,2,137939,137939,137941,0,2,3
39502,1,2,137940,137941,137943,1,3,0
39503,1,3,137941,137943,137946,2,5,0
39504,5,3,137946,137946,137949,0,3,0
39505,6,1,137952,137952,137953,0,1,3
39506,5,3,137957,137957,137960,0,3,4
39507,3,2,137960,137960,137962,0,2,0
39508,6,3,137966,137966,137969,0,3,4
39509,6,3,137972,137972,137975,0,3,3
39510,1,2,137973,137975,137977,2,4,0
39511,2,3,137975,137977,137980,2,5,0
39512,2,2,137977,137980,137982,3,5,0
39513,5,3,137982,137982,137985,0,3,0
39514,6,2,137988,137988,137990,0,2,3
39515,3,3,137991,137991,137994,0,3,1
39516,3,1,137994,137994,137995,0,1,0
39517,1,3,137995,137995,137998,0,3,0
39518,3,1,137998,137998,137999,0,1,0
39519,1,1,137999,137999,138000,0,1,0
39520,3,1,138002,138002,138003,0,1,2
39521,2,2,138004,138004,138006,0,2,1
39522,4,1,138008,138008,138009,0,1,2
39523,2,2,138010,138010,138012,0,2,1
39524,1,2,138011,138012,138014,1,3,0
39525,1,1,138012,138014,138015,2,3,0
39526,2,1,138014,138015,138016,1,2,0
39527,5,2,138019,138019,138021,0,2,3
39528,5,3,138024,138024,138027,0,3,3
39529,2,3,138026,138027,138030,1,4,0
39530,3,1,138029,138030,138031,1,2,0
39531,1,1,138030,138031,138032,1,2,0
39532,4,2,138034,138034,138036,0,2,2
39533,3,2,138037,138037,138039,0,2,1
39534,4,3,138041,138041,138044,0,3,2
39535,5,3,138046,138046,138049,0,3,2
39536,4,2,138050,138050,138052,0,2,1
39537,5,3,138055,138055,138058,0,3,3
39538,4,3,138059,138059,138062,0,3,1
39539,6,3,138065,138065,138068,0,3,3
39540,1,2,138066,138068,138070,2,4,0
39541,5,3,138071,138071,138074,0,3,1
39542,3,1,138074,138074,138075,0,1,0
39543,1,3,138075,138075,138078,0,3,0
39544,2,2,138077,138078,138080,1,3,0
39545,1,1,138078,138080,138081,2,3,0
39546,2,2,138080,138081,138083,1,3,0
39547,2,2,138082,138083,138085,1,3,0
39548,2,3,138084,138085,138088,1,4,0
39549,1,2,138085,138088,138090,3,5,0
39550,4,1,138089,138090,138091,1,2,0
39551,6,2,138095,138095,138097,0,2,4
39552,1,1,138096,138097,138098,1,2,0
39553,4,2,138100,138100,138102,0,2,2
39554,3,2,138103,138103,138105,0,2,1
39555,5,1,138108,138108,138109,0,1,3
39556,1,1,138109,138109,138110,0,1,0
39557,5,2,138114,138114,138116,0,2,4
39558,5,1,138119,138119,138120,0,1,3
39559,4,2,138123,138123,138125,0,2,3
39560,4,1,138127,138127,138128,0,1,2
39561,4,2,138131,138131,138133,0,2,3
39562,5,1,138136,138136,138137,0,1,3
39563,3,3,138139,138139,138142,0,3,2
39564,1,3,138140,138142,138145,2,5,0
39565,4,3,138144,138145,138148,1,4,0
39566,1,3,138145,138148,138151,3,6,0
39567,3,3,138148,138151,138154,3,6,0
39568,2,1,138150,138154,138155,4,5,0
39569,1,2,138151,138155,138157,4,6,0
39570,6,2,138157,138157,138159,0,2,0
39571,3,1,138160,138160,138161,0,1,1
39572,4,1,138164,138164,138165,0,1,3
39573,5,1,138169,138169,138170,0,1,4
39574,4,2,138173,138173,138175,0,2,3
39575,1,2,138174,138175,138177,1,3,0
39576,2,2,138176,138177,138179,1,3,0
39577,1,3,138177,138179,138182,2,5,0
39578,6,2,138183,138183,138185,0,2,1
39579,1,1,138184,138185,138186,1,2,0
39580,1,3,138185,138186,138189,1,4,0
39581,6,3,138191,138191,138194,0,3,2
39582,1,2,138192,138194,138196,2,4,0
39583,6,2,138198,138198,138200,0,2,2
39584,6,3,138204,138204,138207,0,3,4
39585,1,1,138205,138207,138208,2,3,0
39586,6,2,138211,138211,138213,0,2,3
39587,5,1,138216,138216,138217,0,1,3
39588,4,2,138220,138220,138222,0,2,3
39589,4,3,138224,138224,138227,0,3,2
39590,5,3,138229,138229,138232,0,3,2
39591,5,1,138234,138234,138235,0,1,2
39592,1,1,138235,138235,138236,0,1,0
39593,3,2,138238,138238,138240,0,2,2
39594,2,2,138240,138240,138242,0,2,0
39595,4,2,138244,138244,138246,0,2,2
39596,3,3,138247,138247,138250,0,3,1
39597,4,1,138251,138251,138252,0,1,1
39598,2,2,138253,138253,138255,0,2,1
39599,4,1,138257,138257,138258,0,1,2
39600,6,3,138263,138263,138266,0,3,5
39601,6,1,138269,138269,138270,0,1,3
39602,6,1,138275,138275,138276,0,1,5
39603,2,1,138277,138277,138278,0,1,1
39604,5,1,138282,138282,138283,0,1,4
39605,3,2,138285,138285,138287,0,2,2
39606,6,1,138291,138291,138292,0,1,4
39607,3,1,138294,138294,138295,0,1,2
39608,2,3,138296,138296,138299,0,3,1
39609,5,2,138301,138301,138303,0,2,2
39610,3,3,138304,138304,138307,0,3,1
39611,6,2,138310,138310,138312,0,2,3
39612,3,3,138313,138313,138316,0,3,1
39613,3,3,138316,138316,138319,0,3,0
39614,1,1,138317,138319,138320,2,3,0
39615,4,1,138321,138321,138322,0,1,1
39616,5,3,138326,138326,138329,0,3,4
39617,3,2,138329,138329,138331,0,2,0
39618,4,3,138333,138333,138336,0,3,2
39619,3,1,138336,138336,138337,0,1,0
39620,3,1,138339,138339,138340,0,1,2
39621,3,3,138342,138342,138345,0,3,2
39622,4,2,138346,138346,138348,0,2,1
39623,6,3,138352,138352,138355,0,3,4
39624,2,1,138354,138355,138356,1,2,0
39625,6,1,138360,138360,138361,0,1,4
39626,1,1,138361,138361,138362,0,1,0
39627,1,1,138362,138362,138363,0,1,0
39628,2,3,138364,138364,138367,0,3,1
39629,6,2,138370,138370,138372,0,2,3
39630,6,1,138376,138376,138377,0,1,4
39631,4,2,138380,138380,138382,0,2,3
39632,6,1,138386,138386,138387,0,1,4
39633,5,3,138391,138391,138394,0,3,4
39634,2,1,138393,138394,138395,1,2,0
39635,6,1,138399,138399,138400,0,1,4
39636,3,3,138402,138402,138405,0,3,2
39637,2,2,138404,138405,138407,1,3,0
39638,3,2,138407,138407,138409,0,2,0
39639,2,2,138409,138409,138411,0,2,0
39640,1,1,138410,138411,138412,1,2,0
39641,6,1,138416,138416,138417,0,1,4
39642,4,2,138420,138420,138422,0,2,3
39643,1,2,138421,138422,138424,1,3,0
39644,4,1,138425,138425,138426,0,1,1
39645,5,3,138430,138430,138433,0,3,4
39646,1,3,138431,138433,138436,2,5,0
39647,4,2,138435,138436,138438,1,3,0
39648,6,2,138441,138441,138443,0,2,3
39649,4,1,138445,138445,138446,0,1,2
39650,5,1,138450,138450,138451,0,1,4
39651,6,2,138456,138456,138458,0,2,5
39652,6,2,138462,138462,138464,0,2,4
39653,3,2,138465,138465,138467,0,2,1
39654,1,1,138466,138467,138468,1,2,0
39655,6,1,138472,138472,138473,0,1,4
39656,3,1,138475,138475,138476,0,1,2
39657,2,3,138477,138477,138480,0,3,1
39658,2,3,138479,138480,138483,1,4,0
39659,4,3,138483,138483,138486,0,3,0
39660,1,3,138484,138486,138489,2,5,0
39661,5,1,138489,138489,138490,0,1,0
39662,5,3,138494,138494,138497,0,3,4
39663,5,2,138499,138499,138501,0,2,2
39664,1,2,138500,138501,138503,1,3,0
39665,4,2,138504,138504,138506,0,2,1
39666,5,1,138509,138509,138510,0,1,3
39667,5,3,138514,138514,138517,0,3,4
39668,5,2,138519,138519,138521,0,2,2
39669,1,3,138520,138521,138524,1,4,0
39670,2,1,138522,138524,138525,2,3,0
39671,4,2,138526,138526,138528,0,2,1
39672,1,2,138527,138528,138530,1,3,0
39673,3,2,138530,138530,138532,0,2,0
39674,1,1,138531,138532,138533,1,2,0
39675,4,3,138535,138535,138538,0,3,2
39676,1,2,138536,138538,138540,2,4,0
39677,5,2,138541,138541,138543,0,2,1
39678,3,1,138544,138544,138545,0,1,1
39679,4,2,138548,138548,138550,0,2,3
39680,2,3,138550,138550,138553,0,3,0
39681,4,2,138554,138554,138556,0,2,1
39682,2,2,138556,138556,138558,0,2,0
39683,3,3,138559,138559,138562,0,3,1
39684,1,2,138560,138562,138564,2,4,0
39685,2,3,138562,138564,138567,2,5,0
39686,4,1,138566,138567,138568,1,2,0
39687,5,3,138571,138571,138574,0,3,3
39688,6,3,138577,138577,138580,0,3,3
39689,2,3,138579,138580,138583,1,4,0
39690,5,1,138584,138584,138585,0,1,1
39691,5,3,138589,138589,138592,0,3,4
39692,4,3,138593,138593,138596,0,3,1
39693,3,1,138596,138596,138597,0,1,0
39694,5,1,138601,138601,138602,0,1,4
39695,4,3,138605,138605,138608,0,3,3
39696,5,1,138610,138610,138611,0,1,2
39697,4,1,138614,138614,138615,0,1,3
39698,2,1,138616,138616,138617,0,1,1
39699,2,1,138618,138618,138619,0,1,1
39700,5,3,138623,138623,138626,0,3,4
39701,2,2,138625,138626,138628,1,3,0
39702,2,2,138627,138628,138630,1,3,0
39703,3,1,138630,138630,138631,0,1,0
39704,3,2,138633,138633,138635,0,2,2
39705,5,1,138638,138638,138639,0,1,3
39706,3,1,138641,138641,138642,0,1,2
39707,6,3,138647,138647,138650,0,3,5
39708,6,1,138653,138653,138654,0,1,3
39709,6,3,138659,138659,138662,0,3,5
39710,4,3,138663,138663,138666,0,3,1
39711,3,1,138666,138666,138667,0,1,0
39712,2,3,138668,138668,138671,0,3,1
39713,5,1,138673,138673,138674,0,1,2
39714,5,3,138678,138678,138681,0,3,4
39715,2,1,138680,138681,138682,1,2,0
39716,3,2,138683,138683,138685,0,2,1
39717,5,2,138688,138688,138690,0,2,3
39718,5,1,138693,138693,138694,0,1,3
39719,2,1,138695,138695,138696,0,1,1
39720,4,2,138699,138699,138701,0,2,3
39721,3,3,138702,138702,138705,0,3,1
39722,5,2,138707,138707,138709,0,2,2
39723,2,3,138709,138709,138712,0,3,0
39724,2,3,138711,138712,138715,1,4,0
39725,5,3,138716,138716,138719,0,3,1
39726,1,1,138717,138719,138720,2,3,0
39727,1,3,138718,138720,138723,2,5,0
39728,5,1,138723,138723,138724,0,1,0
39729,4,1,138727,138727,138728,0,1,3
39730,3,1,138730,138730,138731,0,1,2
39731,2,1,138732,138732,138733,0,1,1
39732,2,1,138734,138734,138735,0,1,1
39733,4,3,138738,138738,138741,0,3,3
39734,2,2,138740,138741,138743,1,3,0
39735,3,1,138743,138743,138744,0,1,0
39736,4,1,138747,138747,138748,0,1,3
39737,3,1,138750,138750,138751,0,1,2
39738,4,3,138754,138754,138757,0,3,3
39739,5,2,138759,138759,138761,0,2,2
39740,6,3,138765,138765,138768,0,3,4
39741,4,3,138769,138769,138772,0,3,1
39742,5,3,138774,138774,138777,0,3,2
39743,3,3,138777,138777,138780,0,3,0
39744,2,1,138779,138780,138781,1,2,0
39745,6,1,138785,138785,138786,0,1,4
39746,4,3,138789,138789,138792,0,3,3
39747,1,2,138790,138792,138794,2,4,0
39748,1,1,138791,138794,138795,3,4,0
39749,6,3,138797,138797,138800,0,3,2
39750,3,3,138800,138800,138803,0,3,0
39751,4,2,138804,138804,138806,0,2,1
39752,2,3,138806,138806,138809,0,3,0
39753,4,1,138810,138810,138811,0,1,1
39754,1,3,138811,138811,138814,0,3,0
39755,2,3,138813,138814,138817,1,4,0
39756,4,1,138817,138817,138818,0,1,0
39757,4,2,138821,138821,138823,0,2,3
39758,1,1,138822,138823,138824,1,2,0
39759,3,1,138825,138825,138826,0,1,1
39760,3,3,138828,138828,138831,0,3,2
39761,3,1,138831,138831,138832,0,1,0
39762,5,3,138836,138836,138839,0,3,4
39763,5,1,138841,138841,138842,0,1,2
39764,5,3,138846,138846,138849,0,3,4
39765,2,2,138848,138849,138851,1,3,0
39766,3,2,138851,138851,138853,0,2,0
39767,1,2,138852,138853,138855,1,3,0
39768,5,3,138857,138857,138860,0,3,2
39769,4,1,138861,138861,138862,0,1,1
39770,5,3,138866,138866,138869,0,3,4
39771,4,2,138870,138870,138872,0,2,1
39772,4,2,138874,138874,138876,0,2,2
39773,1,2,138875,138876,138878,1,3,0
39774,6,3,138881,138881,138884,0,3,3
39775,4,2,138885,138885,138887,0,2,1
39776,4,3,138889,138889,138892,0,3,2
39777,1,3,138890,138892,138895,2,5,0
39778,6,3,138896,138896,138899,0,3,1
39779,5,3,138901,138901,138904,0,3,2
39780,5,2,138906,138906,138908,0,2,2
39781,5,2,138911,138911,138913,0,2,3
39782,2,2,138913,138913,138915,0,2,0
39783,3,1,138916,138916,138917,0,1,1
39784,4,2,138920,138920,138922,0,2,3
39785,4,2,138924,138924,138926,0,2,2
39786,3,3,138927,138927,138930,0,3,1
39787,5,2,138932,138932,138934,0,2,2
39788,6,2,138938,138938,138940,0,2,4
39789,4,2,138942,138942,138944,0,2,2
39790,5,3,138947,138947,138950,0,3,3
39791,4,1,138951,138951,138952,0,1,1
39792,3,2,138954,138954,138956,0,2,2
39793,6,2,138960,138960,138962,0,2,4
39794,2,3,138962,138962,138965,0,3,0
39795,6,1,138968,138968,138969,0,1,3
39796,6,3,138974,138974,138977,0,3,5
39797,6,2,138980,138980,138982,0,2,3
39798,5,2,138985,138985,138987,0,2,3
39799,6,1,138991,138991,138992,0,1,4
39800,4,2,138995,138995,138997,0,2,3
39801,5,2,139000,139000,139002,0,2,3
39802,5,3,139005,139005,139008,0,3,3
39803,5,1,139010,139010,139011,0,1,2
39804,6,1,139016,139016,139017,0,1,5
39805,6,1,139022,139022,139023,0,1,5
39806,1,1,139023,139023,139024,0,1,0
39807,5,2,139028,139028,139030,0,2,4
39808,2,2,139030,139030,139032,0,2,0
39809,1,3,139031,139032,139035,1,4,0
39810,4,1,139035,139035,139036,0,1,0
39811,1,1,139036,139036,139037,0,1,0
39812,6,2,139042,139042,139044,0,2,5
39813,3,2,139045,139045,139047,0,2,1
39814,1,2,139046,139047,139049,1,3,0
39815,5,2,139051,139051,139053,0,2,2
39816,3,3,139054,139054,139057,0,3,1
39817,4,2,139058,139058,139060,0,2,1
39818,1,3,139059,139060,139063,1,4,0
39819,2,2,139061,139063,139065,2,4,0
39820,4,3,139065,139065,139068,0,3,0
39821,2,2,139067,139068,139070,1,3,0
39822,5,3,139072,139072,139075,0,3,2
39823,6,3,139078,139078,139081,0,3,3
39824,5,3,139083,139083,139086,0,3,2
39825,4,1,139087,139087,139088,0,1,1
39826,3,3,139090,139090,139093,0,3,2
39827,2,1,139092,139093,139094,1,2,0
39828,2,3,139094,139094,139097,0,3,0
39829,2,2,139096,139097,139099,1,3,0
39830,6,1,139102,139102,139103,0,1,3
39831,3,2,139105,139105,139107,0,2,2
39832,4,3,139109,139109,139112,0,3,2
39833,4,1,139113,139113,139114,0,1,1
39834,1,3,139114,139114,139117,0,3,0
39835,2,2,139116,139117,139119,1,3,0
39836,4,1,139120,139120,139121,0,1,1
39837,1,2,139121,139121,139123,0,2,0
39838,5,3,139126,139126,139129,0,3,3
39839,5,2,139131,139131,139133,0,2,2
39840,6,2,139137,139137,139139,0,2,4
39841,5,2,139142,139142,139144,0,2,3
39842,6,3,139148,139148,139151,0,3,4
39843,1,2,139149,139151,139153,2,4,0
39844,5,1,139154,139154,139155,0,1,1
39845,3,1,139157,139157,139158,0,1,2
39846,3,1,139160,139160,139161,0,1,2
39847,2,1,139162,139162,139163,0,1,1
39848,2,1,139164,139164,139165,0,1,1
39849,6,3,139170,139170,139173,0,3,5
39850,2,1,139172,139173,139174,1,2,0
39851,4,2,139176,139176,139178,0,2,2
39852,5,1,139181,139181,139182,0,1,3
39853,5,1,139186,139186,139187,0,1,4
39854,2,1,139188,139188,139189,0,1,1
39855,3,2,139191,139191,139193,0,2,2
39856,1,3,139192,139193,139196,1,4,0
39857,5,1,139197,139197,139198,0,1,1
39858,3,2,139200,139200,139202,0,2,2
39859,2,3,139202,139202,139205,0,3,0
39860,4,1,139206,139206,139207,0,1,1
39861,2,2,139208,139208,139210,0,2,1
39862,4,3,139212,139212,139215,0,3,2
39863,3,3,139215,139215,139218,0,3,0
39864,5,3,139220,139220,139223,0,3,2
39865,1,1,139221,139223,139224,2,3,0
39866,3,3,139224,139224,139227,0,3,0
39867,1,3,139225,139227,139230,2,5,0
39868,2,2,139227,139230,139232,3,5,0
39869,1,3,139228,139232,139235,4,7,0
39870,4,2,139232,139235,139237,3,5,0
39871,6,2,139238,139238,139240,0,2,1
39872,4,3,139242,139242,139245,0,3,2
39873,2,2,139244,139245,139247,1,3,0
39874,5,1,139249,139249,139250,0,1,2
39875,1,1,139250,139250,139251,0,1,0
39876,2,3,139252,139252,139255,0,3,1
39877,1,3,139253,139255,139258,2,5,0
39878,5,3,139258,139258,139261,0,3,0
39879,3,1,139261,139261,139262,0,1,0
39880,3,1,139264,139264,139265,0,1,2
39881,6,2,139270,139270,139272,0,2,5
39882,1,1,139271,139272,139273,1,2,0
39883,5,3,139276,139276,139279,0,3,3
39884,2,2,139278,139279,139281,1,3,0
39885,5,1,139283,139283,139284,0,1,2
39886,2,1,139285,139285,139286,0,1,1
39887,3,2,139288,139288,139290,0,2,2
39888,5,3,139293,139293,139296,0,3,3
39889,5,1,139298,139298,139299,0,1,2
39890,1,1,139299,139299,139300,0,1,0
39891,3,2,139302,139302,139304,0,2,2
39892,2,1,139304,139304,139305,0,1,0
39893,1,3,139305,139305,139308,0,3,0
39894,5,2,139310,139310,139312,0,2,2
39895,4,2,139314,139314,139316,0,2,2
39896,3,3,139317,139317,139320,0,3,1
39897,6,2,139323,139323,139325,0,2,3
39898,1,2,139324,139325,139327,1,3,0
39899,6,1,139330,139330,139331,0,1,3
39900,5,3,139335,139335,139338,0,3,4
39901,6,1,139341,139341,139342,0,1,3
39902,2,2,139343,139343,139345,0,2,1
39903,3,1,139346,139346,139347,0,1,1
39904,5,3,139351,139351,139354,0,3,4
39905,1,1,139352,139354,139355,2,3,0
39906,5,2,139357,139357,139359,0,2,2
39907,3,3,139360,139360,139363,0,3,1
39908,3,1,139363,139363,139364,0,1,0
39909,3,2,139366,139366,139368,0,2,2
39910,4,2,139370,139370,139372,0,2,2
39911,5,1,139375,139375,139376,0,1,3
39912,5,1,139380,139380,139381,0,1,4
39913,6,2,139386,139386,139388,0,2,5
39914,1,3,139387,139388,139391,1,4,0
39915,5,2,139392,139392,139394,0,2,1
39916,4,2,139396,139396,139398,0,2,2
39917,1,1,139397,139398,139399,1,2,0
39918,6,2,139403,139403,139405,0,2,4
39919,5,1,139408,139408,139409,0,1,3
39920,4,3,139412,139412,139415,0,3,3
39921,3,3,139415,139415,139418,0,3,0
39922,6,3,139421,139421,139424,0,3,3
39923,5,3,139426,139426,139429,0,3,2
39924,4,3,139430,139430,139433,0,3,1
39925,4,3,139434,139434,139437,0,3,1
39926,2,2,139436,139437,139439,1,3,0
39927,1,3,139437,139439,139442,2,5,0
39928,1,3,139438,139442,139445,4,7,0
39929,6,2,139444,139445,139447,1,3,0
39930,5,2,139449,139449,139451,0,2,2
39931,2,1,139451,139451,139452,0,1,0
39932,4,2,139455,139455,139457,0,2,3
39933,2,2,139457,139457,139459,0,2,0
39934,5,3,139462,139462,139465,0,3,3
39935,6,2,139468,139468,139470,0,2,3
39936,6,2,139474,139474,139476,0,2,4
39937,5,3,139479,139479,139482,0,3,3
39938,4,3,139483,139483,139486,0,3,1
39939,6,3,139489,139489,139492,0,3,3
39940,4,2,139493,139493,139495,0,2,1
39941,6,1,139499,139499,139500,0,1,4
39942,3,3,139502,139502,139505,0,3,2
39943,3,3,139505,139505,139508,0,3,0
39944,2,2,139507,139508,139510,1,3,0
39945,6,1,139513,139513,139514,0,1,3
39946,5,1,139518,139518,139519,0,1,4
39947,5,2,139523,139523,139525,0,2,4
39948,4,2,139527,139527,139529,0,2,2
39949,4,3,139531,139531,139534,0,3,2
39950,3,3,139534,139534,139537,0,3,0
39951,2,2,139536,139537,139539,1,3,0
39952,4,2,139540,139540,139542,0,2,1
39953,3,1,139543,139543,139544,0,1,1
39954,4,3,139547,139547,139550,0,3,3
39955,2,3,139549,139550,139553,1,4,0
39956,5,1,139554,139554,139555,0,1,1
39957,2,2,139556,139556,139558,0,2,1
39958,1,3,139557,139558,139561,1,4,0
39959,1,2,139558,139561,139563,3,5,0
39960,1,1,139559,139563,139564,4,5,0
39961,6,2,139565,139565,139567,0,2,1
39962,6,2,139571,139571,139573,0,2,4
39963,3,3,139574,139574,139577,0,3,1
39964,2,3,139576,139577,139580,1,4,0
39965,1,3,139577,139580,139583,3,6,0
39966,5,2,139582,139583,139585,1,3,0
39967,1,3,139583,139585,139588,2,5,0
39968,3,1,139586,139588,139589,2,3,0
39969,6,2,139592,139592,139594,0,2,3
39970,2,1,139594,139594,139595,0,1,0
39971,1,1,139595,139595,139596,0,1,0
39972,1,3,139596,139596,139599,0,3,0
39973,6,3,139602,139602,139605,0,3,3
39974,6,3,139608,139608,139611,0,3,3
39975,4,3,139612,139612,139615,0,3,1
39976,6,3,139618,139618,139621,0,3,3
39977,2,1,139620,139621,139622,1,2,0
39978,2,2,139622,139622,139624,0,2,0
39979,3,3,139625,139625,139628,0,3,1
39980,1,3,139626,139628,139631,2,5,0
39981,6,3,139632,139632,139635,0,3,1
39982,6,1,139638,139638,139639,0,1,3
39983,5,2,139643,139643,139645,0,2,4
39984,5,1,139648,139648,139649,0,1,3
39985,3,3,139651,139651,139654,0,3,2
39986,1,2,139652,139654,139656,2,4,0
39987,5,2,139657,139657,139659,0,2,1
39988,4,1,139661,139661,139662,0,1,2
39989,4,3,139665,139665,139668,0,3,3
39990,3,2,139668,139668,139670,0,2,0
39991,3,1,139671,139671,139672,0,1,1
39992,5,1,139676,139676,139677,0,1,4
39993,4,3,139680,139680,139683,0,3,3
39994,5,3,139685,139685,139688,0,3,2
39995,1,1,139686,139688,139689,2,3,0
39996,2,3,139688,139689,139692,1,4,0
39997,2,1,139690,139692,139693,2,3,0
39998,4,2,139694,139694,139696,0,2,1
39999,6,2,139700,139700,139702,0,2,4
40000,6,3,139706,139706,139709,0,3,4
40001,2,1,139708,139709,139710,1,2,0
40002,3,2,139711,139711,139713,0,2,1
40003,6,3,139717,139717,139720,0,3,4
40004,2,1,139719,139720,139721,1,2,0
40005,4,2,139723,139723,139725,0,2,2
40006,4,3,139727,139727,139730,0,3,2
40007,2,2,139729,139730,139732,1,3,0
40008,6,3,139735,139735,139738,0,3,3
40009,4,1,139739,139739,139740,0,1,1
40010,2,1,139741,139741,139742,0,1,1
40011,1,1,139742,139742,139743,0,1,0
40012,2,2,139744,139744,139746,0,2,1
40013,4,2,139748,139748,139750,0,2,2
40014,2,3,139750,139750,139753,0,3,0
40015,5,3,139755,139755,139758,0,3,2
40016,2,3,139757,139758,139761,1,4,0
40017,6,3,139763,139763,139766,0,3,2
40018,1,1,139764,139766,139767,2,3,0
40019,6,2,139770,139770,139772,0,2,3
40020,5,2,139775,139775,139777,0,2,3
40021,5,1,139780,139780,139781,0,1,3
40022,5,3,139785,139785,139788,0,3,4
40023,4,2,139789,139789,139791,0,2,1
40024,3,2,139792,139792,139794,0,2,1
40025,3,1,139795,139795,139796,0,1,1
40026,1,3,139796,139796,139799,0,3,0
40027,5,3,139801,139801,139804,0,3,2
40028,2,2,139803,139804,139806,1,3,0
40029,6,2,139809,139809,139811,0,2,3
40030,4,3,139813,139813,139816,0,3,2
40031,4,3,139817,139817,139820,0,3,1
40032,1,1,139818,139820,139821,2,3,0
40033,2,2,139820,139821,139823,1,3,0
40034,1,1,139821,139823,139824,2,3,0
40035,6,3,139827,139827,139830,0,3,3
40036,5,1,139832,139832,139833,0,1,2
40037,2,3,139834,139834,139837,0,3,1
40038,4,1,139838,139838,139839,0,1,1
40039,1,2,139839,139839,139841,0,2,0
40040,3,1,139842,139842,139843,0,1,1
40041,1,2,139843,139843,139845,0,2,0
40042,5,2,139848,139848,139850,0,2,3
40043,1,3,139849,139850,139853,1,4,0
40044,5,1,139854,139854,139855,0,1,1
40045,1,2,139855,139855,139857,0,2,0
40046,3,2,139858,139858,139860,0,2,1
40047,4,1,139862,139862,139863,0,1,2
40048,6,2,139868,139868,139870,0,2,5
40049,5,3,139873,139873,139876,0,3,3
40050,3,3,139876,139876,139879,0,3,0
40051,6,3,139882,139882,139885,0,3,3
40052,1,1,139883,139885,139886,2,3,0
40053,3,1,139886,139886,139887,0,1,0
40054,2,1,139888,139888,139889,0,1,1
40055,1,1,139889,139889,139890,0,1,0
40056,4,3,139893,139893,139896,0,3,3
40057,1,2,139894,139896,139898,2,4,0
40058,5,2,139899,139899,139901,0,2,1
40059,3,2,139902,139902,139904,0,2,1
40060,3,1,139905,139905,139906,0,1,1
40061,1,3,139906,139906,139909,0,3,0
40062,4,1,139910,139910,139911,0,1,1
40063,6,2,139916,139916,139918,0,2,5
40064,5,2,139921,139921,139923,0,2,3
40065,4,3,139925,139925,139928,0,3,2
40066,2,3,139927,139928,139931,1,4,0
40067,3,1,139930,139931,139932,1,2,0
40068,5,1,139935,139935,139936,0,1,3
40069,4,3,139939,139939,139942,0,3,3
40070,2,1,139941,139942,139943,1,2,0
40071,6,3,139947,139947,139950,0,3,4
40072,5,1,139952,139952,139953,0,1,2
40073,2,2,139954,139954,139956,0,2,1
40074,5,1,139959,139959,139960,0,1,3
40075,4,1,139963,139963,139964,0,1,3
40076,5,3,139968,139968,139971,0,3,4
40077,6,1,139974,139974,139975,0,1,3
40078,1,2,139975,139975,139977,0,2,0
40079,4,1,139979,139979,139980,0,1,2
40080,5,3,139984,139984,139987,0,3,4
40081,2,3,139986,139987,139990,1,4,0
40082,4,3,139990,139990,139993,0,3,0
40083,5,2,139995,139995,139997,0,2,2
40084,6,1,140001,140001,140002,0,1,4
40085,3,3,140004,140004,140007,0,3,2
40086,2,3,140006,140007,140010,1,4,0
40087,4,2,140010,140010,140012,0,2,0
40088,5,3,140015,140015,140018,0,3,3
40089,1,2,140016,140018,140020,2,4,0
40090,1,3,140017,140020,140023,3,6,0
40091,4,1,140021,140023,140024,2,3,0
40092,5,1,140026,140026,140027,0,1,2
40093,6,1,140032,140032,140033,0,1,5
40094,3,2,140035,140035,140037,0,2,2
40095,4,1,140039,140039,140040,0,1,2
40096,2,3,140041,140041,140044,0,3,1
40097,2,1,140043,140044,140045,1,2,0
40098,3,2,140046,140046,140048,0,2,1
40099,4,1,140050,140050,140051,0,1,2
40100,4,1,140054,140054,140055,0,1,3
40101,5,3,140059,140059,140062,0,3,4
40102,5,1,140064,140064,140065,0,1,2
40103,6,3,140070,140070,140073,0,3,5
40104,6,3,140076,140076,140079,0,3,3
40105,2,1,140078,140079,140080,1,2,0
40106,5,2,140083,140083,140085,0,2,3
40107,4,2,140087,140087,140089,0,2,2
40108,4,1,140091,140091,140092,0,1,2
40109,1,1,140092,140092,140093,0,1,0
40110,1,3,140093,140093,140096,0,3,0
40111,1,3,140094,140096,140099,2,5,0
40112,1,2,140095,140099,140101,4,6,0
40113,1,2,140096,140101,140103,5,7,0
40114,2,2,140098,140103,140105,5,7,0
40115,5,1,140103,140105,140106,2,3,0
40116,5,3,140108,140108,140111,0,3,2
40117,5,1,140113,140113,140114,0,1,2
40118,5,3,140118,140118,140121,0,3,4
40119,1,2,140119,140121,140123,2,4,0
40120,4,1,140123,140123,140124,0,1,0
40121,6,3,140129,140129,140132,0,3,5
40122,3,3,140132,140132,140135,0,3,0
40123,2,3,140134,140135,140138,1,4,0
40124,3,1,140137,140138,140139,1,2,0
40125,1,1,140138,140139,140140,1,2,0
40126,4,1,140142,140142,140143,0,1,2
40127,2,1,140144,140144,140145,0,1,1
40128,6,1,140150,140150,140151,0,1,5
40129,4,1,140154,140154,140155,0,1,3
40130,6,1,140160,140160,140161,0,1,5
40131,3,2,140163,140163,140165,0,2,2
40132,3,3,140166,140166,140169,0,3,1
40133,6,3,140172,140172,140175,0,3,3
40134,3,3,140175,140175,140178,0,3,0
40135,1,1,140176,140178,140179,2,3,0
40136,3,2,140179,140179,140181,0,2,0
40137,6,3,140185,140185,140188,0,3,4
40138,3,2,140188,140188,140190,0,2,0
40139,1,1,140189,140190,140191,1,2,0
40140,5,3,140194,140194,140197,0,3,3
40141,5,2,140199,140199,140201,0,2,2
40142,3,1,140202,140202,140203,0,1,1
40143,3,1,140205,140205,140206,0,1,2
40144,2,3,140207,140207,140210,0,3,1
40145,5,1,140212,140212,140213,0,1,2
40146,1,3,140213,140213,140216,0,3,0
40147,4,1,140217,140217,140218,0,1,1
40148,3,1,140220,140220,140221,0,1,2
40149,5,3,140225,140225,140228,0,3,4
40150,2,1,140227,140228,140229,1,2,0
40151,1,2,140228,140229,140231,1,3,0
40152,2,1,140230,140231,140232,1,2,0
40153,3,2,140233,140233,140235,0,2,1
40154,1,3,140234,140235,140238,1,4,0
40155,1,2,140235,140238,140240,3,5,0
40156,5,2,140240,140240,140242,0,2,0
40157,3,3,140243,140243,140246,0,3,1
40158,4,1,140247,140247,140248,0,1,1
40159,6,1,140253,140253,140254,0,1,5
40160,3,3,140256,140256,140259,0,3,2
40161,2,3,140258,140259,140262,1,4,0
40162,4,3,140262,140262,140265,0,3,0
40163,1,2,140263,140265,140267,2,4,0
40164,3,1,140266,140267,140268,1,2,0
40165,5,3,140271,140271,140274,0,3,3
40166,1,3,140272,140274,140277,2,5,0
40167,1,2,140273,140277,140279,4,6,0
40168,2,1,140275,140279,140280,4,5,0
40169,4,3,140279,140280,140283,1,4,0
40170,4,2,140283,140283,140285,0,2,0
40171,5,1,140288,140288,140289,0,1,3
40172,5,2,140293,140293,140295,0,2,4
40173,4,3,140297,140297,140300,0,3,2
40174,2,2,140299,140300,140302,1,3,0
40175,5,3,140304,140304,140307,0,3,2
40176,3,2,140307,140307,140309,0,2,0
40177,6,3,140313,140313,140316,0,3,4
40178,3,2,140316,140316,140318,0,2,0
40179,2,1,140318,140318,140319,0,1,0
40180,2,2,140320,140320,140322,0,2,1
40181,2,2,140322,140322,140324,0,2,0
40182,6,2,140328,140328,140330,0,2,4
40183,2,1,140330,140330,140331,0,1,0
40184,6,3,140336,140336,140339,0,3,5
40185,6,2,140342,140342,140344,0,2,3
40186,2,2,140344,140344,140346,0,2,0
40187,2,2,140346,140346,140348,0,2,0
40188,3,3,140349,140349,140352,0,3,1
40189,5,1,140354,140354,140355,0,1,2
40190,3,3,140357,140357,140360,0,3,2
40191,4,1,140361,140361,140362,0,1,1
40192,6,3,140367,140367,140370,0,3,5
40193,1,2,140368,140370,140372,2,4,0
40194,1,3,140369,140372,140375,3,6,0
40195,1,3,140370,140375,140378,5,8,0
40196,1,1,140371,140378,140379,7,8,0
40197,1,2,140372,140379,140381,7,9,0
40198,4,1,140376,140381,140382,5,6,0
40199,1,3,140377,140382,140385,5,8,0
40200,5,2,140382,140385,140387,3,5,0
40201,4,2,140386,140387,140389,1,3,0
40202,5,2,140391,140391,140393,0,2,2
40203,6,3,140397,140397,140400,0,3,4
40204,2,3,140399,140400,140403,1,4,0
40205,3,1,140402,140403,140404,1,2,0
40206,5,3,140407,140407,140410,0,3,3
40207,5,1,140412,140412,140413,0,1,2
40208,4,3,140416,140416,140419,0,3,3
40209,5,2,140421,140421,140423,0,2,2
40210,3,1,140424,140424,140425,0,1,1
40211,3,3,140427,140427,140430,0,3,2
40212,2,3,140429,140430,140433,1,4,0
40213,1,1,140430,140433,140434,3,4,0
40214,2,3,140432,140434,140437,2,5,0
40215,4,3,140436,140437,140440,1,4,0
40216,5,3,140441,140441,140444,0,3,1
40217,2,1,140443,140444,140445,1,2,0
40218,1,1,140444,140445,140446,1,2,0
40219,4,1,140448,140448,140449,0,1,2
40220,5,3,140453,140453,140456,0,3,4
40221,3,3,140456,140456,140459,0,3,0
40222,6,1,140462,140462,140463,0,1,3
40223,3,3,140465,140465,140468,0,3,2
40224,3,2,140468,140468,140470,0,2,0
40225,5,3,140473,140473,140476,0,3,3
40226,6,2,140479,140479,140481,0,2,3
40227,3,2,140482,140482,140484,0,2,1
40228,4,2,140486,140486,140488,0,2,2
40229,3,2,140489,140489,140491,0,2,1
40230,2,1,140491,140491,140492,0,1,0
40231,6,2,140497,140497,140499,0,2,5
40232,2,2,140499,140499,140501,0,2,0
40233,3,2,140502,140502,140504,0,2,1
40234,5,3,140507,140507,140510,0,3,3
40235,4,2,140511,140511,140513,0,2,1
40236,5,1,140516,140516,140517,0,1,3
40237,5,2,140521,140521,140523,0,2,4
40238,4,1,140525,140525,140526,0,1,2
40239,3,2,140528,140528,140530,0,2,2
40240,5,3,140533,140533,140536,0,3,3
40241,2,3,140535,140536,140539,1,4,0
40242,3,2,140538,140539,140541,1,3,0
40243,2,3,140540,140541,140544,1,4,0
40244,6,1,140546,140546,140547,0,1,2
40245,3,2,140549,140549,140551,0,2,2
40246,1,2,140550,140551,140553,1,3,0
40247,4,2,140554,140554,140556,0,2,1
40248,5,1,140559,140559,140560,0,1,3
40249,2,2,140561,140561,140563,0,2,1
40250,1,1,140562,140563,140564,1,2,0
40251,2,3,140564,140564,140567,0,3,0
40252,6,1,140570,140570,140571,0,1,3
40253,4,1,140574,140574,140575,0,1,3
40254,4,2,140578,140578,140580,0,2,3
40255,2,1,140580,140580,140581,0,1,0
40256,4,2,140584,140584,140586,0,2,3
40257,4,1,140588,140588,140589,0,1,2
40258,5,3,140593,140593,140596,0,3,4
40259,2,2,140595,140596,140598,1,3,0
40260,5,1,140600,140600,140601,0,1,2
40261,6,3,140606,140606,140609,0,3,5
40262,4,1,140610,140610,140611,0,1,1
40263,2,3,140612,140612,140615,0,3,1
40264,4,1,140616,140616,140617,0,1,1
40265,6,2,140622,140622,140624,0,2,5
40266,5,3,140627,140627,140630,0,3,3
40267,5,3,140632,140632,140635,0,3,2
40268,6,3,140638,140638,140641,0,3,3
40269,4,2,140642,140642,140644,0,2,1
40270,2,2,140644,140644,140646,0,2,0
40271,2,2,140646,140646,140648,0,2,0
40272,4,3,140650,140650,140653,0,3,2
40273,6,3,140656,140656,140659,0,3,3
40274,1,3,140657,140659,140662,2,5,0
40275,2,3,140659,140662,140665,3,6,0
40276,3,3,140662,140665,140668,3,6,0
40277,6,1,140668,140668,140669,0,1,0
40278,4,1,140672,140672,140673,0,1,3
40279,3,1,140675,140675,140676,0,1,2
40280,4,2,140679,140679,140681,0,2,3
40281,2,1,140681,140681,140682,0,1,0
40282,4,1,140685,140685,140686,0,1,3
40283,6,3,140691,140691,140694,0,3,5
40284,1,1,140692,140694,140695,2,3,0
40285,1,3,140693,140695,140698,2,5,0
40286,4,1,140697,140698,140699,1,2,0
40287,5,3,140702,140702,140705,0,3,3
40288,1,1,140703,140705,140706,2,3,0
40289,5,2,140708,140708,140710,0,2,2
40290,2,1,140710,140710,140711,0,1,0
40291,2,2,140712,140712,140714,0,2,1
40292,3,3,140715,140715,140718,0,3,1
40293,3,2,140718,140718,140720,0,2,0
40294,6,2,140724,140724,140726,0,2,4
40295,3,1,140727,140727,140728,0,1,1
40296,6,2,140733,140733,140735,0,2,5
40297,3,1,140736,140736,140737,0,1,1
40298,4,3,140740,140740,140743,0,3,3
40299,5,1,140745,140745,140746,0,1,2
40300,3,2,140748,140748,140750,0,2,2
40301,6,2,140754,140754,140756,0,2,4
40302,2,1,140756,140756,140757,0,1,0
40303,5,3,140761,140761,140764,0,3,4
40304,3,3,140764,140764,140767,0,3,0
40305,1,3,140765,140767,140770,2,5,0
40306,2,3,140767,140770,140773,3,6,0
40307,5,1,140772,140773,140774,1,2,0
40308,6,3,140778,140778,140781,0,3,4
40309,3,1,140781,140781,140782,0,1,0
40310,5,2,140786,140786,140788,0,2,4
40311,1,2,140787,140788,140790,1,3,0
40312,5,2,140792,140792,140794,0,2,2
40313,6,2,140798,140798,140800,0,2,4
40314,4,3,140802,140802,140805,0,3,2
40315,2,3,140804,140805,140808,1,4,0
40316,6,2,140810,140810,140812,0,2,2
40317,6,3,140816,140816,140819,0,3,4
40318,4,1,140820,140820,140821,0,1,1
40319,5,2,140825,140825,140827,0,2,4
40320,3,1,140828,140828,140829,0,1,1
40321,3,3,140831,140831,140834,0,3,2
40322,6,3,140837,140837,140840,0,3,3
40323,5,1,140842,140842,140843,0,1,2
40324,3,1,140845,140845,140846,0,1,2
40325,5,3,140850,140850,140853,0,3,4
40326,2,2,140852,140853,140855,1,3,0
40327,3,1,140855,140855,140856,0,1,0
40328,3,1,140858,140858,140859,0,1,2
40329,5,2,140863,140863,140865,0,2,4
40330,5,2,140868,140868,140870,0,2,3
40331,4,1,140872,140872,140873,0,1,2
40332,3,2,140875,140875,140877,0,2,2
40333,4,1,140879,140879,140880,0,1,2
40334,4,3,140883,140883,140886,0,3,3
40335,1,3,140884,140886,140889,2,5,0
40336,1,2,140885,140889,140891,4,6,0
40337,5,1,140890,140891,140892,1,2,0
40338,5,2,140895,140895,140897,0,2,3
40339,6,2,140901,140901,140903,0,2,4
40340,3,2,140904,140904,140906,0,2,1
40341,1,3,140905,140906,140909,1,4,0
40342,5,2,140910,140910,140912,0,2,1
40343,1,1,140911,140912,140913,1,2,0
40344,4,1,140915,140915,140916,0,1,2
40345,5,3,140920,140920,140923,0,3,4
40346,2,1,140922,140923,140924,1,2,0
40347,3,3,140925,140925,140928,0,3,1
40348,6,1,140931,140931,140932,0,1,3
40349,1,3,140932,140932,140935,0,3,0
40350,4,1,140936,140936,140937,0,1,1
40351,6,3,140942,140942,140945,0,3,5
40352,2,1,140944,140945,140946,1,2,0
40353,3,1,140947,140947,140948,0,1,1
40354,2,3,140949,140949,140952,0,3,1
40355,1,1,140950,140952,140953,2,3,0
40356,1,3,140951,140953,140956,2,5,0
40357,2,1,140953,140956,140957,3,4,0
40358,1,1,140954,140957,140958,3,4,0
40359,6,1,140960,140960,140961,0,1,2
40360,4,2,140964,140964,140966,0,2,3
40361,3,1,140967,140967,140968,0,1,1
40362,5,3,140972,140972,140975,0,3,4
40363,2,2,140974,140975,140977,1,3,0
40364,2,3,140976,140977,140980,1,4,0
40365,5,2,140981,140981,140983,0,2,1
40366,5,3,140986,140986,140989,0,3,3
40367,4,3,140990,140990,140993,0,3,1
40368,6,3,140996,140996,140999,0,3,3
40369,4,1,141000,141000,141001,0,1,1
40370,1,2,141001,141001,141003,0,2,0
40371,5,2,141006,141006,141008,0,2,3
40372,1,1,141007,141008,141009,1,2,0
40373,3,2,141010,141010,141012,0,2,1
40374,1,2,141011,141012,141014,1,3,0
40375,2,1,141013,141014,141015,1,2,0
40376,6,2,141019,141019,141021,0,2,4
40377,4,3,141023,141023,141026,0,3,2
40378,6,3,141029,141029,141032,0,3,3
40379,4,3,141033,141033,141036,0,3,1
40380,3,3,141036,141036,141039,0,3,0
40381,6,2,141042,141042,141044,0,2,3
40382,1,3,141043,141044,141047,1,4,0
40383,2,2,141045,141047,141049,2,4,0
40384,6,3,141051,141051,141054,0,3,2
40385,5,3,141056,141056,141059,0,3,2
40386,3,1,141059,141059,141060,0,1,0
40387,4,3,141063,141063,141066,0,3,3
40388,5,3,141068,141068,141071,0,3,2
40389,5,2,141073,141073,141075,0,2,2
40390,2,1,141075,141075,141076,0,1,0
40391,4,1,141079,141079,141080,0,1,3
40392,1,2,141080,141080,141082,0,2,0
40393,5,1,141085,141085,141086,0,1,3
40394,5,1,141090,141090,141091,0,1,4
40395,5,3,141095,141095,141098,0,3,4
40396,5,1,141100,141100,141101,0,1,2
40397,5,1,141105,141105,141106,0,1,4
40398,1,2,141106,141106,141108,0,2,0
40399,4,2,141110,141110,141112,0,2,2
40400,1,3,141111,141112,141115,1,4,0
40401,6,2,141117,141117,141119,0,2,2
40402,6,3,141123,141123,141126,0,3,4
40403,1,1,141124,141126,141127,2,3,0
40404,4,2,141128,141128,141130,0,2,1
40405,6,1,141134,141134,141135,0,1,4
40406,1,3,141135,141135,141138,0,3,0
40407,5,2,141140,141140,141142,0,2,2
40408,1,1,141141,141142,141143,1,2,0
40409,6,3,141147,141147,141150,0,3,4
40410,6,2,141153,141153,141155,0,2,3
40411,4,1,141157,141157,141158,0,1,2
40412,6,2,141163,141163,141165,0,2,5
40413,4,3,141167,141167,141170,0,3,2
40414,4,3,141171,141171,141174,0,3,1
40415,5,1,141176,141176,141177,0,1,2
40416,5,1,141181,141181,141182,0,1,4
40417,2,1,141183,141183,141184,0,1,1
40418,5,1,141188,141188,141189,0,1,4
40419,4,3,141192,141192,141195,0,3,3
40420,1,3,141193,141195,141198,2,5,0
40421,6,3,141199,141199,141202,0,3,1
40422,6,2,141205,141205,141207,0,2,3
40423,3,2,141208,141208,141210,0,2,1
40424,1,2,141209,141210,141212,1,3,0
40425,1,1,141210,141212,141213,2,3,0
40426,6,2,141216,141216,141218,0,2,3
40427,4,1,141220,141220,141221,0,1,2
40428,1,1,141221,141221,141222,0,1,0
40429,5,3,141226,141226,141229,0,3,4
40430,5,1,141231,141231,141232,0,1,2
40431,2,3,141233,141233,141236,0,3,1
40432,6,2,141239,141239,141241,0,2,3
40433,6,1,141245,141245,141246,0,1,4
40434,5,3,141250,141250,141253,0,3,4
40435,3,3,141253,141253,141256,0,3,0
40436,5,2,141258,141258,141260,0,2,2
40437,1,1,141259,141260,141261,1,2,0
40438,6,2,141265,141265,141267,0,2,4
40439,5,1,141270,141270,141271,0,1,3
40440,4,3,141274,141274,141277,0,3,3
40441,5,3,141279,141279,141282,0,3,2
40442,3,1,141282,141282,141283,0,1,0
40443,3,3,141285,141285,141288,0,3,2
40444,5,3,141290,141290,141293,0,3,2
40445,2,2,141292,141293,141295,1,3,0
40446,1,1,141293,141295,141296,2,3,0
40447,3,3,141296,141296,141299,0,3,0
40448,5,1,141301,141301,141302,0,1,2
40449,6,3,141307,141307,141310,0,3,5
40450,3,2,141310,141310,141312,0,2,0
40451,1,1,141311,141312,141313,1,2,0
40452,5,3,141316,141316,141319,0,3,3
40453,5,3,141321,141321,141324,0,3,2
40454,1,1,141322,141324,141325,2,3,0
40455,1,2,141323,141325,141327,2,4,0
40456,1,1,141324,141327,141328,3,4,0
40457,5,2,141329,141329,141331,0,2,1
40458,1,1,141330,141331,141332,1,2,0
40459,4,2,141334,141334,141336,0,2,2
40460,4,2,141338,141338,141340,0,2,2
40461,2,2,141340,141340,141342,0,2,0
40462,1,2,141341,141342,141344,1,3,0
40463,6,3,141347,141347,141350,0,3,3
40464,5,1,141352,141352,141353,0,1,2
40465,4,1,141356,141356,141357,0,1,3
40466,3,2,141359,141359,141361,0,2,2
40467,4,3,141363,141363,141366,0,3,2
40468,4,2,141367,141367,141369,0,2,1
40469,3,2,141370,141370,141372,0,2,1
40470,6,1,141376,141376,141377,0,1,4
40471,1,2,141377,141377,141379,0,2,0
40472,5,1,141382,141382,141383,0,1,3
40473,3,2,141385,141385,141387,0,2,2
40474,2,3,141387,141387,141390,0,3,0
40475,1,3,141388,141390,141393,2,5,0
40476,4,1,141392,141393,141394,1,2,0
40477,5,2,141397,141397,141399,0,2,3
40478,3,3,141400,141400,141403,0,3,1
40479,4,2,141404,141404,141406,0,2,1
40480,2,1,141406,141406,141407,0,1,0
40481,1,3,141407,141407,141410,0,3,0
40482,1,1,141408,141410,141411,2,3,0
40483,4,2,141412,141412,141414,0,2,1
40484,6,1,141418,141418,141419,0,1,4
40485,6,2,141424,141424,141426,0,2,5
40486,5,3,141429,141429,141432,0,3,3
40487,3,3,141432,141432,141435,0,3,0
40488,1,3,141433,141435,141438,2,5,0
40489,2,2,141435,141438,141440,3,5,0
40490,6,2,141441,141441,141443,0,2,1
40491,3,2,141444,141444,141446,0,2,1
40492,1,3,141445,141446,141449,1,4,0
40493,6,2,141451,141451,141453,0,2,2
40494,4,1,141455,141455,141456,0,1,2
40495,3,1,141458,141458,141459,0,1,2
40496,4,1,141462,141462,141463,0,1,3
40497,5,2,141467,141467,141469,0,2,4
40498,3,3,141470,141470,141473,0,3,1
40499,6,2,141476,141476,141478,0,2,3
40500,6,1,141482,141482,141483,0,1,4
40501,5,1,141487,141487,141488,0,1,4
40502,2,2,141489,141489,141491,0,2,1
40503,2,3,141491,141491,141494,0,3,0
40504,4,3,141495,141495,141498,0,3,1
40505,2,2,141497,141498,141500,1,3,0
40506,2,2,141499,141500,141502,1,3,0
40507,5,1,141504,141504,141505,0,1,2
40508,2,3,141506,141506,141509,0,3,1
40509,4,1,141510,141510,141511,0,1,1
40510,6,2,141516,141516,141518,0,2,5
40511,6,2,141522,141522,141524,0,2,4
40512,3,3,141525,141525,141528,0,3,1
40513,6,1,141531,141531,141532,0,1,3
40514,1,3,141532,141532,141535,0,3,0
40515,6,2,141538,141538,141540,0,2,3
40516,4,1,141542,141542,141543,0,1,2
40517,3,3,141545,141545,141548,0,3,2
40518,1,1,141546,141548,141549,2,3,0
40519,4,2,141550,141550,141552,0,2,1
40520,5,2,141555,141555,141557,0,2,3
40521,2,2,141557,141557,141559,0,2,0
40522,4,3,141561,141561,141564,0,3,2
40523,4,3,141565,141565,141568,0,3,1
40524,5,1,141570,141570,141571,0,1,2
40525,1,3,141571,141571,141574,0,3,0
40526,4,3,141575,141575,141578,0,3,1
40527,5,2,141580,141580,141582,0,2,2
40528,3,2,141583,141583,141585,0,2,1
40529,6,1,141589,141589,141590,0,1,4
40530,4,2,141593,141593,141595,0,2,3
40531,6,2,141599,141599,141601,0,2,4
40532,4,2,141603,141603,141605,0,2,2
40533,1,2,141604,141605,141607,1,3,0
40534,6,3,141610,141610,141613,0,3,3
40535,2,3,141612,141613,141616,1,4,0
40536,1,3,141613,141616,141619,3,6,0
40537,4,2,141617,141619,141621,2,4,0
40538,5,1,141622,141622,141623,0,1,1
40539,6,2,141628,141628,141630,0,2,5
40540,5,2,141633,141633,141635,0,2,3
40541,5,2,141638,141638,141640,0,2,3
40542,2,2,141640,141640,141642,0,2,0
40543,4,3,141644,141644,141647,0,3,2
40544,6,2,141650,141650,141652,0,2,3
40545,2,1,141652,141652,141653,0,1,0
40546,5,3,141657,141657,141660,0,3,4
40547,6,3,141663,141663,141666,0,3,3
40548,4,2,141667,141667,141669,0,2,1
40549,2,3,141669,141669,141672,0,3,0
40550,2,3,141671,141672,141675,1,4,0
40551,2,2,141673,141675,141677,2,4,0
40552,2,2,141675,141677,141679,2,4,0
40553,5,1,141680,141680,141681,0,1,1
40554,6,1,141686,141686,141687,0,1,5
40555,5,2,141691,141691,141693,0,2,4
40556,2,2,141693,141693,141695,0,2,0
40557,3,2,141696,141696,141698,0,2,1
40558,3,1,141699,141699,141700,0,1,1
40559,6,3,141705,141705,141708,0,3,5
40560,1,1,141706,141708,141709,2,3,0
40561,1,1,141707,141709,141710,2,3,0
40562,5,2,141712,141712,141714,0,2,2
40563,1,3,141713,141714,141717,1,4,0
40564,6,1,141719,141719,141720,0,1,2
40565,3,1,141722,141722,141723,0,1,2
40566,6,3,141728,141728,141731,0,3,5
40567,4,1,141732,141732,141733,0,1,1
40568,6,2,141738,141738,141740,0,2,5
40569,3,2,141741,141741,141743,0,2,1
40570,6,1,141747,141747,141748,0,1,4
40571,5,2,141752,141752,141754,0,2,4
40572,6,1,141758,141758,141759,0,1,4
40573,5,2,141763,141763,141765,0,2,4
40574,6,1,141769,141769,141770,0,1,4
40575,2,3,141771,141771,141774,0,3,1
40576,4,2,141775,141775,141777,0,2,1
40577,4,2,141779,141779,141781,0,2,2
40578,1,2,141780,141781,141783,1,3,0
40579,1,2,141781,141783,141785,2,4,0
40580,5,1,141786,141786,141787,0,1,1
40581,5,3,141791,141791,141794,0,3,4
40582,3,2,141794,141794,141796,0,2,0
40583,5,1,141799,141799,141800,0,1,3
40584,1,2,141800,141800,141802,0,2,0
40585,1,2,141801,141802,141804,1,3,0
40586,3,1,141804,141804,141805,0,1,0
40587,5,2,141809,141809,141811,0,2,4
40588,4,1,141813,141813,141814,0,1,2
40589,2,3,141815,141815,141818,0,3,1
40590,6,1,141821,141821,141822,0,1,3
40591,6,3,141827,141827,141830,0,3,5
40592,3,2,141830,141830,141832,0,2,0
40593,6,1,141836,141836,141837,0,1,4
40594,2,3,141838,141838,141841,0,3,1
40595,5,1,141843,141843,141844,0,1,2
40596,2,3,141845,141845,141848,0,3,1
40597,5,2,141850,141850,141852,0,2,2
40598,6,1,141856,141856,141857,0,1,4
40599,6,2,141862,141862,141864,0,2,5
40600,5,2,141867,141867,141869,0,2,3
40601,3,1,141870,141870,141871,0,1,1
40602,1,2,141871,141871,141873,0,2,0
40603,2,2,141873,141873,141875,0,2,0
40604,1,1,141874,141875,141876,1,2,0
40605,3,1,141877,141877,141878,0,1,1
40606,3,3,141880,141880,141883,0,3,2
40607,3,3,141883,141883,141886,0,3,0
40608,4,1,141887,141887,141888,0,1,1
40609,4,3,141891,141891,141894,0,3,3
40610,2,1,141893,141894,141895,1,2,0
40611,3,2,141896,141896,141898,0,2,1
40612,3,3,141899,141899,141902,0,3,1
40613,2,2,141901,141902,141904,1,3,0
40614,1,1,141902,141904,141905,2,3,0
40615,1,1,141903,141905,141906,2,3,0
40616,5,2,141908,141908,141910,0,2,2
40617,2,2,141910,141910,141912,0,2,0
40618,3,1,141913,141913,141914,0,1,1
40619,1,1,141914,141914,141915,0,1,0
40620,5,1,141919,141919,141920,0,1,4
40621,5,1,141924,141924,141925,0,1,4
40622,1,2,141925,141925,141927,0,2,0
40623,5,3,141930,141930,141933,0,3,3
40624,3,3,141933,141933,141936,0,3,0
40625,1,1,141934,141936,141937,2,3,0
40626,3,1,141937,141937,141938,0,1,0
40627,6,2,141943,141943,141945,0,2,5
40628,4,1,141947,141947,141948,0,1,2
40629,4,1,141951,141951,141952,0,1,3
40630,4,1,141955,141955,141956,0,1,3
40631,6,1,141961,141961,141962,0,1,5
40632,1,2,141962,141962,141964,0,2,0
40633,5,2,141967,141967,141969,0,2,3
40634,1,2,141968,141969,141971,1,3,0
40635,5,3,141973,141973,141976,0,3,2
40636,6,3,141979,141979,141982,0,3,3
40637,1,1,141980,141982,141983,2,3,0
40638,1,1,141981,141983,141984,2,3,0
40639,3,1,141984,141984,141985,0,1,0
40640,4,1,141988,141988,141989,0,1,3
40641,3,2,141991,141991,141993,0,2,2
40642,3,3,141994,141994,141997,0,3,1
40643,1,3,141995,141997,142000,2,5,0
40644,5,3,142000,142000,142003,0,3,0
40645,5,2,142005,142005,142007,0,2,2
40646,2,3,142007,142007,142010,0,3,0
40647,2,3,142009,142010,142013,1,4,0
40648,1,3,142010,142013,142016,3,6,0
40649,4,3,142014,142016,142019,2,5,0
40650,3,1,142017,142019,142020,2,3,0
40651,3,1,142020,142020,142021,0,1,0
40652,3,2,142023,142023,142025,0,2,2
40653,5,3,142028,142028,142031,0,3,3
40654,4,1,142032,142032,142033,0,1,1
40655,6,3,142038,142038,142041,0,3,5
40656,1,1,142039,142041,142042,2,3,0
40657,5,2,142044,142044,142046,0,2,2
40658,6,1,142050,142050,142051,0,1,4
40659,6,2,142056,142056,142058,0,2,5
40660,1,2,142057,142058,142060,1,3,0
40661,1,3,142058,142060,142063,2,5,0
40662,5,1,142063,142063,142064,0,1,0
40663,2,1,142065,142065,142066,0,1,1
40664,2,2,142067,142067,142069,0,2,1
40665,1,1,142068,142069,142070,1,2,0
40666,6,2,142074,142074,142076,0,2,4
40667,2,2,142076,142076,142078,0,2,0
40668,5,2,142081,142081,142083,0,2,3
40669,1,1,142082,142083,142084,1,2,0
40670,2,2,142084,142084,142086,0,2,0
40671,5,1,142089,142089,142090,0,1,3
40672,2,3,142091,142091,142094,0,3,1
40673,4,2,142095,142095,142097,0,2,1
40674,6,2,142101,142101,142103,0,2,4
40675,4,2,142105,142105,142107,0,2,2
40676,4,3,142109,142109,142112,0,3,2
40677,3,2,142112,142112,142114,0,2,0
40678,5,3,142117,142117,142120,0,3,3
40679,3,3,142120,142120,142123,0,3,0
40680,1,1,142121,142123,142124,2,3,0
40681,5,2,142126,142126,142128,0,2,2
40682,1,2,142127,142128,142130,1,3,0
40683,6,3,142133,142133,142136,0,3,3
40684,6,3,142139,142139,142142,0,3,3
40685,2,2,142141,142142,142144,1,3,0
40686,6,1,142147,142147,142148,0,1,3
40687,3,2,142150,142150,142152,0,2,2
40688,5,2,142155,142155,142157,0,2,3
40689,5,3,142160,142160,142163,0,3,3
40690,4,3,142164,142164,142167,0,3,1
40691,2,2,142166,142167,142169,1,3,0
40692,1,1,142167,142169,142170,2,3,0
40693,2,3,142169,142170,142173,1,4,0
40694,6,2,142175,142175,142177,0,2,2
40695,3,3,142178,142178,142181,0,3,1
40696,4,3,142182,142182,142185,0,3,1
40697,6,2,142188,142188,142190,0,2,3
40698,1,2,142189,142190,142192,1,3,0
40699,2,2,142191,142192,142194,1,3,0
40700,6,3,142197,142197,142200,0,3,3
40701,5,1,142202,142202,142203,0,1,2
40702,6,2,142208,142208,142210,0,2,5
40703,5,3,142213,142213,142216,0,3,3
40704,5,1,142218,142218,142219,0,1,2
40705,2,3,142220,142220,142223,0,3,1
40706,2,3,142222,142223,142226,1,4,0
40707,1,1,142223,142226,142227,3,4,0
40708,4,2,142227,142227,142229,0,2,0
40709,6,2,142233,142233,142235,0,2,4
40710,4,3,142237,142237,142240,0,3,2
40711,2,2,142239,142240,142242,1,3,0
40712,6,3,142245,142245,142248,0,3,3
40713,6,2,142251,142251,142253,0,2,3
40714,1,2,142252,142253,142255,1,3,0
40715,4,1,142256,142256,142257,0,1,1
40716,3,1,142259,142259,142260,0,1,2
40717,3,2,142262,142262,142264,0,2,2
40718,4,1,142266,142266,142267,0,1,2
40719,3,2,142269,142269,142271,0,2,2
40720,5,1,142274,142274,142275,0,1,3
40721,5,3,142279,142279,142282,0,3,4
40722,5,2,142284,142284,142286,0,2,2
40723,1,1,142285,142286,142287,1,2,0
40724,4,3,142289,142289,142292,0,3,2
40725,5,1,142294,142294,142295,0,1,2
40726,1,2,142295,142295,142297,0,2,0
40727,6,2,142301,142301,142303,0,2,4
40728,2,2,142303,142303,142305,0,2,0
40729,3,1,142306,142306,142307,0,1,1
40730,5,1,142311,142311,142312,0,1,4
40731,2,1,142313,142313,142314,0,1,1
40732,4,3,142317,142317,142320,0,3,3
40733,1,3,142318,142320,142323,2,5,0
40734,3,2,142321,142323,142325,2,4,0
40735,1,1,142322,142325,142326,3,4,0
40736,1,2,142323,142326,142328,3,5,0
40737,5,1,142328,142328,142329,0,1,0
40738,4,2,142332,142332,142334,0,2,3
40739,1,2,142333,142334,142336,1,3,0
40740,5,3,142338,142338,142341,0,3,2
40741,2,3,142340,142341,142344,1,4,0
40742,2,2,142342,142344,142346,2,4,0
40743,3,1,142345,142346,142347,1,2,0
40744,2,1,142347,142347,142348,0,1,0
40745,4,3,142351,142351,142354,0,3,3
40746,2,1,142353,142354,142355,1,2,0
40747,5,1,142358,142358,142359,0,1,3
40748,5,1,142363,142363,142364,0,1,4
40749,4,1,142367,142367,142368,0,1,3
40750,3,3,142370,142370,142373,0,3,2
40751,1,2,142371,142373,142375,2,4,0
40752,5,3,142376,142376,142379,0,3,1
40753,6,2,142382,142382,142384,0,2,3
40754,4,1,142386,142386,142387,0,1,2
40755,4,2,142390,142390,142392,0,2,3
40756,3,2,142393,142393,142395,0,2,1
40757,3,3,142396,142396,142399,0,3,1
40758,1,1,142397,142399,142400,2,3,0
40759,5,3,142402,142402,142405,0,3,2
40760,6,2,142408,142408,142410,0,2,3
40761,4,2,142412,142412,142414,0,2,2
40762,2,1,142414,142414,142415,0,1,0
40763,3,1,142417,142417,142418,0,1,2
40764,2,1,142419,142419,142420,0,1,1
40765,6,1,142425,142425,142426,0,1,5
40766,5,2,142430,142430,142432,0,2,4
40767,6,3,142436,142436,142439,0,3,4
40768,1,2,142437,142439,142441,2,4,0
40769,4,2,142441,142441,142443,0,2,0
40770,1,3,142442,142443,142446,1,4,0
40771,6,1,142448,142448,142449,0,1,2
40772,4,1,142452,142452,142453,0,1,3
40773,4,3,142456,142456,142459,0,3,3
40774,6,2,142462,142462,142464,0,2,3
40775,2,3,142464,142464,142467,0,3,0
40776,4,1,142468,142468,142469,0,1,1
40777,1,2,142469,142469,142471,0,2,0
40778,4,3,142473,142473,142476,0,3,2
40779,2,3,142475,142476,142479,1,4,0
40780,4,1,142479,142479,142480,0,1,0
40781,3,2,142482,142482,142484,0,2,2
40782,3,2,142485,142485,142487,0,2,1
40783,1,2,142486,142487,142489,1,3,0
40784,6,1,142492,142492,142493,0,1,3
40785,5,1,142497,142497,142498,0,1,4
40786,4,3,142501,142501,142504,0,3,3
40787,4,2,142505,142505,142507,0,2,1
40788,6,1,142511,142511,142512,0,1,4
40789,1,3,142512,142512,142515,0,3,0
40790,2,3,142514,142515,142518,1,4,0
40791,1,1,142515,142518,142519,3,4,0
40792,1,2,142516,142519,142521,3,5,0
40793,4,1,142520,142521,142522,1,2,0
40794,2,3,142522,142522,142525,0,3,0
40795,3,1,142525,142525,142526,0,1,0
40796,3,2,142528,142528,142530,0,2,2
40797,1,2,142529,142530,142532,1,3,0
40798,3,2,142532,142532,142534,0,2,0
40799,3,3,142535,142535,142538,0,3,1
40800,2,1,142537,142538,142539,1,2,0
40801,2,1,142539,142539,142540,0,1,0
40802,3,3,142542,142542,142545,0,3,2
40803,4,2,142546,142546,142548,0,2,1
40804,1,2,142547,142548,142550,1,3,0
40805,5,3,142552,142552,142555,0,3,2
40806,1,2,142553,142555,142557,2,4,0
40807,1,2,142554,142557,142559,3,5,0
40808,3,2,142557,142559,142561,2,4,0
40809,5,2,142562,142562,142564,0,2,1
40810,2,3,142564,142564,142567,0,3,0
40811,2,1,142566,142567,142568,1,2,0
40812,6,1,142572,142572,142573,0,1,4
40813,6,1,142578,142578,142579,0,1,5
40814,4,3,142582,142582,142585,0,3,3
40815,5,1,142587,142587,142588,0,1,2
40816,1,2,142588,142588,142590,0,2,0
40817,3,1,142591,142591,142592,0,1,1
40818,5,3,142596,142596,142599,0,3,4
40819,3,2,142599,142599,142601,0,2,0
40820,2,1,142601,142601,142602,0,1,0
40821,4,3,142605,142605,142608,0,3,3
40822,2,1,142607,142608,142609,1,2,0
40823,2,2,142609,142609,142611,0,2,0
40824,3,2,142612,142612,142614,0,2,1
40825,6,3,142618,142618,142621,0,3,4
40826,2,2,142620,142621,142623,1,3,0
40827,4,2,142624,142624,142626,0,2,1
40828,6,1,142630,142630,142631,0,1,4
40829,6,3,142636,142636,142639,0,3,5
40830,1,3,142637,142639,142642,2,5,0
40831,5,1,142642,142642,142643,0,1,0
40832,6,3,142648,142648,142651,0,3,5
40833,5,1,142653,142653,142654,0,1,2
40834,5,3,142658,142658,142661,0,3,4
40835,6,3,142664,142664,142667,0,3,3
40836,4,2,142668,142668,142670,0,2,1
40837,6,2,142674,142674,142676,0,2,4
40838,4,1,142678,142678,142679,0,1,2
40839,3,2,142681,142681,142683,0,2,2
40840,1,2,142682,142683,142685,1,3,0
40841,6,2,142688,142688,142690,0,2,3
40842,1,1,142689,142690,142691,1,2,0
40843,3,2,142692,142692,142694,0,2,1
40844,1,3,142693,142694,142697,1,4,0
40845,4,2,142697,142697,142699,0,2,0
40846,2,3,142699,142699,142702,0,3,0
40847,1,1,142700,142702,142703,2,3,0
40848,3,1,142703,142703,142704,0,1,0
40849,4,1,142707,142707,142708,0,1,3
40850,4,1,142711,142711,142712,0,1,3
40851,1,1,142712,142712,142713,0,1,0
40852,4,1,142716,142716,142717,0,1,3
40853,3,3,142719,142719,142722,0,3,2
40854,5,3,142724,142724,142727,0,3,2
40855,3,1,142727,142727,142728,0,1,0
40856,5,2,142732,142732,142734,0,2,4
40857,5,2,142737,142737,142739,0,2,3
40858,2,1,142739,142739,142740,0,1,0
40859,2,2,142741,142741,142743,0,2,1
40860,6,3,142747,142747,142750,0,3,4
40861,5,3,142752,142752,142755,0,3,2
40862,3,1,142755,142755,142756,0,1,0
40863,3,2,142758,142758,142760,0,2,2
40864,6,2,142764,142764,142766,0,2,4
40865,5,3,142769,142769,142772,0,3,3
40866,5,2,142774,142774,142776,0,2,2
40867,1,2,142775,142776,142778,1,3,0
40868,1,2,142776,142778,142780,2,4,0
40869,2,2,142778,142780,142782,2,4,0
40870,4,3,142782,142782,142785,0,3,0
40871,4,1,142786,142786,142787,0,1,1
40872,5,3,142791,142791,142794,0,3,4
40873,3,1,142794,142794,142795,0,1,0
40874,2,2,142796,142796,142798,0,2,1
40875,3,2,142799,142799,142801,0,2,1
40876,2,2,142801,142801,142803,0,2,0
40877,3,2,142804,142804,142806,0,2,1
40878,3,1,142807,142807,142808,0,1,1
40879,3,3,142810,142810,142813,0,3,2
40880,1,3,142811,142813,142816,2,5,0
40881,2,2,142813,142816,142818,3,5,0
40882,4,1,142817,142818,142819,1,2,0
40883,5,1,142822,142822,142823,0,1,3
40884,6,1,142828,142828,142829,0,1,5
40885,1,1,142829,142829,142830,0,1,0
40886,5,3,142834,142834,142837,0,3,4
40887,4,2,142838,142838,142840,0,2,1
40888,4,3,142842,142842,142845,0,3,2
40889,3,1,142845,142845,142846,0,1,0
40890,2,1,142847,142847,142848,0,1,1
40891,2,2,142849,142849,142851,0,2,1
40892,6,3,142855,142855,142858,0,3,4
40893,1,1,142856,142858,142859,2,3,0
40894,4,3,142860,142860,142863,0,3,1
40895,6,1,142866,142866,142867,0,1,3
40896,2,2,142868,142868,142870,0,2,1
40897,6,1,142874,142874,142875,0,1,4
40898,3,3,142877,142877,142880,0,3,2
40899,1,1,142878,142880,142881,2,3,0
40900,5,3,142883,142883,142886,0,3,2
40901,5,1,142888,142888,142889,0,1,2
40902,5,3,142893,142893,142896,0,3,4
40903,6,3,142899,142899,142902,0,3,3
40904,1,1,142900,142902,142903,2,3,0
40905,1,2,142901,142903,142905,2,4,0
40906,5,2,142906,142906,142908,0,2,1
40907,6,1,142912,142912,142913,0,1,4
40908,3,2,142915,142915,142917,0,2,2
40909,1,2,142916,142917,142919,1,3,0
40910,6,2,142922,142922,142924,0,2,3
40911,4,1,142926,142926,142927,0,1,2
40912,6,2,142932,142932,142934,0,2,5
40913,2,3,142934,142934,142937,0,3,0
40914,3,2,142937,142937,142939,0,2,0
40915,3,2,142940,142940,142942,0,2,1
40916,3,3,142943,142943,142946,0,3,1
40917,2,3,142945,142946,142949,1,4,0
40918,4,3,142949,142949,142952,0,3,0
40919,6,2,142955,142955,142957,0,2,3
40920,6,1,142961,142961,142962,0,1,4
40921,1,1,142962,142962,142963,0,1,0
40922,4,3,142966,142966,142969,0,3,3
40923,2,3,142968,142969,142972,1,4,0
40924,2,3,142970,142972,142975,2,5,0
40925,5,1,142975,142975,142976,0,1,0
40926,2,3,142977,142977,142980,0,3,1
40927,4,2,142981,142981,142983,0,2,1
40928,1,2,142982,142983,142985,1,3,0
40929,5,3,142987,142987,142990,0,3,2
40930,2,2,142989,142990,142992,1,3,0
40931,5,1,142994,142994,142995,0,1,2
40932,3,3,142997,142997,143000,0,3,2
40933,4,1,143001,143001,143002,0,1,1
40934,2,3,143003,143003,143006,0,3,1
40935,3,1,143006,143006,143007,0,1,0
40936,5,2,143011,143011,143013,0,2,4
40937,1,3,143012,143013,143016,1,4,0
40938,6,1,143018,143018,143019,0,1,2
40939,1,2,143019,143019,143021,0,2,0
40940,3,2,143022,143022,143024,0,2,1
40941,5,2,143027,143027,143029,0,2,3
40942,4,3,143031,143031,143034,0,3,2
40943,6,1,143037,143037,143038,0,1,3
40944,2,1,143039,143039,143040,0,1,1
40945,6,1,143045,143045,143046,0,1,5
40946,6,3,143051,143051,143054,0,3,5
40947,2,2,143053,143054,143056,1,3,0
40948,1,3,143054,143056,143059,2,5,0
40949,2,2,143056,143059,143061,3,5,0
40950,3,2,143059,143061,143063,2,4,0
40951,1,2,143060,143063,143065,3,5,0
40952,5,1,143065,143065,143066,0,1,0
40953,1,3,143066,143066,143069,0,3,0
40954,1,3,143067,143069,143072,2,5,0
40955,5,2,143072,143072,143074,0,2,0
40956,2,1,143074,143074,143075,0,1,0
40957,6,2,143080,143080,143082,0,2,5
40958,3,2,143083,143083,143085,0,2,1
40959,6,3,143089,143089,143092,0,3,4
40960,6,1,143095,143095,143096,0,1,3
40961,1,1,143096,143096,143097,0,1,0
40962,4,2,143100,143100,143102,0,2,3
40963,4,3,143104,143104,143107,0,3,2
40964,2,3,143106,143107,143110,1,4,0
40965,5,2,143111,143111,143113,0,2,1
40966,5,3,143116,143116,143119,0,3,3
40967,5,3,143121,143121,143124,0,3,2
40968,5,2,143126,143126,143128,0,2,2
40969,4,2,143130,143130,143132,0,2,2
40970,4,3,143134,143134,143137,0,3,2
40971,1,1,143135,143137,143138,2,3,0
40972,5,1,143140,143140,143141,0,1,2
40973,2,2,143142,143142,143144,0,2,1
40974,2,2,143144,143144,143146,0,2,0
40975,5,3,143149,143149,143152,0,3,3
40976,3,2,143152,143152,143154,0,2,0
40977,2,3,143154,143154,143157,0,3,0
40978,2,2,143156,143157,143159,1,3,0
40979,6,1,143162,143162,143163,0,1,3
40980,6,3,143168,143168,143171,0,3,5
40981,6,2,143174,143174,143176,0,2,3
40982,5,3,143179,143179,143182,0,3,3
40983,2,3,143181,143182,143185,1,4,0
40984,5,1,143186,143186,143187,0,1,1
40985,2,3,143188,143188,143191,0,3,1
40986,6,2,143194,143194,143196,0,2,3
40987,6,3,143200,143200,143203,0,3,4
40988,3,3,143203,143203,143206,0,3,0
40989,4,3,143207,143207,143210,0,3,1
40990,1,3,143208,143210,143213,2,5,0
40991,2,3,143210,143213,143216,3,6,0
40992,6,2,143216,143216,143218,0,2,0
40993,4,1,143220,143220,143221,0,1,2
40994,3,3,143223,143223,143226,0,3,2
40995,4,1,143227,143227,143228,0,1,1
40996,1,1,143228,143228,143229,0,1,0
40997,1,3,143229,143229,143232,0,3,0
40998,4,2,143233,143233,143235,0,2,1
40999,5,1,143238,143238,143239,0,1,3
41000,6,2,143244,143244,143246,0,2,5
41001,4,1,143248,143248,143249,0,1,2
41002,1,1,143249,143249,143250,0,1,0
41003,1,1,143250,143250,143251,0,1,0
41004,6,2,143256,143256,143258,0,2,5
41005,5,3,143261,143261,143264,0,3,3
41006,6,3,143267,143267,143270,0,3,3
41007,3,2,143270,143270,143272,0,2,0
41008,5,2,143275,143275,143277,0,2,3
41009,6,3,143281,143281,143284,0,3,4
41010,6,1,143287,143287,143288,0,1,3
41011,5,1,143292,143292,143293,0,1,4
41012,3,1,143295,143295,143296,0,1,2
41013,1,2,143296,143296,143298,0,2,0
41014,5,3,143301,143301,143304,0,3,3
41015,2,2,143303,143304,143306,1,3,0
41016,2,2,143305,143306,143308,1,3,0
41017,5,2,143310,143310,143312,0,2,2
41018,5,1,143315,143315,143316,0,1,3
41019,2,1,143317,143317,143318,0,1,1
41020,6,2,143323,143323,143325,0,2,5
41021,2,2,143325,143325,143327,0,2,0
41022,5,3,143330,143330,143333,0,3,3
41023,6,3,143336,143336,143339,0,3,3
41024,3,1,143339,143339,143340,0,1,0
41025,1,3,143340,143340,143343,0,3,0
41026,3,2,143343,143343,143345,0,2,0
41027,5,2,143348,143348,143350,0,2,3
41028,4,1,143352,143352,143353,0,1,2
41029,6,1,143358,143358,143359,0,1,5
41030,2,3,143360,143360,143363,0,3,1
41031,6,3,143366,143366,143369,0,3,3
41032,6,2,143372,143372,143374,0,2,3
41033,4,1,143376,143376,143377,0,1,2
41034,5,3,143381,143381,143384,0,3,4
41035,2,3,143383,143384,143387,1,4,0
41036,2,2,143385,143387,143389,2,4,0
41037,6,2,143391,143391,143393,0,2,2
41038,6,3,143397,143397,143400,0,3,4
41039,5,2,143402,143402,143404,0,2,2
41040,3,1,143405,143405,143406,0,1,1
41041,5,1,143410,143410,143411,0,1,4
41042,1,1,143411,143411,143412,0,1,0
41043,5,2,143416,143416,143418,0,2,4
41044,6,2,143422,143422,143424,0,2,4
41045,5,3,143427,143427,143430,0,3,3
41046,5,1,143432,143432,143433,0,1,2
41047,1,1,143433,143433,143434,0,1,0
41048,3,1,143436,143436,143437,0,1,2
41049,6,1,143442,143442,143443,0,1,5
41050,6,2,143448,143448,143450,0,2,5
41051,1,3,143449,143450,143453,1,4,0
41052,3,2,143452,143453,143455,1,3,0
41053,2,1,143454,143455,143456,1,2,0
41054,2,3,143456,143456,143459,0,3,0
41055,4,2,143460,143460,143462,0,2,1
41056,2,2,143462,143462,143464,0,2,0
41057,3,3,143465,143465,143468,0,3,1
41058,1,2,143466,143468,143470,2,4,0
41059,4,1,143470,143470,143471,0,1,0
41060,4,2,143474,143474,143476,0,2,3
41061,3,3,143477,143477,143480,0,3,1
41062,5,2,143482,143482,143484,0,2,2
41063,4,2,143486,143486,143488,0,2,2
41064,1,3,143487,143488,143491,1,4,0
41065,2,1,143489,143491,143492,2,3,0
41066,1,3,143490,143492,143495,2,5,0
41067,4,1,143494,143495,143496,1,2,0
41068,2,3,143496,143496,143499,0,3,0
41069,5,3,143501,143501,143504,0,3,2
41070,3,3,143504,143504,143507,0,3,0
41071,2,3,143506,143507,143510,1,4,0
41072,4,2,143510,143510,143512,0,2,0
41073,5,3,143515,143515,143518,0,3,3
41074,1,1,143516,143518,143519,2,3,0
41075,1,2,143517,143519,143521,2,4,0
41076,6,1,143523,143523,143524,0,1,2
41077,5,2,143528,143528,143530,0,2,4
41078,1,3,143529,143530,143533,1,4,0
41079,2,1,143531,143533,143534,2,3,0
41080,4,2,143535,143535,143537,0,2,1
41081,3,1,143538,143538,143539,0,1,1
41082,3,3,143541,143541,143544,0,3,2
41083,6,1,143547,143547,143548,0,1,3
41084,2,2,143549,143549,143551,0,2,1
41085,4,3,143553,143553,143556,0,3,2
41086,3,2,143556,143556,143558,0,2,0
41087,4,3,143560,143560,143563,0,3,2
41088,4,2,143564,143564,143566,0,2,1
41089,4,3,143568,143568,143571,0,3,2
41090,4,1,143572,143572,143573,0,1,1
41091,1,2,143573,143573,143575,0,2,0
41092,1,3,143574,143575,143578,1,4,0
41093,2,3,143576,143578,143581,2,5,0
41094,2,2,143578,143581,143583,3,5,0
41095,5,2,143583,143583,143585,0,2,0
41096,3,3,143586,143586,143589,0,3,1
41097,6,2,143592,143592,143594,0,2,3
41098,6,1,143598,143598,143599,0,1,4
41099,5,3,143603,143603,143606,0,3,4
41100,4,1,143607,143607,143608,0,1,1
41101,5,2,143612,143612,143614,0,2,4
41102,6,2,143618,143618,143620,0,2,4
41103,5,1,143623,143623,143624,0,1,3
41104,2,3,143625,143625,143628,0,3,1
41105,6,1,143631,143631,143632,0,1,3
41106,2,1,143633,143633,143634,0,1,1
41107,4,3,143637,143637,143640,0,3,3
41108,3,1,143640,143640,143641,0,1,0
41109,1,2,143641,143641,143643,0,2,0
41110,6,1,143647,143647,143648,0,1,4
41111,3,1,143650,143650,143651,0,1,2
41112,5,1,143655,143655,143656,0,1,4
41113,4,1,143659,143659,143660,0,1,3
41114,6,3,143665,143665,143668,0,3,5
41115,1,3,143666,143668,143671,2,5,0
41116,1,3,143667,143671,143674,4,7,0
41117,1,1,143668,143674,143675,6,7,0
41118,4,2,143672,143675,143677,3,5,0
41119,5,1,143677,143677,143678,0,1,0
41120,6,2,143683,143683,143685,0,2,5
41121,4,2,143687,143687,143689,0,2,2
41122,6,1,143693,143693,143694,0,1,4
41123,2,3,143695,143695,143698,0,3,1
41124,4,3,143699,143699,143702,0,3,1
41125,4,3,143703,143703,143706,0,3,1
41126,3,2,143706,143706,143708,0,2,0
41127,3,2,143709,143709,143711,0,2,1
41128,5,1,143714,143714,143715,0,1,3
41129,5,3,143719,143719,143722,0,3,4
41130,1,3,143720,143722,143725,2,5,0
41131,2,2,143722,143725,143727,3,5,0
41132,4,2,143726,143727,143729,1,3,0
41133,2,1,143728,143729,143730,1,2,0
41134,1,1,143729,143730,143731,1,2,0
41135,3,1,143732,143732,143733,0,1,1
41136,2,2,143734,143734,143736,0,2,1
41137,6,1,143740,143740,143741,0,1,4
41138,4,2,143744,143744,143746,0,2,3
41139,6,3,143750,143750,143753,0,3,4
41140,6,3,143756,143756,143759,0,3,3
41141,6,3,143762,143762,143765,0,3,3
41142,1,2,143763,143765,143767,2,4,0
41143,6,2,143769,143769,143771,0,2,2
41144,4,3,143773,143773,143776,0,3,2
41145,3,1,143776,143776,143777,0,1,0
41146,5,3,143781,143781,143784,0,3,4
41147,4,2,143785,143785,143787,0,2,1
41148,6,3,143791,143791,143794,0,3,4
41149,6,3,143797,143797,143800,0,3,3
41150,1,2,143798,143800,143802,2,4,0
41151,5,3,143803,143803,143806,0,3,1
41152,6,1,143809,143809,143810,0,1,3
41153,6,1,143815,143815,143816,0,1,5
41154,2,1,143817,143817,143818,0,1,1
41155,1,1,143818,143818,143819,0,1,0
41156,1,2,143819,143819,143821,0,2,0
41157,2,3,143821,143821,143824,0,3,0
41158,1,2,143822,143824,143826,2,4,0
41159,5,1,143827,143827,143828,0,1,1
41160,4,1,143831,143831,143832,0,1,3
41161,2,3,143833,143833,143836,0,3,1
41162,1,3,143834,143836,143839,2,5,0
41163,1,1,143835,143839,143840,4,5,0
41164,3,3,143838,143840,143843,2,5,0
41165,2,2,143840,143843,143845,3,5,0
41166,2,1,143842,143845,143846,3,4,0
41167,6,3,143848,143848,143851,0,3,2
41168,3,1,143851,143851,143852,0,1,0
41169,6,2,143857,143857,143859,0,2,5
41170,5,3,143862,143862,143865,0,3,3
41171,5,2,143867,143867,143869,0,2,2
41172,4,1,143871,143871,143872,0,1,2
41173,5,1,143876,143876,143877,0,1,4
41174,2,3,143878,143878,143881,0,3,1
41175,2,1,143880,143881,143882,1,2,0
41176,6,3,143886,143886,143889,0,3,4
41177,5,2,143891,143891,143893,0,2,2
41178,4,1,143895,143895,143896,0,1,2
41179,1,3,143896,143896,143899,0,3,0
41180,1,1,143897,143899,143900,2,3,0
41181,6,1,143903,143903,143904,0,1,3
41182,6,3,143909,143909,143912,0,3,5
41183,6,2,143915,143915,143917,0,2,3
41184,2,3,143917,143917,143920,0,3,0
41185,6,1,143923,143923,143924,0,1,3
41186,3,1,143926,143926,143927,0,1,2
41187,3,2,143929,143929,143931,0,2,2
41188,4,1,143933,143933,143934,0,1,2
41189,6,3,143939,143939,143942,0,3,5
41190,3,2,143942,143942,143944,0,2,0
41191,2,2,143944,143944,143946,0,2,0
41192,3,1,143947,143947,143948,0,1,1
41193,4,1,143951,143951,143952,0,1,3
41194,1,2,143952,143952,143954,0,2,0
41195,3,1,143955,143955,143956,0,1,1
41196,6,3,143961,143961,143964,0,3,5
41197,5,2,143966,143966,143968,0,2,2
41198,2,2,143968,143968,143970,0,2,0
41199,1,3,143969,143970,143973,1,4,0
41200,5,3,143974,143974,143977,0,3,1
41201,3,1,143977,143977,143978,0,1,0
41202,5,3,143982,143982,143985,0,3,4
41203,4,3,143986,143986,143989,0,3,1
41204,4,3,143990,143990,143993,0,3,1
41205,2,1,143992,143993,143994,1,2,0
41206,6,2,143998,143998,144000,0,2,4
41207,1,3,143999,144000,144003,1,4,0
41208,6,1,144005,144005,144006,0,1,2
41209,3,1,144008,144008,144009,0,1,2
41210,3,1,144011,144011,144012,0,1,2
41211,1,1,144012,144012,144013,0,1,0
41212,2,2,144014,144014,144016,0,2,1
41213,2,2,144016,144016,144018,0,2,0
41214,2,3,144018,144018,144021,0,3,0
41215,4,1,144022,144022,144023,0,1,1
41216,2,3,144024,144024,144027,0,3,1
41217,1,1,144025,144027,144028,2,3,0
41218,1,1,144026,144028,144029,2,3,0
41219,6,1,144032,144032,144033,0,1,3
41220,6,2,144038,144038,144040,0,2,5
41221,3,2,144041,144041,144043,0,2,1
41222,3,3,144044,144044,144047,0,3,1
41223,4,2,144048,144048,144050,0,2,1
41224,6,1,144054,144054,144055,0,1,4
41225,1,3,144055,144055,144058,0,3,0
41226,1,3,144056,144058,144061,2,5,0
41227,3,1,144059,144061,144062,2,3,0
41228,5,1,144064,144064,144065,0,1,2
41229,4,3,144068,144068,144071,0,3,3
41230,5,1,144073,144073,144074,0,1,2
41231,4,1,144077,144077,144078,0,1,3
41232,6,1,144083,144083,144084,0,1,5
41233,1,2,144084,144084,144086,0,2,0
41234,6,2,144090,144090,144092,0,2,4
41235,1,1,144091,144092,144093,1,2,0
41236,5,3,144096,144096,144099,0,3,3
41237,2,3,144098,144099,144102,1,4,0
41238,1,1,144099,144102,144103,3,4,0
41239,3,1,144102,144103,144104,1,2,0
41240,4,1,144106,144106,144107,0,1,2
41241,5,3,144111,144111,144114,0,3,4
41242,3,2,144114,144114,144116,0,2,0
41243,3,2,144117,144117,144119,0,2,1
41244,4,1,144121,144121,144122,0,1,2
41245,5,3,144126,144126,144129,0,3,4
41246,3,2,144129,144129,144131,0,2,0
41247,1,2,144130,144131,144133,1,3,0
41248,2,2,144132,144133,144135,1,3,0
41249,5,3,144137,144137,144140,0,3,2
41250,4,2,144141,144141,144143,0,2,1
41251,1,1,144142,144143,144144,1,2,0
41252,1,3,144143,144144,144147,1,4,0
41253,1,2,144144,144147,144149,3,5,0
41254,3,1,144147,144149,144150,2,3,0
41255,1,2,144148,144150,144152,2,4,0
41256,3,2,144151,144152,144154,1,3,0
41257,5,2,144156,144156,144158,0,2,2
41258,5,2,144161,144161,144163,0,2,3
41259,4,3,144165,144165,144168,0,3,2
41260,1,2,144166,144168,144170,2,4,0
41261,1,3,144167,144170,144173,3,6,0
41262,4,2,144171,144173,144175,2,4,0
41263,4,3,144175,144175,144178,0,3,0
41264,5,1,144180,144180,144181,0,1,2
41265,2,1,144182,144182,144183,0,1,1
41266,4,1,144186,144186,144187,0,1,3
41267,5,3,144191,144191,144194,0,3,4
41268,5,3,144196,144196,144199,0,3,2
41269,2,2,144198,144199,144201,1,3,0
41270,2,3,144200,144201,144204,1,4,0
41271,3,1,144203,144204,144205,1,2,0
41272,6,2,144209,144209,144211,0,2,4
41273,2,1,144211,144211,144212,0,1,0
41274,6,1,144217,144217,144218,0,1,5
41275,1,1,144218,144218,144219,0,1,0
41276,6,3,144224,144224,144227,0,3,5
41277,3,3,144227,144227,144230,0,3,0
41278,1,2,144228,144230,144232,2,4,0
41279,4,3,144232,144232,144235,0,3,0
41280,3,2,144235,144235,144237,0,2,0
41281,2,1,144237,144237,144238,0,1,0
41282,1,1,144238,144238,144239,0,1,0
41283,1,3,144239,144239,144242,0,3,0
41284,4,1,144243,144243,144244,0,1,1
41285,1,3,144244,144244,144247,0,3,0
41286,3,1,144247,144247,144248,0,1,0
41287,3,2,144250,144250,144252,0,2,2
41288,1,1,144251,144252,144253,1,2,0
41289,3,3,144254,144254,144257,0,3,1
41290,1,3,144255,144257,144260,2,5,0
41291,3,3,144258,144260,144263,2,5,0
41292,6,3,144264,144264,144267,0,3,1
41293,5,1,144269,144269,144270,0,1,2
41294,2,3,144271,144271,144274,0,3,1
41295,1,2,144272,144274,144276,2,4,0
41296,6,3,144278,144278,144281,0,3,2
41297,1,2,144279,144281,144283,2,4,0
41298,1,2,144280,144283,144285,3,5,0
41299,4,3,144284,144285,144288,1,4,0
41300,6,2,144290,144290,144292,0,2,2
41301,4,1,144294,144294,144295,0,1,2
41302,6,2,144300,144300,144302,0,2,5
41303,4,1,144304,144304,144305,0,1,2
41304,5,2,144309,144309,144311,0,2,4
41305,5,3,144314,144314,144317,0,3,3
41306,3,2,144317,144317,144319,0,2,0
41307,4,3,144321,144321,144324,0,3,2
41308,2,3,144323,144324,144327,1,4,0
41309,5,2,144328,144328,144330,0,2,1
41310,6,2,144334,144334,144336,0,2,4
41311,6,2,144340,144340,144342,0,2,4
41312,3,2,144343,144343,144345,0,2,1
41313,5,1,144348,144348,144349,0,1,3
41314,1,3,144349,144349,144352,0,3,0
41315,6,3,144355,144355,144358,0,3,3
41316,4,1,144359,144359,144360,0,1,1
41317,4,2,144363,144363,144365,0,2,3
41318,2,3,144365,144365,144368,0,3,0
41319,6,3,144371,144371,144374,0,3,3
41320,3,2,144374,144374,144376,0,2,0
41321,3,2,144377,144377,144379,0,2,1
41322,2,1,144379,144379,144380,0,1,0
41323,4,3,144383,144383,144386,0,3,3
41324,3,2,144386,144386,144388,0,2,0
41325,6,3,144392,144392,144395,0,3,4
41326,2,3,144394,144395,144398,1,4,0
41327,4,3,144398,144398,144401,0,3,0
41328,1,3,144399,144401,144404,2,5,0
41329,3,3,144402,144404,144407,2,5,0
41330,3,2,144405,144407,144409,2,4,0
41331,6,1,144411,144411,144412,0,1,2
41332,3,3,144414,144414,144417,0,3,2
41333,2,2,144416,144417,144419,1,3,0
41334,5,3,144421,144421,144424,0,3,2
41335,1,3,144422,144424,144427,2,5,0
41336,5,1,144427,144427,144428,0,1,0
41337,6,1,144433,144433,144434,0,1,5
41338,4,2,144437,144437,144439,0,2,3
41339,3,3,144440,144440,144443,0,3,1
41340,3,2,144443,144443,144445,0,2,0
41341,6,3,144449,144449,144452,0,3,4
41342,3,2,144452,144452,144454,0,2,0
41343,6,3,144458,144458,144461,0,3,4
41344,1,3,144459,144461,144464,2,5,0
41345,5,1,144464,144464,144465,0,1,0
41346,1,2,144465,144465,144467,0,2,0
41347,5,1,144470,144470,144471,0,1,3
41348,1,1,144471,144471,144472,0,1,0
41349,4,3,144475,144475,144478,0,3,3
41350,5,3,144480,144480,144483,0,3,2
41351,5,2,144485,144485,144487,0,2,2
41352,2,1,144487,144487,144488,0,1,0
41353,6,1,144493,144493,144494,0,1,5
41354,2,1,144495,144495,144496,0,1,1
41355,5,1,144500,144500,144501,0,1,4
41356,5,1,144505,144505,144506,0,1,4
41357,4,3,144509,144509,144512,0,3,3
41358,5,3,144514,144514,144517,0,3,2
41359,1,1,144515,144517,144518,2,3,0
41360,1,3,144516,144518,144521,2,5,0
41361,1,3,144517,144521,144524,4,7,0
41362,6,3,144523,144524,144527,1,4,0
41363,6,1,144529,144529,144530,0,1,2
41364,1,3,144530,144530,144533,0,3,0
41365,5,3,144535,144535,144538,0,3,2
41366,5,3,144540,144540,144543,0,3,2
41367,5,2,144545,144545,144547,0,2,2
41368,4,1,144549,144549,144550,0,1,2
41369,4,2,144553,144553,144555,0,2,3
41370,1,3,144554,144555,144558,1,4,0
41371,3,3,144557,144558,144561,1,4,0
41372,6,2,144563,144563,144565,0,2,2
41373,5,1,144568,144568,144569,0,1,3
41374,2,2,144570,144570,144572,0,2,1
41375,1,1,144571,144572,144573,1,2,0
41376,5,3,144576,144576,144579,0,3,3
41377,1,3,144577,144579,144582,2,5,0
41378,1,2,144578,144582,144584,4,6,0
41379,2,3,144580,144584,144587,4,7,0
41380,2,1,144582,144587,144588,5,6,0
41381,4,2,144586,144588,144590,2,4,0
41382,5,1,144591,144591,144592,0,1,1
41383,4,2,144595,144595,144597,0,2,3
41384,6,2,144601,144601,144603,0,2,4
41385,2,3,144603,144603,144606,0,3,0
41386,5,2,144608,144608,144610,0,2,2
41387,2,2,144610,144610,144612,0,2,0
41388,4,1,144614,144614,144615,0,1,2
41389,6,2,144620,144620,144622,0,2,5
41390,4,2,144624,144624,144626,0,2,2
41391,3,2,144627,144627,144629,0,2,1
41392,4,3,144631,144631,144634,0,3,2
41393,6,3,144637,144637,144640,0,3,3
41394,4,3,144641,144641,144644,0,3,1
41395,1,3,144642,144644,144647,2,5,0
41396,4,1,144646,144647,144648,1,2,0
41397,5,3,144651,144651,144654,0,3,3
41398,3,3,144654,144654,144657,0,3,0
41399,3,2,144657,144657,144659,0,2,0
41400,5,2,144662,144662,144664,0,2,3
41401,5,3,144667,144667,144670,0,3,3
41402,2,1,144669,144670,144671,1,2,0
41403,2,3,144671,144671,144674,0,3,0
41404,3,1,144674,144674,144675,0,1,0
41405,4,1,144678,144678,144679,0,1,3
41406,2,2,144680,144680,144682,0,2,1
41407,4,1,144684,144684,144685,0,1,2
41408,2,1,144686,144686,144687,0,1,1
41409,6,3,144692,144692,144695,0,3,5
41410,6,2,144698,144698,144700,0,2,3
41411,5,3,144703,144703,144706,0,3,3
41412,6,3,144709,144709,144712,0,3,3
41413,2,3,144711,144712,144715,1,4,0
41414,1,1,144712,144715,144716,3,4,0
41415,6,3,144718,144718,144721,0,3,2
41416,5,2,144723,144723,144725,0,2,2
41417,5,1,144728,144728,144729,0,1,3
41418,3,3,144731,144731,144734,0,3,2
41419,4,1,144735,144735,144736,0,1,1
41420,6,1,144741,144741,144742,0,1,5
41421,2,3,144743,144743,144746,0,3,1
41422,2,1,144745,144746,144747,1,2,0
41423,4,2,144749,144749,144751,0,2,2
41424,1,3,144750,144751,144754,1,4,0
41425,4,2,144754,144754,144756,0,2,0
41426,6,3,144760,144760,144763,0,3,4
41427,6,2,144766,144766,144768,0,2,3
41428,1,1,144767,144768,144769,1,2,0
41429,3,3,144770,144770,144773,0,3,1
41430,4,1,144774,144774,144775,0,1,1
41431,2,2,144776,144776,144778,0,2,1
41432,3,1,144779,144779,144780,0,1,1
41433,4,2,144783,144783,144785,0,2,3
41434,6,2,144789,144789,144791,0,2,4
41435,5,3,144794,144794,144797,0,3,3
41436,2,3,144796,144797,144800,1,4,0
41437,4,2,144800,144800,144802,0,2,0
41438,2,1,144802,144802,144803,0,1,0
41439,1,1,144803,144803,144804,0,1,0
41440,2,1,144805,144805,144806,0,1,1
41441,1,2,144806,144806,144808,0,2,0
41442,1,3,144807,144808,144811,1,4,0
41443,1,2,144808,144811,144813,3,5,0
41444,6,2,144814,144814,144816,0,2,1
41445,4,3,144818,144818,144821,0,3,2
41446,2,1,144820,144821,144822,1,2,0
41447,6,3,144826,144826,144829,0,3,4
41448,6,1,144832,144832,144833,0,1,3
41449,6,2,144838,144838,144840,0,2,5
41450,4,3,144842,144842,144845,0,3,2
41451,2,2,144844,144845,144847,1,3,0
41452,2,1,144846,144847,144848,1,2,0
41453,2,3,144848,144848,144851,0,3,0
41454,1,2,144849,144851,144853,2,4,0
41455,3,1,144852,144853,144854,1,2,0
41456,5,2,144857,144857,144859,0,2,3
41457,1,1,144858,144859,144860,1,2,0
41458,4,3,144862,144862,144865,0,3,2
41459,3,1,144865,144865,144866,0,1,0
41460,5,2,144870,144870,144872,0,2,4
41461,1,3,144871,144872,144875,1,4,0
41462,1,2,144872,144875,144877,3,5,0
41463,1,1,144873,144877,144878,4,5,0
41464,1,2,144874,144878,144880,4,6,0
41465,6,1,144880,144880,144881,0,1,0
41466,6,3,144886,144886,144889,0,3,5
41467,3,2,144889,144889,144891,0,2,0
41468,1,1,144890,144891,144892,1,2,0
41469,3,1,144893,144893,144894,0,1,1
41470,5,2,144898,144898,144900,0,2,4
41471,3,2,144901,144901,144903,0,2,1
41472,3,2,144904,144904,144906,0,2,1
41473,6,1,144910,144910,144911,0,1,4
41474,6,3,144916,144916,144919,0,3,5
41475,3,1,144919,144919,144920,0,1,0
41476,4,1,144923,144923,144924,0,1,3
41477,6,3,144929,144929,144932,0,3,5
41478,5,3,144934,144934,144937,0,3,2
41479,6,3,144940,144940,144943,0,3,3
41480,2,1,144942,144943,144944,1,2,0
41481,2,1,144944,144944,144945,0,1,0
41482,5,1,144949,144949,144950,0,1,4
41483,6,2,144955,144955,144957,0,2,5
41484,6,3,144961,144961,144964,0,3,4
41485,5,1,144966,144966,144967,0,1,2
41486,5,2,144971,144971,144973,0,2,4
41487,2,2,144973,144973,144975,0,2,0
41488,4,3,144977,144977,144980,0,3,2
41489,5,2,144982,144982,144984,0,2,2
41490,1,2,144983,144984,144986,1,3,0
41491,1,3,144984,144986,144989,2,5,0
41492,6,3,144990,144990,144993,0,3,1
41493,2,3,144992,144993,144996,1,4,0
41494,2,1,144994,144996,144997,2,3,0
41495,5,1,144999,144999,145000,0,1,2
41496,2,2,145001,145001,145003,0,2,1
41497,2,3,145003,145003,145006,0,3,0
41498,1,1,145004,145006,145007,2,3,0
41499,1,2,145005,145007,145009,2,4,0
41500,1,3,145006,145009,145012,3,6,0
41501,4,1,145010,145012,145013,2,3,0
41502,6,3,145016,145016,145019,0,3,3
41503,3,1,145019,145019,145020,0,1,0
41504,1,1,145020,145020,145021,0,1,0
41505,4,2,145024,145024,145026,0,2,3
41506,5,1,145029,145029,145030,0,1,3
41507,6,1,145035,145035,145036,0,1,5
41508,2,2,145037,145037,145039,0,2,1
41509,6,3,145043,145043,145046,0,3,4
41510,6,1,145049,145049,145050,0,1,3
41511,5,2,145054,145054,145056,0,2,4
41512,5,1,145059,145059,145060,0,1,3
41513,2,3,145061,145061,145064,0,3,1
41514,2,3,145063,145064,145067,1,4,0
41515,1,3,145064,145067,145070,3,6,0
41516,5,2,145069,145070,145072,1,3,0
41517,2,3,145071,145072,145075,1,4,0
41518,6,3,145077,145077,145080,0,3,2
41519,6,3,145083,145083,145086,0,3,3
41520,1,3,145084,145086,145089,2,5,0
41521,4,3,145088,145089,145092,1,4,0
41522,1,1,145089,145092,145093,3,4,0
41523,1,3,145090,145093,145096,3,6,0
41524,1,2,145091,145096,145098,5,7,0
41525,4,2,145095,145098,145100,3,5,0
41526,1,2,145096,145100,145102,4,6,0
41527,5,2,145101,145102,145104,1,3,0
41528,1,2,145102,145104,145106,2,4,0
41529,1,1,145103,145106,145107,3,4,0
41530,5,2,145108,145108,145110,0,2,1
41531,5,2,145113,145113,145115,0,2,3
41532,3,3,145116,145116,145119,0,3,1
41533,6,2,145122,145122,145124,0,2,3
41534,4,1,145126,145126,145127,0,1,2
41535,3,1,145129,145129,145130,0,1,2
41536,1,3,145130,145130,145133,0,3,0
41537,1,2,145131,145133,145135,2,4,0
41538,5,1,145136,145136,145137,0,1,1
41539,6,1,145142,145142,145143,0,1,5
41540,3,1,145145,145145,145146,0,1,2
41541,3,3,145148,145148,145151,0,3,2
41542,1,1,145149,145151,145152,2,3,0
41543,5,2,145154,145154,145156,0,2,2
41544,6,2,145160,145160,145162,0,2,4
41545,2,1,145162,145162,145163,0,1,0
41546,5,2,145167,145167,145169,0,2,4
41547,3,2,145170,145170,145172,0,2,1
41548,4,2,145174,145174,145176,0,2,2
41549,3,2,145177,145177,145179,0,2,1
41550,6,2,145183,145183,145185,0,2,4
41551,1,3,145184,145185,145188,1,4,0
41552,3,2,145187,145188,145190,1,3,0
41553,6,2,145193,145193,145195,0,2,3
41554,2,3,145195,145195,145198,0,3,0
41555,6,1,145201,145201,145202,0,1,3
41556,4,2,145205,145205,145207,0,2,3
41557,1,2,145206,145207,145209,1,3,0
41558,6,1,145212,145212,145213,0,1,3
41559,6,1,145218,145218,145219,0,1,5
41560,2,3,145220,145220,145223,0,3,1
41561,6,1,145226,145226,145227,0,1,3
41562,1,3,145227,145227,145230,0,3,0
41563,2,1,145229,145230,145231,1,2,0
41564,3,3,145232,145232,145235,0,3,1
41565,6,1,145238,145238,145239,0,1,3
41566,1,1,145239,145239,145240,0,1,0
41567,2,3,145241,145241,145244,0,3,1
41568,1,3,145242,145244,145247,2,5,0
41569,1,2,145243,145247,145249,4,6,0
41570,6,3,145249,145249,145252,0,3,0
41571,2,1,145251,145252,145253,1,2,0
41572,1,3,145252,145253,145256,1,4,0
41573,1,3,145253,145256,145259,3,6,0
41574,5,3,145258,145259,145262,1,4,0
41575,4,1,145262,145262,145263,0,1,0
41576,3,2,145265,145265,145267,0,2,2
41577,1,3,145266,145267,145270,1,4,0
41578,1,3,145267,145270,145273,3,6,0
41579,6,3,145273,145273,145276,0,3,0
41580,1,1,145274,145276,145277,2,3,0
41581,2,1,145276,145277,145278,1,2,0
41582,2,1,145278,145278,145279,0,1,0
41583,1,2,145279,145279,145281,0,2,0
41584,5,3,145284,145284,145287,0,3,3
41585,1,3,145285,145287,145290,2,5,0
41586,3,1,145288,145290,145291,2,3,0
41587,2,3,145290,145291,145294,1,4,0
41588,6,1,145296,145296,145297,0,1,2
41589,6,3,145302,145302,145305,0,3,5
41590,1,1,145303,145305,145306,2,3,0
41591,5,2,145308,145308,145310,0,2,2
41592,5,2,145313,145313,145315,0,2,3
41593,1,3,145314,145315,145318,1,4,0
41594,1,1,145315,145318,145319,3,4,0
41595,4,1,145319,145319,145320,0,1,0
41596,5,2,145324,145324,145326,0,2,4
41597,6,1,145330,145330,145331,0,1,4
41598,1,2,145331,145331,145333,0,2,0
41599,1,1,145332,145333,145334,1,2,0
41600,3,1,145335,145335,145336,0,1,1
41601,5,1,145340,145340,145341,0,1,4
41602,3,3,145343,145343,145346,0,3,2
41603,3,3,145346,145346,145349,0,3,0
41604,6,3,145352,145352,145355,0,3,3
41605,6,1,145358,145358,145359,0,1,3
41606,3,3,145361,145361,145364,0,3,2
41607,1,1,145362,145364,145365,2,3,0
41608,6,1,145368,145368,145369,0,1,3
41609,5,3,145373,145373,145376,0,3,4
41610,6,2,145379,145379,145381,0,2,3
41611,5,1,145384,145384,145385,0,1,3
41612,5,1,145389,145389,145390,0,1,4
41613,5,3,145394,145394,145397,0,3,4
41614,5,1,145399,145399,145400,0,1,2
41615,3,3,145402,145402,145405,0,3,2
41616,4,1,145406,145406,145407,0,1,1
41617,3,2,145409,145409,145411,0,2,2
41618,3,1,145412,145412,145413,0,1,1
41619,3,2,145415,145415,145417,0,2,2
41620,1,1,145416,145417,145418,1,2,0
41621,3,1,145419,145419,145420,0,1,1
41622,6,2,145425,145425,145427,0,2,5
41623,3,3,145428,145428,145431,0,3,1
41624,1,3,145429,145431,145434,2,5,0
41625,2,3,145431,145434,145437,3,6,0
41626,4,2,145435,145437,145439,2,4,0
41627,1,3,145436,145439,145442,3,6,0
41628,2,3,145438,145442,145445,4,7,0
41629,1,1,145439,145445,145446,6,7,0
41630,1,1,145440,145446,145447,6,7,0
41631,1,2,145441,145447,145449,6,8,0
41632,1,1,145442,145449,145450,7,8,0
41633,1,2,145443,145450,145452,7,9,0
41634,6,3,145449,145452,145455,3,6,0
41635,6,2,145455,145455,145457,0,2,0
41636,3,2,145458,145458,145460,0,2,1
41637,4,3,145462,145462,145465,0,3,2
41638,6,1,145468,145468,145469,0,1,3
41639,5,1,145473,145473,145474,0,1,4
41640,4,2,145477,145477,145479,0,2,3
41641,5,2,145482,145482,145484,0,2,3
41642,3,2,145485,145485,145487,0,2,1
41643,6,1,145491,145491,145492,0,1,4
41644,4,2,145495,145495,145497,0,2,3
41645,4,3,145499,145499,145502,0,3,2
41646,3,2,145502,145502,145504,0,2,0
41647,4,1,145506,145506,145507,0,1,2
41648,5,3,145511,145511,145514,0,3,4
41649,2,3,145513,145514,145517,1,4,0
41650,3,1,145516,145517,145518,1,2,0
41651,1,1,145517,145518,145519,1,2,0
41652,6,3,145523,145523,145526,0,3,4
41653,5,3,145528,145528,145531,0,3,2
41654,3,3,145531,145531,145534,0,3,0
41655,4,1,145535,145535,145536,0,1,1
41656,2,3,145537,145537,145540,0,3,1
41657,6,1,145543,145543,145544,0,1,3
41658,3,2,145546,145546,145548,0,2,2
41659,6,1,145552,145552,145553,0,1,4
41660,6,3,145558,145558,145561,0,3,5
41661,3,2,145561,145561,145563,0,2,0
41662,6,1,145567,145567,145568,0,1,4
41663,2,3,145569,145569,145572,0,3,1
41664,4,3,145573,145573,145576,0,3,1
41665,1,2,145574,145576,145578,2,4,0
41666,4,1,145578,145578,145579,0,1,0
41667,4,2,145582,145582,145584,0,2,3
41668,4,3,145586,145586,145589,0,3,2
41669,3,2,145589,145589,145591,0,2,0
41670,1,3,145590,145591,145594,1,4,0
41671,1,2,145591,145594,145596,3,5,0
41672,1,1,145592,145596,145597,4,5,0
41673,4,1,145596,145597,145598,1,2,0
41674,5,1,145601,145601,145602,0,1,3
41675,4,2,145605,145605,145607,0,2,3
41676,2,3,145607,145607,145610,0,3,0
41677,6,3,145613,145613,145616,0,3,3
41678,3,1,145616,145616,145617,0,1,0
41679,3,3,145619,145619,145622,0,3,2
41680,2,1,145621,145622,145623,1,2,0
41681,4,3,145625,145625,145628,0,3,2
41682,2,3,145627,145628,145631,1,4,0
41683,5,2,145632,145632,145634,0,2,1
41684,1,2,145633,145634,145636,1,3,0
41685,4,2,145637,145637,145639,0,2,1
41686,3,1,145640,145640,145641,0,1,1
41687,2,3,145642,145642,145645,0,3,1
41688,5,2,145647,145647,145649,0,2,2
41689,1,2,145648,145649,145651,1,3,0
41690,4,1,145652,145652,145653,0,1,1
41691,2,3,145654,145654,145657,0,3,1
41692,6,3,145660,145660,145663,0,3,3
41693,6,3,145666,145666,145669,0,3,3
41694,3,3,145669,145669,145672,0,3,0
41695,2,2,145671,145672,145674,1,3,0
41696,5,3,145676,145676,145679,0,3,2
41697,4,2,145680,145680,145682,0,2,1
41698,2,2,145682,145682,145684,0,2,0
41699,1,1,145683,145684,145685,1,2,0
41700,2,1,145685,145685,145686,0,1,0
41701,6,1,145691,145691,145692,0,1,5
41702,5,2,145696,145696,145698,0,2,4
41703,1,2,145697,145698,145700,1,3,0
41704,5,3,145702,145702,145705,0,3,2
41705,3,3,145705,145705,145708,0,3,0
41706,1,1,145706,145708,145709,2,3,0
41707,4,1,145710,145710,145711,0,1,1
41708,5,1,145715,145715,145716,0,1,4
41709,1,3,145716,145716,145719,0,3,0
41710,5,3,145721,145721,145724,0,3,2
41711,1,3,145722,145724,145727,2,5,0
41712,5,3,145727,145727,145730,0,3,0
41713,4,1,145731,145731,145732,0,1,1
41714,3,2,145734,145734,145736,0,2,2
41715,2,3,145736,145736,145739,0,3,0
41716,4,2,145740,145740,145742,0,2,1
41717,3,1,145743,145743,145744,0,1,1
41718,6,2,145749,145749,145751,0,2,5
41719,5,1,145754,145754,145755,0,1,3
41720,4,3,145758,145758,145761,0,3,3
41721,4,2,145762,145762,145764,0,2,1
41722,6,2,145768,145768,145770,0,2,4
41723,4,1,145772,145772,145773,0,1,2
41724,1,3,145773,145773,145776,0,3,0
41725,5,3,145778,145778,145781,0,3,2
41726,3,2,145781,145781,145783,0,2,0
41727,5,2,145786,145786,145788,0,2,3
41728,2,3,145788,145788,145791,0,3,0
41729,5,3,145793,145793,145796,0,3,2
41730,1,1,145794,145796,145797,2,3,0
41731,4,1,145798,145798,145799,0,1,1
41732,6,2,145804,145804,145806,0,2,5
41733,2,3,145806,145806,145809,0,3,0
41734,5,2,145811,145811,145813,0,2,2
41735,6,3,145817,145817,145820,0,3,4
41736,6,3,145823,145823,145826,0,3,3
41737,5,2,145828,145828,145830,0,2,2
41738,4,1,145832,145832,145833,0,1,2
41739,5,1,145837,145837,145838,0,1,4
41740,2,2,145839,145839,145841,0,2,1
41741,6,1,145845,145845,145846,0,1,4
41742,4,2,145849,145849,145851,0,2,3
41743,2,3,145851,145851,145854,0,3,0
41744,1,1,145852,145854,145855,2,3,0
41745,2,2,145854,145855,145857,1,3,0
41746,1,2,145855,145857,145859,2,4,0
41747,3,3,145858,145859,145862,1,4,0
41748,5,3,145863,145863,145866,0,3,1
41749,1,2,145864,145866,145868,2,4,0
41750,1,3,145865,145868,145871,3,6,0
41751,2,2,145867,145871,145873,4,6,0
41752,1,1,145868,145873,145874,5,6,0
41753,3,3,145871,145874,145877,3,6,0
41754,3,2,145874,145877,145879,3,5,0
41755,5,2,145879,145879,145881,0,2,0
41756,5,3,145884,145884,145887,0,3,3
41757,4,2,145888,145888,145890,0,2,1
41758,3,1,145891,145891,145892,0,1,1
41759,5,3,145896,145896,145899,0,3,4
41760,5,3,145901,145901,145904,0,3,2
41761,3,1,145904,145904,145905,0,1,0
41762,3,1,145907,145907,145908,0,1,2
41763,2,3,145909,145909,145912,0,3,1
41764,1,1,145910,145912,145913,2,3,0
41765,2,3,145912,145913,145916,1,4,0
41766,6,3,145918,145918,145921,0,3,2
41767,6,2,145924,145924,145926,0,2,3
41768,4,1,145928,145928,145929,0,1,2
41769,6,2,145934,145934,145936,0,2,5
41770,5,1,145939,145939,145940,0,1,3
41771,2,3,145941,145941,145944,0,3,1
41772,4,1,145945,145945,145946,0,1,1
41773,4,1,145949,145949,145950,0,1,3
41774,6,2,145955,145955,145957,0,2,5
41775,1,1,145956,145957,145958,1,2,0
41776,3,1,145959,145959,145960,0,1,1
41777,6,3,145965,145965,145968,0,3,5
41778,2,1,145967,145968,145969,1,2,0
41779,5,1,145972,145972,145973,0,1,3
41780,2,3,145974,145974,145977,0,3,1
41781,2,3,145976,145977,145980,1,4,0
41782,5,3,145981,145981,145984,0,3,1
41783,2,2,145983,145984,145986,1,3,0
41784,3,1,145986,145986,145987,0,1,0
41785,1,3,145987,145987,145990,0,3,0
41786,5,3,145992,145992,145995,0,3,2
41787,5,3,145997,145997,146000,0,3,2
41788,5,2,146002,146002,146004,0,2,2
41789,2,1,146004,146004,146005,0,1,0
41790,6,2,146010,146010,146012,0,2,5
41791,5,2,146015,146015,146017,0,2,3
41792,2,3,146017,146017,146020,0,3,0
41793,6,2,146023,146023,146025,0,2,3
41794,4,2,146027,146027,146029,0,2,2
41795,3,1,146030,146030,146031,0,1,1
41796,4,1,146034,146034,146035,0,1,3
41797,4,3,146038,146038,146041,0,3,3
41798,6,1,146044,146044,146045,0,1,3
41799,4,2,146048,146048,146050,0,2,3
41800,4,2,146052,146052,146054,0,2,2
41801,3,3,146055,146055,146058,0,3,1
41802,2,2,146057,146058,146060,1,3,0
41803,4,2,146061,146061,146063,0,2,1
41804,3,2,146064,146064,146066,0,2,1
41805,3,3,146067,146067,146070,0,3,1
41806,2,1,146069,146070,146071,1,2,0
41807,2,2,146071,146071,146073,0,2,0
41808,1,1,146072,146073,146074,1,2,0
41809,4,2,146076,146076,146078,0,2,2
41810,4,3,146080,146080,146083,0,3,2
41811,3,2,146083,146083,146085,0,2,0
41812,5,1,146088,146088,146089,0,1,3
41813,6,3,146094,146094,146097,0,3,5
41814,6,2,146100,146100,146102,0,2,3
41815,6,2,146106,146106,146108,0,2,4
41816,5,1,146111,146111,146112,0,1,3
41817,4,2,146115,146115,146117,0,2,3
41818,1,3,146116,146117,146120,1,4,0
41819,5,1,146121,146121,146122,0,1,1
41820,3,1,146124,146124,146125,0,1,2
41821,2,1,146126,146126,146127,0,1,1
41822,6,1,146132,146132,146133,0,1,5
41823,5,3,146137,146137,146140,0,3,4
41824,3,2,146140,146140,146142,0,2,0
41825,6,2,146146,146146,146148,0,2,4
41826,1,2,146147,146148,146150,1,3,0
41827,2,2,146149,146150,146152,1,3,0
41828,6,1,146155,146155,146156,0,1,3
41829,4,1,146159,146159,146160,0,1,3
41830,2,3,146161,146161,146164,0,3,1
41831,4,1,146165,146165,146166,0,1,1
41832,4,2,146169,146169,146171,0,2,3
41833,4,1,146173,146173,146174,0,1,2
41834,2,1,146175,146175,146176,0,1,1
41835,3,1,146178,146178,146179,0,1,2
41836,4,1,146182,146182,146183,0,1,3
41837,6,2,146188,146188,146190,0,2,5
41838,4,3,146192,146192,146195,0,3,2
41839,4,3,146196,146196,146199,0,3,1
41840,4,1,146200,146200,146201,0,1,1
41841,2,3,146202,146202,146205,0,3,1
41842,3,2,146205,146205,146207,0,2,0
41843,6,3,146211,146211,146214,0,3,4
41844,6,1,146217,146217,146218,0,1,3
41845,4,3,146221,146221,146224,0,3,3
41846,5,2,146226,146226,146228,0,2,2
41847,4,1,146230,146230,146231,0,1,2
41848,1,2,146231,146231,146233,0,2,0
41849,3,1,146234,146234,146235,0,1,1
41850,4,3,146238,146238,146241,0,3,3
41851,2,3,146240,146241,146244,1,4,0
41852,1,3,146241,146244,146247,3,6,0
41853,1,3,146242,146247,146250,5,8,0
41854,3,1,146245,146250,146251,5,6,0
41855,4,3,146249,146251,146254,2,5,0
41856,6,2,146255,146255,146257,0,2,1
41857,1,3,146256,146257,146260,1,4,0
41858,1,3,146257,146260,146263,3,6,0
41859,6,1,146263,146263,146264,0,1,0
41860,4,2,146267,146267,146269,0,2,3
41861,2,1,146269,146269,146270,0,1,0
41862,6,2,146275,146275,146277,0,2,5
41863,3,2,146278,146278,146280,0,2,1
41864,2,1,146280,146280,146281,0,1,0
41865,4,3,146284,146284,146287,0,3,3
41866,2,3,146286,146287,146290,1,4,0
41867,1,3,146287,146290,146293,3,6,0
41868,6,1,146293,146293,146294,0,1,0
41869,3,2,146296,146296,146298,0,2,2
41870,1,1,146297,146298,146299,1,2,0
41871,2,3,146299,146299,146302,0,3,0
41872,3,2,146302,146302,146304,0,2,0
41873,3,2,146305,146305,146307,0,2,1
41874,6,2,146311,146311,146313,0,2,4
41875,3,1,146314,146314,146315,0,1,1
41876,2,2,146316,146316,146318,0,2,1
41877,6,3,146322,146322,146325,0,3,4
41878,6,2,146328,146328,146330,0,2,3
41879,1,3,146329,146330,146333,1,4,0
41880,5,2,146334,146334,146336,0,2,1
41881,5,2,146339,146339,146341,0,2,3
41882,4,2,146343,146343,146345,0,2,2
41883,4,2,146347,146347,146349,0,2,2
41884,1,1,146348,146349,146350,1,2,0
41885,2,3,146350,146350,146353,0,3,0
41886,5,3,146355,146355,146358,0,3,2
41887,2,1,146357,146358,146359,1,2,0
41888,1,3,146358,146359,146362,1,4,0
41889,6,2,146364,146364,146366,0,2,2
41890,1,1,146365,146366,146367,1,2,0
41891,5,3,146370,146370,146373,0,3,3
41892,6,2,146376,146376,146378,0,2,3
41893,1,2,146377,146378,146380,1,3,0
41894,6,3,146383,146383,146386,0,3,3
41895,2,2,146385,146386,146388,1,3,0
41896,1,3,146386,146388,146391,2,5,0
41897,5,3,146391,146391,146394,0,3,0
41898,4,1,146395,146395,146396,0,1,1
41899,3,2,146398,146398,146400,0,2,2
41900,4,3,146402,146402,146405,0,3,2
41901,6,1,146408,146408,146409,0,1,3
41902,3,1,146411,146411,146412,0,1,2
41903,4,3,146415,146415,146418,0,3,3
41904,4,3,146419,146419,146422,0,3,1
41905,1,2,146420,146422,146424,2,4,0
41906,4,2,146424,146424,146426,0,2,0
41907,6,3,146430,146430,146433,0,3,4
41908,3,3,146433,146433,146436,0,3,0
41909,3,1,146436,146436,146437,0,1,0
41910,2,1,146438,146438,146439,0,1,1
41911,1,3,146439,146439,146442,0,3,0
41912,2,3,146441,146442,146445,1,4,0
41913,5,3,146446,146446,146449,0,3,1
41914,2,2,146448,146449,146451,1,3,0
41915,4,1,146452,146452,146453,0,1,1
41916,6,3,146458,146458,146461,0,3,5
41917,3,3,146461,146461,146464,0,3,0
41918,2,3,146463,146464,146467,1,4,0
41919,6,2,146469,146469,146471,0,2,2
41920,4,2,146473,146473,146475,0,2,2
41921,1,2,146474,146475,146477,1,3,0
41922,2,2,146476,146477,146479,1,3,0
41923,2,3,146478,146479,146482,1,4,0
41924,2,2,146480,146482,146484,2,4,0
41925,1,2,146481,146484,146486,3,5,0
41926,1,2,146482,146486,146488,4,6,0
41927,4,3,146486,146488,146491,2,5,0
41928,6,2,146492,146492,146494,0,2,1
41929,1,3,146493,146494,146497,1,4,0
41930,4,3,146497,146497,146500,0,3,0
41931,1,3,146498,146500,146503,2,5,0
41932,2,2,146500,146503,146505,3,5,0
41933,5,1,146505,146505,146506,0,1,0
41934,6,2,146511,146511,146513,0,2,5
41935,3,1,146514,146514,146515,0,1,1
41936,1,1,146515,146515,146516,0,1,0
41937,5,1,146520,146520,146521,0,1,4
41938,4,2,146524,146524,146526,0,2,3
41939,2,1,146526,146526,146527,0,1,0
41940,3,1,146529,146529,146530,0,1,2
41941,2,2,146531,146531,146533,0,2,1
41942,6,2,146537,146537,146539,0,2,4
41943,1,1,146538,146539,146540,1,2,0
41944,3,2,146541,146541,146543,0,2,1
41945,4,1,146545,146545,146546,0,1,2
41946,6,1,146551,146551,146552,0,1,5
41947,1,1,146552,146552,146553,0,1,0
41948,3,2,146555,146555,146557,0,2,2
41949,6,2,146561,146561,146563,0,2,4
41950,4,2,146565,146565,146567,0,2,2
41951,3,2,146568,146568,146570,0,2,1
41952,4,2,146572,146572,146574,0,2,2
41953,6,1,146578,146578,146579,0,1,4
41954,1,1,146579,146579,146580,0,1,0
41955,4,2,146583,146583,146585,0,2,3
41956,4,3,146587,146587,146590,0,3,2
41957,1,3,146588,146590,146593,2,5,0
41958,5,3,146593,146593,146596,0,3,0
41959,4,1,146597,146597,146598,0,1,1
41960,1,3,146598,146598,146601,0,3,0
41961,5,1,146603,146603,146604,0,1,2
41962,1,3,146604,146604,146607,0,3,0
41963,1,2,146605,146607,146609,2,4,0
41964,6,1,146611,146611,146612,0,1,2
41965,4,1,146615,146615,146616,0,1,3
41966,1,3,146616,146616,146619,0,3,0
41967,6,3,146622,146622,146625,0,3,3
41968,1,3,146623,146625,146628,2,5,0
41969,4,3,146627,146628,146631,1,4,0
41970,5,1,146632,146632,146633,0,1,1
41971,6,3,146638,146638,146641,0,3,5
41972,1,2,146639,146641,146643,2,4,0
41973,3,1,146642,146643,146644,1,2,0
41974,5,2,146647,146647,146649,0,2,3
41975,3,3,146650,146650,146653,0,3,1
41976,3,3,146653,146653,146656,0,3,0
41977,4,2,146657,146657,146659,0,2,1
41978,1,2,146658,146659,146661,1,3,0
41979,1,2,146659,146661,146663,2,4,0
41980,6,3,146665,146665,146668,0,3,2
41981,5,2,146670,146670,146672,0,2,2
41982,6,3,146676,146676,146679,0,3,4
41983,5,3,146681,146681,146684,0,3,2
41984,4,2,146685,146685,146687,0,2,1
41985,2,3,146687,146687,146690,0,3,0
41986,2,3,146689,146690,146693,1,4,0
41987,2,2,146691,146693,146695,2,4,0
41988,1,2,146692,146695,146697,3,5,0
41989,2,2,146694,146697,146699,3,5,0
41990,6,3,146700,146700,146703,0,3,1
41991,6,2,146706,146706,146708,0,2,3
41992,4,1,146710,146710,146711,0,1,2
41993,6,1,146716,146716,146717,0,1,5
41994,5,3,146721,146721,146724,0,3,4
41995,5,2,146726,146726,146728,0,2,2
41996,6,3,146732,146732,146735,0,3,4
41997,2,2,146734,146735,146737,1,3,0
41998,4,1,146738,146738,146739,0,1,1
41999,3,3,146741,146741,146744,0,3,2
42000,3,2,146744,146744,146746,0,2,0
42001,4,1,146748,146748,146749,0,1,2
42002,6,2,146754,146754,146756,0,2,5
42003,5,2,146759,146759,146761,0,2,3
42004,3,3,146762,146762,146765,0,3,1
42005,3,2,146765,146765,146767,0,2,0
42006,3,3,146768,146768,146771,0,3,1
42007,6,1,146774,146774,146775,0,1,3
42008,6,3,146780,146780,146783,0,3,5
42009,2,1,146782,146783,146784,1,2,0
42010,1,2,146783,146784,146786,1,3,0
42011,1,3,146784,146786,146789,2,5,0
42012,1,2,146785,146789,146791,4,6,0
42013,2,2,146787,146791,146793,4,6,0
42014,6,2,146793,146793,146795,0,2,0
42015,2,3,146795,146795,146798,0,3,0
42016,2,3,146797,146798,146801,1,4,0
42017,4,1,146801,146801,146802,0,1,0
42018,2,2,146803,146803,146805,0,2,1
42019,4,1,146807,146807,146808,0,1,2
42020,2,1,146809,146809,146810,0,1,1
42021,4,1,146813,146813,146814,0,1,3
42022,2,2,146815,146815,146817,0,2,1
42023,5,3,146820,146820,146823,0,3,3
42024,3,3,146823,146823,146826,0,3,0
42025,1,2,146824,146826,146828,2,4,0
42026,1,2,146825,146828,146830,3,5,0
42027,2,2,146827,146830,146832,3,5,0
42028,5,1,146832,146832,146833,0,1,0
42029,1,3,146833,146833,146836,0,3,0
42030,3,3,146836,146836,146839,0,3,0
42031,5,2,146841,146841,146843,0,2,2
42032,3,2,146844,146844,146846,0,2,1
42033,2,1,146846,146846,146847,0,1,0
42034,5,2,146851,146851,146853,0,2,4
42035,3,2,146854,146854,146856,0,2,1
42036,5,1,146859,146859,146860,0,1,3
42037,1,3,146860,146860,146863,0,3,0
42038,5,3,146865,146865,146868,0,3,2
42039,1,1,146866,146868,146869,2,3,0
42040,3,2,146869,146869,146871,0,2,0
42041,6,1,146875,146875,146876,0,1,4
42042,2,1,146877,146877,146878,0,1,1
42043,5,2,146882,146882,146884,0,2,4
42044,3,3,146885,146885,146888,0,3,1
42045,3,3,146888,146888,146891,0,3,0
42046,1,3,146889,146891,146894,2,5,0
42047,4,3,146893,146894,146897,1,4,0
42048,2,2,146895,146897,146899,2,4,0
42049,5,1,146900,146900,146901,0,1,1
42050,6,3,146906,146906,146909,0,3,5
42051,5,3,146911,146911,146914,0,3,2
42052,4,3,146915,146915,146918,0,3,1
42053,6,1,146921,146921,146922,0,1,3
42054,4,1,146925,146925,146926,0,1,3
42055,1,2,146926,146926,146928,0,2,0
42056,2,2,146928,146928,146930,0,2,0
42057,1,3,146929,146930,146933,1,4,0
42058,5,3,146934,146934,146937,0,3,1
42059,6,3,146940,146940,146943,0,3,3
42060,1,3,146941,146943,146946,2,5,0
42061,3,2,146944,146946,146948,2,4,0
42062,5,3,146949,146949,146952,0,3,1
42063,4,3,146953,146953,146956,0,3,1
42064,3,2,146956,146956,146958,0,2,0
42065,5,2,146961,146961,146963,0,2,3
42066,3,1,146964,146964,146965,0,1,1
42067,6,1,146970,146970,146971,0,1,5
42068,4,2,146974,146974,146976,0,2,3
42069,4,1,146978,146978,146979,0,1,2
42070,4,3,146982,146982,146985,0,3,3
42071,5,2,146987,146987,146989,0,2,2
42072,3,3,146990,146990,146993,0,3,1
42073,5,3,146995,146995,146998,0,3,2
42074,6,1,147001,147001,147002,0,1,3
42075,6,1,147007,147007,147008,0,1,5
42076,5,1,147012,147012,147013,0,1,4
42077,5,1,147017,147017,147018,0,1,4
42078,4,1,147021,147021,147022,0,1,3
42079,2,1,147023,147023,147024,0,1,1
42080,3,3,147026,147026,147029,0,3,2
42081,2,3,147028,147029,147032,1,4,0
42082,5,2,147033,147033,147035,0,2,1
42083,1,1,147034,147035,147036,1,2,0
42084,3,1,147037,147037,147038,0,1,1
42085,4,3,147041,147041,147044,0,3,3
42086,2,3,147043,147044,147047,1,4,0
42087,6,3,147049,147049,147052,0,3,2
42088,5,3,147054,147054,147057,0,3,2
42089,1,1,147055,147057,147058,2,3,0
42090,3,2,147058,147058,147060,0,2,0
42091,1,2,147059,147060,147062,1,3,0
42092,2,2,147061,147062,147064,1,3,0
42093,5,2,147066,147066,147068,0,2,2
42094,1,2,147067,147068,147070,1,3,0
42095,2,1,147069,147070,147071,1,2,0
42096,1,2,147070,147071,147073,1,3,0
42097,2,3,147072,147073,147076,1,4,0
42098,6,2,147078,147078,147080,0,2,2
42099,3,1,147081,147081,147082,0,1,1
42100,6,2,147087,147087,147089,0,2,5
42101,1,2,147088,147089,147091,1,3,0
42102,2,2,147090,147091,147093,1,3,0
42103,3,1,147093,147093,147094,0,1,0
42104,6,3,147099,147099,147102,0,3,5
42105,6,1,147105,147105,147106,0,1,3
42106,4,1,147109,147109,147110,0,1,3
42107,3,1,147112,147112,147113,0,1,2
42108,6,2,147118,147118,147120,0,2,5
42109,5,1,147123,147123,147124,0,1,3
42110,2,3,147125,147125,147128,0,3,1
42111,5,1,147130,147130,147131,0,1,2
42112,3,2,147133,147133,147135,0,2,2
42113,4,1,147137,147137,147138,0,1,2
42114,6,3,147143,147143,147146,0,3,5
42115,4,1,147147,147147,147148,0,1,1
42116,6,3,147153,147153,147156,0,3,5
42117,2,1,147155,147156,147157,1,2,0
42118,4,1,147159,147159,147160,0,1,2
42119,4,2,147163,147163,147165,0,2,3
42120,3,1,147166,147166,147167,0,1,1
42121,1,1,147167,147167,147168,0,1,0
42122,2,2,147169,147169,147171,0,2,1
42123,5,2,147174,147174,147176,0,2,3
42124,2,1,147176,147176,147177,0,1,0
42125,4,1,147180,147180,147181,0,1,3
42126,3,2,147183,147183,147185,0,2,2
42127,2,3,147185,147185,147188,0,3,0
42128,1,1,147186,147188,147189,2,3,0
42129,1,1,147187,147189,147190,2,3,0
42130,3,1,147190,147190,147191,0,1,0
42131,1,1,147191,147191,147192,0,1,0
42132,1,3,147192,147192,147195,0,3,0
42133,4,3,147196,147196,147199,0,3,1
42134,6,2,147202,147202,147204,0,2,3
42135,3,3,147205,147205,147208,0,3,1
42136,3,2,147208,147208,147210,0,2,0
42137,1,3,147209,147210,147213,1,4,0
42138,2,1,147211,147213,147214,2,3,0
42139,4,3,147215,147215,147218,0,3,1
42140,2,3,147217,147218,147221,1,4,0
42141,1,3,147218,147221,147224,3,6,0
42142,5,1,147223,147224,147225,1,2,0
42143,3,3,147226,147226,147229,0,3,1
42144,3,1,147229,147229,147230,0,1,0
42145,5,3,147234,147234,147237,0,3,4
42146,3,3,147237,147237,147240,0,3,0
42147,2,1,147239,147240,147241,1,2,0
42148,3,2,147242,147242,147244,0,2,1
42149,6,3,147248,147248,147251,0,3,4
42150,2,1,147250,147251,147252,1,2,0
42151,1,2,147251,147252,147254,1,3,0
42152,2,2,147253,147254,147256,1,3,0
42153,3,1,147256,147256,147257,0,1,0
42154,3,2,147259,147259,147261,0,2,2
42155,1,2,147260,147261,147263,1,3,0
42156,5,2,147265,147265,147267,0,2,2
42157,4,3,147269,147269,147272,0,3,2
42158,6,1,147275,147275,147276,0,1,3
42159,6,2,147281,147281,147283,0,2,5
42160,5,2,147286,147286,147288,0,2,3
42161,2,2,147288,147288,147290,0,2,0
42162,1,3,147289,147290,147293,1,4,0
42163,4,3,147293,147293,147296,0,3,0
42164,6,3,147299,147299,147302,0,3,3
42165,6,3,147305,147305,147308,0,3,3
42166,3,2,147308,147308,147310,0,2,0
42167,6,2,147314,147314,147316,0,2,4
42168,2,2,147316,147316,147318,0,2,0
42169,4,2,147320,147320,147322,0,2,2
42170,3,3,147323,147323,147326,0,3,1
42171,6,1,147329,147329,147330,0,1,3
42172,3,2,147332,147332,147334,0,2,2
42173,6,2,147338,147338,147340,0,2,4
42174,4,3,147342,147342,147345,0,3,2
42175,3,3,147345,147345,147348,0,3,0
42176,6,2,147351,147351,147353,0,2,3
42177,2,1,147353,147353,147354,0,1,0
42178,4,2,147357,147357,147359,0,2,3
42179,2,2,147359,147359,147361,0,2,0
42180,1,2,147360,147361,147363,1,3,0
42181,6,1,147366,147366,147367,0,1,3
42182,2,3,147368,147368,147371,0,3,1
42183,2,2,147370,147371,147373,1,3,0
42184,5,3,147375,147375,147378,0,3,2
42185,5,2,147380,147380,147382,0,2,2
42186,6,1,147386,147386,147387,0,1,4
42187,3,1,147389,147389,147390,0,1,2
42188,4,2,147393,147393,147395,0,2,3
42189,4,1,147397,147397,147398,0,1,2
42190,1,3,147398,147398,147401,0,3,0
42191,6,3,147404,147404,147407,0,3,3
42192,1,1,147405,147407,147408,2,3,0
42193,2,1,147407,147408,147409,1,2,0
42194,4,3,147411,147411,147414,0,3,2
42195,3,1,147414,147414,147415,0,1,0
42196,1,1,147415,147415,147416,0,1,0
42197,5,2,147420,147420,147422,0,2,4
42198,1,3,147421,147422,147425,1,4,0
42199,1,3,147422,147425,147428,3,6,0
42200,3,2,147425,147428,147430,3,5,0
42201,5,2,147430,147430,147432,0,2,0
42202,2,1,147432,147432,147433,0,1,0
42203,2,2,147434,147434,147436,0,2,1
42204,6,1,147440,147440,147441,0,1,4
42205,3,2,147443,147443,147445,0,2,2
42206,2,2,147445,147445,147447,0,2,0
42207,1,2,147446,147447,147449,1,3,0
42208,1,2,147447,147449,147451,2,4,0
42209,6,3,147453,147453,147456,0,3,2
42210,3,1,147456,147456,147457,0,1,0
42211,4,2,147460,147460,147462,0,2,3
42212,6,3,147466,147466,147469,0,3,4
42213,4,2,147470,147470,147472,0,2,1
42214,5,2,147475,147475,147477,0,2,3
42215,1,3,147476,147477,147480,1,4,0
42216,6,2,147482,147482,147484,0,2,2
42217,1,1,147483,147484,147485,1,2,0
42218,2,2,147485,147485,147487,0,2,0
42219,4,3,147489,147489,147492,0,3,2
42220,3,2,147492,147492,147494,0,2,0
42221,2,3,147494,147494,147497,0,3,0
42222,5,1,147499,147499,147500,0,1,2
42223,3,2,147502,147502,147504,0,2,2
42224,2,1,147504,147504,147505,0,1,0
42225,4,1,147508,147508,147509,0,1,3
42226,2,3,147510,147510,147513,0,3,1
42227,1,2,147511,147513,147515,2,4,0
42228,4,1,147515,147515,147516,0,1,0
42229,5,3,147520,147520,147523,0,3,4
42230,5,2,147525,147525,147527,0,2,2
42231,6,1,147531,147531,147532,0,1,4
42232,3,3,147534,147534,147537,0,3,2
42233,1,2,147535,147537,147539,2,4,0
42234,1,1,147536,147539,147540,3,4,0
42235,6,2,147542,147542,147544,0,2,2
42236,3,3,147545,147545,147548,0,3,1
42237,1,1,147546,147548,147549,2,3,0
42238,5,1,147551,147551,147552,0,1,2
42239,4,3,147555,147555,147558,0,3,3
42240,6,2,147561,147561,147563,0,2,3
42241,5,3,147566,147566,147569,0,3,3
42242,1,3,147567,147569,147572,2,5,0
42243,5,3,147572,147572,147575,0,3,0
42244,2,2,147574,147575,147577,1,3,0
42245,1,2,147575,147577,147579,2,4,0
42246,2,1,147577,147579,147580,2,3,0
42247,5,1,147582,147582,147583,0,1,2
42248,3,2,147585,147585,147587,0,2,2
42249,6,2,147591,147591,147593,0,2,4
42250,5,3,147596,147596,147599,0,3,3
42251,2,2,147598,147599,147601,1,3,0
42252,2,1,147600,147601,147602,1,2,0
42253,5,2,147605,147605,147607,0,2,3
42254,3,3,147608,147608,147611,0,3,1
42255,1,1,147609,147611,147612,2,3,0
42256,3,3,147612,147612,147615,0,3,0
42257,4,3,147616,147616,147619,0,3,1
42258,5,2,147621,147621,147623,0,2,2
42259,2,2,147623,147623,147625,0,2,0
42260,6,3,147629,147629,147632,0,3,4
42261,5,1,147634,147634,147635,0,1,2
42262,1,2,147635,147635,147637,0,2,0
42263,3,3,147638,147638,147641,0,3,1
42264,2,2,147640,147641,147643,1,3,0
42265,1,1,147641,147643,147644,2,3,0
42266,5,1,147646,147646,147647,0,1,2
42267,5,3,147651,147651,147654,0,3,4
42268,3,2,147654,147654,147656,0,2,0
42269,6,1,147660,147660,147661,0,1,4
42270,3,3,147663,147663,147666,0,3,2
42271,1,1,147664,147666,147667,2,3,0
42272,4,2,147668,147668,147670,0,2,1
42273,6,1,147674,147674,147675,0,1,4
42274,1,1,147675,147675,147676,0,1,0
42275,3,2,147678,147678,147680,0,2,2
42276,2,1,147680,147680,147681,0,1,0
42277,6,3,147686,147686,147689,0,3,5
42278,5,1,147691,147691,147692,0,1,2
42279,5,2,147696,147696,147698,0,2,4
42280,6,3,147702,147702,147705,0,3,4
42281,3,2,147705,147705,147707,0,2,0
42282,6,1,147711,147711,147712,0,1,4
42283,5,2,147716,147716,147718,0,2,4
42284,4,2,147720,147720,147722,0,2,2
42285,2,3,147722,147722,147725,0,3,0
42286,5,3,147727,147727,147730,0,3,2
42287,1,3,147728,147730,147733,2,5,0
42288,3,1,147731,147733,147734,2,3,0
42289,1,2,147732,147734,147736,2,4,0
42290,6,2,147738,147738,147740,0,2,2
42291,3,1,147741,147741,147742,0,1,1
42292,6,2,147747,147747,147749,0,2,5
42293,1,3,147748,147749,147752,1,4,0
42294,6,1,147754,147754,147755,0,1,2
42295,2,1,147756,147756,147757,0,1,1
42296,2,1,147758,147758,147759,0,1,1
42297,5,3,147763,147763,147766,0,3,4
42298,3,3,147766,147766,147769,0,3,0
42299,3,1,147769,147769,147770,0,1,0
42300,6,1,147775,147775,147776,0,1,5
42301,2,3,147777,147777,147780,0,3,1
42302,2,2,147779,147780,147782,1,3,0
42303,1,1,147780,147782,147783,2,3,0
42304,2,3,147782,147783,147786,1,4,0
42305,5,3,147787,147787,147790,0,3,1
42306,4,2,147791,147791,147793,0,2,1
42307,4,2,147795,147795,147797,0,2,2
42308,3,1,147798,147798,147799,0,1,1
42309,3,1,147801,147801,147802,0,1,2
42310,3,1,147804,147804,147805,0,1,2
42311,4,1,147808,147808,147809,0,1,3
42312,6,2,147814,147814,147816,0,2,5
42313,6,3,147820,147820,147823,0,3,4
42314,1,2,147821,147823,147825,2,4,0
42315,6,1,147827,147827,147828,0,1,2
42316,6,3,147833,147833,147836,0,3,5
42317,3,2,147836,147836,147838,0,2,0
42318,1,1,147837,147838,147839,1,2,0
42319,1,1,147838,147839,147840,1,2,0
42320,2,1,147840,147840,147841,0,1,0
42321,6,3,147846,147846,147849,0,3,5
42322,3,2,147849,147849,147851,0,2,0
42323,5,2,147854,147854,147856,0,2,3
42324,5,1,147859,147859,147860,0,1,3
42325,4,2,147863,147863,147865,0,2,3
42326,3,2,147866,147866,147868,0,2,1
42327,6,2,147872,147872,147874,0,2,4
42328,3,1,147875,147875,147876,0,1,1
42329,2,3,147877,147877,147880,0,3,1
42330,5,1,147882,147882,147883,0,1,2
42331,1,1,147883,147883,147884,0,1,0
42332,5,1,147888,147888,147889,0,1,4
42333,6,3,147894,147894,147897,0,3,5
42334,2,3,147896,147897,147900,1,4,0
42335,3,1,147899,147900,147901,1,2,0
42336,2,3,147901,147901,147904,0,3,0
42337,4,2,147905,147905,147907,0,2,1
42338,1,3,147906,147907,147910,1,4,0
42339,6,3,147912,147912,147915,0,3,2
42340,2,1,147914,147915,147916,1,2,0
42341,2,3,147916,147916,147919,0,3,0
42342,2,2,147918,147919,147921,1,3,0
42343,6,2,147924,147924,147926,0,2,3
42344,4,3,147928,147928,147931,0,3,2
42345,3,1,147931,147931,147932,0,1,0
42346,2,2,147933,147933,147935,0,2,1
42347,1,1,147934,147935,147936,1,2,0
42348,5,2,147939,147939,147941,0,2,3
42349,2,3,147941,147941,147944,0,3,0
42350,4,2,147945,147945,147947,0,2,1
42351,2,1,147947,147947,147948,0,1,0
42352,5,2,147952,147952,147954,0,2,4
42353,2,1,147954,147954,147955,0,1,0
42354,2,1,147956,147956,147957,0,1,1
42355,3,1,147959,147959,147960,0,1,2
42356,3,3,147962,147962,147965,0,3,2
42357,6,1,147968,147968,147969,0,1,3
42358,6,1,147974,147974,147975,0,1,5
42359,1,2,147975,147975,147977,0,2,0
42360,2,1,147977,147977,147978,0,1,0
42361,5,1,147982,147982,147983,0,1,4
42362,3,1,147985,147985,147986,0,1,2
42363,6,3,147991,147991,147994,0,3,5
42364,2,1,147993,147994,147995,1,2,0
42365,4,2,147997,147997,147999,0,2,2
42366,2,1,147999,147999,148000,0,1,0
42367,1,3,148000,148000,148003,0,3,0
42368,3,1,148003,148003,148004,0,1,0
42369,3,3,148006,148006,148009,0,3,2
42370,6,2,148012,148012,148014,0,2,3
42371,3,2,148015,148015,148017,0,2,1
42372,6,3,148021,148021,148024,0,3,4
42373,6,3,148027,148027,148030,0,3,3
42374,6,3,148033,148033,148036,0,3,3
42375,1,3,148034,148036,148039,2,5,0
42376,5,3,148039,148039,148042,0,3,0
42377,6,1,148045,148045,148046,0,1,3
42378,2,1,148047,148047,148048,0,1,1
42379,6,3,148053,148053,148056,0,3,5
42380,4,3,148057,148057,148060,0,3,1
42381,3,1,148060,148060,148061,0,1,0
42382,3,1,148063,148063,148064,0,1,2
42383,1,2,148064,148064,148066,0,2,0
42384,5,3,148069,148069,148072,0,3,3
42385,1,1,148070,148072,148073,2,3,0
42386,3,3,148073,148073,148076,0,3,0
42387,3,1,148076,148076,148077,0,1,0
42388,1,3,148077,148077,148080,0,3,0
42389,3,1,148080,148080,148081,0,1,0
42390,4,3,148084,148084,148087,0,3,3
42391,5,1,148089,148089,148090,0,1,2
42392,2,1,148091,148091,148092,0,1,1
42393,2,1,148093,148093,148094,0,1,1
42394,1,2,148094,148094,148096,0,2,0
42395,6,2,148100,148100,148102,0,2,4
42396,2,1,148102,148102,148103,0,1,0
42397,2,1,148104,148104,148105,0,1,1
42398,1,3,148105,148105,148108,0,3,0
42399,6,1,148111,148111,148112,0,1,3
42400,3,3,148114,148114,148117,0,3,2
42401,3,2,148117,148117,148119,0,2,0
42402,1,3,148118,148119,148122,1,4,0
42403,4,2,148122,148122,148124,0,2,0
42404,1,1,148123,148124,148125,1,2,0
42405,2,3,148125,148125,148128,0,3,0
42406,4,3,148129,148129,148132,0,3,1
42407,1,1,148130,148132,148133,2,3,0
42408,5,3,148135,148135,148138,0,3,2
42409,5,1,148140,148140,148141,0,1,2
42410,6,2,148146,148146,148148,0,2,5
42411,5,3,148151,148151,148154,0,3,3
42412,6,2,148157,148157,148159,0,2,3
42413,2,2,148159,148159,148161,0,2,0
42414,4,2,148163,148163,148165,0,2,2
42415,6,2,148169,148169,148171,0,2,4
42416,1,2,148170,148171,148173,1,3,0
42417,2,2,148172,148173,148175,1,3,0
42418,6,2,148178,148178,148180,0,2,3
42419,3,2,148181,148181,148183,0,2,1
42420,5,1,148186,148186,148187,0,1,3
42421,3,2,148189,148189,148191,0,2,2
42422,4,1,148193,148193,148194,0,1,2
42423,5,2,148198,148198,148200,0,2,4
42424,2,1,148200,148200,148201,0,1,0
42425,3,2,148203,148203,148205,0,2,2
42426,5,3,148208,148208,148211,0,3,3
42427,6,2,148214,148214,148216,0,2,3
42428,5,1,148219,148219,148220,0,1,3
42429,5,3,148224,148224,148227,0,3,4
42430,6,1,148230,148230,148231,0,1,3
42431,1,1,148231,148231,148232,0,1,0
42432,4,2,148235,148235,148237,0,2,3
42433,5,3,148240,148240,148243,0,3,3
42434,4,2,148244,148244,148246,0,2,1
42435,5,3,148249,148249,148252,0,3,3
42436,3,1,148252,148252,148253,0,1,0
42437,6,2,148258,148258,148260,0,2,5
42438,5,3,148263,148263,148266,0,3,3
42439,5,2,148268,148268,148270,0,2,2
42440,6,3,148274,148274,148277,0,3,4
42441,4,2,148278,148278,148280,0,2,1
42442,3,1,148281,148281,148282,0,1,1
42443,6,1,148287,148287,148288,0,1,5
42444,4,2,148291,148291,148293,0,2,3
42445,2,3,148293,148293,148296,0,3,0
42446,6,2,148299,148299,148301,0,2,3
42447,4,1,148303,148303,148304,0,1,2
42448,5,1,148308,148308,148309,0,1,4
42449,4,2,148312,148312,148314,0,2,3
42450,3,2,148315,148315,148317,0,2,1
42451,6,3,148321,148321,148324,0,3,4
42452,3,1,148324,148324,148325,0,1,0
42453,3,3,148327,148327,148330,0,3,2
42454,5,3,148332,148332,148335,0,3,2
42455,3,1,148335,148335,148336,0,1,0
42456,6,1,148341,148341,148342,0,1,5
42457,2,3,148343,148343,148346,0,3,1
42458,1,1,148344,148346,148347,2,3,0
42459,2,2,148346,148347,148349,1,3,0
42460,2,2,148348,148349,148351,1,3,0
42461,2,1,148350,148351,148352,1,2,0
42462,3,1,148353,148353,148354,0,1,1
42463,4,2,148357,148357,148359,0,2,3
42464,3,2,148360,148360,148362,0,2,1
42465,1,3,148361,148362,148365,1,4,0
42466,2,3,148363,148365,148368,2,5,0
42467,6,3,148369,148369,148372,0,3,1
42468,5,1,148374,148374,148375,0,1,2
42469,3,2,148377,148377,148379,0,2,2
42470,3,1,148380,148380,148381,0,1,1
42471,5,3,148385,148385,148388,0,3,4
42472,4,1,148389,148389,148390,0,1,1
42473,2,3,148391,148391,148394,0,3,1
42474,5,1,148396,148396,148397,0,1,2
42475,5,3,148401,148401,148404,0,3,4
42476,2,1,148403,148404,148405,1,2,0
42477,5,2,148408,148408,148410,0,2,3
42478,1,3,148409,148410,148413,1,4,0
42479,5,1,148414,148414,148415,0,1,1
42480,6,2,148420,148420,148422,0,2,5
42481,1,2,148421,148422,148424,1,3,0
42482,5,1,148426,148426,148427,0,1,2
42483,4,3,148430,148430,148433,0,3,3
42484,3,1,148433,148433,148434,0,1,0
42485,2,3,148435,148435,148438,0,3,1
42486,3,2,148438,148438,148440,0,2,0
42487,6,1,148444,148444,148445,0,1,4
42488,5,2,148449,148449,148451,0,2,4
42489,6,1,148455,148455,148456,0,1,4
42490,3,3,148458,148458,148461,0,3,2
42491,4,2,148462,148462,148464,0,2,1
42492,6,1,148468,148468,148469,0,1,4
42493,6,3,148474,148474,148477,0,3,5
42494,4,3,148478,148478,148481,0,3,1
42495,4,1,148482,148482,148483,0,1,1
42496,1,1,148483,148483,148484,0,1,0
42497,5,2,148488,148488,148490,0,2,4
42498,5,2,148493,148493,148495,0,2,3
42499,2,3,148495,148495,148498,0,3,0
42500,3,1,148498,148498,148499,0,1,0
42501,1,2,148499,148499,148501,0,2,0
42502,4,3,148503,148503,148506,0,3,2
42503,2,2,148505,148506,148508,1,3,0
42504,6,3,148511,148511,148514,0,3,3
42505,5,3,148516,148516,148519,0,3,2
42506,1,1,148517,148519,148520,2,3,0
42507,6,3,148523,148523,148526,0,3,3
42508,2,3,148525,148526,148529,1,4,0
42509,2,3,148527,148529,148532,2,5,0
42510,5,3,148532,148532,148535,0,3,0
42511,2,2,148534,148535,148537,1,3,0
42512,4,3,148538,148538,148541,0,3,1
42513,1,1,148539,148541,148542,2,3,0
42514,1,3,148540,148542,148545,2,5,0
42515,3,2,148543,148545,148547,2,4,0
42516,4,2,148547,148547,148549,0,2,0
42517,4,1,148551,148551,148552,0,1,2
42518,5,1,148556,148556,148557,0,1,4
42519,6,1,148562,148562,148563,0,1,5
42520,4,1,148566,148566,148567,0,1,3
42521,1,2,148567,148567,148569,0,2,0
42522,1,3,148568,148569,148572,1,4,0
42523,4,2,148572,148572,148574,0,2,0
42524,3,3,148575,148575,148578,0,3,1
42525,2,2,148577,148578,148580,1,3,0
42526,2,1,148579,148580,148581,1,2,0
42527,3,1,148582,148582,148583,0,1,1
42528,6,3,148588,148588,148591,0,3,5
42529,5,3,148593,148593,148596,0,3,2
42530,1,1,148594,148596,148597,2,3,0
42531,2,3,148596,148597,148600,1,4,0
42532,5,1,148601,148601,148602,0,1,1
42533,6,3,148607,148607,148610,0,3,5
42534,4,3,148611,148611,148614,0,3,1
42535,6,2,148617,148617,148619,0,2,3
42536,5,3,148622,148622,148625,0,3,3
42537,1,1,148623,148625,148626,2,3,0
42538,5,2,148628,148628,148630,0,2,2
42539,1,2,148629,148630,148632,1,3,0
42540,5,3,148634,148634,148637,0,3,2
42541,1,2,148635,148637,148639,2,4,0
42542,3,3,148638,148639,148642,1,4,0
42543,1,2,148639,148642,148644,3,5,0
42544,2,1,148641,148644,148645,3,4,0
42545,3,3,148644,148645,148648,1,4,0
42546,3,1,148647,148648,148649,1,2,0
42547,2,2,148649,148649,148651,0,2,0
42548,2,2,148651,148651,148653,0,2,0
42549,2,3,148653,148653,148656,0,3,0
42550,4,3,148657,148657,148660,0,3,1
42551,5,2,148662,148662,148664,0,2,2
42552,4,2,148666,148666,148668,0,2,2
42553,4,1,148670,148670,148671,0,1,2
42554,5,2,148675,148675,148677,0,2,4
42555,2,3,148677,148677,148680,0,3,0
42556,2,1,148679,148680,148681,1,2,0
42557,4,2,148683,148683,148685,0,2,2
42558,5,1,148688,148688,148689,0,1,3
42559,5,3,148693,148693,148696,0,3,4
42560,6,2,148699,148699,148701,0,2,3
42561,1,1,148700,148701,148702,1,2,0
42562,5,2,148705,148705,148707,0,2,3
42563,3,3,148708,148708,148711,0,3,1
42564,5,3,148713,148713,148716,0,3,2
42565,4,2,148717,148717,148719,0,2,1
42566,1,1,148718,148719,148720,1,2,0
42567,3,1,148721,148721,148722,0,1,1
42568,5,2,148726,148726,148728,0,2,4
42569,2,2,148728,148728,148730,0,2,0
42570,3,1,148731,148731,148732,0,1,1
42571,3,2,148734,148734,148736,0,2,2
42572,2,3,148736,148736,148739,0,3,0
42573,4,1,148740,148740,148741,0,1,1
42574,6,3,148746,148746,148749,0,3,5
42575,6,2,148752,148752,148754,0,2,3
42576,2,2,148754,148754,148756,0,2,0
42577,1,3,148755,148756,148759,1,4,0
42578,5,3,148760,148760,148763,0,3,1
42579,6,3,148766,148766,148769,0,3,3
42580,2,2,148768,148769,148771,1,3,0
42581,2,1,148770,148771,148772,1,2,0
42582,3,2,148773,148773,148775,0,2,1
42583,1,3,148774,148775,148778,1,4,0
42584,6,3,148780,148780,148783,0,3,2
42585,2,3,148782,148783,148786,1,4,0
42586,1,2,148783,148786,148788,3,5,0
42587,3,1,148786,148788,148789,2,3,0
42588,4,3,148790,148790,148793,0,3,1
42589,5,1,148795,148795,148796,0,1,2
42590,6,1,148801,148801,148802,0,1,5
42591,3,2,148804,148804,148806,0,2,2
42592,5,1,148809,148809,148810,0,1,3
42593,6,1,148815,148815,148816,0,1,5
42594,6,1,148821,148821,148822,0,1,5
42595,6,2,148827,148827,148829,0,2,5
42596,6,2,148833,148833,148835,0,2,4
42597,6,1,148839,148839,148840,0,1,4
42598,2,1,148841,148841,148842,0,1,1
42599,1,2,148842,148842,148844,0,2,0
42600,1,2,148843,148844,148846,1,3,0
42601,5,2,148848,148848,148850,0,2,2
42602,2,2,148850,148850,148852,0,2,0
42603,3,2,148853,148853,148855,0,2,1
42604,2,3,148855,148855,148858,0,3,0
42605,3,2,148858,148858,148860,0,2,0
42606,3,2,148861,148861,148863,0,2,1
42607,1,2,148862,148863,148865,1,3,0
42608,4,3,148866,148866,148869,0,3,1
42609,3,3,148869,148869,148872,0,3,0
42610,2,3,148871,148872,148875,1,4,0
42611,1,2,148872,148875,148877,3,5,0
42612,5,3,148877,148877,148880,0,3,0
42613,6,1,148883,148883,148884,0,1,3
42614,3,1,148886,148886,148887,0,1,2
42615,1,1,148887,148887,148888,0,1,0
42616,2,3,148889,148889,148892,0,3,1
42617,4,2,148893,148893,148895,0,2,1
42618,6,2,148899,148899,148901,0,2,4
42619,4,3,148903,148903,148906,0,3,2
42620,3,3,148906,148906,148909,0,3,0
42621,4,2,148910,148910,148912,0,2,1
42622,6,3,148916,148916,148919,0,3,4
42623,6,1,148922,148922,148923,0,1,3
42624,1,3,148923,148923,148926,0,3,0
42625,5,3,148928,148928,148931,0,3,2
42626,6,2,148934,148934,148936,0,2,3
42627,3,1,148937,148937,148938,0,1,1
42628,1,3,148938,148938,148941,0,3,0
42629,1,2,148939,148941,148943,2,4,0
42630,2,1,148941,148943,148944,2,3,0
42631,5,2,148946,148946,148948,0,2,2
42632,1,1,148947,148948,148949,1,2,0
42633,4,3,148951,148951,148954,0,3,2
42634,4,2,148955,148955,148957,0,2,1
42635,6,2,148961,148961,148963,0,2,4
42636,6,3,148967,148967,148970,0,3,4
42637,6,3,148973,148973,148976,0,3,3
42638,5,1,148978,148978,148979,0,1,2
42639,5,1,148983,148983,148984,0,1,4
42640,2,1,148985,148985,148986,0,1,1
42641,1,2,148986,148986,148988,0,2,0
42642,6,2,148992,148992,148994,0,2,4
42643,6,2,148998,148998,149000,0,2,4
42644,3,2,149001,149001,149003,0,2,1
42645,5,1,149006,149006,149007,0,1,3
42646,6,1,149012,149012,149013,0,1,5
42647,1,3,149013,149013,149016,0,3,0
42648,5,2,149018,149018,149020,0,2,2
42649,2,2,149020,149020,149022,0,2,0
42650,4,1,149024,149024,149025,0,1,2
42651,4,1,149028,149028,149029,0,1,3
42652,6,2,149034,149034,149036,0,2,5
42653,2,2,149036,149036,149038,0,2,0
42654,5,1,149041,149041,149042,0,1,3
42655,6,1,149047,149047,149048,0,1,5
42656,6,1,149053,149053,149054,0,1,5
42657,1,2,149054,149054,149056,0,2,0
42658,5,1,149059,149059,149060,0,1,3
42659,6,3,149065,149065,149068,0,3,5
42660,3,1,149068,149068,149069,0,1,0
42661,5,3,149073,149073,149076,0,3,4
42662,6,3,149079,149079,149082,0,3,3
42663,3,1,149082,149082,149083,0,1,0
42664,3,1,149085,149085,149086,0,1,2
42665,4,1,149089,149089,149090,0,1,3
42666,1,3,149090,149090,149093,0,3,0
42667,6,1,149096,149096,149097,0,1,3
42668,1,1,149097,149097,149098,0,1,0
42669,2,2,149099,149099,149101,0,2,1
42670,2,1,149101,149101,149102,0,1,0
42671,1,1,149102,149102,149103,0,1,0
42672,5,3,149107,149107,149110,0,3,4
42673,5,3,149112,149112,149115,0,3,2
42674,5,2,149117,149117,149119,0,2,2
42675,6,3,149123,149123,149126,0,3,4
42676,5,2,149128,149128,149130,0,2,2
42677,6,1,149134,149134,149135,0,1,4
42678,6,2,149140,149140,149142,0,2,5
42679,1,1,149141,149142,149143,1,2,0
42680,1,1,149142,149143,149144,1,2,0
42681,2,1,149144,149144,149145,0,1,0
42682,1,2,149145,149145,149147,0,2,0
42683,3,3,149148,149148,149151,0,3,1
42684,6,1,149154,149154,149155,0,1,3
42685,1,2,149155,149155,149157,0,2,0
42686,5,2,149160,149160,149162,0,2,3
42687,5,3,149165,149165,149168,0,3,3
42688,2,1,149167,149168,149169,1,2,0
42689,1,3,149168,149169,149172,1,4,0
42690,4,3,149172,149172,149175,0,3,0
42691,5,2,149177,149177,149179,0,2,2
42692,4,3,149181,149181,149184,0,3,2
42693,6,3,149187,149187,149190,0,3,3
42694,4,3,149191,149191,149194,0,3,1
42695,3,3,149194,149194,149197,0,3,0
42696,5,3,149199,149199,149202,0,3,2
42697,2,2,149201,149202,149204,1,3,0
42698,6,3,149207,149207,149210,0,3,3
42699,4,1,149211,149211,149212,0,1,1
42700,4,3,149215,149215,149218,0,3,3
42701,2,1,149217,149218,149219,1,2,0
42702,2,2,149219,149219,149221,0,2,0
42703,2,2,149221,149221,149223,0,2,0
42704,2,1,149223,149223,149224,0,1,0
42705,5,2,149228,149228,149230,0,2,4
42706,5,1,149233,149233,149234,0,1,3
42707,4,3,149237,149237,149240,0,3,3
42708,3,2,149240,149240,149242,0,2,0
42709,4,2,149244,149244,149246,0,2,2
42710,5,1,149249,149249,149250,0,1,3
42711,3,2,149252,149252,149254,0,2,2
42712,3,3,149255,149255,149258,0,3,1
42713,3,3,149258,149258,149261,0,3,0
42714,4,1,149262,149262,149263,0,1,1
42715,5,3,149267,149267,149270,0,3,4
42716,3,2,149270,149270,149272,0,2,0
42717,2,1,149272,149272,149273,0,1,0
42718,3,3,149275,149275,149278,0,3,2
42719,3,1,149278,149278,149279,0,1,0
42720,3,2,149281,149281,149283,0,2,2
42721,1,2,149282,149283,149285,1,3,0
42722,4,1,149286,149286,149287,0,1,1
42723,6,1,149292,149292,149293,0,1,5
42724,3,2,149295,149295,149297,0,2,2
42725,4,3,149299,149299,149302,0,3,2
42726,2,1,149301,149302,149303,1,2,0
42727,2,1,149303,149303,149304,0,1,0
42728,6,3,149309,149309,149312,0,3,5
42729,3,3,149312,149312,149315,0,3,0
42730,4,2,149316,149316,149318,0,2,1
42731,1,3,149317,149318,149321,1,4,0
42732,6,3,149323,149323,149326,0,3,2
42733,2,1,149325,149326,149327,1,2,0
42734,6,2,149331,149331,149333,0,2,4
42735,4,2,149335,149335,149337,0,2,2
42736,6,2,149341,149341,149343,0,2,4
42737,6,3,149347,149347,149350,0,3,4
42738,3,1,149350,149350,149351,0,1,0
42739,3,1,149353,149353,149354,0,1,2
42740,5,1,149358,149358,149359,0,1,4
42741,5,2,149363,149363,149365,0,2,4
42742,5,3,149368,149368,149371,0,3,3
42743,4,1,149372,149372,149373,0,1,1
42744,4,3,149376,149376,149379,0,3,3
42745,2,2,149378,149379,149381,1,3,0
42746,1,1,149379,149381,149382,2,3,0
42747,4,3,149383,149383,149386,0,3,1
42748,4,1,149387,149387,149388,0,1,1
42749,4,2,149391,149391,149393,0,2,3
42750,5,2,149396,149396,149398,0,2,3
42751,2,1,149398,149398,149399,0,1,0
42752,5,3,149403,149403,149406,0,3,4
42753,3,1,149406,149406,149407,0,1,0
42754,1,1,149407,149407,149408,0,1,0
42755,6,1,149413,149413,149414,0,1,5
42756,2,3,149415,149415,149418,0,3,1
42757,1,2,149416,149418,149420,2,4,0
42758,3,2,149419,149420,149422,1,3,0
42759,4,1,149423,149423,149424,0,1,1
42760,2,1,149425,149425,149426,0,1,1
42761,6,2,149431,149431,149433,0,2,5
42762,1,3,149432,149433,149436,1,4,0
42763,3,2,149435,149436,149438,1,3,0
42764,1,2,149436,149438,149440,2,4,0
42765,2,1,149438,149440,149441,2,3,0
42766,6,1,149444,149444,149445,0,1,3
42767,5,3,149449,149449,149452,0,3,4
42768,5,3,149454,149454,149457,0,3,2
42769,2,2,149456,149457,149459,1,3,0
42770,1,3,149457,149459,149462,2,5,0
42771,6,1,149463,149463,149464,0,1,1
42772,3,2,149466,149466,149468,0,2,2
42773,1,1,149467,149468,149469,1,2,0
42774,3,3,149470,149470,149473,0,3,1
42775,2,1,149472,149473,149474,1,2,0
42776,6,1,149478,149478,149479,0,1,4
42777,6,3,149484,149484,149487,0,3,5
42778,5,3,149489,149489,149492,0,3,2
42779,1,3,149490,149492,149495,2,5,0
42780,3,1,149493,149495,149496,2,3,0
42781,6,2,149499,149499,149501,0,2,3
42782,6,2,149505,149505,149507,0,2,4
42783,5,3,149510,149510,149513,0,3,3
42784,2,2,149512,149513,149515,1,3,0
42785,6,3,149518,149518,149521,0,3,3
42786,4,2,149522,149522,149524,0,2,1
42787,2,3,149524,149524,149527,0,3,0
42788,4,3,149528,149528,149531,0,3,1
42789,4,3,149532,149532,149535,0,3,1
42790,3,3,149535,149535,149538,0,3,0
42791,4,1,149539,149539,149540,0,1,1
42792,3,2,149542,149542,149544,0,2,2
42793,1,2,149543,149544,149546,1,3,0
42794,4,1,149547,149547,149548,0,1,1
42795,2,2,149549,149549,149551,0,2,1
42796,5,1,149554,149554,149555,0,1,3
42797,1,2,149555,149555,149557,0,2,0
42798,3,3,149558,149558,149561,0,3,1
42799,6,2,149564,149564,149566,0,2,3
42800,5,1,149569,149569,149570,0,1,3
42801,4,3,149573,149573,149576,0,3,3
42802,1,1,149574,149576,149577,2,3,0
42803,1,2,149575,149577,149579,2,4,0
42804,4,1,149579,149579,149580,0,1,0
42805,1,1,149580,149580,149581,0,1,0
42806,6,1,149586,149586,149587,0,1,5
42807,4,3,149590,149590,149593,0,3,3
42808,3,3,149593,149593,149596,0,3,0
42809,5,2,149598,149598,149600,0,2,2
42810,5,3,149603,149603,149606,0,3,3
42811,6,3,149609,149609,149612,0,3,3
42812,3,1,149612,149612,149613,0,1,0
42813,3,3,149615,149615,149618,0,3,2
42814,3,1,149618,149618,149619,0,1,0
42815,6,3,149624,149624,149627,0,3,5
42816,6,1,149630,149630,149631,0,1,3
42817,2,1,149632,149632,149633,0,1,1
42818,5,1,149637,149637,149638,0,1,4
42819,4,1,149641,149641,149642,0,1,3
42820,2,3,149643,149643,149646,0,3,1
42821,6,3,149649,149649,149652,0,3,3
42822,5,2,149654,149654,149656,0,2,2
42823,5,2,149659,149659,149661,0,2,3
42824,4,2,149663,149663,149665,0,2,2
42825,2,1,149665,149665,149666,0,1,0
42826,5,2,149670,149670,149672,0,2,4
42827,3,2,149673,149673,149675,0,2,1
42828,5,3,149678,149678,149681,0,3,3
42829,1,3,149679,149681,149684,2,5,0
42830,5,3,149684,149684,149687,0,3,0
42831,3,1,149687,149687,149688,0,1,0
42832,2,3,149689,149689,149692,0,3,1
42833,3,2,149692,149692,149694,0,2,0
42834,4,1,149696,149696,149697,0,1,2
42835,1,2,149697,149697,149699,0,2,0
42836,2,3,149699,149699,149702,0,3,0
42837,5,2,149704,149704,149706,0,2,2
42838,6,1,149710,149710,149711,0,1,4
42839,5,1,149715,149715,149716,0,1,4
42840,2,1,149717,149717,149718,0,1,1
42841,5,1,149722,149722,149723,0,1,4
42842,5,1,149727,149727,149728,0,1,4
42843,4,3,149731,149731,149734,0,3,3
42844,6,2,149737,149737,149739,0,2,3
42845,2,2,149739,149739,149741,0,2,0
42846,5,2,149744,149744,149746,0,2,3
42847,1,1,149745,149746,149747,1,2,0
42848,4,3,149749,149749,149752,0,3,2
42849,3,2,149752,149752,149754,0,2,0
42850,3,3,149755,149755,149758,0,3,1
42851,4,1,149759,149759,149760,0,1,1
42852,1,1,149760,149760,149761,0,1,0
42853,1,1,149761,149761,149762,0,1,0
42854,2,1,149763,149763,149764,0,1,1
42855,6,2,149769,149769,149771,0,2,5
42856,1,3,149770,149771,149774,1,4,0
42857,6,3,149776,149776,149779,0,3,2
42858,4,1,149780,149780,149781,0,1,1
42859,2,3,149782,149782,149785,0,3,1
42860,5,3,149787,149787,149790,0,3,2
42861,5,3,149792,149792,149795,0,3,2
42862,4,3,149796,149796,149799,0,3,1
42863,6,2,149802,149802,149804,0,2,3
42864,2,2,149804,149804,149806,0,2,0
42865,1,2,149805,149806,149808,1,3,0
42866,5,2,149810,149810,149812,0,2,2
42867,2,2,149812,149812,149814,0,2,0
42868,2,3,149814,149814,149817,0,3,0
42869,2,3,149816,149817,149820,1,4,0
42870,6,2,149822,149822,149824,0,2,2
42871,3,1,149825,149825,149826,0,1,1
42872,3,1,149828,149828,149829,0,1,2
42873,2,2,149830,149830,149832,0,2,1
42874,5,1,149835,149835,149836,0,1,3
42875,2,2,149837,149837,149839,0,2,1
42876,4,2,149841,149841,149843,0,2,2
42877,6,1,149847,149847,149848,0,1,4
42878,5,2,149852,149852,149854,0,2,4
42879,5,3,149857,149857,149860,0,3,3
42880,2,3,149859,149860,149863,1,4,0
42881,3,2,149862,149863,149865,1,3,0
42882,1,3,149863,149865,149868,2,5,0
42883,6,1,149869,149869,149870,0,1,1
42884,1,3,149870,149870,149873,0,3,0
42885,2,3,149872,149873,149876,1,4,0
42886,4,1,149876,149876,149877,0,1,0
42887,6,1,149882,149882,149883,0,1,5
42888,3,2,149885,149885,149887,0,2,2
42889,2,1,149887,149887,149888,0,1,0
42890,4,2,149891,149891,149893,0,2,3
42891,5,2,149896,149896,149898,0,2,3
42892,5,1,149901,149901,149902,0,1,3
42893,4,2,149905,149905,149907,0,2,3
42894,1,2,149906,149907,149909,1,3,0
42895,4,2,149910,149910,149912,0,2,1
42896,2,2,149912,149912,149914,0,2,0
42897,4,2,149916,149916,149918,0,2,2
42898,1,1,149917,149918,149919,1,2,0
42899,5,3,149922,149922,149925,0,3,3
42900,1,2,149923,149925,149927,2,4,0
42901,5,2,149928,149928,149930,0,2,1
42902,4,3,149932,149932,149935,0,3,2
42903,2,1,149934,149935,149936,1,2,0
42904,6,3,149940,149940,149943,0,3,4
42905,3,1,149943,149943,149944,0,1,0
42906,3,2,149946,149946,149948,0,2,2
42907,6,1,149952,149952,149953,0,1,4
42908,6,2,149958,149958,149960,0,2,5
42909,1,1,149959,149960,149961,1,2,0
42910,2,3,149961,149961,149964,0,3,0
42911,4,3,149965,149965,149968,0,3,1
42912,4,2,149969,149969,149971,0,2,1
42913,1,3,149970,149971,149974,1,4,0
42914,3,3,149973,149974,149977,1,4,0
42915,6,1,149979,149979,149980,0,1,2
42916,2,1,149981,149981,149982,0,1,1
42917,5,2,149986,149986,149988,0,2,4
42918,2,1,149988,149988,149989,0,1,0
42919,6,2,149994,149994,149996,0,2,5
42920,5,2,149999,149999,150001,0,2,3
42921,1,2,150000,150001,150003,1,3,0
42922,2,1,150002,150003,150004,1,2,0
42923,1,2,150003,150004,150006,1,3,0
42924,2,2,150005,150006,150008,1,3,0
42925,1,3,150006,150008,150011,2,5,0
42926,6,1,150012,150012,150013,0,1,1
42927,4,3,150016,150016,150019,0,3,3
42928,1,2,150017,150019,150021,2,4,0
42929,5,2,150022,150022,150024,0,2,1
42930,6,3,150028,150028,150031,0,3,4
42931,6,1,150034,150034,150035,0,1,3
42932,1,2,150035,150035,150037,0,2,0
42933,5,1,150040,150040,150041,0,1,3
42934,1,3,150041,150041,150044,0,3,0
42935,6,2,150047,150047,150049,0,2,3
42936,1,1,150048,150049,150050,1,2,0
42937,6,3,150054,150054,150057,0,3,4
42938,2,3,150056,150057,150060,1,4,0
42939,5,3,150061,150061,150064,0,3,1
42940,5,1,150066,150066,150067,0,1,2
42941,1,3,150067,150067,150070,0,3,0
42942,5,3,150072,150072,150075,0,3,2
42943,3,3,150075,150075,150078,0,3,0
42944,3,2,150078,150078,150080,0,2,0
42945,4,2,150082,150082,150084,0,2,2
42946,3,1,150085,150085,150086,0,1,1
42947,5,3,150090,150090,150093,0,3,4
42948,3,2,150093,150093,150095,0,2,0
42949,2,3,150095,150095,150098,0,3,0
42950,5,2,150100,150100,150102,0,2,2
42951,3,1,150103,150103,150104,0,1,1
42952,3,3,150106,150106,150109,0,3,2
42953,4,2,150110,150110,150112,0,2,1
42954,4,1,150114,150114,150115,0,1,2
42955,1,1,150115,150115,150116,0,1,0
42956,6,2,150121,150121,150123,0,2,5
42957,6,2,150127,150127,150129,0,2,4
42958,4,2,150131,150131,150133,0,2,2
42959,3,3,150134,150134,150137,0,3,1
42960,3,2,150137,150137,150139,0,2,0
42961,6,1,150143,150143,150144,0,1,4
42962,3,1,150146,150146,150147,0,1,2
42963,1,1,150147,150147,150148,0,1,0
42964,4,3,150151,150151,150154,0,3,3
42965,2,2,150153,150154,150156,1,3,0
42966,5,2,150158,150158,150160,0,2,2
42967,5,1,150163,150163,150164,0,1,3
42968,1,1,150164,150164,150165,0,1,0
42969,1,2,150165,150165,150167,0,2,0
42970,3,2,150168,150168,150170,0,2,1
42971,4,2,150172,150172,150174,0,2,2
42972,5,3,150177,150177,150180,0,3,3
42973,2,1,150179,150180,150181,1,2,0
42974,3,2,150182,150182,150184,0,2,1
42975,6,2,150188,150188,150190,0,2,4
42976,6,2,150194,150194,150196,0,2,4
42977,1,2,150195,150196,150198,1,3,0
42978,2,2,150197,150198,150200,1,3,0
42979,2,1,150199,150200,150201,1,2,0
42980,5,3,150204,150204,150207,0,3,3
42981,6,3,150210,150210,150213,0,3,3
42982,3,1,150213,150213,150214,0,1,0
42983,1,2,150214,150214,150216,0,2,0
42984,6,3,150220,150220,150223,0,3,4
42985,3,2,150223,150223,150225,0,2,0
42986,2,3,150225,150225,150228,0,3,0
42987,3,2,150228,150228,150230,0,2,0
42988,5,2,150233,150233,150235,0,2,3
42989,6,3,150239,150239,150242,0,3,4
42990,3,1,150242,150242,150243,0,1,0
42991,1,2,150243,150243,150245,0,2,0
42992,1,3,150244,150245,150248,1,4,0
42993,4,2,150248,150248,150250,0,2,0
42994,1,3,150249,150250,150253,1,4,0
42995,3,3,150252,150253,150256,1,4,0
42996,1,3,150253,150256,150259,3,6,0
42997,1,2,150254,150259,150261,5,7,0
42998,4,3,150258,150261,150264,3,6,0
42999,6,2,150264,150264,150266,0,2,0
43000,2,2,150266,150266,150268,0,2,0
43001,4,3,150270,150270,150273,0,3,2
43002,4,1,150274,150274,150275,0,1,1
43003,2,1,150276,150276,150277,0,1,1
43004,3,1,150279,150279,150280,0,1,2
43005,3,2,150282,150282,150284,0,2,2
43006,1,2,150283,150284,150286,1,3,0
43007,5,3,150288,150288,150291,0,3,2
43008,5,3,150293,150293,150296,0,3,2
43009,2,3,150295,150296,150299,1,4,0
43010,5,1,150300,150300,150301,0,1,1
43011,5,3,150305,150305,150308,0,3,4
43012,5,1,150310,150310,150311,0,1,2
43013,2,2,150312,150312,150314,0,2,1
43014,6,2,150318,150318,150320,0,2,4
43015,6,2,150324,150324,150326,0,2,4
43016,6,2,150330,150330,150332,0,2,4
43017,3,2,150333,150333,150335,0,2,1
43018,3,3,150336,150336,150339,0,3,1
43019,1,1,150337,150339,150340,2,3,0
43020,3,1,150340,150340,150341,0,1,0
43021,6,2,150346,150346,150348,0,2,5
43022,3,1,150349,150349,150350,0,1,1
43023,6,3,150355,150355,150358,0,3,5
43024,2,1,150357,150358,150359,1,2,0
43025,5,1,150362,150362,150363,0,1,3
43026,1,3,150363,150363,150366,0,3,0
43027,1,1,150364,150366,150367,2,3,0
43028,2,2,150366,150367,150369,1,3,0
43029,1,2,150367,150369,150371,2,4,0
43030,6,3,150373,150373,150376,0,3,2
43031,6,1,150379,150379,150380,0,1,3
43032,3,3,150382,150382,150385,0,3,2
43033,1,1,150383,150385,150386,2,3,0
43034,3,2,150386,150386,150388,0,2,0
43035,2,1,150388,150388,150389,0,1,0
43036,1,3,150389,150389,150392,0,3,0
43037,6,1,150395,150395,150396,0,1,3
43038,5,1,150400,150400,150401,0,1,4
43039,5,1,150405,150405,150406,0,1,4
43040,6,2,150411,150411,150413,0,2,5
43041,2,1,150413,150413,150414,0,1,0
43042,6,3,150419,150419,150422,0,3,5
43043,2,2,150421,150422,150424,1,3,0
43044,2,2,150423,150424,150426,1,3,0
43045,5,3,150428,150428,150431,0,3,2
43046,2,3,150430,150431,150434,1,4,0
43047,4,3,150434,150434,150437,0,3,0
43048,2,2,150436,150437,150439,1,3,0
43049,5,2,150441,150441,150443,0,2,2
43050,4,2,150445,150445,150447,0,2,2
43051,5,1,150450,150450,150451,0,1,3
43052,6,2,150456,150456,150458,0,2,5
43053,4,2,150460,150460,150462,0,2,2
43054,2,3,150462,150462,150465,0,3,0
43055,2,3,150464,150465,150468,1,4,0
43056,5,1,150469,150469,150470,0,1,1
43057,4,1,150473,150473,150474,0,1,3
43058,1,3,150474,150474,150477,0,3,0
43059,1,2,150475,150477,150479,2,4,0
43060,3,3,150478,150479,150482,1,4,0
43061,6,3,150484,150484,150487,0,3,2
43062,4,2,150488,150488,150490,0,2,1
43063,6,1,150494,150494,150495,0,1,4
43064,3,3,150497,150497,150500,0,3,2
43065,5,2,150502,150502,150504,0,2,2
43066,3,2,150505,150505,150507,0,2,1
43067,5,3,150510,150510,150513,0,3,3
43068,5,3,150515,150515,150518,0,3,2
43069,5,1,150520,150520,150521,0,1,2
43070,2,2,150522,150522,150524,0,2,1
43071,6,2,150528,150528,150530,0,2,4
43072,5,3,150533,150533,150536,0,3,3
43073,3,2,150536,150536,150538,0,2,0
43074,4,3,150540,150540,150543,0,3,2
43075,2,1,150542,150543,150544,1,2,0
43076,3,1,150545,150545,150546,0,1,1
43077,4,1,150549,150549,150550,0,1,3
43078,3,2,150552,150552,150554,0,2,2
43079,1,3,150553,150554,150557,1,4,0
43080,1,1,150554,150557,150558,3,4,0
43081,3,1,150557,150558,150559,1,2,0
43082,3,3,150560,150560,150563,0,3,1
43083,1,3,150561,150563,150566,2,5,0
43084,1,2,150562,150566,150568,4,6,0
43085,4,1,150566,150568,150569,2,3,0
43086,2,2,150568,150569,150571,1,3,0
43087,1,2,150569,150571,150573,2,4,0
43088,2,3,150571,150573,150576,2,5,0
43089,6,1,150577,150577,150578,0,1,1
43090,3,2,150580,150580,150582,0,2,2
43091,3,2,150583,150583,150585,0,2,1
43092,3,3,150586,150586,150589,0,3,1
43093,2,2,150588,150589,150591,1,3,0
43094,4,3,150592,150592,150595,0,3,1
43095,4,1,150596,150596,150597,0,1,1
43096,6,2,150602,150602,150604,0,2,5
43097,2,3,150604,150604,150607,0,3,0
43098,2,2,150606,150607,150609,1,3,0
43099,3,2,150609,150609,150611,0,2,0
43100,2,1,150611,150611,150612,0,1,0
43101,2,3,150613,150613,150616,0,3,1
43102,3,1,150616,150616,150617,0,1,0
43103,5,2,150621,150621,150623,0,2,4
43104,4,1,150625,150625,150626,0,1,2
43105,3,1,150628,150628,150629,0,1,2
43106,2,2,150630,150630,150632,0,2,1
43107,6,1,150636,150636,150637,0,1,4
43108,2,3,150638,150638,150641,0,3,1
43109,4,1,150642,150642,150643,0,1,1
43110,6,3,150648,150648,150651,0,3,5
43111,5,2,150653,150653,150655,0,2,2
43112,1,3,150654,150655,150658,1,4,0
43113,3,2,150657,150658,150660,1,3,0
43114,4,3,150661,150661,150664,0,3,1
43115,5,1,150666,150666,150667,0,1,2
43116,2,2,150668,150668,150670,0,2,1
43117,4,1,150672,150672,150673,0,1,2
43118,6,3,150678,150678,150681,0,3,5
43119,5,2,150683,150683,150685,0,2,2
43120,3,2,150686,150686,150688,0,2,1
43121,5,3,150691,150691,150694,0,3,3
43122,6,3,150697,150697,150700,0,3,3
43123,3,1,150700,150700,150701,0,1,0
43124,2,1,150702,150702,150703,0,1,1
43125,3,3,150705,150705,150708,0,3,2
43126,4,1,150709,150709,150710,0,1,1
43127,6,1,150715,150715,150716,0,1,5
43128,6,3,150721,150721,150724,0,3,5
43129,6,1,150727,150727,150728,0,1,3
43130,2,2,150729,150729,150731,0,2,1
43131,5,2,150734,150734,150736,0,2,3
43132,2,3,150736,150736,150739,0,3,0
43133,4,1,150740,150740,150741,0,1,1
43134,5,1,150745,150745,150746,0,1,4
43135,3,1,150748,150748,150749,0,1,2
43136,4,1,150752,150752,150753,0,1,3
43137,1,3,150753,150753,150756,0,3,0
43138,3,1,150756,150756,150757,0,1,0
43139,3,2,150759,150759,150761,0,2,2
43140,5,3,150764,150764,150767,0,3,3
43141,2,3,150766,150767,150770,1,4,0
43142,1,1,150767,150770,150771,3,4,0
43143,1,1,150768,150771,150772,3,4,0
43144,3,1,150771,150772,150773,1,2,0
43145,6,1,150777,150777,150778,0,1,4
43146,2,1,150779,150779,150780,0,1,1
43147,1,2,150780,150780,150782,0,2,0
43148,5,3,150785,150785,150788,0,3,3
43149,5,2,150790,150790,150792,0,2,2
43150,1,3,150791,150792,150795,1,4,0
43151,2,3,150793,150795,150798,2,5,0
43152,3,3,150796,150798,150801,2,5,0
43153,2,2,150798,150801,150803,3,5,0
43154,1,2,150799,150803,150805,4,6,0
43155,4,1,150803,150805,150806,2,3,0
43156,4,2,150807,150807,150809,0,2,1
43157,1,2,150808,150809,150811,1,3,0
43158,1,3,150809,150811,150814,2,5,0
43159,1,1,150810,150814,150815,4,5,0
43160,2,1,150812,150815,150816,3,4,0
43161,2,1,150814,150816,150817,2,3,0
43162,2,3,150816,150817,150820,1,4,0
43163,6,2,150822,150822,150824,0,2,2
43164,5,2,150827,150827,150829,0,2,3
43165,6,3,150833,150833,150836,0,3,4
43166,5,1,150838,150838,150839,0,1,2
43167,2,1,150840,150840,150841,0,1,1
43168,6,3,150846,150846,150849,0,3,5
43169,2,1,150848,150849,150850,1,2,0
43170,4,2,150852,150852,150854,0,2,2
43171,1,2,150853,150854,150856,1,3,0
43172,4,2,150857,150857,150859,0,2,1
43173,3,2,150860,150860,150862,0,2,1
43174,5,3,150865,150865,150868,0,3,3
43175,2,1,150867,150868,150869,1,2,0
43176,5,3,150872,150872,150875,0,3,3
43177,4,1,150876,150876,150877,0,1,1
43178,5,2,150881,150881,150883,0,2,4
43179,6,2,150887,150887,150889,0,2,4
43180,1,3,150888,150889,150892,1,4,0
43181,3,1,150891,150892,150893,1,2,0
43182,5,3,150896,150896,150899,0,3,3
43183,6,1,150902,150902,150903,0,1,3
43184,3,2,150905,150905,150907,0,2,2
43185,3,1,150908,150908,150909,0,1,1
43186,4,3,150912,150912,150915,0,3,3
43187,3,1,150915,150915,150916,0,1,0
43188,6,1,150921,150921,150922,0,1,5
43189,4,1,150925,150925,150926,0,1,3
43190,5,1,150930,150930,150931,0,1,4
43191,4,3,150934,150934,150937,0,3,3
43192,3,2,150937,150937,150939,0,2,0
43193,1,1,150938,150939,150940,1,2,0
43194,5,1,150943,150943,150944,0,1,3
43195,2,1,150945,150945,150946,0,1,1
43196,2,1,150947,150947,150948,0,1,1
43197,3,3,150950,150950,150953,0,3,2
43198,2,1,150952,150953,150954,1,2,0
43199,1,1,150953,150954,150955,1,2,0
43200,2,1,150955,150955,150956,0,1,0
43201,1,3,150956,150956,150959,0,3,0
43202,3,3,150959,150959,150962,0,3,0
43203,6,2,150965,150965,150967,0,2,3
43204,1,2,150966,150967,150969,1,3,0
43205,6,1,150972,150972,150973,0,1,3
43206,4,2,150976,150976,150978,0,2,3
43207,5,1,150981,150981,150982,0,1,3
43208,6,2,150987,150987,150989,0,2,5
43209,3,2,150990,150990,150992,0,2,1
43210,4,2,150994,150994,150996,0,2,2
43211,4,3,150998,150998,151001,0,3,2
43212,6,2,151004,151004,151006,0,2,3
43213,2,1,151006,151006,151007,0,1,0
43214,3,2,151009,151009,151011,0,2,2
43215,4,2,151013,151013,151015,0,2,2
43216,3,2,151016,151016,151018,0,2,1
43217,3,1,151019,151019,151020,0,1,1
43218,2,1,151021,151021,151022,0,1,1
43219,5,2,151026,151026,151028,0,2,4
43220,6,1,151032,151032,151033,0,1,4
43221,1,1,151033,151033,151034,0,1,0
43222,4,3,151037,151037,151040,0,3,3
43223,4,1,151041,151041,151042,0,1,1
43224,3,1,151044,151044,151045,0,1,2
43225,1,2,151045,151045,151047,0,2,0
43226,4,3,151049,151049,151052,0,3,2
43227,2,1,151051,151052,151053,1,2,0
43228,1,1,151052,151053,151054,1,2,0
43229,4,3,151056,151056,151059,0,3,2
43230,3,1,151059,151059,151060,0,1,0
43231,4,2,151063,151063,151065,0,2,3
43232,2,2,151065,151065,151067,0,2,0
43233,1,3,151066,151067,151070,1,4,0
43234,3,3,151069,151070,151073,1,4,0
43235,1,1,151070,151073,151074,3,4,0
43236,2,1,151072,151074,151075,2,3,0
43237,6,3,151078,151078,151081,0,3,3
43238,1,2,151079,151081,151083,2,4,0
43239,4,3,151083,151083,151086,0,3,0
43240,2,2,151085,151086,151088,1,3,0
43241,6,2,151091,151091,151093,0,2,3
43242,3,2,151094,151094,151096,0,2,1
43243,3,2,151097,151097,151099,0,2,1
43244,4,2,151101,151101,151103,0,2,2
43245,1,2,151102,151103,151105,1,3,0
43246,3,2,151105,151105,151107,0,2,0
43247,2,1,151107,151107,151108,0,1,0
43248,1,3,151108,151108,151111,0,3,0
43249,2,1,151110,151111,151112,1,2,0
43250,6,3,151116,151116,151119,0,3,4
43251,3,3,151119,151119,151122,0,3,0
43252,6,1,151125,151125,151126,0,1,3
43253,5,1,151130,151130,151131,0,1,4
43254,6,1,151136,151136,151137,0,1,5
43255,4,2,151140,151140,151142,0,2,3
43256,4,2,151144,151144,151146,0,2,2
43257,2,2,151146,151146,151148,0,2,0
43258,5,2,151151,151151,151153,0,2,3
43259,1,3,151152,151153,151156,1,4,0
43260,1,3,151153,151156,151159,3,6,0
43261,6,3,151159,151159,151162,0,3,0
43262,5,3,151164,151164,151167,0,3,2
43263,4,2,151168,151168,151170,0,2,1
43264,6,1,151174,151174,151175,0,1,4
43265,6,2,151180,151180,151182,0,2,5
43266,2,2,151182,151182,151184,0,2,0
43267,6,1,151188,151188,151189,0,1,4
43268,1,3,151189,151189,151192,0,3,0
43269,6,1,151195,151195,151196,0,1,3
43270,4,1,151199,151199,151200,0,1,3
43271,5,1,151204,151204,151205,0,1,4
43272,4,1,151208,151208,151209,0,1,3
43273,5,1,151213,151213,151214,0,1,4
43274,6,1,151219,151219,151220,0,1,5
43275,4,3,151223,151223,151226,0,3,3
43276,3,1,151226,151226,151227,0,1,0
43277,2,3,151228,151228,151231,0,3,1
43278,4,1,151232,151232,151233,0,1,1
43279,6,3,151238,151238,151241,0,3,5
43280,3,3,151241,151241,151244,0,3,0
43281,4,3,151245,151245,151248,0,3,1
43282,6,2,151251,151251,151253,0,2,3
43283,3,3,151254,151254,151257,0,3,1
43284,1,1,151255,151257,151258,2,3,0
43285,3,2,151258,151258,151260,0,2,0
43286,3,3,151261,151261,151264,0,3,1
43287,6,2,151267,151267,151269,0,2,3
43288,6,1,151273,151273,151274,0,1,4
43289,2,3,151275,151275,151278,0,3,1
43290,5,2,151280,151280,151282,0,2,2
43291,1,2,151281,151282,151284,1,3,0
43292,6,1,151287,151287,151288,0,1,3
43293,4,2,151291,151291,151293,0,2,3
43294,6,3,151297,151297,151300,0,3,4
43295,2,3,151299,151300,151303,1,4,0
43296,6,3,151305,151305,151308,0,3,2
43297,3,2,151308,151308,151310,0,2,0
43298,5,2,151313,151313,151315,0,2,3
43299,3,2,151316,151316,151318,0,2,1
43300,1,1,151317,151318,151319,1,2,0
43301,5,1,151322,151322,151323,0,1,3
43302,6,1,151328,151328,151329,0,1,5
43303,3,3,151331,151331,151334,0,3,2
43304,3,3,151334,151334,151337,0,3,0
43305,5,3,151339,151339,151342,0,3,2
43306,5,1,151344,151344,151345,0,1,2
43307,4,3,151348,151348,151351,0,3,3
43308,5,2,151353,151353,151355,0,2,2
43309,6,2,151359,151359,151361,0,2,4
43310,2,3,151361,151361,151364,0,3,0
43311,1,2,151362,151364,151366,2,4,0
43312,3,1,151365,151366,151367,1,2,0
43313,2,1,151367,151367,151368,0,1,0
43314,3,1,151370,151370,151371,0,1,2
43315,3,1,151373,151373,151374,0,1,2
43316,1,3,151374,151374,151377,0,3,0
43317,1,1,151375,151377,151378,2,3,0
43318,3,1,151378,151378,151379,0,1,0
43319,2,1,151380,151380,151381,0,1,1
43320,4,2,151384,151384,151386,0,2,3
43321,5,3,151389,151389,151392,0,3,3
43322,5,1,151394,151394,151395,0,1,2
43323,6,2,151400,151400,151402,0,2,5
43324,4,1,151404,151404,151405,0,1,2
43325,4,3,151408,151408,151411,0,3,3
43326,1,2,151409,151411,151413,2,4,0
43327,6,3,151415,151415,151418,0,3,2
43328,3,2,151418,151418,151420,0,2,0
43329,3,1,151421,151421,151422,0,1,1
43330,6,1,151427,151427,151428,0,1,5
43331,5,1,151432,151432,151433,0,1,4
43332,5,1,151437,151437,151438,0,1,4
43333,4,1,151441,151441,151442,0,1,3
43334,1,2,151442,151442,151444,0,2,0
43335,3,1,151445,151445,151446,0,1,1
43336,6,2,151451,151451,151453,0,2,5
43337,5,2,151456,151456,151458,0,2,3
43338,2,2,151458,151458,151460,0,2,0
43339,1,1,151459,151460,151461,1,2,0
43340,4,2,151463,151463,151465,0,2,2
43341,6,3,151469,151469,151472,0,3,4
43342,1,1,151470,151472,151473,2,3,0
43343,6,3,151476,151476,151479,0,3,3
43344,6,1,151482,151482,151483,0,1,3
43345,1,3,151483,151483,151486,0,3,0
43346,2,3,151485,151486,151489,1,4,0
43347,1,3,151486,151489,151492,3,6,0
43348,2,2,151488,151492,151494,4,6,0
43349,6,2,151494,151494,151496,0,2,0
43350,2,3,151496,151496,151499,0,3,0
43351,4,2,151500,151500,151502,0,2,1
43352,3,1,151503,151503,151504,0,1,1
43353,4,1,151507,151507,151508,0,1,3
43354,1,1,151508,151508,151509,0,1,0
43355,5,3,151513,151513,151516,0,3,4
43356,3,3,151516,151516,151519,0,3,0
43357,5,2,151521,151521,151523,0,2,2
43358,5,2,151526,151526,151528,0,2,3
43359,3,3,151529,151529,151532,0,3,1
43360,2,3,151531,151532,151535,1,4,0
43361,6,1,151537,151537,151538,0,1,2
43362,5,3,151542,151542,151545,0,3,4
43363,5,3,151547,151547,151550,0,3,2
43364,5,2,151552,151552,151554,0,2,2
43365,4,2,151556,151556,151558,0,2,2
43366,3,1,151559,151559,151560,0,1,1
43367,5,3,151564,151564,151567,0,3,4
43368,2,2,151566,151567,151569,1,3,0
43369,2,1,151568,151569,151570,1,2,0
43370,5,2,151573,151573,151575,0,2,3
43371,4,3,151577,151577,151580,0,3,2
43372,4,2,151581,151581,151583,0,2,1
43373,4,3,151585,151585,151588,0,3,2
43374,2,1,151587,151588,151589,1,2,0
43375,5,2,151592,151592,151594,0,2,3
43376,2,3,151594,151594,151597,0,3,0
43377,2,2,151596,151597,151599,1,3,0
43378,5,3,151601,151601,151604,0,3,2
43379,6,3,151607,151607,151610,0,3,3
43380,2,1,151609,151610,151611,1,2,0
43381,2,2,151611,151611,151613,0,2,0
43382,4,3,151615,151615,151618,0,3,2
43383,4,2,151619,151619,151621,0,2,1
43384,6,3,151625,151625,151628,0,3,4
43385,3,1,151628,151628,151629,0,1,0
43386,6,3,151634,151634,151637,0,3,5
43387,1,3,151635,151637,151640,2,5,0
43388,5,2,151640,151640,151642,0,2,0
43389,4,1,151644,151644,151645,0,1,2
43390,2,2,151646,151646,151648,0,2,1
43391,3,1,151649,151649,151650,0,1,1
43392,1,1,151650,151650,151651,0,1,0
43393,2,1,151652,151652,151653,0,1,1
43394,4,2,151656,151656,151658,0,2,3
43395,5,3,151661,151661,151664,0,3,3
43396,3,1,151664,151664,151665,0,1,0
43397,4,3,151668,151668,151671,0,3,3
43398,2,1,151670,151671,151672,1,2,0
43399,3,3,151673,151673,151676,0,3,1
43400,5,3,151678,151678,151681,0,3,2
43401,1,2,151679,151681,151683,2,4,0
43402,6,1,151685,151685,151686,0,1,2
43403,3,2,151688,151688,151690,0,2,2
43404,3,1,151691,151691,151692,0,1,1
43405,1,2,151692,151692,151694,0,2,0
43406,1,3,151693,151694,151697,1,4,0
43407,3,1,151696,151697,151698,1,2,0
43408,5,2,151701,151701,151703,0,2,3
43409,5,2,151706,151706,151708,0,2,3
43410,6,2,151712,151712,151714,0,2,4
43411,1,2,151713,151714,151716,1,3,0
43412,1,2,151714,151716,151718,2,4,0
43413,4,3,151718,151718,151721,0,3,0
43414,5,3,151723,151723,151726,0,3,2
43415,4,1,151727,151727,151728,0,1,1
43416,3,3,151730,151730,151733,0,3,2
43417,6,2,151736,151736,151738,0,2,3
43418,4,1,151740,151740,151741,0,1,2
43419,2,2,151742,151742,151744,0,2,1
43420,2,1,151744,151744,151745,0,1,0
43421,1,3,151745,151745,151748,0,3,0
43422,4,2,151749,151749,151751,0,2,1
43423,4,3,151753,151753,151756,0,3,2
43424,4,3,151757,151757,151760,0,3,1
43425,6,3,151763,151763,151766,0,3,3
43426,6,3,151769,151769,151772,0,3,3
43427,2,3,151771,151772,151775,1,4,0
43428,5,3,151776,151776,151779,0,3,1
43429,4,3,151780,151780,151783,0,3,1
43430,1,1,151781,151783,151784,2,3,0
43431,5,3,151786,151786,151789,0,3,2
43432,3,1,151789,151789,151790,0,1,0
43433,5,2,151794,151794,151796,0,2,4
43434,4,2,151798,151798,151800,0,2,2
43435,4,3,151802,151802,151805,0,3,2
43436,3,1,151805,151805,151806,0,1,0
43437,2,1,151807,151807,151808,0,1,1
43438,3,2,151810,151810,151812,0,2,2
43439,2,3,151812,151812,151815,0,3,0
43440,4,3,151816,151816,151819,0,3,1
43441,2,3,151818,151819,151822,1,4,0
43442,5,2,151823,151823,151825,0,2,1
43443,6,3,151829,151829,151832,0,3,4
43444,3,3,151832,151832,151835,0,3,0
43445,1,3,151833,151835,151838,2,5,0
43446,1,1,151834,151838,151839,4,5,0
43447,1,1,151835,151839,151840,4,5,0
43448,4,3,151839,151840,151843,1,4,0
43449,3,3,151842,151843,151846,1,4,0
43450,6,1,151848,151848,151849,0,1,2
43451,5,2,151853,151853,151855,0,2,4
43452,6,2,151859,151859,151861,0,2,4
43453,3,3,151862,151862,151865,0,3,1
43454,3,2,151865,151865,151867,0,2,0
43455,6,1,151871,151871,151872,0,1,4
43456,3,3,151874,151874,151877,0,3,2
43457,3,2,151877,151877,151879,0,2,0
43458,3,2,151880,151880,151882,0,2,1
43459,6,2,151886,151886,151888,0,2,4
43460,3,1,151889,151889,151890,0,1,1
43461,1,3,151890,151890,151893,0,3,0
43462,6,3,151896,151896,151899,0,3,3
43463,4,1,151900,151900,151901,0,1,1
43464,6,2,151906,151906,151908,0,2,5
43465,5,3,151911,151911,151914,0,3,3
43466,1,3,151912,151914,151917,2,5,0
43467,3,1,151915,151917,151918,2,3,0
43468,2,3,151917,151918,151921,1,4,0
43469,6,2,151923,151923,151925,0,2,2
43470,1,2,151924,151925,151927,1,3,0
43471,3,2,151927,151927,151929,0,2,0
43472,3,3,151930,151930,151933,0,3,1
43473,6,3,151936,151936,151939,0,3,3
43474,1,2,151937,151939,151941,2,4,0
43475,1,2,151938,151941,151943,3,5,0
43476,2,3,151940,151943,151946,3,6,0
43477,2,3,151942,151946,151949,4,7,0
43478,2,2,151944,151949,151951,5,7,0
43479,6,2,151950,151951,151953,1,3,0
43480,2,2,151952,151953,151955,1,3,0
43481,6,3,151958,151958,151961,0,3,3
43482,4,2,151962,151962,151964,0,2,1
43483,2,1,151964,151964,151965,0,1,0
43484,4,2,151968,151968,151970,0,2,3
43485,5,2,151973,151973,151975,0,2,3
43486,5,1,151978,151978,151979,0,1,3
43487,2,3,151980,151980,151983,0,3,1
43488,1,1,151981,151983,151984,2,3,0
43489,5,3,151986,151986,151989,0,3,2
43490,2,3,151988,151989,151992,1,4,0
43491,6,2,151994,151994,151996,0,2,2
43492,6,1,152000,152000,152001,0,1,4
43493,4,2,152004,152004,152006,0,2,3
43494,5,3,152009,152009,152012,0,3,3
43495,2,1,152011,152012,152013,1,2,0
43496,4,1,152015,152015,152016,0,1,2
43497,3,3,152018,152018,152021,0,3,2
43498,2,2,152020,152021,152023,1,3,0
43499,6,1,152026,152026,152027,0,1,3
43500,4,3,152030,152030,152033,0,3,3
43501,6,2,152036,152036,152038,0,2,3
43502,6,2,152042,152042,152044,0,2,4
43503,4,1,152046,152046,152047,0,1,2
43504,5,2,152051,152051,152053,0,2,4
43505,5,3,152056,152056,152059,0,3,3
43506,1,2,152057,152059,152061,2,4,0
43507,2,3,152059,152061,152064,2,5,0
43508,4,2,152063,152064,152066,1,3,0
43509,3,2,152066,152066,152068,0,2,0
43510,2,1,152068,152068,152069,0,1,0
43511,2,2,152070,152070,152072,0,2,1
43512,1,1,152071,152072,152073,1,2,0
43513,1,1,152072,152073,152074,1,2,0
43514,4,3,152076,152076,152079,0,3,2
43515,6,3,152082,152082,152085,0,3,3
43516,2,2,152084,152085,152087,1,3,0
43517,3,3,152087,152087,152090,0,3,0
43518,1,1,152088,152090,152091,2,3,0
43519,3,3,152091,152091,152094,0,3,0
43520,5,3,152096,152096,152099,0,3,2
43521,3,2,152099,152099,152101,0,2,0
43522,4,2,152103,152103,152105,0,2,2
43523,1,2,152104,152105,152107,1,3,0
43524,4,3,152108,152108,152111,0,3,1
43525,4,1,152112,152112,152113,0,1,1
43526,1,1,152113,152113,152114,0,1,0
43527,1,3,152114,152114,152117,0,3,0
43528,4,1,152118,152118,152119,0,1,1
43529,6,1,152124,152124,152125,0,1,5
43530,2,3,152126,152126,152129,0,3,1
43531,5,3,152131,152131,152134,0,3,2
43532,1,3,152132,152134,152137,2,5,0
43533,4,2,152136,152137,152139,1,3,0
43534,3,2,152139,152139,152141,0,2,0
43535,4,1,152143,152143,152144,0,1,2
43536,5,3,152148,152148,152151,0,3,4
43537,5,1,152153,152153,152154,0,1,2
43538,2,2,152155,152155,152157,0,2,1
43539,4,2,152159,152159,152161,0,2,2
43540,2,2,152161,152161,152163,0,2,0
43541,6,1,152167,152167,152168,0,1,4
43542,1,3,152168,152168,152171,0,3,0
43543,4,3,152172,152172,152175,0,3,1
43544,3,3,152175,152175,152178,0,3,0
43545,2,1,152177,152178,152179,1,2,0
43546,3,3,152180,152180,152183,0,3,1
43547,5,2,152185,152185,152187,0,2,2
43548,4,2,152189,152189,152191,0,2,2
43549,5,1,152194,152194,152195,0,1,3
43550,2,2,152196,152196,152198,0,2,1
43551,2,3,152198,152198,152201,0,3,0
43552,2,1,152200,152201,152202,1,2,0
43553,2,3,152202,152202,152205,0,3,0
43554,6,2,152208,152208,152210,0,2,3
43555,4,2,152212,152212,152214,0,2,2
43556,4,1,152216,152216,152217,0,1,2
43557,3,3,152219,152219,152222,0,3,2
43558,5,2,152224,152224,152226,0,2,2
43559,2,2,152226,152226,152228,0,2,0
43560,4,3,152230,152230,152233,0,3,2
43561,1,3,152231,152233,152236,2,5,0
43562,2,2,152233,152236,152238,3,5,0
43563,1,3,152234,152238,152241,4,7,0
43564,5,3,152239,152241,152244,2,5,0
43565,6,3,152245,152245,152248,0,3,1
43566,3,1,152248,152248,152249,0,1,0
43567,2,3,152250,152250,152253,0,3,1
43568,1,1,152251,152253,152254,2,3,0
43569,3,1,152254,152254,152255,0,1,0
43570,4,1,152258,152258,152259,0,1,3
43571,5,2,152263,152263,152265,0,2,4
43572,2,2,152265,152265,152267,0,2,0
43573,6,3,152271,152271,152274,0,3,4
43574,1,1,152272,152274,152275,2,3,0
43575,3,3,152275,152275,152278,0,3,0
43576,6,3,152281,152281,152284,0,3,3
43577,2,1,152283,152284,152285,1,2,0
43578,1,1,152284,152285,152286,1,2,0
43579,6,2,152290,152290,152292,0,2,4
43580,5,2,152295,152295,152297,0,2,3
43581,1,3,152296,152297,152300,1,4,0
43582,1,2,152297,152300,152302,3,5,0
43583,3,2,152300,152302,152304,2,4,0
43584,1,1,152301,152304,152305,3,4,0
43585,4,1,152305,152305,152306,0,1,0
43586,5,2,152310,152310,152312,0,2,4
43587,3,1,152313,152313,152314,0,1,1
43588,5,3,152318,152318,152321,0,3,4
43589,3,2,152321,152321,152323,0,2,0
43590,1,2,152322,152323,152325,1,3,0
43591,6,2,152328,152328,152330,0,2,3
43592,4,1,152332,152332,152333,0,1,2
43593,5,3,152337,152337,152340,0,3,4
43594,4,3,152341,152341,152344,0,3,1
43595,2,1,152343,152344,152345,1,2,0
43596,6,3,152349,152349,152352,0,3,4
43597,1,3,152350,152352,152355,2,5,0
43598,3,3,152353,152355,152358,2,5,0
43599,3,1,152356,152358,152359,2,3,0
43600,1,3,152357,152359,152362,2,5,0
43601,1,1,152358,152362,152363,4,5,0
43602,5,2,152363,152363,152365,0,2,0
43603,4,3,152367,152367,152370,0,3,2
43604,2,1,152369,152370,152371,1,2,0
43605,4,2,152373,152373,152375,0,2,2
43606,6,1,152379,152379,152380,0,1,4
43607,2,1,152381,152381,152382,0,1,1
43608,5,2,152386,152386,152388,0,2,4
43609,6,2,152392,152392,152394,0,2,4
43610,6,1,152398,152398,152399,0,1,4
43611,6,1,152404,152404,152405,0,1,5
43612,3,3,152407,152407,152410,0,3,2
43613,1,2,152408,152410,152412,2,4,0
43614,5,3,152413,152413,152416,0,3,1
43615,5,3,152418,152418,152421,0,3,2
43616,3,1,152421,152421,152422,0,1,0
43617,1,3,152422,152422,152425,0,3,0
43618,3,3,152425,152425,152428,0,3,0
43619,3,1,152428,152428,152429,0,1,0
43620,1,2,152429,152429,152431,0,2,0
43621,3,1,152432,152432,152433,0,1,1
43622,4,2,152436,152436,152438,0,2,3
43623,1,1,152437,152438,152439,1,2,0
43624,3,2,152440,152440,152442,0,2,1
43625,1,2,152441,152442,152444,1,3,0
43626,2,3,152443,152444,152447,1,4,0
43627,5,1,152448,152448,152449,0,1,1
43628,6,2,152454,152454,152456,0,2,5
43629,6,1,152460,152460,152461,0,1,4
43630,4,3,152464,152464,152467,0,3,3
43631,2,3,152466,152467,152470,1,4,0
43632,1,2,152467,152470,152472,3,5,0
43633,4,3,152471,152472,152475,1,4,0
43634,6,2,152477,152477,152479,0,2,2
43635,3,3,152480,152480,152483,0,3,1
43636,6,1,152486,152486,152487,0,1,3
43637,2,2,152488,152488,152490,0,2,1
43638,2,3,152490,152490,152493,0,3,0
43639,4,2,152494,152494,152496,0,2,1
43640,3,3,152497,152497,152500,0,3,1
43641,4,1,152501,152501,152502,0,1,1
43642,1,3,152502,152502,152505,0,3,0
43643,6,1,152508,152508,152509,0,1,3
43644,5,1,152513,152513,152514,0,1,4
43645,3,3,152516,152516,152519,0,3,2
43646,2,2,152518,152519,152521,1,3,0
43647,6,2,152524,152524,152526,0,2,3
43648,2,3,152526,152526,152529,0,3,0
43649,3,1,152529,152529,152530,0,1,0
43650,3,3,152532,152532,152535,0,3,2
43651,1,2,152533,152535,152537,2,4,0
43652,2,1,152535,152537,152538,2,3,0
43653,1,1,152536,152538,152539,2,3,0
43654,3,3,152539,152539,152542,0,3,0
43655,2,3,152541,152542,152545,1,4,0
43656,4,2,152545,152545,152547,0,2,0
43657,4,2,152549,152549,152551,0,2,2
43658,1,3,152550,152551,152554,1,4,0
43659,2,1,152552,152554,152555,2,3,0
43660,4,3,152556,152556,152559,0,3,1
43661,5,2,152561,152561,152563,0,2,2
43662,1,1,152562,152563,152564,1,2,0
43663,6,2,152568,152568,152570,0,2,4
43664,6,2,152574,152574,152576,0,2,4
43665,4,1,152578,152578,152579,0,1,2
43666,5,1,152583,152583,152584,0,1,4
43667,2,1,152585,152585,152586,0,1,1
43668,4,1,152589,152589,152590,0,1,3
43669,6,1,152595,152595,152596,0,1,5
43670,5,1,152600,152600,152601,0,1,4
43671,2,3,152602,152602,152605,0,3,1
43672,3,2,152605,152605,152607,0,2,0
43673,5,1,152610,152610,152611,0,1,3
43674,6,1,152616,152616,152617,0,1,5
43675,6,2,152622,152622,152624,0,2,5
43676,5,1,152627,152627,152628,0,1,3
43677,4,1,152631,152631,152632,0,1,3
43678,2,2,152633,152633,152635,0,2,1
43679,5,2,152638,152638,152640,0,2,3
43680,4,1,152642,152642,152643,0,1,2
43681,1,2,152643,152643,152645,0,2,0
43682,1,3,152644,152645,152648,1,4,0
43683,5,1,152649,152649,152650,0,1,1
43684,1,3,152650,152650,152653,0,3,0
43685,4,3,152654,152654,152657,0,3,1
43686,3,3,152657,152657,152660,0,3,0
43687,5,1,152662,152662,152663,0,1,2
43688,5,3,152667,152667,152670,0,3,4
43689,2,1,152669,152670,152671,1,2,0
43690,2,3,152671,152671,152674,0,3,0
43691,6,3,152677,152677,152680,0,3,3
43692,3,1,152680,152680,152681,0,1,0
43693,6,2,152686,152686,152688,0,2,5
43694,6,2,152692,152692,152694,0,2,4
43695,6,3,152698,152698,152701,0,3,4
43696,1,3,152699,152701,152704,2,5,0
43697,4,1,152703,152704,152705,1,2,0
43698,2,1,152705,152705,152706,0,1,0
43699,2,3,152707,152707,152710,0,3,1
43700,4,3,152711,152711,152714,0,3,1
43701,5,1,152716,152716,152717,0,1,2
43702,6,1,152722,152722,152723,0,1,5
43703,2,3,152724,152724,152727,0,3,1
43704,4,2,152728,152728,152730,0,2,1
43705,1,2,152729,152730,152732,1,3,0
43706,6,3,152735,152735,152738,0,3,3
43707,1,3,152736,152738,152741,2,5,0
43708,1,2,152737,152741,152743,4,6,0
43709,5,2,152742,152743,152745,1,3,0
43710,1,1,152743,152745,152746,2,3,0
43711,6,1,152749,152749,152750,0,1,3
43712,5,1,152754,152754,152755,0,1,4
43713,3,2,152757,152757,152759,0,2,2
43714,5,3,152762,152762,152765,0,3,3
43715,6,2,152768,152768,152770,0,2,3
43716,2,3,152770,152770,152773,0,3,0
43717,4,1,152774,152774,152775,0,1,1
43718,3,1,152777,152777,152778,0,1,2
43719,3,1,152780,152780,152781,0,1,2
43720,5,1,152785,152785,152786,0,1,4
43721,4,1,152789,152789,152790,0,1,3
43722,2,2,152791,152791,152793,0,2,1
43723,6,2,152797,152797,152799,0,2,4
43724,6,2,152803,152803,152805,0,2,4
43725,5,2,152808,152808,152810,0,2,3
43726,1,2,152809,152810,152812,1,3,0
43727,5,1,152814,152814,152815,0,1,2
43728,1,1,152815,152815,152816,0,1,0
43729,3,2,152818,152818,152820,0,2,2
43730,2,1,152820,152820,152821,0,1,0
43731,2,2,152822,152822,152824,0,2,1
43732,1,3,152823,152824,152827,1,4,0
43733,6,3,152829,152829,152832,0,3,2
43734,6,2,152835,152835,152837,0,2,3
43735,1,3,152836,152837,152840,1,4,0
43736,5,1,152841,152841,152842,0,1,1
43737,5,1,152846,152846,152847,0,1,4
43738,4,3,152850,152850,152853,0,3,3
43739,4,3,152854,152854,152857,0,3,1
43740,4,3,152858,152858,152861,0,3,1
43741,3,1,152861,152861,152862,0,1,0
43742,4,1,152865,152865,152866,0,1,3
43743,1,3,152866,152866,152869,0,3,0
43744,4,2,152870,152870,152872,0,2,1
43745,3,3,152873,152873,152876,0,3,1
43746,6,3,152879,152879,152882,0,3,3
43747,2,1,152881,152882,152883,1,2,0
43748,5,3,152886,152886,152889,0,3,3
43749,5,3,152891,152891,152894,0,3,2
43750,1,3,152892,152894,152897,2,5,0
43751,3,1,152895,152897,152898,2,3,0
43752,4,2,152899,152899,152901,0,2,1
43753,4,1,152903,152903,152904,0,1,2
43754,5,2,152908,152908,152910,0,2,4
43755,3,2,152911,152911,152913,0,2,1
43756,3,3,152914,152914,152917,0,3,1
43757,2,3,152916,152917,152920,1,4,0
43758,3,2,152919,152920,152922,1,3,0
43759,6,2,152925,152925,152927,0,2,3
43760,4,2,152929,152929,152931,0,2,2
43761,5,2,152934,152934,152936,0,2,3
43762,3,1,152937,152937,152938,0,1,1
43763,2,1,152939,152939,152940,0,1,1
43764,1,2,152940,152940,152942,0,2,0
43765,4,1,152944,152944,152945,0,1,2
43766,6,3,152950,152950,152953,0,3,5
43767,6,3,152956,152956,152959,0,3,3
43768,6,1,152962,152962,152963,0,1,3
43769,4,1,152966,152966,152967,0,1,3
43770,1,1,152967,152967,152968,0,1,0
43771,5,2,152972,152972,152974,0,2,4
43772,2,2,152974,152974,152976,0,2,0
43773,5,1,152979,152979,152980,0,1,3
43774,6,1,152985,152985,152986,0,1,5
43775,5,1,152990,152990,152991,0,1,4
43776,2,3,152992,152992,152995,0,3,1
43777,3,1,152995,152995,152996,0,1,0
43778,4,3,152999,152999,153002,0,3,3
43779,5,2,153004,153004,153006,0,2,2
43780,1,1,153005,153006,153007,1,2,0
43781,1,1,153006,153007,153008,1,2,0
43782,2,2,153008,153008,153010,0,2,0
43783,5,3,153013,153013,153016,0,3,3
43784,2,1,153015,153016,153017,1,2,0
43785,1,1,153016,153017,153018,1,2,0
43786,4,2,153020,153020,153022,0,2,2
43787,6,3,153026,153026,153029,0,3,4
43788,1,1,153027,153029,153030,2,3,0
43789,2,3,153029,153030,153033,1,4,0
43790,5,2,153034,153034,153036,0,2,1
43791,2,2,153036,153036,153038,0,2,0
43792,4,1,153040,153040,153041,0,1,2
43793,5,3,153045,153045,153048,0,3,4
43794,3,2,153048,153048,153050,0,2,0
43795,2,2,153050,153050,153052,0,2,0
43796,4,1,153054,153054,153055,0,1,2
43797,1,2,153055,153055,153057,0,2,0
43798,6,2,153061,153061,153063,0,2,4
43799,2,2,153063,153063,153065,0,2,0
43800,3,3,153066,153066,153069,0,3,1
43801,2,3,153068,153069,153072,1,4,0
43802,4,3,153072,153072,153075,0,3,0
43803,3,3,153075,153075,153078,0,3,0
43804,4,3,153079,153079,153082,0,3,1
43805,5,2,153084,153084,153086,0,2,2
43806,3,3,153087,153087,153090,0,3,1
43807,4,1,153091,153091,153092,0,1,1
43808,4,3,153095,153095,153098,0,3,3
43809,4,2,153099,153099,153101,0,2,1
43810,5,1,153104,153104,153105,0,1,3
43811,3,1,153107,153107,153108,0,1,2
43812,2,3,153109,153109,153112,0,3,1
43813,2,1,153111,153112,153113,1,2,0
43814,3,1,153114,153114,153115,0,1,1
43815,1,2,153115,153115,153117,0,2,0
43816,3,2,153118,153118,153120,0,2,1
43817,6,1,153124,153124,153125,0,1,4
43818,6,1,153130,153130,153131,0,1,5
43819,6,3,153136,153136,153139,0,3,5
43820,3,2,153139,153139,153141,0,2,0
43821,6,2,153145,153145,153147,0,2,4
43822,3,2,153148,153148,153150,0,2,1
43823,4,2,153152,153152,153154,0,2,2
43824,4,2,153156,153156,153158,0,2,2
43825,6,2,153162,153162,153164,0,2,4
43826,5,1,153167,153167,153168,0,1,3
43827,1,1,153168,153168,153169,0,1,0
43828,5,2,153173,153173,153175,0,2,4
43829,5,1,153178,153178,153179,0,1,3
43830,5,3,153183,153183,153186,0,3,4
43831,2,3,153185,153186,153189,1,4,0
43832,3,1,153188,153189,153190,1,2,0
43833,1,3,153189,153190,153193,1,4,0
43834,6,3,153195,153195,153198,0,3,2
43835,4,1,153199,153199,153200,0,1,1
43836,3,2,153202,153202,153204,0,2,2
43837,5,1,153207,153207,153208,0,1,3
43838,6,3,153213,153213,153216,0,3,5
43839,2,2,153215,153216,153218,1,3,0
43840,4,3,153219,153219,153222,0,3,1
43841,5,1,153224,153224,153225,0,1,2
43842,2,1,153226,153226,153227,0,1,1
43843,3,2,153229,153229,153231,0,2,2
43844,3,2,153232,153232,153234,0,2,1
43845,4,1,153236,153236,153237,0,1,2
43846,2,1,153238,153238,153239,0,1,1
43847,6,1,153244,153244,153245,0,1,5
43848,5,3,153249,153249,153252,0,3,4
43849,1,2,153250,153252,153254,2,4,0
43850,5,1,153255,153255,153256,0,1,1
43851,2,2,153257,153257,153259,0,2,1
43852,5,1,153262,153262,153263,0,1,3
43853,2,2,153264,153264,153266,0,2,1
43854,5,1,153269,153269,153270,0,1,3
43855,3,2,153272,153272,153274,0,2,2
43856,5,2,153277,153277,153279,0,2,3
43857,4,3,153281,153281,153284,0,3,2
43858,1,3,153282,153284,153287,2,5,0
43859,5,2,153287,153287,153289,0,2,0
43860,5,1,153292,153292,153293,0,1,3
43861,5,3,153297,153297,153300,0,3,4
43862,4,3,153301,153301,153304,0,3,1
43863,5,2,153306,153306,153308,0,2,2
43864,6,2,153312,153312,153314,0,2,4
43865,2,2,153314,153314,153316,0,2,0
43866,4,1,153318,153318,153319,0,1,2
43867,4,1,153322,153322,153323,0,1,3
43868,6,3,153328,153328,153331,0,3,5
43869,1,3,153329,153331,153334,2,5,0
43870,5,3,153334,153334,153337,0,3,0
43871,1,2,153335,153337,153339,2,4,0
43872,6,3,153341,153341,153344,0,3,2
43873,5,2,153346,153346,153348,0,2,2
43874,5,1,153351,153351,153352,0,1,3
43875,2,2,153353,153353,153355,0,2,1
43876,4,3,153357,153357,153360,0,3,2
43877,1,1,153358,153360,153361,2,3,0
43878,3,2,153361,153361,153363,0,2,0
43879,4,3,153365,153365,153368,0,3,2
43880,5,2,153370,153370,153372,0,2,2
43881,5,2,153375,153375,153377,0,2,3
43882,4,3,153379,153379,153382,0,3,2
43883,6,1,153385,153385,153386,0,1,3
43884,4,2,153389,153389,153391,0,2,3
43885,4,1,153393,153393,153394,0,1,2
43886,4,1,153397,153397,153398,0,1,3
43887,2,2,153399,153399,153401,0,2,1
43888,5,1,153404,153404,153405,0,1,3
43889,2,2,153406,153406,153408,0,2,1
43890,3,2,153409,153409,153411,0,2,1
43891,1,3,153410,153411,153414,1,4,0
43892,6,3,153416,153416,153419,0,3,2
43893,1,3,153417,153419,153422,2,5,0
43894,5,3,153422,153422,153425,0,3,0
43895,6,1,153428,153428,153429,0,1,3
43896,3,2,153431,153431,153433,0,2,2
43897,6,1,153437,153437,153438,0,1,4
43898,5,2,153442,153442,153444,0,2,4
43899,1,2,153443,153444,153446,1,3,0
43900,2,3,153445,153446,153449,1,4,0
43901,6,3,153451,153451,153454,0,3,2
43902,6,2,153457,153457,153459,0,2,3
43903,6,1,153463,153463,153464,0,1,4
43904,5,2,153468,153468,153470,0,2,4
43905,4,3,153472,153472,153475,0,3,2
43906,3,3,153475,153475,153478,0,3,0
43907,1,2,153476,153478,153480,2,4,0
43908,3,1,153479,153480,153481,1,2,0
43909,4,1,153483,153483,153484,0,1,2
43910,3,2,153486,153486,153488,0,2,2
43911,3,1,153489,153489,153490,0,1,1
43912,4,1,153493,153493,153494,0,1,3
43913,5,1,153498,153498,153499,0,1,4
43914,2,3,153500,153500,153503,0,3,1
43915,2,1,153502,153503,153504,1,2,0
43916,2,3,153504,153504,153507,0,3,0
43917,5,3,153509,153509,153512,0,3,2
43918,3,1,153512,153512,153513,0,1,0
43919,1,2,153513,153513,153515,0,2,0
43920,1,3,153514,153515,153518,1,4,0
43921,6,1,153520,153520,153521,0,1,2
43922,4,3,153524,153524,153527,0,3,3
43923,1,1,153525,153527,153528,2,3,0
43924,4,1,153529,153529,153530,0,1,1
43925,4,3,153533,153533,153536,0,3,3
43926,2,1,153535,153536,153537,1,2,0
43927,3,3,153538,153538,153541,0,3,1
43928,6,2,153544,153544,153546,0,2,3
43929,6,3,153550,153550,153553,0,3,4
43930,6,1,153556,153556,153557,0,1,3
43931,5,2,153561,153561,153563,0,2,4
43932,5,2,153566,153566,153568,0,2,3
43933,1,1,153567,153568,153569,1,2,0
43934,6,1,153573,153573,153574,0,1,4
43935,5,2,153578,153578,153580,0,2,4
43936,5,3,153583,153583,153586,0,3,3
43937,3,3,153586,153586,153589,0,3,0
43938,3,1,153589,153589,153590,0,1,0
43939,6,1,153595,153595,153596,0,1,5
43940,2,2,153597,153597,153599,0,2,1
43941,6,3,153603,153603,153606,0,3,4
43942,2,1,153605,153606,153607,1,2,0
43943,6,1,153611,153611,153612,0,1,4
43944,5,3,153616,153616,153619,0,3,4
43945,2,1,153618,153619,153620,1,2,0
43946,3,1,153621,153621,153622,0,1,1
43947,6,2,153627,153627,153629,0,2,5
43948,1,2,153628,153629,153631,1,3,0
43949,5,2,153633,153633,153635,0,2,2
43950,4,2,153637,153637,153639,0,2,2
43951,6,3,153643,153643,153646,0,3,4
43952,2,1,153645,153646,153647,1,2,0
43953,4,1,153649,153649,153650,0,1,2
43954,1,3,153650,153650,153653,0,3,0
43955,5,1,153655,153655,153656,0,1,2
43956,4,2,153659,153659,153661,0,2,3
43957,5,1,153664,153664,153665,0,1,3
43958,2,1,153666,153666,153667,0,1,1
43959,6,1,153672,153672,153673,0,1,5
43960,1,2,153673,153673,153675,0,2,0
43961,5,1,153678,153678,153679,0,1,3
43962,4,2,153682,153682,153684,0,2,3
43963,3,1,153685,153685,153686,0,1,1
43964,2,1,153687,153687,153688,0,1,1
43965,5,1,153692,153692,153693,0,1,4
43966,5,1,153697,153697,153698,0,1,4
43967,3,3,153700,153700,153703,0,3,2
43968,1,1,153701,153703,153704,2,3,0
43969,3,1,153704,153704,153705,0,1,0
43970,5,2,153709,153709,153711,0,2,4
43971,4,2,153713,153713,153715,0,2,2
43972,1,3,153714,153715,153718,1,4,0
43973,3,3,153717,153718,153721,1,4,0
43974,1,1,153718,153721,153722,3,4,0
43975,1,3,153719,153722,153725,3,6,0
43976,3,3,153722,153725,153728,3,6,0
43977,3,3,153725,153728,153731,3,6,0
43978,5,2,153730,153731,153733,1,3,0
43979,3,1,153733,153733,153734,0,1,0
43980,3,2,153736,153736,153738,0,2,2
43981,2,3,153738,153738,153741,0,3,0
43982,5,2,153743,153743,153745,0,2,2
43983,2,2,153745,153745,153747,0,2,0
43984,3,2,153748,153748,153750,0,2,1
43985,6,3,153754,153754,153757,0,3,4
43986,2,2,153756,153757,153759,1,3,0
43987,3,2,153759,153759,153761,0,2,0
43988,6,1,153765,153765,153766,0,1,4
43989,5,1,153770,153770,153771,0,1,4
43990,3,2,153773,153773,153775,0,2,2
43991,1,1,153774,153775,153776,1,2,0
43992,2,3,153776,153776,153779,0,3,0
43993,2,2,153778,153779,153781,1,3,0
43994,4,1,153782,153782,153783,0,1,1
43995,6,1,153788,153788,153789,0,1,5
43996,3,1,153791,153791,153792,0,1,2
43997,3,2,153794,153794,153796,0,2,2
43998,3,1,153797,153797,153798,0,1,1
43999,1,1,153798,153798,153799,0,1,0
44000,2,2,153800,153800,153802,0,2,1
44001,3,2,153803,153803,153805,0,2,1
44002,2,3,153805,153805,153808,0,3,0
44003,6,3,153811,153811,153814,0,3,3
44004,2,2,153813,153814,153816,1,3,0
44005,6,2,153819,153819,153821,0,2,3
44006,4,2,153823,153823,153825,0,2,2
44007,5,2,153828,153828,153830,0,2,3
44008,3,1,153831,153831,153832,0,1,1
44009,1,3,153832,153832,153835,0,3,0
44010,2,2,153834,153835,153837,1,3,0
44011,2,3,153836,153837,153840,1,4,0
44012,1,2,153837,153840,153842,3,5,0
44013,2,2,153839,153842,153844,3,5,0
44014,4,1,153843,153844,153845,1,2,0
44015,6,1,153849,153849,153850,0,1,4
44016,2,1,153851,153851,153852,0,1,1
44017,5,2,153856,153856,153858,0,2,4
44018,1,3,153857,153858,153861,1,4,0
44019,3,1,153860,153861,153862,1,2,0
44020,1,3,153861,153862,153865,1,4,0
44021,4,2,153865,153865,153867,0,2,0
44022,3,2,153868,153868,153870,0,2,1
44023,2,3,153870,153870,153873,0,3,0
44024,2,3,153872,153873,153876,1,4,0
44025,6,1,153878,153878,153879,0,1,2
44026,1,3,153879,153879,153882,0,3,0
44027,6,2,153885,153885,153887,0,2,3
44028,5,1,153890,153890,153891,0,1,3
44029,1,2,153891,153891,153893,0,2,0
44030,3,2,153894,153894,153896,0,2,1
44031,1,1,153895,153896,153897,1,2,0
44032,3,2,153898,153898,153900,0,2,1
44033,4,2,153902,153902,153904,0,2,2
44034,4,3,153906,153906,153909,0,3,2
44035,4,3,153910,153910,153913,0,3,1
44036,1,2,153911,153913,153915,2,4,0
44037,4,2,153915,153915,153917,0,2,0
44038,5,2,153920,153920,153922,0,2,3
44039,4,2,153924,153924,153926,0,2,2
44040,6,2,153930,153930,153932,0,2,4
44041,1,2,153931,153932,153934,1,3,0
44042,3,3,153934,153934,153937,0,3,0
44043,3,2,153937,153937,153939,0,2,0
44044,2,2,153939,153939,153941,0,2,0
44045,1,2,153940,153941,153943,1,3,0
44046,4,1,153944,153944,153945,0,1,1
44047,4,1,153948,153948,153949,0,1,3
44048,2,2,153950,153950,153952,0,2,1
44049,3,3,153953,153953,153956,0,3,1
44050,3,1,153956,153956,153957,0,1,0
44051,1,2,153957,153957,153959,0,2,0
44052,4,1,153961,153961,153962,0,1,2
44053,4,2,153965,153965,153967,0,2,3
44054,6,1,153971,153971,153972,0,1,4
44055,4,1,153975,153975,153976,0,1,3
44056,5,1,153980,153980,153981,0,1,4
44057,3,1,153983,153983,153984,0,1,2
44058,4,1,153987,153987,153988,0,1,3
44059,6,2,153993,153993,153995,0,2,5
44060,2,3,153995,153995,153998,0,3,0
44061,4,2,153999,153999,154001,0,2,1
44062,3,3,154002,154002,154005,0,3,1
44063,1,1,154003,154005,154006,2,3,0
44064,2,3,154005,154006,154009,1,4,0
44065,6,3,154011,154011,154014,0,3,2
44066,3,3,154014,154014,154017,0,3,0
44067,2,3,154016,154017,154020,1,4,0
44068,4,1,154020,154020,154021,0,1,0
44069,3,1,154023,154023,154024,0,1,2
44070,1,1,154024,154024,154025,0,1,0
44071,2,2,154026,154026,154028,0,2,1
44072,5,1,154031,154031,154032,0,1,3
44073,5,2,154036,154036,154038,0,2,4
44074,4,2,154040,154040,154042,0,2,2
44075,3,2,154043,154043,154045,0,2,1
44076,3,2,154046,154046,154048,0,2,1
44077,5,1,154051,154051,154052,0,1,3
44078,2,1,154053,154053,154054,0,1,1
44079,4,2,154057,154057,154059,0,2,3
44080,6,3,154063,154063,154066,0,3,4
44081,1,2,154064,154066,154068,2,4,0
44082,3,2,154067,154068,154070,1,3,0
44083,4,2,154071,154071,154073,0,2,1
44084,3,2,154074,154074,154076,0,2,1
44085,6,2,154080,154080,154082,0,2,4
44086,5,3,154085,154085,154088,0,3,3
44087,6,2,154091,154091,154093,0,2,3
44088,5,2,154096,154096,154098,0,2,3
44089,5,2,154101,154101,154103,0,2,3
44090,6,2,154107,154107,154109,0,2,4
44091,4,1,154111,154111,154112,0,1,2
44092,2,1,154113,154113,154114,0,1,1
44093,6,3,154119,154119,154122,0,3,5
44094,1,3,154120,154122,154125,2,5,0
44095,2,3,154122,154125,154128,3,6,0
44096,1,3,154123,154128,154131,5,8,0
44097,2,2,154125,154131,154133,6,8,0
44098,4,3,154129,154133,154136,4,7,0
44099,4,1,154133,154136,154137,3,4,0
44100,4,3,154137,154137,154140,0,3,0
44101,5,3,154142,154142,154145,0,3,2
44102,5,1,154147,154147,154148,0,1,2
44103,1,2,154148,154148,154150,0,2,0
44104,6,1,154154,154154,154155,0,1,4
44105,5,2,154159,154159,154161,0,2,4
44106,4,2,154163,154163,154165,0,2,2
44107,3,3,154166,154166,154169,0,3,1
44108,1,1,154167,154169,154170,2,3,0
44109,3,2,154170,154170,154172,0,2,0
44110,6,2,154176,154176,154178,0,2,4
44111,2,3,154178,154178,154181,0,3,0
44112,1,1,154179,154181,154182,2,3,0
44113,6,2,154185,154185,154187,0,2,3
44114,5,2,154190,154190,154192,0,2,3
44115,6,1,154196,154196,154197,0,1,4
44116,6,3,154202,154202,154205,0,3,5
44117,2,1,154204,154205,154206,1,2,0
44118,3,3,154207,154207,154210,0,3,1
44119,1,1,154208,154210,154211,2,3,0
44120,4,1,154212,154212,154213,0,1,1
44121,4,1,154216,154216,154217,0,1,3
44122,3,1,154219,154219,154220,0,1,2
44123,2,1,154221,154221,154222,0,1,1
44124,2,1,154223,154223,154224,0,1,1
44125,2,3,154225,154225,154228,0,3,1
44126,2,2,154227,154228,154230,1,3,0
44127,4,3,154231,154231,154234,0,3,1
44128,2,3,154233,154234,154237,1,4,0
44129,3,1,154236,154237,154238,1,2,0
44130,6,1,154242,154242,154243,0,1,4
44131,4,1,154246,154246,154247,0,1,3
44132,4,2,154250,154250,154252,0,2,3
44133,3,2,154253,154253,154255,0,2,1
44134,4,1,154257,154257,154258,0,1,2
44135,6,3,154263,154263,154266,0,3,5
44136,4,2,154267,154267,154269,0,2,1
44137,1,1,154268,154269,154270,1,2,0
44138,1,1,154269,154270,154271,1,2,0
44139,3,1,154272,154272,154273,0,1,1
44140,4,2,154276,154276,154278,0,2,3
44141,4,2,154280,154280,154282,0,2,2
44142,4,3,154284,154284,154287,0,3,2
44143,3,2,154287,154287,154289,0,2,0
44144,2,3,154289,154289,154292,0,3,0
44145,2,3,154291,154292,154295,1,4,0
44146,1,2,154292,154295,154297,3,5,0
44147,1,1,154293,154297,154298,4,5,0
44148,5,3,154298,154298,154301,0,3,0
44149,6,1,154304,154304,154305,0,1,3
44150,2,2,154306,154306,154308,0,2,1
44151,5,3,154311,154311,154314,0,3,3
44152,6,1,154317,154317,154318,0,1,3
44153,4,2,154321,154321,154323,0,2,3
44154,3,1,154324,154324,154325,0,1,1
44155,4,1,154328,154328,154329,0,1,3
44156,6,3,154334,154334,154337,0,3,5
44157,1,3,154335,154337,154340,2,5,0
44158,2,3,154337,154340,154343,3,6,0
44159,1,2,154338,154343,154345,5,7,0
44160,6,2,154344,154345,154347,1,3,0
44161,5,2,154349,154349,154351,0,2,2
44162,4,3,154353,154353,154356,0,3,2
44163,2,1,154355,154356,154357,1,2,0
44164,6,3,154361,154361,154364,0,3,4
44165,1,3,154362,154364,154367,2,5,0
44166,3,1,154365,154367,154368,2,3,0
44167,4,3,154369,154369,154372,0,3,1
44168,1,1,154370,154372,154373,2,3,0
44169,5,3,154375,154375,154378,0,3,2
44170,4,3,154379,154379,154382,0,3,1
44171,4,1,154383,154383,154384,0,1,1
44172,2,1,154385,154385,154386,0,1,1
44173,2,1,154387,154387,154388,0,1,1
44174,5,1,154392,154392,154393,0,1,4
44175,1,3,154393,154393,154396,0,3,0
44176,3,1,154396,154396,154397,0,1,0
44177,2,2,154398,154398,154400,0,2,1
44178,1,3,154399,154400,154403,1,4,0
44179,4,1,154403,154403,154404,0,1,0
44180,1,1,154404,154404,154405,0,1,0
44181,6,2,154410,154410,154412,0,2,5
44182,2,1,154412,154412,154413,0,1,0
44183,1,1,154413,154413,154414,0,1,0
44184,1,1,154414,154414,154415,0,1,0
44185,5,1,154419,154419,154420,0,1,4
44186,2,1,154421,154421,154422,0,1,1
44187,5,1,154426,154426,154427,0,1,4
44188,4,1,154430,154430,154431,0,1,3
44189,4,1,154434,154434,154435,0,1,3
44190,3,1,154437,154437,154438,0,1,2
44191,3,3,154440,154440,154443,0,3,2
44192,1,3,154441,154443,154446,2,5,0
44193,1,3,154442,154446,154449,4,7,0
44194,2,3,154444,154449,154452,5,8,0
44195,6,1,154450,154452,154453,2,3,0
44196,2,1,154452,154453,154454,1,2,0
44197,4,2,154456,154456,154458,0,2,2
44198,3,2,154459,154459,154461,0,2,1
44199,4,3,154463,154463,154466,0,3,2
44200,1,1,154464,154466,154467,2,3,0
44201,6,3,154470,154470,154473,0,3,3
44202,6,1,154476,154476,154477,0,1,3
44203,4,2,154480,154480,154482,0,2,3
44204,4,2,154484,154484,154486,0,2,2
44205,4,2,154488,154488,154490,0,2,2
44206,3,3,154491,154491,154494,0,3,1
44207,4,3,154495,154495,154498,0,3,1
44208,5,1,154500,154500,154501,0,1,2
44209,1,1,154501,154501,154502,0,1,0
44210,1,3,154502,154502,154505,0,3,0
44211,5,2,154507,154507,154509,0,2,2
44212,1,3,154508,154509,154512,1,4,0
44213,6,2,154514,154514,154516,0,2,2
44214,1,2,154515,154516,154518,1,3,0
44215,6,3,154521,154521,154524,0,3,3
44216,2,3,154523,154524,154527,1,4,0
44217,3,2,154526,154527,154529,1,3,0
44218,1,1,154527,154529,154530,2,3,0
44219,1,2,154528,154530,154532,2,4,0
44220,6,1,154534,154534,154535,0,1,2
44221,1,3,154535,154535,154538,0,3,0
44222,3,2,154538,154538,154540,0,2,0
44223,4,2,154542,154542,154544,0,2,2
44224,1,3,154543,154544,154547,1,4,0
44225,6,1,154549,154549,154550,0,1,2
44226,6,3,154555,154555,154558,0,3,5
44227,1,1,154556,154558,154559,2,3,0
44228,6,2,154562,154562,154564,0,2,3
44229,4,2,154566,154566,154568,0,2,2
44230,2,1,154568,154568,154569,0,1,0
44231,6,3,154574,154574,154577,0,3,5
44232,6,1,154580,154580,154581,0,1,3
44233,4,3,154584,154584,154587,0,3,3
44234,5,3,154589,154589,154592,0,3,2
44235,5,2,154594,154594,154596,0,2,2
44236,2,2,154596,154596,154598,0,2,0
44237,6,3,154602,154602,154605,0,3,4
44238,2,2,154604,154605,154607,1,3,0
44239,5,1,154609,154609,154610,0,1,2
44240,3,1,154612,154612,154613,0,1,2
44241,1,1,154613,154613,154614,0,1,0
44242,3,1,154616,154616,154617,0,1,2
44243,4,1,154620,154620,154621,0,1,3
44244,4,2,154624,154624,154626,0,2,3
44245,1,1,154625,154626,154627,1,2,0
44246,6,1,154631,154631,154632,0,1,4
44247,1,3,154632,154632,154635,0,3,0
44248,2,1,154634,154635,154636,1,2,0
44249,5,1,154639,154639,154640,0,1,3
44250,6,3,154645,154645,154648,0,3,5
44251,4,1,154649,154649,154650,0,1,1
44252,6,3,154655,154655,154658,0,3,5
44253,4,1,154659,154659,154660,0,1,1
44254,2,3,154661,154661,154664,0,3,1
44255,1,3,154662,154664,154667,2,5,0
44256,4,3,154666,154667,154670,1,4,0
44257,1,1,154667,154670,154671,3,4,0
44258,3,3,154670,154671,154674,1,4,0
44259,5,2,154675,154675,154677,0,2,1
44260,2,2,154677,154677,154679,0,2,0
44261,2,3,154679,154679,154682,0,3,0
44262,5,3,154684,154684,154687,0,3,2
44263,4,1,154688,154688,154689,0,1,1
44264,2,3,154690,154690,154693,0,3,1
44265,1,1,154691,154693,154694,2,3,0
44266,6,1,154697,154697,154698,0,1,3
44267,4,2,154701,154701,154703,0,2,3
44268,5,2,154706,154706,154708,0,2,3
44269,2,1,154708,154708,154709,0,1,0
44270,1,1,154709,154709,154710,0,1,0
44271,3,3,154712,154712,154715,0,3,2
44272,1,2,154713,154715,154717,2,4,0
44273,5,1,154718,154718,154719,0,1,1
44274,4,2,154722,154722,154724,0,2,3
44275,3,2,154725,154725,154727,0,2,1
44276,6,1,154731,154731,154732,0,1,4
44277,1,1,154732,154732,154733,0,1,0
44278,5,1,154737,154737,154738,0,1,4
44279,2,3,154739,154739,154742,0,3,1
44280,2,2,154741,154742,154744,1,3,0
44281,6,2,154747,154747,154749,0,2,3
44282,2,1,154749,154749,154750,0,1,0
44283,5,3,154754,154754,154757,0,3,4
44284,1,3,154755,154757,154760,2,5,0
44285,5,1,154760,154760,154761,0,1,0
44286,4,2,154764,154764,154766,0,2,3
44287,5,2,154769,154769,154771,0,2,3
44288,1,2,154770,154771,154773,1,3,0
44289,5,2,154775,154775,154777,0,2,2
44290,6,3,154781,154781,154784,0,3,4
44291,3,1,154784,154784,154785,0,1,0
44292,2,2,154786,154786,154788,0,2,1
44293,4,3,154790,154790,154793,0,3,2
44294,1,1,154791,154793,154794,2,3,0
44295,5,1,154796,154796,154797,0,1,2
44296,3,2,154799,154799,154801,0,2,2
44297,4,2,154803,154803,154805,0,2,2
44298,3,1,154806,154806,154807,0,1,1
44299,4,1,154810,154810,154811,0,1,3
44300,4,2,154814,154814,154816,0,2,3
44301,1,3,154815,154816,154819,1,4,0
44302,4,3,154819,154819,154822,0,3,0
44303,3,2,154822,154822,154824,0,2,0
44304,5,2,154827,154827,154829,0,2,3
44305,5,3,154832,154832,154835,0,3,3
44306,4,2,154836,154836,154838,0,2,1
44307,1,1,154837,154838,154839,1,2,0
44308,2,2,154839,154839,154841,0,2,0
44309,4,3,154843,154843,154846,0,3,2
44310,3,3,154846,154846,154849,0,3,0
44311,1,2,154847,154849,154851,2,4,0
44312,6,3,154853,154853,154856,0,3,2
44313,4,3,154857,154857,154860,0,3,1
44314,1,3,154858,154860,154863,2,5,0
44315,3,2,154861,154863,154865,2,4,0
44316,6,3,154867,154867,154870,0,3,2
44317,6,2,154873,154873,154875,0,2,3
44318,3,1,154876,154876,154877,0,1,1
44319,6,3,154882,154882,154885,0,3,5
44320,1,2,154883,154885,154887,2,4,0
44321,6,3,154889,154889,154892,0,3,2
44322,6,3,154895,154895,154898,0,3,3
44323,5,2,154900,154900,154902,0,2,2
44324,6,3,154906,154906,154909,0,3,4
44325,2,2,154908,154909,154911,1,3,0
44326,1,2,154909,154911,154913,2,4,0
44327,3,2,154912,154913,154915,1,3,0
44328,2,3,154914,154915,154918,1,4,0
44329,4,3,154918,154918,154921,0,3,0
44330,6,3,154924,154924,154927,0,3,3
44331,6,2,154930,154930,154932,0,2,3
44332,3,3,154933,154933,154936,0,3,1
44333,6,3,154939,154939,154942,0,3,3
44334,6,2,154945,154945,154947,0,2,3
44335,4,2,154949,154949,154951,0,2,2
44336,4,1,154953,154953,154954,0,1,2
44337,1,2,154954,154954,154956,0,2,0
44338,1,3,154955,154956,154959,1,4,0
44339,2,1,154957,154959,154960,2,3,0
44340,4,1,154961,154961,154962,0,1,1
44341,2,3,154963,154963,154966,0,3,1
44342,1,2,154964,154966,154968,2,4,0
44343,6,2,154970,154970,154972,0,2,2
44344,6,2,154976,154976,154978,0,2,4
44345,1,3,154977,154978,154981,1,4,0
44346,3,1,154980,154981,154982,1,2,0
44347,6,1,154986,154986,154987,0,1,4
44348,3,1,154989,154989,154990,0,1,2
44349,6,1,154995,154995,154996,0,1,5
44350,1,2,154996,154996,154998,0,2,0
44351,1,2,154997,154998,155000,1,3,0
44352,4,3,155001,155001,155004,0,3,1
44353,5,2,155006,155006,155008,0,2,2
44354,5,2,155011,155011,155013,0,2,3
44355,2,2,155013,155013,155015,0,2,0
44356,5,3,155018,155018,155021,0,3,3
44357,1,1,155019,155021,155022,2,3,0
44358,5,3,155024,155024,155027,0,3,2
44359,2,1,155026,155027,155028,1,2,0
44360,4,1,155030,155030,155031,0,1,2
44361,3,2,155033,155033,155035,0,2,2
44362,3,3,155036,155036,155039,0,3,1
44363,5,1,155041,155041,155042,0,1,2
44364,3,3,155044,155044,155047,0,3,2
44365,3,1,155047,155047,155048,0,1,0
44366,3,2,155050,155050,155052,0,2,2
44367,3,1,155053,155053,155054,0,1,1
44368,3,2,155056,155056,155058,0,2,2
44369,1,2,155057,155058,155060,1,3,0
44370,5,3,155062,155062,155065,0,3,2
44371,1,3,155063,155065,155068,2,5,0
44372,5,2,155068,155068,155070,0,2,0
44373,6,2,155074,155074,155076,0,2,4
44374,1,3,155075,155076,155079,1,4,0
44375,6,2,155081,155081,155083,0,2,2
44376,2,3,155083,155083,155086,0,3,0
44377,2,2,155085,155086,155088,1,3,0
44378,5,3,155090,155090,155093,0,3,2
44379,5,2,155095,155095,155097,0,2,2
44380,4,2,155099,155099,155101,0,2,2
44381,3,3,155102,155102,155105,0,3,1
44382,6,3,155108,155108,155111,0,3,3
44383,3,3,155111,155111,155114,0,3,0
44384,1,1,155112,155114,155115,2,3,0
44385,5,1,155117,155117,155118,0,1,2
44386,1,2,155118,155118,155120,0,2,0
44387,1,1,155119,155120,155121,1,2,0
44388,6,3,155125,155125,155128,0,3,4
44389,6,3,155131,155131,155134,0,3,3
44390,1,1,155132,155134,155135,2,3,0
44391,3,1,155135,155135,155136,0,1,0
44392,2,3,155137,155137,155140,0,3,1
44393,5,1,155142,155142,155143,0,1,2
44394,3,1,155145,155145,155146,0,1,2
44395,4,3,155149,155149,155152,0,3,3
44396,4,2,155153,155153,155155,0,2,1
44397,2,1,155155,155155,155156,0,1,0
44398,6,3,155161,155161,155164,0,3,5
44399,3,3,155164,155164,155167,0,3,0
44400,3,3,155167,155167,155170,0,3,0
44401,4,1,155171,155171,155172,0,1,1
44402,2,3,155173,155173,155176,0,3,1
44403,5,2,155178,155178,155180,0,2,2
44404,6,3,155184,155184,155187,0,3,4
44405,2,1,155186,155187,155188,1,2,0
44406,4,3,155190,155190,155193,0,3,2
44407,3,1,155193,155193,155194,0,1,0
44408,5,1,155198,155198,155199,0,1,4
44409,5,2,155203,155203,155205,0,2,4
44410,2,2,155205,155205,155207,0,2,0
44411,5,3,155210,155210,155213,0,3,3
44412,4,1,155214,155214,155215,0,1,1
44413,5,2,155219,155219,155221,0,2,4
44414,3,2,155222,155222,155224,0,2,1
44415,4,2,155226,155226,155228,0,2,2
44416,2,2,155228,155228,155230,0,2,0
44417,2,1,155230,155230,155231,0,1,0
44418,1,3,155231,155231,155234,0,3,0
44419,1,3,155232,155234,155237,2,5,0
44420,6,2,155238,155238,155240,0,2,1
44421,6,1,155244,155244,155245,0,1,4
44422,5,1,155249,155249,155250,0,1,4
44423,4,1,155253,155253,155254,0,1,3
44424,5,3,155258,155258,155261,0,3,4
44425,1,1,155259,155261,155262,2,3,0
44426,5,3,155264,155264,155267,0,3,2
44427,3,1,155267,155267,155268,0,1,0
44428,6,1,155273,155273,155274,0,1,5
44429,1,2,155274,155274,155276,0,2,0
44430,3,2,155277,155277,155279,0,2,1
44431,4,2,155281,155281,155283,0,2,2
44432,2,1,155283,155283,155284,0,1,0
44433,2,3,155285,155285,155288,0,3,1
44434,2,1,155287,155288,155289,1,2,0
44435,6,3,155293,155293,155296,0,3,4
44436,2,3,155295,155296,155299,1,4,0
44437,1,3,155296,155299,155302,3,6,0
44438,3,3,155299,155302,155305,3,6,0
44439,3,3,155302,155305,155308,3,6,0
44440,4,3,155306,155308,155311,2,5,0
44441,6,1,155312,155312,155313,0,1,1
44442,4,2,155316,155316,155318,0,2,3
44443,6,1,155322,155322,155323,0,1,4
44444,1,2,155323,155323,155325,0,2,0
44445,3,2,155326,155326,155328,0,2,1
44446,4,3,155330,155330,155333,0,3,2
44447,3,1,155333,155333,155334,0,1,0
44448,6,2,155339,155339,155341,0,2,5
44449,6,1,155345,155345,155346,0,1,4
44450,3,3,155348,155348,155351,0,3,2
44451,3,3,155351,155351,155354,0,3,0
44452,6,3,155357,155357,155360,0,3,3
44453,3,1,155360,155360,155361,0,1,0
44454,2,3,155362,155362,155365,0,3,1
44455,3,2,155365,155365,155367,0,2,0
44456,5,3,155370,155370,155373,0,3,3
44457,1,1,155371,155373,155374,2,3,0
44458,5,1,155376,155376,155377,0,1,2
44459,4,3,155380,155380,155383,0,3,3
44460,1,3,155381,155383,155386,2,5,0
44461,6,2,155387,155387,155389,0,2,1
44462,3,2,155390,155390,155392,0,2,1
44463,6,2,155396,155396,155398,0,2,4
44464,3,3,155399,155399,155402,0,3,1
44465,6,1,155405,155405,155406,0,1,3
44466,2,3,155407,155407,155410,0,3,1
44467,2,2,155409,155410,155412,1,3,0
44468,2,2,155411,155412,155414,1,3,0
44469,3,3,155414,155414,155417,0,3,0
44470,4,1,155418,155418,155419,0,1,1
44471,4,2,155422,155422,155424,0,2,3
44472,4,1,155426,155426,155427,0,1,2
44473,4,1,155430,155430,155431,0,1,3
44474,6,2,155436,155436,155438,0,2,5
44475,5,2,155441,155441,155443,0,2,3
44476,5,1,155446,155446,155447,0,1,3
44477,4,3,155450,155450,155453,0,3,3
44478,4,2,155454,155454,155456,0,2,1
44479,6,2,155460,155460,155462,0,2,4
44480,3,1,155463,155463,155464,0,1,1
44481,2,2,155465,155465,155467,0,2,1
44482,4,2,155469,155469,155471,0,2,2
44483,1,2,155470,155471,155473,1,3,0
44484,4,1,155474,155474,155475,0,1,1
44485,3,2,155477,155477,155479,0,2,2
44486,1,2,155478,155479,155481,1,3,0
44487,2,3,155480,155481,155484,1,4,0
44488,6,1,155486,155486,155487,0,1,2
44489,4,3,155490,155490,155493,0,3,3
44490,3,1,155493,155493,155494,0,1,0
44491,5,2,155498,155498,155500,0,2,4
44492,2,2,155500,155500,155502,0,2,0
44493,3,1,155503,155503,155504,0,1,1
44494,5,1,155508,155508,155509,0,1,4
44495,4,1,155512,155512,155513,0,1,3
44496,6,1,155518,155518,155519,0,1,5
44497,5,1,155523,155523,155524,0,1,4
44498,2,1,155525,155525,155526,0,1,1
44499,2,3,155527,155527,155530,0,3,1
44500,5,3,155532,155532,155535,0,3,2
44501,5,2,155537,155537,155539,0,2,2
44502,4,3,155541,155541,155544,0,3,2
44503,5,1,155546,155546,155547,0,1,2
44504,3,1,155549,155549,155550,0,1,2
44505,4,3,155553,155553,155556,0,3,3
44506,5,1,155558,155558,155559,0,1,2
44507,4,3,155562,155562,155565,0,3,3
44508,4,2,155566,155566,155568,0,2,1
44509,1,1,155567,155568,155569,1,2,0
44510,2,2,155569,155569,155571,0,2,0
44511,1,3,155570,155571,155574,1,4,0
44512,3,2,155573,155574,155576,1,3,0
44513,4,3,155577,155577,155580,0,3,1
44514,4,1,155581,155581,155582,0,1,1
44515,2,3,155583,155583,155586,0,3,1
44516,4,3,155587,155587,155590,0,3,1
44517,6,3,155593,155593,155596,0,3,3
44518,4,3,155597,155597,155600,0,3,1
44519,1,3,155598,155600,155603,2,5,0
44520,5,2,155603,155603,155605,0,2,0
44521,1,2,155604,155605,155607,1,3,0
44522,6,3,155610,155610,155613,0,3,3
44523,4,2,155614,155614,155616,0,2,1
44524,4,3,155618,155618,155621,0,3,2
44525,4,1,155622,155622,155623,0,1,1
44526,2,1,155624,155624,155625,0,1,1
44527,2,3,155626,155626,155629,0,3,1
44528,2,1,155628,155629,155630,1,2,0
44529,6,1,155634,155634,155635,0,1,4
44530,3,3,155637,155637,155640,0,3,2
44531,6,1,155643,155643,155644,0,1,3
44532,4,3,155647,155647,155650,0,3,3
44533,4,3,155651,155651,155654,0,3,1
44534,6,3,155657,155657,155660,0,3,3
44535,6,3,155663,155663,155666,0,3,3
44536,5,3,155668,155668,155671,0,3,2
44537,1,2,155669,155671,155673,2,4,0
44538,4,1,155673,155673,155674,0,1,0
44539,5,2,155678,155678,155680,0,2,4
44540,3,2,155681,155681,155683,0,2,1
44541,4,3,155685,155685,155688,0,3,2
44542,1,3,155686,155688,155691,2,5,0
44543,4,2,155690,155691,155693,1,3,0
44544,4,3,155694,155694,155697,0,3,1
44545,4,1,155698,155698,155699,0,1,1
44546,6,1,155704,155704,155705,0,1,5
44547,4,2,155708,155708,155710,0,2,3
44548,1,3,155709,155710,155713,1,4,0
44549,2,2,155711,155713,155715,2,4,0
44550,4,3,155715,155715,155718,0,3,0
44551,1,3,155716,155718,155721,2,5,0
44552,2,2,155718,155721,155723,3,5,0
44553,3,1,155721,155723,155724,2,3,0
44554,2,2,155723,155724,155726,1,3,0
44555,3,2,155726,155726,155728,0,2,0
44556,4,2,155730,155730,155732,0,2,2
44557,1,3,155731,155732,155735,1,4,0
44558,3,1,155734,155735,155736,1,2,0
44559,6,3,155740,155740,155743,0,3,4
44560,6,2,155746,155746,155748,0,2,3
44561,3,1,155749,155749,155750,0,1,1
44562,4,3,155753,155753,155756,0,3,3
44563,2,1,155755,155756,155757,1,2,0
44564,5,1,155760,155760,155761,0,1,3
44565,4,3,155764,155764,155767,0,3,3
44566,1,3,155765,155767,155770,2,5,0
44567,1,3,155766,155770,155773,4,7,0
44568,2,2,155768,155773,155775,5,7,0
44569,3,1,155771,155775,155776,4,5,0
44570,1,2,155772,155776,155778,4,6,0
44571,6,2,155778,155778,155780,0,2,0
44572,5,2,155783,155783,155785,0,2,3
44573,4,1,155787,155787,155788,0,1,2
44574,2,2,155789,155789,155791,0,2,1
44575,5,1,155794,155794,155795,0,1,3
44576,4,3,155798,155798,155801,0,3,3
44577,1,2,155799,155801,155803,2,4,0
44578,6,3,155805,155805,155808,0,3,2
44579,3,3,155808,155808,155811,0,3,0
44580,4,1,155812,155812,155813,0,1,1
44581,6,3,155818,155818,155821,0,3,5
44582,4,2,155822,155822,155824,0,2,1
44583,4,2,155826,155826,155828,0,2,2
44584,3,2,155829,155829,155831,0,2,1
44585,2,2,155831,155831,155833,0,2,0
44586,5,2,155836,155836,155838,0,2,3
44587,3,3,155839,155839,155842,0,3,1
44588,5,2,155844,155844,155846,0,2,2
44589,6,2,155850,155850,155852,0,2,4
44590,5,1,155855,155855,155856,0,1,3
44591,1,2,155856,155856,155858,0,2,0
44592,1,3,155857,155858,155861,1,4,0
44593,3,1,155860,155861,155862,1,2,0
44594,3,1,155863,155863,155864,0,1,1
44595,2,2,155865,155865,155867,0,2,1
44596,3,3,155868,155868,155871,0,3,1
44597,1,1,155869,155871,155872,2,3,0
44598,1,1,155870,155872,155873,2,3,0
44599,1,3,155871,155873,155876,2,5,0
44600,1,1,155872,155876,155877,4,5,0
44601,2,2,155874,155877,155879,3,5,0
44602,5,3,155879,155879,155882,0,3,0
44603,6,3,155885,155885,155888,0,3,3
44604,5,1,155890,155890,155891,0,1,2
44605,3,2,155893,155893,155895,0,2,2
44606,3,3,155896,155896,155899,0,3,1
44607,2,2,155898,155899,155901,1,3,0
44608,2,1,155900,155901,155902,1,2,0
44609,6,2,155906,155906,155908,0,2,4
44610,4,1,155910,155910,155911,0,1,2
44611,6,3,155916,155916,155919,0,3,5
44612,6,1,155922,155922,155923,0,1,3
44613,5,3,155927,155927,155930,0,3,4
44614,3,3,155930,155930,155933,0,3,0
44615,4,2,155934,155934,155936,0,2,1
44616,3,1,155937,155937,155938,0,1,1
44617,6,2,155943,155943,155945,0,2,5
44618,6,2,155949,155949,155951,0,2,4
44619,4,2,155953,155953,155955,0,2,2
44620,6,2,155959,155959,155961,0,2,4
44621,6,1,155965,155965,155966,0,1,4
44622,5,1,155970,155970,155971,0,1,4
44623,3,1,155973,155973,155974,0,1,2
44624,1,2,155974,155974,155976,0,2,0
44625,4,2,155978,155978,155980,0,2,2
44626,1,2,155979,155980,155982,1,3,0
44627,3,3,155982,155982,155985,0,3,0
44628,5,1,155987,155987,155988,0,1,2
44629,6,3,155993,155993,155996,0,3,5
44630,6,3,155999,155999,156002,0,3,3
44631,6,1,156005,156005,156006,0,1,3
44632,4,2,156009,156009,156011,0,2,3
44633,3,2,156012,156012,156014,0,2,1
44634,5,3,156017,156017,156020,0,3,3
44635,6,1,156023,156023,156024,0,1,3
44636,1,2,156024,156024,156026,0,2,0
44637,5,3,156029,156029,156032,0,3,3
44638,4,3,156033,156033,156036,0,3,1
44639,5,1,156038,156038,156039,0,1,2
44640,2,2,156040,156040,156042,0,2,1
44641,1,2,156041,156042,156044,1,3,0
44642,1,1,156042,156044,156045,2,3,0
44643,4,1,156046,156046,156047,0,1,1
44644,1,1,156047,156047,156048,0,1,0
44645,4,1,156051,156051,156052,0,1,3
44646,5,3,156056,156056,156059,0,3,4
44647,4,1,156060,156060,156061,0,1,1
44648,3,1,156063,156063,156064,0,1,2
44649,4,2,156067,156067,156069,0,2,3
44650,3,1,156070,156070,156071,0,1,1
44651,2,1,156072,156072,156073,0,1,1
44652,1,3,156073,156073,156076,0,3,0
44653,3,2,156076,156076,156078,0,2,0
44654,1,1,156077,156078,156079,1,2,0
44655,6,3,156083,156083,156086,0,3,4
44656,4,2,156087,156087,156089,0,2,1
44657,4,3,156091,156091,156094,0,3,2
44658,1,1,156092,156094,156095,2,3,0
44659,1,2,156093,156095,156097,2,4,0
44660,1,2,156094,156097,156099,3,5,0
44661,5,2,156099,156099,156101,0,2,0
44662,4,3,156103,156103,156106,0,3,2
44663,4,1,156107,156107,156108,0,1,1
44664,4,3,156111,156111,156114,0,3,3
44665,2,2,156113,156114,156116,1,3,0
44666,6,2,156119,156119,156121,0,2,3
44667,4,3,156123,156123,156126,0,3,2
44668,6,3,156129,156129,156132,0,3,3
44669,4,3,156133,156133,156136,0,3,1
44670,3,1,156136,156136,156137,0,1,0
44671,2,2,156138,156138,156140,0,2,1
44672,5,1,156143,156143,156144,0,1,3
44673,3,1,156146,156146,156147,0,1,2
44674,6,3,156152,156152,156155,0,3,5
44675,3,3,156155,156155,156158,0,3,0
44676,6,3,156161,156161,156164,0,3,3
44677,1,2,156162,156164,156166,2,4,0
44678,1,2,156163,156166,156168,3,5,0
44679,4,1,156167,156168,156169,1,2,0
44680,4,1,156171,156171,156172,0,1,2
44681,5,2,156176,156176,156178,0,2,4
44682,6,1,156182,156182,156183,0,1,4
44683,6,1,156188,156188,156189,0,1,5
44684,5,3,156193,156193,156196,0,3,4
44685,4,3,156197,156197,156200,0,3,1
44686,6,3,156203,156203,156206,0,3,3
44687,2,3,156205,156206,156209,1,4,0
44688,5,3,156210,156210,156213,0,3,1
44689,4,1,156214,156214,156215,0,1,1
44690,3,3,156217,156217,156220,0,3,2
44691,4,2,156221,156221,156223,0,2,1
44692,2,2,156223,156223,156225,0,2,0
44693,2,3,156225,156225,156228,0,3,0
44694,4,1,156229,156229,156230,0,1,1
44695,2,2,156231,156231,156233,0,2,1
44696,5,1,156236,156236,156237,0,1,3
44697,2,1,156238,156238,156239,0,1,1
44698,1,2,156239,156239,156241,0,2,0
44699,2,2,156241,156241,156243,0,2,0
44700,3,3,156244,156244,156247,0,3,1
44701,6,2,156250,156250,156252,0,2,3
44702,5,1,156255,156255,156256,0,1,3
44703,4,3,156259,156259,156262,0,3,3
44704,3,3,156262,156262,156265,0,3,0
44705,4,2,156266,156266,156268,0,2,1
44706,5,1,156271,156271,156272,0,1,3
44707,1,1,156272,156272,156273,0,1,0
44708,5,2,156277,156277,156279,0,2,4
44709,3,3,156280,156280,156283,0,3,1
44710,3,1,156283,156283,156284,0,1,0
44711,5,1,156288,156288,156289,0,1,4
44712,1,1,156289,156289,156290,0,1,0
44713,4,1,156293,156293,156294,0,1,3
44714,3,2,156296,156296,156298,0,2,2
44715,2,3,156298,156298,156301,0,3,0
44716,1,1,156299,156301,156302,2,3,0
44717,2,2,156301,156302,156304,1,3,0
44718,4,3,156305,156305,156308,0,3,1
44719,3,1,156308,156308,156309,0,1,0
44720,1,2,156309,156309,156311,0,2,0
44721,1,1,156310,156311,156312,1,2,0
44722,1,2,156311,156312,156314,1,3,0
44723,5,3,156316,156316,156319,0,3,2
44724,1,2,156317,156319,156321,2,4,0
44725,6,1,156323,156323,156324,0,1,2
44726,1,2,156324,156324,156326,0,2,0
44727,2,1,156326,156326,156327,0,1,0
44728,4,3,156330,156330,156333,0,3,3
44729,1,1,156331,156333,156334,2,3,0
44730,2,3,156333,156334,156337,1,4,0
44731,3,2,156336,156337,156339,1,3,0
44732,2,2,156338,156339,156341,1,3,0
44733,3,2,156341,156341,156343,0,2,0
44734,1,1,156342,156343,156344,1,2,0
44735,2,3,156344,156344,156347,0,3,0
44736,4,1,156348,156348,156349,0,1,1
44737,5,1,156353,156353,156354,0,1,4
44738,1,1,156354,156354,156355,0,1,0
44739,5,1,156359,156359,156360,0,1,4
44740,1,2,156360,156360,156362,0,2,0
44741,6,2,156366,156366,156368,0,2,4
44742,2,1,156368,156368,156369,0,1,0
44743,6,3,156374,156374,156377,0,3,5
44744,5,3,156379,156379,156382,0,3,2
44745,6,2,156385,156385,156387,0,2,3
44746,3,3,156388,156388,156391,0,3,1
44747,4,3,156392,156392,156395,0,3,1
44748,3,2,156395,156395,156397,0,2,0
44749,5,1,156400,156400,156401,0,1,3
44750,4,2,156404,156404,156406,0,2,3
44751,1,2,156405,156406,156408,1,3,0
44752,4,3,156409,156409,156412,0,3,1
44753,3,1,156412,156412,156413,0,1,0
44754,5,2,156417,156417,156419,0,2,4
44755,5,1,156422,156422,156423,0,1,3
44756,1,3,156423,156423,156426,0,3,0
44757,1,3,156424,156426,156429,2,5,0
44758,1,3,156425,156429,156432,4,7,0
44759,4,1,156429,156432,156433,3,4,0
44760,3,1,156432,156433,156434,1,2,0
44761,3,1,156435,156435,156436,0,1,1
44762,4,1,156439,156439,156440,0,1,3
44763,2,3,156441,156441,156444,0,3,1
44764,4,2,156445,156445,156447,0,2,1
44765,6,3,156451,156451,156454,0,3,4
44766,5,1,156456,156456,156457,0,1,2
44767,3,2,156459,156459,156461,0,2,2
44768,2,3,156461,156461,156464,0,3,0
44769,5,1,156466,156466,156467,0,1,2
44770,4,1,156470,156470,156471,0,1,3
44771,1,2,156471,156471,156473,0,2,0
44772,3,1,156474,156474,156475,0,1,1
44773,5,1,156479,156479,156480,0,1,4
44774,5,1,156484,156484,156485,0,1,4
44775,3,3,156487,156487,156490,0,3,2
44776,6,2,156493,156493,156495,0,2,3
44777,2,2,156495,156495,156497,0,2,0
44778,4,3,156499,156499,156502,0,3,2
44779,1,3,156500,156502,156505,2,5,0
44780,1,2,156501,156505,156507,4,6,0
44781,4,1,156505,156507,156508,2,3,0
44782,1,2,156506,156508,156510,2,4,0
44783,4,1,156510,156510,156511,0,1,0
44784,6,2,156516,156516,156518,0,2,5
44785,5,2,156521,156521,156523,0,2,3
44786,3,2,156524,156524,156526,0,2,1
44787,4,2,156528,156528,156530,0,2,2
44788,6,1,156534,156534,156535,0,1,4
44789,2,3,156536,156536,156539,0,3,1
44790,5,2,156541,156541,156543,0,2,2
44791,3,3,156544,156544,156547,0,3,1
44792,2,2,156546,156547,156549,1,3,0
44793,2,1,156548,156549,156550,1,2,0
44794,4,3,156552,156552,156555,0,3,2
44795,5,2,156557,156557,156559,0,2,2
44796,3,3,156560,156560,156563,0,3,1
44797,5,3,156565,156565,156568,0,3,2
44798,6,2,156571,156571,156573,0,2,3
44799,1,1,156572,156573,156574,1,2,0
44800,5,2,156577,156577,156579,0,2,3
44801,4,1,156581,156581,156582,0,1,2
44802,2,1,156583,156583,156584,0,1,1
44803,5,2,156588,156588,156590,0,2,4
44804,2,3,156590,156590,156593,0,3,0
44805,3,3,156593,156593,156596,0,3,0
44806,1,2,156594,156596,156598,2,4,0
44807,2,3,156596,156598,156601,2,5,0
44808,5,1,156601,156601,156602,0,1,0
44809,6,2,156607,156607,156609,0,2,5
44810,6,1,156613,156613,156614,0,1,4
44811,2,2,156615,156615,156617,0,2,1
44812,4,1,156619,156619,156620,0,1,2
44813,3,1,156622,156622,156623,0,1,2
44814,3,2,156625,156625,156627,0,2,2
44815,4,1,156629,156629,156630,0,1,2
44816,6,3,156635,156635,156638,0,3,5
44817,1,2,156636,156638,156640,2,4,0
44818,2,2,156638,156640,156642,2,4,0
44819,5,1,156643,156643,156644,0,1,1
44820,2,3,156645,156645,156648,0,3,1
44821,1,2,156646,156648,156650,2,4,0
44822,4,3,156650,156650,156653,0,3,0
44823,5,3,156655,156655,156658,0,3,2
44824,4,3,156659,156659,156662,0,3,1
44825,5,3,156664,156664,156667,0,3,2
44826,5,2,156669,156669,156671,0,2,2
44827,5,2,156674,156674,156676,0,2,3
44828,4,3,156678,156678,156681,0,3,2
44829,2,3,156680,156681,156684,1,4,0
44830,4,2,156684,156684,156686,0,2,0
44831,2,1,156686,156686,156687,0,1,0
44832,3,1,156689,156689,156690,0,1,2
44833,1,2,156690,156690,156692,0,2,0
44834,3,3,156693,156693,156696,0,3,1
44835,2,2,156695,156696,156698,1,3,0
44836,2,2,156697,156698,156700,1,3,0
44837,4,2,156701,156701,156703,0,2,1
44838,3,2,156704,156704,156706,0,2,1
44839,5,1,156709,156709,156710,0,1,3
44840,1,2,156710,156710,156712,0,2,0
44841,5,1,156715,156715,156716,0,1,3
44842,1,3,156716,156716,156719,0,3,0
44843,4,1,156720,156720,156721,0,1,1
44844,4,2,156724,156724,156726,0,2,3
44845,2,2,156726,156726,156728,0,2,0
44846,3,2,156729,156729,156731,0,2,1
44847,4,1,156733,156733,156734,0,1,2
44848,1,2,156734,156734,156736,0,2,0
44849,5,2,156739,156739,156741,0,2,3
44850,3,1,156742,156742,156743,0,1,1
44851,6,3,156748,156748,156751,0,3,5
44852,2,2,156750,156751,156753,1,3,0
44853,3,1,156753,156753,156754,0,1,0
44854,4,3,156757,156757,156760,0,3,3
44855,4,2,156761,156761,156763,0,2,1
44856,5,1,156766,156766,156767,0,1,3
44857,5,1,156771,156771,156772,0,1,4
44858,6,2,156777,156777,156779,0,2,5
44859,2,2,156779,156779,156781,0,2,0
44860,2,1,156781,156781,156782,0,1,0
44861,5,3,156786,156786,156789,0,3,4
44862,4,3,156790,156790,156793,0,3,1
44863,6,3,156796,156796,156799,0,3,3
44864,1,2,156797,156799,156801,2,4,0
44865,6,2,156803,156803,156805,0,2,2
44866,4,2,156807,156807,156809,0,2,2
44867,6,2,156813,156813,156815,0,2,4
44868,2,1,156815,156815,156816,0,1,0
44869,2,2,156817,156817,156819,0,2,1
44870,3,1,156820,156820,156821,0,1,1
44871,6,2,156826,156826,156828,0,2,5
44872,4,1,156830,156830,156831,0,1,2
44873,3,2,156833,156833,156835,0,2,2
44874,1,3,156834,156835,156838,1,4,0
44875,4,1,156838,156838,156839,0,1,0
44876,6,1,156844,156844,156845,0,1,5
44877,4,2,156848,156848,156850,0,2,3
44878,3,3,156851,156851,156854,0,3,1
44879,6,2,156857,156857,156859,0,2,3
44880,1,1,156858,156859,156860,1,2,0
44881,5,3,156863,156863,156866,0,3,3
44882,1,2,156864,156866,156868,2,4,0
44883,5,2,156869,156869,156871,0,2,1
44884,2,2,156871,156871,156873,0,2,0
44885,5,2,156876,156876,156878,0,2,3
44886,6,2,156882,156882,156884,0,2,4
44887,6,3,156888,156888,156891,0,3,4
44888,1,3,156889,156891,156894,2,5,0
44889,1,2,156890,156894,156896,4,6,0
44890,4,2,156894,156896,156898,2,4,0
44891,2,3,156896,156898,156901,2,5,0
44892,4,3,156900,156901,156904,1,4,0
44893,1,3,156901,156904,156907,3,6,0
44894,4,2,156905,156907,156909,2,4,0
44895,6,3,156911,156911,156914,0,3,2
44896,3,1,156914,156914,156915,0,1,0
44897,2,1,156916,156916,156917,0,1,1
44898,4,1,156920,156920,156921,0,1,3
44899,3,3,156923,156923,156926,0,3,2
44900,2,2,156925,156926,156928,1,3,0
44901,2,3,156927,156928,156931,1,4,0
44902,5,1,156932,156932,156933,0,1,1
44903,3,2,156935,156935,156937,0,2,2
44904,3,2,156938,156938,156940,0,2,1
44905,1,2,156939,156940,156942,1,3,0
44906,6,2,156945,156945,156947,0,2,3
44907,2,2,156947,156947,156949,0,2,0
44908,4,1,156951,156951,156952,0,1,2
44909,6,2,156957,156957,156959,0,2,5
44910,1,1,156958,156959,156960,1,2,0
44911,5,2,156963,156963,156965,0,2,3
44912,2,3,156965,156965,156968,0,3,0
44913,3,1,156968,156968,156969,0,1,0
44914,4,3,156972,156972,156975,0,3,3
44915,3,3,156975,156975,156978,0,3,0
44916,4,3,156979,156979,156982,0,3,1
44917,2,2,156981,156982,156984,1,3,0
44918,1,3,156982,156984,156987,2,5,0
44919,4,1,156986,156987,156988,1,2,0
44920,1,1,156987,156988,156989,1,2,0
44921,1,1,156988,156989,156990,1,2,0
44922,4,2,156992,156992,156994,0,2,2
44923,2,1,156994,156994,156995,0,1,0
44924,1,1,156995,156995,156996,0,1,0
44925,5,1,157000,157000,157001,0,1,4
44926,6,1,157006,157006,157007,0,1,5
44927,6,2,157012,157012,157014,0,2,5
44928,3,2,157015,157015,157017,0,2,1
44929,3,2,157018,157018,157020,0,2,1
44930,6,3,157024,157024,157027,0,3,4
44931,2,2,157026,157027,157029,1,3,0
44932,6,1,157032,157032,157033,0,1,3
44933,6,2,157038,157038,157040,0,2,5
44934,4,3,157042,157042,157045,0,3,2
44935,1,3,157043,157045,157048,2,5,0
44936,1,1,157044,157048,157049,4,5,0
44937,3,3,157047,157049,157052,2,5,0
44938,5,3,157052,157052,157055,0,3,0
44939,2,1,157054,157055,157056,1,2,0
44940,5,1,157059,157059,157060,0,1,3
44941,6,3,157065,157065,157068,0,3,5
44942,2,1,157067,157068,157069,1,2,0
44943,3,2,157070,157070,157072,0,2,1
44944,6,1,157076,157076,157077,0,1,4
44945,3,1,157079,157079,157080,0,1,2
44946,6,1,157085,157085,157086,0,1,5
44947,3,2,157088,157088,157090,0,2,2
44948,2,3,157090,157090,157093,0,3,0
44949,3,1,157093,157093,157094,0,1,0
44950,6,2,157099,157099,157101,0,2,5
44951,5,2,157104,157104,157106,0,2,3
44952,2,2,157106,157106,157108,0,2,0
44953,4,2,157110,157110,157112,0,2,2
44954,4,1,157114,157114,157115,0,1,2
44955,5,3,157119,157119,157122,0,3,4
44956,1,3,157120,157122,157125,2,5,0
44957,3,2,157123,157125,157127,2,4,0
44958,5,3,157128,157128,157131,0,3,1
44959,6,3,157134,157134,157137,0,3,3
44960,6,3,157140,157140,157143,0,3,3
44961,3,3,157143,157143,157146,0,3,0
44962,5,2,157148,157148,157150,0,2,2
44963,3,1,157151,157151,157152,0,1,1
44964,2,2,157153,157153,157155,0,2,1
44965,3,1,157156,157156,157157,0,1,1
44966,3,3,157159,157159,157162,0,3,2
44967,2,3,157161,157162,157165,1,4,0
44968,6,3,157167,157167,157170,0,3,2
44969,5,2,157172,157172,157174,0,2,2
44970,3,3,157175,157175,157178,0,3,1
44971,4,3,157179,157179,157182,0,3,1
44972,5,2,157184,157184,157186,0,2,2
44973,3,1,157187,157187,157188,0,1,1
44974,6,2,157193,157193,157195,0,2,5
44975,5,1,157198,157198,157199,0,1,3
44976,6,2,157204,157204,157206,0,2,5
44977,6,1,157210,157210,157211,0,1,4
44978,3,1,157213,157213,157214,0,1,2
44979,6,2,157219,157219,157221,0,2,5
44980,5,1,157224,157224,157225,0,1,3
44981,5,3,157229,157229,157232,0,3,4
44982,1,3,157230,157232,157235,2,5,0
44983,1,3,157231,157235,157238,4,7,0
44984,1,1,157232,157238,157239,6,7,0
44985,1,1,157233,157239,157240,6,7,0
44986,5,1,157238,157240,157241,2,3,0
44987,6,3,157244,157244,157247,0,3,3
44988,2,1,157246,157247,157248,1,2,0
44989,2,1,157248,157248,157249,0,1,0
44990,4,2,157252,157252,157254,0,2,3
44991,2,2,157254,157254,157256,0,2,0
44992,5,1,157259,157259,157260,0,1,3
44993,3,2,157262,157262,157264,0,2,2
44994,3,1,157265,157265,157266,0,1,1
44995,6,1,157271,157271,157272,0,1,5
44996,5,1,157276,157276,157277,0,1,4
44997,4,3,157280,157280,157283,0,3,3
44998,5,3,157285,157285,157288,0,3,2
44999,5,1,157290,157290,157291,0,1,2
45000,1,3,157291,157291,157294,0,3,0
45001,1,3,157292,157294,157297,2,5,0
45002,1,2,157293,157297,157299,4,6,0
45003,2,2,157295,157299,157301,4,6,0
45004,2,1,157297,157301,157302,4,5,0
45005,1,3,157298,157302,157305,4,7,0
45006,6,2,157304,157305,157307,1,3,0
45007,5,1,157309,157309,157310,0,1,2
45008,2,1,157311,157311,157312,0,1,1
45009,6,3,157317,157317,157320,0,3,5
45010,2,1,157319,157320,157321,1,2,0
45011,4,1,157323,157323,157324,0,1,2
45012,2,2,157325,157325,157327,0,2,1
45013,4,2,157329,157329,157331,0,2,2
45014,3,2,157332,157332,157334,0,2,1
45015,5,2,157337,157337,157339,0,2,3
45016,5,3,157342,157342,157345,0,3,3
45017,5,2,157347,157347,157349,0,2,2
45018,5,3,157352,157352,157355,0,3,3
45019,4,2,157356,157356,157358,0,2,1
45020,4,3,157360,157360,157363,0,3,2
45021,3,3,157363,157363,157366,0,3,0
45022,6,3,157369,157369,157372,0,3,3
45023,6,3,157375,157375,157378,0,3,3
45024,1,3,157376,157378,157381,2,5,0
45025,5,3,157381,157381,157384,0,3,0
45026,1,2,157382,157384,157386,2,4,0
45027,5,2,157387,157387,157389,0,2,1
45028,1,1,157388,157389,157390,1,2,0
45029,2,3,157390,157390,157393,0,3,0
45030,1,1,157391,157393,157394,2,3,0
45031,4,1,157395,157395,157396,0,1,1
45032,5,2,157400,157400,157402,0,2,4
45033,5,2,157405,157405,157407,0,2,3
45034,3,1,157408,157408,157409,0,1,1
45035,3,1,157411,157411,157412,0,1,2
45036,4,2,157415,157415,157417,0,2,3
45037,2,2,157417,157417,157419,0,2,0
45038,6,2,157423,157423,157425,0,2,4
45039,2,2,157425,157425,157427,0,2,0
45040,2,1,157427,157427,157428,0,1,0
45041,5,2,157432,157432,157434,0,2,4
45042,5,1,157437,157437,157438,0,1,3
45043,2,1,157439,157439,157440,0,1,1
45044,3,3,157442,157442,157445,0,3,2
45045,4,2,157446,157446,157448,0,2,1
45046,3,2,157449,157449,157451,0,2,1
45047,2,1,157451,157451,157452,0,1,0
45048,4,3,157455,157455,157458,0,3,3
45049,4,2,157459,157459,157461,0,2,1
45050,6,3,157465,157465,157468,0,3,4
45051,4,1,157469,157469,157470,0,1,1
45052,4,1,157473,157473,157474,0,1,3
45053,4,1,157477,157477,157478,0,1,3
45054,6,1,157483,157483,157484,0,1,5
45055,2,3,157485,157485,157488,0,3,1
45056,6,1,157491,157491,157492,0,1,3
45057,1,2,157492,157492,157494,0,2,0
45058,5,2,157497,157497,157499,0,2,3
45059,1,1,157498,157499,157500,1,2,0
45060,4,1,157502,157502,157503,0,1,2
45061,5,1,157507,157507,157508,0,1,4
45062,3,3,157510,157510,157513,0,3,2
45063,4,2,157514,157514,157516,0,2,1
45064,5,2,157519,157519,157521,0,2,3
45065,2,2,157521,157521,157523,0,2,0
45066,6,2,157527,157527,157529,0,2,4
45067,5,1,157532,157532,157533,0,1,3
45068,2,3,157534,157534,157537,0,3,1
45069,6,2,157540,157540,157542,0,2,3
45070,2,3,157542,157542,157545,0,3,0
45071,3,3,157545,157545,157548,0,3,0
45072,2,3,157547,157548,157551,1,4,0
45073,6,1,157553,157553,157554,0,1,2
45074,1,1,157554,157554,157555,0,1,0
45075,2,2,157556,157556,157558,0,2,1
45076,4,1,157560,157560,157561,0,1,2
45077,1,2,157561,157561,157563,0,2,0
45078,3,3,157564,157564,157567,0,3,1
45079,6,2,157570,157570,157572,0,2,3
45080,6,2,157576,157576,157578,0,2,4
45081,5,3,157581,157581,157584,0,3,3
45082,2,1,157583,157584,157585,1,2,0
45083,2,3,157585,157585,157588,0,3,0
45084,6,1,157591,157591,157592,0,1,3
45085,1,3,157592,157592,157595,0,3,0
45086,5,2,157597,157597,157599,0,2,2
45087,5,2,157602,157602,157604,0,2,3
45088,6,1,157608,157608,157609,0,1,4
45089,3,3,157611,157611,157614,0,3,2
45090,6,2,157617,157617,157619,0,2,3
45091,1,2,157618,157619,157621,1,3,0
45092,5,1,157623,157623,157624,0,1,2
45093,1,3,157624,157624,157627,0,3,0
45094,5,3,157629,157629,157632,0,3,2
45095,6,2,157635,157635,157637,0,2,3
45096,2,3,157637,157637,157640,0,3,0
45097,3,3,157640,157640,157643,0,3,0
45098,1,3,157641,157643,157646,2,5,0
45099,1,2,157642,157646,157648,4,6,0
45100,6,3,157648,157648,157651,0,3,0
45101,1,1,157649,157651,157652,2,3,0
45102,4,2,157653,157653,157655,0,2,1
45103,6,2,157659,157659,157661,0,2,4
45104,4,1,157663,157663,157664,0,1,2
45105,4,3,157667,157667,157670,0,3,3
45106,4,3,157671,157671,157674,0,3,1
45107,4,1,157675,157675,157676,0,1,1
45108,1,3,157676,157676,157679,0,3,0
45109,1,3,157677,157679,157682,2,5,0
45110,6,1,157683,157683,157684,0,1,1
45111,6,2,157689,157689,157691,0,2,5
45112,3,1,157692,157692,157693,0,1,1
45113,3,2,157695,157695,157697,0,2,2
45114,4,3,157699,157699,157702,0,3,2
45115,4,2,157703,157703,157705,0,2,1
45116,6,1,157709,157709,157710,0,1,4
45117,1,1,157710,157710,157711,0,1,0
45118,3,1,157713,157713,157714,0,1,2
45119,4,3,157717,157717,157720,0,3,3
45120,6,2,157723,157723,157725,0,2,3
45121,2,1,157725,157725,157726,0,1,0
45122,2,3,157727,157727,157730,0,3,1
45123,5,1,157732,157732,157733,0,1,2
45124,6,3,157738,157738,157741,0,3,5
45125,1,1,157739,157741,157742,2,3,0
45126,6,2,157745,157745,157747,0,2,3
45127,1,2,157746,157747,157749,1,3,0
45128,3,1,157749,157749,157750,0,1,0
45129,6,2,157755,157755,157757,0,2,5
45130,6,2,157761,157761,157763,0,2,4
45131,4,3,157765,157765,157768,0,3,2
45132,1,1,157766,157768,157769,2,3,0
45133,2,3,157768,157769,157772,1,4,0
45134,1,1,157769,157772,157773,3,4,0
45135,6,3,157775,157775,157778,0,3,2
45136,5,2,157780,157780,157782,0,2,2
45137,2,2,157782,157782,157784,0,2,0
45138,1,2,157783,157784,157786,1,3,0
45139,3,3,157786,157786,157789,0,3,0
45140,5,3,157791,157791,157794,0,3,2
45141,5,1,157796,157796,157797,0,1,2
45142,3,3,157799,157799,157802,0,3,2
45143,2,1,157801,157802,157803,1,2,0
45144,2,3,157803,157803,157806,0,3,0
45145,2,3,157805,157806,157809,1,4,0
45146,5,1,157810,157810,157811,0,1,1
45147,4,3,157814,157814,157817,0,3,3
45148,4,2,157818,157818,157820,0,2,1
45149,2,3,157820,157820,157823,0,3,0
45150,6,3,157826,157826,157829,0,3,3
45151,1,2,157827,157829,157831,2,4,0
45152,2,2,157829,157831,157833,2,4,0
45153,4,2,157833,157833,157835,0,2,0
45154,4,2,157837,157837,157839,0,2,2
45155,6,1,157843,157843,157844,0,1,4
45156,6,1,157849,157849,157850,0,1,5
45157,4,2,157853,157853,157855,0,2,3
45158,1,3,157854,157855,157858,1,4,0
45159,3,3,157857,157858,157861,1,4,0
45160,6,2,157863,157863,157865,0,2,2
45161,4,2,157867,157867,157869,0,2,2
45162,1,2,157868,157869,157871,1,3,0
45163,2,1,157870,157871,157872,1,2,0
45164,5,1,157875,157875,157876,0,1,3
45165,5,2,157880,157880,157882,0,2,4
45166,3,1,157883,157883,157884,0,1,1
45167,3,2,157886,157886,157888,0,2,2
45168,3,1,157889,157889,157890,0,1,1
45169,6,2,157895,157895,157897,0,2,5
45170,5,1,157900,157900,157901,0,1,3
45171,3,3,157903,157903,157906,0,3,2
45172,2,3,157905,157906,157909,1,4,0
45173,6,3,157911,157911,157914,0,3,2
45174,4,1,157915,157915,157916,0,1,1
45175,6,2,157921,157921,157923,0,2,5
45176,4,1,157925,157925,157926,0,1,2
45177,4,3,157929,157929,157932,0,3,3
45178,1,3,157930,157932,157935,2,5,0
45179,3,2,157933,157935,157937,2,4,0
45180,3,3,157936,157937,157940,1,4,0
45181,5,1,157941,157941,157942,0,1,1
45182,2,2,157943,157943,157945,0,2,1
45183,1,2,157944,157945,157947,1,3,0
45184,1,3,157945,157947,157950,2,5,0
45185,3,3,157948,157950,157953,2,5,0
45186,5,1,157953,157953,157954,0,1,0
45187,2,3,157955,157955,157958,0,3,1
45188,6,1,157961,157961,157962,0,1,3
45189,3,2,157964,157964,157966,0,2,2
45190,5,3,157969,157969,157972,0,3,3
45191,1,1,157970,157972,157973,2,3,0
45192,1,1,157971,157973,157974,2,3,0
45193,5,2,157976,157976,157978,0,2,2
45194,4,1,157980,157980,157981,0,1,2
45195,3,3,157983,157983,157986,0,3,2
45196,6,1,157989,157989,157990,0,1,3
45197,2,1,157991,157991,157992,0,1,1
45198,2,3,157993,157993,157996,0,3,1
45199,5,3,157998,157998,158001,0,3,2
45200,6,2,158004,158004,158006,0,2,3
45201,2,1,158006,158006,158007,0,1,0
45202,5,2,158011,158011,158013,0,2,4
45203,3,3,158014,158014,158017,0,3,1
45204,1,3,158015,158017,158020,2,5,0
45205,3,3,158018,158020,158023,2,5,0
45206,3,3,158021,158023,158026,2,5,0
45207,4,3,158025,158026,158029,1,4,0
45208,5,2,158030,158030,158032,0,2,1
45209,1,2,158031,158032,158034,1,3,0
45210,3,3,158034,158034,158037,0,3,0
45211,3,2,158037,158037,158039,0,2,0
45212,2,3,158039,158039,158042,0,3,0
45213,3,2,158042,158042,158044,0,2,0
45214,3,3,158045,158045,158048,0,3,1
45215,6,2,158051,158051,158053,0,2,3
45216,5,3,158056,158056,158059,0,3,3
45217,6,3,158062,158062,158065,0,3,3
45218,3,1,158065,158065,158066,0,1,0
45219,2,1,158067,158067,158068,0,1,1
45220,5,2,158072,158072,158074,0,2,4
45221,3,1,158075,158075,158076,0,1,1
45222,4,1,158079,158079,158080,0,1,3
45223,6,3,158085,158085,158088,0,3,5
45224,3,2,158088,158088,158090,0,2,0
45225,4,3,158092,158092,158095,0,3,2
45226,3,2,158095,158095,158097,0,2,0
45227,3,1,158098,158098,158099,0,1,1
45228,4,3,158102,158102,158105,0,3,3
45229,5,3,158107,158107,158110,0,3,2
45230,6,1,158113,158113,158114,0,1,3
45231,2,2,158115,158115,158117,0,2,1
45232,1,2,158116,158117,158119,1,3,0
45233,5,2,158121,158121,158123,0,2,2
45234,4,1,158125,158125,158126,0,1,2
45235,6,2,158131,158131,158133,0,2,5
45236,3,1,158134,158134,158135,0,1,1
45237,3,1,158137,158137,158138,0,1,2
45238,2,2,158139,158139,158141,0,2,1
45239,5,2,158144,158144,158146,0,2,3
45240,3,3,158147,158147,158150,0,3,1
45241,4,2,158151,158151,158153,0,2,1
45242,1,2,158152,158153,158155,1,3,0
45243,5,1,158157,158157,158158,0,1,2
45244,1,1,158158,158158,158159,0,1,0
45245,2,2,158160,158160,158162,0,2,1
45246,5,2,158165,158165,158167,0,2,3
45247,1,1,158166,158167,158168,1,2,0
45248,2,3,158168,158168,158171,0,3,0
45249,3,2,158171,158171,158173,0,2,0
45250,1,2,158172,158173,158175,1,3,0
45251,2,1,158174,158175,158176,1,2,0
45252,6,3,158180,158180,158183,0,3,4
45253,3,2,158183,158183,158185,0,2,0
45254,6,1,158189,158189,158190,0,1,4
45255,1,3,158190,158190,158193,0,3,0
45256,5,1,158195,158195,158196,0,1,2
45257,6,2,158201,158201,158203,0,2,5
45258,4,2,158205,158205,158207,0,2,2
45259,5,3,158210,158210,158213,0,3,3
45260,4,1,158214,158214,158215,0,1,1
45261,5,3,158219,158219,158222,0,3,4
45262,2,2,158221,158222,158224,1,3,0
45263,6,3,158227,158227,158230,0,3,3
45264,3,3,158230,158230,158233,0,3,0
45265,4,2,158234,158234,158236,0,2,1
45266,1,3,158235,158236,158239,1,4,0
45267,6,2,158241,158241,158243,0,2,2
45268,5,3,158246,158246,158249,0,3,3
45269,4,3,158250,158250,158253,0,3,1
45270,4,2,158254,158254,158256,0,2,1
45271,1,2,158255,158256,158258,1,3,0
45272,2,2,158257,158258,158260,1,3,0
45273,4,2,158261,158261,158263,0,2,1
45274,3,1,158264,158264,158265,0,1,1
45275,4,1,158268,158268,158269,0,1,3
45276,6,1,158274,158274,158275,0,1,5
45277,5,3,158279,158279,158282,0,3,4
45278,4,2,158283,158283,158285,0,2,1
45279,6,3,158289,158289,158292,0,3,4
45280,6,1,158295,158295,158296,0,1,3
45281,1,3,158296,158296,158299,0,3,0
45282,1,3,158297,158299,158302,2,5,0
45283,2,2,158299,158302,158304,3,5,0
45284,5,2,158304,158304,158306,0,2,0
45285,1,1,158305,158306,158307,1,2,0
45286,2,3,158307,158307,158310,0,3,0
45287,4,3,158311,158311,158314,0,3,1
45288,1,2,158312,158314,158316,2,4,0
45289,1,3,158313,158316,158319,3,6,0
45290,4,1,158317,158319,158320,2,3,0
45291,3,1,158320,158320,158321,0,1,0
45292,4,1,158324,158324,158325,0,1,3
45293,3,1,158327,158327,158328,0,1,2
45294,4,1,158331,158331,158332,0,1,3
45295,3,3,158334,158334,158337,0,3,2
45296,1,1,158335,158337,158338,2,3,0
45297,4,1,158339,158339,158340,0,1,1
45298,1,2,158340,158340,158342,0,2,0
45299,4,2,158344,158344,158346,0,2,2
45300,1,2,158345,158346,158348,1,3,0
45301,3,1,158348,158348,158349,0,1,0
45302,3,3,158351,158351,158354,0,3,2
45303,1,2,158352,158354,158356,2,4,0
45304,2,2,158354,158356,158358,2,4,0
45305,6,3,158360,158360,158363,0,3,2
45306,5,2,158365,158365,158367,0,2,2
45307,5,1,158370,158370,158371,0,1,3
45308,6,3,158376,158376,158379,0,3,5
45309,1,1,158377,158379,158380,2,3,0
45310,6,2,158383,158383,158385,0,2,3
45311,5,3,158388,158388,158391,0,3,3
45312,5,3,158393,158393,158396,0,3,2
45313,4,2,158397,158397,158399,0,2,1
45314,5,1,158402,158402,158403,0,1,3
45315,4,2,158406,158406,158408,0,2,3
45316,1,2,158407,158408,158410,1,3,0
45317,1,3,158408,158410,158413,2,5,0
45318,2,3,158410,158413,158416,3,6,0
45319,1,1,158411,158416,158417,5,6,0
45320,5,1,158416,158417,158418,1,2,0
45321,1,3,158417,158418,158421,1,4,0
45322,3,2,158420,158421,158423,1,3,0
45323,6,2,158426,158426,158428,0,2,3
45324,2,3,158428,158428,158431,0,3,0
45325,5,3,158433,158433,158436,0,3,2
45326,2,2,158435,158436,158438,1,3,0
45327,4,3,158439,158439,158442,0,3,1
45328,2,3,158441,158442,158445,1,4,0
45329,5,1,158446,158446,158447,0,1,1
45330,5,3,158451,158451,158454,0,3,4
45331,3,1,158454,158454,158455,0,1,0
45332,1,3,158455,158455,158458,0,3,0
45333,6,2,158461,158461,158463,0,2,3
45334,1,2,158462,158463,158465,1,3,0
45335,2,2,158464,158465,158467,1,3,0
45336,2,2,158466,158467,158469,1,3,0
45337,1,3,158467,158469,158472,2,5,0
45338,2,1,158469,158472,158473,3,4,0
45339,6,1,158475,158475,158476,0,1,2
45340,4,1,158479,158479,158480,0,1,3
45341,1,2,158480,158480,158482,0,2,0
45342,2,3,158482,158482,158485,0,3,0
45343,3,1,158485,158485,158486,0,1,0
45344,2,2,158487,158487,158489,0,2,1
45345,3,1,158490,158490,158491,0,1,1
45346,2,1,158492,158492,158493,0,1,1
45347,5,2,158497,158497,158499,0,2,4
45348,5,1,158502,158502,158503,0,1,3
45349,2,3,158504,158504,158507,0,3,1
45350,2,3,158506,158507,158510,1,4,0
45351,1,1,158507,158510,158511,3,4,0
45352,2,1,158509,158511,158512,2,3,0
45353,5,3,158514,158514,158517,0,3,2
45354,5,3,158519,158519,158522,0,3,2
45355,3,3,158522,158522,158525,0,3,0
45356,1,2,158523,158525,158527,2,4,0
45357,5,2,158528,158528,158530,0,2,1
45358,5,3,158533,158533,158536,0,3,3
45359,3,3,158536,158536,158539,0,3,0
45360,4,1,158540,158540,158541,0,1,1
45361,5,3,158545,158545,158548,0,3,4
45362,6,2,158551,158551,158553,0,2,3
45363,6,3,158557,158557,158560,0,3,4
45364,1,2,158558,158560,158562,2,4,0
45365,6,3,158564,158564,158567,0,3,2
45366,4,1,158568,158568,158569,0,1,1
45367,3,1,158571,158571,158572,0,1,2
45368,5,3,158576,158576,158579,0,3,4
45369,3,3,158579,158579,158582,0,3,0
45370,5,2,158584,158584,158586,0,2,2
45371,1,3,158585,158586,158589,1,4,0
45372,1,1,158586,158589,158590,3,4,0
45373,5,3,158591,158591,158594,0,3,1
45374,5,3,158596,158596,158599,0,3,2
45375,1,1,158597,158599,158600,2,3,0
45376,3,2,158600,158600,158602,0,2,0
45377,4,1,158604,158604,158605,0,1,2
45378,4,2,158608,158608,158610,0,2,3
45379,2,2,158610,158610,158612,0,2,0
45380,2,3,158612,158612,158615,0,3,0
45381,1,2,158613,158615,158617,2,4,0
45382,6,1,158619,158619,158620,0,1,2
45383,2,1,158621,158621,158622,0,1,1
45384,4,3,158625,158625,158628,0,3,3
45385,6,3,158631,158631,158634,0,3,3
45386,5,1,158636,158636,158637,0,1,2
45387,4,2,158640,158640,158642,0,2,3
45388,3,2,158643,158643,158645,0,2,1
45389,6,3,158649,158649,158652,0,3,4
45390,5,3,158654,158654,158657,0,3,2
45391,2,1,158656,158657,158658,1,2,0
45392,3,1,158659,158659,158660,0,1,1
45393,1,1,158660,158660,158661,0,1,0
45394,6,2,158666,158666,158668,0,2,5
45395,6,2,158672,158672,158674,0,2,4
45396,1,3,158673,158674,158677,1,4,0
45397,5,1,158678,158678,158679,0,1,1
45398,4,3,158682,158682,158685,0,3,3
45399,6,1,158688,158688,158689,0,1,3
45400,2,3,158690,158690,158693,0,3,1
45401,5,3,158695,158695,158698,0,3,2
45402,4,1,158699,158699,158700,0,1,1
45403,2,1,158701,158701,158702,0,1,1
45404,3,2,158704,158704,158706,0,2,2
45405,1,3,158705,158706,158709,1,4,0
45406,5,2,158710,158710,158712,0,2,1
45407,2,2,158712,158712,158714,0,2,0
45408,4,2,158716,158716,158718,0,2,2
45409,1,1,158717,158718,158719,1,2,0
45410,2,2,158719,158719,158721,0,2,0
45411,3,2,158722,158722,158724,0,2,1
45412,2,2,158724,158724,158726,0,2,0
45413,2,1,158726,158726,158727,0,1,0
45414,2,1,158728,158728,158729,0,1,1
45415,1,3,158729,158729,158732,0,3,0
45416,2,3,158731,158732,158735,1,4,0
45417,4,3,158735,158735,158738,0,3,0
45418,3,1,158738,158738,158739,0,1,0
45419,5,1,158743,158743,158744,0,1,4
45420,1,1,158744,158744,158745,0,1,0
45421,2,1,158746,158746,158747,0,1,1
45422,1,1,158747,158747,158748,0,1,0
45423,4,1,158751,158751,158752,0,1,3
45424,3,1,158754,158754,158755,0,1,2
45425,6,2,158760,158760,158762,0,2,5
45426,4,2,158764,158764,158766,0,2,2
45427,4,3,158768,158768,158771,0,3,2
45428,2,2,158770,158771,158773,1,3,0
45429,6,3,158776,158776,158779,0,3,3
45430,2,1,158778,158779,158780,1,2,0
45431,5,3,158783,158783,158786,0,3,3
45432,1,1,158784,158786,158787,2,3,0
45433,4,2,158788,158788,158790,0,2,1
45434,6,3,158794,158794,158797,0,3,4
45435,2,3,158796,158797,158800,1,4,0
45436,1,1,158797,158800,158801,3,4,0
45437,1,3,158798,158801,158804,3,6,0
45438,2,2,158800,158804,158806,4,6,0
45439,6,2,158806,158806,158808,0,2,0
45440,6,2,158812,158812,158814,0,2,4
45441,4,1,158816,158816,158817,0,1,2
45442,5,3,158821,158821,158824,0,3,4
45443,6,3,158827,158827,158830,0,3,3
45444,5,1,158832,158832,158833,0,1,2
45445,1,1,158833,158833,158834,0,1,0
45446,1,3,158834,158834,158837,0,3,0
45447,3,1,158837,158837,158838,0,1,0
45448,3,1,158840,158840,158841,0,1,2
45449,1,2,158841,158841,158843,0,2,0
45450,6,2,158847,158847,158849,0,2,4
45451,3,2,158850,158850,158852,0,2,1
45452,6,1,158856,158856,158857,0,1,4
45453,6,1,158862,158862,158863,0,1,5
45454,6,2,158868,158868,158870,0,2,5
45455,3,2,158871,158871,158873,0,2,1
45456,3,1,158874,158874,158875,0,1,1
45457,3,3,158877,158877,158880,0,3,2
45458,1,3,158878,158880,158883,2,5,0
45459,1,2,158879,158883,158885,4,6,0
45460,6,1,158885,158885,158886,0,1,0
45461,1,3,158886,158886,158889,0,3,0
45462,6,3,158892,158892,158895,0,3,3
45463,5,2,158897,158897,158899,0,2,2
45464,1,2,158898,158899,158901,1,3,0
45465,5,2,158903,158903,158905,0,2,2
45466,1,3,158904,158905,158908,1,4,0
45467,1,2,158905,158908,158910,3,5,0
45468,5,1,158910,158910,158911,0,1,0
45469,1,3,158911,158911,158914,0,3,0
45470,3,1,158914,158914,158915,0,1,0
45471,1,2,158915,158915,158917,0,2,0
45472,2,1,158917,158917,158918,0,1,0
45473,6,3,158923,158923,158926,0,3,5
45474,6,3,158929,158929,158932,0,3,3
45475,6,1,158935,158935,158936,0,1,3
45476,2,2,158937,158937,158939,0,2,1
45477,1,3,158938,158939,158942,1,4,0
45478,6,1,158944,158944,158945,0,1,2
45479,6,3,158950,158950,158953,0,3,5
45480,4,3,158954,158954,158957,0,3,1
45481,3,1,158957,158957,158958,0,1,0
45482,1,3,158958,158958,158961,0,3,0
45483,4,2,158962,158962,158964,0,2,1
45484,2,1,158964,158964,158965,0,1,0
45485,2,2,158966,158966,158968,0,2,1
45486,5,1,158971,158971,158972,0,1,3
45487,4,3,158975,158975,158978,0,3,3
45488,2,2,158977,158978,158980,1,3,0
45489,6,2,158983,158983,158985,0,2,3
45490,5,3,158988,158988,158991,0,3,3
45491,3,1,158991,158991,158992,0,1,0
45492,4,1,158995,158995,158996,0,1,3
45493,1,3,158996,158996,158999,0,3,0
45494,6,3,159002,159002,159005,0,3,3
45495,2,2,159004,159005,159007,1,3,0
45496,6,1,159010,159010,159011,0,1,3
45497,1,3,159011,159011,159014,0,3,0
45498,5,1,159016,159016,159017,0,1,2
45499,3,3,159019,159019,159022,0,3,2
45500,2,3,159021,159022,159025,1,4,0
45501,4,1,159025,159025,159026,0,1,0
45502,5,1,159030,159030,159031,0,1,4
45503,4,2,159034,159034,159036,0,2,3
45504,2,2,159036,159036,159038,0,2,0
45505,3,1,159039,159039,159040,0,1,1
45506,5,3,159044,159044,159047,0,3,4
45507,6,3,159050,159050,159053,0,3,3
45508,3,1,159053,159053,159054,0,1,0
45509,4,2,159057,159057,159059,0,2,3
45510,6,1,159063,159063,159064,0,1,4
45511,5,3,159068,159068,159071,0,3,4
45512,4,2,159072,159072,159074,0,2,1
45513,1,3,159073,159074,159077,1,4,0
45514,4,1,159077,159077,159078,0,1,0
45515,1,1,159078,159078,159079,0,1,0
45516,5,1,159083,159083,159084,0,1,4
45517,4,1,159087,159087,159088,0,1,3
45518,3,1,159090,159090,159091,0,1,2
45519,1,3,159091,159091,159094,0,3,0
45520,2,2,159093,159094,159096,1,3,0
45521,5,1,159098,159098,159099,0,1,2
45522,4,1,159102,159102,159103,0,1,3
45523,5,1,159107,159107,159108,0,1,4
45524,5,2,159112,159112,159114,0,2,4
45525,2,2,159114,159114,159116,0,2,0
45526,5,1,159119,159119,159120,0,1,3
45527,1,3,159120,159120,159123,0,3,0
45528,3,3,159123,159123,159126,0,3,0
45529,5,1,159128,159128,159129,0,1,2
45530,6,2,159134,159134,159136,0,2,5
45531,3,1,159137,159137,159138,0,1,1
45532,5,2,159142,159142,159144,0,2,4
45533,6,3,159148,159148,159151,0,3,4
45534,2,3,159150,159151,159154,1,4,0
45535,5,1,159155,159155,159156,0,1,1
45536,6,3,159161,159161,159164,0,3,5
45537,5,2,159166,159166,159168,0,2,2
45538,4,1,159170,159170,159171,0,1,2
45539,4,2,159174,159174,159176,0,2,3
45540,6,1,159180,159180,159181,0,1,4
45541,2,2,159182,159182,159184,0,2,1
45542,2,2,159184,159184,159186,0,2,0
45543,4,1,159188,159188,159189,0,1,2
45544,2,2,159190,159190,159192,0,2,1
45545,1,3,159191,159192,159195,1,4,0
45546,3,1,159194,159195,159196,1,2,0
45547,3,3,159197,159197,159200,0,3,1
45548,1,3,159198,159200,159203,2,5,0
45549,4,3,159202,159203,159206,1,4,0
45550,5,3,159207,159207,159210,0,3,1
45551,3,1,159210,159210,159211,0,1,0
45552,4,2,159214,159214,159216,0,2,3
45553,6,2,159220,159220,159222,0,2,4
45554,5,2,159225,159225,159227,0,2,3
45555,6,2,159231,159231,159233,0,2,4
45556,4,3,159235,159235,159238,0,3,2
45557,4,1,159239,159239,159240,0,1,1
45558,3,3,159242,159242,159245,0,3,2
45559,2,3,159244,159245,159248,1,4,0
45560,2,1,159246,159248,159249,2,3,0
45561,5,3,159251,159251,159254,0,3,2
45562,1,1,159252,159254,159255,2,3,0
45563,5,1,159257,159257,159258,0,1,2
45564,6,3,159263,159263,159266,0,3,5
45565,5,1,159268,159268,159269,0,1,2
45566,6,3,159274,159274,159277,0,3,5
45567,5,3,159279,159279,159282,0,3,2
45568,2,3,159281,159282,159285,1,4,0
45569,5,3,159286,159286,159289,0,3,1
45570,1,3,159287,159289,159292,2,5,0
45571,3,2,159290,159292,159294,2,4,0
45572,1,3,159291,159294,159297,3,6,0
45573,6,3,159297,159297,159300,0,3,0
45574,1,1,159298,159300,159301,2,3,0
45575,2,3,159300,159301,159304,1,4,0
45576,5,2,159305,159305,159307,0,2,1
45577,3,1,159308,159308,159309,0,1,1
45578,3,1,159311,159311,159312,0,1,2
45579,6,3,159317,159317,159320,0,3,5
45580,5,3,159322,159322,159325,0,3,2
45581,4,1,159326,159326,159327,0,1,1
45582,3,1,159329,159329,159330,0,1,2
45583,1,2,159330,159330,159332,0,2,0
45584,5,2,159335,159335,159337,0,2,3
45585,5,3,159340,159340,159343,0,3,3
45586,3,3,159343,159343,159346,0,3,0
45587,6,2,159349,159349,159351,0,2,3
45588,3,3,159352,159352,159355,0,3,1
45589,2,3,159354,159355,159358,1,4,0
45590,4,1,159358,159358,159359,0,1,0
45591,5,2,159363,159363,159365,0,2,4
45592,2,3,159365,159365,159368,0,3,0
45593,1,2,159366,159368,159370,2,4,0
45594,2,2,159368,159370,159372,2,4,0
45595,5,3,159373,159373,159376,0,3,1
45596,6,2,159379,159379,159381,0,2,3
45597,3,1,159382,159382,159383,0,1,1
45598,1,2,159383,159383,159385,0,2,0
45599,6,2,159389,159389,159391,0,2,4
45600,6,3,159395,159395,159398,0,3,4
45601,4,2,159399,159399,159401,0,2,1
45602,4,3,159403,159403,159406,0,3,2
45603,1,2,159404,159406,159408,2,4,0
45604,3,2,159407,159408,159410,1,3,0
45605,6,2,159413,159413,159415,0,2,3
45606,4,1,159417,159417,159418,0,1,2
45607,2,1,159419,159419,159420,0,1,1
45608,1,2,159420,159420,159422,0,2,0
45609,6,1,159426,159426,159427,0,1,4
45610,2,2,159428,159428,159430,0,2,1
45611,3,1,159431,159431,159432,0,1,1
45612,3,2,159434,159434,159436,0,2,2
45613,6,2,159440,159440,159442,0,2,4
45614,4,3,159444,159444,159447,0,3,2
45615,5,3,159449,159449,159452,0,3,2
45616,5,3,159454,159454,159457,0,3,2
45617,5,3,159459,159459,159462,0,3,2
45618,1,2,159460,159462,159464,2,4,0
45619,6,1,159466,159466,159467,0,1,2
45620,5,1,159471,159471,159472,0,1,4
45621,1,2,159472,159472,159474,0,2,0
45622,3,2,159475,159475,159477,0,2,1
45623,5,3,159480,159480,159483,0,3,3
45624,3,3,159483,159483,159486,0,3,0
45625,3,3,159486,159486,159489,0,3,0
45626,5,2,159491,159491,159493,0,2,2
45627,3,2,159494,159494,159496,0,2,1
45628,5,2,159499,159499,159501,0,2,3
45629,3,3,159502,159502,159505,0,3,1
45630,2,3,159504,159505,159508,1,4,0
45631,1,3,159505,159508,159511,3,6,0
45632,2,3,159507,159511,159514,4,7,0
45633,2,3,159509,159514,159517,5,8,0
45634,1,2,159510,159517,159519,7,9,0
45635,3,3,159513,159519,159522,6,9,0
45636,1,1,159514,159522,159523,8,9,0
45637,1,3,159515,159523,159526,8,11,0
45638,4,1,159519,159526,159527,7,8,0
45639,4,2,159523,159527,159529,4,6,0
45640,2,3,159525,159529,159532,4,7,0
45641,3,3,159528,159532,159535,4,7,0
45642,6,1,159534,159535,159536,1,2,0
45643,4,3,159538,159538,159541,0,3,2
45644,4,1,159542,159542,159543,0,1,1
45645,6,3,159548,159548,159551,0,3,5
45646,4,2,159552,159552,159554,0,2,1
45647,2,1,159554,159554,159555,0,1,0
45648,6,2,159560,159560,159562,0,2,5
45649,6,2,159566,159566,159568,0,2,4
45650,6,3,159572,159572,159575,0,3,4
45651,4,2,159576,159576,159578,0,2,1
45652,1,1,159577,159578,159579,1,2,0
45653,5,3,159582,159582,159585,0,3,3
45654,6,1,159588,159588,159589,0,1,3
45655,4,1,159592,159592,159593,0,1,3
45656,1,1,159593,159593,159594,0,1,0
45657,6,3,159599,159599,159602,0,3,5
45658,3,2,159602,159602,159604,0,2,0
45659,3,2,159605,159605,159607,0,2,1
45660,1,2,159606,159607,159609,1,3,0
45661,2,3,159608,159609,159612,1,4,0
45662,2,3,159610,159612,159615,2,5,0
45663,5,3,159615,159615,159618,0,3,0
45664,6,1,159621,159621,159622,0,1,3
45665,3,1,159624,159624,159625,0,1,2
45666,5,3,159629,159629,159632,0,3,4
45667,3,1,159632,159632,159633,0,1,0
45668,5,1,159637,159637,159638,0,1,4
45669,2,2,159639,159639,159641,0,2,1
45670,1,3,159640,159641,159644,1,4,0
45671,6,3,159646,159646,159649,0,3,2
45672,5,3,159651,159651,159654,0,3,2
45673,2,2,159653,159654,159656,1,3,0
45674,3,3,159656,159656,159659,0,3,0
45675,5,3,159661,159661,159664,0,3,2
45676,6,1,159667,159667,159668,0,1,3
45677,1,1,159668,159668,159669,0,1,0
45678,6,2,159674,159674,159676,0,2,5
45679,6,3,159680,159680,159683,0,3,4
45680,1,1,159681,159683,159684,2,3,0
45681,5,3,159686,159686,159689,0,3,2
45682,1,1,159687,159689,159690,2,3,0
45683,1,1,159688,159690,159691,2,3,0
45684,5,3,159693,159693,159696,0,3,2
45685,1,3,159694,159696,159699,2,5,0
45686,1,1,159695,159699,159700,4,5,0
45687,4,2,159699,159700,159702,1,3,0
45688,6,1,159705,159705,159706,0,1,3
45689,3,2,159708,159708,159710,0,2,2
45690,5,3,159713,159713,159716,0,3,3
45691,2,1,159715,159716,159717,1,2,0
45692,6,2,159721,159721,159723,0,2,4
45693,3,3,159724,159724,159727,0,3,1
45694,2,2,159726,159727,159729,1,3,0
45695,2,1,159728,159729,159730,1,2,0
45696,5,1,159733,159733,159734,0,1,3
45697,1,3,159734,159734,159737,0,3,0
45698,1,3,159735,159737,159740,2,5,0
45699,6,1,159741,159741,159742,0,1,1
45700,2,2,159743,159743,159745,0,2,1
45701,3,2,159746,159746,159748,0,2,1
45702,1,2,159747,159748,159750,1,3,0
45703,5,1,159752,159752,159753,0,1,2
45704,3,3,159755,159755,159758,0,3,2
45705,4,1,159759,159759,159760,0,1,1
45706,1,1,159760,159760,159761,0,1,0
45707,1,2,159761,159761,159763,0,2,0
45708,5,2,159766,159766,159768,0,2,3
45709,3,3,159769,159769,159772,0,3,1
45710,4,1,159773,159773,159774,0,1,1
45711,1,2,159774,159774,159776,0,2,0
45712,4,1,159778,159778,159779,0,1,2
45713,3,2,159781,159781,159783,0,2,2
45714,2,1,159783,159783,159784,0,1,0
45715,4,2,159787,159787,159789,0,2,3
45716,5,3,159792,159792,159795,0,3,3
45717,5,2,159797,159797,159799,0,2,2
45718,2,1,159799,159799,159800,0,1,0
45719,2,3,159801,159801,159804,0,3,1
45720,2,3,159803,159804,159807,1,4,0
45721,2,1,159805,159807,159808,2,3,0
45722,1,2,159806,159808,159810,2,4,0
45723,1,2,159807,159810,159812,3,5,0
45724,4,2,159811,159812,159814,1,3,0
45725,1,2,159812,159814,159816,2,4,0
45726,5,3,159817,159817,159820,0,3,1
45727,4,2,159821,159821,159823,0,2,1
45728,4,3,159825,159825,159828,0,3,2
45729,6,1,159831,159831,159832,0,1,3
45730,6,2,159837,159837,159839,0,2,5
45731,3,2,159840,159840,159842,0,2,1
45732,3,1,159843,159843,159844,0,1,1
45733,5,2,159848,159848,159850,0,2,4
45734,4,1,159852,159852,159853,0,1,2
45735,3,1,159855,159855,159856,0,1,2
45736,2,1,159857,159857,159858,0,1,1
45737,2,3,159859,159859,159862,0,3,1
45738,4,1,159863,159863,159864,0,1,1
45739,4,3,159867,159867,159870,0,3,3
45740,6,1,159873,159873,159874,0,1,3
45741,1,1,159874,159874,159875,0,1,0
45742,4,1,159878,159878,159879,0,1,3
45743,5,1,159883,159883,159884,0,1,4
45744,5,1,159888,159888,159889,0,1,4
45745,6,1,159894,159894,159895,0,1,5
45746,6,2,159900,159900,159902,0,2,5
45747,4,2,159904,159904,159906,0,2,2
45748,4,2,159908,159908,159910,0,2,2
45749,2,1,159910,159910,159911,0,1,0
45750,2,1,159912,159912,159913,0,1,1
45751,6,3,159918,159918,159921,0,3,5
45752,1,1,159919,159921,159922,2,3,0
45753,5,1,159924,159924,159925,0,1,2
45754,3,2,159927,159927,159929,0,2,2
45755,4,2,159931,159931,159933,0,2,2
45756,2,3,159933,159933,159936,0,3,0
45757,6,2,159939,159939,159941,0,2,3
45758,5,3,159944,159944,159947,0,3,3
45759,6,2,159950,159950,159952,0,2,3
45760,4,3,159954,159954,159957,0,3,2
45761,5,3,159959,159959,159962,0,3,2
45762,4,1,159963,159963,159964,0,1,1
45763,2,1,159965,159965,159966,0,1,1
45764,2,3,159967,159967,159970,0,3,1
45765,3,3,159970,159970,159973,0,3,0
45766,1,1,159971,159973,159974,2,3,0
45767,6,2,159977,159977,159979,0,2,3
45768,1,1,159978,159979,159980,1,2,0
45769,5,3,159983,159983,159986,0,3,3
45770,4,1,159987,159987,159988,0,1,1
45771,6,2,159993,159993,159995,0,2,5
45772,2,1,159995,159995,159996,0,1,0
45773,5,3,160000,160000,160003,0,3,4
45774,3,3,160003,160003,160006,0,3,0
45775,2,2,160005,160006,160008,1,3,0
45776,2,1,160007,160008,160009,1,2,0
45777,6,1,160013,160013,160014,0,1,4
45778,4,2,160017,160017,160019,0,2,3
45779,3,2,160020,160020,160022,0,2,1
45780,6,1,160026,160026,160027,0,1,4
45781,3,1,160029,160029,160030,0,1,2
45782,1,3,160030,160030,160033,0,3,0
45783,1,1,160031,160033,160034,2,3,0
45784,4,2,160035,160035,160037,0,2,1
45785,6,3,160041,160041,160044,0,3,4
45786,2,1,160043,160044,160045,1,2,0
45787,2,2,160045,160045,160047,0,2,0
45788,2,1,160047,160047,160048,0,1,0
45789,3,1,160050,160050,160051,0,1,2
45790,3,3,160053,160053,160056,0,3,2
45791,6,1,160059,160059,160060,0,1,3
45792,1,1,160060,160060,160061,0,1,0
45793,1,1,160061,160061,160062,0,1,0
45794,1,1,160062,160062,160063,0,1,0
45795,5,2,160067,160067,160069,0,2,4
45796,4,3,160071,160071,160074,0,3,2
45797,1,3,160072,160074,160077,2,5,0
45798,6,2,160078,160078,160080,0,2,1
45799,4,2,160082,160082,160084,0,2,2
45800,4,2,160086,160086,160088,0,2,2
45801,3,2,160089,160089,160091,0,2,1
45802,5,3,160094,160094,160097,0,3,3
45803,5,2,160099,160099,160101,0,2,2
45804,4,1,160103,160103,160104,0,1,2
45805,2,1,160105,160105,160106,0,1,1
45806,5,3,160110,160110,160113,0,3,4
45807,6,1,160116,160116,160117,0,1,3
45808,3,2,160119,160119,160121,0,2,2
45809,3,1,160122,160122,160123,0,1,1
45810,1,1,160123,160123,160124,0,1,0
45811,4,3,160127,160127,160130,0,3,3
45812,5,3,160132,160132,160135,0,3,2
45813,2,3,160134,160135,160138,1,4,0
45814,4,3,160138,160138,160141,0,3,0
45815,5,2,160143,160143,160145,0,2,2
45816,2,3,160145,160145,160148,0,3,0
45817,3,2,160148,160148,160150,0,2,0
45818,4,2,160152,160152,160154,0,2,2
45819,1,1,160153,160154,160155,1,2,0
45820,6,3,160159,160159,160162,0,3,4
45821,3,3,160162,160162,160165,0,3,0
45822,3,1,160165,160165,160166,0,1,0
45823,2,1,160167,160167,160168,0,1,1
45824,4,1,160171,160171,160172,0,1,3
45825,2,2,160173,160173,160175,0,2,1
45826,5,2,160178,160178,160180,0,2,3
45827,4,1,160182,160182,160183,0,1,2
45828,5,2,160187,160187,160189,0,2,4
45829,2,3,160189,160189,160192,0,3,0
45830,4,1,160193,160193,160194,0,1,1
45831,2,2,160195,160195,160197,0,2,1
45832,1,2,160196,160197,160199,1,3,0
45833,2,3,160198,160199,160202,1,4,0
45834,4,1,160202,160202,160203,0,1,0
45835,6,1,160208,160208,160209,0,1,5
45836,2,3,160210,160210,160213,0,3,1
45837,2,2,160212,160213,160215,1,3,0
45838,4,1,160216,160216,160217,0,1,1
45839,3,3,160219,160219,160222,0,3,2
45840,4,3,160223,160223,160226,0,3,1
45841,1,2,160224,160226,160228,2,4,0
45842,3,2,160227,160228,160230,1,3,0
45843,2,3,160229,160230,160233,1,4,0
45844,3,2,160232,160233,160235,1,3,0
45845,5,3,160237,160237,160240,0,3,2
45846,4,1,160241,160241,160242,0,1,1
45847,3,1,160244,160244,160245,0,1,2
45848,1,1,160245,160245,160246,0,1,0
45849,4,3,160249,160249,160252,0,3,3
45850,1,1,160250,160252,160253,2,3,0
45851,1,1,160251,160253,160254,2,3,0
45852,1,3,160252,160254,160257,2,5,0
45853,4,1,160256,160257,160258,1,2,0
45854,5,3,160261,160261,160264,0,3,3
45855,4,3,160265,160265,160268,0,3,1
45856,2,1,160267,160268,160269,1,2,0
45857,6,2,160273,160273,160275,0,2,4
45858,6,3,160279,160279,160282,0,3,4
45859,3,2,160282,160282,160284,0,2,0
45860,5,2,160287,160287,160289,0,2,3
45861,2,3,160289,160289,160292,0,3,0
45862,1,1,160290,160292,160293,2,3,0
45863,3,3,160293,160293,160296,0,3,0
45864,1,3,160294,160296,160299,2,5,0
45865,2,1,160296,160299,160300,3,4,0
45866,1,2,160297,160300,160302,3,5,0
45867,6,2,160303,160303,160305,0,2,1
45868,4,3,160307,160307,160310,0,3,2
45869,1,1,160308,160310,160311,2,3,0
45870,1,3,160309,160311,160314,2,5,0
45871,3,1,160312,160314,160315,2,3,0
45872,1,1,160313,160315,160316,2,3,0
45873,2,1,160315,160316,160317,1,2,0
45874,3,3,160318,160318,160321,0,3,1
45875,6,1,160324,160324,160325,0,1,3
45876,2,3,160326,160326,160329,0,3,1
45877,1,1,160327,160329,160330,2,3,0
45878,1,3,160328,160330,160333,2,5,0
45879,6,3,160334,160334,160337,0,3,1
45880,2,1,160336,160337,160338,1,2,0
45881,4,1,160340,160340,160341,0,1,2
45882,6,2,160346,160346,160348,0,2,5
45883,1,1,160347,160348,160349,1,2,0
45884,2,3,160349,160349,160352,0,3,0
45885,6,3,160355,160355,160358,0,3,3
45886,4,1,160359,160359,160360,0,1,1
45887,6,1,160365,160365,160366,0,1,5
45888,1,2,160366,160366,160368,0,2,0
45889,6,1,160372,160372,160373,0,1,4
45890,5,2,160377,160377,160379,0,2,4
45891,4,1,160381,160381,160382,0,1,2
45892,6,1,160387,160387,160388,0,1,5
45893,2,2,160389,160389,160391,0,2,1
45894,3,2,160392,160392,160394,0,2,1
45895,2,2,160394,160394,160396,0,2,0
45896,1,1,160395,160396,160397,1,2,0
45897,4,1,160399,160399,160400,0,1,2
45898,5,3,160404,160404,160407,0,3,4
45899,6,2,160410,160410,160412,0,2,3
45900,3,1,160413,160413,160414,0,1,1
45901,5,2,160418,160418,160420,0,2,4
45902,6,3,160424,160424,160427,0,3,4
45903,5,3,160429,160429,160432,0,3,2
45904,2,1,160431,160432,160433,1,2,0
45905,3,2,160434,160434,160436,0,2,1
45906,5,2,160439,160439,160441,0,2,3
45907,4,2,160443,160443,160445,0,2,2
45908,2,2,160445,160445,160447,0,2,0
45909,2,1,160447,160447,160448,0,1,0
45910,3,1,160450,160450,160451,0,1,2
45911,5,3,160455,160455,160458,0,3,4
45912,3,1,160458,160458,160459,0,1,0
45913,5,3,160463,160463,160466,0,3,4
45914,3,1,160466,160466,160467,0,1,0
45915,4,2,160470,160470,160472,0,2,3
45916,3,3,160473,160473,160476,0,3,1
45917,1,3,160474,160476,160479,2,5,0
45918,1,3,160475,160479,160482,4,7,0
45919,1,3,160476,160482,160485,6,9,0
45920,4,3,160480,160485,160488,5,8,0
45921,3,2,160483,160488,160490,5,7,0
45922,4,1,160487,160490,160491,3,4,0
45923,4,3,160491,160491,160494,0,3,0
45924,2,3,160493,160494,160497,1,4,0
45925,6,1,160499,160499,160500,0,1,2
45926,1,3,160500,160500,160503,0,3,0
45927,2,2,160502,160503,160505,1,3,0
45928,4,3,160506,160506,160509,0,3,1
45929,6,2,160512,160512,160514,0,2,3
45930,3,2,160515,160515,160517,0,2,1
45931,4,3,160519,160519,160522,0,3,2
45932,1,3,160520,160522,160525,2,5,0
45933,1,3,160521,160525,160528,4,7,0
45934,2,1,160523,160528,160529,5,6,0
45935,3,2,160526,160529,160531,3,5,0
45936,2,2,160528,160531,160533,3,5,0
45937,6,2,160534,160534,160536,0,2,1
45938,1,3,160535,160536,160539,1,4,0
45939,1,3,160536,160539,160542,3,6,0
45940,1,2,160537,160542,160544,5,7,0
45941,5,2,160542,160544,160546,2,4,0
45942,5,1,160547,160547,160548,0,1,1
45943,2,1,160549,160549,160550,0,1,1
45944,5,1,160554,160554,160555,0,1,4
45945,4,1,160558,160558,160559,0,1,3
45946,5,1,160563,160563,160564,0,1,4
45947,6,3,160569,160569,160572,0,3,5
45948,3,2,160572,160572,160574,0,2,0
45949,6,3,160578,160578,160581,0,3,4
45950,1,3,160579,160581,160584,2,5,0
45951,3,2,160582,160584,160586,2,4,0
45952,6,1,160588,160588,160589,0,1,2
45953,6,3,160594,160594,160597,0,3,5
45954,1,2,160595,160597,160599,2,4,0
45955,6,1,160601,160601,160602,0,1,2
45956,4,3,160605,160605,160608,0,3,3
45957,5,2,160610,160610,160612,0,2,2
45958,3,1,160613,160613,160614,0,1,1
45959,6,1,160619,160619,160620,0,1,5
45960,1,2,160620,160620,160622,0,2,0
45961,3,1,160623,160623,160624,0,1,1
45962,1,1,160624,160624,160625,0,1,0
45963,6,1,160630,160630,160631,0,1,5
45964,2,2,160632,160632,160634,0,2,1
45965,1,2,160633,160634,160636,1,3,0
45966,1,2,160634,160636,160638,2,4,0
45967,4,1,160638,160638,160639,0,1,0
45968,2,2,160640,160640,160642,0,2,1
45969,5,2,160645,160645,160647,0,2,3
45970,1,3,160646,160647,160650,1,4,0
45971,5,2,160651,160651,160653,0,2,1
45972,1,3,160652,160653,160656,1,4,0
45973,6,2,160658,160658,160660,0,2,2
45974,1,1,160659,160660,160661,1,2,0
45975,6,1,160665,160665,160666,0,1,4
45976,4,2,160669,160669,160671,0,2,3
45977,1,1,160670,160671,160672,1,2,0
45978,1,2,160671,160672,160674,1,3,0
45979,3,3,160674,160674,160677,0,3,0
45980,1,3,160675,160677,160680,2,5,0
45981,5,3,160680,160680,160683,0,3,0
45982,6,2,160686,160686,160688,0,2,3
45983,1,1,160687,160688,160689,1,2,0
45984,2,1,160689,160689,160690,0,1,0
45985,4,1,160693,160693,160694,0,1,3
45986,1,3,160694,160694,160697,0,3,0
45987,5,1,160699,160699,160700,0,1,2
45988,4,1,160703,160703,160704,0,1,3
45989,1,1,160704,160704,160705,0,1,0
45990,6,1,160710,160710,160711,0,1,5
45991,1,1,160711,160711,160712,0,1,0
45992,5,2,160716,160716,160718,0,2,4
45993,2,3,160718,160718,160721,0,3,0
45994,4,2,160722,160722,160724,0,2,1
45995,5,3,160727,160727,160730,0,3,3
45996,5,2,160732,160732,160734,0,2,2
45997,4,1,160736,160736,160737,0,1,2
45998,5,1,160741,160741,160742,0,1,4
45999,1,2,160742,160742,160744,0,2,0
46000,3,1,160745,160745,160746,0,1,1
46001,2,1,160747,160747,160748,0,1,1
46002,2,1,160749,160749,160750,0,1,1
46003,4,2,160753,160753,160755,0,2,3
46004,1,2,160754,160755,160757,1,3,0
46005,2,2,160756,160757,160759,1,3,0
46006,6,1,160762,160762,160763,0,1,3
46007,5,1,160767,160767,160768,0,1,4
46008,4,2,160771,160771,160773,0,2,3
46009,2,1,160773,160773,160774,0,1,0
46010,5,3,160778,160778,160781,0,3,4
46011,5,3,160783,160783,160786,0,3,2
46012,5,1,160788,160788,160789,0,1,2
46013,3,1,160791,160791,160792,0,1,2
46014,1,2,160792,160792,160794,0,2,0
46015,2,3,160794,160794,160797,0,3,0
46016,2,1,160796,160797,160798,1,2,0
46017,6,3,160802,160802,160805,0,3,4
46018,1,1,160803,160805,160806,2,3,0
46019,1,1,160804,160806,160807,2,3,0
46020,5,2,160809,160809,160811,0,2,2
46021,1,1,160810,160811,160812,1,2,0
46022,4,2,160814,160814,160816,0,2,2
46023,3,3,160817,160817,160820,0,3,1
46024,5,1,160822,160822,160823,0,1,2
46025,5,1,160827,160827,160828,0,1,4
46026,3,3,160830,160830,160833,0,3,2
46027,1,3,160831,160833,160836,2,5,0
46028,2,1,160833,160836,160837,3,4,0
46029,3,3,160836,160837,160840,1,4,0
46030,6,3,160842,160842,160845,0,3,2
46031,5,1,160847,160847,160848,0,1,2
46032,1,1,160848,160848,160849,0,1,0
46033,3,2,160851,160851,160853,0,2,2
46034,4,3,160855,160855,160858,0,3,2
46035,5,1,160860,160860,160861,0,1,2
46036,6,3,160866,160866,160869,0,3,5
46037,4,2,160870,160870,160872,0,2,1
46038,3,1,160873,160873,160874,0,1,1
46039,6,2,160879,160879,160881,0,2,5
46040,6,3,160885,160885,160888,0,3,4
46041,1,1,160886,160888,160889,2,3,0
46042,1,1,160887,160889,160890,2,3,0
46043,3,2,160890,160890,160892,0,2,0
46044,1,2,160891,160892,160894,1,3,0
46045,6,1,160897,160897,160898,0,1,3
46046,5,1,160902,160902,160903,0,1,4
46047,5,1,160907,160907,160908,0,1,4
46048,3,1,160910,160910,160911,0,1,2
46049,5,3,160915,160915,160918,0,3,4
46050,4,2,160919,160919,160921,0,2,1
46051,4,2,160923,160923,160925,0,2,2
46052,2,1,160925,160925,160926,0,1,0
46053,6,1,160931,160931,160932,0,1,5
46054,2,3,160933,160933,160936,0,3,1
46055,1,3,160934,160936,160939,2,5,0
46056,1,3,160935,160939,160942,4,7,0
46057,1,3,160936,160942,160945,6,9,0
46058,5,1,160941,160945,160946,4,5,0
46059,2,1,160943,160946,160947,3,4,0
46060,4,1,160947,160947,160948,0,1,0
46061,2,2,160949,160949,160951,0,2,1
46062,2,3,160951,160951,160954,0,3,0
46063,4,2,160955,160955,160957,0,2,1
46064,5,2,160960,160960,160962,0,2,3
46065,2,3,160962,160962,160965,0,3,0
46066,1,2,160963,160965,160967,2,4,0
46067,4,3,160967,160967,160970,0,3,0
46068,5,3,160972,160972,160975,0,3,2
46069,6,2,160978,160978,160980,0,2,3
46070,4,1,160982,160982,160983,0,1,2
46071,2,2,160984,160984,160986,0,2,1
46072,4,3,160988,160988,160991,0,3,2
46073,1,1,160989,160991,160992,2,3,0
46074,6,1,160995,160995,160996,0,1,3
46075,6,1,161001,161001,161002,0,1,5
46076,4,1,161005,161005,161006,0,1,3
46077,4,3,161009,161009,161012,0,3,3
46078,4,1,161013,161013,161014,0,1,1
46079,2,3,161015,161015,161018,0,3,1
46080,5,2,161020,161020,161022,0,2,2
46081,2,1,161022,161022,161023,0,1,0
46082,4,3,161026,161026,161029,0,3,3
46083,6,3,161032,161032,161035,0,3,3
46084,4,3,161036,161036,161039,0,3,1
46085,3,2,161039,161039,161041,0,2,0
46086,2,3,161041,161041,161044,0,3,0
46087,2,3,161043,161044,161047,1,4,0
46088,4,3,161047,161047,161050,0,3,0
46089,3,3,161050,161050,161053,0,3,0
46090,1,1,161051,161053,161054,2,3,0
46091,1,2,161052,161054,161056,2,4,0
46092,4,3,161056,161056,161059,0,3,0
46093,6,1,161062,161062,161063,0,1,3
46094,1,1,161063,161063,161064,0,1,0
46095,4,1,161067,161067,161068,0,1,3
46096,5,3,161072,161072,161075,0,3,4
46097,3,3,161075,161075,161078,0,3,0
46098,4,3,161079,161079,161082,0,3,1
46099,4,2,161083,161083,161085,0,2,1
46100,3,3,161086,161086,161089,0,3,1
46101,6,2,161092,161092,161094,0,2,3
46102,1,2,161093,161094,161096,1,3,0
46103,6,1,161099,161099,161100,0,1,3
46104,2,2,161101,161101,161103,0,2,1
46105,1,2,161102,161103,161105,1,3,0
46106,6,3,161108,161108,161111,0,3,3
46107,6,2,161114,161114,161116,0,2,3
46108,4,1,161118,161118,161119,0,1,2
46109,2,2,161120,161120,161122,0,2,1
46110,3,3,161123,161123,161126,0,3,1
46111,5,2,161128,161128,161130,0,2,2
46112,4,1,161132,161132,161133,0,1,2
46113,5,1,161137,161137,161138,0,1,4
46114,4,1,161141,161141,161142,0,1,3
46115,1,3,161142,161142,161145,0,3,0
46116,4,3,161146,161146,161149,0,3,1
46117,3,1,161149,161149,161150,0,1,0
46118,5,2,161154,161154,161156,0,2,4
46119,1,1,161155,161156,161157,1,2,0
46120,1,3,161156,161157,161160,1,4,0
46121,3,2,161159,161160,161162,1,3,0
46122,5,1,161164,161164,161165,0,1,2
46123,2,1,161166,161166,161167,0,1,1
46124,2,2,161168,161168,161170,0,2,1
46125,6,2,161174,161174,161176,0,2,4
46126,1,2,161175,161176,161178,1,3,0
46127,4,1,161179,161179,161180,0,1,1
46128,3,2,161182,161182,161184,0,2,2
46129,6,1,161188,161188,161189,0,1,4
46130,2,3,161190,161190,161193,0,3,1
46131,6,3,161196,161196,161199,0,3,3
46132,3,3,161199,161199,161202,0,3,0
46133,2,2,161201,161202,161204,1,3,0
46134,2,1,161203,161204,161205,1,2,0
46135,5,1,161208,161208,161209,0,1,3
46136,5,2,161213,161213,161215,0,2,4
46137,6,2,161219,161219,161221,0,2,4
46138,2,2,161221,161221,161223,0,2,0
46139,5,2,161226,161226,161228,0,2,3
46140,6,3,161232,161232,161235,0,3,4
46141,4,2,161236,161236,161238,0,2,1
46142,5,1,161241,161241,161242,0,1,3
46143,3,3,161244,161244,161247,0,3,2
46144,6,3,161250,161250,161253,0,3,3
46145,4,2,161254,161254,161256,0,2,1
46146,6,2,161260,161260,161262,0,2,4
46147,2,1,161262,161262,161263,0,1,0
46148,1,1,161263,161263,161264,0,1,0
46149,2,1,161265,161265,161266,0,1,1
46150,4,2,161269,161269,161271,0,2,3
46151,6,1,161275,161275,161276,0,1,4
46152,3,2,161278,161278,161280,0,2,2
46153,3,3,161281,161281,161284,0,3,1
46154,4,3,161285,161285,161288,0,3,1
46155,4,2,161289,161289,161291,0,2,1
46156,6,3,161295,161295,161298,0,3,4
46157,3,1,161298,161298,161299,0,1,0
46158,1,1,161299,161299,161300,0,1,0
46159,1,1,161300,161300,161301,0,1,0
46160,2,2,161302,161302,161304,0,2,1
46161,4,3,161306,161306,161309,0,3,2
46162,5,1,161311,161311,161312,0,1,2
46163,6,3,161317,161317,161320,0,3,5
46164,3,2,161320,161320,161322,0,2,0
46165,3,2,161323,161323,161325,0,2,1
46166,3,2,161326,161326,161328,0,2,1
46167,1,2,161327,161328,161330,1,3,0
46168,5,2,161332,161332,161334,0,2,2
46169,3,2,161335,161335,161337,0,2,1
46170,2,3,161337,161337,161340,0,3,0
46171,3,2,161340,161340,161342,0,2,0
46172,5,3,161345,161345,161348,0,3,3
46173,5,3,161350,161350,161353,0,3,2
46174,5,3,161355,161355,161358,0,3,2
46175,1,1,161356,161358,161359,2,3,0
46176,2,1,161358,161359,161360,1,2,0
46177,5,3,161363,161363,161366,0,3,3
46178,5,3,161368,161368,161371,0,3,2
46179,1,1,161369,161371,161372,2,3,0
46180,5,3,161374,161374,161377,0,3,2
46181,4,1,161378,161378,161379,0,1,1
46182,2,1,161380,161380,161381,0,1,1
46183,2,3,161382,161382,161385,0,3,1
46184,3,3,161385,161385,161388,0,3,0
46185,4,2,161389,161389,161391,0,2,1
46186,3,2,161392,161392,161394,0,2,1
46187,1,2,161393,161394,161396,1,3,0
46188,1,1,161394,161396,161397,2,3,0
46189,3,3,161397,161397,161400,0,3,0
46190,3,1,161400,161400,161401,0,1,0
46191,6,1,161406,161406,161407,0,1,5
46192,3,3,161409,161409,161412,0,3,2
46193,2,2,161411,161412,161414,1,3,0
46194,3,3,161414,161414,161417,0,3,0
46195,6,3,161420,161420,161423,0,3,3
46196,6,1,161426,161426,161427,0,1,3
46197,5,2,161431,161431,161433,0,2,4
46198,4,3,161435,161435,161438,0,3,2
46199,4,2,161439,161439,161441,0,2,1
46200,6,3,161445,161445,161448,0,3,4
46201,6,3,161451,161451,161454,0,3,3
46202,3,1,161454,161454,161455,0,1,0
46203,5,1,161459,161459,161460,0,1,4
46204,2,2,161461,161461,161463,0,2,1
46205,6,1,161467,161467,161468,0,1,4
46206,2,3,161469,161469,161472,0,3,1
46207,3,2,161472,161472,161474,0,2,0
46208,5,3,161477,161477,161480,0,3,3
46209,5,3,161482,161482,161485,0,3,2
46210,5,3,161487,161487,161490,0,3,2
46211,4,2,161491,161491,161493,0,2,1
46212,4,2,161495,161495,161497,0,2,2
46213,6,1,161501,161501,161502,0,1,4
46214,6,2,161507,161507,161509,0,2,5
46215,6,1,161513,161513,161514,0,1,4
46216,4,2,161517,161517,161519,0,2,3
46217,6,2,161523,161523,161525,0,2,4
46218,3,2,161526,161526,161528,0,2,1
46219,3,1,161529,161529,161530,0,1,1
46220,6,1,161535,161535,161536,0,1,5
46221,6,1,161541,161541,161542,0,1,5
46222,4,1,161545,161545,161546,0,1,3
46223,2,3,161547,161547,161550,0,3,1
46224,1,1,161548,161550,161551,2,3,0
46225,2,3,161550,161551,161554,1,4,0
46226,5,3,161555,161555,161558,0,3,1
46227,5,1,161560,161560,161561,0,1,2
46228,3,1,161563,161563,161564,0,1,2
46229,3,2,161566,161566,161568,0,2,2
46230,6,3,161572,161572,161575,0,3,4
46231,4,2,161576,161576,161578,0,2,1
46232,2,2,161578,161578,161580,0,2,0
46233,3,1,161581,161581,161582,0,1,1
46234,3,2,161584,161584,161586,0,2,2
46235,6,1,161590,161590,161591,0,1,4
46236,4,2,161594,161594,161596,0,2,3
46237,2,2,161596,161596,161598,0,2,0
46238,3,1,161599,161599,161600,0,1,1
46239,4,1,161603,161603,161604,0,1,3
46240,2,3,161605,161605,161608,0,3,1
46241,5,2,161610,161610,161612,0,2,2
46242,3,1,161613,161613,161614,0,1,1
46243,6,3,161619,161619,161622,0,3,5
46244,5,2,161624,161624,161626,0,2,2
46245,2,2,161626,161626,161628,0,2,0
46246,6,1,161632,161632,161633,0,1,4
46247,5,1,161637,161637,161638,0,1,4
46248,5,1,161642,161642,161643,0,1,4
46249,3,2,161645,161645,161647,0,2,2
46250,1,1,161646,161647,161648,1,2,0
46251,3,1,161649,161649,161650,0,1,1
46252,6,3,161655,161655,161658,0,3,5
46253,3,1,161658,161658,161659,0,1,0
46254,1,3,161659,161659,161662,0,3,0
46255,5,1,161664,161664,161665,0,1,2
46256,4,3,161668,161668,161671,0,3,3
46257,6,1,161674,161674,161675,0,1,3
46258,6,2,161680,161680,161682,0,2,5
46259,2,2,161682,161682,161684,0,2,0
46260,5,1,161687,161687,161688,0,1,3
46261,6,1,161693,161693,161694,0,1,5
46262,6,2,161699,161699,161701,0,2,5
46263,3,2,161702,161702,161704,0,2,1
46264,2,1,161704,161704,161705,0,1,0
46265,3,1,161707,161707,161708,0,1,2
46266,2,2,161709,161709,161711,0,2,1
46267,5,1,161714,161714,161715,0,1,3
46268,1,3,161715,161715,161718,0,3,0
46269,4,2,161719,161719,161721,0,2,1
46270,4,1,161723,161723,161724,0,1,2
46271,3,3,161726,161726,161729,0,3,2
46272,3,1,161729,161729,161730,0,1,0
46273,3,1,161732,161732,161733,0,1,2
46274,6,1,161738,161738,161739,0,1,5
46275,3,1,161741,161741,161742,0,1,2
46276,2,3,161743,161743,161746,0,3,1
46277,2,1,161745,161746,161747,1,2,0
46278,2,2,161747,161747,161749,0,2,0
46279,2,3,161749,161749,161752,0,3,0
46280,2,2,161751,161752,161754,1,3,0
46281,1,3,161752,161754,161757,2,5,0
46282,6,2,161758,161758,161760,0,2,1
46283,4,2,161762,161762,161764,0,2,2
46284,2,1,161764,161764,161765,0,1,0
46285,1,3,161765,161765,161768,0,3,0
46286,5,3,161770,161770,161773,0,3,2
46287,6,3,161776,161776,161779,0,3,3
46288,2,3,161778,161779,161782,1,4,0
46289,4,1,161782,161782,161783,0,1,0
46290,4,2,161786,161786,161788,0,2,3
46291,2,1,161788,161788,161789,0,1,0
46292,2,3,161790,161790,161793,0,3,1
46293,5,2,161795,161795,161797,0,2,2
46294,2,1,161797,161797,161798,0,1,0
46295,6,3,161803,161803,161806,0,3,5
46296,5,2,161808,161808,161810,0,2,2
46297,6,1,161814,161814,161815,0,1,4
46298,2,2,161816,161816,161818,0,2,1
46299,4,2,161820,161820,161822,0,2,2
46300,2,2,161822,161822,161824,0,2,0
46301,3,2,161825,161825,161827,0,2,1
46302,6,3,161831,161831,161834,0,3,4
46303,2,2,161833,161834,161836,1,3,0
46304,3,2,161836,161836,161838,0,2,0
46305,5,1,161841,161841,161842,0,1,3
46306,4,2,161845,161845,161847,0,2,3
46307,3,3,161848,161848,161851,0,3,1
46308,6,3,161854,161854,161857,0,3,3
46309,5,3,161859,161859,161862,0,3,2
46310,2,2,161861,161862,161864,1,3,0
46311,5,2,161866,161866,161868,0,2,2
46312,5,1,161871,161871,161872,0,1,3
46313,6,3,161877,161877,161880,0,3,5
46314,6,3,161883,161883,161886,0,3,3
46315,1,3,161884,161886,161889,2,5,0
46316,1,1,161885,161889,161890,4,5,0
46317,4,3,161889,161890,161893,1,4,0
46318,2,2,161891,161893,161895,2,4,0
46319,4,1,161895,161895,161896,0,1,0
46320,1,1,161896,161896,161897,0,1,0
46321,4,2,161900,161900,161902,0,2,3
46322,6,3,161906,161906,161909,0,3,4
46323,1,3,161907,161909,161912,2,5,0
46324,3,1,161910,161912,161913,2,3,0
46325,2,2,161912,161913,161915,1,3,0
46326,6,1,161918,161918,161919,0,1,3
46327,4,1,161922,161922,161923,0,1,3
46328,5,1,161927,161927,161928,0,1,4
46329,2,3,161929,161929,161932,0,3,1
46330,3,2,161932,161932,161934,0,2,0
46331,5,1,161937,161937,161938,0,1,3
46332,1,1,161938,161938,161939,0,1,0
46333,5,2,161943,161943,161945,0,2,4
46334,1,2,161944,161945,161947,1,3,0
46335,2,3,161946,161947,161950,1,4,0
46336,2,2,161948,161950,161952,2,4,0
46337,5,1,161953,161953,161954,0,1,1
46338,5,1,161958,161958,161959,0,1,4
46339,3,1,161961,161961,161962,0,1,2
46340,6,1,161967,161967,161968,0,1,5
46341,4,1,161971,161971,161972,0,1,3
46342,6,2,161977,161977,161979,0,2,5
46343,1,2,161978,161979,161981,1,3,0
46344,4,3,161982,161982,161985,0,3,1
46345,1,3,161983,161985,161988,2,5,0
46346,3,2,161986,161988,161990,2,4,0
46347,4,3,161990,161990,161993,0,3,0
46348,6,3,161996,161996,161999,0,3,3
46349,3,1,161999,161999,162000,0,1,0
46350,1,3,162000,162000,162003,0,3,0
46351,4,3,162004,162004,162007,0,3,1
46352,6,3,162010,162010,162013,0,3,3
46353,2,2,162012,162013,162015,1,3,0
46354,2,1,162014,162015,162016,1,2,0
46355,3,1,162017,162017,162018,0,1,1
46356,1,2,162018,162018,162020,0,2,0
46357,3,3,162021,162021,162024,0,3,1
46358,4,2,162025,162025,162027,0,2,1
46359,4,1,162029,162029,162030,0,1,2
46360,4,3,162033,162033,162036,0,3,3
46361,6,2,162039,162039,162041,0,2,3
46362,1,3,162040,162041,162044,1,4,0
46363,5,1,162045,162045,162046,0,1,1
46364,4,3,162049,162049,162052,0,3,3
46365,5,2,162054,162054,162056,0,2,2
46366,2,3,162056,162056,162059,0,3,0
46367,2,3,162058,162059,162062,1,4,0
46368,3,2,162061,162062,162064,1,3,0
46369,6,2,162067,162067,162069,0,2,3
46370,3,1,162070,162070,162071,0,1,1
46371,5,1,162075,162075,162076,0,1,4
46372,5,1,162080,162080,162081,0,1,4
46373,3,3,162083,162083,162086,0,3,2
46374,5,1,162088,162088,162089,0,1,2
46375,5,2,162093,162093,162095,0,2,4
46376,4,1,162097,162097,162098,0,1,2
46377,3,1,162100,162100,162101,0,1,2
46378,2,1,162102,162102,162103,0,1,1
46379,4,3,162106,162106,162109,0,3,3
46380,6,3,162112,162112,162115,0,3,3
46381,5,2,162117,162117,162119,0,2,2
46382,4,3,162121,162121,162124,0,3,2
46383,5,3,162126,162126,162129,0,3,2
46384,1,3,162127,162129,162132,2,5,0
46385,6,1,162133,162133,162134,0,1,1
46386,1,1,162134,162134,162135,0,1,0
46387,1,3,162135,162135,162138,0,3,0
46388,5,1,162140,162140,162141,0,1,2
46389,6,2,162146,162146,162148,0,2,5
46390,5,3,162151,162151,162154,0,3,3
46391,2,1,162153,162154,162155,1,2,0
46392,5,2,162158,162158,162160,0,2,3
46393,2,2,162160,162160,162162,0,2,0
46394,6,1,162166,162166,162167,0,1,4
46395,4,1,162170,162170,162171,0,1,3
46396,6,3,162176,162176,162179,0,3,5
46397,5,3,162181,162181,162184,0,3,2
46398,3,2,162184,162184,162186,0,2,0
46399,1,2,162185,162186,162188,1,3,0
46400,5,3,162190,162190,162193,0,3,2
46401,3,1,162193,162193,162194,0,1,0
46402,6,2,162199,162199,162201,0,2,5
46403,5,1,162204,162204,162205,0,1,3
46404,5,3,162209,162209,162212,0,3,4
46405,1,3,162210,162212,162215,2,5,0
46406,1,3,162211,162215,162218,4,7,0
46407,4,1,162215,162218,162219,3,4,0
46408,3,1,162218,162219,162220,1,2,0
46409,2,3,162220,162220,162223,0,3,0
46410,4,3,162224,162224,162227,0,3,1
46411,1,2,162225,162227,162229,2,4,0
46412,2,1,162227,162229,162230,2,3,0
46413,1,2,162228,162230,162232,2,4,0
46414,4,1,162232,162232,162233,0,1,0
46415,4,3,162236,162236,162239,0,3,3
46416,1,3,162237,162239,162242,2,5,0
46417,4,3,162241,162242,162245,1,4,0
46418,1,3,162242,162245,162248,3,6,0
46419,4,1,162246,162248,162249,2,3,0
46420,4,3,162250,162250,162253,0,3,1
46421,5,2,162255,162255,162257,0,2,2
46422,5,3,162260,162260,162263,0,3,3
46423,4,2,162264,162264,162266,0,2,1
46424,3,1,162267,162267,162268,0,1,1
46425,5,1,162272,162272,162273,0,1,4
46426,2,1,162274,162274,162275,0,1,1
46427,3,2,162277,162277,162279,0,2,2
46428,3,3,162280,162280,162283,0,3,1
46429,2,3,162282,162283,162286,1,4,0
46430,1,3,162283,162286,162289,3,6,0
46431,2,1,162285,162289,162290,4,5,0
46432,1,2,162286,162290,162292,4,6,0
46433,3,3,162289,162292,162295,3,6,0
46434,3,1,162292,162295,162296,3,4,0
46435,6,3,162298,162298,162301,0,3,2
46436,5,1,162303,162303,162304,0,1,2
46437,6,3,162309,162309,162312,0,3,5
46438,2,3,162311,162312,162315,1,4,0
46439,3,1,162314,162315,162316,1,2,0
46440,4,2,162318,162318,162320,0,2,2
46441,5,3,162323,162323,162326,0,3,3
46442,4,2,162327,162327,162329,0,2,1
46443,5,2,162332,162332,162334,0,2,3
46444,4,1,162336,162336,162337,0,1,2
46445,2,1,162338,162338,162339,0,1,1
46446,6,1,162344,162344,162345,0,1,5
46447,4,1,162348,162348,162349,0,1,3
46448,3,2,162351,162351,162353,0,2,2
46449,4,1,162355,162355,162356,0,1,2
46450,3,3,162358,162358,162361,0,3,2
46451,3,2,162361,162361,162363,0,2,0
46452,6,2,162367,162367,162369,0,2,4
46453,1,2,162368,162369,162371,1,3,0
46454,1,1,162369,162371,162372,2,3,0
46455,1,1,162370,162372,162373,2,3,0
46456,1,3,162371,162373,162376,2,5,0
46457,2,1,162373,162376,162377,3,4,0
46458,4,1,162377,162377,162378,0,1,0
46459,2,2,162379,162379,162381,0,2,1
46460,5,1,162384,162384,162385,0,1,3
46461,1,2,162385,162385,162387,0,2,0
46462,2,2,162387,162387,162389,0,2,0
46463,5,3,162392,162392,162395,0,3,3
46464,1,2,162393,162395,162397,2,4,0
46465,4,2,162397,162397,162399,0,2,0
46466,5,2,162402,162402,162404,0,2,3
46467,3,2,162405,162405,162407,0,2,1
46468,5,2,162410,162410,162412,0,2,3
46469,6,3,162416,162416,162419,0,3,4
46470,2,1,162418,162419,162420,1,2,0
46471,2,2,162420,162420,162422,0,2,0
46472,1,2,162421,162422,162424,1,3,0
46473,6,2,162427,162427,162429,0,2,3
46474,2,2,162429,162429,162431,0,2,0
46475,4,2,162433,162433,162435,0,2,2
46476,4,1,162437,162437,162438,0,1,2
46477,5,1,162442,162442,162443,0,1,4
46478,4,2,162446,162446,162448,0,2,3
46479,3,3,162449,162449,162452,0,3,1
46480,2,1,162451,162452,162453,1,2,0
46481,1,3,162452,162453,162456,1,4,0
46482,1,1,162453,162456,162457,3,4,0
46483,2,1,162455,162457,162458,2,3,0
46484,4,2,162459,162459,162461,0,2,1
46485,2,1,162461,162461,162462,0,1,0
46486,1,3,162462,162462,162465,0,3,0
46487,4,3,162466,162466,162469,0,3,1
46488,4,1,162470,162470,162471,0,1,1
46489,6,1,162476,162476,162477,0,1,5
46490,1,2,162477,162477,162479,0,2,0
46491,4,3,162481,162481,162484,0,3,2
46492,5,1,162486,162486,162487,0,1,2
46493,3,1,162489,162489,162490,0,1,2
46494,4,2,162493,162493,162495,0,2,3
46495,6,1,162499,162499,162500,0,1,4
46496,3,3,162502,162502,162505,0,3,2
46497,5,1,162507,162507,162508,0,1,2
46498,4,3,162511,162511,162514,0,3,3
46499,4,2,162515,162515,162517,0,2,1
46500,4,2,162519,162519,162521,0,2,2
46501,2,2,162521,162521,162523,0,2,0
46502,1,2,162522,162523,162525,1,3,0
46503,6,2,162528,162528,162530,0,2,3
46504,4,2,162532,162532,162534,0,2,2
46505,4,1,162536,162536,162537,0,1,2
46506,3,1,162539,162539,162540,0,1,2
46507,5,3,162544,162544,162547,0,3,4
46508,2,2,162546,162547,162549,1,3,0
46509,2,2,162548,162549,162551,1,3,0
46510,1,1,162549,162551,162552,2,3,0
46511,5,2,162554,162554,162556,0,2,2
46512,1,2,162555,162556,162558,1,3,0
46513,4,3,162559,162559,162562,0,3,1
46514,4,3,162563,162563,162566,0,3,1
46515,2,3,162565,162566,162569,1,4,0
46516,6,3,162571,162571,162574,0,3,2
46517,3,3,162574,162574,162577,0,3,0
46518,6,1,162580,162580,162581,0,1,3
46519,3,3,162583,162583,162586,0,3,2
46520,2,2,162585,162586,162588,1,3,0
46521,4,1,162589,162589,162590,0,1,1
46522,6,2,162595,162595,162597,0,2,5
46523,6,2,162601,162601,162603,0,2,4
46524,5,3,162606,162606,162609,0,3,3
46525,5,2,162611,162611,162613,0,2,2
46526,3,2,162614,162614,162616,0,2,1
46527,5,3,162619,162619,162622,0,3,3
46528,1,3,162620,162622,162625,2,5,0
46529,5,2,162625,162625,162627,0,2,0
46530,6,2,162631,162631,162633,0,2,4
46531,2,1,162633,162633,162634,0,1,0
46532,3,3,162636,162636,162639,0,3,2
46533,1,1,162637,162639,162640,2,3,0
46534,4,1,162641,162641,162642,0,1,1
46535,5,2,162646,162646,162648,0,2,4
46536,2,3,162648,162648,162651,0,3,0
46537,3,1,162651,162651,162652,0,1,0
46538,3,2,162654,162654,162656,0,2,2
46539,4,1,162658,162658,162659,0,1,2
46540,1,3,162659,162659,162662,0,3,0
46541,1,3,162660,162662,162665,2,5,0
46542,2,2,162662,162665,162667,3,5,0
46543,1,1,162663,162667,162668,4,5,0
46544,2,2,162665,162668,162670,3,5,0
46545,3,2,162668,162670,162672,2,4,0
46546,4,3,162672,162672,162675,0,3,0
46547,3,3,162675,162675,162678,0,3,0
46548,6,1,162681,162681,162682,0,1,3
46549,5,2,162686,162686,162688,0,2,4
46550,5,1,162691,162691,162692,0,1,3
46551,6,2,162697,162697,162699,0,2,5
46552,1,3,162698,162699,162702,1,4,0
46553,3,2,162701,162702,162704,1,3,0
46554,2,2,162703,162704,162706,1,3,0
46555,6,3,162709,162709,162712,0,3,3
46556,4,1,162713,162713,162714,0,1,1
46557,4,2,162717,162717,162719,0,2,3
46558,1,1,162718,162719,162720,1,2,0
46559,2,2,162720,162720,162722,0,2,0
46560,3,2,162723,162723,162725,0,2,1
46561,5,3,162728,162728,162731,0,3,3
46562,5,2,162733,162733,162735,0,2,2
46563,1,2,162734,162735,162737,1,3,0
46564,5,1,162739,162739,162740,0,1,2
46565,4,2,162743,162743,162745,0,2,3
46566,3,3,162746,162746,162749,0,3,1
46567,5,1,162751,162751,162752,0,1,2
46568,2,1,162753,162753,162754,0,1,1
46569,6,3,162759,162759,162762,0,3,5
46570,2,3,162761,162762,162765,1,4,0
46571,5,1,162766,162766,162767,0,1,1
46572,3,3,162769,162769,162772,0,3,2
46573,6,1,162775,162775,162776,0,1,3
46574,6,1,162781,162781,162782,0,1,5
46575,1,1,162782,162782,162783,0,1,0
46576,5,3,162787,162787,162790,0,3,4
46577,5,1,162792,162792,162793,0,1,2
46578,4,3,162796,162796,162799,0,3,3
46579,1,1,162797,162799,162800,2,3,0
46580,1,1,162798,162800,162801,2,3,0
46581,1,1,162799,162801,162802,2,3,0
46582,1,2,162800,162802,162804,2,4,0
46583,5,3,162805,162805,162808,0,3,1
46584,3,3,162808,162808,162811,0,3,0
46585,4,1,162812,162812,162813,0,1,1
46586,5,3,162817,162817,162820,0,3,4
46587,6,2,162823,162823,162825,0,2,3
46588,2,2,162825,162825,162827,0,2,0
46589,2,3,162827,162827,162830,0,3,0
46590,4,3,162831,162831,162834,0,3,1
46591,3,2,162834,162834,162836,0,2,0
46592,4,2,162838,162838,162840,0,2,2
46593,3,2,162841,162841,162843,0,2,1
46594,2,1,162843,162843,162844,0,1,0
46595,1,2,162844,162844,162846,0,2,0
46596,1,3,162845,162846,162849,1,4,0
46597,4,2,162849,162849,162851,0,2,0
46598,5,1,162854,162854,162855,0,1,3
46599,5,2,162859,162859,162861,0,2,4
46600,2,1,162861,162861,162862,0,1,0
46601,4,1,162865,162865,162866,0,1,3
46602,3,1,162868,162868,162869,0,1,2
46603,6,1,162874,162874,162875,0,1,5
46604,1,1,162875,162875,162876,0,1,0
46605,3,2,162878,162878,162880,0,2,2
46606,1,1,162879,162880,162881,1,2,0
46607,1,1,162880,162881,162882,1,2,0
46608,6,2,162886,162886,162888,0,2,4
46609,6,1,162892,162892,162893,0,1,4
46610,6,3,162898,162898,162901,0,3,5
46611,6,3,162904,162904,162907,0,3,3
46612,4,2,162908,162908,162910,0,2,1
46613,3,1,162911,162911,162912,0,1,1
46614,1,3,162912,162912,162915,0,3,0
46615,5,3,162917,162917,162920,0,3,2
46616,6,2,162923,162923,162925,0,2,3
46617,6,1,162929,162929,162930,0,1,4
46618,3,1,162932,162932,162933,0,1,2
46619,6,1,162938,162938,162939,0,1,5
46620,5,3,162943,162943,162946,0,3,4
46621,6,1,162949,162949,162950,0,1,3
46622,6,1,162955,162955,162956,0,1,5
46623,2,1,162957,162957,162958,0,1,1
46624,6,1,162963,162963,162964,0,1,5
46625,5,3,162968,162968,162971,0,3,4
46626,6,2,162974,162974,162976,0,2,3
46627,2,3,162976,162976,162979,0,3,0
46628,1,2,162977,162979,162981,2,4,0
46629,5,3,162982,162982,162985,0,3,1
46630,6,2,162988,162988,162990,0,2,3
46631,6,3,162994,162994,162997,0,3,4
46632,4,3,162998,162998,163001,0,3,1
46633,4,3,163002,163002,163005,0,3,1
46634,3,3,163005,163005,163008,0,3,0
46635,3,2,163008,163008,163010,0,2,0
46636,1,2,163009,163010,163012,1,3,0
46637,2,1,163011,163012,163013,1,2,0
46638,4,3,163015,163015,163018,0,3,2
46639,2,2,163017,163018,163020,1,3,0
46640,1,3,163018,163020,163023,2,5,0
46641,5,1,163023,163023,163024,0,1,0
46642,3,2,163026,163026,163028,0,2,2
46643,5,1,163031,163031,163032,0,1,3
46644,5,2,163036,163036,163038,0,2,4
46645,6,2,163042,163042,163044,0,2,4
46646,2,1,163044,163044,163045,0,1,0
46647,6,1,163050,163050,163051,0,1,5
46648,4,2,163054,163054,163056,0,2,3
46649,4,1,163058,163058,163059,0,1,2
46650,6,1,163064,163064,163065,0,1,5
46651,3,1,163067,163067,163068,0,1,2
46652,1,3,163068,163068,163071,0,3,0
46653,4,1,163072,163072,163073,0,1,1
46654,1,1,163073,163073,163074,0,1,0
46655,6,1,163079,163079,163080,0,1,5
46656,5,2,163084,163084,163086,0,2,4
46657,6,3,163090,163090,163093,0,3,4
46658,2,2,163092,163093,163095,1,3,0
46659,3,1,163095,163095,163096,0,1,0
46660,2,3,163097,163097,163100,0,3,1
46661,3,2,163100,163100,163102,0,2,0
46662,6,1,163106,163106,163107,0,1,4
46663,6,3,163112,163112,163115,0,3,5
46664,3,2,163115,163115,163117,0,2,0
46665,3,3,163118,163118,163121,0,3,1
46666,5,2,163123,163123,163125,0,2,2
46667,1,3,163124,163125,163128,1,4,0
46668,1,1,163125,163128,163129,3,4,0
46669,2,1,163127,163129,163130,2,3,0
46670,6,3,163133,163133,163136,0,3,3
46671,1,3,163134,163136,163139,2,5,0
46672,1,3,163135,163139,163142,4,7,0
46673,2,1,163137,163142,163143,5,6,0
46674,5,1,163142,163143,163144,1,2,0
46675,4,1,163146,163146,163147,0,1,2
46676,1,2,163147,163147,163149,0,2,0
46677,2,2,163149,163149,163151,0,2,0
46678,4,1,163153,163153,163154,0,1,2
46679,6,2,163159,163159,163161,0,2,5
46680,6,2,163165,163165,163167,0,2,4
46681,4,1,163169,163169,163170,0,1,2
46682,5,2,163174,163174,163176,0,2,4
46683,2,2,163176,163176,163178,0,2,0
46684,6,2,163182,163182,163184,0,2,4
46685,6,1,163188,163188,163189,0,1,4
46686,4,3,163192,163192,163195,0,3,3
46687,6,1,163198,163198,163199,0,1,3
46688,6,1,163204,163204,163205,0,1,5
46689,3,2,163207,163207,163209,0,2,2
46690,2,1,163209,163209,163210,0,1,0
46691,4,1,163213,163213,163214,0,1,3
46692,5,1,163218,163218,163219,0,1,4
46693,2,1,163220,163220,163221,0,1,1
46694,2,2,163222,163222,163224,0,2,1
46695,3,3,163225,163225,163228,0,3,1
46696,6,1,163231,163231,163232,0,1,3
46697,3,3,163234,163234,163237,0,3,2
46698,1,3,163235,163237,163240,2,5,0
46699,3,1,163238,163240,163241,2,3,0
46700,6,1,163244,163244,163245,0,1,3
46701,3,2,163247,163247,163249,0,2,2
46702,3,3,163250,163250,163253,0,3,1
46703,3,1,163253,163253,163254,0,1,0
46704,2,3,163255,163255,163258,0,3,1
46705,1,2,163256,163258,163260,2,4,0
46706,2,1,163258,163260,163261,2,3,0
46707,3,2,163261,163261,163263,0,2,0
46708,6,1,163267,163267,163268,0,1,4
46709,3,3,163270,163270,163273,0,3,2
46710,2,3,163272,163273,163276,1,4,0
46711,2,1,163274,163276,163277,2,3,0
46712,2,1,163276,163277,163278,1,2,0
46713,6,1,163282,163282,163283,0,1,4
46714,5,3,163287,163287,163290,0,3,4
46715,6,3,163293,163293,163296,0,3,3
46716,3,2,163296,163296,163298,0,2,0
46717,2,1,163298,163298,163299,0,1,0
46718,2,2,163300,163300,163302,0,2,1
46719,1,1,163301,163302,163303,1,2,0
46720,4,1,163305,163305,163306,0,1,2
46721,2,2,163307,163307,163309,0,2,1
46722,5,1,163312,163312,163313,0,1,3
46723,2,3,163314,163314,163317,0,3,1
46724,1,1,163315,163317,163318,2,3,0
46725,5,1,163320,163320,163321,0,1,2
46726,4,3,163324,163324,163327,0,3,3
46727,3,1,163327,163327,163328,0,1,0
46728,3,3,163330,163330,163333,0,3,2
46729,3,2,163333,163333,163335,0,2,0
46730,4,3,163337,163337,163340,0,3,2
46731,3,1,163340,163340,163341,0,1,0
46732,2,2,163342,163342,163344,0,2,1
46733,1,1,163343,163344,163345,1,2,0
46734,4,1,163347,163347,163348,0,1,2
46735,3,2,163350,163350,163352,0,2,2
46736,4,2,163354,163354,163356,0,2,2
46737,4,3,163358,163358,163361,0,3,2
46738,4,3,163362,163362,163365,0,3,1
46739,6,3,163368,163368,163371,0,3,3
46740,1,3,163369,163371,163374,2,5,0
46741,6,1,163375,163375,163376,0,1,1
46742,4,3,163379,163379,163382,0,3,3
46743,6,1,163385,163385,163386,0,1,3
46744,2,1,163387,163387,163388,0,1,1
46745,1,1,163388,163388,163389,0,1,0
46746,1,2,163389,163389,163391,0,2,0
46747,1,1,163390,163391,163392,1,2,0
46748,2,2,163392,163392,163394,0,2,0
46749,1,1,163393,163394,163395,1,2,0
46750,3,3,163396,163396,163399,0,3,1
46751,6,2,163402,163402,163404,0,2,3
46752,5,2,163407,163407,163409,0,2,3
46753,1,3,163408,163409,163412,1,4,0
46754,1,2,163409,163412,163414,3,5,0
46755,3,2,163412,163414,163416,2,4,0
46756,2,2,163414,163416,163418,2,4,0
46757,2,1,163416,163418,163419,2,3,0
46758,2,3,163418,163419,163422,1,4,0
46759,5,2,163423,163423,163425,0,2,1
46760,2,3,163425,163425,163428,0,3,0
46761,6,3,163431,163431,163434,0,3,3
46762,5,3,163436,163436,163439,0,3,2
46763,2,1,163438,163439,163440,1,2,0
46764,4,3,163442,163442,163445,0,3,2
46765,5,1,163447,163447,163448,0,1,2
46766,5,1,163452,163452,163453,0,1,4
46767,4,3,163456,163456,163459,0,3,3
46768,5,2,163461,163461,163463,0,2,2
46769,4,2,163465,163465,163467,0,2,2
46770,6,2,163471,163471,163473,0,2,4
46771,4,3,163475,163475,163478,0,3,2
46772,2,1,163477,163478,163479,1,2,0
46773,6,1,163483,163483,163484,0,1,4
46774,5,2,163488,163488,163490,0,2,4
46775,2,2,163490,163490,163492,0,2,0
46776,1,3,163491,163492,163495,1,4,0
46777,6,3,163497,163497,163500,0,3,2
46778,4,1,163501,163501,163502,0,1,1
46779,6,3,163507,163507,163510,0,3,5
46780,5,2,163512,163512,163514,0,2,2
46781,2,2,163514,163514,163516,0,2,0
46782,2,1,163516,163516,163517,0,1,0
46783,4,1,163520,163520,163521,0,1,3
46784,4,3,163524,163524,163527,0,3,3
46785,1,1,163525,163527,163528,2,3,0
46786,2,1,163527,163528,163529,1,2,0
46787,5,3,163532,163532,163535,0,3,3
46788,1,2,163533,163535,163537,2,4,0
46789,5,1,163538,163538,163539,0,1,1
46790,1,1,163539,163539,163540,0,1,0
46791,6,3,163545,163545,163548,0,3,5
46792,2,2,163547,163548,163550,1,3,0
46793,6,3,163553,163553,163556,0,3,3
46794,2,1,163555,163556,163557,1,2,0
46795,3,3,163558,163558,163561,0,3,1
46796,2,1,163560,163561,163562,1,2,0
46797,2,3,163562,163562,163565,0,3,0
46798,5,1,163567,163567,163568,0,1,2
46799,3,3,163570,163570,163573,0,3,2
46800,5,2,163575,163575,163577,0,2,2
46801,4,1,163579,163579,163580,0,1,2
46802,2,1,163581,163581,163582,0,1,1
46803,6,2,163587,163587,163589,0,2,5
46804,6,2,163593,163593,163595,0,2,4
46805,2,2,163595,163595,163597,0,2,0
46806,3,3,163598,163598,163601,0,3,1
46807,1,1,163599,163601,163602,2,3,0
46808,3,2,163602,163602,163604,0,2,0
46809,4,3,163606,163606,163609,0,3,2
46810,1,2,163607,163609,163611,2,4,0
46811,4,1,163611,163611,163612,0,1,0
46812,6,1,163617,163617,163618,0,1,5
46813,4,2,163621,163621,163623,0,2,3
46814,2,1,163623,163623,163624,0,1,0
46815,5,3,163628,163628,163631,0,3,4
46816,3,1,163631,163631,163632,0,1,0
46817,5,1,163636,163636,163637,0,1,4
46818,5,2,163641,163641,163643,0,2,4
46819,6,1,163647,163647,163648,0,1,4
46820,6,3,163653,163653,163656,0,3,5
46821,6,1,163659,163659,163660,0,1,3
46822,4,3,163663,163663,163666,0,3,3
46823,4,3,163667,163667,163670,0,3,1
46824,3,2,163670,163670,163672,0,2,0
46825,6,3,163676,163676,163679,0,3,4
46826,4,1,163680,163680,163681,0,1,1
46827,6,3,163686,163686,163689,0,3,5
46828,5,2,163691,163691,163693,0,2,2
46829,2,3,163693,163693,163696,0,3,0
46830,6,3,163699,163699,163702,0,3,3
46831,5,3,163704,163704,163707,0,3,2
46832,1,1,163705,163707,163708,2,3,0
46833,2,3,163707,163708,163711,1,4,0
46834,6,2,163713,163713,163715,0,2,2
46835,6,2,163719,163719,163721,0,2,4
46836,2,3,163721,163721,163724,0,3,0
46837,3,1,163724,163724,163725,0,1,0
46838,3,1,163727,163727,163728,0,1,2
46839,5,1,163732,163732,163733,0,1,4
46840,5,3,163737,163737,163740,0,3,4
46841,5,2,163742,163742,163744,0,2,2
46842,3,3,163745,163745,163748,0,3,1
46843,1,2,163746,163748,163750,2,4,0
46844,2,3,163748,163750,163753,2,5,0
46845,3,3,163751,163753,163756,2,5,0
46846,3,1,163754,163756,163757,2,3,0
46847,5,1,163759,163759,163760,0,1,2
46848,4,3,163763,163763,163766,0,3,3
46849,6,3,163769,163769,163772,0,3,3
46850,1,1,163770,163772,163773,2,3,0
46851,4,3,163774,163774,163777,0,3,1
46852,2,2,163776,163777,163779,1,3,0
46853,3,1,163779,163779,163780,0,1,0
46854,3,3,163782,163782,163785,0,3,2
46855,3,1,163785,163785,163786,0,1,0
46856,6,1,163791,163791,163792,0,1,5
46857,4,3,163795,163795,163798,0,3,3
46858,4,3,163799,163799,163802,0,3,1
46859,5,1,163804,163804,163805,0,1,2
46860,3,2,163807,163807,163809,0,2,2
46861,1,1,163808,163809,163810,1,2,0
46862,4,3,163812,163812,163815,0,3,2
46863,2,1,163814,163815,163816,1,2,0
46864,3,1,163817,163817,163818,0,1,1
46865,5,2,163822,163822,163824,0,2,4
46866,6,1,163828,163828,163829,0,1,4
46867,4,1,163832,163832,163833,0,1,3
46868,2,1,163834,163834,163835,0,1,1
46869,6,2,163840,163840,163842,0,2,5
46870,3,1,163843,163843,163844,0,1,1
46871,4,2,163847,163847,163849,0,2,3
46872,6,3,163853,163853,163856,0,3,4
46873,5,2,163858,163858,163860,0,2,2
46874,3,2,163861,163861,163863,0,2,1
46875,6,3,163867,163867,163870,0,3,4
46876,2,3,163869,163870,163873,1,4,0
46877,2,3,163871,163873,163876,2,5,0
46878,3,3,163874,163876,163879,2,5,0
46879,3,2,163877,163879,163881,2,4,0
46880,4,3,163881,163881,163884,0,3,0
46881,6,3,163887,163887,163890,0,3,3
46882,5,1,163892,163892,163893,0,1,2
46883,5,3,163897,163897,163900,0,3,4
46884,5,3,163902,163902,163905,0,3,2
46885,1,2,163903,163905,163907,2,4,0
46886,4,3,163907,163907,163910,0,3,0
46887,4,2,163911,163911,163913,0,2,1
46888,5,2,163916,163916,163918,0,2,3
46889,1,1,163917,163918,163919,1,2,0
46890,2,1,163919,163919,163920,0,1,0
46891,1,1,163920,163920,163921,0,1,0
46892,3,3,163923,163923,163926,0,3,2
46893,3,3,163926,163926,163929,0,3,0
46894,5,2,163931,163931,163933,0,2,2
46895,1,2,163932,163933,163935,1,3,0
46896,2,2,163934,163935,163937,1,3,0
46897,2,3,163936,163937,163940,1,4,0
46898,2,2,163938,163940,163942,2,4,0
46899,2,2,163940,163942,163944,2,4,0
46900,2,1,163942,163944,163945,2,3,0
46901,4,2,163946,163946,163948,0,2,1
46902,4,3,163950,163950,163953,0,3,2
46903,2,3,163952,163953,163956,1,4,0
46904,5,1,163957,163957,163958,0,1,1
46905,6,1,163963,163963,163964,0,1,5
46906,4,3,163967,163967,163970,0,3,3
46907,4,1,163971,163971,163972,0,1,1
46908,2,1,163973,163973,163974,0,1,1
46909,1,3,163974,163974,163977,0,3,0
46910,3,3,163977,163977,163980,0,3,0
46911,5,3,163982,163982,163985,0,3,2
46912,5,3,163987,163987,163990,0,3,2
46913,5,3,163992,163992,163995,0,3,2
46914,4,1,163996,163996,163997,0,1,1
46915,6,1,164002,164002,164003,0,1,5
46916,3,1,164005,164005,164006,0,1,2
46917,6,3,164011,164011,164014,0,3,5
46918,4,2,164015,164015,164017,0,2,1
46919,3,1,164018,164018,164019,0,1,1
46920,1,1,164019,164019,164020,0,1,0
46921,5,2,164024,164024,164026,0,2,4
46922,2,3,164026,164026,164029,0,3,0
46923,6,3,164032,164032,164035,0,3,3
46924,6,3,164038,164038,164041,0,3,3
46925,3,3,164041,164041,164044,0,3,0
46926,4,1,164045,164045,164046,0,1,1
46927,3,2,164048,164048,164050,0,2,2
46928,4,1,164052,164052,164053,0,1,2
46929,1,2,164053,164053,164055,0,2,0
46930,1,1,164054,164055,164056,1,2,0
46931,4,2,164058,164058,164060,0,2,2
46932,1,3,164059,164060,164063,1,4,0
46933,3,2,164062,164063,164065,1,3,0
46934,6,1,164068,164068,164069,0,1,3
46935,2,3,164070,164070,164073,0,3,1
46936,2,1,164072,164073,164074,1,2,0
46937,6,1,164078,164078,164079,0,1,4
46938,4,2,164082,164082,164084,0,2,3
46939,1,3,164083,164084,164087,1,4,0
46940,4,1,164087,164087,164088,0,1,0
46941,1,3,164088,164088,164091,0,3,0
46942,6,1,164094,164094,164095,0,1,3
46943,4,1,164098,164098,164099,0,1,3
46944,6,1,164104,164104,164105,0,1,5
46945,1,2,164105,164105,164107,0,2,0
46946,1,3,164106,164107,164110,1,4,0
46947,1,1,164107,164110,164111,3,4,0
46948,4,3,164111,164111,164114,0,3,0
46949,3,2,164114,164114,164116,0,2,0
46950,1,2,164115,164116,164118,1,3,0
46951,6,3,164121,164121,164124,0,3,3
46952,1,1,164122,164124,164125,2,3,0
46953,3,2,164125,164125,164127,0,2,0
46954,2,1,164127,164127,164128,0,1,0
46955,2,3,164129,164129,164132,0,3,1
46956,3,3,164132,164132,164135,0,3,0
46957,2,1,164134,164135,164136,1,2,0
46958,5,1,164139,164139,164140,0,1,3
46959,3,3,164142,164142,164145,0,3,2
46960,2,2,164144,164145,164147,1,3,0
46961,1,2,164145,164147,164149,2,4,0
46962,5,3,164150,164150,164153,0,3,1
46963,3,2,164153,164153,164155,0,2,0
46964,3,2,164156,164156,164158,0,2,1
46965,4,1,164160,164160,164161,0,1,2
46966,1,2,164161,164161,164163,0,2,0
46967,3,2,164164,164164,164166,0,2,1
46968,4,3,164168,164168,164171,0,3,2
46969,2,3,164170,164171,164174,1,4,0
46970,4,3,164174,164174,164177,0,3,0
46971,2,3,164176,164177,164180,1,4,0
46972,1,3,164177,164180,164183,3,6,0
46973,4,2,164181,164183,164185,2,4,0
46974,5,2,164186,164186,164188,0,2,1
46975,4,3,164190,164190,164193,0,3,2
46976,6,3,164196,164196,164199,0,3,3
46977,1,1,164197,164199,164200,2,3,0
46978,4,1,164201,164201,164202,0,1,1
46979,5,2,164206,164206,164208,0,2,4
46980,6,2,164212,164212,164214,0,2,4
46981,2,2,164214,164214,164216,0,2,0
46982,2,1,164216,164216,164217,0,1,0
46983,3,2,164219,164219,164221,0,2,2
46984,5,2,164224,164224,164226,0,2,3
46985,6,2,164230,164230,164232,0,2,4
46986,1,1,164231,164232,164233,1,2,0
46987,6,2,164237,164237,164239,0,2,4
46988,1,3,164238,164239,164242,1,4,0
46989,4,3,164242,164242,164245,0,3,0
46990,2,3,164244,164245,164248,1,4,0
46991,2,3,164246,164248,164251,2,5,0
46992,4,3,164250,164251,164254,1,4,0
46993,4,3,164254,164254,164257,0,3,0
46994,5,1,164259,164259,164260,0,1,2
46995,3,3,164262,164262,164265,0,3,2
46996,6,1,164268,164268,164269,0,1,3
46997,1,2,164269,164269,164271,0,2,0
46998,4,1,164273,164273,164274,0,1,2
46999,3,2,164276,164276,164278,0,2,2
47000,1,1,164277,164278,164279,1,2,0
47001,4,1,164281,164281,164282,0,1,2
47002,3,3,164284,164284,164287,0,3,2
47003,3,2,164287,164287,164289,0,2,0
47004,4,2,164291,164291,164293,0,2,2
47005,3,2,164294,164294,164296,0,2,1
47006,3,1,164297,164297,164298,0,1,1
47007,3,1,164300,164300,164301,0,1,2
47008,4,1,164304,164304,164305,0,1,3
47009,2,3,164306,164306,164309,0,3,1
47010,3,2,164309,164309,164311,0,2,0
47011,1,2,164310,164311,164313,1,3,0
47012,5,3,164315,164315,164318,0,3,2
47013,2,1,164317,164318,164319,1,2,0
47014,4,3,164321,164321,164324,0,3,2
47015,1,2,164322,164324,164326,2,4,0
47016,3,3,164325,164326,164329,1,4,0
47017,3,1,164328,164329,164330,1,2,0
47018,1,3,164329,164330,164333,1,4,0
47019,2,3,164331,164333,164336,2,5,0
47020,5,3,164336,164336,164339,0,3,0
47021,5,3,164341,164341,164344,0,3,2
47022,6,3,164347,164347,164350,0,3,3
47023,3,3,164350,164350,164353,0,3,0
47024,4,3,164354,164354,164357,0,3,1
47025,1,2,164355,164357,164359,2,4,0
47026,1,2,164356,164359,164361,3,5,0
47027,4,2,164360,164361,164363,1,3,0
47028,3,1,164363,164363,164364,0,1,0
47029,6,2,164369,164369,164371,0,2,5
47030,1,3,164370,164371,164374,1,4,0
47031,1,2,164371,164374,164376,3,5,0
47032,6,2,164377,164377,164379,0,2,1
47033,1,3,164378,164379,164382,1,4,0
47034,2,3,164380,164382,164385,2,5,0
47035,4,1,164384,164385,164386,1,2,0
47036,3,2,164387,164387,164389,0,2,1
47037,1,2,164388,164389,164391,1,3,0
47038,5,3,164393,164393,164396,0,3,2
47039,1,1,164394,164396,164397,2,3,0
47040,4,1,164398,164398,164399,0,1,1
47041,4,1,164402,164402,164403,0,1,3
47042,2,2,164404,164404,164406,0,2,1
47043,2,1,164406,164406,164407,0,1,0
47044,3,3,164409,164409,164412,0,3,2
47045,4,2,164413,164413,164415,0,2,1
47046,2,3,164415,164415,164418,0,3,0
47047,4,3,164419,164419,164422,0,3,1
47048,3,1,164422,164422,164423,0,1,0
47049,3,3,164425,164425,164428,0,3,2
47050,6,3,164431,164431,164434,0,3,3
47051,6,3,164437,164437,164440,0,3,3
47052,3,1,164440,164440,164441,0,1,0
47053,6,3,164446,164446,164449,0,3,5
47054,4,2,164450,164450,164452,0,2,1
47055,6,1,164456,164456,164457,0,1,4
47056,6,3,164462,164462,164465,0,3,5
47057,2,1,164464,164465,164466,1,2,0
47058,6,2,164470,164470,164472,0,2,4
47059,4,2,164474,164474,164476,0,2,2
47060,1,3,164475,164476,164479,1,4,0
47061,4,3,164479,164479,164482,0,3,0
47062,3,2,164482,164482,164484,0,2,0
47063,5,2,164487,164487,164489,0,2,3
47064,5,3,164492,164492,164495,0,3,3
47065,1,1,164493,164495,164496,2,3,0
47066,6,3,164499,164499,164502,0,3,3
47067,4,2,164503,164503,164505,0,2,1
47068,1,3,164504,164505,164508,1,4,0
47069,2,1,164506,164508,164509,2,3,0
47070,6,1,164512,164512,164513,0,1,3
47071,5,3,164517,164517,164520,0,3,4
47072,2,3,164519,164520,164523,1,4,0
47073,1,1,164520,164523,164524,3,4,0
47074,3,1,164523,164524,164525,1,2,0
47075,6,2,164529,164529,164531,0,2,4
47076,6,2,164535,164535,164537,0,2,4
47077,6,3,164541,164541,164544,0,3,4
47078,6,3,164547,164547,164550,0,3,3
47079,6,1,164553,164553,164554,0,1,3
47080,3,1,164556,164556,164557,0,1,2
47081,2,2,164558,164558,164560,0,2,1
47082,4,1,164562,164562,164563,0,1,2
47083,2,2,164564,164564,164566,0,2,1
47084,3,1,164567,164567,164568,0,1,1
47085,3,1,164570,164570,164571,0,1,2
47086,6,1,164576,164576,164577,0,1,5
47087,3,1,164579,164579,164580,0,1,2
47088,6,2,164585,164585,164587,0,2,5
47089,5,1,164590,164590,164591,0,1,3
47090,4,3,164594,164594,164597,0,3,3
47091,1,2,164595,164597,164599,2,4,0
47092,2,3,164597,164599,164602,2,5,0
47093,5,3,164602,164602,164605,0,3,0
47094,2,2,164604,164605,164607,1,3,0
47095,4,3,164608,164608,164611,0,3,1
47096,6,3,164614,164614,164617,0,3,3
47097,3,2,164617,164617,164619,0,2,0
47098,3,2,164620,164620,164622,0,2,1
47099,1,1,164621,164622,164623,1,2,0
47100,1,1,164622,164623,164624,1,2,0
47101,4,2,164626,164626,164628,0,2,2
47102,5,2,164631,164631,164633,0,2,3
47103,4,1,164635,164635,164636,0,1,2
47104,3,2,164638,164638,164640,0,2,2
47105,1,1,164639,164640,164641,1,2,0
47106,6,2,164645,164645,164647,0,2,4
47107,5,1,164650,164650,164651,0,1,3
47108,2,2,164652,164652,164654,0,2,1
47109,1,1,164653,164654,164655,1,2,0
47110,3,1,164656,164656,164657,0,1,1
47111,2,2,164658,164658,164660,0,2,1
47112,1,3,164659,164660,164663,1,4,0
47113,3,1,164662,164663,164664,1,2,0
47114,3,3,164665,164665,164668,0,3,1
47115,2,1,164667,164668,164669,1,2,0
47116,2,3,164669,164669,164672,0,3,0
47117,5,1,164674,164674,164675,0,1,2
47118,1,1,164675,164675,164676,0,1,0
47119,6,3,164681,164681,164684,0,3,5
47120,3,3,164684,164684,164687,0,3,0
47121,2,2,164686,164687,164689,1,3,0
47122,6,2,164692,164692,164694,0,2,3
47123,1,3,164693,164694,164697,1,4,0
47124,1,3,164694,164697,164700,3,6,0
47125,4,3,164698,164700,164703,2,5,0
47126,4,2,164702,164703,164705,1,3,0
47127,5,1,164707,164707,164708,0,1,2
47128,1,1,164708,164708,164709,0,1,0
47129,6,2,164714,164714,164716,0,2,5
47130,2,2,164716,164716,164718,0,2,0
47131,1,1,164717,164718,164719,1,2,0
47132,1,3,164718,164719,164722,1,4,0
47133,1,3,164719,164722,164725,3,6,0
47134,3,1,164722,164725,164726,3,4,0
47135,4,1,164726,164726,164727,0,1,0
47136,3,2,164729,164729,164731,0,2,2
47137,6,3,164735,164735,164738,0,3,4
47138,5,1,164740,164740,164741,0,1,2
47139,4,1,164744,164744,164745,0,1,3
47140,2,3,164746,164746,164749,0,3,1
47141,4,1,164750,164750,164751,0,1,1
47142,5,1,164755,164755,164756,0,1,4
47143,1,2,164756,164756,164758,0,2,0
47144,1,3,164757,164758,164761,1,4,0
47145,5,2,164762,164762,164764,0,2,1
47146,1,1,164763,164764,164765,1,2,0
47147,5,3,164768,164768,164771,0,3,3
47148,2,3,164770,164771,164774,1,4,0
47149,1,3,164771,164774,164777,3,6,0
47150,2,2,164773,164777,164779,4,6,0
47151,4,1,164777,164779,164780,2,3,0
47152,2,1,164779,164780,164781,1,2,0
47153,2,3,164781,164781,164784,0,3,0
47154,3,3,164784,164784,164787,0,3,0
47155,1,3,164785,164787,164790,2,5,0
47156,1,2,164786,164790,164792,4,6,0
47157,2,3,164788,164792,164795,4,7,0
47158,5,1,164793,164795,164796,2,3,0
47159,1,2,164794,164796,164798,2,4,0
47160,6,3,164800,164800,164803,0,3,2
47161,4,1,164804,164804,164805,0,1,1
47162,3,3,164807,164807,164810,0,3,2
47163,5,3,164812,164812,164815,0,3,2
47164,4,3,164816,164816,164819,0,3,1
47165,4,1,164820,164820,164821,0,1,1
47166,6,3,164826,164826,164829,0,3,5
47167,3,2,164829,164829,164831,0,2,0
47168,3,2,164832,164832,164834,0,2,1
47169,6,2,164838,164838,164840,0,2,4
47170,1,3,164839,164840,164843,1,4,0
47171,2,1,164841,164843,164844,2,3,0
47172,1,2,164842,164844,164846,2,4,0
47173,2,3,164844,164846,164849,2,5,0
47174,2,1,164846,164849,164850,3,4,0
47175,1,1,164847,164850,164851,3,4,0
47176,5,2,164852,164852,164854,0,2,1
47177,6,1,164858,164858,164859,0,1,4
47178,3,2,164861,164861,164863,0,2,2
47179,3,2,164864,164864,164866,0,2,1
47180,4,1,164868,164868,164869,0,1,2
47181,6,3,164874,164874,164877,0,3,5
47182,4,1,164878,164878,164879,0,1,1
47183,3,1,164881,164881,164882,0,1,2
47184,2,1,164883,164883,164884,0,1,1
47185,6,1,164889,164889,164890,0,1,5
47186,1,2,164890,164890,164892,0,2,0
47187,3,1,164893,164893,164894,0,1,1
47188,6,1,164899,164899,164900,0,1,5
47189,4,2,164903,164903,164905,0,2,3
47190,5,1,164908,164908,164909,0,1,3
47191,1,2,164909,164909,164911,0,2,0
47192,5,3,164914,164914,164917,0,3,3
47193,5,2,164919,164919,164921,0,2,2
47194,2,3,164921,164921,164924,0,3,0
47195,3,2,164924,164924,164926,0,2,0
47196,5,1,164929,164929,164930,0,1,3
47197,6,1,164935,164935,164936,0,1,5
47198,2,1,164937,164937,164938,0,1,1
47199,5,3,164942,164942,164945,0,3,4
47200,6,3,164948,164948,164951,0,3,3
47201,1,3,164949,164951,164954,2,5,0
47202,2,3,164951,164954,164957,3,6,0
47203,2,2,164953,164957,164959,4,6,0
47204,4,1,164957,164959,164960,2,3,0
47205,2,2,164959,164960,164962,1,3,0
47206,5,2,164964,164964,164966,0,2,2
47207,2,3,164966,164966,164969,0,3,0
47208,3,3,164969,164969,164972,0,3,0
47209,2,1,164971,164972,164973,1,2,0
47210,4,3,164975,164975,164978,0,3,2
47211,6,1,164981,164981,164982,0,1,3
47212,3,2,164984,164984,164986,0,2,2
47213,2,2,164986,164986,164988,0,2,0
47214,3,1,164989,164989,164990,0,1,1
47215,2,3,164991,164991,164994,0,3,1
47216,5,2,164996,164996,164998,0,2,2
47217,6,1,165002,165002,165003,0,1,4
47218,5,3,165007,165007,165010,0,3,4
47219,2,2,165009,165010,165012,1,3,0
47220,4,3,165013,165013,165016,0,3,1
47221,3,3,165016,165016,165019,0,3,0
47222,4,3,165020,165020,165023,0,3,1
47223,5,2,165025,165025,165027,0,2,2
47224,3,2,165028,165028,165030,0,2,1
47225,2,1,165030,165030,165031,0,1,0
47226,3,2,165033,165033,165035,0,2,2
47227,4,1,165037,165037,165038,0,1,2
47228,5,1,165042,165042,165043,0,1,4
47229,1,1,165043,165043,165044,0,1,0
47230,3,1,165046,165046,165047,0,1,2
47231,3,1,165049,165049,165050,0,1,2
47232,5,3,165054,165054,165057,0,3,4
47233,1,3,165055,165057,165060,2,5,0
47234,3,3,165058,165060,165063,2,5,0
47235,1,1,165059,165063,165064,4,5,0
47236,2,2,165061,165064,165066,3,5,0
47237,1,2,165062,165066,165068,4,6,0
47238,6,1,165068,165068,165069,0,1,0
47239,6,1,165074,165074,165075,0,1,5
47240,4,2,165078,165078,165080,0,2,3
47241,2,1,165080,165080,165081,0,1,0
47242,1,2,165081,165081,165083,0,2,0
47243,2,2,165083,165083,165085,0,2,0
47244,5,1,165088,165088,165089,0,1,3
47245,6,1,165094,165094,165095,0,1,5
47246,6,2,165100,165100,165102,0,2,5
47247,5,2,165105,165105,165107,0,2,3
47248,3,3,165108,165108,165111,0,3,1
47249,2,2,165110,165111,165113,1,3,0
47250,5,2,165115,165115,165117,0,2,2
47251,2,3,165117,165117,165120,0,3,0
47252,3,2,165120,165120,165122,0,2,0
47253,5,1,165125,165125,165126,0,1,3
47254,2,3,165127,165127,165130,0,3,1
47255,3,1,165130,165130,165131,0,1,0
47256,5,3,165135,165135,165138,0,3,4
47257,5,1,165140,165140,165141,0,1,2
47258,5,1,165145,165145,165146,0,1,4
47259,4,2,165149,165149,165151,0,2,3
47260,4,1,165153,165153,165154,0,1,2
47261,3,1,165156,165156,165157,0,1,2
47262,3,1,165159,165159,165160,0,1,2
47263,1,1,165160,165160,165161,0,1,0
47264,2,2,165162,165162,165164,0,2,1
47265,1,1,165163,165164,165165,1,2,0
47266,4,1,165167,165167,165168,0,1,2
47267,6,2,165173,165173,165175,0,2,5
47268,5,2,165178,165178,165180,0,2,3
47269,4,3,165182,165182,165185,0,3,2
47270,2,1,165184,165185,165186,1,2,0
47271,4,2,165188,165188,165190,0,2,2
47272,6,1,165194,165194,165195,0,1,4
47273,4,1,165198,165198,165199,0,1,3
47274,6,2,165204,165204,165206,0,2,5
47275,3,3,165207,165207,165210,0,3,1
47276,5,1,165212,165212,165213,0,1,2
47277,3,2,165215,165215,165217,0,2,2
47278,4,3,165219,165219,165222,0,3,2
47279,1,3,165220,165222,165225,2,5,0
47280,4,2,165224,165225,165227,1,3,0
47281,5,3,165229,165229,165232,0,3,2
47282,1,1,165230,165232,165233,2,3,0
47283,2,3,165232,165233,165236,1,4,0
47284,2,1,165234,165236,165237,2,3,0
47285,3,1,165237,165237,165238,0,1,0
47286,5,1,165242,165242,165243,0,1,4
47287,5,1,165247,165247,165248,0,1,4
47288,6,3,165253,165253,165256,0,3,5
47289,4,2,165257,165257,165259,0,2,1
47290,1,3,165258,165259,165262,1,4,0
47291,5,1,165263,165263,165264,0,1,1
47292,2,2,165265,165265,165267,0,2,1
47293,4,2,165269,165269,165271,0,2,2
47294,4,1,165273,165273,165274,0,1,2
47295,1,2,165274,165274,165276,0,2,0
47296,4,1,165278,165278,165279,0,1,2
47297,6,3,165284,165284,165287,0,3,5
47298,3,1,165287,165287,165288,0,1,0
47299,2,2,165289,165289,165291,0,2,1
47300,2,1,165291,165291,165292,0,1,0
47301,4,2,165295,165295,165297,0,2,3
47302,5,2,165300,165300,165302,0,2,3
47303,3,2,165303,165303,165305,0,2,1
47304,2,2,165305,165305,165307,0,2,0
47305,2,1,165307,165307,165308,0,1,0
47306,5,2,165312,165312,165314,0,2,4
47307,6,3,165318,165318,165321,0,3,4
47308,5,1,165323,165323,165324,0,1,2
47309,1,2,165324,165324,165326,0,2,0
47310,5,2,165329,165329,165331,0,2,3
47311,4,2,165333,165333,165335,0,2,2
47312,1,2,165334,165335,165337,1,3,0
47313,2,3,165336,165337,165340,1,4,0
47314,5,1,165341,165341,165342,0,1,1
47315,3,1,165344,165344,165345,0,1,2
47316,4,2,165348,165348,165350,0,2,3
47317,2,2,165350,165350,165352,0,2,0
47318,2,3,165352,165352,165355,0,3,0
47319,5,3,165357,165357,165360,0,3,2
47320,4,3,165361,165361,165364,0,3,1
47321,4,1,165365,165365,165366,0,1,1
47322,3,2,165368,165368,165370,0,2,2
47323,2,3,165370,165370,165373,0,3,0
47324,3,2,165373,165373,165375,0,2,0
47325,3,2,165376,165376,165378,0,2,1
47326,5,3,165381,165381,165384,0,3,3
47327,6,2,165387,165387,165389,0,2,3
47328,1,2,165388,165389,165391,1,3,0
47329,4,3,165392,165392,165395,0,3,1
47330,5,2,165397,165397,165399,0,2,2
47331,2,1,165399,165399,165400,0,1,0
47332,6,3,165405,165405,165408,0,3,5
47333,5,1,165410,165410,165411,0,1,2
47334,1,1,165411,165411,165412,0,1,0
47335,5,2,165416,165416,165418,0,2,4
47336,2,3,165418,165418,165421,0,3,0
47337,4,2,165422,165422,165424,0,2,1
47338,5,2,165427,165427,165429,0,2,3
47339,4,3,165431,165431,165434,0,3,2
47340,1,3,165432,165434,165437,2,5,0
47341,3,3,165435,165437,165440,2,5,0
47342,3,3,165438,165440,165443,2,5,0
47343,3,2,165441,165443,165445,2,4,0
47344,6,3,165447,165447,165450,0,3,2
47345,1,1,165448,165450,165451,2,3,0
47346,6,3,165454,165454,165457,0,3,3
47347,3,1,165457,165457,165458,0,1,0
47348,2,2,165459,165459,165461,0,2,1
47349,4,3,165463,165463,165466,0,3,2
47350,2,2,165465,165466,165468,1,3,0
47351,4,3,165469,165469,165472,0,3,1
47352,2,3,165471,165472,165475,1,4,0
47353,2,3,165473,165475,165478,2,5,0
47354,1,3,165474,165478,165481,4,7,0
47355,3,3,165477,165481,165484,4,7,0
47356,5,1,165482,165484,165485,2,3,0
47357,2,1,165484,165485,165486,1,2,0
47358,3,2,165487,165487,165489,0,2,1
47359,3,1,165490,165490,165491,0,1,1
47360,6,2,165496,165496,165498,0,2,5
47361,1,1,165497,165498,165499,1,2,0
47362,3,2,165500,165500,165502,0,2,1
47363,3,1,165503,165503,165504,0,1,1
47364,1,2,165504,165504,165506,0,2,0
47365,3,1,165507,165507,165508,0,1,1
47366,3,3,165510,165510,165513,0,3,2
47367,5,3,165515,165515,165518,0,3,2
47368,4,1,165519,165519,165520,0,1,1
47369,1,2,165520,165520,165522,0,2,0
47370,4,3,165524,165524,165527,0,3,2
47371,4,1,165528,165528,165529,0,1,1
47372,3,1,165531,165531,165532,0,1,2
47373,1,1,165532,165532,165533,0,1,0
47374,1,2,165533,165533,165535,0,2,0
47375,3,1,165536,165536,165537,0,1,1
47376,5,2,165541,165541,165543,0,2,4
47377,6,2,165547,165547,165549,0,2,4
47378,2,1,165549,165549,165550,0,1,0
47379,2,2,165551,165551,165553,0,2,1
47380,4,3,165555,165555,165558,0,3,2
47381,3,3,165558,165558,165561,0,3,0
47382,3,3,165561,165561,165564,0,3,0
47383,5,3,165566,165566,165569,0,3,2
47384,1,2,165567,165569,165571,2,4,0
47385,3,2,165570,165571,165573,1,3,0
47386,6,1,165576,165576,165577,0,1,3
47387,6,3,165582,165582,165585,0,3,5
47388,5,3,165587,165587,165590,0,3,2
47389,3,2,165590,165590,165592,0,2,0
47390,1,1,165591,165592,165593,1,2,0
47391,6,2,165597,165597,165599,0,2,4
47392,5,1,165602,165602,165603,0,1,3
47393,6,3,165608,165608,165611,0,3,5
47394,4,2,165612,165612,165614,0,2,1
47395,1,3,165613,165614,165617,1,4,0
47396,5,3,165618,165618,165621,0,3,1
47397,6,3,165624,165624,165627,0,3,3
47398,2,2,165626,165627,165629,1,3,0
47399,4,3,165630,165630,165633,0,3,1
47400,2,3,165632,165633,165636,1,4,0
47401,4,3,165636,165636,165639,0,3,0
47402,6,3,165642,165642,165645,0,3,3
47403,3,2,165645,165645,165647,0,2,0
47404,3,2,165648,165648,165650,0,2,1
47405,3,3,165651,165651,165654,0,3,1
47406,5,3,165656,165656,165659,0,3,2
47407,3,2,165659,165659,165661,0,2,0
47408,5,2,165664,165664,165666,0,2,3
47409,2,3,165666,165666,165669,0,3,0
47410,2,3,165668,165669,165672,1,4,0
47411,3,3,165671,165672,165675,1,4,0
47412,5,2,165676,165676,165678,0,2,1
47413,1,3,165677,165678,165681,1,4,0
47414,5,3,165682,165682,165685,0,3,1
47415,2,3,165684,165685,165688,1,4,0
47416,2,1,165686,165688,165689,2,3,0
47417,2,3,165688,165689,165692,1,4,0
47418,1,3,165689,165692,165695,3,6,0
47419,1,1,165690,165695,165696,5,6,0
47420,3,2,165693,165696,165698,3,5,0
47421,5,2,165698,165698,165700,0,2,0
47422,6,3,165704,165704,165707,0,3,4
47423,6,3,165710,165710,165713,0,3,3
47424,6,1,165716,165716,165717,0,1,3
47425,1,2,165717,165717,165719,0,2,0
47426,5,2,165722,165722,165724,0,2,3
47427,5,3,165727,165727,165730,0,3,3
47428,1,2,165728,165730,165732,2,4,0
47429,5,3,165733,165733,165736,0,3,1
47430,1,1,165734,165736,165737,2,3,0
47431,6,1,165740,165740,165741,0,1,3
47432,2,3,165742,165742,165745,0,3,1
47433,5,3,165747,165747,165750,0,3,2
47434,3,1,165750,165750,165751,0,1,0
47435,3,2,165753,165753,165755,0,2,2
47436,3,1,165756,165756,165757,0,1,1
47437,3,3,165759,165759,165762,0,3,2
47438,4,2,165763,165763,165765,0,2,1
47439,6,1,165769,165769,165770,0,1,4
47440,6,3,165775,165775,165778,0,3,5
47441,1,3,165776,165778,165781,2,5,0
47442,1,3,165777,165781,165784,4,7,0
47443,4,1,165781,165784,165785,3,4,0
47444,3,2,165784,165785,165787,1,3,0
47445,6,3,165790,165790,165793,0,3,3
47446,2,1,165792,165793,165794,1,2,0
47447,2,1,165794,165794,165795,0,1,0
47448,5,2,165799,165799,165801,0,2,4
47449,6,3,165805,165805,165808,0,3,4
47450,5,2,165810,165810,165812,0,2,2
47451,2,1,165812,165812,165813,0,1,0
47452,3,2,165815,165815,165817,0,2,2
47453,2,3,165817,165817,165820,0,3,0
47454,4,3,165821,165821,165824,0,3,1
47455,4,3,165825,165825,165828,0,3,1
47456,4,2,165829,165829,165831,0,2,1
47457,6,2,165835,165835,165837,0,2,4
47458,4,2,165839,165839,165841,0,2,2
47459,4,2,165843,165843,165845,0,2,2
47460,4,2,165847,165847,165849,0,2,2
47461,6,1,165853,165853,165854,0,1,4
47462,6,2,165859,165859,165861,0,2,5
47463,4,1,165863,165863,165864,0,1,2
47464,6,3,165869,165869,165872,0,3,5
47465,2,2,165871,165872,165874,1,3,0
47466,2,1,165873,165874,165875,1,2,0
47467,5,1,165878,165878,165879,0,1,3
47468,4,2,165882,165882,165884,0,2,3
47469,1,1,165883,165884,165885,1,2,0
47470,6,1,165889,165889,165890,0,1,4
47471,1,3,165890,165890,165893,0,3,0
47472,3,1,165893,165893,165894,0,1,0
47473,1,2,165894,165894,165896,0,2,0
47474,1,1,165895,165896,165897,1,2,0
47475,2,2,165897,165897,165899,0,2,0
47476,4,3,165901,165901,165904,0,3,2
47477,2,2,165903,165904,165906,1,3,0
47478,2,3,165905,165906,165909,1,4,0
47479,2,3,165907,165909,165912,2,5,0
47480,1,2,165908,165912,165914,4,6,0
47481,6,1,165914,165914,165915,0,1,0
47482,3,2,165917,165917,165919,0,2,2
47483,4,1,165921,165921,165922,0,1,2
47484,5,2,165926,165926,165928,0,2,4
47485,6,3,165932,165932,165935,0,3,4
47486,5,1,165937,165937,165938,0,1,2
47487,5,3,165942,165942,165945,0,3,4
47488,2,2,165944,165945,165947,1,3,0
47489,2,2,165946,165947,165949,1,3,0
47490,2,2,165948,165949,165951,1,3,0
47491,1,1,165949,165951,165952,2,3,0
47492,3,1,165952,165952,165953,0,1,0
47493,5,2,165957,165957,165959,0,2,4
47494,5,2,165962,165962,165964,0,2,3
47495,3,2,165965,165965,165967,0,2,1
47496,3,2,165968,165968,165970,0,2,1
47497,5,2,165973,165973,165975,0,2,3
47498,1,1,165974,165975,165976,1,2,0
47499,3,2,165977,165977,165979,0,2,1
47500,3,3,165980,165980,165983,0,3,1
47501,3,2,165983,165983,165985,0,2,0
47502,3,3,165986,165986,165989,0,3,1
47503,5,2,165991,165991,165993,0,2,2
47504,4,1,165995,165995,165996,0,1,2
47505,5,2,166000,166000,166002,0,2,4
47506,3,3,166003,166003,166006,0,3,1
47507,5,1,166008,166008,166009,0,1,2
47508,4,2,166012,166012,166014,0,2,3
47509,4,1,166016,166016,166017,0,1,2
47510,2,2,166018,166018,166020,0,2,1
47511,5,1,166023,166023,166024,0,1,3
47512,4,2,166027,166027,166029,0,2,3
47513,1,2,166028,166029,166031,1,3,0
47514,4,3,166032,166032,166035,0,3,1
47515,2,2,166034,166035,166037,1,3,0
47516,3,3,166037,166037,166040,0,3,0
47517,3,1,166040,166040,166041,0,1,0
47518,1,2,166041,166041,166043,0,2,0
47519,5,2,166046,166046,166048,0,2,3
47520,5,2,166051,166051,166053,0,2,3
47521,6,3,166057,166057,166060,0,3,4
47522,6,1,166063,166063,166064,0,1,3
47523,6,3,166069,166069,166072,0,3,5
47524,2,1,166071,166072,166073,1,2,0
47525,4,3,166075,166075,166078,0,3,2
47526,3,3,166078,166078,166081,0,3,0
47527,3,2,166081,166081,166083,0,2,0
47528,4,2,166085,166085,166087,0,2,2
47529,4,2,166089,166089,166091,0,2,2
47530,2,1,166091,166091,166092,0,1,0
47531,2,2,166093,166093,166095,0,2,1
47532,2,1,166095,166095,166096,0,1,0
47533,2,3,166097,166097,166100,0,3,1
47534,6,3,166103,166103,166106,0,3,3
47535,4,1,166107,166107,166108,0,1,1
47536,6,1,166113,166113,166114,0,1,5
47537,1,1,166114,166114,166115,0,1,0
47538,3,1,166117,166117,166118,0,1,2
47539,3,3,166120,166120,166123,0,3,2
47540,2,2,166122,166123,166125,1,3,0
47541,5,3,166127,166127,166130,0,3,2
47542,3,1,166130,166130,166131,0,1,0
47543,5,1,166135,166135,166136,0,1,4
47544,1,1,166136,166136,166137,0,1,0
47545,5,1,166141,166141,166142,0,1,4
47546,2,3,166143,166143,166146,0,3,1
47547,6,3,166149,166149,166152,0,3,3
47548,1,1,166150,166152,166153,2,3,0
47549,4,1,166154,166154,166155,0,1,1
47550,4,2,166158,166158,166160,0,2,3
47551,3,1,166161,166161,166162,0,1,1
47552,3,1,166164,166164,166165,0,1,2
47553,4,1,166168,166168,166169,0,1,3
47554,3,1,166171,166171,166172,0,1,2
47555,4,1,166175,166175,166176,0,1,3
47556,2,3,166177,166177,166180,0,3,1
47557,6,1,166183,166183,166184,0,1,3
47558,4,3,166187,166187,166190,0,3,3
47559,4,3,166191,166191,166194,0,3,1
47560,2,3,166193,166194,166197,1,4,0
47561,2,2,166195,166197,166199,2,4,0
47562,1,2,166196,166199,166201,3,5,0
47563,6,2,166202,166202,166204,0,2,1
47564,3,1,166205,166205,166206,0,1,1
47565,2,3,166207,166207,166210,0,3,1
47566,5,1,166212,166212,166213,0,1,2
47567,1,1,166213,166213,166214,0,1,0
47568,2,2,166215,166215,166217,0,2,1
47569,3,1,166218,166218,166219,0,1,1
47570,1,1,166219,166219,166220,0,1,0
47571,6,3,166225,166225,166228,0,3,5
47572,3,2,166228,166228,166230,0,2,0
47573,4,2,166232,166232,166234,0,2,2
47574,1,2,166233,166234,166236,1,3,0
47575,3,1,166236,166236,166237,0,1,0
47576,1,2,166237,166237,166239,0,2,0
47577,2,2,166239,166239,166241,0,2,0
47578,6,3,166245,166245,166248,0,3,4
47579,2,1,166247,166248,166249,1,2,0
47580,6,2,166253,166253,166255,0,2,4
47581,6,1,166259,166259,166260,0,1,4
47582,2,2,166261,166261,166263,0,2,1
47583,2,1,166263,166263,166264,0,1,0
47584,4,1,166267,166267,166268,0,1,3
47585,4,2,166271,166271,166273,0,2,3
47586,6,1,166277,166277,166278,0,1,4
47587,5,2,166282,166282,166284,0,2,4
47588,3,3,166285,166285,166288,0,3,1
47589,2,3,166287,166288,166291,1,4,0
47590,2,2,166289,166291,166293,2,4,0
47591,4,2,166293,166293,166295,0,2,0
47592,4,2,166297,166297,166299,0,2,2
47593,4,1,166301,166301,166302,0,1,2
47594,2,3,166303,166303,166306,0,3,1
47595,5,3,166308,166308,166311,0,3,2
47596,2,3,166310,166311,166314,1,4,0
47597,1,3,166311,166314,166317,3,6,0
47598,6,2,166317,166317,166319,0,2,0
47599,2,2,166319,166319,166321,0,2,0
47600,1,3,166320,166321,166324,1,4,0
47601,3,1,166323,166324,166325,1,2,0
47602,3,3,166326,166326,166329,0,3,1
47603,2,3,166328,166329,166332,1,4,0
47604,5,1,166333,166333,166334,0,1,1
47605,1,3,166334,166334,166337,0,3,0
47606,3,3,166337,166337,166340,0,3,0
47607,4,2,166341,166341,166343,0,2,1
47608,1,2,166342,166343,166345,1,3,0
47609,2,1,166344,166345,166346,1,2,0
47610,3,1,166347,166347,166348,0,1,1
47611,6,2,166353,166353,166355,0,2,5
47612,5,2,166358,166358,166360,0,2,3
47613,6,3,166364,166364,166367,0,3,4
47614,4,3,166368,166368,166371,0,3,1
47615,6,3,166374,166374,166377,0,3,3
47616,6,3,166380,166380,166383,0,3,3
47617,6,1,166386,166386,166387,0,1,3
47618,2,3,166388,166388,166391,0,3,1
47619,6,3,166394,166394,166397,0,3,3
47620,5,1,166399,166399,166400,0,1,2
47621,4,3,166403,166403,166406,0,3,3
47622,3,1,166406,166406,166407,0,1,0
47623,6,3,166412,166412,166415,0,3,5
47624,4,3,166416,166416,166419,0,3,1
47625,2,1,166418,166419,166420,1,2,0
47626,4,2,166422,166422,166424,0,2,2
47627,5,1,166427,166427,166428,0,1,3
47628,1,3,166428,166428,166431,0,3,0
47629,5,2,166433,166433,166435,0,2,2
47630,4,3,166437,166437,166440,0,3,2
47631,4,2,166441,166441,166443,0,2,1
47632,5,3,166446,166446,166449,0,3,3
47633,3,1,166449,166449,166450,0,1,0
47634,5,3,166454,166454,166457,0,3,4
47635,5,1,166459,166459,166460,0,1,2
47636,4,3,166463,166463,166466,0,3,3
47637,2,3,166465,166466,166469,1,4,0
47638,1,3,166466,166469,166472,3,6,0
47639,6,2,166472,166472,166474,0,2,0
47640,6,2,166478,166478,166480,0,2,4
47641,5,3,166483,166483,166486,0,3,3
47642,6,2,166489,166489,166491,0,2,3
47643,6,1,166495,166495,166496,0,1,4
47644,2,1,166497,166497,166498,0,1,1
47645,2,3,166499,166499,166502,0,3,1
47646,5,2,166504,166504,166506,0,2,2
47647,3,3,166507,166507,166510,0,3,1
47648,1,3,166508,166510,166513,2,5,0
47649,4,3,166512,166513,166516,1,4,0
47650,2,2,166514,166516,166518,2,4,0
47651,5,2,166519,166519,166521,0,2,1
47652,4,1,166523,166523,166524,0,1,2
47653,5,2,166528,166528,166530,0,2,4
47654,2,2,166530,166530,166532,0,2,0
47655,4,1,166534,166534,166535,0,1,2
47656,6,2,166540,166540,166542,0,2,5
47657,6,1,166546,166546,166547,0,1,4
47658,2,3,166548,166548,166551,0,3,1
47659,2,1,166550,166551,166552,1,2,0
47660,5,2,166555,166555,166557,0,2,3
47661,1,3,166556,166557,166560,1,4,0
47662,3,1,166559,166560,166561,1,2,0
47663,2,3,166561,166561,166564,0,3,0
47664,1,3,166562,166564,166567,2,5,0
47665,5,2,166567,166567,166569,0,2,0
47666,5,2,166572,166572,166574,0,2,3
47667,4,2,166576,166576,166578,0,2,2
47668,4,2,166580,166580,166582,0,2,2
47669,1,1,166581,166582,166583,1,2,0
47670,6,2,166587,166587,166589,0,2,4
47671,3,2,166590,166590,166592,0,2,1
47672,3,2,166593,166593,166595,0,2,1
47673,5,3,166598,166598,166601,0,3,3
47674,3,2,166601,166601,166603,0,2,0
47675,1,1,166602,166603,166604,1,2,0
47676,4,3,166606,166606,166609,0,3,2
47677,4,1,166610,166610,166611,0,1,1
47678,4,2,166614,166614,166616,0,2,3
47679,6,3,166620,166620,166623,0,3,4
47680,6,2,166626,166626,166628,0,2,3
47681,5,2,166631,166631,166633,0,2,3
47682,6,3,166637,166637,166640,0,3,4
47683,6,1,166643,166643,166644,0,1,3
47684,3,2,166646,166646,166648,0,2,2
47685,4,2,166650,166650,166652,0,2,2
47686,4,3,166654,166654,166657,0,3,2
47687,4,2,166658,166658,166660,0,2,1
47688,1,3,166659,166660,166663,1,4,0
47689,3,2,166662,166663,166665,1,3,0
47690,5,1,166667,166667,166668,0,1,2
47691,2,3,166669,166669,166672,0,3,1
47692,6,1,166675,166675,166676,0,1,3
47693,5,2,166680,166680,166682,0,2,4
47694,5,3,166685,166685,166688,0,3,3
47695,1,2,166686,166688,166690,2,4,0
47696,2,2,166688,166690,166692,2,4,0
47697,3,1,166691,166692,166693,1,2,0
47698,5,2,166696,166696,166698,0,2,3
47699,3,2,166699,166699,166701,0,2,1
47700,5,2,166704,166704,166706,0,2,3
47701,1,1,166705,166706,166707,1,2,0
47702,1,1,166706,166707,166708,1,2,0
47703,4,2,166710,166710,166712,0,2,2
47704,5,3,166715,166715,166718,0,3,3
47705,1,3,166716,166718,166721,2,5,0
47706,5,3,166721,166721,166724,0,3,0
47707,1,2,166722,166724,166726,2,4,0
47708,3,2,166725,166726,166728,1,3,0
47709,2,3,166727,166728,166731,1,4,0
47710,6,1,166733,166733,166734,0,1,2
47711,5,2,166738,166738,166740,0,2,4
47712,3,3,166741,166741,166744,0,3,1
47713,5,2,166746,166746,166748,0,2,2
47714,3,3,166749,166749,166752,0,3,1
47715,6,2,166755,166755,166757,0,2,3
47716,3,1,166758,166758,166759,0,1,1
47717,6,1,166764,166764,166765,0,1,5
47718,1,3,166765,166765,166768,0,3,0
47719,3,1,166768,166768,166769,0,1,0
47720,4,2,166772,166772,166774,0,2,3
47721,4,1,166776,166776,166777,0,1,2
47722,2,1,166778,166778,166779,0,1,1
47723,1,2,166779,166779,166781,0,2,0
47724,6,2,166785,166785,166787,0,2,4
47725,1,2,166786,166787,166789,1,3,0
47726,4,2,166790,166790,166792,0,2,1
47727,4,2,166794,166794,166796,0,2,2
47728,1,2,166795,166796,166798,1,3,0
47729,2,1,166797,166798,166799,1,2,0
47730,6,1,166803,166803,166804,0,1,4
47731,6,1,166809,166809,166810,0,1,5
47732,1,2,166810,166810,166812,0,2,0
47733,3,3,166813,166813,166816,0,3,1
47734,5,1,166818,166818,166819,0,1,2
47735,4,1,166822,166822,166823,0,1,3
47736,2,2,166824,166824,166826,0,2,1
47737,4,3,166828,166828,166831,0,3,2
47738,1,3,166829,166831,166834,2,5,0
47739,3,3,166832,166834,166837,2,5,0
47740,2,1,166834,166837,166838,3,4,0
47741,5,3,166839,166839,166842,0,3,1
47742,2,2,166841,166842,166844,1,3,0
47743,2,1,166843,166844,166845,1,2,0
47744,2,3,166845,166845,166848,0,3,0
47745,6,3,166851,166851,166854,0,3,3
47746,2,3,166853,166854,166857,1,4,0
47747,2,2,166855,166857,166859,2,4,0
47748,4,3,166859,166859,166862,0,3,0
47749,1,3,166860,166862,166865,2,5,0
47750,2,3,166862,166865,166868,3,6,0
47751,2,1,166864,166868,166869,4,5,0
47752,4,2,166868,166869,166871,1,3,0
47753,6,1,166874,166874,166875,0,1,3
47754,4,2,166878,166878,166880,0,2,3
47755,6,1,166884,166884,166885,0,1,4
47756,1,3,166885,166885,166888,0,3,0
47757,1,1,166886,166888,166889,2,3,0
47758,2,2,166888,166889,166891,1,3,0
47759,3,1,166891,166891,166892,0,1,0
47760,3,3,166894,166894,166897,0,3,2
47761,6,2,166900,166900,166902,0,2,3
47762,5,3,166905,166905,166908,0,3,3
47763,3,2,166908,166908,166910,0,2,0
47764,1,1,166909,166910,166911,1,2,0
47765,1,3,166910,166911,166914,1,4,0
47766,3,1,166913,166914,166915,1,2,0
47767,2,1,166915,166915,166916,0,1,0
47768,6,1,166921,166921,166922,0,1,5
47769,5,1,166926,166926,166927,0,1,4
47770,2,2,166928,166928,166930,0,2,1
47771,1,3,166929,166930,166933,1,4,0
47772,4,1,166933,166933,166934,0,1,0
47773,4,3,166937,166937,166940,0,3,3
47774,3,3,166940,166940,166943,0,3,0
47775,3,3,166943,166943,166946,0,3,0
47776,1,3,166944,166946,166949,2,5,0
47777,5,2,166949,166949,166951,0,2,0
47778,4,1,166953,166953,166954,0,1,2
47779,2,1,166955,166955,166956,0,1,1
47780,2,3,166957,166957,166960,0,3,1
47781,6,2,166963,166963,166965,0,2,3
47782,1,1,166964,166965,166966,1,2,0
47783,6,2,166970,166970,166972,0,2,4
47784,6,2,166976,166976,166978,0,2,4
47785,6,3,166982,166982,166985,0,3,4
47786,5,3,166987,166987,166990,0,3,2
47787,3,3,166990,166990,166993,0,3,0
47788,2,3,166992,166993,166996,1,4,0
47789,4,2,166996,166996,166998,0,2,0
47790,4,1,167000,167000,167001,0,1,2
47791,6,2,167006,167006,167008,0,2,5
47792,5,2,167011,167011,167013,0,2,3
47793,5,1,167016,167016,167017,0,1,3
47794,5,2,167021,167021,167023,0,2,4
47795,3,2,167024,167024,167026,0,2,1
47796,5,1,167029,167029,167030,0,1,3
47797,6,2,167035,167035,167037,0,2,5
47798,6,1,167041,167041,167042,0,1,4
47799,5,2,167046,167046,167048,0,2,4
47800,6,1,167052,167052,167053,0,1,4
47801,5,1,167057,167057,167058,0,1,4
47802,4,3,167061,167061,167064,0,3,3
47803,3,3,167064,167064,167067,0,3,0
47804,1,1,167065,167067,167068,2,3,0
47805,3,2,167068,167068,167070,0,2,0
47806,4,2,167072,167072,167074,0,2,2
47807,3,1,167075,167075,167076,0,1,1
47808,5,2,167080,167080,167082,0,2,4
47809,2,2,167082,167082,167084,0,2,0
47810,3,3,167085,167085,167088,0,3,1
47811,3,3,167088,167088,167091,0,3,0
47812,1,2,167089,167091,167093,2,4,0
47813,4,1,167093,167093,167094,0,1,0
47814,5,3,167098,167098,167101,0,3,4
47815,2,3,167100,167101,167104,1,4,0
47816,6,2,167106,167106,167108,0,2,2
47817,1,1,167107,167108,167109,1,2,0
47818,3,2,167110,167110,167112,0,2,1
47819,2,3,167112,167112,167115,0,3,0
47820,4,3,167116,167116,167119,0,3,1
47821,3,1,167119,167119,167120,0,1,0
47822,1,3,167120,167120,167123,0,3,0
47823,3,3,167123,167123,167126,0,3,0
47824,1,3,167124,167126,167129,2,5,0
47825,4,2,167128,167129,167131,1,3,0
47826,5,1,167133,167133,167134,0,1,2
47827,1,3,167134,167134,167137,0,3,0
47828,5,1,167139,167139,167140,0,1,2
47829,2,1,167141,167141,167142,0,1,1
47830,6,1,167147,167147,167148,0,1,5
47831,1,1,167148,167148,167149,0,1,0
47832,2,3,167150,167150,167153,0,3,1
47833,5,3,167155,167155,167158,0,3,2
47834,2,3,167157,167158,167161,1,4,0
47835,5,2,167162,167162,167164,0,2,1
47836,2,3,167164,167164,167167,0,3,0
47837,1,1,167165,167167,167168,2,3,0
47838,5,3,167170,167170,167173,0,3,2
47839,1,2,167171,167173,167175,2,4,0
47840,2,1,167173,167175,167176,2,3,0
47841,5,2,167178,167178,167180,0,2,2
47842,2,2,167180,167180,167182,0,2,0
47843,2,1,167182,167182,167183,0,1,0
47844,5,2,167187,167187,167189,0,2,4
47845,3,2,167190,167190,167192,0,2,1
47846,2,3,167192,167192,167195,0,3,0
47847,4,3,167196,167196,167199,0,3,1
47848,2,1,167198,167199,167200,1,2,0
47849,2,1,167200,167200,167201,0,1,0
47850,2,3,167202,167202,167205,0,3,1
47851,6,1,167208,167208,167209,0,1,3
47852,3,3,167211,167211,167214,0,3,2
47853,6,1,167217,167217,167218,0,1,3
47854,6,3,167223,167223,167226,0,3,5
47855,6,2,167229,167229,167231,0,2,3
47856,6,1,167235,167235,167236,0,1,4
47857,2,3,167237,167237,167240,0,3,1
47858,5,3,167242,167242,167245,0,3,2
47859,4,1,167246,167246,167247,0,1,1
47860,3,2,167249,167249,167251,0,2,2
47861,4,2,167253,167253,167255,0,2,2
47862,1,3,167254,167255,167258,1,4,0
47863,3,3,167257,167258,167261,1,4,0
47864,6,1,167263,167263,167264,0,1,2
47865,5,3,167268,167268,167271,0,3,4
47866,6,1,167274,167274,167275,0,1,3
47867,5,3,167279,167279,167282,0,3,4
47868,5,3,167284,167284,167287,0,3,2
47869,4,2,167288,167288,167290,0,2,1
47870,3,3,167291,167291,167294,0,3,1
47871,2,3,167293,167294,167297,1,4,0
47872,4,3,167297,167297,167300,0,3,0
47873,2,3,167299,167300,167303,1,4,0
47874,5,2,167304,167304,167306,0,2,1
47875,5,3,167309,167309,167312,0,3,3
47876,5,2,167314,167314,167316,0,2,2
47877,4,3,167318,167318,167321,0,3,2
47878,4,1,167322,167322,167323,0,1,1
47879,2,1,167324,167324,167325,0,1,1
47880,3,2,167327,167327,167329,0,2,2
47881,6,3,167333,167333,167336,0,3,4
47882,5,1,167338,167338,167339,0,1,2
47883,1,3,167339,167339,167342,0,3,0
47884,4,2,167343,167343,167345,0,2,1
47885,6,2,167349,167349,167351,0,2,4
47886,4,1,167353,167353,167354,0,1,2
47887,5,3,167358,167358,167361,0,3,4
47888,4,2,167362,167362,167364,0,2,1
47889,4,2,167366,167366,167368,0,2,2
47890,3,1,167369,167369,167370,0,1,1
47891,2,1,167371,167371,167372,0,1,1
47892,2,3,167373,167373,167376,0,3,1
47893,3,2,167376,167376,167378,0,2,0
47894,5,3,167381,167381,167384,0,3,3
47895,2,1,167383,167384,167385,1,2,0
47896,5,3,167388,167388,167391,0,3,3
47897,5,1,167393,167393,167394,0,1,2
47898,6,3,167399,167399,167402,0,3,5
47899,6,3,167405,167405,167408,0,3,3
47900,6,2,167411,167411,167413,0,2,3
47901,4,2,167415,167415,167417,0,2,2
47902,6,2,167421,167421,167423,0,2,4
47903,5,1,167426,167426,167427,0,1,3
47904,4,1,167430,167430,167431,0,1,3
47905,3,3,167433,167433,167436,0,3,2
47906,2,1,167435,167436,167437,1,2,0
47907,3,1,167438,167438,167439,0,1,1
47908,2,2,167440,167440,167442,0,2,1
47909,6,1,167446,167446,167447,0,1,4
47910,2,1,167448,167448,167449,0,1,1
47911,4,3,167452,167452,167455,0,3,3
47912,5,1,167457,167457,167458,0,1,2
47913,1,3,167458,167458,167461,0,3,0
47914,5,2,167463,167463,167465,0,2,2
47915,1,1,167464,167465,167466,1,2,0
47916,3,2,167467,167467,167469,0,2,1
47917,6,2,167473,167473,167475,0,2,4
47918,5,1,167478,167478,167479,0,1,3
47919,5,2,167483,167483,167485,0,2,4
47920,5,1,167488,167488,167489,0,1,3
47921,4,3,167492,167492,167495,0,3,3
47922,3,3,167495,167495,167498,0,3,0
47923,3,2,167498,167498,167500,0,2,0
47924,4,3,167502,167502,167505,0,3,2
47925,4,1,167506,167506,167507,0,1,1
47926,2,1,167508,167508,167509,0,1,1
47927,2,2,167510,167510,167512,0,2,1
47928,1,3,167511,167512,167515,1,4,0
47929,6,3,167517,167517,167520,0,3,2
47930,6,3,167523,167523,167526,0,3,3
47931,6,2,167529,167529,167531,0,2,3
47932,2,3,167531,167531,167534,0,3,0
47933,3,1,167534,167534,167535,0,1,0
47934,6,1,167540,167540,167541,0,1,5
47935,6,1,167546,167546,167547,0,1,5
47936,3,1,167549,167549,167550,0,1,2
47937,5,2,167554,167554,167556,0,2,4
47938,1,3,167555,167556,167559,1,4,0
47939,2,3,167557,167559,167562,2,5,0
47940,3,3,167560,167562,167565,2,5,0
47941,6,1,167566,167566,167567,0,1,1
47942,4,1,167570,167570,167571,0,1,3
47943,1,1,167571,167571,167572,0,1,0
47944,6,1,167577,167577,167578,0,1,5
47945,3,1,167580,167580,167581,0,1,2
47946,3,1,167583,167583,167584,0,1,2
47947,4,1,167587,167587,167588,0,1,3
47948,2,3,167589,167589,167592,0,3,1
47949,3,3,167592,167592,167595,0,3,0
47950,3,1,167595,167595,167596,0,1,0
47951,4,3,167599,167599,167602,0,3,3
47952,6,1,167605,167605,167606,0,1,3
47953,6,3,167611,167611,167614,0,3,5
47954,4,2,167615,167615,167617,0,2,1
47955,5,2,167620,167620,167622,0,2,3
47956,3,3,167623,167623,167626,0,3,1
47957,5,3,167628,167628,167631,0,3,2
47958,2,2,167630,167631,167633,1,3,0
47959,4,1,167634,167634,167635,0,1,1
47960,4,1,167638,167638,167639,0,1,3
47961,1,3,167639,167639,167642,0,3,0
47962,6,2,167645,167645,167647,0,2,3
47963,4,2,167649,167649,167651,0,2,2
47964,1,1,167650,167651,167652,1,2,0
47965,2,1,167652,167652,167653,0,1,0
47966,5,3,167657,167657,167660,0,3,4
47967,1,2,167658,167660,167662,2,4,0
47968,3,2,167661,167662,167664,1,3,0
47969,3,2,167664,167664,167666,0,2,0
47970,5,2,167669,167669,167671,0,2,3
47971,1,2,167670,167671,167673,1,3,0
47972,4,3,167674,167674,167677,0,3,1
47973,5,2,167679,167679,167681,0,2,2
47974,3,2,167682,167682,167684,0,2,1
47975,3,2,167685,167685,167687,0,2,1
47976,3,2,167688,167688,167690,0,2,1
47977,5,3,167693,167693,167696,0,3,3
47978,6,1,167699,167699,167700,0,1,3
47979,5,2,167704,167704,167706,0,2,4
47980,6,1,167710,167710,167711,0,1,4
47981,2,1,167712,167712,167713,0,1,1
47982,1,1,167713,167713,167714,0,1,0
47983,1,2,167714,167714,167716,0,2,0
47984,2,2,167716,167716,167718,0,2,0
47985,5,1,167721,167721,167722,0,1,3
47986,2,3,167723,167723,167726,0,3,1
47987,6,2,167729,167729,167731,0,2,3
47988,2,2,167731,167731,167733,0,2,0
47989,6,3,167737,167737,167740,0,3,4
47990,5,2,167742,167742,167744,0,2,2
47991,4,3,167746,167746,167749,0,3,2
47992,4,1,167750,167750,167751,0,1,1
47993,4,3,167754,167754,167757,0,3,3
47994,6,3,167760,167760,167763,0,3,3
47995,1,3,167761,167763,167766,2,5,0
47996,2,3,167763,167766,167769,3,6,0
47997,3,2,167766,167769,167771,3,5,0
47998,3,3,167769,167771,167774,2,5,0
47999,4,2,167773,167774,167776,1,3,0
48000,5,1,167778,167778,167779,0,1,2
48001,1,2,167779,167779,167781,0,2,0
48002,4,3,167783,167783,167786,0,3,2
48003,6,2,167789,167789,167791,0,2,3
48004,2,1,167791,167791,167792,0,1,0
48005,1,3,167792,167792,167795,0,3,0
48006,4,3,167796,167796,167799,0,3,1
48007,1,2,167797,167799,167801,2,4,0
48008,6,1,167803,167803,167804,0,1,2
48009,2,1,167805,167805,167806,0,1,1
48010,5,1,167810,167810,167811,0,1,4
48011,6,2,167816,167816,167818,0,2,5
48012,5,1,167821,167821,167822,0,1,3
48013,4,1,167825,167825,167826,0,1,3
48014,6,3,167831,167831,167834,0,3,5
48015,5,1,167836,167836,167837,0,1,2
48016,6,3,167842,167842,167845,0,3,5
48017,6,2,167848,167848,167850,0,2,3
48018,5,1,167853,167853,167854,0,1,3
48019,5,1,167858,167858,167859,0,1,4
48020,5,2,167863,167863,167865,0,2,4
48021,6,3,167869,167869,167872,0,3,4
48022,4,1,167873,167873,167874,0,1,1
48023,6,1,167879,167879,167880,0,1,5
48024,5,1,167884,167884,167885,0,1,4
48025,5,3,167889,167889,167892,0,3,4
48026,3,2,167892,167892,167894,0,2,0
48027,1,2,167893,167894,167896,1,3,0
48028,4,2,167897,167897,167899,0,2,1
48029,5,2,167902,167902,167904,0,2,3
48030,4,3,167906,167906,167909,0,3,2
48031,3,3,167909,167909,167912,0,3,0
48032,1,1,167910,167912,167913,2,3,0
48033,2,2,167912,167913,167915,1,3,0
48034,2,2,167914,167915,167917,1,3,0
48035,1,3,167915,167917,167920,2,5,0
48036,3,1,167918,167920,167921,2,3,0
48037,3,1,167921,167921,167922,0,1,0
48038,5,3,167926,167926,167929,0,3,4
48039,6,2,167932,167932,167934,0,2,3
48040,6,1,167938,167938,167939,0,1,4
48041,4,2,167942,167942,167944,0,2,3
48042,6,3,167948,167948,167951,0,3,4
48043,5,1,167953,167953,167954,0,1,2
48044,5,2,167958,167958,167960,0,2,4
48045,4,1,167962,167962,167963,0,1,2
48046,4,2,167966,167966,167968,0,2,3
48047,4,2,167970,167970,167972,0,2,2
48048,1,2,167971,167972,167974,1,3,0
48049,5,3,167976,167976,167979,0,3,2
48050,1,1,167977,167979,167980,2,3,0
48051,5,1,167982,167982,167983,0,1,2
48052,4,1,167986,167986,167987,0,1,3
48053,2,3,167988,167988,167991,0,3,1
48054,1,3,167989,167991,167994,2,5,0
48055,5,3,167994,167994,167997,0,3,0
48056,4,3,167998,167998,168001,0,3,1
48057,6,3,168004,168004,168007,0,3,3
48058,4,1,168008,168008,168009,0,1,1
48059,1,3,168009,168009,168012,0,3,0
48060,4,3,168013,168013,168016,0,3,1
48061,5,3,168018,168018,168021,0,3,2
48062,5,2,168023,168023,168025,0,2,2
48063,3,1,168026,168026,168027,0,1,1
48064,2,1,168028,168028,168029,0,1,1
48065,1,2,168029,168029,168031,0,2,0
48066,5,1,168034,168034,168035,0,1,3
48067,6,2,168040,168040,168042,0,2,5
48068,5,2,168045,168045,168047,0,2,3
48069,2,2,168047,168047,168049,0,2,0
48070,2,2,168049,168049,168051,0,2,0
48071,5,2,168054,168054,168056,0,2,3
48072,4,2,168058,168058,168060,0,2,2
48073,3,2,168061,168061,168063,0,2,1
48074,6,3,168067,168067,168070,0,3,4
48075,1,3,168068,168070,168073,2,5,0
48076,4,2,168072,168073,168075,1,3,0
48077,5,1,168077,168077,168078,0,1,2
48078,1,1,168078,168078,168079,0,1,0
48079,6,3,168084,168084,168087,0,3,5
48080,4,3,168088,168088,168091,0,3,1
48081,1,2,168089,168091,168093,2,4,0
48082,6,1,168095,168095,168096,0,1,2
48083,6,2,168101,168101,168103,0,2,5
48084,2,2,168103,168103,168105,0,2,0
48085,1,3,168104,168105,168108,1,4,0
48086,6,1,168110,168110,168111,0,1,2
48087,2,3,168112,168112,168115,0,3,1
48088,3,2,168115,168115,168117,0,2,0
48089,6,2,168121,168121,168123,0,2,4
48090,2,3,168123,168123,168126,0,3,0
48091,1,3,168124,168126,168129,2,5,0
48092,2,1,168126,168129,168130,3,4,0
48093,4,3,168130,168130,168133,0,3,0
48094,4,1,168134,168134,168135,0,1,1
48095,5,1,168139,168139,168140,0,1,4
48096,3,2,168142,168142,168144,0,2,2
48097,5,3,168147,168147,168150,0,3,3
48098,4,1,168151,168151,168152,0,1,1
48099,1,2,168152,168152,168154,0,2,0
48100,5,3,168157,168157,168160,0,3,3
48101,1,2,168158,168160,168162,2,4,0
48102,1,2,168159,168162,168164,3,5,0
48103,6,3,168165,168165,168168,0,3,1
48104,3,3,168168,168168,168171,0,3,0
48105,1,2,168169,168171,168173,2,4,0
48106,2,2,168171,168173,168175,2,4,0
48107,2,3,168173,168175,168178,2,5,0
48108,3,1,168176,168178,168179,2,3,0
48109,4,2,168180,168180,168182,0,2,1
48110,2,3,168182,168182,168185,0,3,0
48111,3,1,168185,168185,168186,0,1,0
48112,3,2,168188,168188,168190,0,2,2
48113,2,1,168190,168190,168191,0,1,0
48114,1,1,168191,168191,168192,0,1,0
48115,4,1,168195,168195,168196,0,1,3
48116,6,3,168201,168201,168204,0,3,5
48117,5,3,168206,168206,168209,0,3,2
48118,5,1,168211,168211,168212,0,1,2
48119,3,1,168214,168214,168215,0,1,2
48120,3,1,168217,168217,168218,0,1,2
48121,1,3,168218,168218,168221,0,3,0
48122,1,1,168219,168221,168222,2,3,0
48123,1,1,168220,168222,168223,2,3,0
48124,2,1,168222,168223,168224,1,2,0
48125,4,2,168226,168226,168228,0,2,2
48126,2,1,168228,168228,168229,0,1,0
48127,4,3,168232,168232,168235,0,3,3
48128,1,1,168233,168235,168236,2,3,0
48129,6,3,168239,168239,168242,0,3,3
48130,4,3,168243,168243,168246,0,3,1
48131,2,1,168245,168246,168247,1,2,0
48132,6,3,168251,168251,168254,0,3,4
48133,4,2,168255,168255,168257,0,2,1
48134,6,3,168261,168261,168264,0,3,4
48135,6,2,168267,168267,168269,0,2,3
48136,5,3,168272,168272,168275,0,3,3
48137,5,1,168277,168277,168278,0,1,2
48138,5,2,168282,168282,168284,0,2,4
48139,6,3,168288,168288,168291,0,3,4
48140,2,1,168290,168291,168292,1,2,0
48141,6,2,168296,168296,168298,0,2,4
48142,5,3,168301,168301,168304,0,3,3
48143,4,1,168305,168305,168306,0,1,1
48144,5,2,168310,168310,168312,0,2,4
48145,1,3,168311,168312,168315,1,4,0
48146,3,3,168314,168315,168318,1,4,0
48147,6,3,168320,168320,168323,0,3,2
48148,4,3,168324,168324,168327,0,3,1
48149,2,1,168326,168327,168328,1,2,0
48150,4,3,168330,168330,168333,0,3,2
48151,2,1,168332,168333,168334,1,2,0
48152,1,1,168333,168334,168335,1,2,0
48153,4,3,168337,168337,168340,0,3,2
48154,4,3,168341,168341,168344,0,3,1
48155,2,2,168343,168344,168346,1,3,0
48156,3,3,168346,168346,168349,0,3,0
48157,4,1,168350,168350,168351,0,1,1
48158,6,2,168356,168356,168358,0,2,5
48159,5,2,168361,168361,168363,0,2,3
48160,4,1,168365,168365,168366,0,1,2
48161,3,1,168368,168368,168369,0,1,2
48162,2,2,168370,168370,168372,0,2,1
48163,2,1,168372,168372,168373,0,1,0
48164,2,1,168374,168374,168375,0,1,1
48165,4,3,168378,168378,168381,0,3,3
48166,3,2,168381,168381,168383,0,2,0
48167,1,1,168382,168383,168384,1,2,0
48168,6,2,168388,168388,168390,0,2,4
48169,2,1,168390,168390,168391,0,1,0
48170,3,2,168393,168393,168395,0,2,2
48171,1,1,168394,168395,168396,1,2,0
48172,2,1,168396,168396,168397,0,1,0
48173,3,3,168399,168399,168402,0,3,2
48174,2,3,168401,168402,168405,1,4,0
48175,2,1,168403,168405,168406,2,3,0
48176,4,1,168407,168407,168408,0,1,1
48177,3,1,168410,168410,168411,0,1,2
48178,1,1,168411,168411,168412,0,1,0
48179,1,2,168412,168412,168414,0,2,0
48180,1,1,168413,168414,168415,1,2,0
48181,5,3,168418,168418,168421,0,3,3
48182,5,3,168423,168423,168426,0,3,2
48183,2,2,168425,168426,168428,1,3,0
48184,6,1,168431,168431,168432,0,1,3
48185,1,2,168432,168432,168434,0,2,0
48186,2,2,168434,168434,168436,0,2,0
48187,6,3,168440,168440,168443,0,3,4
48188,5,3,168445,168445,168448,0,3,2
48189,5,3,168450,168450,168453,0,3,2
48190,4,3,168454,168454,168457,0,3,1
48191,4,1,168458,168458,168459,0,1,1
48192,5,1,168463,168463,168464,0,1,4
48193,2,3,168465,168465,168468,0,3,1
48194,1,2,168466,168468,168470,2,4,0
48195,6,3,168472,168472,168475,0,3,2
48196,4,3,168476,168476,168479,0,3,1
48197,5,3,168481,168481,168484,0,3,2
48198,1,3,168482,168484,168487,2,5,0
48199,1,3,168483,168487,168490,4,7,0
48200,1,1,168484,168490,168491,6,7,0
48201,4,1,168488,168491,168492,3,4,0
48202,3,3,168491,168492,168495,1,4,0
48203,3,3,168494,168495,168498,1,4,0
48204,2,2,168496,168498,168500,2,4,0
48205,6,3,168502,168502,168505,0,3,2
48206,6,2,168508,168508,168510,0,2,3
48207,3,2,168511,168511,168513,0,2,1
48208,6,2,168517,168517,168519,0,2,4
48209,3,3,168520,168520,168523,0,3,1
48210,6,3,168526,168526,168529,0,3,3
48211,2,1,168528,168529,168530,1,2,0
48212,1,2,168529,168530,168532,1,3,0
48213,5,1,168534,168534,168535,0,1,2
48214,5,3,168539,168539,168542,0,3,4
48215,6,1,168545,168545,168546,0,1,3
48216,6,2,168551,168551,168553,0,2,5
48217,5,1,168556,168556,168557,0,1,3
48218,2,2,168558,168558,168560,0,2,1
48219,3,1,168561,168561,168562,0,1,1
48220,4,3,168565,168565,168568,0,3,3
48221,2,1,168567,168568,168569,1,2,0
48222,4,3,168571,168571,168574,0,3,2
48223,6,3,168577,168577,168580,0,3,3
48224,3,2,168580,168580,168582,0,2,0
48225,6,3,168586,168586,168589,0,3,4
48226,6,1,168592,168592,168593,0,1,3
48227,5,2,168597,168597,168599,0,2,4
48228,4,3,168601,168601,168604,0,3,2
48229,6,1,168607,168607,168608,0,1,3
48230,3,1,168610,168610,168611,0,1,2
48231,4,3,168614,168614,168617,0,3,3
48232,2,1,168616,168617,168618,1,2,0
48233,3,1,168619,168619,168620,0,1,1
48234,2,1,168621,168621,168622,0,1,1
48235,3,2,168624,168624,168626,0,2,2
48236,5,2,168629,168629,168631,0,2,3
48237,4,2,168633,168633,168635,0,2,2
48238,1,2,168634,168635,168637,1,3,0
48239,1,2,168635,168637,168639,2,4,0
48240,1,3,168636,168639,168642,3,6,0
48241,5,3,168641,168642,168645,1,4,0
48242,6,2,168647,168647,168649,0,2,2
48243,4,3,168651,168651,168654,0,3,2
48244,4,3,168655,168655,168658,0,3,1
48245,3,3,168658,168658,168661,0,3,0
48246,4,3,168662,168662,168665,0,3,1
48247,5,3,168667,168667,168670,0,3,2
48248,6,1,168673,168673,168674,0,1,3
48249,4,3,168677,168677,168680,0,3,3
48250,6,2,168683,168683,168685,0,2,3
48251,4,3,168687,168687,168690,0,3,2
48252,3,2,168690,168690,168692,0,2,0
48253,1,3,168691,168692,168695,1,4,0
48254,4,1,168695,168695,168696,0,1,0
48255,5,1,168700,168700,168701,0,1,4
48256,6,3,168706,168706,168709,0,3,5
48257,2,3,168708,168709,168712,1,4,0
48258,3,3,168711,168712,168715,1,4,0
48259,1,1,168712,168715,168716,3,4,0
48260,1,1,168713,168716,168717,3,4,0
48261,4,2,168717,168717,168719,0,2,0
48262,3,1,168720,168720,168721,0,1,1
48263,4,2,168724,168724,168726,0,2,3
48264,5,1,168729,168729,168730,0,1,3
48265,6,3,168735,168735,168738,0,3,5
48266,6,2,168741,168741,168743,0,2,3
48267,4,3,168745,168745,168748,0,3,2
48268,3,2,168748,168748,168750,0,2,0
48269,1,1,168749,168750,168751,1,2,0
48270,1,2,168750,168751,168753,1,3,0
48271,4,3,168754,168754,168757,0,3,1
48272,4,1,168758,168758,168759,0,1,1
48273,5,2,168763,168763,168765,0,2,4
48274,2,3,168765,168765,168768,0,3,0
48275,2,1,168767,168768,168769,1,2,0
48276,4,2,168771,168771,168773,0,2,2
48277,4,2,168775,168775,168777,0,2,2
48278,3,3,168778,168778,168781,0,3,1
48279,1,1,168779,168781,168782,2,3,0
48280,5,1,168784,168784,168785,0,1,2
48281,2,2,168786,168786,168788,0,2,1
48282,2,1,168788,168788,168789,0,1,0
48283,2,2,168790,168790,168792,0,2,1
48284,6,1,168796,168796,168797,0,1,4
48285,6,2,168802,168802,168804,0,2,5
48286,6,2,168808,168808,168810,0,2,4
48287,2,1,168810,168810,168811,0,1,0
48288,3,1,168813,168813,168814,0,1,2
48289,2,1,168815,168815,168816,0,1,1
48290,6,3,168821,168821,168824,0,3,5
48291,6,2,168827,168827,168829,0,2,3
48292,3,3,168830,168830,168833,0,3,1
48293,3,3,168833,168833,168836,0,3,0
48294,4,3,168837,168837,168840,0,3,1
48295,2,2,168839,168840,168842,1,3,0
48296,3,2,168842,168842,168844,0,2,0
48297,3,1,168845,168845,168846,0,1,1
48298,6,1,168851,168851,168852,0,1,5
48299,2,2,168853,168853,168855,0,2,1
48300,5,2,168858,168858,168860,0,2,3
48301,2,1,168860,168860,168861,0,1,0
48302,5,2,168865,168865,168867,0,2,4
48303,6,2,168871,168871,168873,0,2,4
48304,6,2,168877,168877,168879,0,2,4
48305,3,2,168880,168880,168882,0,2,1
48306,6,3,168886,168886,168889,0,3,4
48307,2,1,168888,168889,168890,1,2,0
48308,6,2,168894,168894,168896,0,2,4
48309,6,1,168900,168900,168901,0,1,4
48310,3,3,168903,168903,168906,0,3,2
48311,4,3,168907,168907,168910,0,3,1
48312,6,1,168913,168913,168914,0,1,3
48313,3,3,168916,168916,168919,0,3,2
48314,3,1,168919,168919,168920,0,1,0
48315,3,3,168922,168922,168925,0,3,2
48316,4,1,168926,168926,168927,0,1,1
48317,6,2,168932,168932,168934,0,2,5
48318,3,3,168935,168935,168938,0,3,1
48319,4,2,168939,168939,168941,0,2,1
48320,3,1,168942,168942,168943,0,1,1
48321,6,3,168948,168948,168951,0,3,5
48322,5,1,168953,168953,168954,0,1,2
48323,6,1,168959,168959,168960,0,1,5
48324,1,1,168960,168960,168961,0,1,0
48325,5,1,168965,168965,168966,0,1,4
48326,1,2,168966,168966,168968,0,2,0
48327,3,2,168969,168969,168971,0,2,1
48328,6,1,168975,168975,168976,0,1,4
48329,1,2,168976,168976,168978,0,2,0
48330,3,3,168979,168979,168982,0,3,1
48331,1,3,168980,168982,168985,2,5,0
48332,4,2,168984,168985,168987,1,3,0
48333,3,2,168987,168987,168989,0,2,0
48334,5,3,168992,168992,168995,0,3,3
48335,1,3,168993,168995,168998,2,5,0
48336,3,2,168996,168998,169000,2,4,0
48337,2,1,168998,169000,169001,2,3,0
48338,2,3,169000,169001,169004,1,4,0
48339,2,3,169002,169004,169007,2,5,0
48340,5,1,169007,169007,169008,0,1,0
48341,2,1,169009,169009,169010,0,1,1
48342,3,1,169012,169012,169013,0,1,2
48343,1,3,169013,169013,169016,0,3,0
48344,1,2,169014,169016,169018,2,4,0
48345,3,3,169017,169018,169021,1,4,0
48346,4,2,169021,169021,169023,0,2,0
48347,5,2,169026,169026,169028,0,2,3
48348,3,2,169029,169029,169031,0,2,1
48349,6,2,169035,169035,169037,0,2,4
48350,1,1,169036,169037,169038,1,2,0
48351,6,2,169042,169042,169044,0,2,4
48352,2,2,169044,169044,169046,0,2,0
48353,6,2,169050,169050,169052,0,2,4
48354,6,1,169056,169056,169057,0,1,4
48355,5,1,169061,169061,169062,0,1,4
48356,6,1,169067,169067,169068,0,1,5
48357,5,1,169072,169072,169073,0,1,4
48358,4,1,169076,169076,169077,0,1,3
48359,5,2,169081,169081,169083,0,2,4
48360,5,1,169086,169086,169087,0,1,3
48361,2,1,169088,169088,169089,0,1,1
48362,2,3,169090,169090,169093,0,3,1
48363,2,2,169092,169093,169095,1,3,0
48364,5,2,169097,169097,169099,0,2,2
48365,3,2,169100,169100,169102,0,2,1
48366,6,2,169106,169106,169108,0,2,4
48367,6,3,169112,169112,169115,0,3,4
48368,1,1,169113,169115,169116,2,3,0
48369,6,1,169119,169119,169120,0,1,3
48370,4,1,169123,169123,169124,0,1,3
48371,2,2,169125,169125,169127,0,2,1
48372,6,1,169131,169131,169132,0,1,4
48373,3,1,169134,169134,169135,0,1,2
48374,2,1,169136,169136,169137,0,1,1
48375,4,2,169140,169140,169142,0,2,3
48376,2,1,169142,169142,169143,0,1,0
48377,1,2,169143,169143,169145,0,2,0
48378,2,1,169145,169145,169146,0,1,0
48379,5,2,169150,169150,169152,0,2,4
48380,4,2,169154,169154,169156,0,2,2
48381,3,3,169157,169157,169160,0,3,1
48382,4,1,169161,169161,169162,0,1,1
48383,5,3,169166,169166,169169,0,3,4
48384,2,2,169168,169169,169171,1,3,0
48385,1,3,169169,169171,169174,2,5,0
48386,1,3,169170,169174,169177,4,7,0
48387,4,3,169174,169177,169180,3,6,0
48388,6,1,169180,169180,169181,0,1,0
48389,3,1,169183,169183,169184,0,1,2
48390,1,3,169184,169184,169187,0,3,0
48391,5,2,169189,169189,169191,0,2,2
48392,5,2,169194,169194,169196,0,2,3
48393,2,1,169196,169196,169197,0,1,0
48394,3,1,169199,169199,169200,0,1,2
48395,3,2,169202,169202,169204,0,2,2
48396,3,2,169205,169205,169207,0,2,1
48397,5,1,169210,169210,169211,0,1,3
48398,5,2,169215,169215,169217,0,2,4
48399,3,3,169218,169218,169221,0,3,1
48400,1,3,169219,169221,169224,2,5,0
48401,1,1,169220,169224,169225,4,5,0
48402,1,3,169221,169225,169228,4,7,0
48403,1,3,169222,169228,169231,6,9,0
48404,3,2,169225,169231,169233,6,8,0
48405,6,1,169231,169233,169234,2,3,0
48406,6,1,169237,169237,169238,0,1,3
48407,6,3,169243,169243,169246,0,3,5
48408,2,2,169245,169246,169248,1,3,0
48409,3,2,169248,169248,169250,0,2,0
48410,5,3,169253,169253,169256,0,3,3
48411,1,3,169254,169256,169259,2,5,0
48412,3,3,169257,169259,169262,2,5,0
48413,2,1,169259,169262,169263,3,4,0
48414,1,1,169260,169263,169264,3,4,0
48415,2,2,169262,169264,169266,2,4,0
48416,6,3,169268,169268,169271,0,3,2
48417,1,1,169269,169271,169272,2,3,0
48418,4,3,169273,169273,169276,0,3,1
48419,4,3,169277,169277,169280,0,3,1
48420,1,1,169278,169280,169281,2,3,0
48421,1,1,169279,169281,169282,2,3,0
48422,4,2,169283,169283,169285,0,2,1
48423,5,3,169288,169288,169291,0,3,3
48424,3,2,169291,169291,169293,0,2,0
48425,1,2,169292,169293,169295,1,3,0
48426,6,2,169298,169298,169300,0,2,3
48427,5,1,169303,169303,169304,0,1,3
48428,3,3,169306,169306,169309,0,3,2
48429,6,1,169312,169312,169313,0,1,3
48430,4,2,169316,169316,169318,0,2,3
48431,3,2,169319,169319,169321,0,2,1
48432,5,2,169324,169324,169326,0,2,3
48433,5,3,169329,169329,169332,0,3,3
48434,4,1,169333,169333,169334,0,1,1
48435,6,3,169339,169339,169342,0,3,5
48436,2,1,169341,169342,169343,1,2,0
48437,1,1,169342,169343,169344,1,2,0
48438,3,3,169345,169345,169348,0,3,1
48439,1,1,169346,169348,169349,2,3,0
48440,6,3,169352,169352,169355,0,3,3
48441,3,3,169355,169355,169358,0,3,0
48442,6,3,169361,169361,169364,0,3,3
48443,3,2,169364,169364,169366,0,2,0
48444,4,1,169368,169368,169369,0,1,2
48445,3,3,169371,169371,169374,0,3,2
48446,5,1,169376,169376,169377,0,1,2
48447,6,2,169382,169382,169384,0,2,5
48448,3,2,169385,169385,169387,0,2,1
48449,2,3,169387,169387,169390,0,3,0
48450,4,1,169391,169391,169392,0,1,1
48451,3,3,169394,169394,169397,0,3,2
48452,6,2,169400,169400,169402,0,2,3
48453,6,3,169406,169406,169409,0,3,4
48454,6,1,169412,169412,169413,0,1,3
48455,4,2,169416,169416,169418,0,2,3
48456,2,2,169418,169418,169420,0,2,0
48457,5,2,169423,169423,169425,0,2,3
48458,5,3,169428,169428,169431,0,3,3
48459,2,3,169430,169431,169434,1,4,0
48460,1,2,169431,169434,169436,3,5,0
48461,5,3,169436,169436,169439,0,3,0
48462,6,1,169442,169442,169443,0,1,3
48463,6,3,169448,169448,169451,0,3,5
48464,3,1,169451,169451,169452,0,1,0
48465,3,2,169454,169454,169456,0,2,2
48466,4,1,169458,169458,169459,0,1,2
48467,3,2,169461,169461,169463,0,2,2
48468,3,3,169464,169464,169467,0,3,1
48469,5,1,169469,169469,169470,0,1,2
48470,2,1,169471,169471,169472,0,1,1
48471,1,2,169472,169472,169474,0,2,0
48472,5,3,169477,169477,169480,0,3,3
48473,5,1,169482,169482,169483,0,1,2
48474,6,1,169488,169488,169489,0,1,5
48475,5,3,169493,169493,169496,0,3,4
48476,1,2,169494,169496,169498,2,4,0
48477,1,1,169495,169498,169499,3,4,0
48478,5,3,169500,169500,169503,0,3,1
48479,5,1,169505,169505,169506,0,1,2
48480,4,1,169509,169509,169510,0,1,3
48481,4,3,169513,169513,169516,0,3,3
48482,4,2,169517,169517,169519,0,2,1
48483,5,1,169522,169522,169523,0,1,3
48484,4,1,169526,169526,169527,0,1,3
48485,2,2,169528,169528,169530,0,2,1
48486,2,3,169530,169530,169533,0,3,0
48487,3,1,169533,169533,169534,0,1,0
48488,2,1,169535,169535,169536,0,1,1
48489,3,2,169538,169538,169540,0,2,2
48490,4,3,169542,169542,169545,0,3,2
48491,5,2,169547,169547,169549,0,2,2
48492,6,3,169553,169553,169556,0,3,4
48493,4,2,169557,169557,169559,0,2,1
48494,2,1,169559,169559,169560,0,1,0
48495,6,3,169565,169565,169568,0,3,5
48496,5,3,169570,169570,169573,0,3,2
48497,6,2,169576,169576,169578,0,2,3
48498,5,1,169581,169581,169582,0,1,3
48499,3,1,169584,169584,169585,0,1,2
48500,6,3,169590,169590,169593,0,3,5
48501,1,1,169591,169593,169594,2,3,0
48502,2,1,169593,169594,169595,1,2,0
48503,5,3,169598,169598,169601,0,3,3
48504,5,2,169603,169603,169605,0,2,2
48505,6,2,169609,169609,169611,0,2,4
48506,5,1,169614,169614,169615,0,1,3
48507,4,1,169618,169618,169619,0,1,3
48508,4,3,169622,169622,169625,0,3,3
48509,2,3,169624,169625,169628,1,4,0
48510,1,3,169625,169628,169631,3,6,0
48511,6,3,169631,169631,169634,0,3,0
48512,5,3,169636,169636,169639,0,3,2
48513,2,1,169638,169639,169640,1,2,0
48514,4,3,169642,169642,169645,0,3,2
48515,6,3,169648,169648,169651,0,3,3
48516,2,2,169650,169651,169653,1,3,0
48517,1,1,169651,169653,169654,2,3,0
48518,2,1,169653,169654,169655,1,2,0
48519,4,3,169657,169657,169660,0,3,2
48520,1,2,169658,169660,169662,2,4,0
48521,5,2,169663,169663,169665,0,2,1
48522,2,2,169665,169665,169667,0,2,0
48523,1,3,169666,169667,169670,1,4,0
48524,6,2,169672,169672,169674,0,2,2
48525,6,2,169678,169678,169680,0,2,4
48526,6,3,169684,169684,169687,0,3,4
48527,1,2,169685,169687,169689,2,4,0
48528,4,1,169689,169689,169690,0,1,0
48529,6,3,169695,169695,169698,0,3,5
48530,5,2,169700,169700,169702,0,2,2
48531,3,3,169703,169703,169706,0,3,1
48532,4,1,169707,169707,169708,0,1,1
48533,6,2,169713,169713,169715,0,2,5
48534,2,2,169715,169715,169717,0,2,0
48535,1,3,169716,169717,169720,1,4,0
48536,1,2,169717,169720,169722,3,5,0
48537,5,2,169722,169722,169724,0,2,0
48538,6,3,169728,169728,169731,0,3,4
48539,1,2,169729,169731,169733,2,4,0
48540,2,2,169731,169733,169735,2,4,0
48541,2,1,169733,169735,169736,2,3,0
48542,3,2,169736,169736,169738,0,2,0
48543,6,2,169742,169742,169744,0,2,4
48544,5,3,169747,169747,169750,0,3,3
48545,6,1,169753,169753,169754,0,1,3
48546,4,1,169757,169757,169758,0,1,3
48547,6,1,169763,169763,169764,0,1,5
48548,2,2,169765,169765,169767,0,2,1
48549,5,3,169770,169770,169773,0,3,3
48550,1,2,169771,169773,169775,2,4,0
48551,5,1,169776,169776,169777,0,1,1
48552,2,1,169778,169778,169779,0,1,1
48553,1,3,169779,169779,169782,0,3,0
48554,3,1,169782,169782,169783,0,1,0
48555,4,3,169786,169786,169789,0,3,3
48556,5,3,169791,169791,169794,0,3,2
48557,5,3,169796,169796,169799,0,3,2
48558,2,3,169798,169799,169802,1,4,0
48559,6,3,169804,169804,169807,0,3,2
48560,5,1,169809,169809,169810,0,1,2
48561,6,3,169815,169815,169818,0,3,5
48562,3,1,169818,169818,169819,0,1,0
48563,6,3,169824,169824,169827,0,3,5
48564,4,3,169828,169828,169831,0,3,1
48565,6,1,169834,169834,169835,0,1,3
48566,2,1,169836,169836,169837,0,1,1
48567,4,3,169840,169840,169843,0,3,3
48568,2,1,169842,169843,169844,1,2,0
48569,3,2,169845,169845,169847,0,2,1
48570,1,2,169846,169847,169849,1,3,0
48571,1,2,169847,169849,169851,2,4,0
48572,4,1,169851,169851,169852,0,1,0
48573,2,2,169853,169853,169855,0,2,1
48574,2,2,169855,169855,169857,0,2,0
48575,1,1,169856,169857,169858,1,2,0
48576,4,2,169860,169860,169862,0,2,2
48577,4,2,169864,169864,169866,0,2,2
48578,5,2,169869,169869,169871,0,2,3
48579,3,1,169872,169872,169873,0,1,1
48580,6,3,169878,169878,169881,0,3,5
48581,4,3,169882,169882,169885,0,3,1
48582,5,1,169887,169887,169888,0,1,2
48583,2,2,169889,169889,169891,0,2,1
48584,6,3,169895,169895,169898,0,3,4
48585,4,3,169899,169899,169902,0,3,1
48586,3,1,169902,169902,169903,0,1,0
48587,2,3,169904,169904,169907,0,3,1
48588,2,2,169906,169907,169909,1,3,0
48589,5,1,169911,169911,169912,0,1,2
48590,2,1,169913,169913,169914,0,1,1
48591,3,2,169916,169916,169918,0,2,2
48592,6,1,169922,169922,169923,0,1,4
48593,3,2,169925,169925,169927,0,2,2
48594,6,2,169931,169931,169933,0,2,4
48595,6,1,169937,169937,169938,0,1,4
48596,1,1,169938,169938,169939,0,1,0
48597,4,1,169942,169942,169943,0,1,3
48598,3,3,169945,169945,169948,0,3,2
48599,6,2,169951,169951,169953,0,2,3
48600,3,1,169954,169954,169955,0,1,1
48601,6,1,169960,169960,169961,0,1,5
48602,6,1,169966,169966,169967,0,1,5
48603,2,3,169968,169968,169971,0,3,1
48604,4,1,169972,169972,169973,0,1,1
48605,4,2,169976,169976,169978,0,2,3
48606,6,3,169982,169982,169985,0,3,4
48607,3,3,169985,169985,169988,0,3,0
48608,5,2,169990,169990,169992,0,2,2
48609,6,2,169996,169996,169998,0,2,4
48610,4,2,170000,170000,170002,0,2,2
48611,1,3,170001,170002,170005,1,4,0
48612,5,1,170006,170006,170007,0,1,1
48613,4,1,170010,170010,170011,0,1,3
48614,5,2,170015,170015,170017,0,2,4
48615,2,3,170017,170017,170020,0,3,0
48616,4,2,170021,170021,170023,0,2,1
48617,4,3,170025,170025,170028,0,3,2
48618,4,1,170029,170029,170030,0,1,1
48619,3,3,170032,170032,170035,0,3,2
48620,1,1,170033,170035,170036,2,3,0
48621,4,2,170037,170037,170039,0,2,1
48622,5,1,170042,170042,170043,0,1,3
48623,6,1,170048,170048,170049,0,1,5
48624,6,1,170054,170054,170055,0,1,5
48625,6,3,170060,170060,170063,0,3,5
48626,3,3,170063,170063,170066,0,3,0
48627,2,2,170065,170066,170068,1,3,0
48628,1,1,170066,170068,170069,2,3,0
48629,4,2,170070,170070,170072,0,2,1
48630,1,3,170071,170072,170075,1,4,0
48631,5,2,170076,170076,170078,0,2,1
48632,3,2,170079,170079,170081,0,2,1
48633,2,3,170081,170081,170084,0,3,0
48634,4,1,170085,170085,170086,0,1,1
48635,5,1,170090,170090,170091,0,1,4
48636,3,2,170093,170093,170095,0,2,2
48637,2,2,170095,170095,170097,0,2,0
48638,4,2,170099,170099,170101,0,2,2
48639,2,1,170101,170101,170102,0,1,0
48640,2,3,170103,170103,170106,0,3,1
48641,1,1,170104,170106,170107,2,3,0
48642,1,2,170105,170107,170109,2,4,0
48643,6,3,170111,170111,170114,0,3,2
48644,3,3,170114,170114,170117,0,3,0
48645,4,2,170118,170118,170120,0,2,1
48646,5,1,170123,170123,170124,0,1,3
48647,4,1,170127,170127,170128,0,1,3
48648,6,1,170133,170133,170134,0,1,5
48649,1,3,170134,170134,170137,0,3,0
48650,5,2,170139,170139,170141,0,2,2
48651,3,3,170142,170142,170145,0,3,1
48652,5,3,170147,170147,170150,0,3,2
48653,2,3,170149,170150,170153,1,4,0
48654,6,1,170155,170155,170156,0,1,2
48655,1,3,170156,170156,170159,0,3,0
48656,5,3,170161,170161,170164,0,3,2
48657,2,1,170163,170164,170165,1,2,0
48658,4,1,170167,170167,170168,0,1,2
48659,3,2,170170,170170,170172,0,2,2
48660,3,3,170173,170173,170176,0,3,1
48661,3,1,170176,170176,170177,0,1,0
48662,2,3,170178,170178,170181,0,3,1
48663,1,2,170179,170181,170183,2,4,0
48664,1,1,170180,170183,170184,3,4,0
48665,5,2,170185,170185,170187,0,2,1
48666,2,1,170187,170187,170188,0,1,0
48667,3,1,170190,170190,170191,0,1,2
48668,5,3,170195,170195,170198,0,3,4
48669,1,3,170196,170198,170201,2,5,0
48670,3,3,170199,170201,170204,2,5,0
48671,1,3,170200,170204,170207,4,7,0
48672,6,1,170206,170207,170208,1,2,0
48673,3,3,170209,170209,170212,0,3,1
48674,1,1,170210,170212,170213,2,3,0
48675,1,2,170211,170213,170215,2,4,0
48676,3,3,170214,170215,170218,1,4,0
48677,3,1,170217,170218,170219,1,2,0
48678,6,3,170223,170223,170226,0,3,4
48679,6,3,170229,170229,170232,0,3,3
48680,4,3,170233,170233,170236,0,3,1
48681,6,1,170239,170239,170240,0,1,3
48682,2,3,170241,170241,170244,0,3,1
48683,3,1,170244,170244,170245,0,1,0
48684,5,2,170249,170249,170251,0,2,4
48685,6,3,170255,170255,170258,0,3,4
48686,5,2,170260,170260,170262,0,2,2
48687,6,3,170266,170266,170269,0,3,4
48688,2,2,170268,170269,170271,1,3,0
48689,5,2,170273,170273,170275,0,2,2
48690,3,3,170276,170276,170279,0,3,1
48691,3,1,170279,170279,170280,0,1,0
48692,5,3,170284,170284,170287,0,3,4
48693,1,2,170285,170287,170289,2,4,0
48694,2,1,170287,170289,170290,2,3,0
48695,2,3,170289,170290,170293,1,4,0
48696,5,2,170294,170294,170296,0,2,1
48697,3,2,170297,170297,170299,0,2,1
48698,4,2,170301,170301,170303,0,2,2
48699,6,1,170307,170307,170308,0,1,4
48700,6,3,170313,170313,170316,0,3,5
48701,6,2,170319,170319,170321,0,2,3
48702,6,1,170325,170325,170326,0,1,4
48703,5,1,170330,170330,170331,0,1,4
48704,4,3,170334,170334,170337,0,3,3
48705,5,2,170339,170339,170341,0,2,2
48706,3,3,170342,170342,170345,0,3,1
48707,5,3,170347,170347,170350,0,3,2
48708,4,1,170351,170351,170352,0,1,1
48709,5,3,170356,170356,170359,0,3,4
48710,6,1,170362,170362,170363,0,1,3
48711,5,1,170367,170367,170368,0,1,4
48712,1,2,170368,170368,170370,0,2,0
48713,5,2,170373,170373,170375,0,2,3
48714,6,3,170379,170379,170382,0,3,4
48715,4,3,170383,170383,170386,0,3,1
48716,5,3,170388,170388,170391,0,3,2
48717,5,1,170393,170393,170394,0,1,2
48718,3,1,170396,170396,170397,0,1,2
48719,1,2,170397,170397,170399,0,2,0
48720,6,2,170403,170403,170405,0,2,4
48721,5,1,170408,170408,170409,0,1,3
48722,3,1,170411,170411,170412,0,1,2
48723,3,3,170414,170414,170417,0,3,2
48724,1,2,170415,170417,170419,2,4,0
48725,6,1,170421,170421,170422,0,1,2
48726,5,3,170426,170426,170429,0,3,4
48727,2,1,170428,170429,170430,1,2,0
48728,6,3,170434,170434,170437,0,3,4
48729,1,1,170435,170437,170438,2,3,0
48730,6,3,170441,170441,170444,0,3,3
48731,4,1,170445,170445,170446,0,1,1
48732,1,2,170446,170446,170448,0,2,0
48733,3,3,170449,170449,170452,0,3,1
48734,4,2,170453,170453,170455,0,2,1
48735,3,2,170456,170456,170458,0,2,1
48736,5,2,170461,170461,170463,0,2,3
48737,4,1,170465,170465,170466,0,1,2
48738,1,3,170466,170466,170469,0,3,0
48739,4,1,170470,170470,170471,0,1,1
48740,5,1,170475,170475,170476,0,1,4
48741,3,1,170478,170478,170479,0,1,2
48742,4,2,170482,170482,170484,0,2,3
48743,6,2,170488,170488,170490,0,2,4
48744,3,3,170491,170491,170494,0,3,1
48745,4,3,170495,170495,170498,0,3,1
48746,5,3,170500,170500,170503,0,3,2
48747,6,2,170506,170506,170508,0,2,3
48748,1,2,170507,170508,170510,1,3,0
48749,4,2,170511,170511,170513,0,2,1
48750,1,1,170512,170513,170514,1,2,0
48751,3,3,170515,170515,170518,0,3,1
48752,4,2,170519,170519,170521,0,2,1
48753,2,1,170521,170521,170522,0,1,0
48754,1,2,170522,170522,170524,0,2,0
48755,1,1,170523,170524,170525,1,2,0
48756,1,1,170524,170525,170526,1,2,0
48757,6,2,170530,170530,170532,0,2,4
48758,4,3,170534,170534,170537,0,3,2
48759,3,1,170537,170537,170538,0,1,0
48760,3,3,170540,170540,170543,0,3,2
48761,2,3,170542,170543,170546,1,4,0
48762,5,3,170547,170547,170550,0,3,1
48763,4,1,170551,170551,170552,0,1,1
48764,6,2,170557,170557,170559,0,2,5
48765,2,1,170559,170559,170560,0,1,0
48766,3,1,170562,170562,170563,0,1,2
48767,5,1,170567,170567,170568,0,1,4
48768,5,3,170572,170572,170575,0,3,4
48769,1,3,170573,170575,170578,2,5,0
48770,1,3,170574,170578,170581,4,7,0
48771,2,2,170576,170581,170583,5,7,0
48772,6,2,170582,170583,170585,1,3,0
48773,6,2,170588,170588,170590,0,2,3
48774,5,1,170593,170593,170594,0,1,3
48775,6,2,170599,170599,170601,0,2,5
48776,3,1,170602,170602,170603,0,1,1
48777,3,3,170605,170605,170608,0,3,2
48778,2,2,170607,170608,170610,1,3,0
48779,3,2,170610,170610,170612,0,2,0
48780,6,2,170616,170616,170618,0,2,4
48781,1,3,170617,170618,170621,1,4,0
48782,5,3,170622,170622,170625,0,3,1
48783,6,2,170628,170628,170630,0,2,3
48784,1,2,170629,170630,170632,1,3,0
48785,2,2,170631,170632,170634,1,3,0
48786,4,3,170635,170635,170638,0,3,1
48787,2,2,170637,170638,170640,1,3,0
48788,5,2,170642,170642,170644,0,2,2
48789,3,2,170645,170645,170647,0,2,1
48790,3,1,170648,170648,170649,0,1,1
48791,2,1,170650,170650,170651,0,1,1
48792,1,1,170651,170651,170652,0,1,0
48793,3,2,170654,170654,170656,0,2,2
48794,3,2,170657,170657,170659,0,2,1
48795,2,2,170659,170659,170661,0,2,0
48796,2,1,170661,170661,170662,0,1,0
48797,5,2,170666,170666,170668,0,2,4
48798,1,1,170667,170668,170669,1,2,0
48799,3,3,170670,170670,170673,0,3,1
48800,4,1,170674,170674,170675,0,1,1
48801,6,1,170680,170680,170681,0,1,5
48802,1,1,170681,170681,170682,0,1,0
48803,4,1,170685,170685,170686,0,1,3
48804,4,3,170689,170689,170692,0,3,3
48805,4,2,170693,170693,170695,0,2,1
48806,2,1,170695,170695,170696,0,1,0
48807,4,3,170699,170699,170702,0,3,3
48808,4,2,170703,170703,170705,0,2,1
48809,5,3,170708,170708,170711,0,3,3
48810,2,1,170710,170711,170712,1,2,0
48811,1,3,170711,170712,170715,1,4,0
48812,2,3,170713,170715,170718,2,5,0
48813,2,3,170715,170718,170721,3,6,0
48814,5,2,170720,170721,170723,1,3,0
48815,1,2,170721,170723,170725,2,4,0
48816,2,3,170723,170725,170728,2,5,0
48817,4,3,170727,170728,170731,1,4,0
48818,1,2,170728,170731,170733,3,5,0
48819,5,1,170733,170733,170734,0,1,0
48820,3,1,170736,170736,170737,0,1,2
48821,2,1,170738,170738,170739,0,1,1
48822,6,3,170744,170744,170747,0,3,5
48823,4,3,170748,170748,170751,0,3,1
48824,6,1,170754,170754,170755,0,1,3
48825,5,1,170759,170759,170760,0,1,4
48826,4,3,170763,170763,170766,0,3,3
48827,5,2,170768,170768,170770,0,2,2
48828,2,2,170770,170770,170772,0,2,0
48829,1,3,170771,170772,170775,1,4,0
48830,4,2,170775,170775,170777,0,2,0
48831,2,3,170777,170777,170780,0,3,0
48832,5,1,170782,170782,170783,0,1,2
48833,1,3,170783,170783,170786,0,3,0
48834,4,2,170787,170787,170789,0,2,1
48835,2,1,170789,170789,170790,0,1,0
48836,1,2,170790,170790,170792,0,2,0
48837,2,3,170792,170792,170795,0,3,0
48838,2,1,170794,170795,170796,1,2,0
48839,3,2,170797,170797,170799,0,2,1
48840,2,2,170799,170799,170801,0,2,0
48841,4,1,170803,170803,170804,0,1,2
48842,2,3,170805,170805,170808,0,3,1
48843,1,2,170806,170808,170810,2,4,0
48844,6,1,170812,170812,170813,0,1,2
48845,1,1,170813,170813,170814,0,1,0
48846,5,1,170818,170818,170819,0,1,4
48847,3,3,170821,170821,170824,0,3,2
48848,1,2,170822,170824,170826,2,4,0
48849,4,2,170826,170826,170828,0,2,0
48850,5,2,170831,170831,170833,0,2,3
48851,2,2,170833,170833,170835,0,2,0
48852,1,3,170834,170835,170838,1,4,0
48853,6,2,170840,170840,170842,0,2,2
48854,5,1,170845,170845,170846,0,1,3
48855,1,2,170846,170846,170848,0,2,0
48856,5,2,170851,170851,170853,0,2,3
48857,1,2,170852,170853,170855,1,3,0
48858,6,3,170858,170858,170861,0,3,3
48859,6,2,170864,170864,170866,0,2,3
48860,5,3,170869,170869,170872,0,3,3
48861,5,1,170874,170874,170875,0,1,2
48862,3,2,170877,170877,170879,0,2,2
48863,2,2,170879,170879,170881,0,2,0
48864,3,2,170882,170882,170884,0,2,1
48865,5,2,170887,170887,170889,0,2,3
48866,3,2,170890,170890,170892,0,2,1
48867,3,2,170893,170893,170895,0,2,1
48868,4,3,170897,170897,170900,0,3,2
48869,5,3,170902,170902,170905,0,3,2
48870,1,2,170903,170905,170907,2,4,0
48871,4,2,170907,170907,170909,0,2,0
48872,2,3,170909,170909,170912,0,3,0
48873,1,3,170910,170912,170915,2,5,0
48874,1,1,170911,170915,170916,4,5,0
48875,5,3,170916,170916,170919,0,3,0
48876,1,3,170917,170919,170922,2,5,0
48877,1,3,170918,170922,170925,4,7,0
48878,3,2,170921,170925,170927,4,6,0
48879,3,3,170924,170927,170930,3,6,0
48880,2,2,170926,170930,170932,4,6,0
48881,3,2,170929,170932,170934,3,5,0
48882,6,2,170935,170935,170937,0,2,1
48883,1,3,170936,170937,170940,1,4,0
48884,4,1,170940,170940,170941,0,1,0
48885,2,2,170942,170942,170944,0,2,1
48886,3,1,170945,170945,170946,0,1,1
48887,4,3,170949,170949,170952,0,3,3
48888,5,3,170954,170954,170957,0,3,2
48889,1,3,170955,170957,170960,2,5,0
48890,5,2,170960,170960,170962,0,2,0
48891,5,2,170965,170965,170967,0,2,3
48892,6,2,170971,170971,170973,0,2,4
48893,2,3,170973,170973,170976,0,3,0
48894,3,1,170976,170976,170977,0,1,0
48895,1,1,170977,170977,170978,0,1,0
48896,3,1,170980,170980,170981,0,1,2
48897,4,3,170984,170984,170987,0,3,3
48898,5,1,170989,170989,170990,0,1,2
48899,1,1,170990,170990,170991,0,1,0
48900,6,3,170996,170996,170999,0,3,5
48901,1,1,170997,170999,171000,2,3,0
48902,5,2,171002,171002,171004,0,2,2
48903,6,1,171008,171008,171009,0,1,4
48904,4,3,171012,171012,171015,0,3,3
48905,4,1,171016,171016,171017,0,1,1
48906,4,2,171020,171020,171022,0,2,3
48907,1,2,171021,171022,171024,1,3,0
48908,1,1,171022,171024,171025,2,3,0
48909,1,2,171023,171025,171027,2,4,0
48910,3,1,171026,171027,171028,1,2,0
48911,5,1,171031,171031,171032,0,1,3
48912,3,3,171034,171034,171037,0,3,2
48913,5,2,171039,171039,171041,0,2,2
48914,4,2,171043,171043,171045,0,2,2
48915,5,1,171048,171048,171049,0,1,3
48916,5,3,171053,171053,171056,0,3,4
48917,4,1,171057,171057,171058,0,1,1
48918,1,2,171058,171058,171060,0,2,0
48919,4,3,171062,171062,171065,0,3,2
48920,2,3,171064,171065,171068,1,4,0
48921,6,3,171070,171070,171073,0,3,2
48922,1,1,171071,171073,171074,2,3,0
48923,6,1,171077,171077,171078,0,1,3
48924,2,2,171079,171079,171081,0,2,1
48925,6,2,171085,171085,171087,0,2,4
48926,5,1,171090,171090,171091,0,1,3
48927,5,3,171095,171095,171098,0,3,4
48928,6,1,171101,171101,171102,0,1,3
48929,3,3,171104,171104,171107,0,3,2
48930,3,3,171107,171107,171110,0,3,0
48931,1,1,171108,171110,171111,2,3,0
48932,3,2,171111,171111,171113,0,2,0
48933,4,1,171115,171115,171116,0,1,2
48934,5,3,171120,171120,171123,0,3,4
48935,5,2,171125,171125,171127,0,2,2
48936,4,2,171129,171129,171131,0,2,2
48937,2,2,171131,171131,171133,0,2,0
48938,2,2,171133,171133,171135,0,2,0
48939,2,3,171135,171135,171138,0,3,0
48940,1,2,171136,171138,171140,2,4,0
48941,1,3,171137,171140,171143,3,6,0
48942,3,2,171140,171143,171145,3,5,0
48943,4,2,171144,171145,171147,1,3,0
48944,4,2,171148,171148,171150,0,2,1
48945,5,2,171153,171153,171155,0,2,3
48946,6,2,171159,171159,171161,0,2,4
48947,4,2,171163,171163,171165,0,2,2
48948,4,3,171167,171167,171170,0,3,2
48949,6,3,171173,171173,171176,0,3,3
48950,3,3,171176,171176,171179,0,3,0
48951,6,1,171182,171182,171183,0,1,3
48952,5,2,171187,171187,171189,0,2,4
48953,4,1,171191,171191,171192,0,1,2
48954,3,3,171194,171194,171197,0,3,2
48955,4,3,171198,171198,171201,0,3,1
48956,4,2,171202,171202,171204,0,2,1
48957,1,2,171203,171204,171206,1,3,0
48958,1,1,171204,171206,171207,2,3,0
48959,4,3,171208,171208,171211,0,3,1
48960,4,3,171212,171212,171215,0,3,1
48961,4,3,171216,171216,171219,0,3,1
48962,2,2,171218,171219,171221,1,3,0
48963,1,2,171219,171221,171223,2,4,0
48964,4,3,171223,171223,171226,0,3,0
48965,6,1,171229,171229,171230,0,1,3
48966,5,3,171234,171234,171237,0,3,4
48967,2,3,171236,171237,171240,1,4,0
48968,1,2,171237,171240,171242,3,5,0
48969,1,3,171238,171242,171245,4,7,0
48970,5,3,171243,171245,171248,2,5,0
48971,1,1,171244,171248,171249,4,5,0
48972,5,2,171249,171249,171251,0,2,0
48973,6,2,171255,171255,171257,0,2,4
48974,2,1,171257,171257,171258,0,1,0
48975,2,2,171259,171259,171261,0,2,1
48976,4,1,171263,171263,171264,0,1,2
48977,4,1,171267,171267,171268,0,1,3
48978,1,2,171268,171268,171270,0,2,0
48979,1,2,171269,171270,171272,1,3,0
48980,1,1,171270,171272,171273,2,3,0
48981,6,3,171276,171276,171279,0,3,3
48982,6,3,171282,171282,171285,0,3,3
48983,2,3,171284,171285,171288,1,4,0
48984,2,2,171286,171288,171290,2,4,0
48985,5,1,171291,171291,171292,0,1,1
48986,6,3,171297,171297,171300,0,3,5
48987,6,2,171303,171303,171305,0,2,3
48988,1,2,171304,171305,171307,1,3,0
48989,3,2,171307,171307,171309,0,2,0
48990,5,3,171312,171312,171315,0,3,3
48991,6,3,171318,171318,171321,0,3,3
48992,2,2,171320,171321,171323,1,3,0
48993,1,3,171321,171323,171326,2,5,0
48994,1,3,171322,171326,171329,4,7,0
48995,5,3,171327,171329,171332,2,5,0
48996,6,2,171333,171333,171335,0,2,1
48997,1,3,171334,171335,171338,1,4,0
48998,2,3,171336,171338,171341,2,5,0
48999,3,1,171339,171341,171342,2,3,0
49000,3,3,171342,171342,171345,0,3,0
49001,5,1,171347,171347,171348,0,1,2
49002,6,1,171353,171353,171354,0,1,5
49003,4,3,171357,171357,171360,0,3,3
49004,4,3,171361,171361,171364,0,3,1
49005,5,3,171366,171366,171369,0,3,2
49006,3,2,171369,171369,171371,0,2,0
49007,6,3,171375,171375,171378,0,3,4
49008,4,1,171379,171379,171380,0,1,1
49009,6,1,171385,171385,171386,0,1,5
49010,1,2,171386,171386,171388,0,2,0
49011,3,1,171389,171389,171390,0,1,1
49012,1,1,171390,171390,171391,0,1,0
49013,1,1,171391,171391,171392,0,1,0
49014,5,3,171396,171396,171399,0,3,4
49015,2,2,171398,171399,171401,1,3,0
49016,5,3,171403,171403,171406,0,3,2
49017,5,1,171408,171408,171409,0,1,2
49018,2,2,171410,171410,171412,0,2,1
49019,6,1,171416,171416,171417,0,1,4
49020,3,3,171419,171419,171422,0,3,2
49021,4,2,171423,171423,171425,0,2,1
49022,5,1,171428,171428,171429,0,1,3
49023,5,3,171433,171433,171436,0,3,4
49024,3,3,171436,171436,171439,0,3,0
49025,5,2,171441,171441,171443,0,2,2
49026,3,1,171444,171444,171445,0,1,1
49027,3,1,171447,171447,171448,0,1,2
49028,6,3,171453,171453,171456,0,3,5
49029,6,3,171459,171459,171462,0,3,3
49030,5,3,171464,171464,171467,0,3,2
49031,1,3,171465,171467,171470,2,5,0
49032,3,1,171468,171470,171471,2,3,0
49033,4,2,171472,171472,171474,0,2,1
49034,3,2,171475,171475,171477,0,2,1
49035,3,2,171478,171478,171480,0,2,1
49036,2,3,171480,171480,171483,0,3,0
49037,2,1,171482,171483,171484,1,2,0
49038,2,3,171484,171484,171487,0,3,0
49039,3,1,171487,171487,171488,0,1,0
49040,3,1,171490,171490,171491,0,1,2
49041,5,2,171495,171495,171497,0,2,4
49042,2,1,171497,171497,171498,0,1,0
49043,6,2,171503,171503,171505,0,2,5
49044,2,1,171505,171505,171506,0,1,0
49045,3,3,171508,171508,171511,0,3,2
49046,3,3,171511,171511,171514,0,3,0
49047,6,3,171517,171517,171520,0,3,3
49048,5,1,171522,171522,171523,0,1,2
49049,5,1,171527,171527,171528,0,1,4
49050,2,3,171529,171529,171532,0,3,1
49051,4,2,171533,171533,171535,0,2,1
49052,5,2,171538,171538,171540,0,2,3
49053,5,1,171543,171543,171544,0,1,3
49054,5,2,171548,171548,171550,0,2,4
49055,1,2,171549,171550,171552,1,3,0
49056,3,2,171552,171552,171554,0,2,0
49057,6,2,171558,171558,171560,0,2,4
49058,2,1,171560,171560,171561,0,1,0
49059,1,2,171561,171561,171563,0,2,0
49060,4,3,171565,171565,171568,0,3,2
49061,1,2,171566,171568,171570,2,4,0
49062,2,3,171568,171570,171573,2,5,0
49063,1,3,171569,171573,171576,4,7,0
49064,5,1,171574,171576,171577,2,3,0
49065,2,1,171576,171577,171578,1,2,0
49066,6,3,171582,171582,171585,0,3,4
49067,3,2,171585,171585,171587,0,2,0
49068,6,2,171591,171591,171593,0,2,4
49069,1,2,171592,171593,171595,1,3,0
49070,1,3,171593,171595,171598,2,5,0
49071,6,3,171599,171599,171602,0,3,1
49072,5,1,171604,171604,171605,0,1,2
49073,3,3,171607,171607,171610,0,3,2
49074,5,2,171612,171612,171614,0,2,2
49075,5,2,171617,171617,171619,0,2,3
49076,2,2,171619,171619,171621,0,2,0
49077,5,3,171624,171624,171627,0,3,3
49078,3,2,171627,171627,171629,0,2,0
49079,4,3,171631,171631,171634,0,3,2
49080,3,2,171634,171634,171636,0,2,0
49081,1,2,171635,171636,171638,1,3,0
49082,6,3,171641,171641,171644,0,3,3
49083,5,3,171646,171646,171649,0,3,2
49084,1,3,171647,171649,171652,2,5,0
49085,3,3,171650,171652,171655,2,5,0
49086,5,1,171655,171655,171656,0,1,0
49087,2,3,171657,171657,171660,0,3,1
49088,4,3,171661,171661,171664,0,3,1
49089,5,1,171666,171666,171667,0,1,2
49090,3,2,171669,171669,171671,0,2,2
49091,1,3,171670,171671,171674,1,4,0
49092,5,1,171675,171675,171676,0,1,1
49093,2,2,171677,171677,171679,0,2,1
49094,6,3,171683,171683,171686,0,3,4
49095,2,1,171685,171686,171687,1,2,0
49096,6,2,171691,171691,171693,0,2,4
49097,3,2,171694,171694,171696,0,2,1
49098,5,3,171699,171699,171702,0,3,3
49099,6,2,171705,171705,171707,0,2,3
49100,2,2,171707,171707,171709,0,2,0
49101,3,3,171710,171710,171713,0,3,1
49102,3,2,171713,171713,171715,0,2,0
49103,6,2,171719,171719,171721,0,2,4
49104,1,2,171720,171721,171723,1,3,0
49105,2,2,171722,171723,171725,1,3,0
49106,4,3,171726,171726,171729,0,3,1
49107,4,2,171730,171730,171732,0,2,1
49108,1,1,171731,171732,171733,1,2,0
49109,4,2,171735,171735,171737,0,2,2
49110,6,2,171741,171741,171743,0,2,4
49111,5,3,171746,171746,171749,0,3,3
49112,3,3,171749,171749,171752,0,3,0
49113,2,1,171751,171752,171753,1,2,0
49114,3,1,171754,171754,171755,0,1,1
49115,2,3,171756,171756,171759,0,3,1
49116,6,3,171762,171762,171765,0,3,3
49117,5,3,171767,171767,171770,0,3,2
49118,4,2,171771,171771,171773,0,2,1
49119,2,2,171773,171773,171775,0,2,0
49120,4,2,171777,171777,171779,0,2,2
49121,2,1,171779,171779,171780,0,1,0
49122,5,3,171784,171784,171787,0,3,4
49123,2,2,171786,171787,171789,1,3,0
49124,1,1,171787,171789,171790,2,3,0
49125,3,3,171790,171790,171793,0,3,0
49126,2,1,171792,171793,171794,1,2,0
49127,1,2,171793,171794,171796,1,3,0
49128,6,2,171799,171799,171801,0,2,3
49129,1,3,171800,171801,171804,1,4,0
49130,4,2,171804,171804,171806,0,2,0
49131,3,2,171807,171807,171809,0,2,1
49132,2,3,171809,171809,171812,0,3,0
49133,2,3,171811,171812,171815,1,4,0
49134,3,2,171814,171815,171817,1,3,0
49135,3,2,171817,171817,171819,0,2,0
49136,5,3,171822,171822,171825,0,3,3
49137,4,3,171826,171826,171829,0,3,1
49138,1,1,171827,171829,171830,2,3,0
49139,3,3,171830,171830,171833,0,3,0
49140,5,1,171835,171835,171836,0,1,2
49141,6,3,171841,171841,171844,0,3,5
49142,4,1,171845,171845,171846,0,1,1
49143,6,2,171851,171851,171853,0,2,5
49144,2,3,171853,171853,171856,0,3,0
49145,5,1,171858,171858,171859,0,1,2
49146,5,2,171863,171863,171865,0,2,4
49147,5,2,171868,171868,171870,0,2,3
49148,5,1,171873,171873,171874,0,1,3
49149,4,2,171877,171877,171879,0,2,3
49150,3,3,171880,171880,171883,0,3,1
49151,6,1,171886,171886,171887,0,1,3
49152,5,3,171891,171891,171894,0,3,4
49153,4,3,171895,171895,171898,0,3,1
49154,6,1,171901,171901,171902,0,1,3
49155,4,1,171905,171905,171906,0,1,3
49156,1,1,171906,171906,171907,0,1,0
49157,1,1,171907,171907,171908,0,1,0
49158,2,3,171909,171909,171912,0,3,1
49159,1,1,171910,171912,171913,2,3,0
49160,6,2,171916,171916,171918,0,2,3
49161,5,2,171921,171921,171923,0,2,3
49162,1,3,171922,171923,171926,1,4,0
49163,3,1,171925,171926,171927,1,2,0
49164,4,2,171929,171929,171931,0,2,2
49165,4,1,171933,171933,171934,0,1,2
49166,6,1,171939,171939,171940,0,1,5
49167,1,1,171940,171940,171941,0,1,0
49168,5,3,171945,171945,171948,0,3,4
49169,1,3,171946,171948,171951,2,5,0
49170,2,3,171948,171951,171954,3,6,0
49171,3,3,171951,171954,171957,3,6,0
49172,1,2,171952,171957,171959,5,7,0
49173,6,1,171958,171959,171960,1,2,0
49174,5,1,171963,171963,171964,0,1,3
49175,5,2,171968,171968,171970,0,2,4
49176,1,2,171969,171970,171972,1,3,0
49177,6,2,171975,171975,171977,0,2,3
49178,5,1,171980,171980,171981,0,1,3
49179,4,3,171984,171984,171987,0,3,3
49180,5,3,171989,171989,171992,0,3,2
49181,1,2,171990,171992,171994,2,4,0
49182,3,2,171993,171994,171996,1,3,0
49183,3,3,171996,171996,171999,0,3,0
49184,1,1,171997,171999,172000,2,3,0
49185,4,1,172001,172001,172002,0,1,1
49186,6,1,172007,172007,172008,0,1,5
49187,2,1,172009,172009,172010,0,1,1
49188,6,1,172015,172015,172016,0,1,5
49189,1,3,172016,172016,172019,0,3,0
49190,2,3,172018,172019,172022,1,4,0
49191,4,2,172022,172022,172024,0,2,0
49192,2,2,172024,172024,172026,0,2,0
49193,6,3,172030,172030,172033,0,3,4
49194,5,3,172035,172035,172038,0,3,2
49195,6,2,172041,172041,172043,0,2,3
49196,2,2,172043,172043,172045,0,2,0
49197,5,2,172048,172048,172050,0,2,3
49198,1,1,172049,172050,172051,1,2,0
49199,1,3,172050,172051,172054,1,4,0
49200,4,3,172054,172054,172057,0,3,0
49201,1,2,172055,172057,172059,2,4,0
49202,3,1,172058,172059,172060,1,2,0
49203,6,2,172064,172064,172066,0,2,4
49204,1,3,172065,172066,172069,1,4,0
49205,3,3,172068,172069,172072,1,4,0
49206,2,3,172070,172072,172075,2,5,0
49207,6,2,172076,172076,172078,0,2,1
49208,4,3,172080,172080,172083,0,3,2
49209,6,1,172086,172086,172087,0,1,3
49210,3,3,172089,172089,172092,0,3,2
49211,5,3,172094,172094,172097,0,3,2
49212,2,2,172096,172097,172099,1,3,0
49213,6,3,172102,172102,172105,0,3,3
49214,4,2,172106,172106,172108,0,2,1
49215,4,2,172110,172110,172112,0,2,2
49216,1,3,172111,172112,172115,1,4,0
49217,5,1,172116,172116,172117,0,1,1
49218,2,2,172118,172118,172120,0,2,1
49219,5,2,172123,172123,172125,0,2,3
49220,1,1,172124,172125,172126,1,2,0
49221,6,3,172130,172130,172133,0,3,4
49222,2,1,172132,172133,172134,1,2,0
49223,3,3,172135,172135,172138,0,3,1
49224,6,2,172141,172141,172143,0,2,3
49225,4,1,172145,172145,172146,0,1,2
49226,1,1,172146,172146,172147,0,1,0
49227,5,1,172151,172151,172152,0,1,4
49228,3,1,172154,172154,172155,0,1,2
49229,2,3,172156,172156,172159,0,3,1
49230,6,3,172162,172162,172165,0,3,3
49231,4,2,172166,172166,172168,0,2,1
49232,6,1,172172,172172,172173,0,1,4
49233,2,2,172174,172174,172176,0,2,1
49234,6,3,172180,172180,172183,0,3,4
49235,5,2,172185,172185,172187,0,2,2
49236,3,3,172188,172188,172191,0,3,1
49237,4,1,172192,172192,172193,0,1,1
49238,6,2,172198,172198,172200,0,2,5
49239,5,1,172203,172203,172204,0,1,3
49240,3,1,172206,172206,172207,0,1,2
49241,1,2,172207,172207,172209,0,2,0
49242,5,3,172212,172212,172215,0,3,3
49243,4,3,172216,172216,172219,0,3,1
49244,3,1,172219,172219,172220,0,1,0
49245,1,1,172220,172220,172221,0,1,0
49246,3,3,172223,172223,172226,0,3,2
49247,4,2,172227,172227,172229,0,2,1
49248,6,3,172233,172233,172236,0,3,4
49249,4,2,172237,172237,172239,0,2,1
49250,6,3,172243,172243,172246,0,3,4
49251,1,2,172244,172246,172248,2,4,0
49252,3,1,172247,172248,172249,1,2,0
49253,1,2,172248,172249,172251,1,3,0
49254,2,2,172250,172251,172253,1,3,0
49255,1,3,172251,172253,172256,2,5,0
49256,2,2,172253,172256,172258,3,5,0
49257,2,1,172255,172258,172259,3,4,0
49258,1,2,172256,172259,172261,3,5,0
49259,4,3,172260,172261,172264,1,4,0
49260,6,3,172266,172266,172269,0,3,2
49261,3,1,172269,172269,172270,0,1,0
49262,4,1,172273,172273,172274,0,1,3
49263,4,3,172277,172277,172280,0,3,3
49264,1,2,172278,172280,172282,2,4,0
49265,6,1,172284,172284,172285,0,1,2
49266,1,2,172285,172285,172287,0,2,0
49267,1,2,172286,172287,172289,1,3,0
49268,6,3,172292,172292,172295,0,3,3
49269,1,3,172293,172295,172298,2,5,0
49270,4,3,172297,172298,172301,1,4,0
49271,3,3,172300,172301,172304,1,4,0
49272,2,3,172302,172304,172307,2,5,0
49273,5,3,172307,172307,172310,0,3,0
49274,5,2,172312,172312,172314,0,2,2
49275,2,3,172314,172314,172317,0,3,0
49276,3,1,172317,172317,172318,0,1,0
49277,3,1,172320,172320,172321,0,1,2
49278,6,2,172326,172326,172328,0,2,5
49279,5,3,172331,172331,172334,0,3,3
49280,1,1,172332,172334,172335,2,3,0
49281,2,3,172334,172335,172338,1,4,0
49282,6,2,172340,172340,172342,0,2,2
49283,1,3,172341,172342,172345,1,4,0
49284,1,2,172342,172345,172347,3,5,0
49285,6,1,172348,172348,172349,0,1,1
49286,6,2,172354,172354,172356,0,2,5
49287,1,3,172355,172356,172359,1,4,0
49288,4,1,172359,172359,172360,0,1,0
49289,5,3,172364,172364,172367,0,3,4
49290,6,3,172370,172370,172373,0,3,3
49291,1,2,172371,172373,172375,2,4,0
49292,5,1,172376,172376,172377,0,1,1
49293,3,2,172379,172379,172381,0,2,2
49294,5,3,172384,172384,172387,0,3,3
49295,5,1,172389,172389,172390,0,1,2
49296,4,2,172393,172393,172395,0,2,3
49297,1,1,172394,172395,172396,1,2,0
49298,1,2,172395,172396,172398,1,3,0
49299,5,3,172400,172400,172403,0,3,2
49300,3,2,172403,172403,172405,0,2,0
49301,3,2,172406,172406,172408,0,2,1
49302,2,2,172408,172408,172410,0,2,0
49303,5,1,172413,172413,172414,0,1,3
49304,3,1,172416,172416,172417,0,1,2
49305,2,1,172418,172418,172419,0,1,1
49306,5,3,172423,172423,172426,0,3,4
49307,1,2,172424,172426,172428,2,4,0
49308,4,3,172428,172428,172431,0,3,0
49309,5,1,172433,172433,172434,0,1,2
49310,2,3,172435,172435,172438,0,3,1
49311,5,3,172440,172440,172443,0,3,2
49312,4,1,172444,172444,172445,0,1,1
49313,3,2,172447,172447,172449,0,2,2
49314,5,1,172452,172452,172453,0,1,3
49315,2,3,172454,172454,172457,0,3,1
49316,3,2,172457,172457,172459,0,2,0
49317,3,2,172460,172460,172462,0,2,1
49318,5,3,172465,172465,172468,0,3,3
49319,1,2,172466,172468,172470,2,4,0
49320,4,1,172470,172470,172471,0,1,0
49321,4,2,172474,172474,172476,0,2,3
49322,1,3,172475,172476,172479,1,4,0
49323,3,2,172478,172479,172481,1,3,0
49324,4,1,172482,172482,172483,0,1,1
49325,6,2,172488,172488,172490,0,2,5
49326,3,1,172491,172491,172492,0,1,1
49327,3,3,172494,172494,172497,0,3,2
49328,5,2,172499,172499,172501,0,2,2
49329,4,3,172503,172503,172506,0,3,2
49330,3,2,172506,172506,172508,0,2,0
49331,4,1,172510,172510,172511,0,1,2
49332,3,2,172513,172513,172515,0,2,2
49333,3,2,172516,172516,172518,0,2,1
49334,4,3,172520,172520,172523,0,3,2
49335,5,1,172525,172525,172526,0,1,2
49336,2,3,172527,172527,172530,0,3,1
49337,1,2,172528,172530,172532,2,4,0
49338,6,1,172534,172534,172535,0,1,2
49339,1,2,172535,172535,172537,0,2,0
49340,1,1,172536,172537,172538,1,2,0
49341,2,3,172538,172538,172541,0,3,0
49342,1,1,172539,172541,172542,2,3,0
49343,1,2,172540,172542,172544,2,4,0
49344,2,1,172542,172544,172545,2,3,0
49345,2,3,172544,172545,172548,1,4,0
49346,1,2,172545,172548,172550,3,5,0
49347,1,2,172546,172550,172552,4,6,0
49348,1,3,172547,172552,172555,5,8,0
49349,2,1,172549,172555,172556,6,7,0
49350,4,2,172553,172556,172558,3,5,0
49351,3,3,172556,172558,172561,2,5,0
49352,1,3,172557,172561,172564,4,7,0
49353,5,3,172562,172564,172567,2,5,0
49354,6,3,172568,172568,172571,0,3,1
49355,6,2,172574,172574,172576,0,2,3
49356,4,2,172578,172578,172580,0,2,2
49357,4,3,172582,172582,172585,0,3,2
49358,1,3,172583,172585,172588,2,5,0
49359,3,1,172586,172588,172589,2,3,0
49360,2,2,172588,172589,172591,1,3,0
49361,6,2,172594,172594,172596,0,2,3
49362,2,2,172596,172596,172598,0,2,0
49363,1,1,172597,172598,172599,1,2,0
49364,2,3,172599,172599,172602,0,3,0
49365,1,3,172600,172602,172605,2,5,0
49366,5,1,172605,172605,172606,0,1,0
49367,3,1,172608,172608,172609,0,1,2
49368,4,3,172612,172612,172615,0,3,3
49369,1,2,172613,172615,172617,2,4,0
49370,4,2,172617,172617,172619,0,2,0
49371,6,3,172623,172623,172626,0,3,4
49372,2,3,172625,172626,172629,1,4,0
49373,5,3,172630,172630,172633,0,3,1
49374,5,2,172635,172635,172637,0,2,2
49375,1,1,172636,172637,172638,1,2,0
49376,3,1,172639,172639,172640,0,1,1
49377,3,3,172642,172642,172645,0,3,2
49378,4,2,172646,172646,172648,0,2,1
49379,3,3,172649,172649,172652,0,3,1
49380,4,1,172653,172653,172654,0,1,1
49381,1,1,172654,172654,172655,0,1,0
49382,2,3,172656,172656,172659,0,3,1
49383,6,2,172662,172662,172664,0,2,3
49384,5,3,172667,172667,172670,0,3,3
49385,2,3,172669,172670,172673,1,4,0
49386,3,1,172672,172673,172674,1,2,0
49387,1,3,172673,172674,172677,1,4,0
49388,6,1,172679,172679,172680,0,1,2
49389,5,2,172684,172684,172686,0,2,4
49390,6,2,172690,172690,172692,0,2,4
49391,1,1,172691,172692,172693,1,2,0
49392,2,2,172693,172693,172695,0,2,0
49393,4,1,172697,172697,172698,0,1,2
49394,2,1,172699,172699,172700,0,1,1
49395,3,3,172702,172702,172705,0,3,2
49396,6,3,172708,172708,172711,0,3,3
49397,3,2,172711,172711,172713,0,2,0
49398,2,2,172713,172713,172715,0,2,0
49399,6,1,172719,172719,172720,0,1,4
49400,6,3,172725,172725,172728,0,3,5
49401,5,2,172730,172730,172732,0,2,2
49402,4,2,172734,172734,172736,0,2,2
49403,3,3,172737,172737,172740,0,3,1
49404,6,3,172743,172743,172746,0,3,3
49405,2,3,172745,172746,172749,1,4,0
49406,3,3,172748,172749,172752,1,4,0
49407,3,3,172751,172752,172755,1,4,0
49408,5,3,172756,172756,172759,0,3,1
49409,1,1,172757,172759,172760,2,3,0
49410,1,1,172758,172760,172761,2,3,0
49411,4,1,172762,172762,172763,0,1,1
49412,4,1,172766,172766,172767,0,1,3
49413,1,3,172767,172767,172770,0,3,0
49414,3,2,172770,172770,172772,0,2,0
49415,1,3,172771,172772,172775,1,4,0
49416,1,1,172772,172775,172776,3,4,0
49417,5,1,172777,172777,172778,0,1,1
49418,4,2,172781,172781,172783,0,2,3
49419,4,2,172785,172785,172787,0,2,2
49420,1,2,172786,172787,172789,1,3,0
49421,6,1,172792,172792,172793,0,1,3
49422,4,3,172796,172796,172799,0,3,3
49423,4,1,172800,172800,172801,0,1,1
49424,5,3,172805,172805,172808,0,3,4
49425,5,3,172810,172810,172813,0,3,2
49426,4,2,172814,172814,172816,0,2,1
49427,5,2,172819,172819,172821,0,2,3
49428,3,2,172822,172822,172824,0,2,1
49429,1,3,172823,172824,172827,1,4,0
49430,2,2,172825,172827,172829,2,4,0
49431,1,1,172826,172829,172830,3,4,0
49432,3,2,172829,172830,172832,1,3,0
49433,1,3,172830,172832,172835,2,5,0
49434,3,1,172833,172835,172836,2,3,0
49435,2,2,172835,172836,172838,1,3,0
49436,3,2,172838,172838,172840,0,2,0
49437,3,2,172841,172841,172843,0,2,1
49438,3,2,172844,172844,172846,0,2,1
49439,2,1,172846,172846,172847,0,1,0
49440,5,3,172851,172851,172854,0,3,4
49441,1,2,172852,172854,172856,2,4,0
49442,3,1,172855,172856,172857,1,2,0
49443,3,3,172858,172858,172861,0,3,1
49444,5,2,172863,172863,172865,0,2,2
49445,4,2,172867,172867,172869,0,2,2
49446,3,3,172870,172870,172873,0,3,1
49447,1,2,172871,172873,172875,2,4,0
49448,1,3,172872,172875,172878,3,6,0
49449,5,2,172877,172878,172880,1,3,0
49450,3,1,172880,172880,172881,0,1,0
49451,4,3,172884,172884,172887,0,3,3
49452,1,1,172885,172887,172888,2,3,0
49453,1,1,172886,172888,172889,2,3,0
49454,2,3,172888,172889,172892,1,4,0
49455,6,1,172894,172894,172895,0,1,2
49456,3,2,172897,172897,172899,0,2,2
49457,3,1,172900,172900,172901,0,1,1
49458,2,1,172902,172902,172903,0,1,1
49459,2,1,172904,172904,172905,0,1,1
49460,3,2,172907,172907,172909,0,2,2
49461,5,1,172912,172912,172913,0,1,3
49462,2,2,172914,172914,172916,0,2,1
49463,5,2,172919,172919,172921,0,2,3
49464,2,2,172921,172921,172923,0,2,0
49465,4,2,172925,172925,172927,0,2,2
49466,2,1,172927,172927,172928,0,1,0
49467,5,1,172932,172932,172933,0,1,4
49468,5,3,172937,172937,172940,0,3,4
49469,3,1,172940,172940,172941,0,1,0
49470,5,2,172945,172945,172947,0,2,4
49471,5,2,172950,172950,172952,0,2,3
49472,2,2,172952,172952,172954,0,2,0
49473,4,1,172956,172956,172957,0,1,2
49474,5,3,172961,172961,172964,0,3,4
49475,1,2,172962,172964,172966,2,4,0
49476,4,3,172966,172966,172969,0,3,0
49477,3,3,172969,172969,172972,0,3,0
49478,3,2,172972,172972,172974,0,2,0
49479,5,3,172977,172977,172980,0,3,3
49480,4,1,172981,172981,172982,0,1,1
49481,4,1,172985,172985,172986,0,1,3
49482,1,3,172986,172986,172989,0,3,0
49483,3,1,172989,172989,172990,0,1,0
49484,1,3,172990,172990,172993,0,3,0
49485,3,2,172993,172993,172995,0,2,0
49486,3,2,172996,172996,172998,0,2,1
49487,6,3,173002,173002,173005,0,3,4
49488,1,2,173003,173005,173007,2,4,0
49489,5,3,173008,173008,173011,0,3,1
49490,4,2,173012,173012,173014,0,2,1
49491,6,1,173018,173018,173019,0,1,4
49492,6,2,173024,173024,173026,0,2,5
49493,6,1,173030,173030,173031,0,1,4
49494,5,1,173035,173035,173036,0,1,4
49495,6,1,173041,173041,173042,0,1,5
49496,2,3,173043,173043,173046,0,3,1
49497,2,1,173045,173046,173047,1,2,0
49498,5,3,173050,173050,173053,0,3,3
49499,1,2,173051,173053,173055,2,4,0
49500,6,1,173057,173057,173058,0,1,2
49501,6,3,173063,173063,173066,0,3,5
49502,4,2,173067,173067,173069,0,2,1
49503,1,3,173068,173069,173072,1,4,0
49504,6,1,173074,173074,173075,0,1,2
49505,4,1,173078,173078,173079,0,1,3
49506,6,3,173084,173084,173087,0,3,5
49507,6,2,173090,173090,173092,0,2,3
49508,3,2,173093,173093,173095,0,2,1
49509,5,3,173098,173098,173101,0,3,3
49510,4,1,173102,173102,173103,0,1,1
49511,6,1,173108,173108,173109,0,1,5
49512,2,2,173110,173110,173112,0,2,1
49513,6,1,173116,173116,173117,0,1,4
49514,1,1,173117,173117,173118,0,1,0
49515,5,3,173122,173122,173125,0,3,4
49516,1,1,173123,173125,173126,2,3,0
49517,2,2,173125,173126,173128,1,3,0
49518,3,1,173128,173128,173129,0,1,0
49519,3,3,173131,173131,173134,0,3,2
49520,2,3,173133,173134,173137,1,4,0
49521,6,3,173139,173139,173142,0,3,2
49522,4,2,173143,173143,173145,0,2,1
49523,2,3,173145,173145,173148,0,3,0
49524,6,1,173151,173151,173152,0,1,3
49525,4,1,173155,173155,173156,0,1,3
49526,2,2,173157,173157,173159,0,2,1
49527,6,2,173163,173163,173165,0,2,4
49528,5,2,173168,173168,173170,0,2,3
49529,4,2,173172,173172,173174,0,2,2
49530,3,2,173175,173175,173177,0,2,1
49531,1,2,173176,173177,173179,1,3,0
49532,2,1,173178,173179,173180,1,2,0
49533,6,1,173184,173184,173185,0,1,4
49534,1,2,173185,173185,173187,0,2,0
49535,4,2,173189,173189,173191,0,2,2
49536,6,3,173195,173195,173198,0,3,4
49537,5,3,173200,173200,173203,0,3,2
49538,6,1,173206,173206,173207,0,1,3
49539,1,2,173207,173207,173209,0,2,0
49540,4,2,173211,173211,173213,0,2,2
49541,5,1,173216,173216,173217,0,1,3
49542,4,1,173220,173220,173221,0,1,3
49543,6,3,173226,173226,173229,0,3,5
49544,5,1,173231,173231,173232,0,1,2
49545,5,3,173236,173236,173239,0,3,4
49546,4,2,173240,173240,173242,0,2,1
49547,6,1,173246,173246,173247,0,1,4
49548,3,2,173249,173249,173251,0,2,2
49549,3,2,173252,173252,173254,0,2,1
49550,4,2,173256,173256,173258,0,2,2
49551,4,1,173260,173260,173261,0,1,2
49552,2,1,173262,173262,173263,0,1,1
49553,1,3,173263,173263,173266,0,3,0
49554,5,2,173268,173268,173270,0,2,2
49555,1,3,173269,173270,173273,1,4,0
49556,1,1,173270,173273,173274,3,4,0
49557,3,3,173273,173274,173277,1,4,0
49558,1,1,173274,173277,173278,3,4,0
49559,4,2,173278,173278,173280,0,2,0
49560,4,1,173282,173282,173283,0,1,2
49561,6,1,173288,173288,173289,0,1,5
49562,6,2,173294,173294,173296,0,2,5
49563,2,2,173296,173296,173298,0,2,0
49564,2,1,173298,173298,173299,0,1,0
49565,3,2,173301,173301,173303,0,2,2
49566,6,2,173307,173307,173309,0,2,4
49567,1,2,173308,173309,173311,1,3,0
49568,5,1,173313,173313,173314,0,1,2
49569,6,2,173319,173319,173321,0,2,5
49570,2,1,173321,173321,173322,0,1,0
49571,5,3,173326,173326,173329,0,3,4
49572,1,1,173327,173329,173330,2,3,0
49573,6,3,173333,173333,173336,0,3,3
49574,4,1,173337,173337,173338,0,1,1
49575,6,2,173343,173343,173345,0,2,5
49576,6,2,173349,173349,173351,0,2,4
49577,2,2,173351,173351,173353,0,2,0
49578,1,3,173352,173353,173356,1,4,0
49579,5,1,173357,173357,173358,0,1,1
49580,3,1,173360,173360,173361,0,1,2
49581,6,1,173366,173366,173367,0,1,5
49582,6,2,173372,173372,173374,0,2,5
49583,1,1,173373,173374,173375,1,2,0
49584,1,1,173374,173375,173376,1,2,0
49585,6,1,173380,173380,173381,0,1,4
49586,2,2,173382,173382,173384,0,2,1
49587,6,1,173388,173388,173389,0,1,4
49588,4,3,173392,173392,173395,0,3,3
49589,3,2,173395,173395,173397,0,2,0
49590,5,2,173400,173400,173402,0,2,3
49591,4,3,173404,173404,173407,0,3,2
49592,2,1,173406,173407,173408,1,2,0
49593,3,2,173409,173409,173411,0,2,1
49594,4,3,173413,173413,173416,0,3,2
49595,6,1,173419,173419,173420,0,1,3
49596,2,3,173421,173421,173424,0,3,1
49597,5,1,173426,173426,173427,0,1,2
49598,4,2,173430,173430,173432,0,2,3
49599,5,1,173435,173435,173436,0,1,3
49600,5,3,173440,173440,173443,0,3,4
49601,4,2,173444,173444,173446,0,2,1
49602,5,3,173449,173449,173452,0,3,3
49603,6,2,173455,173455,173457,0,2,3
49604,3,1,173458,173458,173459,0,1,1
49605,1,2,173459,173459,173461,0,2,0
49606,2,2,173461,173461,173463,0,2,0
49607,5,1,173466,173466,173467,0,1,3
49608,2,2,173468,173468,173470,0,2,1
49609,5,1,173473,173473,173474,0,1,3
49610,1,1,173474,173474,173475,0,1,0
49611,2,2,173476,173476,173478,0,2,1
49612,4,2,173480,173480,173482,0,2,2
49613,5,3,173485,173485,173488,0,3,3
49614,4,3,173489,173489,173492,0,3,1
49615,5,1,173494,173494,173495,0,1,2
49616,4,1,173498,173498,173499,0,1,3
49617,4,1,173502,173502,173503,0,1,3
49618,6,3,173508,173508,173511,0,3,5
49619,4,2,173512,173512,173514,0,2,1
49620,3,3,173515,173515,173518,0,3,1
49621,1,3,173516,173518,173521,2,5,0
49622,4,1,173520,173521,173522,1,2,0
49623,4,1,173524,173524,173525,0,1,2
49624,2,1,173526,173526,173527,0,1,1
49625,5,2,173531,173531,173533,0,2,4
49626,6,2,173537,173537,173539,0,2,4
49627,5,1,173542,173542,173543,0,1,3
49628,2,1,173544,173544,173545,0,1,1
49629,2,1,173546,173546,173547,0,1,1
49630,1,1,173547,173547,173548,0,1,0
49631,5,1,173552,173552,173553,0,1,4
49632,5,1,173557,173557,173558,0,1,4
49633,3,2,173560,173560,173562,0,2,2
49634,6,3,173566,173566,173569,0,3,4
49635,2,1,173568,173569,173570,1,2,0
49636,4,1,173572,173572,173573,0,1,2
49637,1,2,173573,173573,173575,0,2,0
49638,2,3,173575,173575,173578,0,3,0
49639,6,2,173581,173581,173583,0,2,3
49640,5,1,173586,173586,173587,0,1,3
49641,1,3,173587,173587,173590,0,3,0
49642,2,3,173589,173590,173593,1,4,0
49643,6,1,173595,173595,173596,0,1,2
49644,3,1,173598,173598,173599,0,1,2
49645,6,3,173604,173604,173607,0,3,5
49646,3,1,173607,173607,173608,0,1,0
49647,3,2,173610,173610,173612,0,2,2
49648,3,1,173613,173613,173614,0,1,1
49649,2,1,173615,173615,173616,0,1,1
49650,5,3,173620,173620,173623,0,3,4
49651,4,3,173624,173624,173627,0,3,1
49652,3,3,173627,173627,173630,0,3,0
49653,3,3,173630,173630,173633,0,3,0
49654,1,2,173631,173633,173635,2,4,0
49655,2,2,173633,173635,173637,2,4,0
49656,1,3,173634,173637,173640,3,6,0
49657,2,2,173636,173640,173642,4,6,0
49658,5,3,173641,173642,173645,1,4,0
49659,5,3,173646,173646,173649,0,3,1
49660,2,1,173648,173649,173650,1,2,0
49661,3,3,173651,173651,173654,0,3,1
49662,4,1,173655,173655,173656,0,1,1
49663,6,3,173661,173661,173664,0,3,5
49664,3,3,173664,173664,173667,0,3,0
49665,3,3,173667,173667,173670,0,3,0
49666,4,3,173671,173671,173674,0,3,1
49667,3,2,173674,173674,173676,0,2,0
49668,2,1,173676,173676,173677,0,1,0
49669,5,3,173681,173681,173684,0,3,4
49670,2,3,173683,173684,173687,1,4,0
49671,4,3,173687,173687,173690,0,3,0
49672,1,3,173688,173690,173693,2,5,0
49673,5,1,173693,173693,173694,0,1,0
49674,1,1,173694,173694,173695,0,1,0
49675,5,2,173699,173699,173701,0,2,4
49676,3,3,173702,173702,173705,0,3,1
49677,5,1,173707,173707,173708,0,1,2
49678,3,1,173710,173710,173711,0,1,2
49679,3,3,173713,173713,173716,0,3,2
49680,2,1,173715,173716,173717,1,2,0
49681,5,1,173720,173720,173721,0,1,3
49682,1,3,173721,173721,173724,0,3,0
49683,2,1,173723,173724,173725,1,2,0
49684,6,1,173729,173729,173730,0,1,4
49685,3,3,173732,173732,173735,0,3,2
49686,3,2,173735,173735,173737,0,2,0
49687,5,3,173740,173740,173743,0,3,3
49688,4,1,173744,173744,173745,0,1,1
49689,4,1,173748,173748,173749,0,1,3
49690,6,2,173754,173754,173756,0,2,5
49691,6,3,173760,173760,173763,0,3,4
49692,6,3,173766,173766,173769,0,3,3
49693,5,1,173771,173771,173772,0,1,2
49694,2,1,173773,173773,173774,0,1,1
49695,1,1,173774,173774,173775,0,1,0
49696,6,2,173780,173780,173782,0,2,5
49697,5,3,173785,173785,173788,0,3,3
49698,3,1,173788,173788,173789,0,1,0
49699,1,1,173789,173789,173790,0,1,0
49700,6,3,173795,173795,173798,0,3,5
49701,2,1,173797,173798,173799,1,2,0
49702,5,2,173802,173802,173804,0,2,3
49703,2,1,173804,173804,173805,0,1,0
49704,3,3,173807,173807,173810,0,3,2
49705,3,1,173810,173810,173811,0,1,0
49706,2,3,173812,173812,173815,0,3,1
49707,6,3,173818,173818,173821,0,3,3
49708,2,2,173820,173821,173823,1,3,0
49709,1,2,173821,173823,173825,2,4,0
49710,2,1,173823,173825,173826,2,3,0
49711,3,2,173826,173826,173828,0,2,0
49712,5,2,173831,173831,173833,0,2,3
49713,4,1,173835,173835,173836,0,1,2
49714,3,2,173838,173838,173840,0,2,2
49715,6,3,173844,173844,173847,0,3,4
49716,2,2,173846,173847,173849,1,3,0
49717,1,2,173847,173849,173851,2,4,0
49718,6,3,173853,173853,173856,0,3,2
49719,4,1,173857,173857,173858,0,1,1
49720,5,1,173862,173862,173863,0,1,4
49721,3,1,173865,173865,173866,0,1,2
49722,6,3,173871,173871,173874,0,3,5
49723,3,1,173874,173874,173875,0,1,0
49724,4,3,173878,173878,173881,0,3,3
49725,5,1,173883,173883,173884,0,1,2
49726,3,3,173886,173886,173889,0,3,2
49727,2,1,173888,173889,173890,1,2,0
49728,6,3,173894,173894,173897,0,3,4
49729,5,1,173899,173899,173900,0,1,2
49730,3,1,173902,173902,173903,0,1,2
49731,2,3,173904,173904,173907,0,3,1
49732,3,2,173907,173907,173909,0,2,0
49733,4,3,173911,173911,173914,0,3,2
49734,4,2,173915,173915,173917,0,2,1
49735,5,2,173920,173920,173922,0,2,3
49736,2,3,173922,173922,173925,0,3,0
49737,1,1,173923,173925,173926,2,3,0
49738,4,1,173927,173927,173928,0,1,1
49739,5,3,173932,173932,173935,0,3,4
49740,5,2,173937,173937,173939,0,2,2
49741,4,3,173941,173941,173944,0,3,2
49742,5,1,173946,173946,173947,0,1,2
49743,5,3,173951,173951,173954,0,3,4
49744,5,2,173956,173956,173958,0,2,2
49745,2,3,173958,173958,173961,0,3,0
49746,5,1,173963,173963,173964,0,1,2
49747,2,2,173965,173965,173967,0,2,1
49748,3,2,173968,173968,173970,0,2,1
49749,2,1,173970,173970,173971,0,1,0
49750,2,2,173972,173972,173974,0,2,1
49751,1,3,173973,173974,173977,1,4,0
49752,1,3,173974,173977,173980,3,6,0
49753,6,1,173980,173980,173981,0,1,0
49754,5,3,173985,173985,173988,0,3,4
49755,1,2,173986,173988,173990,2,4,0
49756,3,1,173989,173990,173991,1,2,0
49757,4,1,173993,173993,173994,0,1,2
49758,4,1,173997,173997,173998,0,1,3
49759,3,3,174000,174000,174003,0,3,2
49760,6,2,174006,174006,174008,0,2,3
49761,3,1,174009,174009,174010,0,1,1
49762,3,1,174012,174012,174013,0,1,2
49763,2,1,174014,174014,174015,0,1,1
49764,4,3,174018,174018,174021,0,3,3
49765,2,3,174020,174021,174024,1,4,0
49766,1,1,174021,174024,174025,3,4,0
49767,5,2,174026,174026,174028,0,2,1
49768,6,1,174032,174032,174033,0,1,4
49769,2,1,174034,174034,174035,0,1,1
49770,6,2,174040,174040,174042,0,2,5
49771,5,1,174045,174045,174046,0,1,3
49772,1,3,174046,174046,174049,0,3,0
49773,4,1,174050,174050,174051,0,1,1
49774,2,1,174052,174052,174053,0,1,1
49775,3,3,174055,174055,174058,0,3,2
49776,2,1,174057,174058,174059,1,2,0
49777,1,1,174058,174059,174060,1,2,0
49778,3,1,174061,174061,174062,0,1,1
49779,2,1,174063,174063,174064,0,1,1
49780,3,3,174066,174066,174069,0,3,2
49781,5,3,174071,174071,174074,0,3,2
49782,3,1,174074,174074,174075,0,1,0
49783,5,1,174079,174079,174080,0,1,4
49784,2,3,174081,174081,174084,0,3,1
49785,5,3,174086,174086,174089,0,3,2
49786,5,3,174091,174091,174094,0,3,2
49787,4,3,174095,174095,174098,0,3,1
49788,3,2,174098,174098,174100,0,2,0
49789,2,2,174100,174100,174102,0,2,0
49790,3,1,174103,174103,174104,0,1,1
49791,3,2,174106,174106,174108,0,2,2
49792,2,2,174108,174108,174110,0,2,0
49793,4,3,174112,174112,174115,0,3,2
49794,3,1,174115,174115,174116,0,1,0
49795,2,2,174117,174117,174119,0,2,1
49796,2,3,174119,174119,174122,0,3,0
49797,3,1,174122,174122,174123,0,1,0
49798,2,1,174124,174124,174125,0,1,1
49799,1,1,174125,174125,174126,0,1,0
49800,3,2,174128,174128,174130,0,2,2
49801,5,3,174133,174133,174136,0,3,3
49802,5,2,174138,174138,174140,0,2,2
49803,1,2,174139,174140,174142,1,3,0
49804,3,2,174142,174142,174144,0,2,0
49805,4,2,174146,174146,174148,0,2,2
49806,4,3,174150,174150,174153,0,3,2
49807,4,2,174154,174154,174156,0,2,1
49808,6,3,174160,174160,174163,0,3,4
49809,3,1,174163,174163,174164,0,1,0
49810,5,2,174168,174168,174170,0,2,4
49811,1,2,174169,174170,174172,1,3,0
49812,3,3,174172,174172,174175,0,3,0
49813,5,2,174177,174177,174179,0,2,2
49814,6,3,174183,174183,174186,0,3,4
49815,4,3,174187,174187,174190,0,3,1
49816,5,1,174192,174192,174193,0,1,2
49817,1,2,174193,174193,174195,0,2,0
49818,5,3,174198,174198,174201,0,3,3
49819,2,3,174200,174201,174204,1,4,0
49820,2,1,174202,174204,174205,2,3,0
49821,3,3,174205,174205,174208,0,3,0
49822,3,3,174208,174208,174211,0,3,0
49823,6,2,174214,174214,174216,0,2,3
49824,4,2,174218,174218,174220,0,2,2
49825,2,2,174220,174220,174222,0,2,0
49826,6,1,174226,174226,174227,0,1,4
49827,5,1,174231,174231,174232,0,1,4
49828,6,1,174237,174237,174238,0,1,5
49829,2,2,174239,174239,174241,0,2,1
49830,5,1,174244,174244,174245,0,1,3
49831,1,3,174245,174245,174248,0,3,0
49832,2,3,174247,174248,174251,1,4,0
49833,5,2,174252,174252,174254,0,2,1
49834,6,1,174258,174258,174259,0,1,4
49835,1,3,174259,174259,174262,0,3,0
49836,2,2,174261,174262,174264,1,3,0
49837,6,1,174267,174267,174268,0,1,3
49838,1,2,174268,174268,174270,0,2,0
49839,3,1,174271,174271,174272,0,1,1
49840,5,2,174276,174276,174278,0,2,4
49841,5,1,174281,174281,174282,0,1,3
49842,4,1,174285,174285,174286,0,1,3
49843,4,3,174289,174289,174292,0,3,3
49844,3,1,174292,174292,174293,0,1,0
49845,1,1,174293,174293,174294,0,1,0
49846,2,3,174295,174295,174298,0,3,1
49847,4,1,174299,174299,174300,0,1,1
49848,2,3,174301,174301,174304,0,3,1
49849,3,2,174304,174304,174306,0,2,0
49850,5,3,174309,174309,174312,0,3,3
49851,6,3,174315,174315,174318,0,3,3
49852,2,1,174317,174318,174319,1,2,0
49853,4,3,174321,174321,174324,0,3,2
49854,5,2,174326,174326,174328,0,2,2
49855,5,1,174331,174331,174332,0,1,3
49856,1,2,174332,174332,174334,0,2,0
49857,4,2,174336,174336,174338,0,2,2
49858,2,3,174338,174338,174341,0,3,0
49859,2,2,174340,174341,174343,1,3,0
49860,5,1,174345,174345,174346,0,1,2
49861,5,1,174350,174350,174351,0,1,4
49862,2,3,174352,174352,174355,0,3,1
49863,1,2,174353,174355,174357,2,4,0
49864,2,3,174355,174357,174360,2,5,0
49865,3,3,174358,174360,174363,2,5,0
49866,4,2,174362,174363,174365,1,3,0
49867,4,1,174366,174366,174367,0,1,1
49868,3,2,174369,174369,174371,0,2,2
49869,4,2,174373,174373,174375,0,2,2
49870,3,1,174376,174376,174377,0,1,1
49871,3,2,174379,174379,174381,0,2,2
49872,6,3,174385,174385,174388,0,3,4
49873,5,1,174390,174390,174391,0,1,2
49874,3,3,174393,174393,174396,0,3,2
49875,4,2,174397,174397,174399,0,2,1
49876,1,1,174398,174399,174400,1,2,0
49877,1,1,174399,174400,174401,1,2,0
49878,3,2,174402,174402,174404,0,2,1
49879,4,3,174406,174406,174409,0,3,2
49880,4,2,174410,174410,174412,0,2,1
49881,1,1,174411,174412,174413,1,2,0
49882,5,3,174416,174416,174419,0,3,3
49883,5,2,174421,174421,174423,0,2,2
49884,1,3,174422,174423,174426,1,4,0
49885,2,3,174424,174426,174429,2,5,0
49886,1,1,174425,174429,174430,4,5,0
49887,4,1,174429,174430,174431,1,2,0
49888,3,3,174432,174432,174435,0,3,1
49889,6,3,174438,174438,174441,0,3,3
49890,5,2,174443,174443,174445,0,2,2
49891,1,1,174444,174445,174446,1,2,0
49892,3,3,174447,174447,174450,0,3,1
49893,5,3,174452,174452,174455,0,3,2
49894,1,1,174453,174455,174456,2,3,0
49895,3,2,174456,174456,174458,0,2,0
49896,5,1,174461,174461,174462,0,1,3
49897,1,2,174462,174462,174464,0,2,0
49898,4,2,174466,174466,174468,0,2,2
49899,6,1,174472,174472,174473,0,1,4
49900,4,3,174476,174476,174479,0,3,3
49901,1,1,174477,174479,174480,2,3,0
49902,6,1,174483,174483,174484,0,1,3
49903,4,1,174487,174487,174488,0,1,3
49904,3,1,174490,174490,174491,0,1,2
49905,4,3,174494,174494,174497,0,3,3
49906,3,1,174497,174497,174498,0,1,0
49907,3,2,174500,174500,174502,0,2,2
49908,1,3,174501,174502,174505,1,4,0
49909,3,2,174504,174505,174507,1,3,0
49910,2,2,174506,174507,174509,1,3,0
49911,3,1,174509,174509,174510,0,1,0
49912,2,2,174511,174511,174513,0,2,1
49913,1,2,174512,174513,174515,1,3,0
49914,2,2,174514,174515,174517,1,3,0
49915,6,1,174520,174520,174521,0,1,3
49916,5,2,174525,174525,174527,0,2,4
49917,4,3,174529,174529,174532,0,3,2
49918,6,2,174535,174535,174537,0,2,3
49919,1,3,174536,174537,174540,1,4,0
49920,4,2,174540,174540,174542,0,2,0
49921,3,2,174543,174543,174545,0,2,1
49922,3,3,174546,174546,174549,0,3,1
49923,2,3,174548,174549,174552,1,4,0
49924,4,1,174552,174552,174553,0,1,0
49925,4,3,174556,174556,174559,0,3,3
49926,6,1,174562,174562,174563,0,1,3
49927,1,1,174563,174563,174564,0,1,0
49928,5,3,174568,174568,174571,0,3,4
49929,1,3,174569,174571,174574,2,5,0
49930,1,2,174570,174574,174576,4,6,0
49931,3,2,174573,174576,174578,3,5,0
49932,4,2,174577,174578,174580,1,3,0
49933,2,3,174579,174580,174583,1,4,0
49934,2,2,174581,174583,174585,2,4,0
49935,4,1,174585,174585,174586,0,1,0
49936,3,1,174588,174588,174589,0,1,2
49937,4,3,174592,174592,174595,0,3,3
49938,3,2,174595,174595,174597,0,2,0
49939,3,1,174598,174598,174599,0,1,1
49940,6,2,174604,174604,174606,0,2,5
49941,2,1,174606,174606,174607,0,1,0
49942,5,1,174611,174611,174612,0,1,4
49943,6,3,174617,174617,174620,0,3,5
49944,5,1,174622,174622,174623,0,1,2
49945,6,3,174628,174628,174631,0,3,5
49946,5,3,174633,174633,174636,0,3,2
49947,4,3,174637,174637,174640,0,3,1
49948,5,3,174642,174642,174645,0,3,2
49949,6,1,174648,174648,174649,0,1,3
49950,3,3,174651,174651,174654,0,3,2
49951,1,1,174652,174654,174655,2,3,0
49952,4,3,174656,174656,174659,0,3,1
49953,3,2,174659,174659,174661,0,2,0
49954,6,1,174665,174665,174666,0,1,4
49955,6,1,174671,174671,174672,0,1,5
49956,2,2,174673,174673,174675,0,2,1
49957,1,1,174674,174675,174676,1,2,0
49958,5,2,174679,174679,174681,0,2,3
49959,1,1,174680,174681,174682,1,2,0
49960,6,2,174686,174686,174688,0,2,4
49961,1,2,174687,174688,174690,1,3,0
49962,5,3,174692,174692,174695,0,3,2
49963,5,2,174697,174697,174699,0,2,2
49964,2,2,174699,174699,174701,0,2,0
49965,3,3,174702,174702,174705,0,3,1
49966,1,2,174703,174705,174707,2,4,0
49967,3,2,174706,174707,174709,1,3,0
49968,1,2,174707,174709,174711,2,4,0
49969,5,2,174712,174712,174714,0,2,1
49970,3,2,174715,174715,174717,0,2,1
49971,3,2,174718,174718,174720,0,2,1
49972,2,1,174720,174720,174721,0,1,0
49973,3,1,174723,174723,174724,0,1,2
49974,5,1,174728,174728,174729,0,1,4
49975,6,2,174734,174734,174736,0,2,5
49976,4,2,174738,174738,174740,0,2,2
49977,1,1,174739,174740,174741,1,2,0
49978,2,2,174741,174741,174743,0,2,0
49979,5,2,174746,174746,174748,0,2,3
49980,3,2,174749,174749,174751,0,2,1
49981,3,3,174752,174752,174755,0,3,1
49982,3,3,174755,174755,174758,0,3,0
49983,3,3,174758,174758,174761,0,3,0
49984,1,3,174759,174761,174764,2,5,0
49985,3,3,174762,174764,174767,2,5,0
49986,2,3,174764,174767,174770,3,6,0
49987,3,2,174767,174770,174772,3,5,0
49988,4,3,174771,174772,174775,1,4,0
49989,1,3,174772,174775,174778,3,6,0
49990,4,1,174776,174778,174779,2,3,0
49991,1,2,174777,174779,174781,2,4,0
49992,1,2,174778,174781,174783,3,5,0
49993,2,2,174780,174783,174785,3,5,0
49994,1,3,174781,174785,174788,4,7,0
49995,4,3,174785,174788,174791,3,6,0
49996,4,2,174789,174791,174793,2,4,0
49997,3,3,174792,174793,174796,1,4,0
49998,3,2,174795,174796,174798,1,3,0
49999,3,1,174798,174798,174799,0,1,0
50000,1,1,174799,174799,174800,0,1,0
50001,2,3,174801,174801,174804,0,3,1
50002,6,1,174807,174807,174808,0,1,3
50003,2,3,174809,174809,174812,0,3,1
50004,1,3,174810,174812,174815,2,5,0
50005,2,2,174812,174815,174817,3,5,0
50006,5,3,174817,174817,174820,0,3,0
50007,5,3,174822,174822,174825,0,3,2
50008,4,3,174826,174826,174829,0,3,1
50009,5,2,174831,174831,174833,0,2,2
50010,2,1,174833,174833,174834,0,1,0
50011,4,1,174837,174837,174838,0,1,3
50012,4,2,174841,174841,174843,0,2,3
50013,5,1,174846,174846,174847,0,1,3
50014,4,2,174850,174850,174852,0,2,3
50015,6,1,174856,174856,174857,0,1,4
50016,6,2,174862,174862,174864,0,2,5
50017,2,3,174864,174864,174867,0,3,0
50018,4,2,174868,174868,174870,0,2,1
50019,4,3,174872,174872,174875,0,3,2
50020,2,3,174874,174875,174878,1,4,0
50021,3,1,174877,174878,174879,1,2,0
50022,1,3,174878,174879,174882,1,4,0
50023,1,1,174879,174882,174883,3,4,0
50024,1,1,174880,174883,174884,3,4,0
50025,1,1,174881,174884,174885,3,4,0
50026,1,2,174882,174885,174887,3,5,0
50027,4,3,174886,174887,174890,1,4,0
50028,3,2,174889,174890,174892,1,3,0
50029,6,1,174895,174895,174896,0,1,3
50030,5,1,174900,174900,174901,0,1,4
50031,5,3,174905,174905,174908,0,3,4
50032,5,3,174910,174910,174913,0,3,2
50033,4,2,174914,174914,174916,0,2,1
50034,2,1,174916,174916,174917,0,1,0
50035,5,3,174921,174921,174924,0,3,4
50036,2,3,174923,174924,174927,1,4,0
50037,5,1,174928,174928,174929,0,1,1
50038,6,1,174934,174934,174935,0,1,5
50039,4,2,174938,174938,174940,0,2,3
50040,4,1,174942,174942,174943,0,1,2
50041,1,2,174943,174943,174945,0,2,0
50042,3,3,174946,174946,174949,0,3,1
50043,3,3,174949,174949,174952,0,3,0
50044,5,1,174954,174954,174955,0,1,2
50045,1,3,174955,174955,174958,0,3,0
50046,6,2,174961,174961,174963,0,2,3
50047,1,2,174962,174963,174965,1,3,0
50048,6,1,174968,174968,174969,0,1,3
50049,3,2,174971,174971,174973,0,2,2
50050,3,2,174974,174974,174976,0,2,1
50051,5,3,174979,174979,174982,0,3,3
50052,1,3,174980,174982,174985,2,5,0
50053,1,2,174981,174985,174987,4,6,0
50054,6,2,174987,174987,174989,0,2,0
50055,3,2,174990,174990,174992,0,2,1
50056,5,3,174995,174995,174998,0,3,3
50057,1,3,174996,174998,175001,2,5,0
50058,5,3,175001,175001,175004,0,3,0
50059,3,1,175004,175004,175005,0,1,0
50060,6,2,175010,175010,175012,0,2,5
50061,2,2,175012,175012,175014,0,2,0
50062,3,2,175015,175015,175017,0,2,1
50063,5,1,175020,175020,175021,0,1,3
50064,3,3,175023,175023,175026,0,3,2
50065,6,3,175029,175029,175032,0,3,3
50066,6,3,175035,175035,175038,0,3,3
50067,1,3,175036,175038,175041,2,5,0
50068,1,2,175037,175041,175043,4,6,0
50069,4,3,175041,175043,175046,2,5,0
50070,6,3,175047,175047,175050,0,3,1
50071,5,1,175052,175052,175053,0,1,2
50072,5,2,175057,175057,175059,0,2,4
50073,6,2,175063,175063,175065,0,2,4
50074,3,1,175066,175066,175067,0,1,1
50075,5,2,175071,175071,175073,0,2,4
50076,3,1,175074,175074,175075,0,1,1
50077,3,2,175077,175077,175079,0,2,2
50078,5,2,175082,175082,175084,0,2,3
50079,3,1,175085,175085,175086,0,1,1
50080,5,1,175090,175090,175091,0,1,4
50081,3,1,175093,175093,175094,0,1,2
50082,1,2,175094,175094,175096,0,2,0
50083,3,2,175097,175097,175099,0,2,1
50084,3,1,175100,175100,175101,0,1,1
50085,1,1,175101,175101,175102,0,1,0
50086,2,2,175103,175103,175105,0,2,1
50087,3,3,175106,175106,175109,0,3,1
50088,1,3,175107,175109,175112,2,5,0
50089,3,1,175110,175112,175113,2,3,0
50090,6,1,175116,175116,175117,0,1,3
50091,6,2,175122,175122,175124,0,2,5
50092,4,3,175126,175126,175129,0,3,2
50093,4,2,175130,175130,175132,0,2,1
50094,4,1,175134,175134,175135,0,1,2
50095,6,1,175140,175140,175141,0,1,5
50096,6,2,175146,175146,175148,0,2,5
50097,1,1,175147,175148,175149,1,2,0
50098,5,3,175152,175152,175155,0,3,3
50099,1,3,175153,175155,175158,2,5,0
50100,1,3,175154,175158,175161,4,7,0
50101,2,2,175156,175161,175163,5,7,0
50102,1,3,175157,175163,175166,6,9,0
50103,6,1,175163,175166,175167,3,4,0
50104,4,2,175167,175167,175169,0,2,0
50105,5,2,175172,175172,175174,0,2,3
50106,5,3,175177,175177,175180,0,3,3
50107,3,2,175180,175180,175182,0,2,0
50108,2,2,175182,175182,175184,0,2,0
50109,1,2,175183,175184,175186,1,3,0
50110,6,3,175189,175189,175192,0,3,3
50111,2,2,175191,175192,175194,1,3,0
50112,3,1,175194,175194,175195,0,1,0
50113,1,3,175195,175195,175198,0,3,0
50114,4,3,175199,175199,175202,0,3,1
50115,1,2,175200,175202,175204,2,4,0
50116,6,2,175206,175206,175208,0,2,2
50117,3,3,175209,175209,175212,0,3,1
50118,4,3,175213,175213,175216,0,3,1
50119,5,1,175218,175218,175219,0,1,2
50120,1,3,175219,175219,175222,0,3,0
50121,4,3,175223,175223,175226,0,3,1
50122,5,1,175228,175228,175229,0,1,2
50123,1,1,175229,175229,175230,0,1,0
50124,5,2,175234,175234,175236,0,2,4
50125,2,1,175236,175236,175237,0,1,0
50126,6,3,175242,175242,175245,0,3,5
50127,5,2,175247,175247,175249,0,2,2
50128,2,2,175249,175249,175251,0,2,0
50129,5,2,175254,175254,175256,0,2,3
50130,2,2,175256,175256,175258,0,2,0
50131,4,1,175260,175260,175261,0,1,2
50132,3,2,175263,175263,175265,0,2,2
50133,2,3,175265,175265,175268,0,3,0
50134,1,2,175266,175268,175270,2,4,0
50135,2,1,175268,175270,175271,2,3,0
50136,2,1,175270,175271,175272,1,2,0
50137,3,3,175273,175273,175276,0,3,1
50138,4,1,175277,175277,175278,0,1,1
50139,5,2,175282,175282,175284,0,2,4
50140,5,3,175287,175287,175290,0,3,3
50141,6,1,175293,175293,175294,0,1,3
50142,1,3,175294,175294,175297,0,3,0
50143,6,3,175300,175300,175303,0,3,3
50144,5,3,175305,175305,175308,0,3,2
50145,5,1,175310,175310,175311,0,1,2
50146,2,1,175312,175312,175313,0,1,1
50147,4,3,175316,175316,175319,0,3,3
50148,4,1,175320,175320,175321,0,1,1
50149,5,2,175325,175325,175327,0,2,4
50150,1,1,175326,175327,175328,1,2,0
50151,6,3,175332,175332,175335,0,3,4
50152,1,1,175333,175335,175336,2,3,0
50153,4,1,175337,175337,175338,0,1,1
50154,2,3,175339,175339,175342,0,3,1
50155,3,2,175342,175342,175344,0,2,0
50156,5,3,175347,175347,175350,0,3,3
50157,4,2,175351,175351,175353,0,2,1
50158,3,2,175354,175354,175356,0,2,1
50159,4,1,175358,175358,175359,0,1,2
50160,1,1,175359,175359,175360,0,1,0
50161,3,3,175362,175362,175365,0,3,2
50162,6,2,175368,175368,175370,0,2,3
50163,2,1,175370,175370,175371,0,1,0
50164,1,1,175371,175371,175372,0,1,0
50165,1,3,175372,175372,175375,0,3,0
50166,6,3,175378,175378,175381,0,3,3
50167,2,3,175380,175381,175384,1,4,0
50168,2,1,175382,175384,175385,2,3,0
50169,4,3,175386,175386,175389,0,3,1
50170,6,2,175392,175392,175394,0,2,3
50171,5,1,175397,175397,175398,0,1,3
50172,1,1,175398,175398,175399,0,1,0
50173,6,2,175404,175404,175406,0,2,5
50174,4,2,175408,175408,175410,0,2,2
50175,6,1,175414,175414,175415,0,1,4
50176,3,2,175417,175417,175419,0,2,2
50177,5,3,175422,175422,175425,0,3,3
50178,5,3,175427,175427,175430,0,3,2
50179,5,3,175432,175432,175435,0,3,2
50180,6,2,175438,175438,175440,0,2,3
50181,2,1,175440,175440,175441,0,1,0
50182,1,1,175441,175441,175442,0,1,0
50183,2,1,175443,175443,175444,0,1,1
50184,5,3,175448,175448,175451,0,3,4
50185,6,3,175454,175454,175457,0,3,3
50186,2,2,175456,175457,175459,1,3,0
50187,1,2,175457,175459,175461,2,4,0
50188,5,1,175462,175462,175463,0,1,1
50189,2,2,175464,175464,175466,0,2,1
50190,6,3,175470,175470,175473,0,3,4
50191,2,1,175472,175473,175474,1,2,0
50192,2,3,175474,175474,175477,0,3,0
50193,5,2,175479,175479,175481,0,2,2
50194,5,3,175484,175484,175487,0,3,3
50195,2,2,175486,175487,175489,1,3,0
50196,1,2,175487,175489,175491,2,4,0
50197,1,2,175488,175491,175493,3,5,0
50198,4,2,175492,175493,175495,1,3,0
50199,5,1,175497,175497,175498,0,1,2
50200,3,3,175500,175500,175503,0,3,2
50201,5,2,175505,175505,175507,0,2,2
50202,1,1,175506,175507,175508,1,2,0
50203,6,1,175512,175512,175513,0,1,4
50204,4,3,175516,175516,175519,0,3,3
50205,5,1,175521,175521,175522,0,1,2
50206,5,1,175526,175526,175527,0,1,4
50207,3,2,175529,175529,175531,0,2,2
50208,2,1,175531,175531,175532,0,1,0
50209,3,2,175534,175534,175536,0,2,2
50210,6,1,175540,175540,175541,0,1,4
50211,5,2,175545,175545,175547,0,2,4
50212,6,3,175551,175551,175554,0,3,4
50213,4,2,175555,175555,175557,0,2,1
50214,2,1,175557,175557,175558,0,1,0
50215,5,3,175562,175562,175565,0,3,4
50216,1,1,175563,175565,175566,2,3,0
50217,6,2,175569,175569,175571,0,2,3
50218,2,3,175571,175571,175574,0,3,0
50219,6,3,175577,175577,175580,0,3,3
50220,4,1,175581,175581,175582,0,1,1
50221,5,2,175586,175586,175588,0,2,4
50222,3,2,175589,175589,175591,0,2,1
50223,3,1,175592,175592,175593,0,1,1
50224,2,2,175594,175594,175596,0,2,1
50225,1,1,175595,175596,175597,1,2,0
50226,4,2,175599,175599,175601,0,2,2
50227,3,2,175602,175602,175604,0,2,1
50228,2,3,175604,175604,175607,0,3,0
50229,6,3,175610,175610,175613,0,3,3
50230,2,2,175612,175613,175615,1,3,0
50231,3,2,175615,175615,175617,0,2,0
50232,2,3,175617,175617,175620,0,3,0
50233,6,2,175623,175623,175625,0,2,3
50234,2,1,175625,175625,175626,0,1,0
50235,4,1,175629,175629,175630,0,1,3
50236,5,2,175634,175634,175636,0,2,4
50237,5,1,175639,175639,175640,0,1,3
50238,4,2,175643,175643,175645,0,2,3
50239,2,2,175645,175645,175647,0,2,0
50240,3,3,175648,175648,175651,0,3,1
50241,6,3,175654,175654,175657,0,3,3
50242,1,3,175655,175657,175660,2,5,0
50243,3,1,175658,175660,175661,2,3,0
50244,1,3,175659,175661,175664,2,5,0
50245,4,2,175663,175664,175666,1,3,0
50246,4,1,175667,175667,175668,0,1,1
50247,6,1,175673,175673,175674,0,1,5
50248,1,3,175674,175674,175677,0,3,0
50249,3,1,175677,175677,175678,0,1,0
50250,1,3,175678,175678,175681,0,3,0
50251,3,2,175681,175681,175683,0,2,0
50252,3,1,175684,175684,175685,0,1,1
50253,5,2,175689,175689,175691,0,2,4
50254,3,3,175692,175692,175695,0,3,1
50255,5,1,175697,175697,175698,0,1,2
50256,4,1,175701,175701,175702,0,1,3
50257,3,3,175704,175704,175707,0,3,2
50258,4,2,175708,175708,175710,0,2,1
50259,3,3,175711,175711,175714,0,3,1
50260,2,1,175713,175714,175715,1,2,0
50261,4,3,175717,175717,175720,0,3,2
50262,1,2,175718,175720,175722,2,4,0
50263,3,3,175721,175722,175725,1,4,0
50264,6,1,175727,175727,175728,0,1,2
50265,2,2,175729,175729,175731,0,2,1
50266,3,3,175732,175732,175735,0,3,1
50267,5,2,175737,175737,175739,0,2,2
50268,3,2,175740,175740,175742,0,2,1
50269,4,1,175744,175744,175745,0,1,2
50270,2,2,175746,175746,175748,0,2,1
50271,5,2,175751,175751,175753,0,2,3
50272,2,1,175753,175753,175754,0,1,0
50273,4,1,175757,175757,175758,0,1,3
50274,3,1,175760,175760,175761,0,1,2
50275,4,2,175764,175764,175766,0,2,3
50276,3,1,175767,175767,175768,0,1,1
50277,5,2,175772,175772,175774,0,2,4
50278,4,1,175776,175776,175777,0,1,2
50279,6,2,175782,175782,175784,0,2,5
50280,2,2,175784,175784,175786,0,2,0
50281,2,2,175786,175786,175788,0,2,0
50282,2,2,175788,175788,175790,0,2,0
50283,1,3,175789,175790,175793,1,4,0
50284,6,3,175795,175795,175798,0,3,2
50285,1,2,175796,175798,175800,2,4,0
50286,6,2,175802,175802,175804,0,2,2
50287,4,2,175806,175806,175808,0,2,2
50288,3,1,175809,175809,175810,0,1,1
50289,5,1,175814,175814,175815,0,1,4
50290,5,2,175819,175819,175821,0,2,4
50291,1,2,175820,175821,175823,1,3,0
50292,1,1,175821,175823,175824,2,3,0
50293,2,2,175823,175824,175826,1,3,0
50294,6,2,175829,175829,175831,0,2,3
50295,1,3,175830,175831,175834,1,4,0
50296,5,1,175835,175835,175836,0,1,1
50297,1,1,175836,175836,175837,0,1,0
50298,3,1,175839,175839,175840,0,1,2
50299,1,3,175840,175840,175843,0,3,0
50300,2,1,175842,175843,175844,1,2,0
50301,1,3,175843,175844,175847,1,4,0
50302,5,1,175848,175848,175849,0,1,1
50303,2,3,175850,175850,175853,0,3,1
50304,6,3,175856,175856,175859,0,3,3
50305,1,3,175857,175859,175862,2,5,0
50306,4,2,175861,175862,175864,1,3,0
50307,2,1,175863,175864,175865,1,2,0
50308,3,2,175866,175866,175868,0,2,1
50309,6,2,175872,175872,175874,0,2,4
50310,4,2,175876,175876,175878,0,2,2
50311,5,2,175881,175881,175883,0,2,3
50312,6,3,175887,175887,175890,0,3,4
50313,2,3,175889,175890,175893,1,4,0
50314,5,1,175894,175894,175895,0,1,1
50315,3,2,175897,175897,175899,0,2,2
50316,4,3,175901,175901,175904,0,3,2
50317,5,2,175906,175906,175908,0,2,2
50318,3,3,175909,175909,175912,0,3,1
50319,6,1,175915,175915,175916,0,1,3
50320,6,2,175921,175921,175923,0,2,5
50321,1,2,175922,175923,175925,1,3,0
50322,5,3,175927,175927,175930,0,3,2
50323,3,2,175930,175930,175932,0,2,0
50324,1,2,175931,175932,175934,1,3,0
50325,3,1,175934,175934,175935,0,1,0
50326,6,1,175940,175940,175941,0,1,5
50327,1,3,175941,175941,175944,0,3,0
50328,4,1,175945,175945,175946,0,1,1
50329,1,2,175946,175946,175948,0,2,0
50330,1,3,175947,175948,175951,1,4,0
50331,5,1,175952,175952,175953,0,1,1
50332,1,3,175953,175953,175956,0,3,0
50333,5,1,175958,175958,175959,0,1,2
50334,1,1,175959,175959,175960,0,1,0
50335,1,3,175960,175960,175963,0,3,0
50336,2,3,175962,175963,175966,1,4,0
50337,1,1,175963,175966,175967,3,4,0
50338,4,3,175967,175967,175970,0,3,0
50339,3,1,175970,175970,175971,0,1,0
50340,2,1,175972,175972,175973,0,1,1
50341,3,2,175975,175975,175977,0,2,2
50342,5,2,175980,175980,175982,0,2,3
50343,3,2,175983,175983,175985,0,2,1
50344,5,3,175988,175988,175991,0,3,3
50345,1,2,175989,175991,175993,2,4,0
50346,4,3,175993,175993,175996,0,3,0
50347,2,1,175995,175996,175997,1,2,0
50348,5,1,176000,176000,176001,0,1,3
50349,2,3,176002,176002,176005,0,3,1
50350,5,2,176007,176007,176009,0,2,2
50351,3,3,176010,176010,176013,0,3,1
50352,5,3,176015,176015,176018,0,3,2
50353,5,1,176020,176020,176021,0,1,2
50354,2,3,176022,176022,176025,0,3,1
50355,2,1,176024,176025,176026,1,2,0
50356,1,1,176025,176026,176027,1,2,0
50357,4,2,176029,176029,176031,0,2,2
50358,2,3,176031,176031,176034,0,3,0
50359,6,1,176037,176037,176038,0,1,3
50360,4,2,176041,176041,176043,0,2,3
50361,5,1,176046,176046,176047,0,1,3
50362,3,1,176049,176049,176050,0,1,2
50363,2,1,176051,176051,176052,0,1,1
50364,6,1,176057,176057,176058,0,1,5
50365,5,2,176062,176062,176064,0,2,4
50366,2,1,176064,176064,176065,0,1,0
50367,6,1,176070,176070,176071,0,1,5
50368,1,2,176071,176071,176073,0,2,0
50369,3,2,176074,176074,176076,0,2,1
50370,1,3,176075,176076,176079,1,4,0
50371,3,1,176078,176079,176080,1,2,0
50372,2,1,176080,176080,176081,0,1,0
50373,4,3,176084,176084,176087,0,3,3
50374,6,2,176090,176090,176092,0,2,3
50375,3,2,176093,176093,176095,0,2,1
50376,1,2,176094,176095,176097,1,3,0
50377,4,1,176098,176098,176099,0,1,1
50378,3,1,176101,176101,176102,0,1,2
50379,2,3,176103,176103,176106,0,3,1
50380,6,1,176109,176109,176110,0,1,3
50381,6,3,176115,176115,176118,0,3,5
50382,5,2,176120,176120,176122,0,2,2
50383,2,2,176122,176122,176124,0,2,0
50384,2,2,176124,176124,176126,0,2,0
50385,2,1,176126,176126,176127,0,1,0
50386,6,1,176132,176132,176133,0,1,5
50387,4,3,176136,176136,176139,0,3,3
50388,6,3,176142,176142,176145,0,3,3
50389,4,2,176146,176146,176148,0,2,1
50390,5,1,176151,176151,176152,0,1,3
50391,3,2,176154,176154,176156,0,2,2
50392,1,1,176155,176156,176157,1,2,0
50393,2,1,176157,176157,176158,0,1,0
50394,1,2,176158,176158,176160,0,2,0
50395,5,3,176163,176163,176166,0,3,3
50396,2,3,176165,176166,176169,1,4,0
50397,1,3,176166,176169,176172,3,6,0
50398,5,3,176171,176172,176175,1,4,0
50399,1,2,176172,176175,176177,3,5,0
50400,1,2,176173,176177,176179,4,6,0
50401,2,3,176175,176179,176182,4,7,0
50402,1,2,176176,176182,176184,6,8,0
50403,3,2,176179,176184,176186,5,7,0
50404,1,1,176180,176186,176187,6,7,0
50405,1,1,176181,176187,176188,6,7,0
50406,4,1,176185,176188,176189,3,4,0
50407,6,1,176191,176191,176192,0,1,2
50408,3,3,176194,176194,176197,0,3,2
50409,5,1,176199,176199,176200,0,1,2
50410,4,3,176203,176203,176206,0,3,3
50411,4,3,176207,176207,176210,0,3,1
50412,5,2,176212,176212,176214,0,2,2
50413,6,1,176218,176218,176219,0,1,4
50414,4,1,176222,176222,176223,0,1,3
50415,4,2,176226,176226,176228,0,2,3
50416,6,2,176232,176232,176234,0,2,4
50417,2,1,176234,176234,176235,0,1,0
50418,6,1,176240,176240,176241,0,1,5
50419,1,2,176241,176241,176243,0,2,0
50420,2,1,176243,176243,176244,0,1,0
50421,1,3,176244,176244,176247,0,3,0
50422,4,3,176248,176248,176251,0,3,1
50423,5,1,176253,176253,176254,0,1,2
50424,5,3,176258,176258,176261,0,3,4
50425,3,2,176261,176261,176263,0,2,0
50426,5,1,176266,176266,176267,0,1,3
50427,4,3,176270,176270,176273,0,3,3
50428,4,2,176274,176274,176276,0,2,1
50429,1,1,176275,176276,176277,1,2,0
50430,1,1,176276,176277,176278,1,2,0
50431,5,3,176281,176281,176284,0,3,3
50432,1,1,176282,176284,176285,2,3,0
50433,6,1,176288,176288,176289,0,1,3
50434,5,1,176293,176293,176294,0,1,4
50435,2,2,176295,176295,176297,0,2,1
50436,6,2,176301,176301,176303,0,2,4
50437,2,3,176303,176303,176306,0,3,0
50438,3,1,176306,176306,176307,0,1,0
50439,4,3,176310,176310,176313,0,3,3
50440,6,3,176316,176316,176319,0,3,3
50441,2,2,176318,176319,176321,1,3,0
50442,2,1,176320,176321,176322,1,2,0
50443,1,3,176321,176322,176325,1,4,0
50444,2,3,176323,176325,176328,2,5,0
50445,6,2,176329,176329,176331,0,2,1
50446,6,2,176335,176335,176337,0,2,4
50447,2,1,176337,176337,176338,0,1,0
50448,4,1,176341,176341,176342,0,1,3
50449,4,1,176345,176345,176346,0,1,3
50450,4,2,176349,176349,176351,0,2,3
50451,1,1,176350,176351,176352,1,2,0
50452,6,1,176356,176356,176357,0,1,4
50453,2,3,176358,176358,176361,0,3,1
50454,6,2,176364,176364,176366,0,2,3
50455,2,1,176366,176366,176367,0,1,0
50456,4,2,176370,176370,176372,0,2,3
50457,1,3,176371,176372,176375,1,4,0
50458,5,3,176376,176376,176379,0,3,1
50459,2,3,176378,176379,176382,1,4,0
50460,2,3,176380,176382,176385,2,5,0
50461,2,3,176382,176385,176388,3,6,0
50462,1,1,176383,176388,176389,5,6,0
50463,2,3,176385,176389,176392,4,7,0
50464,4,3,176389,176392,176395,3,6,0
50465,2,2,176391,176395,176397,4,6,0
50466,1,2,176392,176397,176399,5,7,0
50467,2,2,176394,176399,176401,5,7,0
50468,4,1,176398,176401,176402,3,4,0
50469,4,3,176402,176402,176405,0,3,0
50470,4,2,176406,176406,176408,0,2,1
50471,2,1,176408,176408,176409,0,1,0
50472,6,2,176414,176414,176416,0,2,5
50473,4,2,176418,176418,176420,0,2,2
50474,1,3,176419,176420,176423,1,4,0
50475,5,3,176424,176424,176427,0,3,1
50476,3,3,176427,176427,176430,0,3,0
50477,1,3,176428,176430,176433,2,5,0
50478,1,2,176429,176433,176435,4,6,0
50479,4,2,176433,176435,176437,2,4,0
50480,2,2,176435,176437,176439,2,4,0
50481,3,2,176438,176439,176441,1,3,0
50482,6,3,176444,176444,176447,0,3,3
50483,3,1,176447,176447,176448,0,1,0
50484,2,3,176449,176449,176452,0,3,1
50485,4,2,176453,176453,176455,0,2,1
50486,5,2,176458,176458,176460,0,2,3
50487,6,1,176464,176464,176465,0,1,4
50488,4,1,176468,176468,176469,0,1,3
50489,3,3,176471,176471,176474,0,3,2
50490,6,1,176477,176477,176478,0,1,3
50491,3,2,176480,176480,176482,0,2,2
50492,2,2,176482,176482,176484,0,2,0
50493,4,2,176486,176486,176488,0,2,2
50494,5,3,176491,176491,176494,0,3,3
50495,3,3,176494,176494,176497,0,3,0
50496,2,1,176496,176497,176498,1,2,0
50497,6,3,176502,176502,176505,0,3,4
50498,1,1,176503,176505,176506,2,3,0
50499,5,2,176508,176508,176510,0,2,2
50500,3,1,176511,176511,176512,0,1,1
50501,6,1,176517,176517,176518,0,1,5
50502,2,2,176519,176519,176521,0,2,1
50503,5,2,176524,176524,176526,0,2,3
50504,2,1,176526,176526,176527,0,1,0
50505,6,2,176532,176532,176534,0,2,5
50506,5,3,176537,176537,176540,0,3,3
50507,6,3,176543,176543,176546,0,3,3
50508,6,2,176549,176549,176551,0,2,3
50509,6,1,176555,176555,176556,0,1,4
50510,4,1,176559,176559,176560,0,1,3
50511,2,1,176561,176561,176562,0,1,1
50512,6,1,176567,176567,176568,0,1,5
50513,5,2,176572,176572,176574,0,2,4
50514,6,2,176578,176578,176580,0,2,4
50515,3,3,176581,176581,176584,0,3,1
50516,1,3,176582,176584,176587,2,5,0
50517,6,3,176588,176588,176591,0,3,1
50518,3,3,176591,176591,176594,0,3,0
50519,3,1,176594,176594,176595,0,1,0
50520,2,2,176596,176596,176598,0,2,1
50521,2,1,176598,176598,176599,0,1,0
50522,2,3,176600,176600,176603,0,3,1
50523,4,1,176604,176604,176605,0,1,1
50524,3,3,176607,176607,176610,0,3,2
50525,1,3,176608,176610,176613,2,5,0
50526,5,3,176613,176613,176616,0,3,0
50527,3,1,176616,176616,176617,0,1,0
50528,2,1,176618,176618,176619,0,1,1
50529,4,2,176622,176622,176624,0,2,3
50530,3,1,176625,176625,176626,0,1,1
50531,5,2,176630,176630,176632,0,2,4
50532,6,2,176636,176636,176638,0,2,4
50533,3,2,176639,176639,176641,0,2,1
50534,5,3,176644,176644,176647,0,3,3
50535,6,3,176650,176650,176653,0,3,3
50536,2,1,176652,176653,176654,1,2,0
50537,5,2,176657,176657,176659,0,2,3
50538,3,3,176660,176660,176663,0,3,1
50539,2,1,176662,176663,176664,1,2,0
50540,3,3,176665,176665,176668,0,3,1
50541,3,1,176668,176668,176669,0,1,0
50542,5,2,176673,176673,176675,0,2,4
50543,4,3,176677,176677,176680,0,3,2
50544,4,3,176681,176681,176684,0,3,1
50545,5,3,176686,176686,176689,0,3,2
50546,4,2,176690,176690,176692,0,2,1
50547,3,3,176693,176693,176696,0,3,1
50548,6,3,176699,176699,176702,0,3,3
50549,2,2,176701,176702,176704,1,3,0
50550,1,3,176702,176704,176707,2,5,0
50551,2,1,176704,176707,176708,3,4,0
50552,3,2,176707,176708,176710,1,3,0
50553,2,2,176709,176710,176712,1,3,0
50554,2,3,176711,176712,176715,1,4,0
50555,2,1,176713,176715,176716,2,3,0
50556,3,1,176716,176716,176717,0,1,0
50557,4,1,176720,176720,176721,0,1,3
50558,6,2,176726,176726,176728,0,2,5
50559,3,2,176729,176729,176731,0,2,1
50560,3,2,176732,176732,176734,0,2,1
50561,5,3,176737,176737,176740,0,3,3
50562,2,2,176739,176740,176742,1,3,0
50563,6,3,176745,176745,176748,0,3,3
50564,3,3,176748,176748,176751,0,3,0
50565,2,1,176750,176751,176752,1,2,0
50566,6,2,176756,176756,176758,0,2,4
50567,4,3,176760,176760,176763,0,3,2
50568,3,3,176763,176763,176766,0,3,0
50569,6,3,176769,176769,176772,0,3,3
50570,1,3,176770,176772,176775,2,5,0
50571,5,3,176775,176775,176778,0,3,0
50572,1,1,176776,176778,176779,2,3,0
50573,2,3,176778,176779,176782,1,4,0
50574,2,2,176780,176782,176784,2,4,0
50575,5,3,176785,176785,176788,0,3,1
50576,1,3,176786,176788,176791,2,5,0
50577,1,2,176787,176791,176793,4,6,0
50578,1,1,176788,176793,176794,5,6,0
50579,5,3,176793,176794,176797,1,4,0
50580,1,2,176794,176797,176799,3,5,0
50581,5,2,176799,176799,176801,0,2,0
50582,3,2,176802,176802,176804,0,2,1
50583,6,1,176808,176808,176809,0,1,4
50584,2,2,176810,176810,176812,0,2,1
50585,4,1,176814,176814,176815,0,1,2
50586,4,2,176818,176818,176820,0,2,3
50587,1,1,176819,176820,176821,1,2,0
50588,6,3,176825,176825,176828,0,3,4
50589,5,1,176830,176830,176831,0,1,2
50590,3,3,176833,176833,176836,0,3,2
50591,2,2,176835,176836,176838,1,3,0
50592,2,3,176837,176838,176841,1,4,0
50593,1,3,176838,176841,176844,3,6,0
50594,1,2,176839,176844,176846,5,7,0
50595,3,2,176842,176846,176848,4,6,0
50596,3,3,176845,176848,176851,3,6,0
50597,3,2,176848,176851,176853,3,5,0
50598,6,1,176854,176854,176855,0,1,1
50599,1,3,176855,176855,176858,0,3,0
50600,1,3,176856,176858,176861,2,5,0
50601,1,2,176857,176861,176863,4,6,0
50602,1,3,176858,176863,176866,5,8,0
50603,3,2,176861,176866,176868,5,7,0
50604,1,3,176862,176868,176871,6,9,0
50605,6,2,176868,176871,176873,3,5,0
50606,4,2,176872,176873,176875,1,3,0
50607,1,2,176873,176875,176877,2,4,0
50608,2,1,176875,176877,176878,2,3,0
50609,2,2,176877,176878,176880,1,3,0
50610,2,2,176879,176880,176882,1,3,0
50611,3,3,176882,176882,176885,0,3,0
50612,3,2,176885,176885,176887,0,2,0
50613,4,2,176889,176889,176891,0,2,2
50614,1,2,176890,176891,176893,1,3,0
50615,3,2,176893,176893,176895,0,2,0
50616,5,2,176898,176898,176900,0,2,3
50617,3,3,176901,176901,176904,0,3,1
50618,5,2,176906,176906,176908,0,2,2
50619,1,1,176907,176908,176909,1,2,0
50620,2,2,176909,176909,176911,0,2,0
50621,2,3,176911,176911,176914,0,3,0
50622,5,2,176916,176916,176918,0,2,2
50623,3,2,176919,176919,176921,0,2,1
50624,3,1,176922,176922,176923,0,1,1
50625,1,3,176923,176923,176926,0,3,0
50626,4,1,176927,176927,176928,0,1,1
50627,4,2,176931,176931,176933,0,2,3
50628,1,2,176932,176933,176935,1,3,0
50629,5,1,176937,176937,176938,0,1,2
50630,5,3,176942,176942,176945,0,3,4
50631,5,2,176947,176947,176949,0,2,2
50632,2,1,176949,176949,176950,0,1,0
50633,3,1,176952,176952,176953,0,1,2
50634,2,3,176954,176954,176957,0,3,1
50635,2,3,176956,176957,176960,1,4,0
50636,5,3,176961,176961,176964,0,3,1
50637,4,1,176965,176965,176966,0,1,1
50638,2,2,176967,176967,176969,0,2,1
50639,6,2,176973,176973,176975,0,2,4
50640,5,1,176978,176978,176979,0,1,3
50641,2,3,176980,176980,176983,0,3,1
50642,4,2,176984,176984,176986,0,2,1
50643,5,2,176989,176989,176991,0,2,3
50644,1,2,176990,176991,176993,1,3,0
50645,4,1,176994,176994,176995,0,1,1
50646,5,1,176999,176999,177000,0,1,4
50647,5,1,177004,177004,177005,0,1,4
50648,2,3,177006,177006,177009,0,3,1
50649,3,1,177009,177009,177010,0,1,0
50650,2,2,177011,177011,177013,0,2,1
50651,6,2,177017,177017,177019,0,2,4
50652,4,3,177021,177021,177024,0,3,2
50653,2,2,177023,177024,177026,1,3,0
50654,6,3,177029,177029,177032,0,3,3
50655,4,3,177033,177033,177036,0,3,1
50656,6,2,177039,177039,177041,0,2,3
50657,4,2,177043,177043,177045,0,2,2
50658,6,3,177049,177049,177052,0,3,4
50659,1,1,177050,177052,177053,2,3,0
50660,3,3,177053,177053,177056,0,3,0
50661,3,3,177056,177056,177059,0,3,0
50662,6,2,177062,177062,177064,0,2,3
50663,5,2,177067,177067,177069,0,2,3
50664,4,3,177071,177071,177074,0,3,2
50665,2,1,177073,177074,177075,1,2,0
50666,6,1,177079,177079,177080,0,1,4
50667,3,1,177082,177082,177083,0,1,2
50668,4,3,177086,177086,177089,0,3,3
50669,1,1,177087,177089,177090,2,3,0
50670,4,2,177091,177091,177093,0,2,1
50671,6,2,177097,177097,177099,0,2,4
50672,2,1,177099,177099,177100,0,1,0
50673,5,2,177104,177104,177106,0,2,4
50674,6,1,177110,177110,177111,0,1,4
50675,6,3,177116,177116,177119,0,3,5
50676,3,1,177119,177119,177120,0,1,0
50677,6,2,177125,177125,177127,0,2,5
50678,4,3,177129,177129,177132,0,3,2
50679,3,2,177132,177132,177134,0,2,0
50680,5,2,177137,177137,177139,0,2,3
50681,5,1,177142,177142,177143,0,1,3
50682,6,1,177148,177148,177149,0,1,5
50683,3,1,177151,177151,177152,0,1,2
50684,5,2,177156,177156,177158,0,2,4
50685,2,1,177158,177158,177159,0,1,0
50686,2,1,177160,177160,177161,0,1,1
50687,5,3,177165,177165,177168,0,3,4
50688,1,1,177166,177168,177169,2,3,0
50689,3,1,177169,177169,177170,0,1,0
50690,4,1,177173,177173,177174,0,1,3
50691,1,3,177174,177174,177177,0,3,0
50692,6,1,177180,177180,177181,0,1,3
50693,6,2,177186,177186,177188,0,2,5
50694,5,2,177191,177191,177193,0,2,3
50695,4,2,177195,177195,177197,0,2,2
50696,3,1,177198,177198,177199,0,1,1
50697,5,1,177203,177203,177204,0,1,4
50698,1,3,177204,177204,177207,0,3,0
50699,4,1,177208,177208,177209,0,1,1
50700,1,1,177209,177209,177210,0,1,0
50701,3,2,177212,177212,177214,0,2,2
50702,1,2,177213,177214,177216,1,3,0
50703,1,1,177214,177216,177217,2,3,0
50704,1,3,177215,177217,177220,2,5,0
50705,5,3,177220,177220,177223,0,3,0
50706,4,3,177224,177224,177227,0,3,1
50707,4,3,177228,177228,177231,0,3,1
50708,1,1,177229,177231,177232,2,3,0
50709,3,2,177232,177232,177234,0,2,0
50710,1,1,177233,177234,177235,1,2,0
50711,5,1,177238,177238,177239,0,1,3
50712,1,2,177239,177239,177241,0,2,0
50713,1,1,177240,177241,177242,1,2,0
50714,6,3,177246,177246,177249,0,3,4
50715,6,3,177252,177252,177255,0,3,3
50716,5,1,177257,177257,177258,0,1,2
50717,3,1,177260,177260,177261,0,1,2
50718,5,1,177265,177265,177266,0,1,4
50719,4,3,177269,177269,177272,0,3,3
50720,4,3,177273,177273,177276,0,3,1
50721,3,3,177276,177276,177279,0,3,0
50722,3,2,177279,177279,177281,0,2,0
50723,4,2,177283,177283,177285,0,2,2
50724,5,2,177288,177288,177290,0,2,3
50725,6,1,177294,177294,177295,0,1,4
50726,1,3,177295,177295,177298,0,3,0
50727,2,2,177297,177298,177300,1,3,0
50728,4,2,177301,177301,177303,0,2,1
50729,5,2,177306,177306,177308,0,2,3
50730,5,1,177311,177311,177312,0,1,3
50731,5,3,177316,177316,177319,0,3,4
50732,2,3,177318,177319,177322,1,4,0
50733,6,2,177324,177324,177326,0,2,2
50734,4,1,177328,177328,177329,0,1,2
50735,1,3,177329,177329,177332,0,3,0
50736,3,3,177332,177332,177335,0,3,0
50737,2,1,177334,177335,177336,1,2,0
50738,6,1,177340,177340,177341,0,1,4
50739,1,3,177341,177341,177344,0,3,0
50740,4,3,177345,177345,177348,0,3,1
50741,2,2,177347,177348,177350,1,3,0
50742,2,2,177349,177350,177352,1,3,0
50743,6,2,177355,177355,177357,0,2,3
50744,1,3,177356,177357,177360,1,4,0
50745,3,1,177359,177360,177361,1,2,0
50746,4,3,177363,177363,177366,0,3,2
50747,5,1,177368,177368,177369,0,1,2
50748,6,2,177374,177374,177376,0,2,5
50749,3,2,177377,177377,177379,0,2,1
50750,5,2,177382,177382,177384,0,2,3
50751,1,1,177383,177384,177385,1,2,0
50752,4,3,177387,177387,177390,0,3,2
50753,5,3,177392,177392,177395,0,3,2
50754,5,2,177397,177397,177399,0,2,2
50755,5,1,177402,177402,177403,0,1,3
50756,1,2,177403,177403,177405,0,2,0
50757,3,2,177406,177406,177408,0,2,1
50758,1,3,177407,177408,177411,1,4,0
50759,4,3,177411,177411,177414,0,3,0
50760,1,2,177412,177414,177416,2,4,0
50761,6,2,177418,177418,177420,0,2,2
50762,2,2,177420,177420,177422,0,2,0
50763,2,2,177422,177422,177424,0,2,0
50764,4,3,177426,177426,177429,0,3,2
50765,2,1,177428,177429,177430,1,2,0
50766,2,1,177430,177430,177431,0,1,0
50767,3,2,177433,177433,177435,0,2,2
50768,3,2,177436,177436,177438,0,2,1
50769,2,2,177438,177438,177440,0,2,0
50770,5,1,177443,177443,177444,0,1,3
50771,4,1,177447,177447,177448,0,1,3
50772,3,3,177450,177450,177453,0,3,2
50773,6,3,177456,177456,177459,0,3,3
50774,2,2,177458,177459,177461,1,3,0
50775,1,3,177459,177461,177464,2,5,0
50776,2,1,177461,177464,177465,3,4,0
50777,5,3,177466,177466,177469,0,3,1
50778,1,1,177467,177469,177470,2,3,0
50779,1,3,177468,177470,177473,2,5,0
50780,2,3,177470,177473,177476,3,6,0
50781,4,1,177474,177476,177477,2,3,0
50782,3,3,177477,177477,177480,0,3,0
50783,6,1,177483,177483,177484,0,1,3
50784,3,1,177486,177486,177487,0,1,2
50785,2,1,177488,177488,177489,0,1,1
50786,5,1,177493,177493,177494,0,1,4
50787,5,2,177498,177498,177500,0,2,4
50788,3,2,177501,177501,177503,0,2,1
50789,4,1,177505,177505,177506,0,1,2
50790,4,2,177509,177509,177511,0,2,3
50791,3,3,177512,177512,177515,0,3,1
50792,6,3,177518,177518,177521,0,3,3
50793,5,1,177523,177523,177524,0,1,2
50794,5,3,177528,177528,177531,0,3,4
50795,3,2,177531,177531,177533,0,2,0
50796,4,2,177535,177535,177537,0,2,2
50797,1,3,177536,177537,177540,1,4,0
50798,4,1,177540,177540,177541,0,1,0
50799,1,2,177541,177541,177543,0,2,0
50800,5,1,177546,177546,177547,0,1,3
50801,2,3,177548,177548,177551,0,3,1
50802,4,2,177552,177552,177554,0,2,1
50803,5,3,177557,177557,177560,0,3,3
50804,1,1,177558,177560,177561,2,3,0
50805,6,3,177564,177564,177567,0,3,3
50806,1,1,177565,177567,177568,2,3,0
50807,1,3,177566,177568,177571,2,5,0
50808,1,2,177567,177571,177573,4,6,0
50809,5,1,177572,177573,177574,1,2,0
50810,4,1,177576,177576,177577,0,1,2
50811,4,2,177580,177580,177582,0,2,3
50812,1,3,177581,177582,177585,1,4,0
50813,2,3,177583,177585,177588,2,5,0
50814,2,3,177585,177588,177591,3,6,0
50815,6,3,177591,177591,177594,0,3,0
50816,1,3,177592,177594,177597,2,5,0
50817,4,1,177596,177597,177598,1,2,0
50818,6,2,177602,177602,177604,0,2,4
50819,6,3,177608,177608,177611,0,3,4
50820,5,2,177613,177613,177615,0,2,2
50821,2,2,177615,177615,177617,0,2,0
50822,3,3,177618,177618,177621,0,3,1
50823,2,1,177620,177621,177622,1,2,0
50824,2,1,177622,177622,177623,0,1,0
50825,2,3,177624,177624,177627,0,3,1
50826,4,3,177628,177628,177631,0,3,1
50827,1,2,177629,177631,177633,2,4,0
50828,5,1,177634,177634,177635,0,1,1
50829,1,1,177635,177635,177636,0,1,0
50830,6,3,177641,177641,177644,0,3,5
50831,2,2,177643,177644,177646,1,3,0
50832,6,2,177649,177649,177651,0,2,3
50833,1,1,177650,177651,177652,1,2,0
50834,3,3,177653,177653,177656,0,3,1
50835,1,3,177654,177656,177659,2,5,0
50836,3,1,177657,177659,177660,2,3,0
50837,3,2,177660,177660,177662,0,2,0
50838,5,3,177665,177665,177668,0,3,3
50839,6,3,177671,177671,177674,0,3,3
50840,4,3,177675,177675,177678,0,3,1
50841,6,1,177681,177681,177682,0,1,3
50842,4,1,177685,177685,177686,0,1,3
50843,6,3,177691,177691,177694,0,3,5
50844,6,2,177697,177697,177699,0,2,3
50845,4,3,177701,177701,177704,0,3,2
50846,5,3,177706,177706,177709,0,3,2
50847,4,2,177710,177710,177712,0,2,1
50848,1,3,177711,177712,177715,1,4,0
50849,4,1,177715,177715,177716,0,1,0
50850,2,3,177717,177717,177720,0,3,1
50851,3,3,177720,177720,177723,0,3,0
50852,2,3,177722,177723,177726,1,4,0
50853,6,3,177728,177728,177731,0,3,2
50854,3,2,177731,177731,177733,0,2,0
50855,3,1,177734,177734,177735,0,1,1
50856,2,1,177736,177736,177737,0,1,1
50857,6,1,177742,177742,177743,0,1,5
50858,4,3,177746,177746,177749,0,3,3
50859,5,1,177751,177751,177752,0,1,2
50860,2,2,177753,177753,177755,0,2,1
50861,4,3,177757,177757,177760,0,3,2
50862,3,2,177760,177760,177762,0,2,0
50863,5,2,177765,177765,177767,0,2,3
50864,6,2,177771,177771,177773,0,2,4
50865,3,2,177774,177774,177776,0,2,1
50866,5,2,177779,177779,177781,0,2,3
50867,4,3,177783,177783,177786,0,3,2
50868,2,1,177785,177786,177787,1,2,0
50869,6,3,177791,177791,177794,0,3,4
50870,1,2,177792,177794,177796,2,4,0
50871,1,3,177793,177796,177799,3,6,0
50872,3,2,177796,177799,177801,3,5,0
50873,5,3,177801,177801,177804,0,3,0
50874,6,3,177807,177807,177810,0,3,3
50875,4,2,177811,177811,177813,0,2,1
50876,4,2,177815,177815,177817,0,2,2
50877,5,3,177820,177820,177823,0,3,3
50878,6,3,177826,177826,177829,0,3,3
50879,1,3,177827,177829,177832,2,5,0
50880,2,2,177829,177832,177834,3,5,0
50881,4,1,177833,177834,177835,1,2,0
50882,2,3,177835,177835,177838,0,3,0
50883,4,3,177839,177839,177842,0,3,1
50884,6,1,177845,177845,177846,0,1,3
50885,3,2,177848,177848,177850,0,2,2
50886,5,2,177853,177853,177855,0,2,3
50887,3,1,177856,177856,177857,0,1,1
50888,3,1,177859,177859,177860,0,1,2
50889,6,1,177865,177865,177866,0,1,5
50890,2,3,177867,177867,177870,0,3,1
50891,1,2,177868,177870,177872,2,4,0
50892,6,2,177874,177874,177876,0,2,2
50893,4,1,177878,177878,177879,0,1,2
50894,4,1,177882,177882,177883,0,1,3
50895,6,3,177888,177888,177891,0,3,5
50896,5,1,177893,177893,177894,0,1,2
50897,4,1,177897,177897,177898,0,1,3
50898,5,3,177902,177902,177905,0,3,4
50899,6,1,177908,177908,177909,0,1,3
50900,1,3,177909,177909,177912,0,3,0
50901,5,2,177914,177914,177916,0,2,2
50902,2,1,177916,177916,177917,0,1,0
50903,6,2,177922,177922,177924,0,2,5
50904,4,1,177926,177926,177927,0,1,2
50905,2,1,177928,177928,177929,0,1,1
50906,2,2,177930,177930,177932,0,2,1
50907,4,3,177934,177934,177937,0,3,2
50908,5,2,177939,177939,177941,0,2,2
50909,3,1,177942,177942,177943,0,1,1
50910,3,2,177945,177945,177947,0,2,2
50911,6,1,177951,177951,177952,0,1,4
50912,4,1,177955,177955,177956,0,1,3
50913,3,2,177958,177958,177960,0,2,2
50914,2,3,177960,177960,177963,0,3,0
50915,1,1,177961,177963,177964,2,3,0
50916,1,2,177962,177964,177966,2,4,0
50917,4,1,177966,177966,177967,0,1,0
50918,3,1,177969,177969,177970,0,1,2
50919,6,2,177975,177975,177977,0,2,5
50920,2,3,177977,177977,177980,0,3,0
50921,6,2,177983,177983,177985,0,2,3
50922,2,1,177985,177985,177986,0,1,0
50923,3,1,177988,177988,177989,0,1,2
50924,6,1,177994,177994,177995,0,1,5
50925,5,2,177999,177999,178001,0,2,4
50926,1,2,178000,178001,178003,1,3,0
50927,2,2,178002,178003,178005,1,3,0
50928,4,3,178006,178006,178009,0,3,1
50929,3,2,178009,178009,178011,0,2,0
50930,1,2,178010,178011,178013,1,3,0
50931,2,1,178012,178013,178014,1,2,0
50932,1,2,178013,178014,178016,1,3,0
50933,4,3,178017,178017,178020,0,3,1
50934,4,2,178021,178021,178023,0,2,1
50935,6,3,178027,178027,178030,0,3,4
50936,5,1,178032,178032,178033,0,1,2
50937,3,2,178035,178035,178037,0,2,2
50938,1,1,178036,178037,178038,1,2,0
50939,5,2,178041,178041,178043,0,2,3
50940,6,3,178047,178047,178050,0,3,4
50941,4,2,178051,178051,178053,0,2,1
50942,4,3,178055,178055,178058,0,3,2
50943,1,1,178056,178058,178059,2,3,0
50944,6,2,178062,178062,178064,0,2,3
50945,5,1,178067,178067,178068,0,1,3
50946,4,3,178071,178071,178074,0,3,3
50947,2,1,178073,178074,178075,1,2,0
50948,6,2,178079,178079,178081,0,2,4
50949,5,1,178084,178084,178085,0,1,3
50950,1,3,178085,178085,178088,0,3,0
50951,1,2,178086,178088,178090,2,4,0
50952,1,3,178087,178090,178093,3,6,0
50953,5,2,178092,178093,178095,1,3,0
50954,3,1,178095,178095,178096,0,1,0
50955,1,2,178096,178096,178098,0,2,0
50956,2,3,178098,178098,178101,0,3,0
50957,5,3,178103,178103,178106,0,3,2
50958,6,2,178109,178109,178111,0,2,3
50959,5,2,178114,178114,178116,0,2,3
50960,1,2,178115,178116,178118,1,3,0
50961,5,2,178120,178120,178122,0,2,2
50962,2,3,178122,178122,178125,0,3,0
50963,2,3,178124,178125,178128,1,4,0
50964,5,1,178129,178129,178130,0,1,1
50965,4,2,178133,178133,178135,0,2,3
50966,5,1,178138,178138,178139,0,1,3
50967,5,2,178143,178143,178145,0,2,4
50968,6,1,178149,178149,178150,0,1,4
50969,5,1,178154,178154,178155,0,1,4
50970,1,1,178155,178155,178156,0,1,0
50971,1,1,178156,178156,178157,0,1,0
50972,6,1,178162,178162,178163,0,1,5
50973,4,1,178166,178166,178167,0,1,3
50974,1,3,178167,178167,178170,0,3,0
50975,6,2,178173,178173,178175,0,2,3
50976,2,1,178175,178175,178176,0,1,0
50977,2,1,178177,178177,178178,0,1,1
50978,6,1,178183,178183,178184,0,1,5
50979,2,3,178185,178185,178188,0,3,1
50980,5,1,178190,178190,178191,0,1,2
50981,2,3,178192,178192,178195,0,3,1
50982,3,1,178195,178195,178196,0,1,0
50983,6,3,178201,178201,178204,0,3,5
50984,6,2,178207,178207,178209,0,2,3
50985,3,1,178210,178210,178211,0,1,1
50986,2,1,178212,178212,178213,0,1,1
50987,1,2,178213,178213,178215,0,2,0
50988,2,3,178215,178215,178218,0,3,0
50989,2,2,178217,178218,178220,1,3,0
50990,6,3,178223,178223,178226,0,3,3
50991,6,3,178229,178229,178232,0,3,3
50992,4,1,178233,178233,178234,0,1,1
50993,5,1,178238,178238,178239,0,1,4
50994,3,3,178241,178241,178244,0,3,2
50995,5,2,178246,178246,178248,0,2,2
50996,5,3,178251,178251,178254,0,3,3
50997,2,1,178253,178254,178255,1,2,0
50998,5,3,178258,178258,178261,0,3,3
50999,4,2,178262,178262,178264,0,2,1
51000,4,3,178266,178266,178269,0,3,2
51001,3,3,178269,178269,178272,0,3,0
51002,6,3,178275,178275,178278,0,3,3
51003,2,1,178277,178278,178279,1,2,0
51004,3,3,178280,178280,178283,0,3,1
51005,2,2,178282,178283,178285,1,3,0
51006,4,2,178286,178286,178288,0,2,1
51007,2,1,178288,178288,178289,0,1,0
51008,1,3,178289,178289,178292,0,3,0
51009,6,2,178295,178295,178297,0,2,3
51010,4,2,178299,178299,178301,0,2,2
51011,4,2,178303,178303,178305,0,2,2
51012,5,2,178308,178308,178310,0,2,3
51013,5,1,178313,178313,178314,0,1,3
51014,3,3,178316,178316,178319,0,3,2
51015,1,1,178317,178319,178320,2,3,0
51016,4,3,178321,178321,178324,0,3,1
51017,5,3,178326,178326,178329,0,3,2
51018,1,2,178327,178329,178331,2,4,0
51019,4,1,178331,178331,178332,0,1,0
51020,5,3,178336,178336,178339,0,3,4
51021,6,3,178342,178342,178345,0,3,3
51022,1,3,178343,178345,178348,2,5,0
51023,5,2,178348,178348,178350,0,2,0
51024,3,3,178351,178351,178354,0,3,1
51025,1,1,178352,178354,178355,2,3,0
51026,4,2,178356,178356,178358,0,2,1
51027,6,2,178362,178362,178364,0,2,4
51028,5,2,178367,178367,178369,0,2,3
51029,3,3,178370,178370,178373,0,3,1
51030,4,2,178374,178374,178376,0,2,1
51031,5,3,178379,178379,178382,0,3,3
51032,5,2,178384,178384,178386,0,2,2
51033,4,3,178388,178388,178391,0,3,2
51034,4,2,178392,178392,178394,0,2,1
51035,2,3,178394,178394,178397,0,3,0
51036,5,1,178399,178399,178400,0,1,2
51037,5,2,178404,178404,178406,0,2,4
51038,3,3,178407,178407,178410,0,3,1
51039,1,2,178408,178410,178412,2,4,0
51040,2,3,178410,178412,178415,2,5,0
51041,4,2,178414,178415,178417,1,3,0
51042,3,1,178417,178417,178418,0,1,0
51043,5,2,178422,178422,178424,0,2,4
51044,1,3,178423,178424,178427,1,4,0
51045,6,3,178429,178429,178432,0,3,2
51046,6,2,178435,178435,178437,0,2,3
51047,2,2,178437,178437,178439,0,2,0
51048,3,2,178440,178440,178442,0,2,1
51049,5,3,178445,178445,178448,0,3,3
51050,4,1,178449,178449,178450,0,1,1
51051,6,1,178455,178455,178456,0,1,5
51052,6,3,178461,178461,178464,0,3,5
51053,1,3,178462,178464,178467,2,5,0
51054,1,3,178463,178467,178470,4,7,0
51055,2,2,178465,178470,178472,5,7,0
51056,3,3,178468,178472,178475,4,7,0
51057,5,3,178473,178475,178478,2,5,0
51058,3,2,178476,178478,178480,2,4,0
51059,5,1,178481,178481,178482,0,1,1
51060,3,1,178484,178484,178485,0,1,2
51061,4,3,178488,178488,178491,0,3,3
51062,6,2,178494,178494,178496,0,2,3
51063,6,1,178500,178500,178501,0,1,4
51064,3,3,178503,178503,178506,0,3,2
51065,2,2,178505,178506,178508,1,3,0
51066,3,2,178508,178508,178510,0,2,0
51067,5,2,178513,178513,178515,0,2,3
51068,5,2,178518,178518,178520,0,2,3
51069,4,2,178522,178522,178524,0,2,2
51070,5,1,178527,178527,178528,0,1,3
51071,4,3,178531,178531,178534,0,3,3
51072,1,2,178532,178534,178536,2,4,0
51073,3,1,178535,178536,178537,1,2,0
51074,2,3,178537,178537,178540,0,3,0
51075,1,1,178538,178540,178541,2,3,0
51076,4,2,178542,178542,178544,0,2,1
51077,3,1,178545,178545,178546,0,1,1
51078,4,1,178549,178549,178550,0,1,3
51079,4,1,178553,178553,178554,0,1,3
51080,5,2,178558,178558,178560,0,2,4
51081,4,3,178562,178562,178565,0,3,2
51082,1,3,178563,178565,178568,2,5,0
51083,3,1,178566,178568,178569,2,3,0
51084,4,1,178570,178570,178571,0,1,1
51085,6,1,178576,178576,178577,0,1,5
51086,3,1,178579,178579,178580,0,1,2
51087,4,1,178583,178583,178584,0,1,3
51088,1,3,178584,178584,178587,0,3,0
51089,1,2,178585,178587,178589,2,4,0
51090,1,2,178586,178589,178591,3,5,0
51091,5,1,178591,178591,178592,0,1,0
51092,5,3,178596,178596,178599,0,3,4
51093,1,2,178597,178599,178601,2,4,0
51094,6,2,178603,178603,178605,0,2,2
51095,4,3,178607,178607,178610,0,3,2
51096,6,2,178613,178613,178615,0,2,3
51097,5,2,178618,178618,178620,0,2,3
51098,3,2,178621,178621,178623,0,2,1
51099,6,1,178627,178627,178628,0,1,4
51100,3,1,178630,178630,178631,0,1,2
51101,2,2,178632,178632,178634,0,2,1
51102,6,2,178638,178638,178640,0,2,4
51103,1,1,178639,178640,178641,1,2,0
51104,1,3,178640,178641,178644,1,4,0
51105,5,3,178645,178645,178648,0,3,1
51106,1,3,178646,178648,178651,2,5,0
51107,6,1,178652,178652,178653,0,1,1
51108,2,3,178654,178654,178657,0,3,1
51109,5,2,178659,178659,178661,0,2,2
51110,1,2,178660,178661,178663,1,3,0
51111,2,3,178662,178663,178666,1,4,0
51112,3,1,178665,178666,178667,1,2,0
51113,1,1,178666,178667,178668,1,2,0
51114,4,3,178670,178670,178673,0,3,2
51115,3,3,178673,178673,178676,0,3,0
51116,1,1,178674,178676,178677,2,3,0
51117,5,1,178679,178679,178680,0,1,2
51118,5,3,178684,178684,178687,0,3,4
51119,4,1,178688,178688,178689,0,1,1
51120,2,1,178690,178690,178691,0,1,1
51121,4,2,178694,178694,178696,0,2,3
51122,1,2,178695,178696,178698,1,3,0
51123,2,1,178697,178698,178699,1,2,0
51124,4,2,178701,178701,178703,0,2,2
51125,5,2,178706,178706,178708,0,2,3
51126,1,2,178707,178708,178710,1,3,0
51127,4,3,178711,178711,178714,0,3,1
51128,4,2,178715,178715,178717,0,2,1
51129,6,3,178721,178721,178724,0,3,4
51130,5,3,178726,178726,178729,0,3,2
51131,4,2,178730,178730,178732,0,2,1
51132,3,1,178733,178733,178734,0,1,1
51133,3,3,178736,178736,178739,0,3,2
51134,2,1,178738,178739,178740,1,2,0
51135,1,3,178739,178740,178743,1,4,0
51136,4,1,178743,178743,178744,0,1,0
51137,2,1,178745,178745,178746,0,1,1
51138,4,2,178749,178749,178751,0,2,3
51139,5,3,178754,178754,178757,0,3,3
51140,4,1,178758,178758,178759,0,1,1
51141,5,2,178763,178763,178765,0,2,4
51142,2,2,178765,178765,178767,0,2,0
51143,3,2,178768,178768,178770,0,2,1
51144,5,1,178773,178773,178774,0,1,3
51145,6,1,178779,178779,178780,0,1,5
51146,1,1,178780,178780,178781,0,1,0
51147,2,3,178782,178782,178785,0,3,1
51148,1,1,178783,178785,178786,2,3,0
51149,6,3,178789,178789,178792,0,3,3
51150,6,2,178795,178795,178797,0,2,3
51151,5,1,178800,178800,178801,0,1,3
51152,2,1,178802,178802,178803,0,1,1
51153,2,3,178804,178804,178807,0,3,1
51154,4,3,178808,178808,178811,0,3,1
51155,6,3,178814,178814,178817,0,3,3
51156,4,1,178818,178818,178819,0,1,1
51157,2,1,178820,178820,178821,0,1,1
51158,4,1,178824,178824,178825,0,1,3
51159,3,2,178827,178827,178829,0,2,2
51160,4,2,178831,178831,178833,0,2,2
51161,6,1,178837,178837,178838,0,1,4
51162,6,3,178843,178843,178846,0,3,5
51163,5,2,178848,178848,178850,0,2,2
51164,6,2,178854,178854,178856,0,2,4
51165,5,3,178859,178859,178862,0,3,3
51166,2,2,178861,178862,178864,1,3,0
51167,1,1,178862,178864,178865,2,3,0
51168,1,2,178863,178865,178867,2,4,0
51169,4,3,178867,178867,178870,0,3,0
51170,6,3,178873,178873,178876,0,3,3
51171,1,2,178874,178876,178878,2,4,0
51172,2,2,178876,178878,178880,2,4,0
51173,2,3,178878,178880,178883,2,5,0
51174,4,2,178882,178883,178885,1,3,0
51175,4,1,178886,178886,178887,0,1,1
51176,6,1,178892,178892,178893,0,1,5
51177,5,2,178897,178897,178899,0,2,4
51178,4,2,178901,178901,178903,0,2,2
51179,3,3,178904,178904,178907,0,3,1
51180,5,2,178909,178909,178911,0,2,2
51181,5,3,178914,178914,178917,0,3,3
51182,2,1,178916,178917,178918,1,2,0
51183,2,2,178918,178918,178920,0,2,0
51184,6,3,178924,178924,178927,0,3,4
51185,6,2,178930,178930,178932,0,2,3
51186,1,2,178931,178932,178934,1,3,0
51187,4,3,178935,178935,178938,0,3,1
51188,2,3,178937,178938,178941,1,4,0
51189,2,2,178939,178941,178943,2,4,0
51190,4,2,178943,178943,178945,0,2,0
51191,2,3,178945,178945,178948,0,3,0
51192,4,1,178949,178949,178950,0,1,1
51193,3,2,178952,178952,178954,0,2,2
51194,2,3,178954,178954,178957,0,3,0
51195,1,3,178955,178957,178960,2,5,0
51196,5,2,178960,178960,178962,0,2,0
51197,3,2,178963,178963,178965,0,2,1
51198,4,1,178967,178967,178968,0,1,2
51199,5,2,178972,178972,178974,0,2,4
51200,6,2,178978,178978,178980,0,2,4
51201,2,2,178980,178980,178982,0,2,0
51202,3,3,178983,178983,178986,0,3,1
51203,4,1,178987,178987,178988,0,1,1
51204,4,1,178991,178991,178992,0,1,3
51205,1,1,178992,178992,178993,0,1,0
51206,6,3,178998,178998,179001,0,3,5
51207,4,3,179002,179002,179005,0,3,1
51208,1,1,179003,179005,179006,2,3,0
51209,1,1,179004,179006,179007,2,3,0
51210,4,1,179008,179008,179009,0,1,1
51211,6,2,179014,179014,179016,0,2,5
51212,5,3,179019,179019,179022,0,3,3
51213,6,1,179025,179025,179026,0,1,3
51214,6,1,179031,179031,179032,0,1,5
51215,1,3,179032,179032,179035,0,3,0
51216,2,1,179034,179035,179036,1,2,0
51217,1,1,179035,179036,179037,1,2,0
51218,6,3,179041,179041,179044,0,3,4
51219,4,2,179045,179045,179047,0,2,1
51220,5,2,179050,179050,179052,0,2,3
51221,2,3,179052,179052,179055,0,3,0
51222,6,1,179058,179058,179059,0,1,3
51223,2,1,179060,179060,179061,0,1,1
51224,1,2,179061,179061,179063,0,2,0
51225,1,2,179062,179063,179065,1,3,0
51226,1,1,179063,179065,179066,2,3,0
51227,3,1,179066,179066,179067,0,1,0
51228,1,3,179067,179067,179070,0,3,0
51229,3,1,179070,179070,179071,0,1,0
51230,5,1,179075,179075,179076,0,1,4
51231,1,1,179076,179076,179077,0,1,0
51232,2,1,179078,179078,179079,0,1,1
51233,3,2,179081,179081,179083,0,2,2
51234,5,2,179086,179086,179088,0,2,3
51235,4,2,179090,179090,179092,0,2,2
51236,4,1,179094,179094,179095,0,1,2
51237,1,3,179095,179095,179098,0,3,0
51238,2,3,179097,179098,179101,1,4,0
51239,2,1,179099,179101,179102,2,3,0
51240,6,2,179105,179105,179107,0,2,3
51241,6,3,179111,179111,179114,0,3,4
51242,3,3,179114,179114,179117,0,3,0
51243,2,3,179116,179117,179120,1,4,0
51244,6,2,179122,179122,179124,0,2,2
51245,5,2,179127,179127,179129,0,2,3
51246,4,2,179131,179131,179133,0,2,2
51247,3,1,179134,179134,179135,0,1,1
51248,2,2,179136,179136,179138,0,2,1
51249,2,3,179138,179138,179141,0,3,0
51250,6,1,179144,179144,179145,0,1,3
51251,2,2,179146,179146,179148,0,2,1
51252,1,2,179147,179148,179150,1,3,0
51253,1,1,179148,179150,179151,2,3,0
51254,5,3,179153,179153,179156,0,3,2
51255,5,2,179158,179158,179160,0,2,2
51256,4,3,179162,179162,179165,0,3,2
51257,4,2,179166,179166,179168,0,2,1
51258,1,2,179167,179168,179170,1,3,0
51259,1,1,179168,179170,179171,2,3,0
51260,4,1,179172,179172,179173,0,1,1
51261,2,2,179174,179174,179176,0,2,1
51262,2,3,179176,179176,179179,0,3,0
51263,5,2,179181,179181,179183,0,2,2
51264,2,2,179183,179183,179185,0,2,0
51265,1,2,179184,179185,179187,1,3,0
51266,2,1,179186,179187,179188,1,2,0
51267,1,2,179187,179188,179190,1,3,0
51268,2,3,179189,179190,179193,1,4,0
51269,2,1,179191,179193,179194,2,3,0
51270,2,2,179193,179194,179196,1,3,0
51271,2,3,179195,179196,179199,1,4,0
51272,4,3,179199,179199,179202,0,3,0
51273,6,3,179205,179205,179208,0,3,3
51274,3,1,179208,179208,179209,0,1,0
51275,3,1,179211,179211,179212,0,1,2
51276,1,3,179212,179212,179215,0,3,0
51277,4,1,179216,179216,179217,0,1,1
51278,6,3,179222,179222,179225,0,3,5
51279,3,2,179225,179225,179227,0,2,0
51280,5,1,179230,179230,179231,0,1,3
51281,1,3,179231,179231,179234,0,3,0
51282,2,3,179233,179234,179237,1,4,0
51283,6,2,179239,179239,179241,0,2,2
51284,3,1,179242,179242,179243,0,1,1
51285,4,3,179246,179246,179249,0,3,3
51286,2,2,179248,179249,179251,1,3,0
51287,3,3,179251,179251,179254,0,3,0
51288,1,2,179252,179254,179256,2,4,0
51289,4,1,179256,179256,179257,0,1,0
51290,4,3,179260,179260,179263,0,3,3
51291,2,3,179262,179263,179266,1,4,0
51292,6,1,179268,179268,179269,0,1,2
51293,1,2,179269,179269,179271,0,2,0
51294,2,1,179271,179271,179272,0,1,0
51295,6,3,179277,179277,179280,0,3,5
51296,3,2,179280,179280,179282,0,2,0
51297,6,1,179286,179286,179287,0,1,4
51298,3,1,179289,179289,179290,0,1,2
51299,2,1,179291,179291,179292,0,1,1
51300,5,3,179296,179296,179299,0,3,4
51301,3,2,179299,179299,179301,0,2,0
51302,3,2,179302,179302,179304,0,2,1
51303,1,3,179303,179304,179307,1,4,0
51304,4,2,179307,179307,179309,0,2,0
51305,6,3,179313,179313,179316,0,3,4
51306,3,1,179316,179316,179317,0,1,0
51307,5,1,179321,179321,179322,0,1,4
51308,1,1,179322,179322,179323,0,1,0
51309,6,3,179328,179328,179331,0,3,5
51310,3,1,179331,179331,179332,0,1,0
51311,3,3,179334,179334,179337,0,3,2
51312,3,2,179337,179337,179339,0,2,0
51313,6,2,179343,179343,179345,0,2,4
51314,5,1,179348,179348,179349,0,1,3
51315,5,3,179353,179353,179356,0,3,4
51316,4,1,179357,179357,179358,0,1,1
51317,4,2,179361,179361,179363,0,2,3
51318,3,1,179364,179364,179365,0,1,1
51319,2,3,179366,179366,179369,0,3,1
51320,2,3,179368,179369,179372,1,4,0
51321,3,3,179371,179372,179375,1,4,0
51322,4,1,179375,179375,179376,0,1,0
51323,5,3,179380,179380,179383,0,3,4
51324,2,2,179382,179383,179385,1,3,0
51325,4,1,179386,179386,179387,0,1,1
51326,4,3,179390,179390,179393,0,3,3
51327,2,3,179392,179393,179396,1,4,0
51328,1,3,179393,179396,179399,3,6,0
51329,1,3,179394,179399,179402,5,8,0
51330,1,1,179395,179402,179403,7,8,0
51331,5,3,179400,179403,179406,3,6,0
51332,1,2,179401,179406,179408,5,7,0
51333,4,3,179405,179408,179411,3,6,0
51334,3,3,179408,179411,179414,3,6,0
51335,4,1,179412,179414,179415,2,3,0
51336,3,2,179415,179415,179417,0,2,0
51337,2,3,179417,179417,179420,0,3,0
51338,2,3,179419,179420,179423,1,4,0
51339,3,2,179422,179423,179425,1,3,0
51340,4,1,179426,179426,179427,0,1,1
51341,6,2,179432,179432,179434,0,2,5
51342,6,2,179438,179438,179440,0,2,4
51343,2,1,179440,179440,179441,0,1,0
51344,1,3,179441,179441,179444,0,3,0
51345,5,3,179446,179446,179449,0,3,2
51346,2,3,179448,179449,179452,1,4,0
51347,4,3,179452,179452,179455,0,3,0
51348,6,1,179458,179458,179459,0,1,3
51349,2,3,179460,179460,179463,0,3,1
51350,6,2,179466,179466,179468,0,2,3
51351,5,2,179471,179471,179473,0,2,3
51352,6,1,179477,179477,179478,0,1,4
51353,1,3,179478,179478,179481,0,3,0
51354,6,3,179484,179484,179487,0,3,3
51355,2,3,179486,179487,179490,1,4,0
51356,6,3,179492,179492,179495,0,3,2
51357,4,1,179496,179496,179497,0,1,1
51358,3,1,179499,179499,179500,0,1,2
51359,3,1,179502,179502,179503,0,1,2
51360,3,3,179505,179505,179508,0,3,2
51361,4,1,179509,179509,179510,0,1,1
51362,3,1,179512,179512,179513,0,1,2
51363,2,1,179514,179514,179515,0,1,1
51364,4,1,179518,179518,179519,0,1,3
51365,3,3,179521,179521,179524,0,3,2
51366,3,1,179524,179524,179525,0,1,0
51367,2,1,179526,179526,179527,0,1,1
51368,1,2,179527,179527,179529,0,2,0
51369,5,1,179532,179532,179533,0,1,3
51370,4,2,179536,179536,179538,0,2,3
51371,5,3,179541,179541,179544,0,3,3
51372,1,2,179542,179544,179546,2,4,0
51373,3,2,179545,179546,179548,1,3,0
51374,2,3,179547,179548,179551,1,4,0
51375,1,1,179548,179551,179552,3,4,0
51376,5,2,179553,179553,179555,0,2,1
51377,2,2,179555,179555,179557,0,2,0
51378,4,1,179559,179559,179560,0,1,2
51379,6,2,179565,179565,179567,0,2,5
51380,4,2,179569,179569,179571,0,2,2
51381,5,1,179574,179574,179575,0,1,3
51382,3,1,179577,179577,179578,0,1,2
51383,2,2,179579,179579,179581,0,2,1
51384,5,1,179584,179584,179585,0,1,3
51385,5,2,179589,179589,179591,0,2,4
51386,6,3,179595,179595,179598,0,3,4
51387,2,3,179597,179598,179601,1,4,0
51388,1,3,179598,179601,179604,3,6,0
51389,4,2,179602,179604,179606,2,4,0
51390,6,2,179608,179608,179610,0,2,2
51391,3,3,179611,179611,179614,0,3,1
51392,3,3,179614,179614,179617,0,3,0
51393,5,2,179619,179619,179621,0,2,2
51394,1,1,179620,179621,179622,1,2,0
51395,4,3,179624,179624,179627,0,3,2
51396,4,1,179628,179628,179629,0,1,1
51397,4,3,179632,179632,179635,0,3,3
51398,2,2,179634,179635,179637,1,3,0
51399,6,3,179640,179640,179643,0,3,3
51400,3,3,179643,179643,179646,0,3,0
51401,1,3,179644,179646,179649,2,5,0
51402,2,1,179646,179649,179650,3,4,0
51403,4,2,179650,179650,179652,0,2,0
51404,1,2,179651,179652,179654,1,3,0
51405,5,1,179656,179656,179657,0,1,2
51406,6,2,179662,179662,179664,0,2,5
51407,5,2,179667,179667,179669,0,2,3
51408,4,2,179671,179671,179673,0,2,2
51409,3,1,179674,179674,179675,0,1,1
51410,5,2,179679,179679,179681,0,2,4
51411,3,1,179682,179682,179683,0,1,1
51412,4,3,179686,179686,179689,0,3,3
51413,3,3,179689,179689,179692,0,3,0
51414,2,3,179691,179692,179695,1,4,0
51415,4,3,179695,179695,179698,0,3,0
51416,5,2,179700,179700,179702,0,2,2
51417,3,3,179703,179703,179706,0,3,1
51418,6,2,179709,179709,179711,0,2,3
51419,2,1,179711,179711,179712,0,1,0
51420,6,2,179717,179717,179719,0,2,5
51421,2,3,179719,179719,179722,0,3,0
51422,5,1,179724,179724,179725,0,1,2
51423,5,1,179729,179729,179730,0,1,4
51424,1,3,179730,179730,179733,0,3,0
51425,4,3,179734,179734,179737,0,3,1
51426,3,1,179737,179737,179738,0,1,0
51427,2,2,179739,179739,179741,0,2,1
51428,6,1,179745,179745,179746,0,1,4
51429,1,2,179746,179746,179748,0,2,0
51430,2,2,179748,179748,179750,0,2,0
51431,4,1,179752,179752,179753,0,1,2
51432,5,3,179757,179757,179760,0,3,4
51433,4,3,179761,179761,179764,0,3,1
51434,6,1,179767,179767,179768,0,1,3
51435,3,1,179770,179770,179771,0,1,2
51436,3,1,179773,179773,179774,0,1,2
51437,4,3,179777,179777,179780,0,3,3
51438,2,2,179779,179780,179782,1,3,0
51439,3,2,179782,179782,179784,0,2,0
51440,2,1,179784,179784,179785,0,1,0
51441,5,1,179789,179789,179790,0,1,4
51442,2,2,179791,179791,179793,0,2,1
51443,4,1,179795,179795,179796,0,1,2
51444,4,1,179799,179799,179800,0,1,3
51445,4,1,179803,179803,179804,0,1,3
51446,4,3,179807,179807,179810,0,3,3
51447,1,2,179808,179810,179812,2,4,0
51448,2,1,179810,179812,179813,2,3,0
51449,1,2,179811,179813,179815,2,4,0
51450,4,1,179815,179815,179816,0,1,0
51451,5,3,179820,179820,179823,0,3,4
51452,5,1,179825,179825,179826,0,1,2
51453,1,1,179826,179826,179827,0,1,0
51454,2,1,179828,179828,179829,0,1,1
51455,5,3,179833,179833,179836,0,3,4
51456,3,2,179836,179836,179838,0,2,0
51457,1,1,179837,179838,179839,1,2,0
51458,2,1,179839,179839,179840,0,1,0
51459,6,2,179845,179845,179847,0,2,5
51460,3,2,179848,179848,179850,0,2,1
51461,4,2,179852,179852,179854,0,2,2
51462,2,1,179854,179854,179855,0,1,0
51463,1,3,179855,179855,179858,0,3,0
51464,3,2,179858,179858,179860,0,2,0
51465,5,3,179863,179863,179866,0,3,3
51466,3,3,179866,179866,179869,0,3,0
51467,6,2,179872,179872,179874,0,2,3
51468,4,1,179876,179876,179877,0,1,2
51469,3,2,179879,179879,179881,0,2,2
51470,3,2,179882,179882,179884,0,2,1
51471,6,3,179888,179888,179891,0,3,4
51472,4,2,179892,179892,179894,0,2,1
51473,2,2,179894,179894,179896,0,2,0
51474,6,1,179900,179900,179901,0,1,4
51475,5,3,179905,179905,179908,0,3,4
51476,5,3,179910,179910,179913,0,3,2
51477,5,2,179915,179915,179917,0,2,2
51478,3,3,179918,179918,179921,0,3,1
51479,3,1,179921,179921,179922,0,1,0
51480,6,3,179927,179927,179930,0,3,5
51481,1,3,179928,179930,179933,2,5,0
51482,2,3,179930,179933,179936,3,6,0
51483,2,1,179932,179936,179937,4,5,0
51484,5,3,179937,179937,179940,0,3,0
51485,3,2,179940,179940,179942,0,2,0
51486,4,2,179944,179944,179946,0,2,2
51487,6,2,179950,179950,179952,0,2,4
51488,6,3,179956,179956,179959,0,3,4
51489,5,1,179961,179961,179962,0,1,2
51490,6,1,179967,179967,179968,0,1,5
51491,4,3,179971,179971,179974,0,3,3
51492,2,2,179973,179974,179976,1,3,0
51493,3,1,179976,179976,179977,0,1,0
51494,3,2,179979,179979,179981,0,2,2
51495,3,3,179982,179982,179985,0,3,1
51496,5,3,179987,179987,179990,0,3,2
51497,3,1,179990,179990,179991,0,1,0
51498,5,1,179995,179995,179996,0,1,4
51499,3,1,179998,179998,179999,0,1,2
51500,4,2,180002,180002,180004,0,2,3
51501,3,3,180005,180005,180008,0,3,1
51502,6,2,180011,180011,180013,0,2,3
51503,2,2,180013,180013,180015,0,2,0
51504,5,1,180018,180018,180019,0,1,3
51505,1,2,180019,180019,180021,0,2,0
51506,2,2,180021,180021,180023,0,2,0
51507,6,2,180027,180027,180029,0,2,4
51508,3,2,180030,180030,180032,0,2,1
51509,4,1,180034,180034,180035,0,1,2
51510,3,1,180037,180037,180038,0,1,2
51511,3,1,180040,180040,180041,0,1,2
51512,4,1,180044,180044,180045,0,1,3
51513,5,2,180049,180049,180051,0,2,4
51514,5,1,180054,180054,180055,0,1,3
51515,5,1,180059,180059,180060,0,1,4
51516,4,1,180063,180063,180064,0,1,3
51517,1,1,180064,180064,180065,0,1,0
51518,5,2,180069,180069,180071,0,2,4
51519,3,1,180072,180072,180073,0,1,1
51520,3,2,180075,180075,180077,0,2,2
51521,3,2,180078,180078,180080,0,2,1
51522,1,2,180079,180080,180082,1,3,0
51523,4,3,180083,180083,180086,0,3,1
51524,2,3,180085,180086,180089,1,4,0
51525,2,2,180087,180089,180091,2,4,0
51526,2,3,180089,180091,180094,2,5,0
51527,3,3,180092,180094,180097,2,5,0
51528,5,3,180097,180097,180100,0,3,0
51529,2,2,180099,180100,180102,1,3,0
51530,4,3,180103,180103,180106,0,3,1
51531,2,3,180105,180106,180109,1,4,0
51532,6,3,180111,180111,180114,0,3,2
51533,6,2,180117,180117,180119,0,2,3
51534,1,1,180118,180119,180120,1,2,0
51535,2,3,180120,180120,180123,0,3,0
51536,3,3,180123,180123,180126,0,3,0
51537,4,2,180127,180127,180129,0,2,1
51538,4,2,180131,180131,180133,0,2,2
51539,6,1,180137,180137,180138,0,1,4
51540,4,1,180141,180141,180142,0,1,3
51541,6,1,180147,180147,180148,0,1,5
51542,1,3,180148,180148,180151,0,3,0
51543,5,2,180153,180153,180155,0,2,2
51544,1,3,180154,180155,180158,1,4,0
51545,3,1,180157,180158,180159,1,2,0
51546,4,1,180161,180161,180162,0,1,2
51547,2,1,180163,180163,180164,0,1,1
51548,6,2,180169,180169,180171,0,2,5
51549,6,2,180175,180175,180177,0,2,4
51550,1,1,180176,180177,180178,1,2,0
51551,6,3,180182,180182,180185,0,3,4
51552,3,1,180185,180185,180186,0,1,0
51553,4,2,180189,180189,180191,0,2,3
51554,2,3,180191,180191,180194,0,3,0
51555,1,2,180192,180194,180196,2,4,0
51556,6,1,180198,180198,180199,0,1,2
51557,5,1,180203,180203,180204,0,1,4
51558,2,3,180205,180205,180208,0,3,1
51559,5,3,180210,180210,180213,0,3,2
51560,5,2,180215,180215,180217,0,2,2
51561,4,3,180219,180219,180222,0,3,2
51562,1,3,180220,180222,180225,2,5,0
51563,1,3,180221,180225,180228,4,7,0
51564,1,3,180222,180228,180231,6,9,0
51565,1,1,180223,180231,180232,8,9,0
51566,2,1,180225,180232,180233,7,8,0
51567,6,1,180231,180233,180234,2,3,0
51568,4,3,180235,180235,180238,0,3,1
51569,3,3,180238,180238,180241,0,3,0
51570,1,1,180239,180241,180242,2,3,0
51571,1,1,180240,180242,180243,2,3,0
51572,5,2,180245,180245,180247,0,2,2
51573,6,3,180251,180251,180254,0,3,4
51574,1,1,180252,180254,180255,2,3,0
51575,4,3,180256,180256,180259,0,3,1
51576,4,1,180260,180260,180261,0,1,1
51577,6,3,180266,180266,180269,0,3,5
51578,3,1,180269,180269,180270,0,1,0
51579,2,1,180271,180271,180272,0,1,1
51580,2,3,180273,180273,180276,0,3,1
51581,3,3,180276,180276,180279,0,3,0
51582,4,2,180280,180280,180282,0,2,1
51583,1,3,180281,180282,180285,1,4,0
51584,1,3,180282,180285,180288,3,6,0
51585,3,3,180285,180288,180291,3,6,0
51586,5,1,180290,180291,180292,1,2,0
51587,3,3,180293,180293,180296,0,3,1
51588,1,3,180294,180296,180299,2,5,0
51589,1,1,180295,180299,180300,4,5,0
51590,4,3,180299,180300,180303,1,4,0
51591,5,1,180304,180304,180305,0,1,1
51592,1,1,180305,180305,180306,0,1,0
51593,3,3,180308,180308,180311,0,3,2
51594,6,1,180314,180314,180315,0,1,3
51595,6,3,180320,180320,180323,0,3,5
51596,4,1,180324,180324,180325,0,1,1
51597,5,1,180329,180329,180330,0,1,4
51598,1,3,180330,180330,180333,0,3,0
51599,1,1,180331,180333,180334,2,3,0
51600,1,1,180332,180334,180335,2,3,0
51601,3,1,180335,180335,180336,0,1,0
51602,6,1,180341,180341,180342,0,1,5
51603,4,1,180345,180345,180346,0,1,3
51604,2,1,180347,180347,180348,0,1,1
51605,5,1,180352,180352,180353,0,1,4
51606,6,1,180358,180358,180359,0,1,5
51607,5,1,180363,180363,180364,0,1,4
51608,2,1,180365,180365,180366,0,1,1
51609,6,1,180371,180371,180372,0,1,5
51610,2,2,180373,180373,180375,0,2,1
51611,3,2,180376,180376,180378,0,2,1
51612,1,3,180377,180378,180381,1,4,0
51613,2,2,180379,180381,180383,2,4,0
51614,5,3,180384,180384,180387,0,3,1
51615,3,1,180387,180387,180388,0,1,0
51616,3,3,180390,180390,180393,0,3,2
51617,2,2,180392,180393,180395,1,3,0
51618,2,3,180394,180395,180398,1,4,0
51619,5,1,180399,180399,180400,0,1,1
51620,1,1,180400,180400,180401,0,1,0
51621,3,1,180403,180403,180404,0,1,2
51622,3,1,180406,180406,180407,0,1,2
51623,6,2,180412,180412,180414,0,2,5
51624,4,1,180416,180416,180417,0,1,2
51625,4,1,180420,180420,180421,0,1,3
51626,6,2,180426,180426,180428,0,2,5
51627,2,2,180428,180428,180430,0,2,0
51628,4,1,180432,180432,180433,0,1,2
51629,6,3,180438,180438,180441,0,3,5
51630,3,2,180441,180441,180443,0,2,0
51631,6,3,180447,180447,180450,0,3,4
51632,3,3,180450,180450,180453,0,3,0
51633,5,1,180455,180455,180456,0,1,2
51634,6,2,180461,180461,180463,0,2,5
51635,2,1,180463,180463,180464,0,1,0
51636,3,2,180466,180466,180468,0,2,2
51637,1,3,180467,180468,180471,1,4,0
51638,5,3,180472,180472,180475,0,3,1
51639,2,1,180474,180475,180476,1,2,0
51640,3,2,180477,180477,180479,0,2,1
51641,4,2,180481,180481,180483,0,2,2
51642,5,1,180486,180486,180487,0,1,3
51643,2,3,180488,180488,180491,0,3,1
51644,5,2,180493,180493,180495,0,2,2
51645,3,1,180496,180496,180497,0,1,1
51646,1,3,180497,180497,180500,0,3,0
51647,4,3,180501,180501,180504,0,3,1
51648,2,1,180503,180504,180505,1,2,0
51649,3,2,180506,180506,180508,0,2,1
51650,4,2,180510,180510,180512,0,2,2
51651,3,3,180513,180513,180516,0,3,1
51652,6,1,180519,180519,180520,0,1,3
51653,3,3,180522,180522,180525,0,3,2
51654,4,3,180526,180526,180529,0,3,1
51655,3,1,180529,180529,180530,0,1,0
51656,6,2,180535,180535,180537,0,2,5
51657,2,2,180537,180537,180539,0,2,0
51658,5,3,180542,180542,180545,0,3,3
51659,6,3,180548,180548,180551,0,3,3
51660,4,3,180552,180552,180555,0,3,1
51661,4,1,180556,180556,180557,0,1,1
51662,3,1,180559,180559,180560,0,1,2
51663,3,3,180562,180562,180565,0,3,2
51664,2,3,180564,180565,180568,1,4,0
51665,6,3,180570,180570,180573,0,3,2
51666,4,1,180574,180574,180575,0,1,1
51667,1,3,180575,180575,180578,0,3,0
51668,4,1,180579,180579,180580,0,1,1
51669,3,2,180582,180582,180584,0,2,2
51670,2,2,180584,180584,180586,0,2,0
51671,1,1,180585,180586,180587,1,2,0
51672,4,1,180589,180589,180590,0,1,2
51673,3,1,180592,180592,180593,0,1,2
51674,4,1,180596,180596,180597,0,1,3
51675,1,3,180597,180597,180600,0,3,0
51676,4,3,180601,180601,180604,0,3,1
51677,1,2,180602,180604,180606,2,4,0
51678,5,2,180607,180607,180609,0,2,1
51679,6,1,180613,180613,180614,0,1,4
51680,4,3,180617,180617,180620,0,3,3
51681,2,2,180619,180620,180622,1,3,0
51682,5,3,180624,180624,180627,0,3,2
51683,5,3,180629,180629,180632,0,3,2
51684,4,1,180633,180633,180634,0,1,1
51685,5,3,180638,180638,180641,0,3,4
51686,3,1,180641,180641,180642,0,1,0
51687,4,1,180645,180645,180646,0,1,3
51688,2,3,180647,180647,180650,0,3,1
51689,2,2,180649,180650,180652,1,3,0
51690,2,1,180651,180652,180653,1,2,0
51691,3,1,180654,180654,180655,0,1,1
51692,5,2,180659,180659,180661,0,2,4
51693,6,1,180665,180665,180666,0,1,4
51694,4,3,180669,180669,180672,0,3,3
51695,5,2,180674,180674,180676,0,2,2
51696,5,1,180679,180679,180680,0,1,3
51697,5,1,180684,180684,180685,0,1,4
51698,1,3,180685,180685,180688,0,3,0
51699,2,3,180687,180688,180691,1,4,0
51700,5,3,180692,180692,180695,0,3,1
51701,1,2,180693,180695,180697,2,4,0
51702,6,1,180699,180699,180700,0,1,2
51703,4,2,180703,180703,180705,0,2,3
51704,3,1,180706,180706,180707,0,1,1
51705,2,2,180708,180708,180710,0,2,1
51706,5,3,180713,180713,180716,0,3,3
51707,1,3,180714,180716,180719,2,5,0
51708,5,1,180719,180719,180720,0,1,0
51709,6,2,180725,180725,180727,0,2,5
51710,6,1,180731,180731,180732,0,1,4
51711,3,1,180734,180734,180735,0,1,2
51712,3,1,180737,180737,180738,0,1,2
51713,5,1,180742,180742,180743,0,1,4
51714,6,3,180748,180748,180751,0,3,5
51715,5,1,180753,180753,180754,0,1,2
51716,4,1,180757,180757,180758,0,1,3
51717,5,1,180762,180762,180763,0,1,4
51718,1,3,180763,180763,180766,0,3,0
51719,2,1,180765,180766,180767,1,2,0
51720,4,2,180769,180769,180771,0,2,2
51721,2,1,180771,180771,180772,0,1,0
51722,4,2,180775,180775,180777,0,2,3
51723,3,3,180778,180778,180781,0,3,1
51724,5,1,180783,180783,180784,0,1,2
51725,4,2,180787,180787,180789,0,2,3
51726,2,1,180789,180789,180790,0,1,0
51727,6,1,180795,180795,180796,0,1,5
51728,5,3,180800,180800,180803,0,3,4
51729,5,2,180805,180805,180807,0,2,2
51730,3,2,180808,180808,180810,0,2,1
51731,3,3,180811,180811,180814,0,3,1
51732,5,1,180816,180816,180817,0,1,2
51733,1,1,180817,180817,180818,0,1,0
51734,3,2,180820,180820,180822,0,2,2
51735,6,1,180826,180826,180827,0,1,4
51736,2,2,180828,180828,180830,0,2,1
51737,4,1,180832,180832,180833,0,1,2
51738,1,2,180833,180833,180835,0,2,0
51739,1,1,180834,180835,180836,1,2,0
51740,2,2,180836,180836,180838,0,2,0
51741,2,3,180838,180838,180841,0,3,0
51742,6,2,180844,180844,180846,0,2,3
51743,6,3,180850,180850,180853,0,3,4
51744,1,3,180851,180853,180856,2,5,0
51745,4,2,180855,180856,180858,1,3,0
51746,6,1,180861,180861,180862,0,1,3
51747,3,2,180864,180864,180866,0,2,2
51748,3,2,180867,180867,180869,0,2,1
51749,4,1,180871,180871,180872,0,1,2
51750,3,1,180874,180874,180875,0,1,2
51751,1,2,180875,180875,180877,0,2,0
51752,6,2,180881,180881,180883,0,2,4
51753,5,3,180886,180886,180889,0,3,3
51754,4,3,180890,180890,180893,0,3,1
51755,6,3,180896,180896,180899,0,3,3
51756,2,3,180898,180899,180902,1,4,0
51757,2,1,180900,180902,180903,2,3,0
51758,3,3,180903,180903,180906,0,3,0
51759,5,3,180908,180908,180911,0,3,2
51760,6,3,180914,180914,180917,0,3,3
51761,6,2,180920,180920,180922,0,2,3
51762,1,3,180921,180922,180925,1,4,0
51763,1,3,180922,180925,180928,3,6,0
51764,1,1,180923,180928,180929,5,6,0
51765,5,3,180928,180929,180932,1,4,0
51766,6,3,180934,180934,180937,0,3,2
51767,5,3,180939,180939,180942,0,3,2
51768,3,3,180942,180942,180945,0,3,0
51769,6,2,180948,180948,180950,0,2,3
51770,3,3,180951,180951,180954,0,3,1
51771,3,3,180954,180954,180957,0,3,0
51772,6,3,180960,180960,180963,0,3,3
51773,3,1,180963,180963,180964,0,1,0
51774,1,3,180964,180964,180967,0,3,0
51775,6,2,180970,180970,180972,0,2,3
51776,4,2,180974,180974,180976,0,2,2
51777,1,2,180975,180976,180978,1,3,0
51778,3,3,180978,180978,180981,0,3,0
51779,6,3,180984,180984,180987,0,3,3
51780,6,3,180990,180990,180993,0,3,3
51781,5,1,180995,180995,180996,0,1,2
51782,2,2,180997,180997,180999,0,2,1
51783,6,2,181003,181003,181005,0,2,4
51784,4,1,181007,181007,181008,0,1,2
51785,3,2,181010,181010,181012,0,2,2
51786,1,1,181011,181012,181013,1,2,0
51787,1,2,181012,181013,181015,1,3,0
51788,3,3,181015,181015,181018,0,3,0
51789,3,3,181018,181018,181021,0,3,0
51790,6,2,181024,181024,181026,0,2,3
51791,5,2,181029,181029,181031,0,2,3
51792,6,2,181035,181035,181037,0,2,4
51793,1,3,181036,181037,181040,1,4,0
51794,3,1,181039,181040,181041,1,2,0
51795,1,1,181040,181041,181042,1,2,0
51796,2,1,181042,181042,181043,0,1,0
51797,1,1,181043,181043,181044,0,1,0
51798,4,3,181047,181047,181050,0,3,3
51799,5,3,181052,181052,181055,0,3,2
51800,5,1,181057,181057,181058,0,1,2
51801,2,2,181059,181059,181061,0,2,1
51802,3,1,181062,181062,181063,0,1,1
51803,5,2,181067,181067,181069,0,2,4
51804,6,2,181073,181073,181075,0,2,4
51805,4,2,181077,181077,181079,0,2,2
51806,5,1,181082,181082,181083,0,1,3
51807,6,1,181088,181088,181089,0,1,5
51808,6,2,181094,181094,181096,0,2,5
51809,2,1,181096,181096,181097,0,1,0
51810,6,1,181102,181102,181103,0,1,5
51811,3,2,181105,181105,181107,0,2,2
51812,4,2,181109,181109,181111,0,2,2
51813,1,2,181110,181111,181113,1,3,0
51814,5,2,181115,181115,181117,0,2,2
51815,5,2,181120,181120,181122,0,2,3
51816,6,2,181126,181126,181128,0,2,4
51817,2,3,181128,181128,181131,0,3,0
51818,1,1,181129,181131,181132,2,3,0
51819,1,2,181130,181132,181134,2,4,0
51820,5,2,181135,181135,181137,0,2,1
51821,5,3,181140,181140,181143,0,3,3
51822,6,1,181146,181146,181147,0,1,3
51823,1,1,181147,181147,181148,0,1,0
51824,2,2,181149,181149,181151,0,2,1
51825,5,3,181154,181154,181157,0,3,3
51826,1,3,181155,181157,181160,2,5,0
51827,1,1,181156,181160,181161,4,5,0
51828,2,2,181158,181161,181163,3,5,0
51829,6,1,181164,181164,181165,0,1,1
51830,5,2,181169,181169,181171,0,2,4
51831,1,3,181170,181171,181174,1,4,0
51832,3,2,181173,181174,181176,1,3,0
51833,2,2,181175,181176,181178,1,3,0
51834,3,3,181178,181178,181181,0,3,0
51835,3,3,181181,181181,181184,0,3,0
51836,1,1,181182,181184,181185,2,3,0
51837,1,3,181183,181185,181188,2,5,0
51838,5,1,181188,181188,181189,0,1,0
51839,3,3,181191,181191,181194,0,3,2
51840,3,3,181194,181194,181197,0,3,0
51841,4,3,181198,181198,181201,0,3,1
51842,3,3,181201,181201,181204,0,3,0
51843,6,2,181207,181207,181209,0,2,3
51844,4,2,181211,181211,181213,0,2,2
51845,2,1,181213,181213,181214,0,1,0
51846,1,2,181214,181214,181216,0,2,0
51847,3,2,181217,181217,181219,0,2,1
51848,2,1,181219,181219,181220,0,1,0
51849,6,3,181225,181225,181228,0,3,5
51850,4,2,181229,181229,181231,0,2,1
51851,6,2,181235,181235,181237,0,2,4
51852,1,2,181236,181237,181239,1,3,0
51853,5,3,181241,181241,181244,0,3,2
51854,2,2,181243,181244,181246,1,3,0
51855,6,1,181249,181249,181250,0,1,3
51856,6,1,181255,181255,181256,0,1,5
51857,1,1,181256,181256,181257,0,1,0
51858,6,3,181262,181262,181265,0,3,5
51859,3,2,181265,181265,181267,0,2,0
51860,2,2,181267,181267,181269,0,2,0
51861,6,2,181273,181273,181275,0,2,4
51862,5,1,181278,181278,181279,0,1,3
51863,4,1,181282,181282,181283,0,1,3
51864,2,2,181284,181284,181286,0,2,1
51865,6,1,181290,181290,181291,0,1,4
51866,2,1,181292,181292,181293,0,1,1
51867,3,2,181295,181295,181297,0,2,2
51868,2,1,181297,181297,181298,0,1,0
51869,2,3,181299,181299,181302,0,3,1
51870,4,3,181303,181303,181306,0,3,1
51871,2,3,181305,181306,181309,1,4,0
51872,6,2,181311,181311,181313,0,2,2
51873,6,3,181317,181317,181320,0,3,4
51874,6,2,181323,181323,181325,0,2,3
51875,2,1,181325,181325,181326,0,1,0
51876,1,3,181326,181326,181329,0,3,0
51877,5,1,181331,181331,181332,0,1,2
51878,3,2,181334,181334,181336,0,2,2
51879,6,3,181340,181340,181343,0,3,4
51880,5,2,181345,181345,181347,0,2,2
51881,6,2,181351,181351,181353,0,2,4
51882,4,3,181355,181355,181358,0,3,2
51883,3,3,181358,181358,181361,0,3,0
51884,6,2,181364,181364,181366,0,2,3
51885,4,1,181368,181368,181369,0,1,2
51886,2,3,181370,181370,181373,0,3,1
51887,1,2,181371,181373,181375,2,4,0
51888,4,1,181375,181375,181376,0,1,0
51889,2,1,181377,181377,181378,0,1,1
51890,4,2,181381,181381,181383,0,2,3
51891,4,3,181385,181385,181388,0,3,2
51892,1,1,181386,181388,181389,2,3,0
51893,3,1,181389,181389,181390,0,1,0
51894,1,3,181390,181390,181393,0,3,0
51895,3,2,181393,181393,181395,0,2,0
51896,5,1,181398,181398,181399,0,1,3
51897,6,1,181404,181404,181405,0,1,5
51898,3,3,181407,181407,181410,0,3,2
51899,1,2,181408,181410,181412,2,4,0
51900,1,3,181409,181412,181415,3,6,0
51901,4,2,181413,181415,181417,2,4,0
51902,6,2,181419,181419,181421,0,2,2
51903,4,1,181423,181423,181424,0,1,2
51904,2,1,181425,181425,181426,0,1,1
51905,6,2,181431,181431,181433,0,2,5
51906,1,3,181432,181433,181436,1,4,0
51907,6,2,181438,181438,181440,0,2,2
51908,4,2,181442,181442,181444,0,2,2
51909,5,2,181447,181447,181449,0,2,3
51910,2,1,181449,181449,181450,0,1,0
51911,6,1,181455,181455,181456,0,1,5
51912,2,1,181457,181457,181458,0,1,1
51913,4,1,181461,181461,181462,0,1,3
51914,1,1,181462,181462,181463,0,1,0
51915,4,3,181466,181466,181469,0,3,3
51916,3,1,181469,181469,181470,0,1,0
51917,2,1,181471,181471,181472,0,1,1
51918,1,3,181472,181472,181475,0,3,0
51919,1,2,181473,181475,181477,2,4,0
51920,5,3,181478,181478,181481,0,3,1
51921,1,3,181479,181481,181484,2,5,0
51922,6,3,181485,181485,181488,0,3,1
51923,5,3,181490,181490,181493,0,3,2
51924,6,2,181496,181496,181498,0,2,3
51925,3,3,181499,181499,181502,0,3,1
51926,4,1,181503,181503,181504,0,1,1
51927,2,2,181505,181505,181507,0,2,1
51928,4,3,181509,181509,181512,0,3,2
51929,4,1,181513,181513,181514,0,1,1
51930,4,1,181517,181517,181518,0,1,3
51931,5,2,181522,181522,181524,0,2,4
51932,4,2,181526,181526,181528,0,2,2
51933,2,1,181528,181528,181529,0,1,0
51934,2,3,181530,181530,181533,0,3,1
51935,4,2,181534,181534,181536,0,2,1
51936,3,3,181537,181537,181540,0,3,1
51937,3,3,181540,181540,181543,0,3,0
51938,6,3,181546,181546,181549,0,3,3
51939,5,2,181551,181551,181553,0,2,2
51940,1,1,181552,181553,181554,1,2,0
51941,5,3,181557,181557,181560,0,3,3
51942,5,1,181562,181562,181563,0,1,2
51943,3,1,181565,181565,181566,0,1,2
51944,3,1,181568,181568,181569,0,1,2
51945,4,2,181572,181572,181574,0,2,3
51946,4,3,181576,181576,181579,0,3,2
51947,1,1,181577,181579,181580,2,3,0
51948,5,2,181582,181582,181584,0,2,2
51949,5,2,181587,181587,181589,0,2,3
51950,4,2,181591,181591,181593,0,2,2
51951,3,3,181594,181594,181597,0,3,1
51952,1,3,181595,181597,181600,2,5,0
51953,3,1,181598,181600,181601,2,3,0
51954,1,1,181599,181601,181602,2,3,0
51955,6,3,181605,181605,181608,0,3,3
51956,5,1,181610,181610,181611,0,1,2
51957,5,3,181615,181615,181618,0,3,4
51958,3,3,181618,181618,181621,0,3,0
51959,4,3,181622,181622,181625,0,3,1
51960,1,1,181623,181625,181626,2,3,0
51961,5,3,181628,181628,181631,0,3,2
51962,5,2,181633,181633,181635,0,2,2
51963,6,3,181639,181639,181642,0,3,4
51964,3,3,181642,181642,181645,0,3,0
51965,6,2,181648,181648,181650,0,2,3
51966,1,1,181649,181650,181651,1,2,0
51967,4,3,181653,181653,181656,0,3,2
51968,2,1,181655,181656,181657,1,2,0
51969,2,2,181657,181657,181659,0,2,0
51970,5,2,181662,181662,181664,0,2,3
51971,6,1,181668,181668,181669,0,1,4
51972,1,2,181669,181669,181671,0,2,0
51973,2,2,181671,181671,181673,0,2,0
51974,1,3,181672,181673,181676,1,4,0
51975,1,2,181673,181676,181678,3,5,0
51976,5,2,181678,181678,181680,0,2,0
51977,3,3,181681,181681,181684,0,3,1
51978,1,3,181682,181684,181687,2,5,0
51979,3,1,181685,181687,181688,2,3,0
51980,2,3,181687,181688,181691,1,4,0
51981,5,2,181692,181692,181694,0,2,1
51982,2,1,181694,181694,181695,0,1,0
51983,1,1,181695,181695,181696,0,1,0
51984,2,1,181697,181697,181698,0,1,1
51985,3,1,181700,181700,181701,0,1,2
51986,5,2,181705,181705,181707,0,2,4
51987,5,1,181710,181710,181711,0,1,3
51988,4,3,181714,181714,181717,0,3,3
51989,6,2,181720,181720,181722,0,2,3
51990,3,2,181723,181723,181725,0,2,1
51991,1,1,181724,181725,181726,1,2,0
51992,6,3,181730,181730,181733,0,3,4
51993,5,2,181735,181735,181737,0,2,2
51994,2,3,181737,181737,181740,0,3,0
51995,2,3,181739,181740,181743,1,4,0
51996,6,3,181745,181745,181748,0,3,2
51997,2,1,181747,181748,181749,1,2,0
51998,1,3,181748,181749,181752,1,4,0
51999,3,3,181751,181752,181755,1,4,0
52000,5,1,181756,181756,181757,0,1,1
52001,3,1,181759,181759,181760,0,1,2
52002,2,1,181761,181761,181762,0,1,1
52003,2,1,181763,181763,181764,0,1,1
52004,4,2,181767,181767,181769,0,2,3
52005,1,2,181768,181769,181771,1,3,0
52006,4,3,181772,181772,181775,0,3,1
52007,5,1,181777,181777,181778,0,1,2
52008,3,2,181780,181780,181782,0,2,2
52009,2,2,181782,181782,181784,0,2,0
52010,4,1,181786,181786,181787,0,1,2
52011,6,3,181792,181792,181795,0,3,5
52012,1,3,181793,181795,181798,2,5,0
52013,2,3,181795,181798,181801,3,6,0
52014,1,3,181796,181801,181804,5,8,0
52015,5,3,181801,181804,181807,3,6,0
52016,1,1,181802,181807,181808,5,6,0
52017,2,1,181804,181808,181809,4,5,0
52018,1,3,181805,181809,181812,4,7,0
52019,3,3,181808,181812,181815,4,7,0
52020,5,3,181813,181815,181818,2,5,0
52021,1,3,181814,181818,181821,4,7,0
52022,6,1,181820,181821,181822,1,2,0
52023,5,2,181825,181825,181827,0,2,3
52024,5,1,181830,181830,181831,0,1,3
52025,1,2,181831,181831,181833,0,2,0
52026,6,2,181837,181837,181839,0,2,4
52027,3,1,181840,181840,181841,0,1,1
52028,1,2,181841,181841,181843,0,2,0
52029,4,2,181845,181845,181847,0,2,2
52030,2,2,181847,181847,181849,0,2,0
52031,1,2,181848,181849,181851,1,3,0
52032,5,1,181853,181853,181854,0,1,2
52033,4,3,181857,181857,181860,0,3,3
52034,1,3,181858,181860,181863,2,5,0
52035,4,3,181862,181863,181866,1,4,0
52036,5,3,181867,181867,181870,0,3,1
52037,4,3,181871,181871,181874,0,3,1
52038,4,1,181875,181875,181876,0,1,1
52039,1,2,181876,181876,181878,0,2,0
52040,5,2,181881,181881,181883,0,2,3
52041,2,2,181883,181883,181885,0,2,0
52042,3,1,181886,181886,181887,0,1,1
52043,6,3,181892,181892,181895,0,3,5
52044,1,3,181893,181895,181898,2,5,0
52045,3,2,181896,181898,181900,2,4,0
52046,5,2,181901,181901,181903,0,2,1
52047,1,2,181902,181903,181905,1,3,0
52048,3,1,181905,181905,181906,0,1,0
52049,1,3,181906,181906,181909,0,3,0
52050,2,1,181908,181909,181910,1,2,0
52051,5,1,181913,181913,181914,0,1,3
52052,5,3,181918,181918,181921,0,3,4
52053,4,3,181922,181922,181925,0,3,1
52054,6,3,181928,181928,181931,0,3,3
52055,4,1,181932,181932,181933,0,1,1
52056,6,3,181938,181938,181941,0,3,5
52057,2,2,181940,181941,181943,1,3,0
52058,6,1,181946,181946,181947,0,1,3
52059,6,2,181952,181952,181954,0,2,5
52060,6,2,181958,181958,181960,0,2,4
52061,4,2,181962,181962,181964,0,2,2
52062,6,1,181968,181968,181969,0,1,4
52063,3,1,181971,181971,181972,0,1,2
52064,2,3,181973,181973,181976,0,3,1
52065,3,3,181976,181976,181979,0,3,0
52066,6,2,181982,181982,181984,0,2,3
52067,3,2,181985,181985,181987,0,2,1
52068,1,3,181986,181987,181990,1,4,0
52069,5,1,181991,181991,181992,0,1,1
52070,2,3,181993,181993,181996,0,3,1
52071,2,2,181995,181996,181998,1,3,0
52072,2,2,181997,181998,182000,1,3,0
52073,1,1,181998,182000,182001,2,3,0
52074,6,1,182004,182004,182005,0,1,3
52075,3,1,182007,182007,182008,0,1,2
52076,3,3,182010,182010,182013,0,3,2
52077,6,3,182016,182016,182019,0,3,3
52078,2,3,182018,182019,182022,1,4,0
52079,4,3,182022,182022,182025,0,3,0
52080,1,2,182023,182025,182027,2,4,0
52081,1,3,182024,182027,182030,3,6,0
52082,4,3,182028,182030,182033,2,5,0
52083,2,1,182030,182033,182034,3,4,0
52084,6,1,182036,182036,182037,0,1,2
52085,1,3,182037,182037,182040,0,3,0
52086,5,2,182042,182042,182044,0,2,2
52087,1,3,182043,182044,182047,1,4,0
52088,6,3,182049,182049,182052,0,3,2
52089,4,3,182053,182053,182056,0,3,1
52090,6,1,182059,182059,182060,0,1,3
52091,1,1,182060,182060,182061,0,1,0
52092,5,1,182065,182065,182066,0,1,4
52093,5,1,182070,182070,182071,0,1,4
52094,4,3,182074,182074,182077,0,3,3
52095,3,3,182077,182077,182080,0,3,0
52096,2,2,182079,182080,182082,1,3,0
52097,3,3,182082,182082,182085,0,3,0
52098,4,3,182086,182086,182089,0,3,1
52099,6,2,182092,182092,182094,0,2,3
52100,3,3,182095,182095,182098,0,3,1
52101,6,2,182101,182101,182103,0,2,3
52102,2,2,182103,182103,182105,0,2,0
52103,6,2,182109,182109,182111,0,2,4
52104,5,2,182114,182114,182116,0,2,3
52105,1,2,182115,182116,182118,1,3,0
52106,4,3,182119,182119,182122,0,3,1
52107,3,1,182122,182122,182123,0,1,0
52108,1,3,182123,182123,182126,0,3,0
52109,6,1,182129,182129,182130,0,1,3
52110,2,2,182131,182131,182133,0,2,1
52111,2,1,182133,182133,182134,0,1,0
52112,1,2,182134,182134,182136,0,2,0
52113,2,3,182136,182136,182139,0,3,0
52114,3,3,182139,182139,182142,0,3,0
52115,5,1,182144,182144,182145,0,1,2
52116,2,3,182146,182146,182149,0,3,1
52117,5,1,182151,182151,182152,0,1,2
52118,1,3,182152,182152,182155,0,3,0
52119,5,3,182157,182157,182160,0,3,2
52120,3,3,182160,182160,182163,0,3,0
52121,2,3,182162,182163,182166,1,4,0
52122,5,3,182167,182167,182170,0,3,1
52123,6,3,182173,182173,182176,0,3,3
52124,3,2,182176,182176,182178,0,2,0
52125,3,1,182179,182179,182180,0,1,1
52126,3,2,182182,182182,182184,0,2,2
52127,4,2,182186,182186,182188,0,2,2
52128,6,1,182192,182192,182193,0,1,4
52129,1,3,182193,182193,182196,0,3,0
52130,3,1,182196,182196,182197,0,1,0
52131,5,2,182201,182201,182203,0,2,4
52132,5,1,182206,182206,182207,0,1,3
52133,5,3,182211,182211,182214,0,3,4
52134,5,2,182216,182216,182218,0,2,2
52135,1,3,182217,182218,182221,1,4,0
52136,5,1,182222,182222,182223,0,1,1
52137,4,2,182226,182226,182228,0,2,3
52138,5,3,182231,182231,182234,0,3,3
52139,3,1,182234,182234,182235,0,1,0
52140,2,2,182236,182236,182238,0,2,1
52141,2,3,182238,182238,182241,0,3,0
52142,2,2,182240,182241,182243,1,3,0
52143,6,3,182246,182246,182249,0,3,3
52144,5,2,182251,182251,182253,0,2,2
52145,1,3,182252,182253,182256,1,4,0
52146,5,2,182257,182257,182259,0,2,1
52147,4,2,182261,182261,182263,0,2,2
52148,1,3,182262,182263,182266,1,4,0
52149,1,3,182263,182266,182269,3,6,0
52150,4,1,182267,182269,182270,2,3,0
52151,4,1,182271,182271,182272,0,1,1
52152,3,3,182274,182274,182277,0,3,2
52153,1,2,182275,182277,182279,2,4,0
52154,3,3,182278,182279,182282,1,4,0
52155,5,2,182283,182283,182285,0,2,1
52156,6,2,182289,182289,182291,0,2,4
52157,2,1,182291,182291,182292,0,1,0
52158,1,1,182292,182292,182293,0,1,0
52159,5,3,182297,182297,182300,0,3,4
52160,4,3,182301,182301,182304,0,3,1
52161,2,2,182303,182304,182306,1,3,0
52162,4,3,182307,182307,182310,0,3,1
52163,4,1,182311,182311,182312,0,1,1
52164,3,2,182314,182314,182316,0,2,2
52165,3,3,182317,182317,182320,0,3,1
52166,6,2,182323,182323,182325,0,2,3
52167,5,3,182328,182328,182331,0,3,3
52168,6,2,182334,182334,182336,0,2,3
52169,5,3,182339,182339,182342,0,3,3
52170,4,3,182343,182343,182346,0,3,1
52171,2,3,182345,182346,182349,1,4,0
52172,4,1,182349,182349,182350,0,1,0
52173,5,3,182354,182354,182357,0,3,4
52174,3,2,182357,182357,182359,0,2,0
52175,4,3,182361,182361,182364,0,3,2
52176,1,1,182362,182364,182365,2,3,0
52177,4,1,182366,182366,182367,0,1,1
52178,2,2,182368,182368,182370,0,2,1
52179,3,1,182371,182371,182372,0,1,1
52180,5,3,182376,182376,182379,0,3,4
52181,6,2,182382,182382,182384,0,2,3
52182,3,2,182385,182385,182387,0,2,1
52183,3,3,182388,182388,182391,0,3,1
52184,1,2,182389,182391,182393,2,4,0
52185,1,1,182390,182393,182394,3,4,0
52186,1,2,182391,182394,182396,3,5,0
52187,5,2,182396,182396,182398,0,2,0
52188,1,3,182397,182398,182401,1,4,0
52189,2,3,182399,182401,182404,2,5,0
52190,1,1,182400,182404,182405,4,5,0
52191,6,2,182406,182406,182408,0,2,1
52192,6,1,182412,182412,182413,0,1,4
52193,4,3,182416,182416,182419,0,3,3
52194,4,3,182420,182420,182423,0,3,1
52195,3,3,182423,182423,182426,0,3,0
52196,6,3,182429,182429,182432,0,3,3
52197,5,3,182434,182434,182437,0,3,2
52198,3,3,182437,182437,182440,0,3,0
52199,6,1,182443,182443,182444,0,1,3
52200,2,1,182445,182445,182446,0,1,1
52201,2,3,182447,182447,182450,0,3,1
52202,4,3,182451,182451,182454,0,3,1
52203,4,1,182455,182455,182456,0,1,1
52204,3,3,182458,182458,182461,0,3,2
52205,6,2,182464,182464,182466,0,2,3
52206,1,1,182465,182466,182467,1,2,0
52207,3,3,182468,182468,182471,0,3,1
52208,6,1,182474,182474,182475,0,1,3
52209,6,1,182480,182480,182481,0,1,5
52210,2,2,182482,182482,182484,0,2,1
52211,4,3,182486,182486,182489,0,3,2
52212,5,2,182491,182491,182493,0,2,2
52213,2,2,182493,182493,182495,0,2,0
52214,6,2,182499,182499,182501,0,2,4
52215,4,3,182503,182503,182506,0,3,2
52216,4,1,182507,182507,182508,0,1,1
52217,1,2,182508,182508,182510,0,2,0
52218,6,2,182514,182514,182516,0,2,4
52219,6,1,182520,182520,182521,0,1,4
52220,1,2,182521,182521,182523,0,2,0
52221,2,2,182523,182523,182525,0,2,0
52222,3,1,182526,182526,182527,0,1,1
52223,6,1,182532,182532,182533,0,1,5
52224,3,2,182535,182535,182537,0,2,2
52225,6,2,182541,182541,182543,0,2,4
52226,4,3,182545,182545,182548,0,3,2
52227,4,1,182549,182549,182550,0,1,1
52228,3,3,182552,182552,182555,0,3,2
52229,6,1,182558,182558,182559,0,1,3
52230,5,1,182563,182563,182564,0,1,4
52231,5,2,182568,182568,182570,0,2,4
52232,6,2,182574,182574,182576,0,2,4
52233,5,2,182579,182579,182581,0,2,3
52234,4,3,182583,182583,182586,0,3,2
52235,1,2,182584,182586,182588,2,4,0
52236,1,3,182585,182588,182591,3,6,0
52237,6,3,182591,182591,182594,0,3,0
52238,1,2,182592,182594,182596,2,4,0
52239,1,2,182593,182596,182598,3,5,0
52240,1,2,182594,182598,182600,4,6,0
52241,1,2,182595,182600,182602,5,7,0
52242,1,3,182596,182602,182605,6,9,0
52243,6,3,182602,182605,182608,3,6,0
52244,5,3,182607,182608,182611,1,4,0
52245,1,1,182608,182611,182612,3,4,0
52246,6,1,182614,182614,182615,0,1,2
52247,2,3,182616,182616,182619,0,3,1
52248,4,1,182620,182620,182621,0,1,1
52249,4,3,182624,182624,182627,0,3,3
52250,6,1,182630,182630,182631,0,1,3
52251,5,1,182635,182635,182636,0,1,4
52252,4,1,182639,182639,182640,0,1,3
52253,5,3,182644,182644,182647,0,3,4
52254,5,3,182649,182649,182652,0,3,2
52255,1,1,182650,182652,182653,2,3,0
52256,6,3,182656,182656,182659,0,3,3
52257,4,3,182660,182660,182663,0,3,1
52258,4,3,182664,182664,182667,0,3,1
52259,1,2,182665,182667,182669,2,4,0
52260,4,2,182669,182669,182671,0,2,0
52261,2,1,182671,182671,182672,0,1,0
52262,4,3,182675,182675,182678,0,3,3
52263,2,2,182677,182678,182680,1,3,0
52264,2,2,182679,182680,182682,1,3,0
52265,3,2,182682,182682,182684,0,2,0
52266,1,2,182683,182684,182686,1,3,0
52267,6,1,182689,182689,182690,0,1,3
52268,3,3,182692,182692,182695,0,3,2
52269,2,2,182694,182695,182697,1,3,0
52270,3,1,182697,182697,182698,0,1,0
52271,2,3,182699,182699,182702,0,3,1
52272,5,3,182704,182704,182707,0,3,2
52273,3,3,182707,182707,182710,0,3,0
52274,4,2,182711,182711,182713,0,2,1
52275,4,1,182715,182715,182716,0,1,2
52276,2,2,182717,182717,182719,0,2,1
52277,1,3,182718,182719,182722,1,4,0
52278,6,3,182724,182724,182727,0,3,2
52279,1,3,182725,182727,182730,2,5,0
52280,6,3,182731,182731,182734,0,3,1
52281,2,1,182733,182734,182735,1,2,0
52282,1,3,182734,182735,182738,1,4,0
52283,2,1,182736,182738,182739,2,3,0
52284,5,3,182741,182741,182744,0,3,2
52285,6,3,182747,182747,182750,0,3,3
52286,2,3,182749,182750,182753,1,4,0
52287,3,3,182752,182753,182756,1,4,0
52288,6,3,182758,182758,182761,0,3,2
52289,3,1,182761,182761,182762,0,1,0
52290,2,2,182763,182763,182765,0,2,1
52291,2,2,182765,182765,182767,0,2,0
52292,4,3,182769,182769,182772,0,3,2
52293,3,2,182772,182772,182774,0,2,0
52294,2,1,182774,182774,182775,0,1,0
52295,5,3,182779,182779,182782,0,3,4
52296,5,1,182784,182784,182785,0,1,2
52297,4,3,182788,182788,182791,0,3,3
52298,4,2,182792,182792,182794,0,2,1
52299,5,3,182797,182797,182800,0,3,3
52300,4,1,182801,182801,182802,0,1,1
52301,2,2,182803,182803,182805,0,2,1
52302,4,2,182807,182807,182809,0,2,2
52303,4,2,182811,182811,182813,0,2,2
52304,1,2,182812,182813,182815,1,3,0
52305,1,1,182813,182815,182816,2,3,0
52306,5,3,182818,182818,182821,0,3,2
52307,6,1,182824,182824,182825,0,1,3
52308,4,3,182828,182828,182831,0,3,3
52309,5,1,182833,182833,182834,0,1,2
52310,2,1,182835,182835,182836,0,1,1
52311,4,2,182839,182839,182841,0,2,3
52312,2,2,182841,182841,182843,0,2,0
52313,2,2,182843,182843,182845,0,2,0
52314,2,1,182845,182845,182846,0,1,0
52315,5,2,182850,182850,182852,0,2,4
52316,5,1,182855,182855,182856,0,1,3
52317,2,1,182857,182857,182858,0,1,1
52318,1,2,182858,182858,182860,0,2,0
52319,1,1,182859,182860,182861,1,2,0
52320,6,1,182865,182865,182866,0,1,4
52321,5,2,182870,182870,182872,0,2,4
52322,2,1,182872,182872,182873,0,1,0
52323,6,1,182878,182878,182879,0,1,5
52324,4,3,182882,182882,182885,0,3,3
52325,6,3,182888,182888,182891,0,3,3
52326,4,1,182892,182892,182893,0,1,1
52327,2,2,182894,182894,182896,0,2,1
52328,2,3,182896,182896,182899,0,3,0
52329,4,2,182900,182900,182902,0,2,1
52330,4,2,182904,182904,182906,0,2,2
52331,3,1,182907,182907,182908,0,1,1
52332,1,1,182908,182908,182909,0,1,0
52333,3,3,182911,182911,182914,0,3,2
52334,4,3,182915,182915,182918,0,3,1
52335,6,3,182921,182921,182924,0,3,3
52336,5,2,182926,182926,182928,0,2,2
52337,6,1,182932,182932,182933,0,1,4
52338,4,2,182936,182936,182938,0,2,3
52339,2,1,182938,182938,182939,0,1,0
52340,3,3,182941,182941,182944,0,3,2
52341,2,1,182943,182944,182945,1,2,0
52342,1,3,182944,182945,182948,1,4,0
52343,4,1,182948,182948,182949,0,1,0
52344,4,2,182952,182952,182954,0,2,3
52345,3,3,182955,182955,182958,0,3,1
52346,5,3,182960,182960,182963,0,3,2
52347,3,3,182963,182963,182966,0,3,0
52348,4,1,182967,182967,182968,0,1,1
52349,1,1,182968,182968,182969,0,1,0
52350,5,3,182973,182973,182976,0,3,4
52351,4,3,182977,182977,182980,0,3,1
52352,1,2,182978,182980,182982,2,4,0
52353,3,1,182981,182982,182983,1,2,0
52354,5,2,182986,182986,182988,0,2,3
52355,2,3,182988,182988,182991,0,3,0
52356,2,2,182990,182991,182993,1,3,0
52357,1,2,182991,182993,182995,2,4,0
52358,5,2,182996,182996,182998,0,2,1
52359,5,2,183001,183001,183003,0,2,3
52360,3,1,183004,183004,183005,0,1,1
52361,6,3,183010,183010,183013,0,3,5
52362,4,2,183014,183014,183016,0,2,1
52363,6,3,183020,183020,183023,0,3,4
52364,1,3,183021,183023,183026,2,5,0
52365,3,3,183024,183026,183029,2,5,0
52366,5,3,183029,183029,183032,0,3,0
52367,2,1,183031,183032,183033,1,2,0
52368,5,2,183036,183036,183038,0,2,3
52369,4,3,183040,183040,183043,0,3,2
52370,1,2,183041,183043,183045,2,4,0
52371,3,3,183044,183045,183048,1,4,0
52372,5,3,183049,183049,183052,0,3,1
52373,2,3,183051,183052,183055,1,4,0
52374,6,2,183057,183057,183059,0,2,2
52375,2,2,183059,183059,183061,0,2,0
52376,2,3,183061,183061,183064,0,3,0
52377,6,3,183067,183067,183070,0,3,3
52378,3,2,183070,183070,183072,0,2,0
52379,5,3,183075,183075,183078,0,3,3
52380,3,1,183078,183078,183079,0,1,0
52381,4,3,183082,183082,183085,0,3,3
52382,4,2,183086,183086,183088,0,2,1
52383,4,2,183090,183090,183092,0,2,2
52384,3,2,183093,183093,183095,0,2,1
52385,2,1,183095,183095,183096,0,1,0
52386,4,2,183099,183099,183101,0,2,3
52387,3,1,183102,183102,183103,0,1,1
52388,3,3,183105,183105,183108,0,3,2
52389,2,3,183107,183108,183111,1,4,0
52390,2,1,183109,183111,183112,2,3,0
52391,4,2,183113,183113,183115,0,2,1
52392,4,3,183117,183117,183120,0,3,2
52393,4,3,183121,183121,183124,0,3,1
52394,3,3,183124,183124,183127,0,3,0
52395,5,3,183129,183129,183132,0,3,2
52396,5,2,183134,183134,183136,0,2,2
52397,4,2,183138,183138,183140,0,2,2
52398,5,1,183143,183143,183144,0,1,3
52399,4,2,183147,183147,183149,0,2,3
52400,5,2,183152,183152,183154,0,2,3
52401,2,3,183154,183154,183157,0,3,0
52402,4,3,183158,183158,183161,0,3,1
52403,4,2,183162,183162,183164,0,2,1
52404,2,1,183164,183164,183165,0,1,0
52405,1,1,183165,183165,183166,0,1,0
52406,3,3,183168,183168,183171,0,3,2
52407,1,2,183169,183171,183173,2,4,0
52408,4,2,183173,183173,183175,0,2,0
52409,3,2,183176,183176,183178,0,2,1
52410,2,2,183178,183178,183180,0,2,0
52411,6,1,183184,183184,183185,0,1,4
52412,3,1,183187,183187,183188,0,1,2
52413,6,3,183193,183193,183196,0,3,5
52414,6,1,183199,183199,183200,0,1,3
52415,2,3,183201,183201,183204,0,3,1
52416,5,2,183206,183206,183208,0,2,2
52417,6,3,183212,183212,183215,0,3,4
52418,3,1,183215,183215,183216,0,1,0
52419,4,2,183219,183219,183221,0,2,3
52420,6,1,183225,183225,183226,0,1,4
52421,5,2,183230,183230,183232,0,2,4
52422,6,2,183236,183236,183238,0,2,4
52423,4,1,183240,183240,183241,0,1,2
52424,4,2,183244,183244,183246,0,2,3
52425,1,2,183245,183246,183248,1,3,0
52426,4,2,183249,183249,183251,0,2,1
52427,3,1,183252,183252,183253,0,1,1
52428,5,3,183257,183257,183260,0,3,4
52429,5,1,183262,183262,183263,0,1,2
52430,6,1,183268,183268,183269,0,1,5
52431,3,1,183271,183271,183272,0,1,2
52432,1,1,183272,183272,183273,0,1,0
52433,3,1,183275,183275,183276,0,1,2
52434,2,2,183277,183277,183279,0,2,1
52435,4,1,183281,183281,183282,0,1,2
52436,1,3,183282,183282,183285,0,3,0
52437,1,3,183283,183285,183288,2,5,0
52438,3,2,183286,183288,183290,2,4,0
52439,2,2,183288,183290,183292,2,4,0
52440,1,3,183289,183292,183295,3,6,0
52441,6,1,183295,183295,183296,0,1,0
52442,1,2,183296,183296,183298,0,2,0
52443,1,3,183297,183298,183301,1,4,0
52444,4,2,183301,183301,183303,0,2,0
52445,5,1,183306,183306,183307,0,1,3
52446,2,1,183308,183308,183309,0,1,1
52447,1,1,183309,183309,183310,0,1,0
52448,6,1,183315,183315,183316,0,1,5
52449,1,2,183316,183316,183318,0,2,0
52450,1,1,183317,183318,183319,1,2,0
52451,4,1,183321,183321,183322,0,1,2
52452,1,3,183322,183322,183325,0,3,0
52453,2,3,183324,183325,183328,1,4,0
52454,4,3,183328,183328,183331,0,3,0
52455,3,1,183331,183331,183332,0,1,0
52456,1,2,183332,183332,183334,0,2,0
52457,5,2,183337,183337,183339,0,2,3
52458,3,2,183340,183340,183342,0,2,1
52459,3,2,183343,183343,183345,0,2,1
52460,1,3,183344,183345,183348,1,4,0
52461,6,1,183350,183350,183351,0,1,2
52462,6,3,183356,183356,183359,0,3,5
52463,6,3,183362,183362,183365,0,3,3
52464,6,3,183368,183368,183371,0,3,3
52465,1,2,183369,183371,183373,2,4,0
52466,3,3,183372,183373,183376,1,4,0
52467,4,3,183376,183376,183379,0,3,0
52468,5,2,183381,183381,183383,0,2,2
52469,6,3,183387,183387,183390,0,3,4
52470,2,2,183389,183390,183392,1,3,0
52471,3,1,183392,183392,183393,0,1,0
52472,6,2,183398,183398,183400,0,2,5
52473,6,1,183404,183404,183405,0,1,4
52474,6,3,183410,183410,183413,0,3,5
52475,2,2,183412,183413,183415,1,3,0
52476,3,2,183415,183415,183417,0,2,0
52477,1,2,183416,183417,183419,1,3,0
52478,5,1,183421,183421,183422,0,1,2
52479,3,2,183424,183424,183426,0,2,2
52480,5,2,183429,183429,183431,0,2,3
52481,3,2,183432,183432,183434,0,2,1
52482,2,3,183434,183434,183437,0,3,0
52483,2,3,183436,183437,183440,1,4,0
52484,6,3,183442,183442,183445,0,3,2
52485,5,2,183447,183447,183449,0,2,2
52486,6,3,183453,183453,183456,0,3,4
52487,5,1,183458,183458,183459,0,1,2
52488,6,1,183464,183464,183465,0,1,5
52489,1,1,183465,183465,183466,0,1,0
52490,6,1,183471,183471,183472,0,1,5
52491,3,3,183474,183474,183477,0,3,2
52492,2,3,183476,183477,183480,1,4,0
52493,6,2,183482,183482,183484,0,2,2
52494,2,3,183484,183484,183487,0,3,0
52495,5,2,183489,183489,183491,0,2,2
52496,6,3,183495,183495,183498,0,3,4
52497,5,1,183500,183500,183501,0,1,2
52498,3,3,183503,183503,183506,0,3,2
52499,2,3,183505,183506,183509,1,4,0
52500,6,1,183511,183511,183512,0,1,2
52501,3,1,183514,183514,183515,0,1,2
52502,5,1,183519,183519,183520,0,1,4
52503,4,1,183523,183523,183524,0,1,3
52504,3,2,183526,183526,183528,0,2,2
52505,3,1,183529,183529,183530,0,1,1
52506,5,2,183534,183534,183536,0,2,4
52507,6,3,183540,183540,183543,0,3,4
52508,5,3,183545,183545,183548,0,3,2
52509,1,2,183546,183548,183550,2,4,0
52510,2,1,183548,183550,183551,2,3,0
52511,4,3,183552,183552,183555,0,3,1
52512,3,2,183555,183555,183557,0,2,0
52513,1,1,183556,183557,183558,1,2,0
52514,3,2,183559,183559,183561,0,2,1
52515,6,3,183565,183565,183568,0,3,4
52516,5,1,183570,183570,183571,0,1,2
52517,1,2,183571,183571,183573,0,2,0
52518,5,2,183576,183576,183578,0,2,3
52519,2,1,183578,183578,183579,0,1,0
52520,6,2,183584,183584,183586,0,2,5
52521,3,2,183587,183587,183589,0,2,1
52522,3,1,183590,183590,183591,0,1,1
52523,2,1,183592,183592,183593,0,1,1
52524,4,1,183596,183596,183597,0,1,3
52525,3,1,183599,183599,183600,0,1,2
52526,6,2,183605,183605,183607,0,2,5
52527,4,1,183609,183609,183610,0,1,2
52528,2,3,183611,183611,183614,0,3,1
52529,1,2,183612,183614,183616,2,4,0
52530,4,3,183616,183616,183619,0,3,0
52531,1,2,183617,183619,183621,2,4,0
52532,3,3,183620,183621,183624,1,4,0
52533,2,1,183622,183624,183625,2,3,0
52534,6,3,183628,183628,183631,0,3,3
52535,1,3,183629,183631,183634,2,5,0
52536,4,3,183633,183634,183637,1,4,0
52537,1,2,183634,183637,183639,3,5,0
52538,4,2,183638,183639,183641,1,3,0
52539,1,2,183639,183641,183643,2,4,0
52540,5,1,183644,183644,183645,0,1,1
52541,5,3,183649,183649,183652,0,3,4
52542,6,3,183655,183655,183658,0,3,3
52543,2,2,183657,183658,183660,1,3,0
52544,2,2,183659,183660,183662,1,3,0
52545,2,1,183661,183662,183663,1,2,0
52546,3,3,183664,183664,183667,0,3,1
52547,2,2,183666,183667,183669,1,3,0
52548,5,3,183671,183671,183674,0,3,2
52549,3,1,183674,183674,183675,0,1,0
52550,3,1,183677,183677,183678,0,1,2
52551,5,1,183682,183682,183683,0,1,4
52552,2,3,183684,183684,183687,0,3,1
52553,3,3,183687,183687,183690,0,3,0
52554,6,1,183693,183693,183694,0,1,3
52555,3,3,183696,183696,183699,0,3,2
52556,1,3,183697,183699,183702,2,5,0
52557,3,3,183700,183702,183705,2,5,0
52558,2,1,183702,183705,183706,3,4,0
52559,5,2,183707,183707,183709,0,2,1
52560,1,3,183708,183709,183712,1,4,0
52561,1,1,183709,183712,183713,3,4,0
52562,2,1,183711,183713,183714,2,3,0
52563,2,2,183713,183714,183716,1,3,0
52564,5,3,183718,183718,183721,0,3,2
52565,5,1,183723,183723,183724,0,1,2
52566,3,1,183726,183726,183727,0,1,2
52567,1,1,183727,183727,183728,0,1,0
52568,3,3,183730,183730,183733,0,3,2
52569,5,2,183735,183735,183737,0,2,2
52570,3,1,183738,183738,183739,0,1,1
52571,4,1,183742,183742,183743,0,1,3
52572,4,2,183746,183746,183748,0,2,3
52573,6,1,183752,183752,183753,0,1,4
52574,2,3,183754,183754,183757,0,3,1
52575,6,2,183760,183760,183762,0,2,3
52576,3,2,183763,183763,183765,0,2,1
52577,6,1,183769,183769,183770,0,1,4
52578,3,1,183772,183772,183773,0,1,2
52579,3,1,183775,183775,183776,0,1,2
52580,4,3,183779,183779,183782,0,3,3
52581,2,1,183781,183782,183783,1,2,0
52582,6,1,183787,183787,183788,0,1,4
52583,1,3,183788,183788,183791,0,3,0
52584,6,1,183794,183794,183795,0,1,3
52585,4,2,183798,183798,183800,0,2,3
52586,2,1,183800,183800,183801,0,1,0
52587,5,2,183805,183805,183807,0,2,4
52588,3,3,183808,183808,183811,0,3,1
52589,6,2,183814,183814,183816,0,2,3
52590,1,3,183815,183816,183819,1,4,0
52591,5,1,183820,183820,183821,0,1,1
52592,4,1,183824,183824,183825,0,1,3
52593,6,3,183830,183830,183833,0,3,5
52594,1,3,183831,183833,183836,2,5,0
52595,3,1,183834,183836,183837,2,3,0
52596,6,2,183840,183840,183842,0,2,3
52597,4,2,183844,183844,183846,0,2,2
52598,2,1,183846,183846,183847,0,1,0
52599,2,1,183848,183848,183849,0,1,1
52600,4,3,183852,183852,183855,0,3,3
52601,2,2,183854,183855,183857,1,3,0
52602,1,2,183855,183857,183859,2,4,0
52603,4,2,183859,183859,183861,0,2,0
52604,2,3,183861,183861,183864,0,3,0
52605,1,1,183862,183864,183865,2,3,0
52606,1,1,183863,183865,183866,2,3,0
52607,2,3,183865,183866,183869,1,4,0
52608,1,3,183866,183869,183872,3,6,0
52609,6,2,183872,183872,183874,0,2,0
52610,3,1,183875,183875,183876,0,1,1
52611,2,1,183877,183877,183878,0,1,1
52612,5,2,183882,183882,183884,0,2,4
52613,2,3,183884,183884,183887,0,3,0
52614,4,1,183888,183888,183889,0,1,1
52615,5,1,183893,183893,183894,0,1,4
52616,2,1,183895,183895,183896,0,1,1
52617,4,3,183899,183899,183902,0,3,3
52618,1,1,183900,183902,183903,2,3,0
52619,1,1,183901,183903,183904,2,3,0
52620,2,1,183903,183904,183905,1,2,0
52621,6,1,183909,183909,183910,0,1,4
52622,3,2,183912,183912,183914,0,2,2
52623,2,3,183914,183914,183917,0,3,0
52624,3,1,183917,183917,183918,0,1,0
52625,3,2,183920,183920,183922,0,2,2
52626,3,2,183923,183923,183925,0,2,1
52627,1,2,183924,183925,183927,1,3,0
52628,4,3,183928,183928,183931,0,3,1
52629,4,1,183932,183932,183933,0,1,1
52630,4,1,183936,183936,183937,0,1,3
52631,6,3,183942,183942,183945,0,3,5
52632,2,2,183944,183945,183947,1,3,0
52633,1,1,183945,183947,183948,2,3,0
52634,4,1,183949,183949,183950,0,1,1
52635,4,3,183953,183953,183956,0,3,3
52636,2,1,183955,183956,183957,1,2,0
52637,4,1,183959,183959,183960,0,1,2
52638,6,2,183965,183965,183967,0,2,5
52639,1,3,183966,183967,183970,1,4,0
52640,2,2,183968,183970,183972,2,4,0
52641,6,1,183974,183974,183975,0,1,2
52642,2,2,183976,183976,183978,0,2,1
52643,1,2,183977,183978,183980,1,3,0
52644,6,3,183983,183983,183986,0,3,3
52645,3,1,183986,183986,183987,0,1,0
52646,5,2,183991,183991,183993,0,2,4
52647,3,3,183994,183994,183997,0,3,1
52648,6,2,184000,184000,184002,0,2,3
52649,2,3,184002,184002,184005,0,3,0
52650,4,3,184006,184006,184009,0,3,1
52651,5,3,184011,184011,184014,0,3,2
52652,4,3,184015,184015,184018,0,3,1
52653,1,2,184016,184018,184020,2,4,0
52654,1,3,184017,184020,184023,3,6,0
52655,6,3,184023,184023,184026,0,3,0
52656,4,2,184027,184027,184029,0,2,1
52657,4,3,184031,184031,184034,0,3,2
52658,2,3,184033,184034,184037,1,4,0
52659,1,3,184034,184037,184040,3,6,0
52660,5,2,184039,184040,184042,1,3,0
52661,2,1,184041,184042,184043,1,2,0
52662,5,2,184046,184046,184048,0,2,3
52663,4,1,184050,184050,184051,0,1,2
52664,1,3,184051,184051,184054,0,3,0
52665,3,2,184054,184054,184056,0,2,0
52666,4,2,184058,184058,184060,0,2,2
52667,1,2,184059,184060,184062,1,3,0
52668,2,3,184061,184062,184065,1,4,0
52669,4,1,184065,184065,184066,0,1,0
52670,3,1,184068,184068,184069,0,1,2
52671,4,2,184072,184072,184074,0,2,3
52672,4,3,184076,184076,184079,0,3,2
52673,2,1,184078,184079,184080,1,2,0
52674,4,1,184082,184082,184083,0,1,2
52675,3,1,184085,184085,184086,0,1,2
52676,2,3,184087,184087,184090,0,3,1
52677,1,1,184088,184090,184091,2,3,0
52678,5,1,184093,184093,184094,0,1,2
52679,6,3,184099,184099,184102,0,3,5
52680,5,1,184104,184104,184105,0,1,2
52681,6,3,184110,184110,184113,0,3,5
52682,4,3,184114,184114,184117,0,3,1
52683,5,1,184119,184119,184120,0,1,2
52684,2,3,184121,184121,184124,0,3,1
52685,3,2,184124,184124,184126,0,2,0
52686,5,3,184129,184129,184132,0,3,3
52687,3,1,184132,184132,184133,0,1,0
52688,5,2,184137,184137,184139,0,2,4
52689,6,2,184143,184143,184145,0,2,4
52690,2,1,184145,184145,184146,0,1,0
52691,1,2,184146,184146,184148,0,2,0
52692,6,1,184152,184152,184153,0,1,4
52693,1,3,184153,184153,184156,0,3,0
52694,6,2,184159,184159,184161,0,2,3
52695,6,2,184165,184165,184167,0,2,4
52696,6,2,184171,184171,184173,0,2,4
52697,6,1,184177,184177,184178,0,1,4
52698,4,2,184181,184181,184183,0,2,3
52699,3,2,184184,184184,184186,0,2,1
52700,2,1,184186,184186,184187,0,1,0
52701,3,2,184189,184189,184191,0,2,2
52702,5,3,184194,184194,184197,0,3,3
52703,6,3,184200,184200,184203,0,3,3
52704,3,1,184203,184203,184204,0,1,0
52705,3,1,184206,184206,184207,0,1,2
52706,4,2,184210,184210,184212,0,2,3
52707,5,2,184215,184215,184217,0,2,3
52708,1,2,184216,184217,184219,1,3,0
52709,4,3,184220,184220,184223,0,3,1
52710,4,2,184224,184224,184226,0,2,1
52711,5,3,184229,184229,184232,0,3,3
52712,2,3,184231,184232,184235,1,4,0
52713,2,3,184233,184235,184238,2,5,0
52714,6,3,184239,184239,184242,0,3,1
52715,6,3,184245,184245,184248,0,3,3
52716,5,2,184250,184250,184252,0,2,2
52717,3,1,184253,184253,184254,0,1,1
52718,2,3,184255,184255,184258,0,3,1
52719,1,1,184256,184258,184259,2,3,0
52720,6,1,184262,184262,184263,0,1,3
52721,3,2,184265,184265,184267,0,2,2
52722,5,1,184270,184270,184271,0,1,3
52723,2,2,184272,184272,184274,0,2,1
52724,5,2,184277,184277,184279,0,2,3
52725,6,1,184283,184283,184284,0,1,4
52726,2,1,184285,184285,184286,0,1,1
52727,5,1,184290,184290,184291,0,1,4
52728,5,3,184295,184295,184298,0,3,4
52729,1,3,184296,184298,184301,2,5,0
52730,6,1,184302,184302,184303,0,1,1
52731,6,2,184308,184308,184310,0,2,5
52732,1,3,184309,184310,184313,1,4,0
52733,2,3,184311,184313,184316,2,5,0
52734,1,2,184312,184316,184318,4,6,0
52735,3,1,184315,184318,184319,3,4,0
52736,1,1,184316,184319,184320,3,4,0
52737,1,1,184317,184320,184321,3,4,0
52738,5,2,184322,184322,184324,0,2,1
52739,6,1,184328,184328,184329,0,1,4
52740,6,1,184334,184334,184335,0,1,5
52741,1,3,184335,184335,184338,0,3,0
52742,6,2,184341,184341,184343,0,2,3
52743,6,2,184347,184347,184349,0,2,4
52744,2,3,184349,184349,184352,0,3,0
52745,6,2,184355,184355,184357,0,2,3
52746,1,2,184356,184357,184359,1,3,0
52747,1,3,184357,184359,184362,2,5,0
52748,2,1,184359,184362,184363,3,4,0
52749,2,3,184361,184363,184366,2,5,0
52750,4,3,184365,184366,184369,1,4,0
52751,5,3,184370,184370,184373,0,3,1
52752,5,2,184375,184375,184377,0,2,2
52753,2,3,184377,184377,184380,0,3,0
52754,5,3,184382,184382,184385,0,3,2
52755,6,2,184388,184388,184390,0,2,3
52756,6,3,184394,184394,184397,0,3,4
52757,4,3,184398,184398,184401,0,3,1
52758,6,2,184404,184404,184406,0,2,3
52759,4,3,184408,184408,184411,0,3,2
52760,6,2,184414,184414,184416,0,2,3
52761,4,1,184418,184418,184419,0,1,2
52762,1,1,184419,184419,184420,0,1,0
52763,3,1,184422,184422,184423,0,1,2
52764,4,3,184426,184426,184429,0,3,3
52765,5,1,184431,184431,184432,0,1,2
52766,1,3,184432,184432,184435,0,3,0
52767,4,2,184436,184436,184438,0,2,1
52768,4,2,184440,184440,184442,0,2,2
52769,4,2,184444,184444,184446,0,2,2
52770,6,1,184450,184450,184451,0,1,4
52771,6,3,184456,184456,184459,0,3,5
52772,2,1,184458,184459,184460,1,2,0
52773,1,3,184459,184460,184463,1,4,0
52774,3,2,184462,184463,184465,1,3,0
52775,1,3,184463,184465,184468,2,5,0
52776,1,2,184464,184468,184470,4,6,0
52777,1,3,184465,184470,184473,5,8,0
52778,1,2,184466,184473,184475,7,9,0
52779,4,3,184470,184475,184478,5,8,0
52780,3,2,184473,184478,184480,5,7,0
52781,3,1,184476,184480,184481,4,5,0
52782,2,1,184478,184481,184482,3,4,0
52783,5,3,184483,184483,184486,0,3,1
52784,6,3,184489,184489,184492,0,3,3
52785,6,2,184495,184495,184497,0,2,3
52786,5,3,184500,184500,184503,0,3,3
52787,2,1,184502,184503,184504,1,2,0
52788,1,3,184503,184504,184507,1,4,0
52789,4,1,184507,184507,184508,0,1,0
52790,6,2,184513,184513,184515,0,2,5
52791,3,3,184516,184516,184519,0,3,1
52792,1,1,184517,184519,184520,2,3,0
52793,1,1,184518,184520,184521,2,3,0
52794,6,2,184524,184524,184526,0,2,3
52795,1,1,184525,184526,184527,1,2,0
52796,3,3,184528,184528,184531,0,3,1
52797,5,1,184533,184533,184534,0,1,2
52798,3,1,184536,184536,184537,0,1,2
52799,1,3,184537,184537,184540,0,3,0
52800,2,2,184539,184540,184542,1,3,0
52801,5,2,184544,184544,184546,0,2,2
52802,2,2,184546,184546,184548,0,2,0
52803,4,3,184550,184550,184553,0,3,2
52804,1,3,184551,184553,184556,2,5,0
52805,1,2,184552,184556,184558,4,6,0
52806,4,1,184556,184558,184559,2,3,0
52807,5,2,184561,184561,184563,0,2,2
52808,6,1,184567,184567,184568,0,1,4
52809,1,2,184568,184568,184570,0,2,0
52810,3,2,184571,184571,184573,0,2,1
52811,2,1,184573,184573,184574,0,1,0
52812,1,3,184574,184574,184577,0,3,0
52813,2,3,184576,184577,184580,1,4,0
52814,6,1,184582,184582,184583,0,1,2
52815,6,2,184588,184588,184590,0,2,5
52816,5,2,184593,184593,184595,0,2,3
52817,5,3,184598,184598,184601,0,3,3
52818,1,3,184599,184601,184604,2,5,0
52819,3,1,184602,184604,184605,2,3,0
52820,2,2,184604,184605,184607,1,3,0
52821,2,1,184606,184607,184608,1,2,0
52822,3,2,184609,184609,184611,0,2,1
52823,1,3,184610,184611,184614,1,4,0
52824,2,1,184612,184614,184615,2,3,0
52825,3,2,184615,184615,184617,0,2,0
52826,4,2,184619,184619,184621,0,2,2
52827,4,2,184623,184623,184625,0,2,2
52828,4,2,184627,184627,184629,0,2,2
52829,3,3,184630,184630,184633,0,3,1
52830,1,2,184631,184633,184635,2,4,0
52831,4,2,184635,184635,184637,0,2,0
52832,4,3,184639,184639,184642,0,3,2
52833,1,3,184640,184642,184645,2,5,0
52834,2,3,184642,184645,184648,3,6,0
52835,4,3,184646,184648,184651,2,5,0
52836,6,3,184652,184652,184655,0,3,1
52837,3,2,184655,184655,184657,0,2,0
52838,6,3,184661,184661,184664,0,3,4
52839,6,3,184667,184667,184670,0,3,3
52840,4,3,184671,184671,184674,0,3,1
52841,5,1,184676,184676,184677,0,1,2
52842,2,3,184678,184678,184681,0,3,1
52843,4,3,184682,184682,184685,0,3,1
52844,6,2,184688,184688,184690,0,2,3
52845,2,1,184690,184690,184691,0,1,0
52846,6,2,184696,184696,184698,0,2,5
52847,4,1,184700,184700,184701,0,1,2
52848,2,3,184702,184702,184705,0,3,1
52849,2,1,184704,184705,184706,1,2,0
52850,5,3,184709,184709,184712,0,3,3
52851,4,3,184713,184713,184716,0,3,1
52852,1,3,184714,184716,184719,2,5,0
52853,3,3,184717,184719,184722,2,5,0
52854,5,3,184722,184722,184725,0,3,0
52855,5,3,184727,184727,184730,0,3,2
52856,3,1,184730,184730,184731,0,1,0
52857,3,3,184733,184733,184736,0,3,2
52858,5,2,184738,184738,184740,0,2,2
52859,5,2,184743,184743,184745,0,2,3
52860,3,3,184746,184746,184749,0,3,1
52861,2,2,184748,184749,184751,1,3,0
52862,6,2,184754,184754,184756,0,2,3
52863,4,3,184758,184758,184761,0,3,2
52864,3,3,184761,184761,184764,0,3,0
52865,4,1,184765,184765,184766,0,1,1
52866,5,3,184770,184770,184773,0,3,4
52867,1,2,184771,184773,184775,2,4,0
52868,2,1,184773,184775,184776,2,3,0
52869,6,3,184779,184779,184782,0,3,3
52870,4,3,184783,184783,184786,0,3,1
52871,2,1,184785,184786,184787,1,2,0
52872,1,1,184786,184787,184788,1,2,0
52873,3,3,184789,184789,184792,0,3,1
52874,2,1,184791,184792,184793,1,2,0
52875,4,3,184795,184795,184798,0,3,2
52876,6,1,184801,184801,184802,0,1,3
52877,4,3,184805,184805,184808,0,3,3
52878,5,3,184810,184810,184813,0,3,2
52879,2,3,184812,184813,184816,1,4,0
52880,5,1,184817,184817,184818,0,1,1
52881,2,1,184819,184819,184820,0,1,1
52882,1,3,184820,184820,184823,0,3,0
52883,5,3,184825,184825,184828,0,3,2
52884,4,1,184829,184829,184830,0,1,1
52885,1,1,184830,184830,184831,0,1,0
52886,1,3,184831,184831,184834,0,3,0
52887,4,2,184835,184835,184837,0,2,1
52888,4,2,184839,184839,184841,0,2,2
52889,4,2,184843,184843,184845,0,2,2
52890,5,1,184848,184848,184849,0,1,3
52891,2,2,184850,184850,184852,0,2,1
52892,2,3,184852,184852,184855,0,3,0
52893,2,2,184854,184855,184857,1,3,0
52894,2,3,184856,184857,184860,1,4,0
52895,6,3,184862,184862,184865,0,3,2
52896,3,3,184865,184865,184868,0,3,0
52897,1,3,184866,184868,184871,2,5,0
52898,1,2,184867,184871,184873,4,6,0
52899,1,2,184868,184873,184875,5,7,0
52900,5,3,184873,184875,184878,2,5,0
52901,2,2,184875,184878,184880,3,5,0
52902,2,2,184877,184880,184882,3,5,0
52903,2,3,184879,184882,184885,3,6,0
52904,4,1,184883,184885,184886,2,3,0
52905,6,3,184889,184889,184892,0,3,3
52906,2,3,184891,184892,184895,1,4,0
52907,3,3,184894,184895,184898,1,4,0
52908,4,2,184898,184898,184900,0,2,0
52909,5,1,184903,184903,184904,0,1,3
52910,6,2,184909,184909,184911,0,2,5
52911,1,1,184910,184911,184912,1,2,0
52912,6,3,184916,184916,184919,0,3,4
52913,5,3,184921,184921,184924,0,3,2
52914,3,3,184924,184924,184927,0,3,0
52915,4,1,184928,184928,184929,0,1,1
52916,6,2,184934,184934,184936,0,2,5
52917,6,1,184940,184940,184941,0,1,4
52918,4,1,184944,184944,184945,0,1,3
52919,4,3,184948,184948,184951,0,3,3
52920,6,1,184954,184954,184955,0,1,3
52921,2,3,184956,184956,184959,0,3,1
52922,5,1,184961,184961,184962,0,1,2
52923,6,3,184967,184967,184970,0,3,5
52924,1,3,184968,184970,184973,2,5,0
52925,1,3,184969,184973,184976,4,7,0
52926,5,2,184974,184976,184978,2,4,0
52927,6,1,184980,184980,184981,0,1,2
52928,1,3,184981,184981,184984,0,3,0
52929,1,1,184982,184984,184985,2,3,0
52930,2,3,184984,184985,184988,1,4,0
52931,3,1,184987,184988,184989,1,2,0
52932,2,3,184989,184989,184992,0,3,0
52933,1,2,184990,184992,184994,2,4,0
52934,5,2,184995,184995,184997,0,2,1
52935,2,3,184997,184997,185000,0,3,0
52936,3,2,185000,185000,185002,0,2,0
52937,1,1,185001,185002,185003,1,2,0
52938,6,3,185007,185007,185010,0,3,4
52939,6,3,185013,185013,185016,0,3,3
52940,1,3,185014,185016,185019,2,5,0
52941,1,1,185015,185019,185020,4,5,0
52942,1,1,185016,185020,185021,4,5,0
52943,3,3,185019,185021,185024,2,5,0
52944,3,3,185022,185024,185027,2,5,0
52945,1,2,185023,185027,185029,4,6,0
52946,2,3,185025,185029,185032,4,7,0
52947,6,2,185031,185032,185034,1,3,0
52948,2,1,185033,185034,185035,1,2,0
52949,5,1,185038,185038,185039,0,1,3
52950,6,1,185044,185044,185045,0,1,5
52951,1,1,185045,185045,185046,0,1,0
52952,4,2,185049,185049,185051,0,2,3
52953,1,1,185050,185051,185052,1,2,0
52954,4,3,185054,185054,185057,0,3,2
52955,2,2,185056,185057,185059,1,3,0
52956,2,2,185058,185059,185061,1,3,0
52957,6,2,185064,185064,185066,0,2,3
52958,6,2,185070,185070,185072,0,2,4
52959,1,3,185071,185072,185075,1,4,0
52960,2,3,185073,185075,185078,2,5,0
52961,2,3,185075,185078,185081,3,6,0
52962,5,3,185080,185081,185084,1,4,0
52963,5,3,185085,185085,185088,0,3,1
52964,3,1,185088,185088,185089,0,1,0
52965,4,2,185092,185092,185094,0,2,3
52966,3,3,185095,185095,185098,0,3,1
52967,2,2,185097,185098,185100,1,3,0
52968,5,2,185102,185102,185104,0,2,2
52969,6,2,185108,185108,185110,0,2,4
52970,1,2,185109,185110,185112,1,3,0
52971,6,1,185115,185115,185116,0,1,3
52972,2,3,185117,185117,185120,0,3,1
52973,6,1,185123,185123,185124,0,1,3
52974,2,2,185125,185125,185127,0,2,1
52975,6,2,185131,185131,185133,0,2,4
52976,3,3,185134,185134,185137,0,3,1
52977,5,2,185139,185139,185141,0,2,2
52978,5,2,185144,185144,185146,0,2,3
52979,1,1,185145,185146,185147,1,2,0
52980,3,3,185148,185148,185151,0,3,1
52981,5,3,185153,185153,185156,0,3,2
52982,1,3,185154,185156,185159,2,5,0
52983,2,2,185156,185159,185161,3,5,0
52984,5,1,185161,185161,185162,0,1,0
52985,3,3,185164,185164,185167,0,3,2
52986,5,1,185169,185169,185170,0,1,2
52987,4,2,185173,185173,185175,0,2,3
52988,5,2,185178,185178,185180,0,2,3
52989,3,2,185181,185181,185183,0,2,1
52990,5,2,185186,185186,185188,0,2,3
52991,5,2,185191,185191,185193,0,2,3
52992,2,3,185193,185193,185196,0,3,0
52993,4,2,185197,185197,185199,0,2,1
52994,3,3,185200,185200,185203,0,3,1
52995,6,2,185206,185206,185208,0,2,3
52996,2,1,185208,185208,185209,0,1,0
52997,1,1,185209,185209,185210,0,1,0
52998,3,1,185212,185212,185213,0,1,2
52999,5,1,185217,185217,185218,0,1,4
53000,2,1,185219,185219,185220,0,1,1
53001,4,3,185223,185223,185226,0,3,3
53002,6,2,185229,185229,185231,0,2,3
53003,2,2,185231,185231,185233,0,2,0
53004,6,3,185237,185237,185240,0,3,4
53005,1,1,185238,185240,185241,2,3,0
53006,2,3,185240,185241,185244,1,4,0
53007,2,1,185242,185244,185245,2,3,0
53008,6,2,185248,185248,185250,0,2,3
53009,5,1,185253,185253,185254,0,1,3
53010,1,1,185254,185254,185255,0,1,0
53011,3,2,185257,185257,185259,0,2,2
53012,1,2,185258,185259,185261,1,3,0
53013,4,2,185262,185262,185264,0,2,1
53014,6,2,185268,185268,185270,0,2,4
53015,1,3,185269,185270,185273,1,4,0
53016,2,2,185271,185273,185275,2,4,0
53017,6,1,185277,185277,185278,0,1,2
53018,2,3,185279,185279,185282,0,3,1
53019,4,1,185283,185283,185284,0,1,1
53020,3,2,185286,185286,185288,0,2,2
53021,4,2,185290,185290,185292,0,2,2
53022,3,3,185293,185293,185296,0,3,1
53023,2,3,185295,185296,185299,1,4,0
53024,2,1,185297,185299,185300,2,3,0
53025,4,3,185301,185301,185304,0,3,1
53026,3,2,185304,185304,185306,0,2,0
53027,4,1,185308,185308,185309,0,1,2
53028,1,2,185309,185309,185311,0,2,0
53029,4,3,185313,185313,185316,0,3,2
53030,2,3,185315,185316,185319,1,4,0
53031,4,2,185319,185319,185321,0,2,0
53032,5,3,185324,185324,185327,0,3,3
53033,2,1,185326,185327,185328,1,2,0
53034,1,3,185327,185328,185331,1,4,0
53035,2,3,185329,185331,185334,2,5,0
53036,6,3,185335,185335,185338,0,3,1
53037,3,2,185338,185338,185340,0,2,0
53038,5,2,185343,185343,185345,0,2,3
53039,4,2,185347,185347,185349,0,2,2
53040,1,1,185348,185349,185350,1,2,0
53041,1,1,185349,185350,185351,1,2,0
53042,2,2,185351,185351,185353,0,2,0
53043,4,2,185355,185355,185357,0,2,2
53044,4,2,185359,185359,185361,0,2,2
53045,5,2,185364,185364,185366,0,2,3
53046,1,1,185365,185366,185367,1,2,0
53047,2,2,185367,185367,185369,0,2,0
53048,3,2,185370,185370,185372,0,2,1
53049,6,1,185376,185376,185377,0,1,4
53050,3,1,185379,185379,185380,0,1,2
53051,1,2,185380,185380,185382,0,2,0
53052,1,1,185381,185382,185383,1,2,0
53053,1,3,185382,185383,185386,1,4,0
53054,6,3,185388,185388,185391,0,3,2
53055,1,2,185389,185391,185393,2,4,0
53056,3,2,185392,185393,185395,1,3,0
53057,5,3,185397,185397,185400,0,3,2
53058,4,3,185401,185401,185404,0,3,1
53059,6,3,185407,185407,185410,0,3,3
53060,4,1,185411,185411,185412,0,1,1
53061,4,1,185415,185415,185416,0,1,3
53062,6,1,185421,185421,185422,0,1,5
53063,1,1,185422,185422,185423,0,1,0
53064,5,1,185427,185427,185428,0,1,4
53065,1,3,185428,185428,185431,0,3,0
53066,3,1,185431,185431,185432,0,1,0
53067,6,3,185437,185437,185440,0,3,5
53068,3,2,185440,185440,185442,0,2,0
53069,1,3,185441,185442,185445,1,4,0
53070,5,1,185446,185446,185447,0,1,1
53071,6,3,185452,185452,185455,0,3,5
53072,6,2,185458,185458,185460,0,2,3
53073,3,1,185461,185461,185462,0,1,1
53074,3,2,185464,185464,185466,0,2,2
53075,2,1,185466,185466,185467,0,1,0
53076,5,2,185471,185471,185473,0,2,4
53077,3,2,185474,185474,185476,0,2,1
53078,1,3,185475,185476,185479,1,4,0
53079,4,3,185479,185479,185482,0,3,0
53080,2,3,185481,185482,185485,1,4,0
53081,5,3,185486,185486,185489,0,3,1
53082,3,1,185489,185489,185490,0,1,0
53083,4,1,185493,185493,185494,0,1,3
53084,5,1,185498,185498,185499,0,1,4
53085,1,1,185499,185499,185500,0,1,0
53086,6,2,185505,185505,185507,0,2,5
53087,5,3,185510,185510,185513,0,3,3
53088,2,3,185512,185513,185516,1,4,0
53089,6,2,185518,185518,185520,0,2,2
53090,6,3,185524,185524,185527,0,3,4
53091,1,1,185525,185527,185528,2,3,0
53092,1,3,185526,185528,185531,2,5,0
53093,2,1,185528,185531,185532,3,4,0
53094,3,3,185531,185532,185535,1,4,0
53095,3,3,185534,185535,185538,1,4,0
53096,2,3,185536,185538,185541,2,5,0
53097,3,1,185539,185541,185542,2,3,0
53098,5,1,185544,185544,185545,0,1,2
53099,1,3,185545,185545,185548,0,3,0
53100,6,2,185551,185551,185553,0,2,3
53101,6,2,185557,185557,185559,0,2,4
53102,3,2,185560,185560,185562,0,2,1
53103,3,3,185563,185563,185566,0,3,1
53104,6,3,185569,185569,185572,0,3,3
53105,2,1,185571,185572,185573,1,2,0
53106,6,1,185577,185577,185578,0,1,4
53107,4,3,185581,185581,185584,0,3,3
53108,3,3,185584,185584,185587,0,3,0
53109,1,2,185585,185587,185589,2,4,0
53110,2,1,185587,185589,185590,2,3,0
53111,2,2,185589,185590,185592,1,3,0
53112,2,1,185591,185592,185593,1,2,0
53113,2,3,185593,185593,185596,0,3,0
53114,4,1,185597,185597,185598,0,1,1
53115,4,2,185601,185601,185603,0,2,3
53116,4,3,185605,185605,185608,0,3,2
53117,5,3,185610,185610,185613,0,3,2
53118,2,3,185612,185613,185616,1,4,0
53119,1,2,185613,185616,185618,3,5,0
53120,3,1,185616,185618,185619,2,3,0
53121,4,2,185620,185620,185622,0,2,1
53122,1,3,185621,185622,185625,1,4,0
53123,3,1,185624,185625,185626,1,2,0
53124,4,2,185628,185628,185630,0,2,2
53125,2,2,185630,185630,185632,0,2,0
53126,5,3,185635,185635,185638,0,3,3
53127,4,3,185639,185639,185642,0,3,1
53128,1,3,185640,185642,185645,2,5,0
53129,1,2,185641,185645,185647,4,6,0
53130,1,1,185642,185647,185648,5,6,0
53131,1,1,185643,185648,185649,5,6,0
53132,6,2,185649,185649,185651,0,2,0
53133,1,2,185650,185651,185653,1,3,0
53134,6,2,185656,185656,185658,0,2,3
53135,3,1,185659,185659,185660,0,1,1
53136,6,2,185665,185665,185667,0,2,5
53137,2,2,185667,185667,185669,0,2,0
53138,5,3,185672,185672,185675,0,3,3
53139,5,1,185677,185677,185678,0,1,2
53140,1,2,185678,185678,185680,0,2,0
53141,1,3,185679,185680,185683,1,4,0
53142,6,1,185685,185685,185686,0,1,2
53143,1,3,185686,185686,185689,0,3,0
53144,2,1,185688,185689,185690,1,2,0
53145,6,2,185694,185694,185696,0,2,4
53146,2,2,185696,185696,185698,0,2,0
53147,2,3,185698,185698,185701,0,3,0
53148,6,3,185704,185704,185707,0,3,3
53149,2,1,185706,185707,185708,1,2,0
53150,1,2,185707,185708,185710,1,3,0
53151,5,3,185712,185712,185715,0,3,2
53152,1,2,185713,185715,185717,2,4,0
53153,5,3,185718,185718,185721,0,3,1
53154,1,2,185719,185721,185723,2,4,0
53155,1,3,185720,185723,185726,3,6,0
53156,3,3,185723,185726,185729,3,6,0
53157,1,2,185724,185729,185731,5,7,0
53158,6,1,185730,185731,185732,1,2,0
53159,1,1,185731,185732,185733,1,2,0
53160,4,3,185735,185735,185738,0,3,2
53161,3,1,185738,185738,185739,0,1,0
53162,4,3,185742,185742,185745,0,3,3
53163,1,3,185743,185745,185748,2,5,0
53164,5,2,185748,185748,185750,0,2,0
53165,4,3,185752,185752,185755,0,3,2
53166,4,3,185756,185756,185759,0,3,1
53167,1,1,185757,185759,185760,2,3,0
53168,1,3,185758,185760,185763,2,5,0
53169,5,1,185763,185763,185764,0,1,0
53170,2,1,185765,185765,185766,0,1,1
53171,6,1,185771,185771,185772,0,1,5
53172,3,1,185774,185774,185775,0,1,2
53173,4,1,185778,185778,185779,0,1,3
53174,4,1,185782,185782,185783,0,1,3
53175,4,1,185786,185786,185787,0,1,3
53176,4,1,185790,185790,185791,0,1,3
53177,6,1,185796,185796,185797,0,1,5
53178,4,3,185800,185800,185803,0,3,3
53179,5,2,185805,185805,185807,0,2,2
53180,2,1,185807,185807,185808,0,1,0
53181,5,1,185812,185812,185813,0,1,4
53182,4,1,185816,185816,185817,0,1,3
53183,2,1,185818,185818,185819,0,1,1
53184,4,1,185822,185822,185823,0,1,3
53185,3,1,185825,185825,185826,0,1,2
53186,5,3,185830,185830,185833,0,3,4
53187,1,3,185831,185833,185836,2,5,0
53188,2,3,185833,185836,185839,3,6,0
53189,3,1,185836,185839,185840,3,4,0
53190,4,1,185840,185840,185841,0,1,0
53191,2,1,185842,185842,185843,0,1,1
53192,2,3,185844,185844,185847,0,3,1
53193,2,1,185846,185847,185848,1,2,0
53194,3,2,185849,185849,185851,0,2,1
53195,4,2,185853,185853,185855,0,2,2
53196,2,1,185855,185855,185856,0,1,0
53197,6,1,185861,185861,185862,0,1,5
53198,6,1,185867,185867,185868,0,1,5
53199,1,3,185868,185868,185871,0,3,0
53200,5,3,185873,185873,185876,0,3,2
53201,2,2,185875,185876,185878,1,3,0
53202,1,3,185876,185878,185881,2,5,0
53203,4,1,185880,185881,185882,1,2,0
53204,3,3,185883,185883,185886,0,3,1
53205,2,2,185885,185886,185888,1,3,0
53206,3,3,185888,185888,185891,0,3,0
53207,6,3,185894,185894,185897,0,3,3
53208,4,3,185898,185898,185901,0,3,1
53209,4,2,185902,185902,185904,0,2,1
53210,1,3,185903,185904,185907,1,4,0
53211,3,2,185906,185907,185909,1,3,0
53212,4,2,185910,185910,185912,0,2,1
53213,2,3,185912,185912,185915,0,3,0
53214,4,1,185916,185916,185917,0,1,1
53215,5,2,185921,185921,185923,0,2,4
53216,3,2,185924,185924,185926,0,2,1
53217,2,1,185926,185926,185927,0,1,0
53218,1,3,185927,185927,185930,0,3,0
53219,6,1,185933,185933,185934,0,1,3
53220,1,1,185934,185934,185935,0,1,0
53221,5,2,185939,185939,185941,0,2,4
53222,5,3,185944,185944,185947,0,3,3
53223,4,3,185948,185948,185951,0,3,1
53224,1,3,185949,185951,185954,2,5,0
53225,1,1,185950,185954,185955,4,5,0
53226,6,3,185956,185956,185959,0,3,1
53227,4,3,185960,185960,185963,0,3,1
53228,1,3,185961,185963,185966,2,5,0
53229,2,1,185963,185966,185967,3,4,0
53230,1,1,185964,185967,185968,3,4,0
53231,4,2,185968,185968,185970,0,2,0
53232,6,3,185974,185974,185977,0,3,4
53233,1,2,185975,185977,185979,2,4,0
53234,5,3,185980,185980,185983,0,3,1
53235,6,2,185986,185986,185988,0,2,3
53236,6,2,185992,185992,185994,0,2,4
53237,3,1,185995,185995,185996,0,1,1
53238,5,3,186000,186000,186003,0,3,4
53239,5,3,186005,186005,186008,0,3,2
53240,6,1,186011,186011,186012,0,1,3
53241,4,1,186015,186015,186016,0,1,3
53242,3,1,186018,186018,186019,0,1,2
53243,4,1,186022,186022,186023,0,1,3
53244,3,1,186025,186025,186026,0,1,2
53245,4,1,186029,186029,186030,0,1,3
53246,6,1,186035,186035,186036,0,1,5
53247,3,1,186038,186038,186039,0,1,2
53248,4,2,186042,186042,186044,0,2,3
53249,1,3,186043,186044,186047,1,4,0
53250,3,3,186046,186047,186050,1,4,0
53251,4,2,186050,186050,186052,0,2,0
53252,5,3,186055,186055,186058,0,3,3
53253,5,1,186060,186060,186061,0,1,2
53254,4,2,186064,186064,186066,0,2,3
53255,6,3,186070,186070,186073,0,3,4
53256,4,1,186074,186074,186075,0,1,1
53257,6,2,186080,186080,186082,0,2,5
53258,4,3,186084,186084,186087,0,3,2
53259,4,3,186088,186088,186091,0,3,1
53260,3,3,186091,186091,186094,0,3,0
53261,6,1,186097,186097,186098,0,1,3
53262,3,1,186100,186100,186101,0,1,2
53263,2,1,186102,186102,186103,0,1,1
53264,2,1,186104,186104,186105,0,1,1
53265,2,3,186106,186106,186109,0,3,1
53266,5,1,186111,186111,186112,0,1,2
53267,1,1,186112,186112,186113,0,1,0
53268,4,1,186116,186116,186117,0,1,3
53269,3,3,186119,186119,186122,0,3,2
53270,6,1,186125,186125,186126,0,1,3
53271,1,3,186126,186126,186129,0,3,0
53272,1,3,186127,186129,186132,2,5,0
53273,3,2,186130,186132,186134,2,4,0
53274,2,3,186132,186134,186137,2,5,0
53275,1,1,186133,186137,186138,4,5,0
53276,5,3,186138,186138,186141,0,3,0
53277,6,2,186144,186144,186146,0,2,3
53278,1,2,186145,186146,186148,1,3,0
53279,5,3,186150,186150,186153,0,3,2
53280,5,1,186155,186155,186156,0,1,2
53281,2,2,186157,186157,186159,0,2,1
53282,6,1,186163,186163,186164,0,1,4
53283,4,2,186167,186167,186169,0,2,3
53284,6,3,186173,186173,186176,0,3,4
53285,4,3,186177,186177,186180,0,3,1
53286,4,1,186181,186181,186182,0,1,1
53287,4,2,186185,186185,186187,0,2,3
53288,4,2,186189,186189,186191,0,2,2
53289,5,1,186194,186194,186195,0,1,3
53290,1,3,186195,186195,186198,0,3,0
53291,5,1,186200,186200,186201,0,1,2
53292,5,2,186205,186205,186207,0,2,4
53293,5,1,186210,186210,186211,0,1,3
53294,2,1,186212,186212,186213,0,1,1
53295,2,2,186214,186214,186216,0,2,1
53296,4,2,186218,186218,186220,0,2,2
53297,5,1,186223,186223,186224,0,1,3
53298,5,3,186228,186228,186231,0,3,4
53299,3,3,186231,186231,186234,0,3,0
53300,5,3,186236,186236,186239,0,3,2
53301,6,1,186242,186242,186243,0,1,3
53302,3,1,186245,186245,186246,0,1,2
53303,5,1,186250,186250,186251,0,1,4
53304,2,2,186252,186252,186254,0,2,1
53305,4,3,186256,186256,186259,0,3,2
53306,3,1,186259,186259,186260,0,1,0
53307,4,1,186263,186263,186264,0,1,3
53308,5,2,186268,186268,186270,0,2,4
53309,6,3,186274,186274,186277,0,3,4
53310,6,2,186280,186280,186282,0,2,3
53311,6,2,186286,186286,186288,0,2,4
53312,6,2,186292,186292,186294,0,2,4
53313,6,3,186298,186298,186301,0,3,4
53314,3,2,186301,186301,186303,0,2,0
53315,4,1,186305,186305,186306,0,1,2
53316,2,2,186307,186307,186309,0,2,1
53317,1,3,186308,186309,186312,1,4,0
53318,4,1,186312,186312,186313,0,1,0
53319,4,1,186316,186316,186317,0,1,3
53320,2,3,186318,186318,186321,0,3,1
53321,2,3,186320,186321,186324,1,4,0
53322,4,2,186324,186324,186326,0,2,0
53323,2,3,186326,186326,186329,0,3,0
53324,6,1,186332,186332,186333,0,1,3
53325,2,3,186334,186334,186337,0,3,1
53326,4,1,186338,186338,186339,0,1,1
53327,3,2,186341,186341,186343,0,2,2
53328,2,2,186343,186343,186345,0,2,0
53329,5,1,186348,186348,186349,0,1,3
53330,1,3,186349,186349,186352,0,3,0
53331,1,1,186350,186352,186353,2,3,0
53332,1,2,186351,186353,186355,2,4,0
53333,2,2,186353,186355,186357,2,4,0
53334,2,1,186355,186357,186358,2,3,0
53335,3,3,186358,186358,186361,0,3,0
53336,6,3,186364,186364,186367,0,3,3
53337,1,3,186365,186367,186370,2,5,0
53338,3,1,186368,186370,186371,2,3,0
53339,4,2,186372,186372,186374,0,2,1
53340,4,3,186376,186376,186379,0,3,2
53341,4,2,186380,186380,186382,0,2,1
53342,4,1,186384,186384,186385,0,1,2
53343,4,3,186388,186388,186391,0,3,3
53344,1,2,186389,186391,186393,2,4,0
53345,6,1,186395,186395,186396,0,1,2
53346,2,1,186397,186397,186398,0,1,1
53347,2,3,186399,186399,186402,0,3,1
53348,6,2,186405,186405,186407,0,2,3
53349,5,1,186410,186410,186411,0,1,3
53350,1,3,186411,186411,186414,0,3,0
53351,3,3,186414,186414,186417,0,3,0
53352,6,2,186420,186420,186422,0,2,3
53353,5,3,186425,186425,186428,0,3,3
53354,2,3,186427,186428,186431,1,4,0
53355,3,3,186430,186431,186434,1,4,0
53356,5,1,186435,186435,186436,0,1,1
53357,6,3,186441,186441,186444,0,3,5
53358,3,3,186444,186444,186447,0,3,0
53359,6,3,186450,186450,186453,0,3,3
53360,3,1,186453,186453,186454,0,1,0
53361,5,1,186458,186458,186459,0,1,4
53362,1,3,186459,186459,186462,0,3,0
53363,5,2,186464,186464,186466,0,2,2
53364,3,3,186467,186467,186470,0,3,1
53365,4,1,186471,186471,186472,0,1,1
53366,5,2,186476,186476,186478,0,2,4
53367,5,3,186481,186481,186484,0,3,3
53368,3,3,186484,186484,186487,0,3,0
53369,5,2,186489,186489,186491,0,2,2
53370,4,2,186493,186493,186495,0,2,2
53371,3,3,186496,186496,186499,0,3,1
53372,4,3,186500,186500,186503,0,3,1
53373,1,2,186501,186503,186505,2,4,0
53374,3,1,186504,186505,186506,1,2,0
53375,5,2,186509,186509,186511,0,2,3
53376,3,1,186512,186512,186513,0,1,1
53377,1,1,186513,186513,186514,0,1,0
53378,4,2,186517,186517,186519,0,2,3
53379,5,1,186522,186522,186523,0,1,3
53380,1,3,186523,186523,186526,0,3,0
53381,5,1,186528,186528,186529,0,1,2
53382,1,1,186529,186529,186530,0,1,0
53383,3,1,186532,186532,186533,0,1,2
53384,3,1,186535,186535,186536,0,1,2
53385,3,1,186538,186538,186539,0,1,2
53386,4,3,186542,186542,186545,0,3,3
53387,3,3,186545,186545,186548,0,3,0
53388,5,1,186550,186550,186551,0,1,2
53389,2,1,186552,186552,186553,0,1,1
53390,2,1,186554,186554,186555,0,1,1
53391,1,2,186555,186555,186557,0,2,0
53392,6,1,186561,186561,186562,0,1,4
53393,3,2,186564,186564,186566,0,2,2
53394,5,3,186569,186569,186572,0,3,3
53395,6,2,186575,186575,186577,0,2,3
53396,1,1,186576,186577,186578,1,2,0
53397,5,1,186581,186581,186582,0,1,3
53398,2,2,186583,186583,186585,0,2,1
53399,1,2,186584,186585,186587,1,3,0
53400,3,1,186587,186587,186588,0,1,0
53401,6,3,186593,186593,186596,0,3,5
53402,6,3,186599,186599,186602,0,3,3
53403,3,1,186602,186602,186603,0,1,0
53404,1,3,186603,186603,186606,0,3,0
53405,2,2,186605,186606,186608,1,3,0
53406,2,3,186607,186608,186611,1,4,0
53407,2,2,186609,186611,186613,2,4,0
53408,3,2,186612,186613,186615,1,3,0
53409,5,3,186617,186617,186620,0,3,2
53410,5,1,186622,186622,186623,0,1,2
53411,5,3,186627,186627,186630,0,3,4
53412,3,1,186630,186630,186631,0,1,0
53413,5,1,186635,186635,186636,0,1,4
53414,2,2,186637,186637,186639,0,2,1
53415,5,3,186642,186642,186645,0,3,3
53416,3,2,186645,186645,186647,0,2,0
53417,3,2,186648,186648,186650,0,2,1
53418,1,1,186649,186650,186651,1,2,0
53419,1,1,186650,186651,186652,1,2,0
53420,2,2,186652,186652,186654,0,2,0
53421,4,3,186656,186656,186659,0,3,2
53422,2,3,186658,186659,186662,1,4,0
53423,2,1,186660,186662,186663,2,3,0
53424,1,2,186661,186663,186665,2,4,0
53425,3,3,186664,186665,186668,1,4,0
53426,6,1,186670,186670,186671,0,1,2
53427,4,1,186674,186674,186675,0,1,3
53428,1,2,186675,186675,186677,0,2,0
53429,1,1,186676,186677,186678,1,2,0
53430,6,3,186682,186682,186685,0,3,4
53431,6,1,186688,186688,186689,0,1,3
53432,5,3,186693,186693,186696,0,3,4
53433,2,3,186695,186696,186699,1,4,0
53434,5,3,186700,186700,186703,0,3,1
53435,5,1,186705,186705,186706,0,1,2
53436,3,3,186708,186708,186711,0,3,2
53437,4,3,186712,186712,186715,0,3,1
53438,5,2,186717,186717,186719,0,2,2
53439,6,1,186723,186723,186724,0,1,4
53440,4,3,186727,186727,186730,0,3,3
53441,5,1,186732,186732,186733,0,1,2
53442,2,2,186734,186734,186736,0,2,1
53443,2,1,186736,186736,186737,0,1,0
53444,5,3,186741,186741,186744,0,3,4
53445,1,1,186742,186744,186745,2,3,0
53446,1,3,186743,186745,186748,2,5,0
53447,1,1,186744,186748,186749,4,5,0
53448,2,2,186746,186749,186751,3,5,0
53449,5,2,186751,186751,186753,0,2,0
53450,3,3,186754,186754,186757,0,3,1
53451,5,3,186759,186759,186762,0,3,2
53452,1,1,186760,186762,186763,2,3,0
53453,3,3,186763,186763,186766,0,3,0
53454,5,2,186768,186768,186770,0,2,2
53455,5,1,186773,186773,186774,0,1,3
53456,2,2,186775,186775,186777,0,2,1
53457,4,1,186779,186779,186780,0,1,2
53458,1,3,186780,186780,186783,0,3,0
53459,3,1,186783,186783,186784,0,1,0
53460,6,1,186789,186789,186790,0,1,5
53461,6,2,186795,186795,186797,0,2,5
53462,5,2,186800,186800,186802,0,2,3
53463,3,3,186803,186803,186806,0,3,1
53464,6,2,186809,186809,186811,0,2,3
53465,3,1,186812,186812,186813,0,1,1
53466,4,1,186816,186816,186817,0,1,3
53467,6,1,186822,186822,186823,0,1,5
53468,4,2,186826,186826,186828,0,2,3
53469,1,3,186827,186828,186831,1,4,0
53470,6,3,186833,186833,186836,0,3,2
53471,3,1,186836,186836,186837,0,1,0
53472,3,3,186839,186839,186842,0,3,2
53473,2,3,186841,186842,186845,1,4,0
53474,6,1,186847,186847,186848,0,1,2
53475,1,1,186848,186848,186849,0,1,0
53476,6,1,186854,186854,186855,0,1,5
53477,3,3,186857,186857,186860,0,3,2
53478,1,3,186858,186860,186863,2,5,0
53479,2,2,186860,186863,186865,3,5,0
53480,1,3,186861,186865,186868,4,7,0
53481,2,2,186863,186868,186870,5,7,0
53482,6,3,186869,186870,186873,1,4,0
53483,3,1,186872,186873,186874,1,2,0
53484,5,3,186877,186877,186880,0,3,3
53485,5,1,186882,186882,186883,0,1,2
53486,4,1,186886,186886,186887,0,1,3
53487,6,2,186892,186892,186894,0,2,5
53488,6,2,186898,186898,186900,0,2,4
53489,3,2,186901,186901,186903,0,2,1
53490,5,3,186906,186906,186909,0,3,3
53491,2,3,186908,186909,186912,1,4,0
53492,2,2,186910,186912,186914,2,4,0
53493,4,3,186914,186914,186917,0,3,0
53494,5,3,186919,186919,186922,0,3,2
53495,4,2,186923,186923,186925,0,2,1
53496,6,1,186929,186929,186930,0,1,4
53497,2,2,186931,186931,186933,0,2,1
53498,6,3,186937,186937,186940,0,3,4
53499,5,2,186942,186942,186944,0,2,2
53500,4,2,186946,186946,186948,0,2,2
53501,1,1,186947,186948,186949,1,2,0
53502,1,1,186948,186949,186950,1,2,0
53503,6,3,186954,186954,186957,0,3,4
53504,6,3,186960,186960,186963,0,3,3
53505,6,3,186966,186966,186969,0,3,3
53506,3,3,186969,186969,186972,0,3,0
53507,2,3,186971,186972,186975,1,4,0
53508,1,2,186972,186975,186977,3,5,0
53509,3,2,186975,186977,186979,2,4,0
53510,6,1,186981,186981,186982,0,1,2
53511,3,2,186984,186984,186986,0,2,2
53512,1,2,186985,186986,186988,1,3,0
53513,6,1,186991,186991,186992,0,1,3
53514,2,3,186993,186993,186996,0,3,1
53515,4,2,186997,186997,186999,0,2,1
53516,2,2,186999,186999,187001,0,2,0
53517,6,3,187005,187005,187008,0,3,4
53518,2,2,187007,187008,187010,1,3,0
53519,6,2,187013,187013,187015,0,2,3
53520,2,1,187015,187015,187016,0,1,0
53521,5,1,187020,187020,187021,0,1,4
53522,1,1,187021,187021,187022,0,1,0
53523,1,2,187022,187022,187024,0,2,0
53524,4,2,187026,187026,187028,0,2,2
53525,3,1,187029,187029,187030,0,1,1
53526,3,1,187032,187032,187033,0,1,2
53527,5,2,187037,187037,187039,0,2,4
53528,4,2,187041,187041,187043,0,2,2
53529,5,3,187046,187046,187049,0,3,3
53530,5,2,187051,187051,187053,0,2,2
53531,5,3,187056,187056,187059,0,3,3
53532,6,3,187062,187062,187065,0,3,3
53533,2,2,187064,187065,187067,1,3,0
53534,5,1,187069,187069,187070,0,1,2
53535,5,2,187074,187074,187076,0,2,4
53536,3,2,187077,187077,187079,0,2,1
53537,1,3,187078,187079,187082,1,4,0
53538,2,2,187080,187082,187084,2,4,0
53539,4,1,187084,187084,187085,0,1,0
53540,6,2,187090,187090,187092,0,2,5
53541,4,1,187094,187094,187095,0,1,2
53542,2,2,187096,187096,187098,0,2,1
53543,5,1,187101,187101,187102,0,1,3
53544,5,2,187106,187106,187108,0,2,4
53545,4,1,187110,187110,187111,0,1,2
53546,4,1,187114,187114,187115,0,1,3
53547,5,3,187119,187119,187122,0,3,4
53548,3,3,187122,187122,187125,0,3,0
53549,1,2,187123,187125,187127,2,4,0
53550,6,2,187129,187129,187131,0,2,2
53551,3,1,187132,187132,187133,0,1,1
53552,3,3,187135,187135,187138,0,3,2
53553,2,1,187137,187138,187139,1,2,0
53554,3,3,187140,187140,187143,0,3,1
53555,6,2,187146,187146,187148,0,2,3
53556,5,3,187151,187151,187154,0,3,3
53557,2,1,187153,187154,187155,1,2,0
53558,2,3,187155,187155,187158,0,3,0
53559,1,1,187156,187158,187159,2,3,0
53560,2,2,187158,187159,187161,1,3,0
53561,1,3,187159,187161,187164,2,5,0
53562,4,2,187163,187164,187166,1,3,0
53563,4,1,187167,187167,187168,0,1,1
53564,3,3,187170,187170,187173,0,3,2
53565,3,1,187173,187173,187174,0,1,0
53566,4,3,187177,187177,187180,0,3,3
53567,1,1,187178,187180,187181,2,3,0
53568,1,1,187179,187181,187182,2,3,0
53569,4,1,187183,187183,187184,0,1,1
53570,3,1,187186,187186,187187,0,1,2
53571,3,1,187189,187189,187190,0,1,2
53572,6,2,187195,187195,187197,0,2,5
53573,4,1,187199,187199,187200,0,1,2
53574,3,3,187202,187202,187205,0,3,2
53575,5,2,187207,187207,187209,0,2,2
53576,3,1,187210,187210,187211,0,1,1
53577,3,3,187213,187213,187216,0,3,2
53578,6,3,187219,187219,187222,0,3,3
53579,1,2,187220,187222,187224,2,4,0
53580,5,2,187225,187225,187227,0,2,1
53581,4,3,187229,187229,187232,0,3,2
53582,4,1,187233,187233,187234,0,1,1
53583,4,2,187237,187237,187239,0,2,3
53584,1,1,187238,187239,187240,1,2,0
53585,1,2,187239,187240,187242,1,3,0
53586,6,1,187245,187245,187246,0,1,3
53587,2,2,187247,187247,187249,0,2,1
53588,2,1,187249,187249,187250,0,1,0
53589,6,1,187255,187255,187256,0,1,5
53590,5,3,187260,187260,187263,0,3,4
53591,1,1,187261,187263,187264,2,3,0
53592,3,1,187264,187264,187265,0,1,0
53593,3,1,187267,187267,187268,0,1,2
53594,1,3,187268,187268,187271,0,3,0
53595,1,1,187269,187271,187272,2,3,0
53596,6,3,187275,187275,187278,0,3,3
53597,3,3,187278,187278,187281,0,3,0
53598,1,2,187279,187281,187283,2,4,0
53599,1,2,187280,187283,187285,3,5,0
53600,1,3,187281,187285,187288,4,7,0
53601,2,2,187283,187288,187290,5,7,0
53602,6,2,187289,187290,187292,1,3,0
53603,4,1,187293,187293,187294,0,1,1
53604,5,2,187298,187298,187300,0,2,4
53605,5,1,187303,187303,187304,0,1,3
53606,4,1,187307,187307,187308,0,1,3
53607,2,3,187309,187309,187312,0,3,1
53608,1,1,187310,187312,187313,2,3,0
53609,4,3,187314,187314,187317,0,3,1
53610,5,1,187319,187319,187320,0,1,2
53611,2,1,187321,187321,187322,0,1,1
53612,4,3,187325,187325,187328,0,3,3
53613,4,2,187329,187329,187331,0,2,1
53614,5,1,187334,187334,187335,0,1,3
53615,6,2,187340,187340,187342,0,2,5
53616,5,2,187345,187345,187347,0,2,3
53617,4,2,187349,187349,187351,0,2,2
53618,2,2,187351,187351,187353,0,2,0
53619,3,1,187354,187354,187355,0,1,1
53620,5,2,187359,187359,187361,0,2,4
53621,1,2,187360,187361,187363,1,3,0
53622,4,2,187364,187364,187366,0,2,1
53623,5,1,187369,187369,187370,0,1,3
53624,2,2,187371,187371,187373,0,2,1
53625,2,3,187373,187373,187376,0,3,0
53626,2,3,187375,187376,187379,1,4,0
53627,3,1,187378,187379,187380,1,2,0
53628,2,1,187380,187380,187381,0,1,0
53629,3,2,187383,187383,187385,0,2,2
53630,1,2,187384,187385,187387,1,3,0
53631,4,3,187388,187388,187391,0,3,1
53632,6,2,187394,187394,187396,0,2,3
53633,5,2,187399,187399,187401,0,2,3
53634,3,2,187402,187402,187404,0,2,1
53635,1,1,187403,187404,187405,1,2,0
53636,4,3,187407,187407,187410,0,3,2
53637,2,3,187409,187410,187413,1,4,0
53638,4,2,187413,187413,187415,0,2,0
53639,1,2,187414,187415,187417,1,3,0
53640,2,3,187416,187417,187420,1,4,0
53641,2,2,187418,187420,187422,2,4,0
53642,6,1,187424,187424,187425,0,1,2
53643,3,2,187427,187427,187429,0,2,2
53644,3,1,187430,187430,187431,0,1,1
53645,5,2,187435,187435,187437,0,2,4
53646,1,2,187436,187437,187439,1,3,0
53647,2,2,187438,187439,187441,1,3,0
53648,4,1,187442,187442,187443,0,1,1
53649,3,2,187445,187445,187447,0,2,2
53650,3,2,187448,187448,187450,0,2,1
53651,2,3,187450,187450,187453,0,3,0
53652,5,3,187455,187455,187458,0,3,2
53653,2,3,187457,187458,187461,1,4,0
53654,4,1,187461,187461,187462,0,1,0
53655,6,3,187467,187467,187470,0,3,5
53656,3,2,187470,187470,187472,0,2,0
53657,3,1,187473,187473,187474,0,1,1
53658,6,2,187479,187479,187481,0,2,5
53659,3,2,187482,187482,187484,0,2,1
53660,3,1,187485,187485,187486,0,1,1
53661,1,3,187486,187486,187489,0,3,0
53662,3,1,187489,187489,187490,0,1,0
53663,3,2,187492,187492,187494,0,2,2
53664,5,1,187497,187497,187498,0,1,3
53665,3,2,187500,187500,187502,0,2,2
53666,5,2,187505,187505,187507,0,2,3
53667,5,1,187510,187510,187511,0,1,3
53668,1,1,187511,187511,187512,0,1,0
53669,6,2,187517,187517,187519,0,2,5
53670,5,3,187522,187522,187525,0,3,3
53671,2,2,187524,187525,187527,1,3,0
53672,4,3,187528,187528,187531,0,3,1
53673,4,1,187532,187532,187533,0,1,1
53674,3,1,187535,187535,187536,0,1,2
53675,3,3,187538,187538,187541,0,3,2
53676,6,1,187544,187544,187545,0,1,3
53677,4,2,187548,187548,187550,0,2,3
53678,4,2,187552,187552,187554,0,2,2
53679,1,3,187553,187554,187557,1,4,0
53680,6,2,187559,187559,187561,0,2,2
53681,5,3,187564,187564,187567,0,3,3
53682,5,2,187569,187569,187571,0,2,2
53683,1,1,187570,187571,187572,1,2,0
53684,5,1,187575,187575,187576,0,1,3
53685,5,3,187580,187580,187583,0,3,4
53686,1,2,187581,187583,187585,2,4,0
53687,2,2,187583,187585,187587,2,4,0
53688,5,2,187588,187588,187590,0,2,1
53689,6,2,187594,187594,187596,0,2,4
53690,2,1,187596,187596,187597,0,1,0
53691,4,1,187600,187600,187601,0,1,3
53692,6,1,187606,187606,187607,0,1,5
53693,2,1,187608,187608,187609,0,1,1
53694,5,2,187613,187613,187615,0,2,4
53695,4,2,187617,187617,187619,0,2,2
53696,6,1,187623,187623,187624,0,1,4
53697,5,2,187628,187628,187630,0,2,4
53698,3,1,187631,187631,187632,0,1,1
53699,5,2,187636,187636,187638,0,2,4
53700,4,3,187640,187640,187643,0,3,2
53701,4,1,187644,187644,187645,0,1,1
53702,2,3,187646,187646,187649,0,3,1
53703,2,1,187648,187649,187650,1,2,0
53704,2,3,187650,187650,187653,0,3,0
53705,1,2,187651,187653,187655,2,4,0
53706,2,3,187653,187655,187658,2,5,0
53707,2,1,187655,187658,187659,3,4,0
53708,6,2,187661,187661,187663,0,2,2
53709,6,2,187667,187667,187669,0,2,4
53710,6,2,187673,187673,187675,0,2,4
53711,4,2,187677,187677,187679,0,2,2
53712,3,2,187680,187680,187682,0,2,1
53713,4,1,187684,187684,187685,0,1,2
53714,5,2,187689,187689,187691,0,2,4
53715,1,1,187690,187691,187692,1,2,0
53716,1,1,187691,187692,187693,1,2,0
53717,3,1,187694,187694,187695,0,1,1
53718,4,1,187698,187698,187699,0,1,3
53719,5,3,187703,187703,187706,0,3,4
53720,2,2,187705,187706,187708,1,3,0
53721,6,3,187711,187711,187714,0,3,3
53722,6,3,187717,187717,187720,0,3,3
53723,1,1,187718,187720,187721,2,3,0
53724,5,3,187723,187723,187726,0,3,2
53725,6,1,187729,187729,187730,0,1,3
53726,2,1,187731,187731,187732,0,1,1
53727,3,3,187734,187734,187737,0,3,2
53728,5,2,187739,187739,187741,0,2,2
53729,2,1,187741,187741,187742,0,1,0
53730,5,1,187746,187746,187747,0,1,4
53731,5,2,187751,187751,187753,0,2,4
53732,3,2,187754,187754,187756,0,2,1
53733,2,2,187756,187756,187758,0,2,0
53734,3,2,187759,187759,187761,0,2,1
53735,1,1,187760,187761,187762,1,2,0
53736,6,2,187766,187766,187768,0,2,4
53737,5,2,187771,187771,187773,0,2,3
53738,2,3,187773,187773,187776,0,3,0
53739,6,3,187779,187779,187782,0,3,3
53740,1,1,187780,187782,187783,2,3,0
53741,5,1,187785,187785,187786,0,1,2
53742,3,3,187788,187788,187791,0,3,2
53743,1,2,187789,187791,187793,2,4,0
53744,2,1,187791,187793,187794,2,3,0
53745,5,2,187796,187796,187798,0,2,2
53746,1,1,187797,187798,187799,1,2,0
53747,2,1,187799,187799,187800,0,1,0
53748,6,1,187805,187805,187806,0,1,5
53749,6,1,187811,187811,187812,0,1,5
53750,6,2,187817,187817,187819,0,2,5
53751,2,3,187819,187819,187822,0,3,0
53752,3,1,187822,187822,187823,0,1,0
53753,1,3,187823,187823,187826,0,3,0
53754,1,3,187824,187826,187829,2,5,0
53755,5,1,187829,187829,187830,0,1,0
53756,6,3,187835,187835,187838,0,3,5
53757,3,2,187838,187838,187840,0,2,0
53758,6,2,187844,187844,187846,0,2,4
53759,4,3,187848,187848,187851,0,3,2
53760,4,1,187852,187852,187853,0,1,1
53761,3,2,187855,187855,187857,0,2,2
53762,6,2,187861,187861,187863,0,2,4
53763,6,3,187867,187867,187870,0,3,4
53764,1,3,187868,187870,187873,2,5,0
53765,6,1,187874,187874,187875,0,1,1
53766,6,2,187880,187880,187882,0,2,5
53767,3,1,187883,187883,187884,0,1,1
53768,5,3,187888,187888,187891,0,3,4
53769,4,1,187892,187892,187893,0,1,1
53770,5,3,187897,187897,187900,0,3,4
53771,5,2,187902,187902,187904,0,2,2
53772,4,1,187906,187906,187907,0,1,2
53773,3,1,187909,187909,187910,0,1,2
53774,4,3,187913,187913,187916,0,3,3
53775,3,3,187916,187916,187919,0,3,0
53776,2,3,187918,187919,187922,1,4,0
53777,2,2,187920,187922,187924,2,4,0
53778,5,3,187925,187925,187928,0,3,1
53779,3,1,187928,187928,187929,0,1,0
53780,2,2,187930,187930,187932,0,2,1
53781,3,1,187933,187933,187934,0,1,1
53782,2,3,187935,187935,187938,0,3,1
53783,2,3,187937,187938,187941,1,4,0
53784,4,1,187941,187941,187942,0,1,0
53785,2,1,187943,187943,187944,0,1,1
53786,2,3,187945,187945,187948,0,3,1
53787,3,1,187948,187948,187949,0,1,0
53788,5,3,187953,187953,187956,0,3,4
53789,6,3,187959,187959,187962,0,3,3
53790,3,2,187962,187962,187964,0,2,0
53791,4,3,187966,187966,187969,0,3,2
53792,4,1,187970,187970,187971,0,1,1
53793,1,1,187971,187971,187972,0,1,0
53794,6,2,187977,187977,187979,0,2,5
53795,5,1,187982,187982,187983,0,1,3
53796,6,3,187988,187988,187991,0,3,5
53797,2,3,187990,187991,187994,1,4,0
53798,1,2,187991,187994,187996,3,5,0
53799,3,1,187994,187996,187997,2,3,0
53800,1,1,187995,187997,187998,2,3,0
53801,6,3,188001,188001,188004,0,3,3
53802,4,3,188005,188005,188008,0,3,1
53803,1,1,188006,188008,188009,2,3,0
53804,2,3,188008,188009,188012,1,4,0
53805,6,1,188014,188014,188015,0,1,2
53806,1,2,188015,188015,188017,0,2,0
53807,6,3,188021,188021,188024,0,3,4
53808,3,2,188024,188024,188026,0,2,0
53809,3,3,188027,188027,188030,0,3,1
53810,6,1,188033,188033,188034,0,1,3
53811,4,3,188037,188037,188040,0,3,3
53812,4,1,188041,188041,188042,0,1,1
53813,5,2,188046,188046,188048,0,2,4
53814,4,2,188050,188050,188052,0,2,2
53815,4,3,188054,188054,188057,0,3,2
53816,3,3,188057,188057,188060,0,3,0
53817,6,2,188063,188063,188065,0,2,3
53818,5,3,188068,188068,188071,0,3,3
53819,4,3,188072,188072,188075,0,3,1
53820,4,2,188076,188076,188078,0,2,1
53821,1,1,188077,188078,188079,1,2,0
53822,4,3,188081,188081,188084,0,3,2
53823,1,1,188082,188084,188085,2,3,0
53824,2,2,188084,188085,188087,1,3,0
53825,6,3,188090,188090,188093,0,3,3
53826,1,2,188091,188093,188095,2,4,0
53827,5,1,188096,188096,188097,0,1,1
53828,2,3,188098,188098,188101,0,3,1
53829,1,2,188099,188101,188103,2,4,0
53830,5,1,188104,188104,188105,0,1,1
53831,3,1,188107,188107,188108,0,1,2
53832,4,2,188111,188111,188113,0,2,3
53833,4,3,188115,188115,188118,0,3,2
53834,5,1,188120,188120,188121,0,1,2
53835,2,3,188122,188122,188125,0,3,1
53836,1,3,188123,188125,188128,2,5,0
53837,6,1,188129,188129,188130,0,1,1
53838,6,2,188135,188135,188137,0,2,5
53839,6,2,188141,188141,188143,0,2,4
53840,1,1,188142,188143,188144,1,2,0
53841,4,3,188146,188146,188149,0,3,2
53842,5,3,188151,188151,188154,0,3,2
53843,3,1,188154,188154,188155,0,1,0
53844,4,3,188158,188158,188161,0,3,3
53845,4,2,188162,188162,188164,0,2,1
53846,1,3,188163,188164,188167,1,4,0
53847,2,3,188165,188167,188170,2,5,0
53848,2,1,188167,188170,188171,3,4,0
53849,2,2,188169,188171,188173,2,4,0
53850,4,2,188173,188173,188175,0,2,0
53851,6,1,188179,188179,188180,0,1,4
53852,4,1,188183,188183,188184,0,1,3
53853,2,2,188185,188185,188187,0,2,1
53854,4,1,188189,188189,188190,0,1,2
53855,5,1,188194,188194,188195,0,1,4
53856,6,1,188200,188200,188201,0,1,5
53857,1,2,188201,188201,188203,0,2,0
53858,5,3,188206,188206,188209,0,3,3
53859,3,2,188209,188209,188211,0,2,0
53860,5,2,188214,188214,188216,0,2,3
53861,2,3,188216,188216,188219,0,3,0
53862,1,2,188217,188219,188221,2,4,0
53863,6,3,188223,188223,188226,0,3,2
53864,2,1,188225,188226,188227,1,2,0
53865,3,3,188228,188228,188231,0,3,1
53866,5,2,188233,188233,188235,0,2,2
53867,1,1,188234,188235,188236,1,2,0
53868,2,2,188236,188236,188238,0,2,0
53869,1,2,188237,188238,188240,1,3,0
53870,1,1,188238,188240,188241,2,3,0
53871,3,3,188241,188241,188244,0,3,0
53872,6,3,188247,188247,188250,0,3,3
53873,1,2,188248,188250,188252,2,4,0
53874,6,2,188254,188254,188256,0,2,2
53875,5,1,188259,188259,188260,0,1,3
53876,1,1,188260,188260,188261,0,1,0
53877,5,1,188265,188265,188266,0,1,4
53878,1,1,188266,188266,188267,0,1,0
53879,6,2,188272,188272,188274,0,2,5
53880,3,2,188275,188275,188277,0,2,1
53881,3,2,188278,188278,188280,0,2,1
53882,1,3,188279,188280,188283,1,4,0
53883,1,2,188280,188283,188285,3,5,0
53884,2,2,188282,188285,188287,3,5,0
53885,5,3,188287,188287,188290,0,3,0
53886,4,1,188291,188291,188292,0,1,1
53887,5,1,188296,188296,188297,0,1,4
53888,3,3,188299,188299,188302,0,3,2
53889,2,1,188301,188302,188303,1,2,0
53890,4,1,188305,188305,188306,0,1,2
53891,5,2,188310,188310,188312,0,2,4
53892,5,3,188315,188315,188318,0,3,3
53893,6,2,188321,188321,188323,0,2,3
53894,1,3,188322,188323,188326,1,4,0
53895,1,2,188323,188326,188328,3,5,0
53896,6,3,188329,188329,188332,0,3,1
53897,3,1,188332,188332,188333,0,1,0
53898,6,3,188338,188338,188341,0,3,5
53899,6,2,188344,188344,188346,0,2,3
53900,6,1,188350,188350,188351,0,1,4
53901,2,1,188352,188352,188353,0,1,1
53902,4,2,188356,188356,188358,0,2,3
53903,1,2,188357,188358,188360,1,3,0
53904,4,1,188361,188361,188362,0,1,1
53905,2,1,188363,188363,188364,0,1,1
53906,6,1,188369,188369,188370,0,1,5
53907,3,1,188372,188372,188373,0,1,2
53908,2,2,188374,188374,188376,0,2,1
53909,3,1,188377,188377,188378,0,1,1
53910,1,1,188378,188378,188379,0,1,0
53911,3,3,188381,188381,188384,0,3,2
53912,6,1,188387,188387,188388,0,1,3
53913,2,2,188389,188389,188391,0,2,1
53914,4,2,188393,188393,188395,0,2,2
53915,1,3,188394,188395,188398,1,4,0
53916,5,3,188399,188399,188402,0,3,1
53917,3,1,188402,188402,188403,0,1,0
53918,2,2,188404,188404,188406,0,2,1
53919,6,1,188410,188410,188411,0,1,4
53920,1,3,188411,188411,188414,0,3,0
53921,1,1,188412,188414,188415,2,3,0
53922,2,2,188414,188415,188417,1,3,0
53923,1,3,188415,188417,188420,2,5,0
53924,2,3,188417,188420,188423,3,6,0
53925,2,2,188419,188423,188425,4,6,0
53926,4,3,188423,188425,188428,2,5,0
53927,5,1,188428,188428,188429,0,1,0
53928,1,1,188429,188429,188430,0,1,0
53929,4,3,188433,188433,188436,0,3,3
53930,1,2,188434,188436,188438,2,4,0
53931,1,1,188435,188438,188439,3,4,0
53932,1,3,188436,188439,188442,3,6,0
53933,1,1,188437,188442,188443,5,6,0
53934,1,1,188438,188443,188444,5,6,0
53935,2,1,188440,188444,188445,4,5,0
53936,2,3,188442,188445,188448,3,6,0
53937,1,3,188443,188448,188451,5,8,0
53938,2,2,188445,188451,188453,6,8,0
53939,5,3,188450,188453,188456,3,6,0
53940,3,1,188453,188456,188457,3,4,0
53941,1,1,188454,188457,188458,3,4,0
53942,1,3,188455,188458,188461,3,6,0
53943,5,1,188460,188461,188462,1,2,0
53944,5,3,188465,188465,188468,0,3,3
53945,6,1,188471,188471,188472,0,1,3
53946,2,3,188473,188473,188476,0,3,1
53947,3,2,188476,188476,188478,0,2,0
53948,3,3,188479,188479,188482,0,3,1
53949,5,3,188484,188484,188487,0,3,2
53950,6,3,188490,188490,188493,0,3,3
53951,2,1,188492,188493,188494,1,2,0
53952,6,3,188498,188498,188501,0,3,4
53953,1,3,188499,188501,188504,2,5,0
53954,2,1,188501,188504,188505,3,4,0
53955,2,2,188503,188505,188507,2,4,0
53956,5,1,188508,188508,188509,0,1,1
53957,1,2,188509,188509,188511,0,2,0
53958,2,2,188511,188511,188513,0,2,0
53959,3,2,188514,188514,188516,0,2,1
53960,1,3,188515,188516,188519,1,4,0
53961,3,2,188518,188519,188521,1,3,0
53962,6,3,188524,188524,188527,0,3,3
53963,1,2,188525,188527,188529,2,4,0
53964,1,2,188526,188529,188531,3,5,0
53965,5,3,188531,188531,188534,0,3,0
53966,1,1,188532,188534,188535,2,3,0
53967,3,2,188535,188535,188537,0,2,0
53968,3,1,188538,188538,188539,0,1,1
53969,3,3,188541,188541,188544,0,3,2
53970,3,1,188544,188544,188545,0,1,0
53971,5,3,188549,188549,188552,0,3,4
53972,6,2,188555,188555,188557,0,2,3
53973,5,3,188560,188560,188563,0,3,3
53974,2,1,188562,188563,188564,1,2,0
53975,1,1,188563,188564,188565,1,2,0
53976,6,1,188569,188569,188570,0,1,4
53977,1,1,188570,188570,188571,0,1,0
53978,2,1,188572,188572,188573,0,1,1
53979,6,3,188578,188578,188581,0,3,5
53980,4,1,188582,188582,188583,0,1,1
53981,3,3,188585,188585,188588,0,3,2
53982,5,1,188590,188590,188591,0,1,2
53983,1,3,188591,188591,188594,0,3,0
53984,4,3,188595,188595,188598,0,3,1
53985,4,2,188599,188599,188601,0,2,1
53986,6,3,188605,188605,188608,0,3,4
53987,4,1,188609,188609,188610,0,1,1
53988,1,2,188610,188610,188612,0,2,0
53989,6,2,188616,188616,188618,0,2,4
53990,4,3,188620,188620,188623,0,3,2
53991,6,2,188626,188626,188628,0,2,3
53992,1,3,188627,188628,188631,1,4,0
53993,1,1,188628,188631,188632,3,4,0
53994,2,2,188630,188632,188634,2,4,0
53995,2,1,188632,188634,188635,2,3,0
53996,5,2,188637,188637,188639,0,2,2
53997,5,2,188642,188642,188644,0,2,3
53998,2,2,188644,188644,188646,0,2,0
53999,3,2,188647,188647,188649,0,2,1
54000,1,1,188648,188649,188650,1,2,0
54001,4,2,188652,188652,188654,0,2,2
54002,5,1,188657,188657,188658,0,1,3
54003,2,2,188659,188659,188661,0,2,1
54004,6,1,188665,188665,188666,0,1,4
54005,6,3,188671,188671,188674,0,3,5
54006,1,2,188672,188674,188676,2,4,0
54007,1,2,188673,188676,188678,3,5,0
54008,6,2,188679,188679,188681,0,2,1
54009,3,2,188682,188682,188684,0,2,1
54010,6,2,188688,188688,188690,0,2,4
54011,1,3,188689,188690,188693,1,4,0
54012,1,3,188690,188693,188696,3,6,0
54013,5,3,188695,188696,188699,1,4,0
54014,6,1,188701,188701,188702,0,1,2
54015,1,1,188702,188702,188703,0,1,0
54016,2,1,188704,188704,188705,0,1,1
54017,2,3,188706,188706,188709,0,3,1
54018,2,1,188708,188709,188710,1,2,0
54019,4,2,188712,188712,188714,0,2,2
54020,2,1,188714,188714,188715,0,1,0
54021,4,3,188718,188718,188721,0,3,3
54022,3,3,188721,188721,188724,0,3,0
54023,6,1,188727,188727,188728,0,1,3
54024,4,2,188731,188731,188733,0,2,3
54025,2,1,188733,188733,188734,0,1,0
54026,5,1,188738,188738,188739,0,1,4
54027,2,2,188740,188740,188742,0,2,1
54028,2,2,188742,188742,188744,0,2,0
54029,5,2,188747,188747,188749,0,2,3
54030,5,3,188752,188752,188755,0,3,3
54031,5,3,188757,188757,188760,0,3,2
54032,1,3,188758,188760,188763,2,5,0
54033,4,3,188762,188763,188766,1,4,0
54034,2,2,188764,188766,188768,2,4,0
54035,1,2,188765,188768,188770,3,5,0
54036,2,2,188767,188770,188772,3,5,0
54037,1,3,188768,188772,188775,4,7,0
54038,6,2,188774,188775,188777,1,3,0
54039,4,1,188778,188778,188779,0,1,1
54040,5,1,188783,188783,188784,0,1,4
54041,1,3,188784,188784,188787,0,3,0
54042,5,1,188789,188789,188790,0,1,2
54043,4,2,188793,188793,188795,0,2,3
54044,6,3,188799,188799,188802,0,3,4
54045,2,2,188801,188802,188804,1,3,0
54046,2,3,188803,188804,188807,1,4,0
54047,4,1,188807,188807,188808,0,1,0
54048,2,1,188809,188809,188810,0,1,1
54049,4,1,188813,188813,188814,0,1,3
54050,3,1,188816,188816,188817,0,1,2
54051,2,1,188818,188818,188819,0,1,1
54052,2,3,188820,188820,188823,0,3,1
54053,1,2,188821,188823,188825,2,4,0
54054,6,3,188827,188827,188830,0,3,2
54055,4,2,188831,188831,188833,0,2,1
54056,5,1,188836,188836,188837,0,1,3
54057,3,3,188839,188839,188842,0,3,2
54058,5,2,188844,188844,188846,0,2,2
54059,6,2,188850,188850,188852,0,2,4
54060,5,1,188855,188855,188856,0,1,3
54061,1,2,188856,188856,188858,0,2,0
54062,6,3,188862,188862,188865,0,3,4
54063,4,1,188866,188866,188867,0,1,1
54064,6,2,188872,188872,188874,0,2,5
54065,1,2,188873,188874,188876,1,3,0
54066,3,3,188876,188876,188879,0,3,0
54067,4,1,188880,188880,188881,0,1,1
54068,2,2,188882,188882,188884,0,2,1
54069,6,2,188888,188888,188890,0,2,4
54070,6,2,188894,188894,188896,0,2,4
54071,5,1,188899,188899,188900,0,1,3
54072,2,3,188901,188901,188904,0,3,1
54073,1,3,188902,188904,188907,2,5,0
54074,6,3,188908,188908,188911,0,3,1
54075,2,3,188910,188911,188914,1,4,0
54076,2,1,188912,188914,188915,2,3,0
54077,5,1,188917,188917,188918,0,1,2
54078,5,3,188922,188922,188925,0,3,4
54079,5,2,188927,188927,188929,0,2,2
54080,5,1,188932,188932,188933,0,1,3
54081,4,3,188936,188936,188939,0,3,3
54082,5,3,188941,188941,188944,0,3,2
54083,2,3,188943,188944,188947,1,4,0
54084,5,2,188948,188948,188950,0,2,1
54085,2,1,188950,188950,188951,0,1,0
54086,4,3,188954,188954,188957,0,3,3
54087,5,1,188959,188959,188960,0,1,2
54088,1,1,188960,188960,188961,0,1,0
54089,2,3,188962,188962,188965,0,3,1
54090,1,2,188963,188965,188967,2,4,0
54091,6,2,188969,188969,188971,0,2,2
54092,2,1,188971,188971,188972,0,1,0
54093,5,1,188976,188976,188977,0,1,4
54094,2,3,188978,188978,188981,0,3,1
54095,5,1,188983,188983,188984,0,1,2
54096,3,3,188986,188986,188989,0,3,2
54097,1,2,188987,188989,188991,2,4,0
54098,2,3,188989,188991,188994,2,5,0
54099,1,3,188990,188994,188997,4,7,0
54100,2,1,188992,188997,188998,5,6,0
54101,3,1,188995,188998,188999,3,4,0
54102,2,1,188997,188999,189000,2,3,0
54103,4,1,189001,189001,189002,0,1,1
54104,5,1,189006,189006,189007,0,1,4
54105,3,3,189009,189009,189012,0,3,2
54106,4,3,189013,189013,189016,0,3,1
54107,6,3,189019,189019,189022,0,3,3
54108,2,1,189021,189022,189023,1,2,0
54109,3,2,189024,189024,189026,0,2,1
54110,4,1,189028,189028,189029,0,1,2
54111,6,3,189034,189034,189037,0,3,5
54112,1,1,189035,189037,189038,2,3,0
54113,5,1,189040,189040,189041,0,1,2
54114,6,3,189046,189046,189049,0,3,5
54115,3,1,189049,189049,189050,0,1,0
54116,6,3,189055,189055,189058,0,3,5
54117,6,3,189061,189061,189064,0,3,3
54118,5,2,189066,189066,189068,0,2,2
54119,4,1,189070,189070,189071,0,1,2
54120,5,1,189075,189075,189076,0,1,4
54121,2,1,189077,189077,189078,0,1,1
54122,1,2,189078,189078,189080,0,2,0
54123,5,3,189083,189083,189086,0,3,3
54124,1,1,189084,189086,189087,2,3,0
54125,4,1,189088,189088,189089,0,1,1
54126,1,2,189089,189089,189091,0,2,0
54127,6,2,189095,189095,189097,0,2,4
54128,1,2,189096,189097,189099,1,3,0
54129,6,2,189102,189102,189104,0,2,3
54130,5,3,189107,189107,189110,0,3,3
54131,2,2,189109,189110,189112,1,3,0
54132,1,3,189110,189112,189115,2,5,0
54133,5,3,189115,189115,189118,0,3,0
54134,2,1,189117,189118,189119,1,2,0
54135,5,3,189122,189122,189125,0,3,3
54136,4,2,189126,189126,189128,0,2,1
54137,6,3,189132,189132,189135,0,3,4
54138,3,2,189135,189135,189137,0,2,0
54139,2,3,189137,189137,189140,0,3,0
54140,1,1,189138,189140,189141,2,3,0
54141,2,1,189140,189141,189142,1,2,0
54142,4,3,189144,189144,189147,0,3,2
54143,3,1,189147,189147,189148,0,1,0
54144,5,1,189152,189152,189153,0,1,4
54145,4,2,189156,189156,189158,0,2,3
54146,4,2,189160,189160,189162,0,2,2
54147,2,2,189162,189162,189164,0,2,0
54148,3,1,189165,189165,189166,0,1,1
54149,1,2,189166,189166,189168,0,2,0
54150,6,3,189172,189172,189175,0,3,4
54151,6,2,189178,189178,189180,0,2,3
54152,6,1,189184,189184,189185,0,1,4
54153,4,3,189188,189188,189191,0,3,3
54154,2,3,189190,189191,189194,1,4,0
54155,2,2,189192,189194,189196,2,4,0
54156,3,2,189195,189196,189198,1,3,0
54157,5,3,189200,189200,189203,0,3,2
54158,1,1,189201,189203,189204,2,3,0
54159,1,2,189202,189204,189206,2,4,0
54160,4,1,189206,189206,189207,0,1,0
54161,6,1,189212,189212,189213,0,1,5
54162,4,3,189216,189216,189219,0,3,3
54163,2,3,189218,189219,189222,1,4,0
54164,2,2,189220,189222,189224,2,4,0
54165,2,1,189222,189224,189225,2,3,0
54166,5,3,189227,189227,189230,0,3,2
54167,2,1,189229,189230,189231,1,2,0
54168,5,3,189234,189234,189237,0,3,3
54169,1,2,189235,189237,189239,2,4,0
54170,6,1,189241,189241,189242,0,1,2
54171,6,3,189247,189247,189250,0,3,5
54172,1,3,189248,189250,189253,2,5,0
54173,3,3,189251,189253,189256,2,5,0
54174,1,3,189252,189256,189259,4,7,0
54175,4,1,189256,189259,189260,3,4,0
54176,1,1,189257,189260,189261,3,4,0
54177,6,2,189263,189263,189265,0,2,2
54178,1,2,189264,189265,189267,1,3,0
54179,4,1,189268,189268,189269,0,1,1
54180,5,3,189273,189273,189276,0,3,4
54181,5,3,189278,189278,189281,0,3,2
54182,2,1,189280,189281,189282,1,2,0
54183,3,1,189283,189283,189284,0,1,1
54184,1,3,189284,189284,189287,0,3,0
54185,1,2,189285,189287,189289,2,4,0
54186,1,2,189286,189289,189291,3,5,0
54187,5,2,189291,189291,189293,0,2,0
54188,4,2,189295,189295,189297,0,2,2
54189,1,1,189296,189297,189298,1,2,0
54190,5,1,189301,189301,189302,0,1,3
54191,6,2,189307,189307,189309,0,2,5
54192,2,3,189309,189309,189312,0,3,0
54193,1,3,189310,189312,189315,2,5,0
54194,4,2,189314,189315,189317,1,3,0
54195,6,1,189320,189320,189321,0,1,3
54196,6,1,189326,189326,189327,0,1,5
54197,3,3,189329,189329,189332,0,3,2
54198,1,1,189330,189332,189333,2,3,0
54199,6,1,189336,189336,189337,0,1,3
54200,2,1,189338,189338,189339,0,1,1
54201,1,2,189339,189339,189341,0,2,0
54202,5,1,189344,189344,189345,0,1,3
54203,4,3,189348,189348,189351,0,3,3
54204,2,2,189350,189351,189353,1,3,0
54205,3,3,189353,189353,189356,0,3,0
54206,3,2,189356,189356,189358,0,2,0
54207,3,3,189359,189359,189362,0,3,1
54208,3,2,189362,189362,189364,0,2,0
54209,6,3,189368,189368,189371,0,3,4
54210,6,2,189374,189374,189376,0,2,3
54211,2,3,189376,189376,189379,0,3,0
54212,6,2,189382,189382,189384,0,2,3
54213,6,3,189388,189388,189391,0,3,4
54214,4,3,189392,189392,189395,0,3,1
54215,4,3,189396,189396,189399,0,3,1
54216,3,2,189399,189399,189401,0,2,0
54217,4,3,189403,189403,189406,0,3,2
54218,3,3,189406,189406,189409,0,3,0
54219,6,2,189412,189412,189414,0,2,3
54220,1,2,189413,189414,189416,1,3,0
54221,2,1,189415,189416,189417,1,2,0
54222,3,2,189418,189418,189420,0,2,1
54223,4,1,189422,189422,189423,0,1,2
54224,3,3,189425,189425,189428,0,3,2
54225,5,2,189430,189430,189432,0,2,2
54226,5,1,189435,189435,189436,0,1,3
54227,2,1,189437,189437,189438,0,1,1
54228,2,2,189439,189439,189441,0,2,1
54229,2,1,189441,189441,189442,0,1,0
54230,4,1,189445,189445,189446,0,1,3
54231,6,1,189451,189451,189452,0,1,5
54232,4,2,189455,189455,189457,0,2,3
54233,5,3,189460,189460,189463,0,3,3
54234,1,1,189461,189463,189464,2,3,0
54235,6,2,189467,189467,189469,0,2,3
54236,5,3,189472,189472,189475,0,3,3
54237,2,3,189474,189475,189478,1,4,0
54238,6,1,189480,189480,189481,0,1,2
54239,2,2,189482,189482,189484,0,2,1
54240,2,2,189484,189484,189486,0,2,0
54241,3,2,189487,189487,189489,0,2,1
54242,5,1,189492,189492,189493,0,1,3
54243,2,3,189494,189494,189497,0,3,1
54244,6,3,189500,189500,189503,0,3,3
54245,2,1,189502,189503,189504,1,2,0
54246,3,1,189505,189505,189506,0,1,1
54247,6,3,189511,189511,189514,0,3,5
54248,4,3,189515,189515,189518,0,3,1
54249,3,1,189518,189518,189519,0,1,0
54250,6,1,189524,189524,189525,0,1,5
54251,3,1,189527,189527,189528,0,1,2
54252,2,2,189529,189529,189531,0,2,1
54253,2,1,189531,189531,189532,0,1,0
54254,2,2,189533,189533,189535,0,2,1
54255,6,3,189539,189539,189542,0,3,4
54256,4,1,189543,189543,189544,0,1,1
54257,3,2,189546,189546,189548,0,2,2
54258,3,2,189549,189549,189551,0,2,1
54259,2,1,189551,189551,189552,0,1,0
54260,4,1,189555,189555,189556,0,1,3
54261,1,1,189556,189556,189557,0,1,0
54262,2,1,189558,189558,189559,0,1,1
54263,4,1,189562,189562,189563,0,1,3
54264,1,2,189563,189563,189565,0,2,0
54265,3,2,189566,189566,189568,0,2,1
54266,4,1,189570,189570,189571,0,1,2
54267,5,2,189575,189575,189577,0,2,4
54268,2,2,189577,189577,189579,0,2,0
54269,5,2,189582,189582,189584,0,2,3
54270,5,1,189587,189587,189588,0,1,3
54271,5,3,189592,189592,189595,0,3,4
54272,5,3,189597,189597,189600,0,3,2
54273,5,3,189602,189602,189605,0,3,2
54274,2,2,189604,189605,189607,1,3,0
54275,4,2,189608,189608,189610,0,2,1
54276,6,1,189614,189614,189615,0,1,4
54277,4,2,189618,189618,189620,0,2,3
54278,2,3,189620,189620,189623,0,3,0
54279,4,2,189624,189624,189626,0,2,1
54280,6,1,189630,189630,189631,0,1,4
54281,3,3,189633,189633,189636,0,3,2
54282,3,3,189636,189636,189639,0,3,0
54283,3,2,189639,189639,189641,0,2,0
54284,1,2,189640,189641,189643,1,3,0
54285,3,2,189643,189643,189645,0,2,0
54286,1,1,189644,189645,189646,1,2,0
54287,3,3,189647,189647,189650,0,3,1
54288,5,2,189652,189652,189654,0,2,2
54289,2,2,189654,189654,189656,0,2,0
54290,3,1,189657,189657,189658,0,1,1
54291,6,1,189663,189663,189664,0,1,5
54292,6,2,189669,189669,189671,0,2,5
54293,1,3,189670,189671,189674,1,4,0
54294,4,2,189674,189674,189676,0,2,0
54295,6,2,189680,189680,189682,0,2,4
54296,1,1,189681,189682,189683,1,2,0
54297,4,2,189685,189685,189687,0,2,2
54298,6,2,189691,189691,189693,0,2,4
54299,2,2,189693,189693,189695,0,2,0
54300,2,1,189695,189695,189696,0,1,0
54301,3,2,189698,189698,189700,0,2,2
54302,1,3,189699,189700,189703,1,4,0
54303,6,2,189705,189705,189707,0,2,2
54304,2,1,189707,189707,189708,0,1,0
54305,6,2,189713,189713,189715,0,2,5
54306,6,3,189719,189719,189722,0,3,4
54307,5,1,189724,189724,189725,0,1,2
54308,6,1,189730,189730,189731,0,1,5
54309,4,3,189734,189734,189737,0,3,3
54310,2,2,189736,189737,189739,1,3,0
54311,4,3,189740,189740,189743,0,3,1
54312,2,1,189742,189743,189744,1,2,0
54313,3,2,189745,189745,189747,0,2,1
54314,1,2,189746,189747,189749,1,3,0
54315,5,2,189751,189751,189753,0,2,2
54316,2,3,189753,189753,189756,0,3,0
54317,4,1,189757,189757,189758,0,1,1
54318,2,2,189759,189759,189761,0,2,1
54319,4,2,189763,189763,189765,0,2,2
54320,4,1,189767,189767,189768,0,1,2
54321,1,1,189768,189768,189769,0,1,0
54322,5,3,189773,189773,189776,0,3,4
54323,3,2,189776,189776,189778,0,2,0
54324,2,3,189778,189778,189781,0,3,0
54325,5,1,189783,189783,189784,0,1,2
54326,6,2,189789,189789,189791,0,2,5
54327,3,2,189792,189792,189794,0,2,1
54328,2,1,189794,189794,189795,0,1,0
54329,5,3,189799,189799,189802,0,3,4
54330,1,3,189800,189802,189805,2,5,0
54331,3,3,189803,189805,189808,2,5,0
54332,2,2,189805,189808,189810,3,5,0
54333,2,3,189807,189810,189813,3,6,0
54334,1,3,189808,189813,189816,5,8,0
54335,5,2,189813,189816,189818,3,5,0
54336,1,1,189814,189818,189819,4,5,0
54337,3,2,189817,189819,189821,2,4,0
54338,4,3,189821,189821,189824,0,3,0
54339,1,1,189822,189824,189825,2,3,0
54340,2,3,189824,189825,189828,1,4,0
54341,5,3,189829,189829,189832,0,3,1
54342,4,2,189833,189833,189835,0,2,1
54343,6,3,189839,189839,189842,0,3,4
54344,3,1,189842,189842,189843,0,1,0
54345,6,3,189848,189848,189851,0,3,5
54346,5,3,189853,189853,189856,0,3,2
54347,3,1,189856,189856,189857,0,1,0
54348,2,3,189858,189858,189861,0,3,1
54349,5,2,189863,189863,189865,0,2,2
54350,3,1,189866,189866,189867,0,1,1
54351,1,3,189867,189867,189870,0,3,0
54352,6,2,189873,189873,189875,0,2,3
54353,4,1,189877,189877,189878,0,1,2
54354,5,2,189882,189882,189884,0,2,4
54355,1,1,189883,189884,189885,1,2,0
54356,2,2,189885,189885,189887,0,2,0
54357,3,2,189888,189888,189890,0,2,1
54358,2,1,189890,189890,189891,0,1,0
54359,6,2,189896,189896,189898,0,2,5
54360,5,1,189901,189901,189902,0,1,3
54361,3,3,189904,189904,189907,0,3,2
54362,3,2,189907,189907,189909,0,2,0
54363,3,3,189910,189910,189913,0,3,1
54364,1,3,189911,189913,189916,2,5,0
54365,5,1,189916,189916,189917,0,1,0
54366,3,3,189919,189919,189922,0,3,2
54367,1,3,189920,189922,189925,2,5,0
54368,4,3,189924,189925,189928,1,4,0
54369,2,3,189926,189928,189931,2,5,0
54370,4,3,189930,189931,189934,1,4,0
54371,5,3,189935,189935,189938,0,3,1
54372,1,2,189936,189938,189940,2,4,0
54373,2,3,189938,189940,189943,2,5,0
54374,6,3,189944,189944,189947,0,3,1
54375,6,1,189950,189950,189951,0,1,3
54376,4,3,189954,189954,189957,0,3,3
54377,1,3,189955,189957,189960,2,5,0
54378,4,3,189959,189960,189963,1,4,0
54379,3,3,189962,189963,189966,1,4,0
54380,6,2,189968,189968,189970,0,2,2
54381,4,3,189972,189972,189975,0,3,2
54382,6,3,189978,189978,189981,0,3,3
54383,6,1,189984,189984,189985,0,1,3
54384,4,1,189988,189988,189989,0,1,3
54385,2,1,189990,189990,189991,0,1,1
54386,5,3,189995,189995,189998,0,3,4
54387,1,1,189996,189998,189999,2,3,0
54388,6,3,190002,190002,190005,0,3,3
54389,1,3,190003,190005,190008,2,5,0
54390,4,3,190007,190008,190011,1,4,0
54391,6,3,190013,190013,190016,0,3,2
54392,5,3,190018,190018,190021,0,3,2
54393,5,1,190023,190023,190024,0,1,2
54394,6,3,190029,190029,190032,0,3,5
54395,2,2,190031,190032,190034,1,3,0
54396,2,2,190033,190034,190036,1,3,0
54397,3,3,190036,190036,190039,0,3,0
54398,5,2,190041,190041,190043,0,2,2
54399,2,1,190043,190043,190044,0,1,0
54400,3,1,190046,190046,190047,0,1,2
54401,6,2,190052,190052,190054,0,2,5
54402,4,3,190056,190056,190059,0,3,2
54403,5,1,190061,190061,190062,0,1,2
54404,3,2,190064,190064,190066,0,2,2
54405,3,3,190067,190067,190070,0,3,1
54406,5,3,190072,190072,190075,0,3,2
54407,3,1,190075,190075,190076,0,1,0
54408,1,3,190076,190076,190079,0,3,0
54409,1,2,190077,190079,190081,2,4,0
54410,5,2,190082,190082,190084,0,2,1
54411,4,2,190086,190086,190088,0,2,2
54412,6,2,190092,190092,190094,0,2,4
54413,4,3,190096,190096,190099,0,3,2
54414,3,3,190099,190099,190102,0,3,0
54415,2,2,190101,190102,190104,1,3,0
54416,2,1,190103,190104,190105,1,2,0
54417,6,3,190109,190109,190112,0,3,4
54418,4,2,190113,190113,190115,0,2,1
54419,4,3,190117,190117,190120,0,3,2
54420,5,3,190122,190122,190125,0,3,2
54421,4,2,190126,190126,190128,0,2,1
54422,6,1,190132,190132,190133,0,1,4
54423,5,2,190137,190137,190139,0,2,4
54424,4,1,190141,190141,190142,0,1,2
54425,2,3,190143,190143,190146,0,3,1
54426,1,1,190144,190146,190147,2,3,0
54427,5,1,190149,190149,190150,0,1,2
54428,3,1,190152,190152,190153,0,1,2
54429,1,3,190153,190153,190156,0,3,0
54430,4,3,190157,190157,190160,0,3,1
54431,4,3,190161,190161,190164,0,3,1
54432,2,3,190163,190164,190167,1,4,0
54433,5,1,190168,190168,190169,0,1,1
54434,4,1,190172,190172,190173,0,1,3
54435,3,3,190175,190175,190178,0,3,2
54436,3,1,190178,190178,190179,0,1,0
54437,3,1,190181,190181,190182,0,1,2
54438,2,3,190183,190183,190186,0,3,1
54439,3,3,190186,190186,190189,0,3,0
54440,2,1,190188,190189,190190,1,2,0
54441,5,3,190193,190193,190196,0,3,3
54442,6,2,190199,190199,190201,0,2,3
54443,2,3,190201,190201,190204,0,3,0
54444,2,3,190203,190204,190207,1,4,0
54445,2,2,190205,190207,190209,2,4,0
54446,2,3,190207,190209,190212,2,5,0
54447,5,3,190212,190212,190215,0,3,0
54448,2,1,190214,190215,190216,1,2,0
54449,1,2,190215,190216,190218,1,3,0
54450,4,1,190219,190219,190220,0,1,1
54451,2,1,190221,190221,190222,0,1,1
54452,5,2,190226,190226,190228,0,2,4
54453,6,2,190232,190232,190234,0,2,4
54454,2,2,190234,190234,190236,0,2,0
54455,3,2,190237,190237,190239,0,2,1
54456,2,2,190239,190239,190241,0,2,0
54457,5,1,190244,190244,190245,0,1,3
54458,3,2,190247,190247,190249,0,2,2
54459,4,2,190251,190251,190253,0,2,2
54460,6,1,190257,190257,190258,0,1,4
54461,1,2,190258,190258,190260,0,2,0
54462,5,2,190263,190263,190265,0,2,3
54463,3,3,190266,190266,190269,0,3,1
54464,1,2,190267,190269,190271,2,4,0
54465,4,3,190271,190271,190274,0,3,0
54466,4,1,190275,190275,190276,0,1,1
54467,3,3,190278,190278,190281,0,3,2
54468,1,3,190279,190281,190284,2,5,0
54469,4,2,190283,190284,190286,1,3,0
54470,6,3,190289,190289,190292,0,3,3
54471,1,3,190290,190292,190295,2,5,0
54472,5,2,190295,190295,190297,0,2,0
54473,3,1,190298,190298,190299,0,1,1
54474,1,3,190299,190299,190302,0,3,0
54475,4,3,190303,190303,190306,0,3,1
54476,3,2,190306,190306,190308,0,2,0
54477,5,1,190311,190311,190312,0,1,3
54478,6,1,190317,190317,190318,0,1,5
54479,3,3,190320,190320,190323,0,3,2
54480,3,2,190323,190323,190325,0,2,0
54481,3,3,190326,190326,190329,0,3,1
54482,1,3,190327,190329,190332,2,5,0
54483,5,1,190332,190332,190333,0,1,0
54484,3,1,190335,190335,190336,0,1,2
54485,3,2,190338,190338,190340,0,2,2
54486,3,3,190341,190341,190344,0,3,1
54487,4,2,190345,190345,190347,0,2,1
54488,3,1,190348,190348,190349,0,1,1
54489,3,1,190351,190351,190352,0,1,2
54490,3,1,190354,190354,190355,0,1,2
54491,1,1,190355,190355,190356,0,1,0
54492,3,3,190358,190358,190361,0,3,2
54493,2,3,190360,190361,190364,1,4,0
54494,1,3,190361,190364,190367,3,6,0
54495,2,2,190363,190367,190369,4,6,0
54496,6,3,190369,190369,190372,0,3,0
54497,4,1,190373,190373,190374,0,1,1
54498,5,1,190378,190378,190379,0,1,4
54499,5,2,190383,190383,190385,0,2,4
54500,6,2,190389,190389,190391,0,2,4
54501,4,3,190393,190393,190396,0,3,2
54502,5,3,190398,190398,190401,0,3,2
54503,3,2,190401,190401,190403,0,2,0
54504,1,2,190402,190403,190405,1,3,0
54505,5,3,190407,190407,190410,0,3,2
54506,3,1,190410,190410,190411,0,1,0
54507,4,3,190414,190414,190417,0,3,3
54508,3,3,190417,190417,190420,0,3,0
54509,5,2,190422,190422,190424,0,2,2
54510,1,2,190423,190424,190426,1,3,0
54511,2,3,190425,190426,190429,1,4,0
54512,5,3,190430,190430,190433,0,3,1
54513,5,3,190435,190435,190438,0,3,2
54514,6,1,190441,190441,190442,0,1,3
54515,1,1,190442,190442,190443,0,1,0
54516,1,3,190443,190443,190446,0,3,0
54517,6,3,190449,190449,190452,0,3,3
54518,4,1,190453,190453,190454,0,1,1
54519,2,1,190455,190455,190456,0,1,1
54520,2,2,190457,190457,190459,0,2,1
54521,4,2,190461,190461,190463,0,2,2
54522,1,1,190462,190463,190464,1,2,0
54523,2,2,190464,190464,190466,0,2,0
54524,6,2,190470,190470,190472,0,2,4
54525,4,3,190474,190474,190477,0,3,2
54526,1,3,190475,190477,190480,2,5,0
54527,6,2,190481,190481,190483,0,2,1
54528,6,3,190487,190487,190490,0,3,4
54529,6,1,190493,190493,190494,0,1,3
54530,6,1,190499,190499,190500,0,1,5
54531,4,3,190503,190503,190506,0,3,3
54532,3,1,190506,190506,190507,0,1,0
54533,1,2,190507,190507,190509,0,2,0
54534,2,1,190509,190509,190510,0,1,0
54535,2,3,190511,190511,190514,0,3,1
54536,5,2,190516,190516,190518,0,2,2
54537,6,1,190522,190522,190523,0,1,4
54538,6,2,190528,190528,190530,0,2,5
54539,6,3,190534,190534,190537,0,3,4
54540,3,2,190537,190537,190539,0,2,0
54541,1,2,190538,190539,190541,1,3,0
54542,4,3,190542,190542,190545,0,3,1
54543,6,1,190548,190548,190549,0,1,3
54544,1,3,190549,190549,190552,0,3,0
54545,5,2,190554,190554,190556,0,2,2
54546,3,2,190557,190557,190559,0,2,1
54547,3,2,190560,190560,190562,0,2,1
54548,6,3,190566,190566,190569,0,3,4
54549,6,2,190572,190572,190574,0,2,3
54550,4,3,190576,190576,190579,0,3,2
54551,5,1,190581,190581,190582,0,1,2
54552,3,3,190584,190584,190587,0,3,2
54553,6,2,190590,190590,190592,0,2,3
54554,1,2,190591,190592,190594,1,3,0
54555,6,2,190597,190597,190599,0,2,3
54556,3,3,190600,190600,190603,0,3,1
54557,6,3,190606,190606,190609,0,3,3
54558,2,1,190608,190609,190610,1,2,0
54559,6,3,190614,190614,190617,0,3,4
54560,5,3,190619,190619,190622,0,3,2
54561,1,3,190620,190622,190625,2,5,0
54562,1,2,190621,190625,190627,4,6,0
54563,1,2,190622,190627,190629,5,7,0
54564,1,1,190623,190629,190630,6,7,0
54565,5,3,190628,190630,190633,2,5,0
54566,5,1,190633,190633,190634,0,1,0
54567,1,2,190634,190634,190636,0,2,0
54568,6,2,190640,190640,190642,0,2,4
54569,2,2,190642,190642,190644,0,2,0
54570,3,1,190645,190645,190646,0,1,1
54571,3,3,190648,190648,190651,0,3,2
54572,2,1,190650,190651,190652,1,2,0
54573,6,3,190656,190656,190659,0,3,4
54574,2,1,190658,190659,190660,1,2,0
54575,1,3,190659,190660,190663,1,4,0
54576,4,3,190663,190663,190666,0,3,0
54577,1,3,190664,190666,190669,2,5,0
54578,3,2,190667,190669,190671,2,4,0
54579,1,3,190668,190671,190674,3,6,0
54580,2,1,190670,190674,190675,4,5,0
54581,5,1,190675,190675,190676,0,1,0
54582,6,1,190681,190681,190682,0,1,5
54583,2,1,190683,190683,190684,0,1,1
54584,3,1,190686,190686,190687,0,1,2
54585,4,2,190690,190690,190692,0,2,3
54586,1,1,190691,190692,190693,1,2,0
54587,2,2,190693,190693,190695,0,2,0
54588,5,3,190698,190698,190701,0,3,3
54589,2,1,190700,190701,190702,1,2,0
54590,5,1,190705,190705,190706,0,1,3
54591,1,1,190706,190706,190707,0,1,0
54592,4,2,190710,190710,190712,0,2,3
54593,3,1,190713,190713,190714,0,1,1
54594,6,2,190719,190719,190721,0,2,5
54595,6,3,190725,190725,190728,0,3,4
54596,6,1,190731,190731,190732,0,1,3
54597,3,1,190734,190734,190735,0,1,2
54598,6,2,190740,190740,190742,0,2,5
54599,3,3,190743,190743,190746,0,3,1
54600,2,3,190745,190746,190749,1,4,0
54601,5,1,190750,190750,190751,0,1,1
54602,3,1,190753,190753,190754,0,1,2
54603,5,1,190758,190758,190759,0,1,4
54604,5,1,190763,190763,190764,0,1,4
54605,6,2,190769,190769,190771,0,2,5
54606,1,1,190770,190771,190772,1,2,0
54607,6,1,190776,190776,190777,0,1,4
54608,4,3,190780,190780,190783,0,3,3
54609,6,1,190786,190786,190787,0,1,3
54610,1,2,190787,190787,190789,0,2,0
54611,2,3,190789,190789,190792,0,3,0
54612,4,1,190793,190793,190794,0,1,1
54613,4,2,190797,190797,190799,0,2,3
54614,4,1,190801,190801,190802,0,1,2
54615,2,2,190803,190803,190805,0,2,1
54616,4,2,190807,190807,190809,0,2,2
54617,1,2,190808,190809,190811,1,3,0
54618,3,2,190811,190811,190813,0,2,0
54619,1,2,190812,190813,190815,1,3,0
54620,1,1,190813,190815,190816,2,3,0
54621,5,3,190818,190818,190821,0,3,2
54622,2,2,190820,190821,190823,1,3,0
54623,2,3,190822,190823,190826,1,4,0
54624,4,2,190826,190826,190828,0,2,0
54625,6,2,190832,190832,190834,0,2,4
54626,5,3,190837,190837,190840,0,3,3
54627,4,2,190841,190841,190843,0,2,1
54628,3,3,190844,190844,190847,0,3,1
54629,4,3,190848,190848,190851,0,3,1
54630,5,3,190853,190853,190856,0,3,2
54631,6,3,190859,190859,190862,0,3,3
54632,3,3,190862,190862,190865,0,3,0
54633,2,3,190864,190865,190868,1,4,0
54634,5,1,190869,190869,190870,0,1,1
54635,6,1,190875,190875,190876,0,1,5
54636,6,3,190881,190881,190884,0,3,5
54637,2,1,190883,190884,190885,1,2,0
54638,3,2,190886,190886,190888,0,2,1
54639,2,1,190888,190888,190889,0,1,0
54640,2,3,190890,190890,190893,0,3,1
54641,5,2,190895,190895,190897,0,2,2
54642,5,2,190900,190900,190902,0,2,3
54643,5,2,190905,190905,190907,0,2,3
54644,2,2,190907,190907,190909,0,2,0
54645,2,1,190909,190909,190910,0,1,0
54646,3,1,190912,190912,190913,0,1,2
54647,2,1,190914,190914,190915,0,1,1
54648,3,1,190917,190917,190918,0,1,2
54649,1,3,190918,190918,190921,0,3,0
54650,5,1,190923,190923,190924,0,1,2
54651,5,2,190928,190928,190930,0,2,4
54652,1,3,190929,190930,190933,1,4,0
54653,1,2,190930,190933,190935,3,5,0
54654,6,1,190936,190936,190937,0,1,1
54655,6,1,190942,190942,190943,0,1,5
54656,5,1,190947,190947,190948,0,1,4
54657,6,3,190953,190953,190956,0,3,5
54658,3,2,190956,190956,190958,0,2,0
54659,2,1,190958,190958,190959,0,1,0
54660,1,2,190959,190959,190961,0,2,0
54661,5,2,190964,190964,190966,0,2,3
54662,6,1,190970,190970,190971,0,1,4
54663,6,3,190976,190976,190979,0,3,5
54664,5,2,190981,190981,190983,0,2,2
54665,2,1,190983,190983,190984,0,1,0
54666,1,1,190984,190984,190985,0,1,0
54667,4,1,190988,190988,190989,0,1,3
54668,2,3,190990,190990,190993,0,3,1
54669,5,2,190995,190995,190997,0,2,2
54670,4,1,190999,190999,191000,0,1,2
54671,5,3,191004,191004,191007,0,3,4
54672,5,2,191009,191009,191011,0,2,2
54673,2,3,191011,191011,191014,0,3,0
54674,5,2,191016,191016,191018,0,2,2
54675,4,2,191020,191020,191022,0,2,2
54676,1,2,191021,191022,191024,1,3,0
54677,5,2,191026,191026,191028,0,2,2
54678,2,1,191028,191028,191029,0,1,0
54679,2,2,191030,191030,191032,0,2,1
54680,5,2,191035,191035,191037,0,2,3
54681,1,3,191036,191037,191040,1,4,0
54682,3,3,191039,191040,191043,1,4,0
54683,3,1,191042,191043,191044,1,2,0
54684,6,2,191048,191048,191050,0,2,4
54685,2,1,191050,191050,191051,0,1,0
54686,1,2,191051,191051,191053,0,2,0
54687,2,3,191053,191053,191056,0,3,0
54688,5,3,191058,191058,191061,0,3,2
54689,5,2,191063,191063,191065,0,2,2
54690,5,2,191068,191068,191070,0,2,3
54691,6,2,191074,191074,191076,0,2,4
54692,3,1,191077,191077,191078,0,1,1
54693,1,2,191078,191078,191080,0,2,0
54694,1,3,191079,191080,191083,1,4,0
54695,6,1,191085,191085,191086,0,1,2
54696,4,3,191089,191089,191092,0,3,3
54697,1,3,191090,191092,191095,2,5,0
54698,1,3,191091,191095,191098,4,7,0
54699,4,3,191095,191098,191101,3,6,0
54700,2,1,191097,191101,191102,4,5,0
54701,6,1,191103,191103,191104,0,1,1
54702,5,2,191108,191108,191110,0,2,4
54703,1,1,191109,191110,191111,1,2,0
54704,5,3,191114,191114,191117,0,3,3
54705,5,1,191119,191119,191120,0,1,2
54706,3,1,191122,191122,191123,0,1,2
54707,2,1,191124,191124,191125,0,1,1
54708,4,3,191128,191128,191131,0,3,3
54709,1,1,191129,191131,191132,2,3,0
54710,1,2,191130,191132,191134,2,4,0
54711,3,2,191133,191134,191136,1,3,0
54712,5,3,191138,191138,191141,0,3,2
54713,2,3,191140,191141,191144,1,4,0
54714,6,1,191146,191146,191147,0,1,2
54715,5,3,191151,191151,191154,0,3,4
54716,1,1,191152,191154,191155,2,3,0
54717,3,1,191155,191155,191156,0,1,0
54718,4,2,191159,191159,191161,0,2,3
54719,2,3,191161,191161,191164,0,3,0
54720,2,1,191163,191164,191165,1,2,0
54721,6,1,191169,191169,191170,0,1,4
54722,1,2,191170,191170,191172,0,2,0
54723,1,2,191171,191172,191174,1,3,0
54724,2,3,191173,191174,191177,1,4,0
54725,5,1,191178,191178,191179,0,1,1
54726,1,2,191179,191179,191181,0,2,0
54727,3,2,191182,191182,191184,0,2,1
54728,6,3,191188,191188,191191,0,3,4
54729,4,3,191192,191192,191195,0,3,1
54730,1,1,191193,191195,191196,2,3,0
54731,6,1,191199,191199,191200,0,1,3
54732,4,2,191203,191203,191205,0,2,3
54733,3,1,191206,191206,191207,0,1,1
54734,6,2,191212,191212,191214,0,2,5
54735,2,3,191214,191214,191217,0,3,0
54736,1,2,191215,191217,191219,2,4,0
54737,2,2,191217,191219,191221,2,4,0
54738,1,1,191218,191221,191222,3,4,0
54739,5,3,191223,191223,191226,0,3,1
54740,3,2,191226,191226,191228,0,2,0
54741,5,1,191231,191231,191232,0,1,3
54742,1,1,191232,191232,191233,0,1,0
54743,2,1,191234,191234,191235,0,1,1
54744,6,2,191240,191240,191242,0,2,5
54745,4,2,191244,191244,191246,0,2,2
54746,6,3,191250,191250,191253,0,3,4
54747,1,1,191251,191253,191254,2,3,0
54748,6,2,191257,191257,191259,0,2,3
54749,2,2,191259,191259,191261,0,2,0
54750,5,2,191264,191264,191266,0,2,3
54751,6,3,191270,191270,191273,0,3,4
54752,4,3,191274,191274,191277,0,3,1
54753,1,1,191275,191277,191278,2,3,0
54754,3,2,191278,191278,191280,0,2,0
54755,3,2,191281,191281,191283,0,2,1
54756,5,3,191286,191286,191289,0,3,3
54757,5,2,191291,191291,191293,0,2,2
54758,2,1,191293,191293,191294,0,1,0
54759,4,3,191297,191297,191300,0,3,3
54760,5,3,191302,191302,191305,0,3,2
54761,4,2,191306,191306,191308,0,2,1
54762,6,2,191312,191312,191314,0,2,4
54763,4,3,191316,191316,191319,0,3,2
54764,6,2,191322,191322,191324,0,2,3
54765,5,3,191327,191327,191330,0,3,3
54766,4,1,191331,191331,191332,0,1,1
54767,2,2,191333,191333,191335,0,2,1
54768,4,1,191337,191337,191338,0,1,2
54769,3,2,191340,191340,191342,0,2,2
54770,4,2,191344,191344,191346,0,2,2
54771,1,2,191345,191346,191348,1,3,0
54772,2,1,191347,191348,191349,1,2,0
54773,2,1,191349,191349,191350,0,1,0
54774,5,3,191354,191354,191357,0,3,4
54775,1,1,191355,191357,191358,2,3,0
54776,3,1,191358,191358,191359,0,1,0
54777,5,2,191363,191363,191365,0,2,4
54778,1,3,191364,191365,191368,1,4,0
54779,6,1,191370,191370,191371,0,1,2
54780,5,1,191375,191375,191376,0,1,4
54781,1,3,191376,191376,191379,0,3,0
54782,6,2,191382,191382,191384,0,2,3
54783,3,2,191385,191385,191387,0,2,1
54784,4,2,191389,191389,191391,0,2,2
54785,6,2,191395,191395,191397,0,2,4
54786,2,2,191397,191397,191399,0,2,0
54787,4,1,191401,191401,191402,0,1,2
54788,4,2,191405,191405,191407,0,2,3
54789,4,3,191409,191409,191412,0,3,2
54790,5,1,191414,191414,191415,0,1,2
54791,4,3,191418,191418,191421,0,3,3
54792,2,1,191420,191421,191422,1,2,0
54793,5,3,191425,191425,191428,0,3,3
54794,1,2,191426,191428,191430,2,4,0
54795,1,2,191427,191430,191432,3,5,0
54796,3,3,191430,191432,191435,2,5,0
54797,5,2,191435,191435,191437,0,2,0
54798,2,1,191437,191437,191438,0,1,0
54799,5,2,191442,191442,191444,0,2,4
54800,5,1,191447,191447,191448,0,1,3
54801,1,3,191448,191448,191451,0,3,0
54802,6,2,191454,191454,191456,0,2,3
54803,6,3,191460,191460,191463,0,3,4
54804,1,2,191461,191463,191465,2,4,0
54805,6,2,191467,191467,191469,0,2,2
54806,3,2,191470,191470,191472,0,2,1
54807,3,1,191473,191473,191474,0,1,1
54808,6,1,191479,191479,191480,0,1,5
54809,6,2,191485,191485,191487,0,2,5
54810,5,2,191490,191490,191492,0,2,3
54811,6,2,191496,191496,191498,0,2,4
54812,5,2,191501,191501,191503,0,2,3
54813,5,3,191506,191506,191509,0,3,3
54814,4,3,191510,191510,191513,0,3,1
54815,4,1,191514,191514,191515,0,1,1
54816,5,1,191519,191519,191520,0,1,4
54817,1,2,191520,191520,191522,0,2,0
54818,5,1,191525,191525,191526,0,1,3
54819,6,1,191531,191531,191532,0,1,5
54820,2,3,191533,191533,191536,0,3,1
54821,3,2,191536,191536,191538,0,2,0
54822,2,2,191538,191538,191540,0,2,0
54823,6,1,191544,191544,191545,0,1,4
54824,4,2,191548,191548,191550,0,2,3
54825,6,2,191554,191554,191556,0,2,4
54826,1,3,191555,191556,191559,1,4,0
54827,3,2,191558,191559,191561,1,3,0
54828,1,2,191559,191561,191563,2,4,0
54829,1,3,191560,191563,191566,3,6,0
54830,3,2,191563,191566,191568,3,5,0
54831,1,1,191564,191568,191569,4,5,0
54832,3,1,191567,191569,191570,2,3,0
54833,4,3,191571,191571,191574,0,3,1
54834,3,2,191574,191574,191576,0,2,0
54835,2,2,191576,191576,191578,0,2,0
54836,3,2,191579,191579,191581,0,2,1
54837,5,1,191584,191584,191585,0,1,3
54838,3,3,191587,191587,191590,0,3,2
54839,6,2,191593,191593,191595,0,2,3
54840,1,2,191594,191595,191597,1,3,0
54841,1,1,191595,191597,191598,2,3,0
54842,6,2,191601,191601,191603,0,2,3
54843,4,1,191605,191605,191606,0,1,2
54844,3,3,191608,191608,191611,0,3,2
54845,5,3,191613,191613,191616,0,3,2
54846,3,1,191616,191616,191617,0,1,0
54847,2,2,191618,191618,191620,0,2,1
54848,5,1,191623,191623,191624,0,1,3
54849,5,1,191628,191628,191629,0,1,4
54850,5,1,191633,191633,191634,0,1,4
54851,5,3,191638,191638,191641,0,3,4
54852,1,1,191639,191641,191642,2,3,0
54853,5,1,191644,191644,191645,0,1,2
54854,2,3,191646,191646,191649,0,3,1
54855,2,1,191648,191649,191650,1,2,0
54856,1,1,191649,191650,191651,1,2,0
54857,6,2,191655,191655,191657,0,2,4
54858,1,2,191656,191657,191659,1,3,0
54859,4,3,191660,191660,191663,0,3,1
54860,6,2,191666,191666,191668,0,2,3
54861,4,3,191670,191670,191673,0,3,2
54862,3,2,191673,191673,191675,0,2,0
54863,4,3,191677,191677,191680,0,3,2
54864,1,3,191678,191680,191683,2,5,0
54865,5,1,191683,191683,191684,0,1,0
54866,5,3,191688,191688,191691,0,3,4
54867,4,2,191692,191692,191694,0,2,1
54868,2,1,191694,191694,191695,0,1,0
54869,3,3,191697,191697,191700,0,3,2
54870,5,2,191702,191702,191704,0,2,2
54871,6,2,191708,191708,191710,0,2,4
54872,5,3,191713,191713,191716,0,3,3
54873,3,2,191716,191716,191718,0,2,0
54874,2,1,191718,191718,191719,0,1,0
54875,3,3,191721,191721,191724,0,3,2
54876,6,1,191727,191727,191728,0,1,3
54877,1,1,191728,191728,191729,0,1,0
54878,1,3,191729,191729,191732,0,3,0
54879,5,3,191734,191734,191737,0,3,2
54880,4,3,191738,191738,191741,0,3,1
54881,5,3,191743,191743,191746,0,3,2
54882,6,2,191749,191749,191751,0,2,3
54883,2,2,191751,191751,191753,0,2,0
54884,4,2,191755,191755,191757,0,2,2
54885,6,2,191761,191761,191763,0,2,4
54886,4,3,191765,191765,191768,0,3,2
54887,3,1,191768,191768,191769,0,1,0
54888,2,1,191770,191770,191771,0,1,1
54889,3,3,191773,191773,191776,0,3,2
54890,5,1,191778,191778,191779,0,1,2
54891,4,3,191782,191782,191785,0,3,3
54892,3,3,191785,191785,191788,0,3,0
54893,5,3,191790,191790,191793,0,3,2
54894,4,3,191794,191794,191797,0,3,1
54895,6,1,191800,191800,191801,0,1,3
54896,3,2,191803,191803,191805,0,2,2
54897,6,2,191809,191809,191811,0,2,4
54898,2,2,191811,191811,191813,0,2,0
54899,5,2,191816,191816,191818,0,2,3
54900,1,1,191817,191818,191819,1,2,0
54901,2,3,191819,191819,191822,0,3,0
54902,1,3,191820,191822,191825,2,5,0
54903,1,2,191821,191825,191827,4,6,0
54904,4,3,191825,191827,191830,2,5,0
54905,1,1,191826,191830,191831,4,5,0
54906,3,3,191829,191831,191834,2,5,0
54907,1,3,191830,191834,191837,4,7,0
54908,1,2,191831,191837,191839,6,8,0
54909,1,3,191832,191839,191842,7,10,0
54910,3,3,191835,191842,191845,7,10,0
54911,3,3,191838,191845,191848,7,10,0
54912,5,3,191843,191848,191851,5,8,0
54913,5,3,191848,191851,191854,3,6,0
54914,2,1,191850,191854,191855,4,5,0
54915,4,3,191854,191855,191858,1,4,0
54916,5,3,191859,191859,191862,0,3,1
54917,5,1,191864,191864,191865,0,1,2
54918,5,3,191869,191869,191872,0,3,4
54919,6,3,191875,191875,191878,0,3,3
54920,3,1,191878,191878,191879,0,1,0
54921,5,2,191883,191883,191885,0,2,4
54922,3,1,191886,191886,191887,0,1,1
54923,3,1,191889,191889,191890,0,1,2
54924,5,3,191894,191894,191897,0,3,4
54925,2,2,191896,191897,191899,1,3,0
54926,5,3,191901,191901,191904,0,3,2
54927,6,1,191907,191907,191908,0,1,3
54928,6,2,191913,191913,191915,0,2,5
54929,2,3,191915,191915,191918,0,3,0
54930,1,2,191916,191918,191920,2,4,0
54931,6,1,191922,191922,191923,0,1,2
54932,5,3,191927,191927,191930,0,3,4
54933,3,1,191930,191930,191931,0,1,0
54934,4,1,191934,191934,191935,0,1,3
54935,5,3,191939,191939,191942,0,3,4
54936,4,3,191943,191943,191946,0,3,1
54937,3,1,191946,191946,191947,0,1,0
54938,2,1,191948,191948,191949,0,1,1
54939,1,1,191949,191949,191950,0,1,0
54940,3,2,191952,191952,191954,0,2,2
54941,6,2,191958,191958,191960,0,2,4
54942,1,3,191959,191960,191963,1,4,0
54943,6,3,191965,191965,191968,0,3,2
54944,4,3,191969,191969,191972,0,3,1
54945,2,1,191971,191972,191973,1,2,0
54946,4,1,191975,191975,191976,0,1,2
54947,4,3,191979,191979,191982,0,3,3
54948,1,2,191980,191982,191984,2,4,0
54949,5,2,191985,191985,191987,0,2,1
54950,3,2,191988,191988,191990,0,2,1
54951,4,3,191992,191992,191995,0,3,2
54952,3,1,191995,191995,191996,0,1,0
54953,3,1,191998,191998,191999,0,1,2
54954,6,3,192004,192004,192007,0,3,5
54955,5,2,192009,192009,192011,0,2,2
54956,1,3,192010,192011,192014,1,4,0
54957,2,3,192012,192014,192017,2,5,0
54958,2,1,192014,192017,192018,3,4,0
54959,1,2,192015,192018,192020,3,5,0
54960,6,1,192021,192021,192022,0,1,1
54961,2,1,192023,192023,192024,0,1,1
54962,3,1,192026,192026,192027,0,1,2
54963,1,3,192027,192027,192030,0,3,0
54964,2,3,192029,192030,192033,1,4,0
54965,3,3,192032,192033,192036,1,4,0
54966,3,3,192035,192036,192039,1,4,0
54967,2,1,192037,192039,192040,2,3,0
54968,3,2,192040,192040,192042,0,2,0
54969,5,1,192045,192045,192046,0,1,3
54970,3,2,192048,192048,192050,0,2,2
54971,4,1,192052,192052,192053,0,1,2
54972,6,1,192058,192058,192059,0,1,5
54973,1,3,192059,192059,192062,0,3,0
54974,3,2,192062,192062,192064,0,2,0
54975,3,1,192065,192065,192066,0,1,1
54976,6,3,192071,192071,192074,0,3,5
54977,1,1,192072,192074,192075,2,3,0
54978,6,1,192078,192078,192079,0,1,3
54979,1,2,192079,192079,192081,0,2,0
54980,6,1,192085,192085,192086,0,1,4
54981,5,2,192090,192090,192092,0,2,4
54982,6,1,192096,192096,192097,0,1,4
54983,2,3,192098,192098,192101,0,3,1
54984,2,2,192100,192101,192103,1,3,0
54985,2,3,192102,192103,192106,1,4,0
54986,1,3,192103,192106,192109,3,6,0
54987,6,1,192109,192109,192110,0,1,0
54988,5,1,192114,192114,192115,0,1,4
54989,1,2,192115,192115,192117,0,2,0
54990,4,1,192119,192119,192120,0,1,2
54991,6,3,192125,192125,192128,0,3,5
54992,2,1,192127,192128,192129,1,2,0
54993,2,1,192129,192129,192130,0,1,0
54994,1,1,192130,192130,192131,0,1,0
54995,6,3,192136,192136,192139,0,3,5
54996,3,1,192139,192139,192140,0,1,0
54997,6,1,192145,192145,192146,0,1,5
54998,3,2,192148,192148,192150,0,2,2
54999,6,3,192154,192154,192157,0,3,4
55000,3,1,192157,192157,192158,0,1,0
55001,3,3,192160,192160,192163,0,3,2
55002,4,2,192164,192164,192166,0,2,1
55003,2,1,192166,192166,192167,0,1,0
55004,2,1,192168,192168,192169,0,1,1
55005,3,1,192171,192171,192172,0,1,2
55006,4,2,192175,192175,192177,0,2,3
55007,4,3,192179,192179,192182,0,3,2
55008,2,3,192181,192182,192185,1,4,0
55009,3,2,192184,192185,192187,1,3,0
55010,6,3,192190,192190,192193,0,3,3
55011,4,2,192194,192194,192196,0,2,1
55012,6,3,192200,192200,192203,0,3,4
55013,2,2,192202,192203,192205,1,3,0
55014,2,1,192204,192205,192206,1,2,0
55015,1,1,192205,192206,192207,1,2,0
55016,6,2,192211,192211,192213,0,2,4
55017,2,1,192213,192213,192214,0,1,0
55018,6,2,192219,192219,192221,0,2,5
55019,2,1,192221,192221,192222,0,1,0
55020,6,3,192227,192227,192230,0,3,5
55021,5,1,192232,192232,192233,0,1,2
55022,3,3,192235,192235,192238,0,3,2
55023,1,2,192236,192238,192240,2,4,0
55024,6,2,192242,192242,192244,0,2,2
55025,6,2,192248,192248,192250,0,2,4
55026,4,2,192252,192252,192254,0,2,2
55027,1,2,192253,192254,192256,1,3,0
55028,5,1,192258,192258,192259,0,1,2
55029,2,2,192260,192260,192262,0,2,1
55030,1,1,192261,192262,192263,1,2,0
55031,4,3,192265,192265,192268,0,3,2
55032,6,2,192271,192271,192273,0,2,3
55033,4,2,192275,192275,192277,0,2,2
55034,1,2,192276,192277,192279,1,3,0
55035,2,1,192278,192279,192280,1,2,0
55036,4,3,192282,192282,192285,0,3,2
55037,2,2,192284,192285,192287,1,3,0
55038,3,2,192287,192287,192289,0,2,0
55039,1,2,192288,192289,192291,1,3,0
55040,3,2,192291,192291,192293,0,2,0
55041,3,2,192294,192294,192296,0,2,1
55042,5,3,192299,192299,192302,0,3,3
55043,2,3,192301,192302,192305,1,4,0
55044,3,1,192304,192305,192306,1,2,0
55045,2,2,192306,192306,192308,0,2,0
55046,3,3,192309,192309,192312,0,3,1
55047,3,1,192312,192312,192313,0,1,0
55048,1,1,192313,192313,192314,0,1,0
55049,1,2,192314,192314,192316,0,2,0
55050,5,2,192319,192319,192321,0,2,3
55051,2,3,192321,192321,192324,0,3,0
55052,2,3,192323,192324,192327,1,4,0
55053,1,3,192324,192327,192330,3,6,0
55054,6,3,192330,192330,192333,0,3,0
55055,6,3,192336,192336,192339,0,3,3
55056,6,1,192342,192342,192343,0,1,3
55057,1,1,192343,192343,192344,0,1,0
55058,1,3,192344,192344,192347,0,3,0
55059,6,3,192350,192350,192353,0,3,3
55060,2,3,192352,192353,192356,1,4,0
55061,5,3,192357,192357,192360,0,3,1
55062,1,2,192358,192360,192362,2,4,0
55063,1,3,192359,192362,192365,3,6,0
55064,4,1,192363,192365,192366,2,3,0
55065,2,2,192365,192366,192368,1,3,0
55066,6,2,192371,192371,192373,0,2,3
55067,1,3,192372,192373,192376,1,4,0
55068,3,1,192375,192376,192377,1,2,0
55069,6,3,192381,192381,192384,0,3,4
55070,4,3,192385,192385,192388,0,3,1
55071,3,1,192388,192388,192389,0,1,0
55072,4,2,192392,192392,192394,0,2,3
55073,4,1,192396,192396,192397,0,1,2
55074,3,1,192399,192399,192400,0,1,2
55075,1,3,192400,192400,192403,0,3,0
55076,6,2,192406,192406,192408,0,2,3
55077,4,2,192410,192410,192412,0,2,2
55078,2,3,192412,192412,192415,0,3,0
55079,3,1,192415,192415,192416,0,1,0
55080,6,3,192421,192421,192424,0,3,5
55081,2,3,192423,192424,192427,1,4,0
55082,4,1,192427,192427,192428,0,1,0
55083,3,1,192430,192430,192431,0,1,2
55084,3,2,192433,192433,192435,0,2,2
55085,6,2,192439,192439,192441,0,2,4
55086,4,1,192443,192443,192444,0,1,2
55087,1,1,192444,192444,192445,0,1,0
55088,6,2,192450,192450,192452,0,2,5
55089,1,2,192451,192452,192454,1,3,0
55090,3,3,192454,192454,192457,0,3,0
55091,3,3,192457,192457,192460,0,3,0
55092,5,2,192462,192462,192464,0,2,2
55093,2,1,192464,192464,192465,0,1,0
55094,2,2,192466,192466,192468,0,2,1
55095,5,3,192471,192471,192474,0,3,3
55096,3,3,192474,192474,192477,0,3,0
55097,2,1,192476,192477,192478,1,2,0
55098,5,3,192481,192481,192484,0,3,3
55099,5,1,192486,192486,192487,0,1,2
55100,2,3,192488,192488,192491,0,3,1
55101,4,2,192492,192492,192494,0,2,1
55102,3,1,192495,192495,192496,0,1,1
55103,1,3,192496,192496,192499,0,3,0
55104,5,2,192501,192501,192503,0,2,2
55105,2,1,192503,192503,192504,0,1,0
55106,6,2,192509,192509,192511,0,2,5
55107,3,3,192512,192512,192515,0,3,1
55108,5,2,192517,192517,192519,0,2,2
55109,6,1,192523,192523,192524,0,1,4
55110,3,2,192526,192526,192528,0,2,2
55111,3,2,192529,192529,192531,0,2,1
55112,1,3,192530,192531,192534,1,4,0
55113,2,1,192532,192534,192535,2,3,0
55114,4,3,192536,192536,192539,0,3,1
55115,6,2,192542,192542,192544,0,2,3
55116,6,3,192548,192548,192551,0,3,4
55117,5,2,192553,192553,192555,0,2,2
55118,6,1,192559,192559,192560,0,1,4
55119,2,1,192561,192561,192562,0,1,1
55120,6,1,192567,192567,192568,0,1,5
55121,1,3,192568,192568,192571,0,3,0
55122,3,1,192571,192571,192572,0,1,0
55123,6,3,192577,192577,192580,0,3,5
55124,5,3,192582,192582,192585,0,3,2
55125,4,1,192586,192586,192587,0,1,1
55126,6,3,192592,192592,192595,0,3,5
55127,1,2,192593,192595,192597,2,4,0
55128,6,1,192599,192599,192600,0,1,2
55129,6,1,192605,192605,192606,0,1,5
55130,6,1,192611,192611,192612,0,1,5
55131,3,2,192614,192614,192616,0,2,2
55132,2,3,192616,192616,192619,0,3,0
55133,3,2,192619,192619,192621,0,2,0
55134,2,3,192621,192621,192624,0,3,0
55135,5,3,192626,192626,192629,0,3,2
55136,6,1,192632,192632,192633,0,1,3
55137,2,3,192634,192634,192637,0,3,1
55138,4,2,192638,192638,192640,0,2,1
55139,6,1,192644,192644,192645,0,1,4
55140,1,3,192645,192645,192648,0,3,0
55141,2,2,192647,192648,192650,1,3,0
55142,3,1,192650,192650,192651,0,1,0
55143,1,1,192651,192651,192652,0,1,0
55144,3,1,192654,192654,192655,0,1,2
55145,3,2,192657,192657,192659,0,2,2
55146,1,3,192658,192659,192662,1,4,0
55147,1,2,192659,192662,192664,3,5,0
55148,1,3,192660,192664,192667,4,7,0
55149,4,1,192664,192667,192668,3,4,0
55150,5,3,192669,192669,192672,0,3,1
55151,5,1,192674,192674,192675,0,1,2
55152,2,3,192676,192676,192679,0,3,1
55153,3,1,192679,192679,192680,0,1,0
55154,2,1,192681,192681,192682,0,1,1
55155,1,3,192682,192682,192685,0,3,0
55156,1,3,192683,192685,192688,2,5,0
55157,3,2,192686,192688,192690,2,4,0
55158,2,1,192688,192690,192691,2,3,0
55159,2,1,192690,192691,192692,1,2,0
55160,5,3,192695,192695,192698,0,3,3
55161,5,3,192700,192700,192703,0,3,2
55162,4,2,192704,192704,192706,0,2,1
55163,3,1,192707,192707,192708,0,1,1
55164,2,2,192709,192709,192711,0,2,1
55165,2,1,192711,192711,192712,0,1,0
55166,2,1,192713,192713,192714,0,1,1
55167,3,3,192716,192716,192719,0,3,2
55168,4,1,192720,192720,192721,0,1,1
55169,1,3,192721,192721,192724,0,3,0
55170,4,2,192725,192725,192727,0,2,1
55171,5,3,192730,192730,192733,0,3,3
55172,1,3,192731,192733,192736,2,5,0
55173,1,1,192732,192736,192737,4,5,0
55174,6,1,192738,192738,192739,0,1,1
55175,3,1,192741,192741,192742,0,1,2
55176,3,3,192744,192744,192747,0,3,2
55177,3,3,192747,192747,192750,0,3,0
55178,5,1,192752,192752,192753,0,1,2
55179,5,2,192757,192757,192759,0,2,4
55180,5,2,192762,192762,192764,0,2,3
55181,5,2,192767,192767,192769,0,2,3
55182,6,1,192773,192773,192774,0,1,4
55183,4,2,192777,192777,192779,0,2,3
55184,3,1,192780,192780,192781,0,1,1
55185,4,1,192784,192784,192785,0,1,3
55186,6,1,192790,192790,192791,0,1,5
55187,1,3,192791,192791,192794,0,3,0
55188,2,3,192793,192794,192797,1,4,0
55189,5,2,192798,192798,192800,0,2,1
55190,6,2,192804,192804,192806,0,2,4
55191,4,2,192808,192808,192810,0,2,2
55192,1,3,192809,192810,192813,1,4,0
55193,5,2,192814,192814,192816,0,2,1
55194,1,3,192815,192816,192819,1,4,0
55195,2,2,192817,192819,192821,2,4,0
55196,3,3,192820,192821,192824,1,4,0
55197,3,1,192823,192824,192825,1,2,0
55198,2,1,192825,192825,192826,0,1,0
55199,4,1,192829,192829,192830,0,1,3
55200,5,1,192834,192834,192835,0,1,4
55201,5,1,192839,192839,192840,0,1,4
55202,6,2,192845,192845,192847,0,2,5
55203,5,3,192850,192850,192853,0,3,3
55204,3,1,192853,192853,192854,0,1,0
55205,6,2,192859,192859,192861,0,2,5
55206,2,2,192861,192861,192863,0,2,0
55207,1,2,192862,192863,192865,1,3,0
55208,6,3,192868,192868,192871,0,3,3
55209,5,1,192873,192873,192874,0,1,2
55210,6,3,192879,192879,192882,0,3,5
55211,5,2,192884,192884,192886,0,2,2
55212,6,2,192890,192890,192892,0,2,4
55213,5,1,192895,192895,192896,0,1,3
55214,5,1,192900,192900,192901,0,1,4
55215,2,3,192902,192902,192905,0,3,1
55216,1,2,192903,192905,192907,2,4,0
55217,4,1,192907,192907,192908,0,1,0
55218,5,1,192912,192912,192913,0,1,4
55219,1,1,192913,192913,192914,0,1,0
55220,5,2,192918,192918,192920,0,2,4
55221,2,2,192920,192920,192922,0,2,0
55222,6,2,192926,192926,192928,0,2,4
55223,3,3,192929,192929,192932,0,3,1
55224,6,3,192935,192935,192938,0,3,3
55225,1,3,192936,192938,192941,2,5,0
55226,6,3,192942,192942,192945,0,3,1
55227,1,1,192943,192945,192946,2,3,0
55228,3,3,192946,192946,192949,0,3,0
55229,3,2,192949,192949,192951,0,2,0
55230,3,3,192952,192952,192955,0,3,1
55231,5,2,192957,192957,192959,0,2,2
55232,1,3,192958,192959,192962,1,4,0
55233,1,3,192959,192962,192965,3,6,0
55234,1,2,192960,192965,192967,5,7,0
55235,2,3,192962,192967,192970,5,8,0
55236,6,3,192968,192970,192973,2,5,0
55237,6,2,192974,192974,192976,0,2,1
55238,1,2,192975,192976,192978,1,3,0
55239,1,2,192976,192978,192980,2,4,0
55240,2,3,192978,192980,192983,2,5,0
55241,2,2,192980,192983,192985,3,5,0
55242,2,2,192982,192985,192987,3,5,0
55243,6,3,192988,192988,192991,0,3,1
55244,4,3,192992,192992,192995,0,3,1
55245,3,2,192995,192995,192997,0,2,0
55246,6,2,193001,193001,193003,0,2,4
55247,1,1,193002,193003,193004,1,2,0
55248,6,1,193008,193008,193009,0,1,4
55249,5,2,193013,193013,193015,0,2,4
55250,6,2,193019,193019,193021,0,2,4
55251,5,2,193024,193024,193026,0,2,3
55252,5,1,193029,193029,193030,0,1,3
55253,1,3,193030,193030,193033,0,3,0
55254,1,3,193031,193033,193036,2,5,0
55255,6,2,193037,193037,193039,0,2,1
55256,2,1,193039,193039,193040,0,1,0
55257,5,3,193044,193044,193047,0,3,4
55258,4,3,193048,193048,193051,0,3,1
55259,6,2,193054,193054,193056,0,2,3
55260,1,1,193055,193056,193057,1,2,0
55261,1,2,193056,193057,193059,1,3,0
55262,6,3,193062,193062,193065,0,3,3
55263,2,1,193064,193065,193066,1,2,0
55264,5,2,193069,193069,193071,0,2,3
55265,3,1,193072,193072,193073,0,1,1
55266,6,3,193078,193078,193081,0,3,5
55267,4,2,193082,193082,193084,0,2,1
55268,2,3,193084,193084,193087,0,3,0
55269,4,2,193088,193088,193090,0,2,1
55270,5,3,193093,193093,193096,0,3,3
55271,1,1,193094,193096,193097,2,3,0
55272,1,2,193095,193097,193099,2,4,0
55273,6,1,193101,193101,193102,0,1,2
55274,1,3,193102,193102,193105,0,3,0
55275,3,3,193105,193105,193108,0,3,0
55276,4,2,193109,193109,193111,0,2,1
55277,5,3,193114,193114,193117,0,3,3
55278,6,2,193120,193120,193122,0,2,3
55279,4,1,193124,193124,193125,0,1,2
55280,3,1,193127,193127,193128,0,1,2
55281,3,1,193130,193130,193131,0,1,2
55282,3,3,193133,193133,193136,0,3,2
55283,5,3,193138,193138,193141,0,3,2
55284,2,2,193140,193141,193143,1,3,0
55285,3,2,193143,193143,193145,0,2,0
55286,6,1,193149,193149,193150,0,1,4
55287,1,2,193150,193150,193152,0,2,0
55288,5,1,193155,193155,193156,0,1,3
55289,2,3,193157,193157,193160,0,3,1
55290,2,1,193159,193160,193161,1,2,0
55291,5,2,193164,193164,193166,0,2,3
55292,6,3,193170,193170,193173,0,3,4
55293,5,1,193175,193175,193176,0,1,2
55294,5,1,193180,193180,193181,0,1,4
55295,3,1,193183,193183,193184,0,1,2
55296,1,2,193184,193184,193186,0,2,0
55297,6,2,193190,193190,193192,0,2,4
55298,5,2,193195,193195,193197,0,2,3
55299,2,2,193197,193197,193199,0,2,0
55300,5,3,193202,193202,193205,0,3,3
55301,4,1,193206,193206,193207,0,1,1
55302,1,2,193207,193207,193209,0,2,0
55303,5,3,193212,193212,193215,0,3,3
55304,5,1,193217,193217,193218,0,1,2
55305,1,2,193218,193218,193220,0,2,0
55306,2,1,193220,193220,193221,0,1,0
55307,6,2,193226,193226,193228,0,2,5
55308,4,2,193230,193230,193232,0,2,2
55309,6,3,193236,193236,193239,0,3,4
55310,4,2,193240,193240,193242,0,2,1
55311,6,3,193246,193246,193249,0,3,4
55312,2,2,193248,193249,193251,1,3,0
55313,6,3,193254,193254,193257,0,3,3
55314,5,3,193259,193259,193262,0,3,2
55315,6,3,193265,193265,193268,0,3,3
55316,3,2,193268,193268,193270,0,2,0
55317,3,2,193271,193271,193273,0,2,1
55318,2,1,193273,193273,193274,0,1,0
55319,6,3,193279,193279,193282,0,3,5
55320,1,2,193280,193282,193284,2,4,0
55321,2,1,193282,193284,193285,2,3,0
55322,5,3,193287,193287,193290,0,3,2
55323,4,2,193291,193291,193293,0,2,1
55324,5,2,193296,193296,193298,0,2,3
55325,2,3,193298,193298,193301,0,3,0
55326,6,3,193304,193304,193307,0,3,3
55327,3,2,193307,193307,193309,0,2,0
55328,1,3,193308,193309,193312,1,4,0
55329,5,2,193313,193313,193315,0,2,1
55330,4,1,193317,193317,193318,0,1,2
55331,4,3,193321,193321,193324,0,3,3
55332,3,3,193324,193324,193327,0,3,0
55333,6,2,193330,193330,193332,0,2,3
55334,1,2,193331,193332,193334,1,3,0
55335,4,2,193335,193335,193337,0,2,1
55336,6,3,193341,193341,193344,0,3,4
55337,6,2,193347,193347,193349,0,2,3
55338,2,2,193349,193349,193351,0,2,0
55339,5,3,193354,193354,193357,0,3,3
55340,2,3,193356,193357,193360,1,4,0
55341,4,3,193360,193360,193363,0,3,0
55342,1,1,193361,193363,193364,2,3,0
55343,4,3,193365,193365,193368,0,3,1
55344,1,2,193366,193368,193370,2,4,0
55345,6,1,193372,193372,193373,0,1,2
55346,3,1,193375,193375,193376,0,1,2
55347,5,2,193380,193380,193382,0,2,4
55348,1,3,193381,193382,193385,1,4,0
55349,1,3,193382,193385,193388,3,6,0
55350,2,2,193384,193388,193390,4,6,0
55351,1,3,193385,193390,193393,5,8,0
55352,3,1,193388,193393,193394,5,6,0
55353,2,2,193390,193394,193396,4,6,0
55354,1,2,193391,193396,193398,5,7,0
55355,2,3,193393,193398,193401,5,8,0
55356,5,1,193398,193401,193402,3,4,0
55357,1,2,193399,193402,193404,3,5,0
55358,4,3,193403,193404,193407,1,4,0
55359,2,3,193405,193407,193410,2,5,0
55360,5,1,193410,193410,193411,0,1,0
55361,3,1,193413,193413,193414,0,1,2
55362,4,1,193417,193417,193418,0,1,3
55363,2,1,193419,193419,193420,0,1,1
55364,3,3,193422,193422,193425,0,3,2
55365,1,2,193423,193425,193427,2,4,0
55366,3,2,193426,193427,193429,1,3,0
55367,6,2,193432,193432,193434,0,2,3
55368,5,1,193437,193437,193438,0,1,3
55369,2,3,193439,193439,193442,0,3,1
55370,4,1,193443,193443,193444,0,1,1
55371,2,2,193445,193445,193447,0,2,1
55372,1,1,193446,193447,193448,1,2,0
55373,6,1,193452,193452,193453,0,1,4
55374,5,2,193457,193457,193459,0,2,4
55375,3,1,193460,193460,193461,0,1,1
55376,6,2,193466,193466,193468,0,2,5
55377,1,2,193467,193468,193470,1,3,0
55378,2,2,193469,193470,193472,1,3,0
55379,2,3,193471,193472,193475,1,4,0
55380,1,3,193472,193475,193478,3,6,0
55381,1,3,193473,193478,193481,5,8,0
55382,4,3,193477,193481,193484,4,7,0
55383,6,1,193483,193484,193485,1,2,0
55384,4,2,193487,193487,193489,0,2,2
55385,6,2,193493,193493,193495,0,2,4
55386,1,2,193494,193495,193497,1,3,0
55387,3,2,193497,193497,193499,0,2,0
55388,5,1,193502,193502,193503,0,1,3
55389,3,2,193505,193505,193507,0,2,2
55390,5,2,193510,193510,193512,0,2,3
55391,4,1,193514,193514,193515,0,1,2
55392,4,1,193518,193518,193519,0,1,3
55393,3,2,193521,193521,193523,0,2,2
55394,3,2,193524,193524,193526,0,2,1
55395,4,1,193528,193528,193529,0,1,2
55396,5,3,193533,193533,193536,0,3,4
55397,6,3,193539,193539,193542,0,3,3
55398,1,3,193540,193542,193545,2,5,0
55399,1,2,193541,193545,193547,4,6,0
55400,4,1,193545,193547,193548,2,3,0
55401,6,1,193551,193551,193552,0,1,3
55402,1,3,193552,193552,193555,0,3,0
55403,2,2,193554,193555,193557,1,3,0
55404,1,1,193555,193557,193558,2,3,0
55405,3,2,193558,193558,193560,0,2,0
55406,3,1,193561,193561,193562,0,1,1
55407,2,3,193563,193563,193566,0,3,1
55408,3,1,193566,193566,193567,0,1,0
55409,1,1,193567,193567,193568,0,1,0
55410,5,1,193572,193572,193573,0,1,4
55411,5,1,193577,193577,193578,0,1,4
55412,5,2,193582,193582,193584,0,2,4
55413,5,1,193587,193587,193588,0,1,3
55414,3,1,193590,193590,193591,0,1,2
55415,1,1,193591,193591,193592,0,1,0
55416,1,3,193592,193592,193595,0,3,0
55417,4,2,193596,193596,193598,0,2,1
55418,6,1,193602,193602,193603,0,1,4
55419,2,1,193604,193604,193605,0,1,1
55420,5,1,193609,193609,193610,0,1,4
55421,5,1,193614,193614,193615,0,1,4
55422,2,2,193616,193616,193618,0,2,1
55423,2,2,193618,193618,193620,0,2,0
55424,4,1,193622,193622,193623,0,1,2
55425,3,1,193625,193625,193626,0,1,2
55426,3,1,193628,193628,193629,0,1,2
55427,6,1,193634,193634,193635,0,1,5
55428,1,2,193635,193635,193637,0,2,0
55429,2,3,193637,193637,193640,0,3,0
55430,6,1,193643,193643,193644,0,1,3
55431,3,3,193646,193646,193649,0,3,2
55432,5,1,193651,193651,193652,0,1,2
55433,3,3,193654,193654,193657,0,3,2
55434,1,2,193655,193657,193659,2,4,0
55435,1,1,193656,193659,193660,3,4,0
55436,5,2,193661,193661,193663,0,2,1
55437,6,2,193667,193667,193669,0,2,4
55438,2,2,193669,193669,193671,0,2,0
55439,4,1,193673,193673,193674,0,1,2
55440,3,2,193676,193676,193678,0,2,2
55441,2,2,193678,193678,193680,0,2,0
55442,2,2,193680,193680,193682,0,2,0
55443,2,3,193682,193682,193685,0,3,0
55444,1,1,193683,193685,193686,2,3,0
55445,4,2,193687,193687,193689,0,2,1
55446,3,3,193690,193690,193693,0,3,1
55447,4,1,193694,193694,193695,0,1,1
55448,3,2,193697,193697,193699,0,2,2
55449,2,3,193699,193699,193702,0,3,0
55450,3,1,193702,193702,193703,0,1,0
55451,1,3,193703,193703,193706,0,3,0
55452,5,2,193708,193708,193710,0,2,2
55453,3,1,193711,193711,193712,0,1,1
55454,5,1,193716,193716,193717,0,1,4
55455,1,1,193717,193717,193718,0,1,0
55456,4,2,193721,193721,193723,0,2,3
55457,1,3,193722,193723,193726,1,4,0
55458,2,1,193724,193726,193727,2,3,0
55459,1,2,193725,193727,193729,2,4,0
55460,1,3,193726,193729,193732,3,6,0
55461,3,3,193729,193732,193735,3,6,0
55462,6,3,193735,193735,193738,0,3,0
55463,4,3,193739,193739,193742,0,3,1
55464,3,2,193742,193742,193744,0,2,0
55465,1,3,193743,193744,193747,1,4,0
55466,3,2,193746,193747,193749,1,3,0
55467,1,3,193747,193749,193752,2,5,0
55468,6,3,193753,193753,193756,0,3,1
55469,4,2,193757,193757,193759,0,2,1
55470,2,2,193759,193759,193761,0,2,0
55471,6,3,193765,193765,193768,0,3,4
55472,5,2,193770,193770,193772,0,2,2
55473,1,1,193771,193772,193773,1,2,0
55474,4,1,193775,193775,193776,0,1,2
55475,1,3,193776,193776,193779,0,3,0
55476,2,2,193778,193779,193781,1,3,0
55477,2,1,193780,193781,193782,1,2,0
55478,4,3,193784,193784,193787,0,3,2
55479,1,3,193785,193787,193790,2,5,0
55480,4,3,193789,193790,193793,1,4,0
55481,6,3,193795,193795,193798,0,3,2
55482,2,2,193797,193798,193800,1,3,0
55483,6,1,193803,193803,193804,0,1,3
55484,1,1,193804,193804,193805,0,1,0
55485,5,2,193809,193809,193811,0,2,4
55486,1,2,193810,193811,193813,1,3,0
55487,2,3,193812,193813,193816,1,4,0
55488,6,3,193818,193818,193821,0,3,2
55489,4,2,193822,193822,193824,0,2,1
55490,6,1,193828,193828,193829,0,1,4
55491,1,3,193829,193829,193832,0,3,0
55492,3,2,193832,193832,193834,0,2,0
55493,3,2,193835,193835,193837,0,2,1
55494,2,3,193837,193837,193840,0,3,0
55495,1,1,193838,193840,193841,2,3,0
55496,4,2,193842,193842,193844,0,2,1
55497,2,3,193844,193844,193847,0,3,0
55498,2,1,193846,193847,193848,1,2,0
55499,3,1,193849,193849,193850,0,1,1
55500,3,2,193852,193852,193854,0,2,2
55501,5,2,193857,193857,193859,0,2,3
55502,4,2,193861,193861,193863,0,2,2
55503,2,3,193863,193863,193866,0,3,0
55504,2,1,193865,193866,193867,1,2,0
55505,1,3,193866,193867,193870,1,4,0
55506,1,2,193867,193870,193872,3,5,0
55507,3,2,193870,193872,193874,2,4,0
55508,6,3,193876,193876,193879,0,3,2
55509,5,3,193881,193881,193884,0,3,2
55510,4,2,193885,193885,193887,0,2,1
55511,1,3,193886,193887,193890,1,4,0
55512,3,2,193889,193890,193892,1,3,0
55513,3,2,193892,193892,193894,0,2,0
55514,4,3,193896,193896,193899,0,3,2
55515,6,1,193902,193902,193903,0,1,3
55516,5,1,193907,193907,193908,0,1,4
55517,3,1,193910,193910,193911,0,1,2
55518,2,3,193912,193912,193915,0,3,1
55519,6,2,193918,193918,193920,0,2,3
55520,2,2,193920,193920,193922,0,2,0
55521,2,1,193922,193922,193923,0,1,0
55522,6,1,193928,193928,193929,0,1,5
55523,5,2,193933,193933,193935,0,2,4
55524,2,2,193935,193935,193937,0,2,0
55525,3,3,193938,193938,193941,0,3,1
55526,4,1,193942,193942,193943,0,1,1
55527,6,3,193948,193948,193951,0,3,5
55528,3,1,193951,193951,193952,0,1,0
55529,5,3,193956,193956,193959,0,3,4
55530,2,2,193958,193959,193961,1,3,0
55531,2,2,193960,193961,193963,1,3,0
55532,5,1,193965,193965,193966,0,1,2
55533,6,2,193971,193971,193973,0,2,5
55534,5,3,193976,193976,193979,0,3,3
55535,2,2,193978,193979,193981,1,3,0
55536,3,1,193981,193981,193982,0,1,0
55537,5,2,193986,193986,193988,0,2,4
55538,1,2,193987,193988,193990,1,3,0
55539,4,1,193991,193991,193992,0,1,1
55540,6,1,193997,193997,193998,0,1,5
55541,2,1,193999,193999,194000,0,1,1
55542,6,1,194005,194005,194006,0,1,5
55543,4,1,194009,194009,194010,0,1,3
55544,6,2,194015,194015,194017,0,2,5
55545,6,2,194021,194021,194023,0,2,4
55546,2,1,194023,194023,194024,0,1,0
55547,5,2,194028,194028,194030,0,2,4
55548,2,1,194030,194030,194031,0,1,0
55549,4,1,194034,194034,194035,0,1,3
55550,3,3,194037,194037,194040,0,3,2
55551,5,2,194042,194042,194044,0,2,2
55552,4,1,194046,194046,194047,0,1,2
55553,3,1,194049,194049,194050,0,1,2
55554,1,2,194050,194050,194052,0,2,0
55555,5,2,194055,194055,194057,0,2,3
55556,5,1,194060,194060,194061,0,1,3
55557,6,1,194066,194066,194067,0,1,5
55558,1,1,194067,194067,194068,0,1,0
55559,6,2,194073,194073,194075,0,2,5
55560,4,3,194077,194077,194080,0,3,2
55561,6,2,194083,194083,194085,0,2,3
55562,6,2,194089,194089,194091,0,2,4
55563,6,1,194095,194095,194096,0,1,4
55564,1,2,194096,194096,194098,0,2,0
55565,5,1,194101,194101,194102,0,1,3
55566,6,2,194107,194107,194109,0,2,5
55567,6,1,194113,194113,194114,0,1,4
55568,1,1,194114,194114,194115,0,1,0
55569,3,1,194117,194117,194118,0,1,2
55570,2,2,194119,194119,194121,0,2,1
55571,3,3,194122,194122,194125,0,3,1
55572,3,1,194125,194125,194126,0,1,0
55573,6,1,194131,194131,194132,0,1,5
55574,1,3,194132,194132,194135,0,3,0
55575,2,3,194134,194135,194138,1,4,0
55576,6,3,194140,194140,194143,0,3,2
55577,2,1,194142,194143,194144,1,2,0
55578,4,2,194146,194146,194148,0,2,2
55579,3,1,194149,194149,194150,0,1,1
55580,5,2,194154,194154,194156,0,2,4
55581,2,3,194156,194156,194159,0,3,0
55582,6,1,194162,194162,194163,0,1,3
55583,3,3,194165,194165,194168,0,3,2
55584,6,1,194171,194171,194172,0,1,3
55585,2,2,194173,194173,194175,0,2,1
55586,6,3,194179,194179,194182,0,3,4
55587,1,3,194180,194182,194185,2,5,0
55588,3,3,194183,194185,194188,2,5,0
55589,5,1,194188,194188,194189,0,1,0
55590,4,2,194192,194192,194194,0,2,3
55591,2,1,194194,194194,194195,0,1,0
55592,3,3,194197,194197,194200,0,3,2
55593,4,2,194201,194201,194203,0,2,1
55594,3,1,194204,194204,194205,0,1,1
55595,3,2,194207,194207,194209,0,2,2
55596,6,2,194213,194213,194215,0,2,4
55597,6,3,194219,194219,194222,0,3,4
55598,1,3,194220,194222,194225,2,5,0
55599,5,2,194225,194225,194227,0,2,0
55600,4,2,194229,194229,194231,0,2,2
55601,5,2,194234,194234,194236,0,2,3
55602,4,2,194238,194238,194240,0,2,2
55603,5,1,194243,194243,194244,0,1,3
55604,3,2,194246,194246,194248,0,2,2
55605,6,2,194252,194252,194254,0,2,4
55606,2,2,194254,194254,194256,0,2,0
55607,5,1,194259,194259,194260,0,1,3
55608,4,3,194263,194263,194266,0,3,3
55609,3,2,194266,194266,194268,0,2,0
55610,4,1,194270,194270,194271,0,1,2
55611,1,3,194271,194271,194274,0,3,0
55612,1,1,194272,194274,194275,2,3,0
55613,3,2,194275,194275,194277,0,2,0
55614,5,1,194280,194280,194281,0,1,3
55615,1,1,194281,194281,194282,0,1,0
55616,6,1,194287,194287,194288,0,1,5
55617,4,3,194291,194291,194294,0,3,3
55618,5,2,194296,194296,194298,0,2,2
55619,5,1,194301,194301,194302,0,1,3
55620,1,3,194302,194302,194305,0,3,0
55621,2,2,194304,194305,194307,1,3,0
55622,3,1,194307,194307,194308,0,1,0
55623,1,3,194308,194308,194311,0,3,0
55624,2,1,194310,194311,194312,1,2,0
55625,5,2,194315,194315,194317,0,2,3
55626,1,3,194316,194317,194320,1,4,0
55627,2,3,194318,194320,194323,2,5,0
55628,3,1,194321,194323,194324,2,3,0
55629,6,1,194327,194327,194328,0,1,3
55630,1,1,194328,194328,194329,0,1,0
55631,3,2,194331,194331,194333,0,2,2
55632,4,1,194335,194335,194336,0,1,2
55633,6,2,194341,194341,194343,0,2,5
55634,4,1,194345,194345,194346,0,1,2
55635,2,3,194347,194347,194350,0,3,1
55636,5,3,194352,194352,194355,0,3,2
55637,2,2,194354,194355,194357,1,3,0
55638,1,1,194355,194357,194358,2,3,0
55639,4,2,194359,194359,194361,0,2,1
55640,4,2,194363,194363,194365,0,2,2
55641,2,1,194365,194365,194366,0,1,0
55642,6,3,194371,194371,194374,0,3,5
55643,4,1,194375,194375,194376,0,1,1
55644,3,1,194378,194378,194379,0,1,2
55645,4,3,194382,194382,194385,0,3,3
55646,4,3,194386,194386,194389,0,3,1
55647,1,2,194387,194389,194391,2,4,0
55648,6,1,194393,194393,194394,0,1,2
55649,3,3,194396,194396,194399,0,3,2
55650,3,2,194399,194399,194401,0,2,0
55651,4,1,194403,194403,194404,0,1,2
55652,3,3,194406,194406,194409,0,3,2
55653,4,3,194410,194410,194413,0,3,1
55654,2,3,194412,194413,194416,1,4,0
55655,2,1,194414,194416,194417,2,3,0
55656,2,1,194416,194417,194418,1,2,0
55657,5,1,194421,194421,194422,0,1,3
55658,6,2,194427,194427,194429,0,2,5
55659,4,1,194431,194431,194432,0,1,2
55660,4,1,194435,194435,194436,0,1,3
55661,2,1,194437,194437,194438,0,1,1
55662,2,3,194439,194439,194442,0,3,1
55663,4,2,194443,194443,194445,0,2,1
55664,3,3,194446,194446,194449,0,3,1
55665,2,1,194448,194449,194450,1,2,0
55666,4,3,194452,194452,194455,0,3,2
55667,3,2,194455,194455,194457,0,2,0
55668,4,1,194459,194459,194460,0,1,2
55669,5,3,194464,194464,194467,0,3,4
55670,6,3,194470,194470,194473,0,3,3
55671,1,1,194471,194473,194474,2,3,0
55672,2,2,194473,194474,194476,1,3,0
55673,6,1,194479,194479,194480,0,1,3
55674,4,1,194483,194483,194484,0,1,3
55675,6,2,194489,194489,194491,0,2,5
55676,3,1,194492,194492,194493,0,1,1
55677,2,2,194494,194494,194496,0,2,1
55678,3,1,194497,194497,194498,0,1,1
55679,4,3,194501,194501,194504,0,3,3
55680,5,1,194506,194506,194507,0,1,2
55681,3,3,194509,194509,194512,0,3,2
55682,3,2,194512,194512,194514,0,2,0
55683,3,2,194515,194515,194517,0,2,1
55684,1,1,194516,194517,194518,1,2,0
55685,6,2,194522,194522,194524,0,2,4
55686,5,3,194527,194527,194530,0,3,3
55687,3,2,194530,194530,194532,0,2,0
55688,5,1,194535,194535,194536,0,1,3
55689,4,3,194539,194539,194542,0,3,3
55690,2,3,194541,194542,194545,1,4,0
55691,5,1,194546,194546,194547,0,1,1
55692,5,1,194551,194551,194552,0,1,4
55693,6,2,194557,194557,194559,0,2,5
55694,4,2,194561,194561,194563,0,2,2
55695,1,3,194562,194563,194566,1,4,0
55696,2,2,194564,194566,194568,2,4,0
55697,4,2,194568,194568,194570,0,2,0
55698,1,3,194569,194570,194573,1,4,0
55699,1,3,194570,194573,194576,3,6,0
55700,6,1,194576,194576,194577,0,1,0
55701,5,2,194581,194581,194583,0,2,4
55702,6,2,194587,194587,194589,0,2,4
55703,4,1,194591,194591,194592,0,1,2
55704,4,1,194595,194595,194596,0,1,3
55705,1,2,194596,194596,194598,0,2,0
55706,4,2,194600,194600,194602,0,2,2
55707,5,2,194605,194605,194607,0,2,3
55708,5,3,194610,194610,194613,0,3,3
55709,6,3,194616,194616,194619,0,3,3
55710,1,2,194617,194619,194621,2,4,0
55711,5,3,194622,194622,194625,0,3,1
55712,3,2,194625,194625,194627,0,2,0
55713,2,2,194627,194627,194629,0,2,0
55714,2,2,194629,194629,194631,0,2,0
55715,1,1,194630,194631,194632,1,2,0
55716,6,2,194636,194636,194638,0,2,4
55717,5,3,194641,194641,194644,0,3,3
55718,1,3,194642,194644,194647,2,5,0
55719,3,1,194645,194647,194648,2,3,0
55720,5,3,194650,194650,194653,0,3,2
55721,5,1,194655,194655,194656,0,1,2
55722,3,1,194658,194658,194659,0,1,2
55723,5,2,194663,194663,194665,0,2,4
55724,5,2,194668,194668,194670,0,2,3
55725,1,2,194669,194670,194672,1,3,0
55726,4,2,194673,194673,194675,0,2,1
55727,6,1,194679,194679,194680,0,1,4
55728,1,2,194680,194680,194682,0,2,0
55729,1,3,194681,194682,194685,1,4,0
55730,1,1,194682,194685,194686,3,4,0
55731,5,1,194687,194687,194688,0,1,1
55732,6,2,194693,194693,194695,0,2,5
55733,2,3,194695,194695,194698,0,3,0
55734,4,2,194699,194699,194701,0,2,1
55735,2,1,194701,194701,194702,0,1,0
55736,2,1,194703,194703,194704,0,1,1
55737,3,1,194706,194706,194707,0,1,2
55738,3,3,194709,194709,194712,0,3,2
55739,3,2,194712,194712,194714,0,2,0
55740,6,1,194718,194718,194719,0,1,4
55741,1,3,194719,194719,194722,0,3,0
55742,2,3,194721,194722,194725,1,4,0
55743,6,1,194727,194727,194728,0,1,2
55744,5,1,194732,194732,194733,0,1,4
55745,4,2,194736,194736,194738,0,2,3
55746,2,1,194738,194738,194739,0,1,0
55747,6,1,194744,194744,194745,0,1,5
55748,4,3,194748,194748,194751,0,3,3
55749,4,2,194752,194752,194754,0,2,1
55750,4,1,194756,194756,194757,0,1,2
55751,6,2,194762,194762,194764,0,2,5
55752,1,2,194763,194764,194766,1,3,0
55753,6,2,194769,194769,194771,0,2,3
55754,2,3,194771,194771,194774,0,3,0
55755,2,2,194773,194774,194776,1,3,0
55756,4,3,194777,194777,194780,0,3,1
55757,2,3,194779,194780,194783,1,4,0
55758,5,2,194784,194784,194786,0,2,1
55759,1,2,194785,194786,194788,1,3,0
55760,6,3,194791,194791,194794,0,3,3
55761,2,2,194793,194794,194796,1,3,0
55762,1,3,194794,194796,194799,2,5,0
55763,2,2,194796,194799,194801,3,5,0
55764,3,1,194799,194801,194802,2,3,0
55765,4,3,194803,194803,194806,0,3,1
55766,3,2,194806,194806,194808,0,2,0
55767,4,1,194810,194810,194811,0,1,2
55768,2,2,194812,194812,194814,0,2,1
55769,4,3,194816,194816,194819,0,3,2
55770,6,1,194822,194822,194823,0,1,3
55771,1,1,194823,194823,194824,0,1,0
55772,2,2,194825,194825,194827,0,2,1
55773,5,1,194830,194830,194831,0,1,3
55774,3,2,194833,194833,194835,0,2,2
55775,4,1,194837,194837,194838,0,1,2
55776,2,2,194839,194839,194841,0,2,1
55777,4,1,194843,194843,194844,0,1,2
55778,1,2,194844,194844,194846,0,2,0
55779,3,1,194847,194847,194848,0,1,1
55780,1,2,194848,194848,194850,0,2,0
55781,1,1,194849,194850,194851,1,2,0
55782,3,2,194852,194852,194854,0,2,1
55783,1,1,194853,194854,194855,1,2,0
55784,5,1,194858,194858,194859,0,1,3
55785,6,1,194864,194864,194865,0,1,5
55786,3,2,194867,194867,194869,0,2,2
55787,6,1,194873,194873,194874,0,1,4
55788,1,2,194874,194874,194876,0,2,0
55789,3,2,194877,194877,194879,0,2,1
55790,1,3,194878,194879,194882,1,4,0
55791,1,3,194879,194882,194885,3,6,0
55792,3,2,194882,194885,194887,3,5,0
55793,2,1,194884,194887,194888,3,4,0
55794,6,1,194890,194890,194891,0,1,2
55795,2,2,194892,194892,194894,0,2,1
55796,4,3,194896,194896,194899,0,3,2
55797,4,1,194900,194900,194901,0,1,1
55798,1,2,194901,194901,194903,0,2,0
55799,1,3,194902,194903,194906,1,4,0
55800,5,1,194907,194907,194908,0,1,1
55801,6,3,194913,194913,194916,0,3,5
55802,2,1,194915,194916,194917,1,2,0
55803,3,1,194918,194918,194919,0,1,1
55804,1,3,194919,194919,194922,0,3,0
55805,6,3,194925,194925,194928,0,3,3
55806,3,1,194928,194928,194929,0,1,0
55807,6,2,194934,194934,194936,0,2,5
55808,3,3,194937,194937,194940,0,3,1
55809,1,1,194938,194940,194941,2,3,0
55810,1,2,194939,194941,194943,2,4,0
55811,1,3,194940,194943,194946,3,6,0
55812,6,2,194946,194946,194948,0,2,0
55813,2,1,194948,194948,194949,0,1,0
55814,4,3,194952,194952,194955,0,3,3
55815,6,1,194958,194958,194959,0,1,3
55816,5,1,194963,194963,194964,0,1,4
55817,1,1,194964,194964,194965,0,1,0
55818,1,3,194965,194965,194968,0,3,0
55819,2,3,194967,194968,194971,1,4,0
55820,1,3,194968,194971,194974,3,6,0
55821,2,3,194970,194974,194977,4,7,0
55822,1,2,194971,194977,194979,6,8,0
55823,6,1,194977,194979,194980,2,3,0
55824,2,2,194979,194980,194982,1,3,0
55825,2,2,194981,194982,194984,1,3,0
55826,1,2,194982,194984,194986,2,4,0
55827,5,1,194987,194987,194988,0,1,1
55828,2,3,194989,194989,194992,0,3,1
55829,3,2,194992,194992,194994,0,2,0
55830,2,1,194994,194994,194995,0,1,0
55831,1,2,194995,194995,194997,0,2,0
55832,6,1,195001,195001,195002,0,1,4
55833,2,1,195003,195003,195004,0,1,1
55834,5,2,195008,195008,195010,0,2,4
55835,4,1,195012,195012,195013,0,1,2
55836,5,3,195017,195017,195020,0,3,4
55837,2,1,195019,195020,195021,1,2,0
55838,5,3,195024,195024,195027,0,3,3
55839,2,2,195026,195027,195029,1,3,0
55840,5,1,195031,195031,195032,0,1,2
55841,6,1,195037,195037,195038,0,1,5
55842,4,2,195041,195041,195043,0,2,3
55843,2,3,195043,195043,195046,0,3,0
55844,3,3,195046,195046,195049,0,3,0
55845,1,1,195047,195049,195050,2,3,0
55846,6,1,195053,195053,195054,0,1,3
55847,1,2,195054,195054,195056,0,2,0
55848,4,2,195058,195058,195060,0,2,2
55849,2,1,195060,195060,195061,0,1,0
55850,1,1,195061,195061,195062,0,1,0
55851,5,1,195066,195066,195067,0,1,4
55852,1,2,195067,195067,195069,0,2,0
55853,5,1,195072,195072,195073,0,1,3
55854,6,1,195078,195078,195079,0,1,5
55855,5,3,195083,195083,195086,0,3,4
55856,3,2,195086,195086,195088,0,2,0
55857,5,1,195091,195091,195092,0,1,3
55858,2,1,195093,195093,195094,0,1,1
55859,5,2,195098,195098,195100,0,2,4
55860,6,2,195104,195104,195106,0,2,4
55861,4,2,195108,195108,195110,0,2,2
55862,1,2,195109,195110,195112,1,3,0
55863,1,1,195110,195112,195113,2,3,0
55864,5,3,195115,195115,195118,0,3,2
55865,2,3,195117,195118,195121,1,4,0
55866,4,2,195121,195121,195123,0,2,0
55867,5,1,195126,195126,195127,0,1,3
55868,5,3,195131,195131,195134,0,3,4
55869,6,2,195137,195137,195139,0,2,3
55870,5,1,195142,195142,195143,0,1,3
55871,3,3,195145,195145,195148,0,3,2
55872,6,3,195151,195151,195154,0,3,3
55873,5,1,195156,195156,195157,0,1,2
55874,4,3,195160,195160,195163,0,3,3
55875,3,2,195163,195163,195165,0,2,0
55876,6,3,195169,195169,195172,0,3,4
55877,2,1,195171,195172,195173,1,2,0
55878,6,1,195177,195177,195178,0,1,4
55879,3,2,195180,195180,195182,0,2,2
55880,4,1,195184,195184,195185,0,1,2
55881,5,1,195189,195189,195190,0,1,4
55882,3,3,195192,195192,195195,0,3,2
55883,6,2,195198,195198,195200,0,2,3
55884,2,2,195200,195200,195202,0,2,0
55885,3,1,195203,195203,195204,0,1,1
55886,6,1,195209,195209,195210,0,1,5
55887,5,2,195214,195214,195216,0,2,4
55888,2,1,195216,195216,195217,0,1,0
55889,5,1,195221,195221,195222,0,1,4
55890,2,3,195223,195223,195226,0,3,1
55891,2,2,195225,195226,195228,1,3,0
55892,3,2,195228,195228,195230,0,2,0
55893,1,1,195229,195230,195231,1,2,0
55894,6,3,195235,195235,195238,0,3,4
55895,3,3,195238,195238,195241,0,3,0
55896,2,3,195240,195241,195244,1,4,0
55897,1,3,195241,195244,195247,3,6,0
55898,6,1,195247,195247,195248,0,1,0
55899,2,2,195249,195249,195251,0,2,1
55900,1,1,195250,195251,195252,1,2,0
55901,4,1,195254,195254,195255,0,1,2
55902,3,1,195257,195257,195258,0,1,2
55903,4,2,195261,195261,195263,0,2,3
55904,3,1,195264,195264,195265,0,1,1
55905,2,3,195266,195266,195269,0,3,1
55906,5,2,195271,195271,195273,0,2,2
55907,5,3,195276,195276,195279,0,3,3
55908,5,3,195281,195281,195284,0,3,2
55909,5,1,195286,195286,195287,0,1,2
55910,6,1,195292,195292,195293,0,1,5
55911,6,1,195298,195298,195299,0,1,5
55912,3,2,195301,195301,195303,0,2,2
55913,3,3,195304,195304,195307,0,3,1
55914,2,1,195306,195307,195308,1,2,0
55915,1,2,195307,195308,195310,1,3,0
55916,6,1,195313,195313,195314,0,1,3
55917,1,3,195314,195314,195317,0,3,0
55918,1,2,195315,195317,195319,2,4,0
55919,6,3,195321,195321,195324,0,3,2
55920,1,2,195322,195324,195326,2,4,0
55921,3,3,195325,195326,195329,1,4,0
55922,1,3,195326,195329,195332,3,6,0
55923,6,1,195332,195332,195333,0,1,0
55924,5,1,195337,195337,195338,0,1,4
55925,4,2,195341,195341,195343,0,2,3
55926,2,1,195343,195343,195344,0,1,0
55927,1,1,195344,195344,195345,0,1,0
55928,2,3,195346,195346,195349,0,3,1
55929,4,1,195350,195350,195351,0,1,1
55930,6,2,195356,195356,195358,0,2,5
55931,1,1,195357,195358,195359,1,2,0
55932,4,3,195361,195361,195364,0,3,2
55933,4,3,195365,195365,195368,0,3,1
55934,3,3,195368,195368,195371,0,3,0
55935,4,3,195372,195372,195375,0,3,1
55936,1,3,195373,195375,195378,2,5,0
55937,6,2,195379,195379,195381,0,2,1
55938,5,1,195384,195384,195385,0,1,3
55939,3,2,195387,195387,195389,0,2,2
55940,3,3,195390,195390,195393,0,3,1
55941,6,1,195396,195396,195397,0,1,3
55942,4,2,195400,195400,195402,0,2,3
55943,5,1,195405,195405,195406,0,1,3
55944,2,3,195407,195407,195410,0,3,1
55945,5,1,195412,195412,195413,0,1,2
55946,4,1,195416,195416,195417,0,1,3
55947,6,3,195422,195422,195425,0,3,5
55948,4,2,195426,195426,195428,0,2,1
55949,5,1,195431,195431,195432,0,1,3
55950,6,3,195437,195437,195440,0,3,5
55951,4,1,195441,195441,195442,0,1,1
55952,2,2,195443,195443,195445,0,2,1
55953,2,3,195445,195445,195448,0,3,0
55954,4,1,195449,195449,195450,0,1,1
55955,2,1,195451,195451,195452,0,1,1
55956,2,2,195453,195453,195455,0,2,1
55957,2,1,195455,195455,195456,0,1,0
55958,1,2,195456,195456,195458,0,2,0
55959,3,2,195459,195459,195461,0,2,1
55960,3,2,195462,195462,195464,0,2,1
55961,6,2,195468,195468,195470,0,2,4
55962,5,2,195473,195473,195475,0,2,3
55963,4,3,195477,195477,195480,0,3,2
55964,3,1,195480,195480,195481,0,1,0
55965,2,2,195482,195482,195484,0,2,1
55966,4,3,195486,195486,195489,0,3,2
55967,4,1,195490,195490,195491,0,1,1
55968,6,3,195496,195496,195499,0,3,5
55969,3,2,195499,195499,195501,0,2,0
55970,1,2,195500,195501,195503,1,3,0
55971,4,2,195504,195504,195506,0,2,1
55972,1,3,195505,195506,195509,1,4,0
55973,2,1,195507,195509,195510,2,3,0
55974,3,3,195510,195510,195513,0,3,0
55975,3,3,195513,195513,195516,0,3,0
55976,1,1,195514,195516,195517,2,3,0
55977,6,1,195520,195520,195521,0,1,3
55978,3,2,195523,195523,195525,0,2,2
55979,1,2,195524,195525,195527,1,3,0
55980,6,3,195530,195530,195533,0,3,3
55981,5,3,195535,195535,195538,0,3,2
55982,4,3,195539,195539,195542,0,3,1
55983,6,2,195545,195545,195547,0,2,3
55984,5,3,195550,195550,195553,0,3,3
55985,4,3,195554,195554,195557,0,3,1
55986,4,2,195558,195558,195560,0,2,1
55987,4,1,195562,195562,195563,0,1,2
55988,4,2,195566,195566,195568,0,2,3
55989,1,3,195567,195568,195571,1,4,0
55990,3,2,195570,195571,195573,1,3,0
55991,4,3,195574,195574,195577,0,3,1
55992,2,2,195576,195577,195579,1,3,0
55993,4,3,195580,195580,195583,0,3,1
55994,1,3,195581,195583,195586,2,5,0
55995,1,3,195582,195586,195589,4,7,0
55996,5,1,195587,195589,195590,2,3,0
55997,1,3,195588,195590,195593,2,5,0
55998,5,1,195593,195593,195594,0,1,0
55999,6,2,195599,195599,195601,0,2,5
56000,3,1,195602,195602,195603,0,1,1
56001,3,3,195605,195605,195608,0,3,2
56002,4,1,195609,195609,195610,0,1,1
56003,6,3,195615,195615,195618,0,3,5
56004,4,1,195619,195619,195620,0,1,1
56005,6,1,195625,195625,195626,0,1,5
56006,6,2,195631,195631,195633,0,2,5
56007,4,2,195635,195635,195637,0,2,2
56008,3,3,195638,195638,195641,0,3,1
56009,2,2,195640,195641,195643,1,3,0
56010,1,3,195641,195643,195646,2,5,0
56011,6,2,195647,195647,195649,0,2,1
56012,3,2,195650,195650,195652,0,2,1
56013,3,1,195653,195653,195654,0,1,1
56014,5,1,195658,195658,195659,0,1,4
56015,4,3,195662,195662,195665,0,3,3
56016,4,3,195666,195666,195669,0,3,1
56017,2,1,195668,195669,195670,1,2,0
56018,2,1,195670,195670,195671,0,1,0
56019,6,2,195676,195676,195678,0,2,5
56020,2,3,195678,195678,195681,0,3,0
56021,5,1,195683,195683,195684,0,1,2
56022,4,2,195687,195687,195689,0,2,3
56023,2,3,195689,195689,195692,0,3,0
56024,2,3,195691,195692,195695,1,4,0
56025,5,1,195696,195696,195697,0,1,1
56026,1,1,195697,195697,195698,0,1,0
56027,5,2,195702,195702,195704,0,2,4
56028,4,3,195706,195706,195709,0,3,2
56029,4,1,195710,195710,195711,0,1,1
56030,5,3,195715,195715,195718,0,3,4
56031,1,1,195716,195718,195719,2,3,0
56032,5,1,195721,195721,195722,0,1,2
56033,1,2,195722,195722,195724,0,2,0
56034,5,3,195727,195727,195730,0,3,3
56035,4,1,195731,195731,195732,0,1,1
56036,3,1,195734,195734,195735,0,1,2
56037,5,1,195739,195739,195740,0,1,4
56038,4,1,195743,195743,195744,0,1,3
56039,2,3,195745,195745,195748,0,3,1
56040,1,1,195746,195748,195749,2,3,0
56041,2,1,195748,195749,195750,1,2,0
56042,4,2,195752,195752,195754,0,2,2
56043,6,2,195758,195758,195760,0,2,4
56044,1,2,195759,195760,195762,1,3,0
56045,5,1,195764,195764,195765,0,1,2
56046,5,2,195769,195769,195771,0,2,4
56047,4,3,195773,195773,195776,0,3,2
56048,2,2,195775,195776,195778,1,3,0
56049,3,1,195778,195778,195779,0,1,0
56050,1,1,195779,195779,195780,0,1,0
56051,3,3,195782,195782,195785,0,3,2
56052,5,2,195787,195787,195789,0,2,2
56053,5,2,195792,195792,195794,0,2,3
56054,1,3,195793,195794,195797,1,4,0
56055,1,3,195794,195797,195800,3,6,0
56056,2,1,195796,195800,195801,4,5,0
56057,3,3,195799,195801,195804,2,5,0
56058,6,2,195805,195805,195807,0,2,1
56059,5,2,195810,195810,195812,0,2,3
56060,3,2,195813,195813,195815,0,2,1
56061,1,3,195814,195815,195818,1,4,0
56062,5,1,195819,195819,195820,0,1,1
56063,2,2,195821,195821,195823,0,2,1
56064,1,3,195822,195823,195826,1,4,0
56065,2,1,195824,195826,195827,2,3,0
56066,6,2,195830,195830,195832,0,2,3
56067,6,2,195836,195836,195838,0,2,4
56068,6,2,195842,195842,195844,0,2,4
56069,6,2,195848,195848,195850,0,2,4
56070,6,1,195854,195854,195855,0,1,4
56071,1,3,195855,195855,195858,0,3,0
56072,3,3,195858,195858,195861,0,3,0
56073,6,2,195864,195864,195866,0,2,3
56074,1,3,195865,195866,195869,1,4,0
56075,3,2,195868,195869,195871,1,3,0
56076,1,3,195869,195871,195874,2,5,0
56077,2,1,195871,195874,195875,3,4,0
56078,4,3,195875,195875,195878,0,3,0
56079,3,2,195878,195878,195880,0,2,0
56080,5,2,195883,195883,195885,0,2,3
56081,1,2,195884,195885,195887,1,3,0
56082,2,3,195886,195887,195890,1,4,0
56083,5,2,195891,195891,195893,0,2,1
56084,4,1,195895,195895,195896,0,1,2
56085,4,2,195899,195899,195901,0,2,3
56086,2,3,195901,195901,195904,0,3,0
56087,4,2,195905,195905,195907,0,2,1
56088,2,1,195907,195907,195908,0,1,0
56089,6,3,195913,195913,195916,0,3,5
56090,2,2,195915,195916,195918,1,3,0
56091,3,3,195918,195918,195921,0,3,0
56092,2,2,195920,195921,195923,1,3,0
56093,6,2,195926,195926,195928,0,2,3
56094,1,1,195927,195928,195929,1,2,0
56095,2,1,195929,195929,195930,0,1,0
56096,5,2,195934,195934,195936,0,2,4
56097,1,1,195935,195936,195937,1,2,0
56098,1,1,195936,195937,195938,1,2,0
56099,6,2,195942,195942,195944,0,2,4
56100,4,3,195946,195946,195949,0,3,2
56101,1,1,195947,195949,195950,2,3,0
56102,6,1,195953,195953,195954,0,1,3
56103,2,3,195955,195955,195958,0,3,1
56104,4,3,195959,195959,195962,0,3,1
56105,5,2,195964,195964,195966,0,2,2
56106,1,3,195965,195966,195969,1,4,0
56107,3,1,195968,195969,195970,1,2,0
56108,6,3,195974,195974,195977,0,3,4
56109,6,1,195980,195980,195981,0,1,3
56110,4,3,195984,195984,195987,0,3,3
56111,4,1,195988,195988,195989,0,1,1
56112,6,1,195994,195994,195995,0,1,5
56113,3,3,195997,195997,196000,0,3,2
56114,6,1,196003,196003,196004,0,1,3
56115,5,3,196008,196008,196011,0,3,4
56116,4,3,196012,196012,196015,0,3,1
56117,1,3,196013,196015,196018,2,5,0
56118,4,2,196017,196018,196020,1,3,0
56119,3,2,196020,196020,196022,0,2,0
56120,5,2,196025,196025,196027,0,2,3
56121,5,3,196030,196030,196033,0,3,3
56122,2,1,196032,196033,196034,1,2,0
56123,5,3,196037,196037,196040,0,3,3
56124,1,1,196038,196040,196041,2,3,0
56125,2,2,196040,196041,196043,1,3,0
56126,1,1,196041,196043,196044,2,3,0
56127,2,1,196043,196044,196045,1,2,0
56128,1,2,196044,196045,196047,1,3,0
56129,6,1,196050,196050,196051,0,1,3
56130,6,3,196056,196056,196059,0,3,5
56131,3,2,196059,196059,196061,0,2,0
56132,1,1,196060,196061,196062,1,2,0
56133,6,1,196066,196066,196067,0,1,4
56134,6,2,196072,196072,196074,0,2,5
56135,3,1,196075,196075,196076,0,1,1
56136,1,2,196076,196076,196078,0,2,0
56137,4,3,196080,196080,196083,0,3,2
56138,5,2,196085,196085,196087,0,2,2
56139,5,3,196090,196090,196093,0,3,3
56140,2,3,196092,196093,196096,1,4,0
56141,3,3,196095,196096,196099,1,4,0
56142,3,2,196098,196099,196101,1,3,0
56143,5,1,196103,196103,196104,0,1,2
56144,5,1,196108,196108,196109,0,1,4
56145,1,2,196109,196109,196111,0,2,0
56146,1,2,196110,196111,196113,1,3,0
56147,6,3,196116,196116,196119,0,3,3
56148,5,2,196121,196121,196123,0,2,2
56149,3,1,196124,196124,196125,0,1,1
56150,6,3,196130,196130,196133,0,3,5
56151,1,2,196131,196133,196135,2,4,0
56152,2,1,196133,196135,196136,2,3,0
56153,6,2,196139,196139,196141,0,2,3
56154,3,3,196142,196142,196145,0,3,1
56155,2,1,196144,196145,196146,1,2,0
56156,6,2,196150,196150,196152,0,2,4
56157,3,2,196153,196153,196155,0,2,1
56158,3,1,196156,196156,196157,0,1,1
56159,6,3,196162,196162,196165,0,3,5
56160,4,3,196166,196166,196169,0,3,1
56161,3,1,196169,196169,196170,0,1,0
56162,3,3,196172,196172,196175,0,3,2
56163,4,1,196176,196176,196177,0,1,1
56164,4,3,196180,196180,196183,0,3,3
56165,6,3,196186,196186,196189,0,3,3
56166,5,3,196191,196191,196194,0,3,2
56167,1,1,196192,196194,196195,2,3,0
56168,5,3,196197,196197,196200,0,3,2
56169,5,1,196202,196202,196203,0,1,2
56170,6,1,196208,196208,196209,0,1,5
56171,3,2,196211,196211,196213,0,2,2
56172,6,1,196217,196217,196218,0,1,4
56173,1,1,196218,196218,196219,0,1,0
56174,2,2,196220,196220,196222,0,2,1
56175,6,3,196226,196226,196229,0,3,4
56176,1,3,196227,196229,196232,2,5,0
56177,3,3,196230,196232,196235,2,5,0
56178,3,3,196233,196235,196238,2,5,0
56179,4,1,196237,196238,196239,1,2,0
56180,5,1,196242,196242,196243,0,1,3
56181,3,3,196245,196245,196248,0,3,2
56182,4,2,196249,196249,196251,0,2,1
56183,4,2,196253,196253,196255,0,2,2
56184,3,3,196256,196256,196259,0,3,1
56185,6,3,196262,196262,196265,0,3,3
56186,6,2,196268,196268,196270,0,2,3
56187,6,3,196274,196274,196277,0,3,4
56188,3,3,196277,196277,196280,0,3,0
56189,1,3,196278,196280,196283,2,5,0
56190,1,2,196279,196283,196285,4,6,0
56191,2,1,196281,196285,196286,4,5,0
56192,1,2,196282,196286,196288,4,6,0
56193,3,1,196285,196288,196289,3,4,0
56194,2,1,196287,196289,196290,2,3,0
56195,1,3,196288,196290,196293,2,5,0
56196,5,2,196293,196293,196295,0,2,0
56197,1,1,196294,196295,196296,1,2,0
56198,4,1,196298,196298,196299,0,1,2
56199,6,1,196304,196304,196305,0,1,5
56200,1,1,196305,196305,196306,0,1,0
56201,3,1,196308,196308,196309,0,1,2
56202,6,3,196314,196314,196317,0,3,5
56203,5,2,196319,196319,196321,0,2,2
56204,5,1,196324,196324,196325,0,1,3
56205,6,2,196330,196330,196332,0,2,5
56206,5,2,196335,196335,196337,0,2,3
56207,5,2,196340,196340,196342,0,2,3
56208,4,2,196344,196344,196346,0,2,2
56209,5,3,196349,196349,196352,0,3,3
56210,3,3,196352,196352,196355,0,3,0
56211,1,2,196353,196355,196357,2,4,0
56212,6,3,196359,196359,196362,0,3,2
56213,3,3,196362,196362,196365,0,3,0
56214,5,3,196367,196367,196370,0,3,2
56215,4,1,196371,196371,196372,0,1,1
56216,4,1,196375,196375,196376,0,1,3
56217,1,2,196376,196376,196378,0,2,0
56218,2,2,196378,196378,196380,0,2,0
56219,2,2,196380,196380,196382,0,2,0
56220,5,2,196385,196385,196387,0,2,3
56221,1,2,196386,196387,196389,1,3,0
56222,6,3,196392,196392,196395,0,3,3
56223,5,2,196397,196397,196399,0,2,2
56224,2,1,196399,196399,196400,0,1,0
56225,6,3,196405,196405,196408,0,3,5
56226,1,2,196406,196408,196410,2,4,0
56227,1,2,196407,196410,196412,3,5,0
56228,5,1,196412,196412,196413,0,1,0
56229,4,1,196416,196416,196417,0,1,3
56230,4,2,196420,196420,196422,0,2,3
56231,6,3,196426,196426,196429,0,3,4
56232,4,1,196430,196430,196431,0,1,1
56233,3,2,196433,196433,196435,0,2,2
56234,3,3,196436,196436,196439,0,3,1
56235,6,1,196442,196442,196443,0,1,3
56236,2,1,196444,196444,196445,0,1,1
56237,5,3,196449,196449,196452,0,3,4
56238,3,3,196452,196452,196455,0,3,0
56239,3,2,196455,196455,196457,0,2,0
56240,4,1,196459,196459,196460,0,1,2
56241,4,2,196463,196463,196465,0,2,3
56242,2,3,196465,196465,196468,0,3,0
56243,6,3,196471,196471,196474,0,3,3
56244,6,2,196477,196477,196479,0,2,3
56245,1,2,196478,196479,196481,1,3,0
56246,5,3,196483,196483,196486,0,3,2
56247,3,1,196486,196486,196487,0,1,0
56248,3,3,196489,196489,196492,0,3,2
56249,5,2,196494,196494,196496,0,2,2
56250,4,2,196498,196498,196500,0,2,2
56251,6,1,196504,196504,196505,0,1,4
56252,1,3,196505,196505,196508,0,3,0
56253,4,1,196509,196509,196510,0,1,1
56254,6,2,196515,196515,196517,0,2,5
56255,6,3,196521,196521,196524,0,3,4
56256,4,2,196525,196525,196527,0,2,1
56257,3,1,196528,196528,196529,0,1,1
56258,4,2,196532,196532,196534,0,2,3
56259,3,2,196535,196535,196537,0,2,1
56260,4,1,196539,196539,196540,0,1,2
56261,1,3,196540,196540,196543,0,3,0
56262,1,1,196541,196543,196544,2,3,0
56263,6,2,196547,196547,196549,0,2,3
56264,4,2,196551,196551,196553,0,2,2
56265,6,2,196557,196557,196559,0,2,4
56266,2,1,196559,196559,196560,0,1,0
56267,6,2,196565,196565,196567,0,2,5
56268,3,1,196568,196568,196569,0,1,1
56269,5,3,196573,196573,196576,0,3,4
56270,6,3,196579,196579,196582,0,3,3
56271,6,1,196585,196585,196586,0,1,3
56272,3,2,196588,196588,196590,0,2,2
56273,2,2,196590,196590,196592,0,2,0
56274,5,2,196595,196595,196597,0,2,3
56275,4,1,196599,196599,196600,0,1,2
56276,4,3,196603,196603,196606,0,3,3
56277,6,2,196609,196609,196611,0,2,3
56278,5,3,196614,196614,196617,0,3,3
56279,5,3,196619,196619,196622,0,3,2
56280,4,3,196623,196623,196626,0,3,1
56281,5,2,196628,196628,196630,0,2,2
56282,4,1,196632,196632,196633,0,1,2
56283,3,2,196635,196635,196637,0,2,2
56284,5,3,196640,196640,196643,0,3,3
56285,1,3,196641,196643,196646,2,5,0
56286,5,2,196646,196646,196648,0,2,0
56287,4,1,196650,196650,196651,0,1,2
56288,3,2,196653,196653,196655,0,2,2
56289,6,2,196659,196659,196661,0,2,4
56290,5,2,196664,196664,196666,0,2,3
56291,1,1,196665,196666,196667,1,2,0
56292,6,2,196671,196671,196673,0,2,4
56293,4,3,196675,196675,196678,0,3,2
56294,1,2,196676,196678,196680,2,4,0
56295,6,3,196682,196682,196685,0,3,2
56296,1,3,196683,196685,196688,2,5,0
56297,4,2,196687,196688,196690,1,3,0
56298,1,2,196688,196690,196692,2,4,0
56299,3,3,196691,196692,196695,1,4,0
56300,6,1,196697,196697,196698,0,1,2
56301,2,2,196699,196699,196701,0,2,1
56302,4,1,196703,196703,196704,0,1,2
56303,3,2,196706,196706,196708,0,2,2
56304,6,3,196712,196712,196715,0,3,4
56305,6,1,196718,196718,196719,0,1,3
56306,2,2,196720,196720,196722,0,2,1
56307,1,1,196721,196722,196723,1,2,0
56308,3,2,196724,196724,196726,0,2,1
56309,4,1,196728,196728,196729,0,1,2
56310,1,3,196729,196729,196732,0,3,0
56311,2,2,196731,196732,196734,1,3,0
56312,1,1,196732,196734,196735,2,3,0
56313,6,3,196738,196738,196741,0,3,3
56314,1,3,196739,196741,196744,2,5,0
56315,6,1,196745,196745,196746,0,1,1
56316,1,2,196746,196746,196748,0,2,0
56317,5,3,196751,196751,196754,0,3,3
56318,6,1,196757,196757,196758,0,1,3
56319,5,3,196762,196762,196765,0,3,4
56320,1,3,196763,196765,196768,2,5,0
56321,5,1,196768,196768,196769,0,1,0
56322,6,2,196774,196774,196776,0,2,5
56323,5,3,196779,196779,196782,0,3,3
56324,3,1,196782,196782,196783,0,1,0
56325,5,2,196787,196787,196789,0,2,4
56326,1,2,196788,196789,196791,1,3,0
56327,3,1,196791,196791,196792,0,1,0
56328,3,1,196794,196794,196795,0,1,2
56329,1,2,196795,196795,196797,0,2,0
56330,1,1,196796,196797,196798,1,2,0
56331,1,1,196797,196798,196799,1,2,0
56332,1,1,196798,196799,196800,1,2,0
56333,2,1,196800,196800,196801,0,1,0
56334,1,2,196801,196801,196803,0,2,0
56335,3,1,196804,196804,196805,0,1,1
56336,5,3,196809,196809,196812,0,3,4
56337,3,1,196812,196812,196813,0,1,0
56338,6,1,196818,196818,196819,0,1,5
56339,2,2,196820,196820,196822,0,2,1
56340,5,1,196825,196825,196826,0,1,3
56341,2,1,196827,196827,196828,0,1,1
56342,2,2,196829,196829,196831,0,2,1
56343,4,1,196833,196833,196834,0,1,2
56344,2,2,196835,196835,196837,0,2,1
56345,1,2,196836,196837,196839,1,3,0
56346,2,2,196838,196839,196841,1,3,0
56347,3,3,196841,196841,196844,0,3,0
56348,3,1,196844,196844,196845,0,1,0
56349,6,1,196850,196850,196851,0,1,5
56350,1,3,196851,196851,196854,0,3,0
56351,1,2,196852,196854,196856,2,4,0
56352,2,2,196854,196856,196858,2,4,0
56353,6,1,196860,196860,196861,0,1,2
56354,1,1,196861,196861,196862,0,1,0
56355,4,2,196865,196865,196867,0,2,3
56356,4,2,196869,196869,196871,0,2,2
56357,6,1,196875,196875,196876,0,1,4
56358,2,1,196877,196877,196878,0,1,1
56359,4,1,196881,196881,196882,0,1,3
56360,2,3,196883,196883,196886,0,3,1
56361,5,3,196888,196888,196891,0,3,2
56362,4,3,196892,196892,196895,0,3,1
56363,4,3,196896,196896,196899,0,3,1
56364,2,1,196898,196899,196900,1,2,0
56365,4,3,196902,196902,196905,0,3,2
56366,2,3,196904,196905,196908,1,4,0
56367,5,1,196909,196909,196910,0,1,1
56368,4,3,196913,196913,196916,0,3,3
56369,4,1,196917,196917,196918,0,1,1
56370,3,3,196920,196920,196923,0,3,2
56371,4,1,196924,196924,196925,0,1,1
56372,5,1,196929,196929,196930,0,1,4
56373,3,1,196932,196932,196933,0,1,2
56374,5,3,196937,196937,196940,0,3,4
56375,1,3,196938,196940,196943,2,5,0
56376,1,2,196939,196943,196945,4,6,0
56377,1,2,196940,196945,196947,5,7,0
56378,6,3,196946,196947,196950,1,4,0
56379,4,3,196950,196950,196953,0,3,0
56380,3,3,196953,196953,196956,0,3,0
56381,5,2,196958,196958,196960,0,2,2
56382,4,3,196962,196962,196965,0,3,2
56383,4,2,196966,196966,196968,0,2,1
56384,3,2,196969,196969,196971,0,2,1
56385,4,3,196973,196973,196976,0,3,2
56386,4,2,196977,196977,196979,0,2,1
56387,6,3,196983,196983,196986,0,3,4
56388,4,2,196987,196987,196989,0,2,1
56389,5,1,196992,196992,196993,0,1,3
56390,1,2,196993,196993,196995,0,2,0
56391,6,2,196999,196999,197001,0,2,4
56392,2,2,197001,197001,197003,0,2,0
56393,3,2,197004,197004,197006,0,2,1
56394,6,3,197010,197010,197013,0,3,4
56395,3,3,197013,197013,197016,0,3,0
56396,4,2,197017,197017,197019,0,2,1
56397,6,1,197023,197023,197024,0,1,4
56398,4,2,197027,197027,197029,0,2,3
56399,4,1,197031,197031,197032,0,1,2
56400,6,2,197037,197037,197039,0,2,5
56401,4,1,197041,197041,197042,0,1,2
56402,4,2,197045,197045,197047,0,2,3
56403,4,3,197049,197049,197052,0,3,2
56404,1,2,197050,197052,197054,2,4,0
56405,3,3,197053,197054,197057,1,4,0
56406,2,2,197055,197057,197059,2,4,0
56407,1,2,197056,197059,197061,3,5,0
56408,3,3,197059,197061,197064,2,5,0
56409,5,3,197064,197064,197067,0,3,0
56410,5,2,197069,197069,197071,0,2,2
56411,2,2,197071,197071,197073,0,2,0
56412,2,2,197073,197073,197075,0,2,0
56413,1,1,197074,197075,197076,1,2,0
56414,1,1,197075,197076,197077,1,2,0
56415,4,2,197079,197079,197081,0,2,2
56416,6,3,197085,197085,197088,0,3,4
56417,5,1,197090,197090,197091,0,1,2
56418,2,3,197092,197092,197095,0,3,1
56419,2,3,197094,197095,197098,1,4,0
56420,3,1,197097,197098,197099,1,2,0
56421,3,3,197100,197100,197103,0,3,1
56422,1,3,197101,197103,197106,2,5,0
56423,3,1,197104,197106,197107,2,3,0
56424,4,3,197108,197108,197111,0,3,1
56425,4,2,197112,197112,197114,0,2,1
56426,5,3,197117,197117,197120,0,3,3
56427,3,1,197120,197120,197121,0,1,0
56428,3,3,197123,197123,197126,0,3,2
56429,2,1,197125,197126,197127,1,2,0
56430,4,1,197129,197129,197130,0,1,2
56431,5,3,197134,197134,197137,0,3,4
56432,4,3,197138,197138,197141,0,3,1
56433,6,3,197144,197144,197147,0,3,3
56434,4,1,197148,197148,197149,0,1,1
56435,1,2,197149,197149,197151,0,2,0
56436,3,1,197152,197152,197153,0,1,1
56437,3,3,197155,197155,197158,0,3,2
56438,3,1,197158,197158,197159,0,1,0
56439,1,2,197159,197159,197161,0,2,0
56440,6,3,197165,197165,197168,0,3,4
56441,6,2,197171,197171,197173,0,2,3
56442,3,3,197174,197174,197177,0,3,1
56443,1,3,197175,197177,197180,2,5,0
56444,6,1,197181,197181,197182,0,1,1
56445,3,3,197184,197184,197187,0,3,2
56446,6,2,197190,197190,197192,0,2,3
56447,1,1,197191,197192,197193,1,2,0
56448,4,1,197195,197195,197196,0,1,2
56449,5,1,197200,197200,197201,0,1,4
56450,2,3,197202,197202,197205,0,3,1
56451,6,2,197208,197208,197210,0,2,3
56452,4,1,197212,197212,197213,0,1,2
56453,6,1,197218,197218,197219,0,1,5
56454,1,2,197219,197219,197221,0,2,0
56455,5,1,197224,197224,197225,0,1,3
56456,3,1,197227,197227,197228,0,1,2
56457,5,2,197232,197232,197234,0,2,4
56458,2,1,197234,197234,197235,0,1,0
56459,6,1,197240,197240,197241,0,1,5
56460,6,3,197246,197246,197249,0,3,5
56461,1,1,197247,197249,197250,2,3,0
56462,4,3,197251,197251,197254,0,3,1
56463,6,1,197257,197257,197258,0,1,3
56464,6,3,197263,197263,197266,0,3,5
56465,5,1,197268,197268,197269,0,1,2
56466,2,1,197270,197270,197271,0,1,1
56467,4,3,197274,197274,197277,0,3,3
56468,5,3,197279,197279,197282,0,3,2
56469,3,3,197282,197282,197285,0,3,0
56470,3,1,197285,197285,197286,0,1,0
56471,6,2,197291,197291,197293,0,2,5
56472,3,2,197294,197294,197296,0,2,1
56473,3,2,197297,197297,197299,0,2,1
56474,3,1,197300,197300,197301,0,1,1
56475,4,3,197304,197304,197307,0,3,3
56476,1,1,197305,197307,197308,2,3,0
56477,5,3,197310,197310,197313,0,3,2
56478,3,3,197313,197313,197316,0,3,0
56479,1,1,197314,197316,197317,2,3,0
56480,2,1,197316,197317,197318,1,2,0
56481,3,2,197319,197319,197321,0,2,1
56482,5,2,197324,197324,197326,0,2,3
56483,1,1,197325,197326,197327,1,2,0
56484,3,3,197328,197328,197331,0,3,1
56485,3,3,197331,197331,197334,0,3,0
56486,5,1,197336,197336,197337,0,1,2
56487,5,3,197341,197341,197344,0,3,4
56488,4,3,197345,197345,197348,0,3,1
56489,2,1,197347,197348,197349,1,2,0
56490,3,2,197350,197350,197352,0,2,1
56491,3,2,197353,197353,197355,0,2,1
56492,6,3,197359,197359,197362,0,3,4
56493,2,2,197361,197362,197364,1,3,0
56494,2,2,197363,197364,197366,1,3,0
56495,5,2,197368,197368,197370,0,2,2
56496,1,1,197369,197370,197371,1,2,0
56497,4,3,197373,197373,197376,0,3,2
56498,1,3,197374,197376,197379,2,5,0
56499,6,2,197380,197380,197382,0,2,1
56500,3,2,197383,197383,197385,0,2,1
56501,2,2,197385,197385,197387,0,2,0
56502,6,1,197391,197391,197392,0,1,4
56503,5,2,197396,197396,197398,0,2,4
56504,1,2,197397,197398,197400,1,3,0
56505,5,2,197402,197402,197404,0,2,2
56506,3,2,197405,197405,197407,0,2,1
56507,5,3,197410,197410,197413,0,3,3
56508,1,2,197411,197413,197415,2,4,0
56509,3,3,197414,197415,197418,1,4,0
56510,6,3,197420,197420,197423,0,3,2
56511,1,2,197421,197423,197425,2,4,0
56512,6,1,197427,197427,197428,0,1,2
56513,2,3,197429,197429,197432,0,3,1
56514,1,3,197430,197432,197435,2,5,0
56515,6,3,197436,197436,197439,0,3,1
56516,1,1,197437,197439,197440,2,3,0
56517,3,2,197440,197440,197442,0,2,0
56518,3,1,197443,197443,197444,0,1,1
56519,2,2,197445,197445,197447,0,2,1
56520,4,2,197449,197449,197451,0,2,2
56521,2,1,197451,197451,197452,0,1,0
56522,3,1,197454,197454,197455,0,1,2
56523,2,2,197456,197456,197458,0,2,1
56524,2,1,197458,197458,197459,0,1,0
56525,4,1,197462,197462,197463,0,1,3
56526,1,1,197463,197463,197464,0,1,0
56527,1,1,197464,197464,197465,0,1,0
56528,6,1,197470,197470,197471,0,1,5
56529,4,3,197474,197474,197477,0,3,3
56530,4,3,197478,197478,197481,0,3,1
56531,3,1,197481,197481,197482,0,1,0
56532,5,2,197486,197486,197488,0,2,4
56533,3,1,197489,197489,197490,0,1,1
56534,6,3,197495,197495,197498,0,3,5
56535,3,2,197498,197498,197500,0,2,0
56536,4,3,197502,197502,197505,0,3,2
56537,1,1,197503,197505,197506,2,3,0
56538,3,1,197506,197506,197507,0,1,0
56539,5,2,197511,197511,197513,0,2,4
56540,6,2,197517,197517,197519,0,2,4
56541,5,3,197522,197522,197525,0,3,3
56542,6,1,197528,197528,197529,0,1,3
56543,1,1,197529,197529,197530,0,1,0
56544,3,3,197532,197532,197535,0,3,2
56545,1,1,197533,197535,197536,2,3,0
56546,4,2,197537,197537,197539,0,2,1
56547,1,1,197538,197539,197540,1,2,0
56548,4,2,197542,197542,197544,0,2,2
56549,2,3,197544,197544,197547,0,3,0
56550,2,2,197546,197547,197549,1,3,0
56551,6,3,197552,197552,197555,0,3,3
56552,4,1,197556,197556,197557,0,1,1
56553,6,2,197562,197562,197564,0,2,5
56554,1,2,197563,197564,197566,1,3,0
56555,6,1,197569,197569,197570,0,1,3
56556,4,1,197573,197573,197574,0,1,3
56557,2,3,197575,197575,197578,0,3,1
56558,6,1,197581,197581,197582,0,1,3
56559,2,2,197583,197583,197585,0,2,1
56560,6,2,197589,197589,197591,0,2,4
56561,5,3,197594,197594,197597,0,3,3
56562,3,2,197597,197597,197599,0,2,0
56563,1,2,197598,197599,197601,1,3,0
56564,5,1,197603,197603,197604,0,1,2
56565,4,1,197607,197607,197608,0,1,3
56566,5,3,197612,197612,197615,0,3,4
56567,2,2,197614,197615,197617,1,3,0
56568,4,1,197618,197618,197619,0,1,1
56569,6,2,197624,197624,197626,0,2,5
56570,2,3,197626,197626,197629,0,3,0
56571,6,1,197632,197632,197633,0,1,3
56572,3,2,197635,197635,197637,0,2,2
56573,6,2,197641,197641,197643,0,2,4
56574,2,3,197643,197643,197646,0,3,0
56575,1,3,197644,197646,197649,2,5,0
56576,5,2,197649,197649,197651,0,2,0
56577,4,1,197653,197653,197654,0,1,2
56578,3,3,197656,197656,197659,0,3,2
56579,6,1,197662,197662,197663,0,1,3
56580,3,3,197665,197665,197668,0,3,2
56581,1,2,197666,197668,197670,2,4,0
56582,4,3,197670,197670,197673,0,3,0
56583,2,3,197672,197673,197676,1,4,0
56584,5,2,197677,197677,197679,0,2,1
56585,4,2,197681,197681,197683,0,2,2
56586,2,1,197683,197683,197684,0,1,0
56587,5,3,197688,197688,197691,0,3,4
56588,2,3,197690,197691,197694,1,4,0
56589,2,1,197692,197694,197695,2,3,0
56590,2,2,197694,197695,197697,1,3,0
56591,5,1,197699,197699,197700,0,1,2
56592,4,3,197703,197703,197706,0,3,3
56593,2,3,197705,197706,197709,1,4,0
56594,2,3,197707,197709,197712,2,5,0
56595,2,2,197709,197712,197714,3,5,0
56596,5,1,197714,197714,197715,0,1,0
56597,2,2,197716,197716,197718,0,2,1
56598,4,3,197720,197720,197723,0,3,2
56599,4,3,197724,197724,197727,0,3,1
56600,2,1,197726,197727,197728,1,2,0
56601,1,1,197727,197728,197729,1,2,0
56602,1,3,197728,197729,197732,1,4,0
56603,1,2,197729,197732,197734,3,5,0
56604,1,2,197730,197734,197736,4,6,0
56605,6,2,197736,197736,197738,0,2,0
56606,2,3,197738,197738,197741,0,3,0
56607,1,2,197739,197741,197743,2,4,0
56608,1,1,197740,197743,197744,3,4,0
56609,6,2,197746,197746,197748,0,2,2
56610,3,3,197749,197749,197752,0,3,1
56611,4,2,197753,197753,197755,0,2,1
56612,1,3,197754,197755,197758,1,4,0
56613,5,2,197759,197759,197761,0,2,1
56614,4,2,197763,197763,197765,0,2,2
56615,6,2,197769,197769,197771,0,2,4
56616,3,1,197772,197772,197773,0,1,1
56617,6,1,197778,197778,197779,0,1,5
56618,6,2,197784,197784,197786,0,2,5
56619,6,2,197790,197790,197792,0,2,4
56620,3,3,197793,197793,197796,0,3,1
56621,5,2,197798,197798,197800,0,2,2
56622,3,2,197801,197801,197803,0,2,1
56623,2,1,197803,197803,197804,0,1,0
56624,5,1,197808,197808,197809,0,1,4
56625,6,1,197814,197814,197815,0,1,5
56626,3,3,197817,197817,197820,0,3,2
56627,5,1,197822,197822,197823,0,1,2
56628,6,2,197828,197828,197830,0,2,5
56629,4,1,197832,197832,197833,0,1,2
56630,5,2,197837,197837,197839,0,2,4
56631,6,1,197843,197843,197844,0,1,4
56632,6,2,197849,197849,197851,0,2,5
56633,3,1,197852,197852,197853,0,1,1
56634,1,1,197853,197853,197854,0,1,0
56635,4,2,197857,197857,197859,0,2,3
56636,5,3,197862,197862,197865,0,3,3
56637,5,3,197867,197867,197870,0,3,2
56638,6,3,197873,197873,197876,0,3,3
56639,4,2,197877,197877,197879,0,2,1
56640,1,2,197878,197879,197881,1,3,0
56641,2,3,197880,197881,197884,1,4,0
56642,6,3,197886,197886,197889,0,3,2
56643,6,1,197892,197892,197893,0,1,3
56644,2,2,197894,197894,197896,0,2,1
56645,2,3,197896,197896,197899,0,3,0
56646,5,1,197901,197901,197902,0,1,2
56647,6,1,197907,197907,197908,0,1,5
56648,5,1,197912,197912,197913,0,1,4
56649,2,2,197914,197914,197916,0,2,1
56650,3,2,197917,197917,197919,0,2,1
56651,3,2,197920,197920,197922,0,2,1
56652,2,1,197922,197922,197923,0,1,0
56653,2,1,197924,197924,197925,0,1,1
56654,5,2,197929,197929,197931,0,2,4
56655,4,2,197933,197933,197935,0,2,2
56656,3,1,197936,197936,197937,0,1,1
56657,1,3,197937,197937,197940,0,3,0
56658,6,1,197943,197943,197944,0,1,3
56659,1,2,197944,197944,197946,0,2,0
56660,6,3,197950,197950,197953,0,3,4
56661,6,3,197956,197956,197959,0,3,3
56662,1,3,197957,197959,197962,2,5,0
56663,2,2,197959,197962,197964,3,5,0
56664,6,1,197965,197965,197966,0,1,1
56665,6,1,197971,197971,197972,0,1,5
56666,6,1,197977,197977,197978,0,1,5
56667,5,2,197982,197982,197984,0,2,4
56668,3,2,197985,197985,197987,0,2,1
56669,6,3,197991,197991,197994,0,3,4
56670,4,1,197995,197995,197996,0,1,1
56671,3,1,197998,197998,197999,0,1,2
56672,1,3,197999,197999,198002,0,3,0
56673,1,3,198000,198002,198005,2,5,0
56674,5,2,198005,198005,198007,0,2,0
56675,3,2,198008,198008,198010,0,2,1
56676,3,2,198011,198011,198013,0,2,1
56677,2,3,198013,198013,198016,0,3,0
56678,2,2,198015,198016,198018,1,3,0
56679,6,3,198021,198021,198024,0,3,3
56680,1,3,198022,198024,198027,2,5,0
56681,1,2,198023,198027,198029,4,6,0
56682,5,1,198028,198029,198030,1,2,0
56683,1,2,198029,198030,198032,1,3,0
56684,3,2,198032,198032,198034,0,2,0
56685,2,2,198034,198034,198036,0,2,0
56686,2,3,198036,198036,198039,0,3,0
56687,2,1,198038,198039,198040,1,2,0
56688,3,1,198041,198041,198042,0,1,1
56689,4,3,198045,198045,198048,0,3,3
56690,6,1,198051,198051,198052,0,1,3
56691,3,1,198054,198054,198055,0,1,2
56692,3,3,198057,198057,198060,0,3,2
56693,3,1,198060,198060,198061,0,1,0
56694,6,2,198066,198066,198068,0,2,5
56695,1,1,198067,198068,198069,1,2,0
56696,4,2,198071,198071,198073,0,2,2
56697,1,3,198072,198073,198076,1,4,0
56698,4,2,198076,198076,198078,0,2,0
56699,4,1,198080,198080,198081,0,1,2
56700,5,3,198085,198085,198088,0,3,4
56701,1,1,198086,198088,198089,2,3,0
56702,5,2,198091,198091,198093,0,2,2
56703,6,1,198097,198097,198098,0,1,4
56704,6,1,198103,198103,198104,0,1,5
56705,5,3,198108,198108,198111,0,3,4
56706,5,3,198113,198113,198116,0,3,2
56707,4,2,198117,198117,198119,0,2,1
56708,1,3,198118,198119,198122,1,4,0
56709,2,2,198120,198122,198124,2,4,0
56710,4,1,198124,198124,198125,0,1,0
56711,3,2,198127,198127,198129,0,2,2
56712,5,3,198132,198132,198135,0,3,3
56713,4,3,198136,198136,198139,0,3,1
56714,2,2,198138,198139,198141,1,3,0
56715,5,2,198143,198143,198145,0,2,2
56716,4,1,198147,198147,198148,0,1,2
56717,6,3,198153,198153,198156,0,3,5
56718,2,1,198155,198156,198157,1,2,0
56719,4,3,198159,198159,198162,0,3,2
56720,3,2,198162,198162,198164,0,2,0
56721,2,2,198164,198164,198166,0,2,0
56722,2,1,198166,198166,198167,0,1,0
56723,6,2,198172,198172,198174,0,2,5
56724,4,2,198176,198176,198178,0,2,2
56725,1,1,198177,198178,198179,1,2,0
56726,5,2,198182,198182,198184,0,2,3
56727,2,2,198184,198184,198186,0,2,0
56728,5,1,198189,198189,198190,0,1,3
56729,4,2,198193,198193,198195,0,2,3
56730,5,1,198198,198198,198199,0,1,3
56731,5,3,198203,198203,198206,0,3,4
56732,2,3,198205,198206,198209,1,4,0
56733,4,1,198209,198209,198210,0,1,0
56734,1,3,198210,198210,198213,0,3,0
56735,4,1,198214,198214,198215,0,1,1
56736,5,3,198219,198219,198222,0,3,4
56737,1,3,198220,198222,198225,2,5,0
56738,1,2,198221,198225,198227,4,6,0
56739,3,2,198224,198227,198229,3,5,0
56740,6,3,198230,198230,198233,0,3,1
56741,5,1,198235,198235,198236,0,1,2
56742,5,2,198240,198240,198242,0,2,4
56743,3,3,198243,198243,198246,0,3,1
56744,4,3,198247,198247,198250,0,3,1
56745,6,3,198253,198253,198256,0,3,3
56746,5,1,198258,198258,198259,0,1,2
56747,1,3,198259,198259,198262,0,3,0
56748,6,1,198265,198265,198266,0,1,3
56749,1,1,198266,198266,198267,0,1,0
56750,1,1,198267,198267,198268,0,1,0
56751,5,2,198272,198272,198274,0,2,4
56752,2,2,198274,198274,198276,0,2,0
56753,1,3,198275,198276,198279,1,4,0
56754,2,3,198277,198279,198282,2,5,0
56755,2,1,198279,198282,198283,3,4,0
56756,3,2,198282,198283,198285,1,3,0
56757,6,2,198288,198288,198290,0,2,3
56758,4,3,198292,198292,198295,0,3,2
56759,1,1,198293,198295,198296,2,3,0
56760,1,1,198294,198296,198297,2,3,0
56761,4,3,198298,198298,198301,0,3,1
56762,1,3,198299,198301,198304,2,5,0
56763,1,1,198300,198304,198305,4,5,0
56764,3,1,198303,198305,198306,2,3,0
56765,1,1,198304,198306,198307,2,3,0
56766,5,2,198309,198309,198311,0,2,2
56767,6,3,198315,198315,198318,0,3,4
56768,3,2,198318,198318,198320,0,2,0
56769,6,2,198324,198324,198326,0,2,4
56770,5,2,198329,198329,198331,0,2,3
56771,6,3,198335,198335,198338,0,3,4
56772,6,2,198341,198341,198343,0,2,3
56773,2,1,198343,198343,198344,0,1,0
56774,5,1,198348,198348,198349,0,1,4
56775,3,3,198351,198351,198354,0,3,2
56776,6,1,198357,198357,198358,0,1,3
56777,4,1,198361,198361,198362,0,1,3
56778,5,3,198366,198366,198369,0,3,4
56779,5,3,198371,198371,198374,0,3,2
56780,5,2,198376,198376,198378,0,2,2
56781,3,3,198379,198379,198382,0,3,1
56782,4,3,198383,198383,198386,0,3,1
56783,4,3,198387,198387,198390,0,3,1
56784,1,3,198388,198390,198393,2,5,0
56785,1,3,198389,198393,198396,4,7,0
56786,6,1,198395,198396,198397,1,2,0
56787,6,2,198401,198401,198403,0,2,4
56788,4,3,198405,198405,198408,0,3,2
56789,5,1,198410,198410,198411,0,1,2
56790,6,1,198416,198416,198417,0,1,5
56791,1,2,198417,198417,198419,0,2,0
56792,4,2,198421,198421,198423,0,2,2
56793,2,2,198423,198423,198425,0,2,0
56794,5,2,198428,198428,198430,0,2,3
56795,5,2,198433,198433,198435,0,2,3
56796,4,1,198437,198437,198438,0,1,2
56797,2,3,198439,198439,198442,0,3,1
56798,5,1,198444,198444,198445,0,1,2
56799,2,1,198446,198446,198447,0,1,1
56800,4,3,198450,198450,198453,0,3,3
56801,2,2,198452,198453,198455,1,3,0
56802,1,2,198453,198455,198457,2,4,0
56803,3,3,198456,198457,198460,1,4,0
56804,3,2,198459,198460,198462,1,3,0
56805,2,2,198461,198462,198464,1,3,0
56806,2,3,198463,198464,198467,1,4,0
56807,2,3,198465,198467,198470,2,5,0
56808,1,2,198466,198470,198472,4,6,0
56809,4,2,198470,198472,198474,2,4,0
56810,5,1,198475,198475,198476,0,1,1
56811,5,2,198480,198480,198482,0,2,4
56812,4,2,198484,198484,198486,0,2,2
56813,1,1,198485,198486,198487,1,2,0
56814,5,3,198490,198490,198493,0,3,3
56815,1,1,198491,198493,198494,2,3,0
56816,1,1,198492,198494,198495,2,3,0
56817,1,2,198493,198495,198497,2,4,0
56818,6,1,198499,198499,198500,0,1,2
56819,4,1,198503,198503,198504,0,1,3
56820,3,2,198506,198506,198508,0,2,2
56821,2,3,198508,198508,198511,0,3,0
56822,5,3,198513,198513,198516,0,3,2
56823,6,2,198519,198519,198521,0,2,3
56824,4,2,198523,198523,198525,0,2,2
56825,2,1,198525,198525,198526,0,1,0
56826,6,3,198531,198531,198534,0,3,5
56827,4,2,198535,198535,198537,0,2,1
56828,5,2,198540,198540,198542,0,2,3
56829,2,3,198542,198542,198545,0,3,0
56830,3,3,198545,198545,198548,0,3,0
56831,1,1,198546,198548,198549,2,3,0
56832,5,3,198551,198551,198554,0,3,2
56833,2,1,198553,198554,198555,1,2,0
56834,3,3,198556,198556,198559,0,3,1
56835,2,3,198558,198559,198562,1,4,0
56836,1,3,198559,198562,198565,3,6,0
56837,1,3,198560,198565,198568,5,8,0
56838,5,2,198565,198568,198570,3,5,0
56839,4,3,198569,198570,198573,1,4,0
56840,3,3,198572,198573,198576,1,4,0
56841,1,1,198573,198576,198577,3,4,0
56842,4,3,198577,198577,198580,0,3,0
56843,1,3,198578,198580,198583,2,5,0
56844,5,1,198583,198583,198584,0,1,0
56845,1,1,198584,198584,198585,0,1,0
56846,3,3,198587,198587,198590,0,3,2
56847,4,3,198591,198591,198594,0,3,1
56848,4,2,198595,198595,198597,0,2,1
56849,3,3,198598,198598,198601,0,3,1
56850,5,3,198603,198603,198606,0,3,2
56851,3,3,198606,198606,198609,0,3,0
56852,5,1,198611,198611,198612,0,1,2
56853,2,1,198613,198613,198614,0,1,1
56854,2,1,198615,198615,198616,0,1,1
56855,2,3,198617,198617,198620,0,3,1
56856,5,1,198622,198622,198623,0,1,2
56857,2,2,198624,198624,198626,0,2,1
56858,4,2,198628,198628,198630,0,2,2
56859,5,2,198633,198633,198635,0,2,3
56860,3,2,198636,198636,198638,0,2,1
56861,2,1,198638,198638,198639,0,1,0
56862,6,1,198644,198644,198645,0,1,5
56863,5,1,198649,198649,198650,0,1,4
56864,4,2,198653,198653,198655,0,2,3
56865,6,1,198659,198659,198660,0,1,4
56866,2,1,198661,198661,198662,0,1,1
56867,4,2,198665,198665,198667,0,2,3
56868,2,2,198667,198667,198669,0,2,0
56869,6,1,198673,198673,198674,0,1,4
56870,4,3,198677,198677,198680,0,3,3
56871,5,3,198682,198682,198685,0,3,2
56872,6,2,198688,198688,198690,0,2,3
56873,4,1,198692,198692,198693,0,1,2
56874,4,2,198696,198696,198698,0,2,3
56875,1,3,198697,198698,198701,1,4,0
56876,4,2,198701,198701,198703,0,2,0
56877,3,1,198704,198704,198705,0,1,1
56878,3,3,198707,198707,198710,0,3,2
56879,1,1,198708,198710,198711,2,3,0
56880,1,1,198709,198711,198712,2,3,0
56881,1,2,198710,198712,198714,2,4,0
56882,6,3,198716,198716,198719,0,3,2
56883,6,1,198722,198722,198723,0,1,3
56884,6,3,198728,198728,198731,0,3,5
56885,5,3,198733,198733,198736,0,3,2
56886,3,3,198736,198736,198739,0,3,0
56887,2,1,198738,198739,198740,1,2,0
56888,5,1,198743,198743,198744,0,1,3
56889,5,3,198748,198748,198751,0,3,4
56890,5,2,198753,198753,198755,0,2,2
56891,5,1,198758,198758,198759,0,1,3
56892,2,1,198760,198760,198761,0,1,1
56893,2,3,198762,198762,198765,0,3,1
56894,3,3,198765,198765,198768,0,3,0
56895,2,2,198767,198768,198770,1,3,0
56896,5,1,198772,198772,198773,0,1,2
56897,4,1,198776,198776,198777,0,1,3
56898,5,3,198781,198781,198784,0,3,4
56899,2,2,198783,198784,198786,1,3,0
56900,5,3,198788,198788,198791,0,3,2
56901,2,1,198790,198791,198792,1,2,0
56902,6,1,198796,198796,198797,0,1,4
56903,4,3,198800,198800,198803,0,3,3
56904,4,3,198804,198804,198807,0,3,1
56905,3,2,198807,198807,198809,0,2,0
56906,4,3,198811,198811,198814,0,3,2
56907,4,2,198815,198815,198817,0,2,1
56908,1,2,198816,198817,198819,1,3,0
56909,5,3,198821,198821,198824,0,3,2
56910,1,2,198822,198824,198826,2,4,0
56911,6,3,198828,198828,198831,0,3,2
56912,3,2,198831,198831,198833,0,2,0
56913,2,3,198833,198833,198836,0,3,0
56914,6,2,198839,198839,198841,0,2,3
56915,5,2,198844,198844,198846,0,2,3
56916,2,2,198846,198846,198848,0,2,0
56917,3,2,198849,198849,198851,0,2,1
56918,2,2,198851,198851,198853,0,2,0
56919,3,2,198854,198854,198856,0,2,1
56920,4,2,198858,198858,198860,0,2,2
56921,5,2,198863,198863,198865,0,2,3
56922,6,1,198869,198869,198870,0,1,4
56923,6,3,198875,198875,198878,0,3,5
56924,2,3,198877,198878,198881,1,4,0
56925,6,3,198883,198883,198886,0,3,2
56926,5,2,198888,198888,198890,0,2,2
56927,1,2,198889,198890,198892,1,3,0
56928,6,2,198895,198895,198897,0,2,3
56929,5,3,198900,198900,198903,0,3,3
56930,3,2,198903,198903,198905,0,2,0
56931,2,1,198905,198905,198906,0,1,0
56932,1,2,198906,198906,198908,0,2,0
56933,3,2,198909,198909,198911,0,2,1
56934,3,1,198912,198912,198913,0,1,1
56935,4,2,198916,198916,198918,0,2,3
56936,5,2,198921,198921,198923,0,2,3
56937,5,3,198926,198926,198929,0,3,3
56938,1,1,198927,198929,198930,2,3,0
56939,2,3,198929,198930,198933,1,4,0
56940,5,2,198934,198934,198936,0,2,1
56941,2,3,198936,198936,198939,0,3,0
56942,5,3,198941,198941,198944,0,3,2
56943,4,1,198945,198945,198946,0,1,1
56944,4,3,198949,198949,198952,0,3,3
56945,1,2,198950,198952,198954,2,4,0
56946,2,2,198952,198954,198956,2,4,0
56947,6,3,198958,198958,198961,0,3,2
56948,2,2,198960,198961,198963,1,3,0
56949,6,2,198966,198966,198968,0,2,3
56950,5,2,198971,198971,198973,0,2,3
56951,6,3,198977,198977,198980,0,3,4
56952,6,2,198983,198983,198985,0,2,3
56953,3,1,198986,198986,198987,0,1,1
56954,2,1,198988,198988,198989,0,1,1
56955,1,1,198989,198989,198990,0,1,0
56956,3,1,198992,198992,198993,0,1,2
56957,4,1,198996,198996,198997,0,1,3
56958,1,2,198997,198997,198999,0,2,0
56959,5,2,199002,199002,199004,0,2,3
56960,5,1,199007,199007,199008,0,1,3
56961,5,3,199012,199012,199015,0,3,4
56962,6,2,199018,199018,199020,0,2,3
56963,5,2,199023,199023,199025,0,2,3
56964,6,3,199029,199029,199032,0,3,4
56965,4,1,199033,199033,199034,0,1,1
56966,4,3,199037,199037,199040,0,3,3
56967,5,1,199042,199042,199043,0,1,2
56968,2,1,199044,199044,199045,0,1,1
56969,4,2,199048,199048,199050,0,2,3
56970,3,3,199051,199051,199054,0,3,1
56971,5,3,199056,199056,199059,0,3,2
56972,2,1,199058,199059,199060,1,2,0
56973,6,3,199064,199064,199067,0,3,4
56974,6,1,199070,199070,199071,0,1,3
56975,3,3,199073,199073,199076,0,3,2
56976,3,2,199076,199076,199078,0,2,0
56977,5,3,199081,199081,199084,0,3,3
56978,6,2,199087,199087,199089,0,2,3
56979,6,2,199093,199093,199095,0,2,4
56980,6,2,199099,199099,199101,0,2,4
56981,1,1,199100,199101,199102,1,2,0
56982,5,3,199105,199105,199108,0,3,3
56983,2,3,199107,199108,199111,1,4,0
56984,1,1,199108,199111,199112,3,4,0
56985,1,3,199109,199112,199115,3,6,0
56986,3,3,199112,199115,199118,3,6,0
56987,1,3,199113,199118,199121,5,8,0
56988,5,2,199118,199121,199123,3,5,0
56989,5,2,199123,199123,199125,0,2,0
56990,2,3,199125,199125,199128,0,3,0
56991,3,3,199128,199128,199131,0,3,0
56992,4,2,199132,199132,199134,0,2,1
56993,6,3,199138,199138,199141,0,3,4
56994,6,3,199144,199144,199147,0,3,3
56995,5,2,199149,199149,199151,0,2,2
56996,5,2,199154,199154,199156,0,2,3
56997,1,1,199155,199156,199157,1,2,0
56998,3,2,199158,199158,199160,0,2,1
56999,2,1,199160,199160,199161,0,1,0
57000,4,1,199164,199164,199165,0,1,3
57001,2,1,199166,199166,199167,0,1,1
57002,5,1,199171,199171,199172,0,1,4
57003,3,3,199174,199174,199177,0,3,2
57004,4,1,199178,199178,199179,0,1,1
57005,5,3,199183,199183,199186,0,3,4
57006,6,1,199189,199189,199190,0,1,3
57007,6,1,199195,199195,199196,0,1,5
57008,6,2,199201,199201,199203,0,2,5
57009,1,2,199202,199203,199205,1,3,0
57010,4,3,199206,199206,199209,0,3,1
57011,3,1,199209,199209,199210,0,1,0
57012,4,1,199213,199213,199214,0,1,3
57013,4,2,199217,199217,199219,0,2,3
57014,3,3,199220,199220,199223,0,3,1
57015,1,2,199221,199223,199225,2,4,0
57016,2,3,199223,199225,199228,2,5,0
57017,6,2,199229,199229,199231,0,2,1
57018,2,1,199231,199231,199232,0,1,0
57019,4,1,199235,199235,199236,0,1,3
57020,4,2,199239,199239,199241,0,2,3
57021,2,1,199241,199241,199242,0,1,0
57022,4,2,199245,199245,199247,0,2,3
57023,2,1,199247,199247,199248,0,1,0
57024,2,3,199249,199249,199252,0,3,1
57025,2,1,199251,199252,199253,1,2,0
57026,5,3,199256,199256,199259,0,3,3
57027,1,1,199257,199259,199260,2,3,0
57028,2,3,199259,199260,199263,1,4,0
57029,5,1,199264,199264,199265,0,1,1
57030,1,3,199265,199265,199268,0,3,0
57031,3,3,199268,199268,199271,0,3,0
57032,5,1,199273,199273,199274,0,1,2
57033,4,1,199277,199277,199278,0,1,3
57034,2,1,199279,199279,199280,0,1,1
57035,5,3,199284,199284,199287,0,3,4
57036,2,2,199286,199287,199289,1,3,0
57037,3,2,199289,199289,199291,0,2,0
57038,6,1,199295,199295,199296,0,1,4
57039,3,1,199298,199298,199299,0,1,2
57040,5,2,199303,199303,199305,0,2,4
57041,6,1,199309,199309,199310,0,1,4
57042,2,1,199311,199311,199312,0,1,1
57043,1,2,199312,199312,199314,0,2,0
57044,2,3,199314,199314,199317,0,3,0
57045,6,2,199320,199320,199322,0,2,3
57046,2,1,199322,199322,199323,0,1,0
57047,4,2,199326,199326,199328,0,2,3
57048,1,1,199327,199328,199329,1,2,0
57049,6,1,199333,199333,199334,0,1,4
57050,3,3,199336,199336,199339,0,3,2
57051,1,3,199337,199339,199342,2,5,0
57052,3,3,199340,199342,199345,2,5,0
57053,3,3,199343,199345,199348,2,5,0
57054,4,1,199347,199348,199349,1,2,0
57055,1,2,199348,199349,199351,1,3,0
57056,2,3,199350,199351,199354,1,4,0
57057,3,1,199353,199354,199355,1,2,0
57058,5,2,199358,199358,199360,0,2,3
57059,5,1,199363,199363,199364,0,1,3
57060,3,1,199366,199366,199367,0,1,2
57061,2,2,199368,199368,199370,0,2,1
57062,4,3,199372,199372,199375,0,3,2
57063,2,3,199374,199375,199378,1,4,0
57064,3,3,199377,199378,199381,1,4,0
57065,6,3,199383,199383,199386,0,3,2
57066,1,2,199384,199386,199388,2,4,0
57067,3,3,199387,199388,199391,1,4,0
57068,2,3,199389,199391,199394,2,5,0
57069,5,1,199394,199394,199395,0,1,0
57070,2,1,199396,199396,199397,0,1,1
57071,1,1,199397,199397,199398,0,1,0
57072,1,2,199398,199398,199400,0,2,0
57073,1,3,199399,199400,199403,1,4,0
57074,3,1,199402,199403,199404,1,2,0
57075,5,2,199407,199407,199409,0,2,3
57076,2,3,199409,199409,199412,0,3,0
57077,6,1,199415,199415,199416,0,1,3
57078,6,2,199421,199421,199423,0,2,5
57079,6,3,199427,199427,199430,0,3,4
57080,5,2,199432,199432,199434,0,2,2
57081,5,2,199437,199437,199439,0,2,3
57082,4,1,199441,199441,199442,0,1,2
57083,4,1,199445,199445,199446,0,1,3
57084,6,1,199451,199451,199452,0,1,5
57085,1,3,199452,199452,199455,0,3,0
57086,4,2,199456,199456,199458,0,2,1
57087,6,2,199462,199462,199464,0,2,4
57088,5,2,199467,199467,199469,0,2,3
57089,1,1,199468,199469,199470,1,2,0
57090,4,3,199472,199472,199475,0,3,2
57091,4,1,199476,199476,199477,0,1,1
57092,4,2,199480,199480,199482,0,2,3
57093,1,1,199481,199482,199483,1,2,0
57094,2,2,199483,199483,199485,0,2,0
57095,4,1,199487,199487,199488,0,1,2
57096,2,3,199489,199489,199492,0,3,1
57097,5,3,199494,199494,199497,0,3,2
57098,2,3,199496,199497,199500,1,4,0
57099,6,3,199502,199502,199505,0,3,2
57100,5,1,199507,199507,199508,0,1,2
57101,6,2,199513,199513,199515,0,2,5
57102,3,3,199516,199516,199519,0,3,1
57103,1,3,199517,199519,199522,2,5,0
57104,4,2,199521,199522,199524,1,3,0
57105,5,1,199526,199526,199527,0,1,2
57106,5,2,199531,199531,199533,0,2,4
57107,4,3,199535,199535,199538,0,3,2
57108,6,3,199541,199541,199544,0,3,3
57109,5,1,199546,199546,199547,0,1,2
57110,3,1,199549,199549,199550,0,1,2
57111,6,2,199555,199555,199557,0,2,5
57112,4,1,199559,199559,199560,0,1,2
57113,6,1,199565,199565,199566,0,1,5
57114,3,3,199568,199568,199571,0,3,2
57115,2,2,199570,199571,199573,1,3,0
57116,3,2,199573,199573,199575,0,2,0
57117,1,3,199574,199575,199578,1,4,0
57118,1,1,199575,199578,199579,3,4,0
57119,6,1,199581,199581,199582,0,1,2
57120,5,3,199586,199586,199589,0,3,4
57121,1,2,199587,199589,199591,2,4,0
57122,3,2,199590,199591,199593,1,3,0
57123,5,1,199595,199595,199596,0,1,2
57124,6,2,199601,199601,199603,0,2,5
57125,5,2,199606,199606,199608,0,2,3
57126,3,1,199609,199609,199610,0,1,1
57127,2,3,199611,199611,199614,0,3,1
57128,3,1,199614,199614,199615,0,1,0
57129,4,1,199618,199618,199619,0,1,3
57130,1,3,199619,199619,199622,0,3,0
57131,5,3,199624,199624,199627,0,3,2
57132,5,2,199629,199629,199631,0,2,2
57133,3,2,199632,199632,199634,0,2,1
57134,4,2,199636,199636,199638,0,2,2
57135,5,3,199641,199641,199644,0,3,3
57136,4,3,199645,199645,199648,0,3,1
57137,1,3,199646,199648,199651,2,5,0
57138,5,1,199651,199651,199652,0,1,0
57139,6,1,199657,199657,199658,0,1,5
57140,3,3,199660,199660,199663,0,3,2
57141,6,3,199666,199666,199669,0,3,3
57142,5,3,199671,199671,199674,0,3,2
57143,1,2,199672,199674,199676,2,4,0
57144,3,1,199675,199676,199677,1,2,0
57145,6,1,199681,199681,199682,0,1,4
57146,4,3,199685,199685,199688,0,3,3
57147,6,3,199691,199691,199694,0,3,3
57148,4,2,199695,199695,199697,0,2,1
57149,2,2,199697,199697,199699,0,2,0
57150,5,1,199702,199702,199703,0,1,3
57151,5,2,199707,199707,199709,0,2,4
57152,2,2,199709,199709,199711,0,2,0
57153,5,3,199714,199714,199717,0,3,3
57154,1,3,199715,199717,199720,2,5,0
57155,2,1,199717,199720,199721,3,4,0
57156,6,3,199723,199723,199726,0,3,2
57157,3,3,199726,199726,199729,0,3,0
57158,5,3,199731,199731,199734,0,3,2
57159,4,2,199735,199735,199737,0,2,1
57160,6,1,199741,199741,199742,0,1,4
57161,4,3,199745,199745,199748,0,3,3
57162,4,2,199749,199749,199751,0,2,1
57163,1,1,199750,199751,199752,1,2,0
57164,4,3,199754,199754,199757,0,3,2
57165,2,3,199756,199757,199760,1,4,0
57166,6,3,199762,199762,199765,0,3,2
57167,4,3,199766,199766,199769,0,3,1
57168,6,3,199772,199772,199775,0,3,3
57169,1,3,199773,199775,199778,2,5,0
57170,1,2,199774,199778,199780,4,6,0
57171,3,1,199777,199780,199781,3,4,0
57172,1,1,199778,199781,199782,3,4,0
57173,2,2,199780,199782,199784,2,4,0
57174,5,1,199785,199785,199786,0,1,1
57175,5,2,199790,199790,199792,0,2,4
57176,3,1,199793,199793,199794,0,1,1
57177,1,3,199794,199794,199797,0,3,0
57178,4,3,199798,199798,199801,0,3,1
57179,3,2,199801,199801,199803,0,2,0
57180,5,1,199806,199806,199807,0,1,3
57181,1,1,199807,199807,199808,0,1,0
57182,4,3,199811,199811,199814,0,3,3
57183,6,2,199817,199817,199819,0,2,3
57184,1,1,199818,199819,199820,1,2,0
57185,5,2,199823,199823,199825,0,2,3
57186,6,1,199829,199829,199830,0,1,4
57187,2,1,199831,199831,199832,0,1,1
57188,2,1,199833,199833,199834,0,1,1
57189,5,3,199838,199838,199841,0,3,4
57190,2,2,199840,199841,199843,1,3,0
57191,1,1,199841,199843,199844,2,3,0
57192,4,1,199845,199845,199846,0,1,1
57193,5,3,199850,199850,199853,0,3,4
57194,6,3,199856,199856,199859,0,3,3
57195,2,1,199858,199859,199860,1,2,0
57196,3,3,199861,199861,199864,0,3,1
57197,5,3,199866,199866,199869,0,3,2
57198,2,1,199868,199869,199870,1,2,0
57199,2,2,199870,199870,199872,0,2,0
57200,4,1,199874,199874,199875,0,1,2
57201,3,1,199877,199877,199878,0,1,2
57202,1,1,199878,199878,199879,0,1,0
57203,5,1,199883,199883,199884,0,1,4
57204,3,3,199886,199886,199889,0,3,2
57205,6,1,199892,199892,199893,0,1,3
57206,1,1,199893,199893,199894,0,1,0
57207,6,3,199899,199899,199902,0,3,5
57208,6,3,199905,199905,199908,0,3,3
57209,1,3,199906,199908,199911,2,5,0
57210,1,1,199907,199911,199912,4,5,0
57211,4,3,199911,199912,199915,1,4,0
57212,2,3,199913,199915,199918,2,5,0
57213,2,1,199915,199918,199919,3,4,0
57214,3,1,199918,199919,199920,1,2,0
57215,3,2,199921,199921,199923,0,2,1
57216,3,3,199924,199924,199927,0,3,1
57217,1,3,199925,199927,199930,2,5,0
57218,1,3,199926,199930,199933,4,7,0
57219,6,2,199932,199933,199935,1,3,0
57220,6,2,199938,199938,199940,0,2,3
57221,6,3,199944,199944,199947,0,3,4
57222,2,1,199946,199947,199948,1,2,0
57223,6,3,199952,199952,199955,0,3,4
57224,6,1,199958,199958,199959,0,1,3
57225,1,1,199959,199959,199960,0,1,0
57226,4,3,199963,199963,199966,0,3,3
57227,4,2,199967,199967,199969,0,2,1
57228,4,1,199971,199971,199972,0,1,2
57229,5,3,199976,199976,199979,0,3,4
57230,6,1,199982,199982,199983,0,1,3
57231,3,2,199985,199985,199987,0,2,2
57232,2,3,199987,199987,199990,0,3,0
57233,1,2,199988,199990,199992,2,4,0
57234,6,3,199994,199994,199997,0,3,2
57235,6,1,200000,200000,200001,0,1,3
57236,3,1,200003,200003,200004,0,1,2
57237,1,3,200004,200004,200007,0,3,0
57238,2,3,200006,200007,200010,1,4,0
57239,1,1,200007,200010,200011,3,4,0
57240,6,2,200013,200013,200015,0,2,2
57241,5,1,200018,200018,200019,0,1,3
57242,6,3,200024,200024,200027,0,3,5
57243,1,1,200025,200027,200028,2,3,0
57244,6,2,200031,200031,200033,0,2,3
57245,6,3,200037,200037,200040,0,3,4
57246,5,3,200042,200042,200045,0,3,2
57247,6,2,200048,200048,200050,0,2,3
57248,6,3,200054,200054,200057,0,3,4
57249,5,1,200059,200059,200060,0,1,2
57250,4,3,200063,200063,200066,0,3,3
57251,2,2,200065,200066,200068,1,3,0
57252,3,3,200068,200068,200071,0,3,0
57253,3,3,200071,200071,200074,0,3,0
57254,3,3,200074,200074,200077,0,3,0
57255,6,3,200080,200080,200083,0,3,3
57256,6,3,200086,200086,200089,0,3,3
57257,4,3,200090,200090,200093,0,3,1
57258,2,1,200092,200093,200094,1,2,0
57259,2,3,200094,200094,200097,0,3,0
57260,6,2,200100,200100,200102,0,2,3
57261,6,3,200106,200106,200109,0,3,4
57262,3,3,200109,200109,200112,0,3,0
57263,5,3,200114,200114,200117,0,3,2
57264,3,2,200117,200117,200119,0,2,0
57265,6,1,200123,200123,200124,0,1,4
57266,1,1,200124,200124,200125,0,1,0
57267,4,1,200128,200128,200129,0,1,3
57268,6,1,200134,200134,200135,0,1,5
57269,6,3,200140,200140,200143,0,3,5
57270,1,2,200141,200143,200145,2,4,0
57271,4,1,200145,200145,200146,0,1,0
57272,4,1,200149,200149,200150,0,1,3
57273,1,3,200150,200150,200153,0,3,0
57274,2,3,200152,200153,200156,1,4,0
57275,5,1,200157,200157,200158,0,1,1
57276,2,3,200159,200159,200162,0,3,1
57277,1,1,200160,200162,200163,2,3,0
57278,5,3,200165,200165,200168,0,3,2
57279,2,2,200167,200168,200170,1,3,0
57280,6,3,200173,200173,200176,0,3,3
57281,2,3,200175,200176,200179,1,4,0
57282,1,2,200176,200179,200181,3,5,0
57283,1,3,200177,200181,200184,4,7,0
57284,2,1,200179,200184,200185,5,6,0
57285,6,2,200185,200185,200187,0,2,0
57286,3,3,200188,200188,200191,0,3,1
57287,2,2,200190,200191,200193,1,3,0
57288,5,1,200195,200195,200196,0,1,2
57289,2,1,200197,200197,200198,0,1,1
57290,5,2,200202,200202,200204,0,2,4
57291,2,1,200204,200204,200205,0,1,0
57292,5,3,200209,200209,200212,0,3,4
57293,5,1,200214,200214,200215,0,1,2
57294,4,2,200218,200218,200220,0,2,3
57295,5,2,200223,200223,200225,0,2,3
57296,4,2,200227,200227,200229,0,2,2
57297,1,2,200228,200229,200231,1,3,0
57298,2,3,200230,200231,200234,1,4,0
57299,1,1,200231,200234,200235,3,4,0
57300,1,2,200232,200235,200237,3,5,0
57301,6,3,200238,200238,200241,0,3,1
57302,2,2,200240,200241,200243,1,3,0
57303,5,2,200245,200245,200247,0,2,2
57304,3,1,200248,200248,200249,0,1,1
57305,1,1,200249,200249,200250,0,1,0
57306,6,2,200255,200255,200257,0,2,5
57307,3,2,200258,200258,200260,0,2,1
57308,3,3,200261,200261,200264,0,3,1
57309,3,1,200264,200264,200265,0,1,0
57310,1,2,200265,200265,200267,0,2,0
57311,4,1,200269,200269,200270,0,1,2
57312,5,1,200274,200274,200275,0,1,4
57313,2,3,200276,200276,200279,0,3,1
57314,4,3,200280,200280,200283,0,3,1
57315,4,2,200284,200284,200286,0,2,1
57316,1,1,200285,200286,200287,1,2,0
57317,5,1,200290,200290,200291,0,1,3
57318,3,2,200293,200293,200295,0,2,2
57319,5,3,200298,200298,200301,0,3,3
57320,1,1,200299,200301,200302,2,3,0
57321,2,3,200301,200302,200305,1,4,0
57322,2,1,200303,200305,200306,2,3,0
57323,4,2,200307,200307,200309,0,2,1
57324,2,1,200309,200309,200310,0,1,0
57325,4,3,200313,200313,200316,0,3,3
57326,5,3,200318,200318,200321,0,3,2
57327,4,2,200322,200322,200324,0,2,1
57328,6,1,200328,200328,200329,0,1,4
57329,3,1,200331,200331,200332,0,1,2
57330,2,3,200333,200333,200336,0,3,1
57331,2,2,200335,200336,200338,1,3,0
57332,2,1,200337,200338,200339,1,2,0
57333,1,2,200338,200339,200341,1,3,0
57334,1,1,200339,200341,200342,2,3,0
57335,4,3,200343,200343,200346,0,3,1
57336,6,1,200349,200349,200350,0,1,3
57337,3,3,200352,200352,200355,0,3,2
57338,4,2,200356,200356,200358,0,2,1
57339,4,1,200360,200360,200361,0,1,2
57340,4,3,200364,200364,200367,0,3,3
57341,4,2,200368,200368,200370,0,2,1
57342,1,1,200369,200370,200371,1,2,0
57343,6,3,200375,200375,200378,0,3,4
57344,3,3,200378,200378,200381,0,3,0
57345,4,1,200382,200382,200383,0,1,1
57346,2,3,200384,200384,200387,0,3,1
57347,1,1,200385,200387,200388,2,3,0
57348,3,3,200388,200388,200391,0,3,0
57349,4,1,200392,200392,200393,0,1,1
57350,3,2,200395,200395,200397,0,2,2
57351,3,3,200398,200398,200401,0,3,1
57352,2,1,200400,200401,200402,1,2,0
57353,4,3,200404,200404,200407,0,3,2
57354,5,1,200409,200409,200410,0,1,2
57355,5,3,200414,200414,200417,0,3,4
57356,4,1,200418,200418,200419,0,1,1
57357,3,1,200421,200421,200422,0,1,2
57358,2,3,200423,200423,200426,0,3,1
57359,2,2,200425,200426,200428,1,3,0
57360,5,1,200430,200430,200431,0,1,2
57361,6,1,200436,200436,200437,0,1,5
57362,1,3,200437,200437,200440,0,3,0
57363,3,1,200440,200440,200441,0,1,0
57364,4,2,200444,200444,200446,0,2,3
57365,2,3,200446,200446,200449,0,3,0
57366,5,1,200451,200451,200452,0,1,2
57367,2,1,200453,200453,200454,0,1,1
57368,6,2,200459,200459,200461,0,2,5
57369,5,1,200464,200464,200465,0,1,3
57370,5,3,200469,200469,200472,0,3,4
57371,5,2,200474,200474,200476,0,2,2
57372,1,2,200475,200476,200478,1,3,0
57373,6,1,200481,200481,200482,0,1,3
57374,1,2,200482,200482,200484,0,2,0
57375,1,3,200483,200484,200487,1,4,0
57376,5,1,200488,200488,200489,0,1,1
57377,4,2,200492,200492,200494,0,2,3
57378,6,2,200498,200498,200500,0,2,4
57379,4,2,200502,200502,200504,0,2,2
57380,1,3,200503,200504,200507,1,4,0
57381,3,1,200506,200507,200508,1,2,0
57382,4,3,200510,200510,200513,0,3,2
57383,2,3,200512,200513,200516,1,4,0
57384,2,1,200514,200516,200517,2,3,0
57385,2,1,200516,200517,200518,1,2,0
57386,3,3,200519,200519,200522,0,3,1
57387,1,2,200520,200522,200524,2,4,0
57388,4,1,200524,200524,200525,0,1,0
57389,4,1,200528,200528,200529,0,1,3
57390,6,1,200534,200534,200535,0,1,5
57391,1,3,200535,200535,200538,0,3,0
57392,6,1,200541,200541,200542,0,1,3
57393,1,2,200542,200542,200544,0,2,0
57394,4,1,200546,200546,200547,0,1,2
57395,6,3,200552,200552,200555,0,3,5
57396,3,3,200555,200555,200558,0,3,0
57397,2,3,200557,200558,200561,1,4,0
57398,5,3,200562,200562,200565,0,3,1
57399,3,2,200565,200565,200567,0,2,0
57400,5,2,200570,200570,200572,0,2,3
57401,4,2,200574,200574,200576,0,2,2
57402,5,1,200579,200579,200580,0,1,3
57403,2,1,200581,200581,200582,0,1,1
57404,4,3,200585,200585,200588,0,3,3
57405,6,2,200591,200591,200593,0,2,3
57406,3,2,200594,200594,200596,0,2,1
57407,1,3,200595,200596,200599,1,4,0
57408,1,3,200596,200599,200602,3,6,0
57409,6,1,200602,200602,200603,0,1,0
57410,4,3,200606,200606,200609,0,3,3
57411,1,3,200607,200609,200612,2,5,0
57412,6,3,200613,200613,200616,0,3,1
57413,2,1,200615,200616,200617,1,2,0
57414,6,3,200621,200621,200624,0,3,4
57415,2,1,200623,200624,200625,1,2,0
57416,3,1,200626,200626,200627,0,1,1
57417,5,2,200631,200631,200633,0,2,4
57418,1,2,200632,200633,200635,1,3,0
57419,5,1,200637,200637,200638,0,1,2
57420,1,3,200638,200638,200641,0,3,0
57421,2,2,200640,200641,200643,1,3,0
57422,4,1,200644,200644,200645,0,1,1
57423,3,1,200647,200647,200648,0,1,2
57424,4,2,200651,200651,200653,0,2,3
57425,6,1,200657,200657,200658,0,1,4
57426,6,3,200663,200663,200666,0,3,5
57427,6,2,200669,200669,200671,0,2,3
57428,3,1,200672,200672,200673,0,1,1
57429,5,1,200677,200677,200678,0,1,4
57430,4,3,200681,200681,200684,0,3,3
57431,3,3,200684,200684,200687,0,3,0
57432,6,2,200690,200690,200692,0,2,3
57433,6,2,200696,200696,200698,0,2,4
57434,1,2,200697,200698,200700,1,3,0
57435,4,2,200701,200701,200703,0,2,1
57436,4,1,200705,200705,200706,0,1,2
57437,3,2,200708,200708,200710,0,2,2
57438,2,2,200710,200710,200712,0,2,0
57439,2,2,200712,200712,200714,0,2,0
57440,2,3,200714,200714,200717,0,3,0
57441,2,2,200716,200717,200719,1,3,0
57442,5,3,200721,200721,200724,0,3,2
57443,6,2,200727,200727,200729,0,2,3
57444,3,1,200730,200730,200731,0,1,1
57445,1,3,200731,200731,200734,0,3,0
57446,1,1,200732,200734,200735,2,3,0
57447,3,1,200735,200735,200736,0,1,0
57448,1,2,200736,200736,200738,0,2,0
57449,2,3,200738,200738,200741,0,3,0
57450,2,3,200740,200741,200744,1,4,0
57451,3,3,200743,200744,200747,1,4,0
57452,4,1,200747,200747,200748,0,1,0
57453,1,2,200748,200748,200750,0,2,0
57454,2,2,200750,200750,200752,0,2,0
57455,4,2,200754,200754,200756,0,2,2
57456,4,2,200758,200758,200760,0,2,2
57457,6,1,200764,200764,200765,0,1,4
57458,2,2,200766,200766,200768,0,2,1
57459,3,3,200769,200769,200772,0,3,1
57460,3,3,200772,200772,200775,0,3,0
57461,1,2,200773,200775,200777,2,4,0
57462,1,2,200774,200777,200779,3,5,0
57463,2,2,200776,200779,200781,3,5,0
57464,6,1,200782,200782,200783,0,1,1
57465,2,1,200784,200784,200785,0,1,1
57466,3,2,200787,200787,200789,0,2,2
57467,5,1,200792,200792,200793,0,1,3
57468,5,2,200797,200797,200799,0,2,4
57469,5,1,200802,200802,200803,0,1,3
57470,2,2,200804,200804,200806,0,2,1
57471,5,1,200809,200809,200810,0,1,3
57472,1,2,200810,200810,200812,0,2,0
57473,3,1,200813,200813,200814,0,1,1
57474,6,1,200819,200819,200820,0,1,5
57475,4,3,200823,200823,200826,0,3,3
57476,3,1,200826,200826,200827,0,1,0
57477,5,2,200831,200831,200833,0,2,4
57478,1,3,200832,200833,200836,1,4,0
57479,1,2,200833,200836,200838,3,5,0
57480,2,2,200835,200838,200840,3,5,0
57481,2,2,200837,200840,200842,3,5,0
57482,6,3,200843,200843,200846,0,3,1
57483,3,3,200846,200846,200849,0,3,0
57484,4,3,200850,200850,200853,0,3,1
57485,5,2,200855,200855,200857,0,2,2
57486,4,1,200859,200859,200860,0,1,2
57487,6,3,200865,200865,200868,0,3,5
57488,2,2,200867,200868,200870,1,3,0
57489,1,3,200868,200870,200873,2,5,0
57490,5,2,200873,200873,200875,0,2,0
57491,2,3,200875,200875,200878,0,3,0
57492,4,3,200879,200879,200882,0,3,1
57493,2,2,200881,200882,200884,1,3,0
57494,6,2,200887,200887,200889,0,2,3
57495,3,2,200890,200890,200892,0,2,1
57496,5,1,200895,200895,200896,0,1,3
57497,3,1,200898,200898,200899,0,1,2
57498,3,3,200901,200901,200904,0,3,2
57499,1,2,200902,200904,200906,2,4,0
57500,5,1,200907,200907,200908,0,1,1
57501,3,3,200910,200910,200913,0,3,2
57502,1,3,200911,200913,200916,2,5,0
57503,1,1,200912,200916,200917,4,5,0
57504,6,1,200918,200918,200919,0,1,1
57505,1,2,200919,200919,200921,0,2,0
57506,4,3,200923,200923,200926,0,3,2
57507,2,1,200925,200926,200927,1,2,0
57508,3,2,200928,200928,200930,0,2,1
57509,5,1,200933,200933,200934,0,1,3
57510,3,3,200936,200936,200939,0,3,2
57511,6,3,200942,200942,200945,0,3,3
57512,3,2,200945,200945,200947,0,2,0
57513,3,2,200948,200948,200950,0,2,1
57514,5,3,200953,200953,200956,0,3,3
57515,1,3,200954,200956,200959,2,5,0
57516,6,2,200960,200960,200962,0,2,1
57517,1,2,200961,200962,200964,1,3,0
57518,3,3,200964,200964,200967,0,3,0
57519,2,3,200966,200967,200970,1,4,0
57520,3,1,200969,200970,200971,1,2,0
57521,4,3,200973,200973,200976,0,3,2
57522,3,1,200976,200976,200977,0,1,0
57523,5,3,200981,200981,200984,0,3,4
57524,3,2,200984,200984,200986,0,2,0
57525,3,3,200987,200987,200990,0,3,1
57526,1,1,200988,200990,200991,2,3,0
57527,6,3,200994,200994,200997,0,3,3
57528,5,1,200999,200999,201000,0,1,2
57529,3,3,201002,201002,201005,0,3,2
57530,3,3,201005,201005,201008,0,3,0
57531,2,3,201007,201008,201011,1,4,0
57532,6,3,201013,201013,201016,0,3,2
57533,1,1,201014,201016,201017,2,3,0
57534,1,1,201015,201017,201018,2,3,0
57535,1,2,201016,201018,201020,2,4,0
57536,3,1,201019,201020,201021,1,2,0
57537,4,3,201023,201023,201026,0,3,2
57538,1,3,201024,201026,201029,2,5,0
57539,1,2,201025,201029,201031,4,6,0
57540,3,1,201028,201031,201032,3,4,0
57541,6,2,201034,201034,201036,0,2,2
57542,2,3,201036,201036,201039,0,3,0
57543,1,1,201037,201039,201040,2,3,0
57544,4,2,201041,201041,201043,0,2,1
57545,1,3,201042,201043,201046,1,4,0
57546,5,3,201047,201047,201050,0,3,1
57547,5,3,201052,201052,201055,0,3,2
57548,1,3,201053,201055,201058,2,5,0
57549,4,1,201057,201058,201059,1,2,0
57550,6,3,201063,201063,201066,0,3,4
57551,2,2,201065,201066,201068,1,3,0
57552,5,3,201070,201070,201073,0,3,2
57553,6,3,201076,201076,201079,0,3,3
57554,5,1,201081,201081,201082,0,1,2
57555,1,1,201082,201082,201083,0,1,0
57556,1,2,201083,201083,201085,0,2,0
57557,4,3,201087,201087,201090,0,3,2
57558,4,2,201091,201091,201093,0,2,1
57559,1,2,201092,201093,201095,1,3,0
57560,5,3,201097,201097,201100,0,3,2
57561,6,2,201103,201103,201105,0,2,3
57562,6,1,201109,201109,201110,0,1,4
57563,3,1,201112,201112,201113,0,1,2
57564,4,1,201116,201116,201117,0,1,3
57565,3,3,201119,201119,201122,0,3,2
57566,4,2,201123,201123,201125,0,2,1
57567,2,1,201125,201125,201126,0,1,0
57568,3,2,201128,201128,201130,0,2,2
57569,5,3,201133,201133,201136,0,3,3
57570,1,2,201134,201136,201138,2,4,0
57571,3,1,201137,201138,201139,1,2,0
57572,3,2,201140,201140,201142,0,2,1
57573,3,3,201143,201143,201146,0,3,1
57574,4,1,201147,201147,201148,0,1,1
57575,4,2,201151,201151,201153,0,2,3
57576,1,3,201152,201153,201156,1,4,0
57577,2,1,201154,201156,201157,2,3,0
57578,1,1,201155,201157,201158,2,3,0
57579,3,3,201158,201158,201161,0,3,0
57580,6,2,201164,201164,201166,0,2,3
57581,1,2,201165,201166,201168,1,3,0
57582,6,3,201171,201171,201174,0,3,3
57583,2,3,201173,201174,201177,1,4,0
57584,1,1,201174,201177,201178,3,4,0
57585,4,3,201178,201178,201181,0,3,0
57586,2,1,201180,201181,201182,1,2,0
57587,4,3,201184,201184,201187,0,3,2
57588,3,2,201187,201187,201189,0,2,0
57589,4,1,201191,201191,201192,0,1,2
57590,1,3,201192,201192,201195,0,3,0
57591,2,1,201194,201195,201196,1,2,0
57592,2,3,201196,201196,201199,0,3,0
57593,2,3,201198,201199,201202,1,4,0
57594,2,2,201200,201202,201204,2,4,0
57595,3,1,201203,201204,201205,1,2,0
57596,1,3,201204,201205,201208,1,4,0
57597,5,2,201209,201209,201211,0,2,1
57598,4,2,201213,201213,201215,0,2,2
57599,3,1,201216,201216,201217,0,1,1
57600,6,2,201222,201222,201224,0,2,5
57601,1,1,201223,201224,201225,1,2,0
57602,2,3,201225,201225,201228,0,3,0
57603,1,1,201226,201228,201229,2,3,0
57604,1,1,201227,201229,201230,2,3,0
57605,5,3,201232,201232,201235,0,3,2
57606,5,2,201237,201237,201239,0,2,2
57607,1,2,201238,201239,201241,1,3,0
57608,1,1,201239,201241,201242,2,3,0
57609,3,3,201242,201242,201245,0,3,0
57610,5,3,201247,201247,201250,0,3,2
57611,5,1,201252,201252,201253,0,1,2
57612,6,2,201258,201258,201260,0,2,5
57613,4,1,201262,201262,201263,0,1,2
57614,5,1,201267,201267,201268,0,1,4
57615,3,3,201270,201270,201273,0,3,2
57616,2,3,201272,201273,201276,1,4,0
57617,3,3,201275,201276,201279,1,4,0
57618,2,2,201277,201279,201281,2,4,0
57619,3,3,201280,201281,201284,1,4,0
57620,5,2,201285,201285,201287,0,2,1
57621,2,2,201287,201287,201289,0,2,0
57622,4,2,201291,201291,201293,0,2,2
57623,1,3,201292,201293,201296,1,4,0
57624,3,1,201295,201296,201297,1,2,0
57625,6,3,201301,201301,201304,0,3,4
57626,4,3,201305,201305,201308,0,3,1
57627,1,1,201306,201308,201309,2,3,0
57628,1,2,201307,201309,201311,2,4,0
57629,4,2,201311,201311,201313,0,2,0
57630,2,1,201313,201313,201314,0,1,0
57631,2,3,201315,201315,201318,0,3,1
57632,4,2,201319,201319,201321,0,2,1
57633,3,2,201322,201322,201324,0,2,1
57634,6,2,201328,201328,201330,0,2,4
57635,6,3,201334,201334,201337,0,3,4
57636,2,3,201336,201337,201340,1,4,0
57637,4,2,201340,201340,201342,0,2,0
57638,2,1,201342,201342,201343,0,1,0
57639,4,2,201346,201346,201348,0,2,3
57640,3,3,201349,201349,201352,0,3,1
57641,5,3,201354,201354,201357,0,3,2
57642,2,1,201356,201357,201358,1,2,0
57643,5,2,201361,201361,201363,0,2,3
57644,3,3,201364,201364,201367,0,3,1
57645,5,3,201369,201369,201372,0,3,2
57646,6,1,201375,201375,201376,0,1,3
57647,2,1,201377,201377,201378,0,1,1
57648,4,2,201381,201381,201383,0,2,3
57649,1,3,201382,201383,201386,1,4,0
57650,1,3,201383,201386,201389,3,6,0
57651,3,3,201386,201389,201392,3,6,0
57652,6,3,201392,201392,201395,0,3,0
57653,1,1,201393,201395,201396,2,3,0
57654,4,3,201397,201397,201400,0,3,1
57655,1,2,201398,201400,201402,2,4,0
57656,6,3,201404,201404,201407,0,3,2
57657,2,3,201406,201407,201410,1,4,0
57658,1,2,201407,201410,201412,3,5,0
57659,5,2,201412,201412,201414,0,2,0
57660,1,3,201413,201414,201417,1,4,0
57661,1,2,201414,201417,201419,3,5,0
57662,3,2,201417,201419,201421,2,4,0
57663,6,1,201423,201423,201424,0,1,2
57664,1,1,201424,201424,201425,0,1,0
57665,6,2,201430,201430,201432,0,2,5
57666,2,3,201432,201432,201435,0,3,0
57667,3,3,201435,201435,201438,0,3,0
57668,3,3,201438,201438,201441,0,3,0
57669,6,1,201444,201444,201445,0,1,3
57670,4,1,201448,201448,201449,0,1,3
57671,3,3,201451,201451,201454,0,3,2
57672,4,1,201455,201455,201456,0,1,1
57673,3,2,201458,201458,201460,0,2,2
57674,6,1,201464,201464,201465,0,1,4
57675,6,1,201470,201470,201471,0,1,5
57676,4,3,201474,201474,201477,0,3,3
57677,3,1,201477,201477,201478,0,1,0
57678,5,2,201482,201482,201484,0,2,4
57679,3,1,201485,201485,201486,0,1,1
57680,2,2,201487,201487,201489,0,2,1
57681,5,3,201492,201492,201495,0,3,3
57682,1,1,201493,201495,201496,2,3,0
57683,2,3,201495,201496,201499,1,4,0
57684,2,1,201497,201499,201500,2,3,0
57685,4,2,201501,201501,201503,0,2,1
57686,5,2,201506,201506,201508,0,2,3
57687,4,1,201510,201510,201511,0,1,2
57688,6,1,201516,201516,201517,0,1,5
57689,2,1,201518,201518,201519,0,1,1
57690,1,2,201519,201519,201521,0,2,0
57691,4,1,201523,201523,201524,0,1,2
57692,2,1,201525,201525,201526,0,1,1
57693,5,3,201530,201530,201533,0,3,4
57694,2,1,201532,201533,201534,1,2,0
57695,1,2,201533,201534,201536,1,3,0
57696,6,2,201539,201539,201541,0,2,3
57697,6,3,201545,201545,201548,0,3,4
57698,4,1,201549,201549,201550,0,1,1
57699,6,3,201555,201555,201558,0,3,5
57700,6,3,201561,201561,201564,0,3,3
57701,5,3,201566,201566,201569,0,3,2
57702,1,3,201567,201569,201572,2,5,0
57703,2,1,201569,201572,201573,3,4,0
57704,6,1,201575,201575,201576,0,1,2
57705,6,1,201581,201581,201582,0,1,5
57706,5,1,201586,201586,201587,0,1,4
57707,1,3,201587,201587,201590,0,3,0
57708,5,3,201592,201592,201595,0,3,2
57709,3,1,201595,201595,201596,0,1,0
57710,4,1,201599,201599,201600,0,1,3
57711,2,2,201601,201601,201603,0,2,1
57712,1,1,201602,201603,201604,1,2,0
57713,4,1,201606,201606,201607,0,1,2
57714,2,2,201608,201608,201610,0,2,1
57715,6,3,201614,201614,201617,0,3,4
57716,4,1,201618,201618,201619,0,1,1
57717,6,2,201624,201624,201626,0,2,5
57718,3,2,201627,201627,201629,0,2,1
57719,4,2,201631,201631,201633,0,2,2
57720,5,2,201636,201636,201638,0,2,3
57721,1,2,201637,201638,201640,1,3,0
57722,1,1,201638,201640,201641,2,3,0
57723,6,2,201644,201644,201646,0,2,3
57724,1,2,201645,201646,201648,1,3,0
57725,4,2,201649,201649,201651,0,2,1
57726,5,3,201654,201654,201657,0,3,3
57727,2,3,201656,201657,201660,1,4,0
57728,1,1,201657,201660,201661,3,4,0
57729,3,1,201660,201661,201662,1,2,0
57730,5,2,201665,201665,201667,0,2,3
57731,3,3,201668,201668,201671,0,3,1
57732,6,2,201674,201674,201676,0,2,3
57733,4,3,201678,201678,201681,0,3,2
57734,4,1,201682,201682,201683,0,1,1
57735,5,3,201687,201687,201690,0,3,4
57736,1,3,201688,201690,201693,2,5,0
57737,5,2,201693,201693,201695,0,2,0
57738,3,3,201696,201696,201699,0,3,1
57739,3,3,201699,201699,201702,0,3,0
57740,6,1,201705,201705,201706,0,1,3
57741,2,3,201707,201707,201710,0,3,1
57742,2,3,201709,201710,201713,1,4,0
57743,6,2,201715,201715,201717,0,2,2
57744,6,3,201721,201721,201724,0,3,4
57745,1,3,201722,201724,201727,2,5,0
57746,4,2,201726,201727,201729,1,3,0
57747,3,1,201729,201729,201730,0,1,0
57748,5,1,201734,201734,201735,0,1,4
57749,6,2,201740,201740,201742,0,2,5
57750,4,2,201744,201744,201746,0,2,2
57751,6,1,201750,201750,201751,0,1,4
57752,5,3,201755,201755,201758,0,3,4
57753,3,1,201758,201758,201759,0,1,0
57754,4,2,201762,201762,201764,0,2,3
57755,6,1,201768,201768,201769,0,1,4
57756,5,2,201773,201773,201775,0,2,4
57757,1,2,201774,201775,201777,1,3,0
57758,5,2,201779,201779,201781,0,2,2
57759,5,1,201784,201784,201785,0,1,3
57760,5,3,201789,201789,201792,0,3,4
57761,2,3,201791,201792,201795,1,4,0
57762,4,1,201795,201795,201796,0,1,0
57763,2,2,201797,201797,201799,0,2,1
57764,6,3,201803,201803,201806,0,3,4
57765,1,3,201804,201806,201809,2,5,0
57766,5,3,201809,201809,201812,0,3,0
57767,3,3,201812,201812,201815,0,3,0
57768,3,1,201815,201815,201816,0,1,0
57769,6,1,201821,201821,201822,0,1,5
57770,5,1,201826,201826,201827,0,1,4
57771,3,3,201829,201829,201832,0,3,2
57772,5,2,201834,201834,201836,0,2,2
57773,1,2,201835,201836,201838,1,3,0
57774,2,1,201837,201838,201839,1,2,0
57775,6,3,201843,201843,201846,0,3,4
57776,3,2,201846,201846,201848,0,2,0
57777,1,2,201847,201848,201850,1,3,0
57778,6,3,201853,201853,201856,0,3,3
57779,1,2,201854,201856,201858,2,4,0
57780,2,2,201856,201858,201860,2,4,0
57781,3,1,201859,201860,201861,1,2,0
57782,4,2,201863,201863,201865,0,2,2
57783,2,1,201865,201865,201866,0,1,0
57784,4,2,201869,201869,201871,0,2,3
57785,2,3,201871,201871,201874,0,3,0
57786,1,1,201872,201874,201875,2,3,0
57787,3,2,201875,201875,201877,0,2,0
57788,3,1,201878,201878,201879,0,1,1
57789,5,2,201883,201883,201885,0,2,4
57790,6,2,201889,201889,201891,0,2,4
57791,5,3,201894,201894,201897,0,3,3
57792,5,2,201899,201899,201901,0,2,2
57793,3,3,201902,201902,201905,0,3,1
57794,1,1,201903,201905,201906,2,3,0
57795,2,3,201905,201906,201909,1,4,0
57796,1,1,201906,201909,201910,3,4,0
57797,3,3,201909,201910,201913,1,4,0
57798,1,3,201910,201913,201916,3,6,0
57799,5,1,201915,201916,201917,1,2,0
57800,3,3,201918,201918,201921,0,3,1
57801,4,2,201922,201922,201924,0,2,1
57802,3,3,201925,201925,201928,0,3,1
57803,5,1,201930,201930,201931,0,1,2
57804,3,1,201933,201933,201934,0,1,2
57805,2,3,201935,201935,201938,0,3,1
57806,6,1,201941,201941,201942,0,1,3
57807,3,3,201944,201944,201947,0,3,2
57808,2,3,201946,201947,201950,1,4,0
57809,1,2,201947,201950,201952,3,5,0
57810,4,3,201951,201952,201955,1,4,0
57811,3,3,201954,201955,201958,1,4,0
57812,4,1,201958,201958,201959,0,1,0
57813,5,2,201963,201963,201965,0,2,4
57814,1,1,201964,201965,201966,1,2,0
57815,1,2,201965,201966,201968,1,3,0
57816,2,3,201967,201968,201971,1,4,0
57817,1,3,201968,201971,201974,3,6,0
57818,5,2,201973,201974,201976,1,3,0
57819,2,3,201975,201976,201979,1,4,0
57820,5,3,201980,201980,201983,0,3,1
57821,5,3,201985,201985,201988,0,3,2
57822,6,1,201991,201991,201992,0,1,3
57823,3,1,201994,201994,201995,0,1,2
57824,4,3,201998,201998,202001,0,3,3
57825,5,1,202003,202003,202004,0,1,2
57826,4,1,202007,202007,202008,0,1,3
57827,4,3,202011,202011,202014,0,3,3
57828,4,3,202015,202015,202018,0,3,1
57829,6,3,202021,202021,202024,0,3,3
57830,3,3,202024,202024,202027,0,3,0
57831,3,3,202027,202027,202030,0,3,0
57832,1,3,202028,202030,202033,2,5,0
57833,3,2,202031,202033,202035,2,4,0
57834,6,2,202037,202037,202039,0,2,2
57835,5,1,202042,202042,202043,0,1,3
57836,6,3,202048,202048,202051,0,3,5
57837,1,1,202049,202051,202052,2,3,0
57838,6,1,202055,202055,202056,0,1,3
57839,4,2,202059,202059,202061,0,2,3
57840,4,2,202063,202063,202065,0,2,2
57841,6,2,202069,202069,202071,0,2,4
57842,4,1,202073,202073,202074,0,1,2
57843,3,3,202076,202076,202079,0,3,2
57844,1,1,202077,202079,202080,2,3,0
57845,6,1,202083,202083,202084,0,1,3
57846,6,3,202089,202089,202092,0,3,5
57847,1,1,202090,202092,202093,2,3,0
57848,5,2,202095,202095,202097,0,2,2
57849,2,1,202097,202097,202098,0,1,0
57850,1,3,202098,202098,202101,0,3,0
57851,6,1,202104,202104,202105,0,1,3
57852,2,3,202106,202106,202109,0,3,1
57853,6,1,202112,202112,202113,0,1,3
57854,4,1,202116,202116,202117,0,1,3
57855,5,2,202121,202121,202123,0,2,4
57856,5,3,202126,202126,202129,0,3,3
57857,4,3,202130,202130,202133,0,3,1
57858,3,2,202133,202133,202135,0,2,0
57859,6,2,202139,202139,202141,0,2,4
57860,2,2,202141,202141,202143,0,2,0
57861,6,2,202147,202147,202149,0,2,4
57862,2,2,202149,202149,202151,0,2,0
57863,5,1,202154,202154,202155,0,1,3
57864,6,3,202160,202160,202163,0,3,5
57865,5,1,202165,202165,202166,0,1,2
57866,1,1,202166,202166,202167,0,1,0
57867,1,3,202167,202167,202170,0,3,0
57868,2,1,202169,202170,202171,1,2,0
57869,6,3,202175,202175,202178,0,3,4
57870,4,1,202179,202179,202180,0,1,1
57871,1,3,202180,202180,202183,0,3,0
57872,4,2,202184,202184,202186,0,2,1
57873,6,3,202190,202190,202193,0,3,4
57874,5,3,202195,202195,202198,0,3,2
57875,1,2,202196,202198,202200,2,4,0
57876,5,1,202201,202201,202202,0,1,1
57877,5,2,202206,202206,202208,0,2,4
57878,5,3,202211,202211,202214,0,3,3
57879,1,1,202212,202214,202215,2,3,0
57880,3,3,202215,202215,202218,0,3,0
57881,6,2,202221,202221,202223,0,2,3
57882,5,2,202226,202226,202228,0,2,3
57883,2,1,202228,202228,202229,0,1,0
57884,5,1,202233,202233,202234,0,1,4
57885,2,1,202235,202235,202236,0,1,1
57886,5,3,202240,202240,202243,0,3,4
57887,6,3,202246,202246,202249,0,3,3
57888,1,3,202247,202249,202252,2,5,0
57889,2,3,202249,202252,202255,3,6,0
57890,1,3,202250,202255,202258,5,8,0
57891,5,2,202255,202258,202260,3,5,0
57892,6,2,202261,202261,202263,0,2,1
57893,6,1,202267,202267,202268,0,1,4
57894,5,1,202272,202272,202273,0,1,4
57895,4,1,202276,202276,202277,0,1,3
57896,4,3,202280,202280,202283,0,3,3
57897,5,1,202285,202285,202286,0,1,2
57898,3,3,202288,202288,202291,0,3,2
57899,1,3,202289,202291,202294,2,5,0
57900,4,2,202293,202294,202296,1,3,0
57901,6,2,202299,202299,202301,0,2,3
57902,2,3,202301,202301,202304,0,3,0
57903,5,3,202306,202306,202309,0,3,2
57904,2,1,202308,202309,202310,1,2,0
57905,4,2,202312,202312,202314,0,2,2
57906,1,1,202313,202314,202315,1,2,0
57907,4,1,202317,202317,202318,0,1,2
57908,4,1,202321,202321,202322,0,1,3
57909,2,3,202323,202323,202326,0,3,1
57910,5,3,202328,202328,202331,0,3,2
57911,2,2,202330,202331,202333,1,3,0
57912,3,1,202333,202333,202334,0,1,0
57913,2,3,202335,202335,202338,0,3,1
57914,2,3,202337,202338,202341,1,4,0
57915,3,2,202340,202341,202343,1,3,0
57916,4,3,202344,202344,202347,0,3,1
57917,3,3,202347,202347,202350,0,3,0
57918,6,3,202353,202353,202356,0,3,3
57919,3,3,202356,202356,202359,0,3,0
57920,5,1,202361,202361,202362,0,1,2
57921,4,1,202365,202365,202366,0,1,3
57922,2,2,202367,202367,202369,0,2,1
57923,6,1,202373,202373,202374,0,1,4
57924,2,2,202375,202375,202377,0,2,1
57925,5,3,202380,202380,202383,0,3,3
57926,4,3,202384,202384,202387,0,3,1
57927,6,1,202390,202390,202391,0,1,3
57928,5,2,202395,202395,202397,0,2,4
57929,4,2,202399,202399,202401,0,2,2
57930,5,2,202404,202404,202406,0,2,3
57931,4,2,202408,202408,202410,0,2,2
57932,3,1,202411,202411,202412,0,1,1
57933,3,3,202414,202414,202417,0,3,2
57934,5,2,202419,202419,202421,0,2,2
57935,4,2,202423,202423,202425,0,2,2
57936,2,3,202425,202425,202428,0,3,0
57937,3,1,202428,202428,202429,0,1,0
57938,4,3,202432,202432,202435,0,3,3
57939,2,1,202434,202435,202436,1,2,0
57940,3,3,202437,202437,202440,0,3,1
57941,4,1,202441,202441,202442,0,1,1
57942,1,1,202442,202442,202443,0,1,0
57943,6,3,202448,202448,202451,0,3,5
57944,3,3,202451,202451,202454,0,3,0
57945,1,1,202452,202454,202455,2,3,0
57946,1,3,202453,202455,202458,2,5,0
57947,4,3,202457,202458,202461,1,4,0
57948,5,3,202462,202462,202465,0,3,1
57949,5,1,202467,202467,202468,0,1,2
57950,4,2,202471,202471,202473,0,2,3
57951,3,1,202474,202474,202475,0,1,1
57952,6,3,202480,202480,202483,0,3,5
57953,1,1,202481,202483,202484,2,3,0
57954,3,1,202484,202484,202485,0,1,0
57955,2,1,202486,202486,202487,0,1,1
57956,2,3,202488,202488,202491,0,3,1
57957,5,2,202493,202493,202495,0,2,2
57958,2,3,202495,202495,202498,0,3,0
57959,6,3,202501,202501,202504,0,3,3
57960,5,3,202506,202506,202509,0,3,2
57961,6,2,202512,202512,202514,0,2,3
57962,2,1,202514,202514,202515,0,1,0
57963,1,1,202515,202515,202516,0,1,0
57964,3,3,202518,202518,202521,0,3,2
57965,3,2,202521,202521,202523,0,2,0
57966,2,3,202523,202523,202526,0,3,0
57967,1,1,202524,202526,202527,2,3,0
57968,6,1,202530,202530,202531,0,1,3
57969,1,1,202531,202531,202532,0,1,0
57970,5,3,202536,202536,202539,0,3,4
57971,2,3,202538,202539,202542,1,4,0
57972,4,1,202542,202542,202543,0,1,0
57973,4,3,202546,202546,202549,0,3,3
57974,6,1,202552,202552,202553,0,1,3
57975,4,3,202556,202556,202559,0,3,3
57976,5,1,202561,202561,202562,0,1,2
57977,1,3,202562,202562,202565,0,3,0
57978,5,1,202567,202567,202568,0,1,2
57979,3,1,202570,202570,202571,0,1,2
57980,3,3,202573,202573,202576,0,3,2
57981,3,2,202576,202576,202578,0,2,0
57982,2,2,202578,202578,202580,0,2,0
57983,4,1,202582,202582,202583,0,1,2
57984,4,3,202586,202586,202589,0,3,3
57985,6,2,202592,202592,202594,0,2,3
57986,4,1,202596,202596,202597,0,1,2
57987,3,1,202599,202599,202600,0,1,2
57988,6,2,202605,202605,202607,0,2,5
57989,2,2,202607,202607,202609,0,2,0
57990,1,3,202608,202609,202612,1,4,0
57991,2,2,202610,202612,202614,2,4,0
57992,5,3,202615,202615,202618,0,3,1
57993,6,3,202621,202621,202624,0,3,3
57994,2,1,202623,202624,202625,1,2,0
57995,5,1,202628,202628,202629,0,1,3
57996,3,2,202631,202631,202633,0,2,2
57997,4,1,202635,202635,202636,0,1,2
57998,4,2,202639,202639,202641,0,2,3
57999,5,3,202644,202644,202647,0,3,3
58000,3,1,202647,202647,202648,0,1,0
58001,6,2,202653,202653,202655,0,2,5
58002,2,3,202655,202655,202658,0,3,0
58003,4,3,202659,202659,202662,0,3,1
58004,1,3,202660,202662,202665,2,5,0
58005,4,3,202664,202665,202668,1,4,0
58006,6,1,202670,202670,202671,0,1,2
58007,4,1,202674,202674,202675,0,1,3
58008,5,2,202679,202679,202681,0,2,4
58009,2,3,202681,202681,202684,0,3,0
58010,2,2,202683,202684,202686,1,3,0
58011,2,2,202685,202686,202688,1,3,0
58012,4,3,202689,202689,202692,0,3,1
58013,2,1,202691,202692,202693,1,2,0
58014,3,2,202694,202694,202696,0,2,1
58015,6,2,202700,202700,202702,0,2,4
58016,5,1,202705,202705,202706,0,1,3
58017,3,1,202708,202708,202709,0,1,2
58018,5,3,202713,202713,202716,0,3,4
58019,1,1,202714,202716,202717,2,3,0
58020,1,2,202715,202717,202719,2,4,0
58021,2,3,202717,202719,202722,2,5,0
58022,3,2,202720,202722,202724,2,4,0
58023,2,2,202722,202724,202726,2,4,0
58024,4,3,202726,202726,202729,0,3,0
58025,5,3,202731,202731,202734,0,3,2
58026,1,1,202732,202734,202735,2,3,0
58027,4,3,202736,202736,202739,0,3,1
58028,4,3,202740,202740,202743,0,3,1
58029,3,1,202743,202743,202744,0,1,0
58030,5,1,202748,202748,202749,0,1,4
58031,5,1,202753,202753,202754,0,1,4
58032,1,3,202754,202754,202757,0,3,0
58033,5,2,202759,202759,202761,0,2,2
58034,1,1,202760,202761,202762,1,2,0
58035,2,2,202762,202762,202764,0,2,0
58036,4,3,202766,202766,202769,0,3,2
58037,1,2,202767,202769,202771,2,4,0
58038,2,3,202769,202771,202774,2,5,0
58039,6,3,202775,202775,202778,0,3,1
58040,6,3,202781,202781,202784,0,3,3
58041,6,1,202787,202787,202788,0,1,3
58042,6,1,202793,202793,202794,0,1,5
58043,5,3,202798,202798,202801,0,3,4
58044,5,1,202803,202803,202804,0,1,2
58045,4,2,202807,202807,202809,0,2,3
58046,4,1,202811,202811,202812,0,1,2
58047,5,1,202816,202816,202817,0,1,4
58048,5,3,202821,202821,202824,0,3,4
58049,2,2,202823,202824,202826,1,3,0
58050,4,2,202827,202827,202829,0,2,1
58051,6,1,202833,202833,202834,0,1,4
58052,3,1,202836,202836,202837,0,1,2
58053,2,1,202838,202838,202839,0,1,1
58054,6,2,202844,202844,202846,0,2,5
58055,1,2,202845,202846,202848,1,3,0
58056,1,3,202846,202848,202851,2,5,0
58057,2,2,202848,202851,202853,3,5,0
58058,3,1,202851,202853,202854,2,3,0
58059,4,1,202855,202855,202856,0,1,1
58060,3,2,202858,202858,202860,0,2,2
58061,5,3,202863,202863,202866,0,3,3
58062,6,3,202869,202869,202872,0,3,3
58063,3,1,202872,202872,202873,0,1,0
58064,3,1,202875,202875,202876,0,1,2
58065,5,1,202880,202880,202881,0,1,4
58066,4,3,202884,202884,202887,0,3,3
58067,4,2,202888,202888,202890,0,2,1
58068,2,1,202890,202890,202891,0,1,0
58069,1,3,202891,202891,202894,0,3,0
58070,5,1,202896,202896,202897,0,1,2
58071,2,2,202898,202898,202900,0,2,1
58072,5,3,202903,202903,202906,0,3,3
58073,4,1,202907,202907,202908,0,1,1
58074,5,1,202912,202912,202913,0,1,4
58075,3,2,202915,202915,202917,0,2,2
58076,6,1,202921,202921,202922,0,1,4
58077,4,3,202925,202925,202928,0,3,3
58078,2,3,202927,202928,202931,1,4,0
58079,5,1,202932,202932,202933,0,1,1
58080,2,2,202934,202934,202936,0,2,1
58081,2,3,202936,202936,202939,0,3,0
58082,4,3,202940,202940,202943,0,3,1
58083,6,3,202946,202946,202949,0,3,3
58084,3,1,202949,202949,202950,0,1,0
58085,2,1,202951,202951,202952,0,1,1
58086,2,1,202953,202953,202954,0,1,1
58087,1,1,202954,202954,202955,0,1,0
58088,2,3,202956,202956,202959,0,3,1
58089,3,2,202959,202959,202961,0,2,0
58090,6,3,202965,202965,202968,0,3,4
58091,5,2,202970,202970,202972,0,2,2
58092,3,3,202973,202973,202976,0,3,1
58093,3,2,202976,202976,202978,0,2,0
58094,6,3,202982,202982,202985,0,3,4
58095,4,1,202986,202986,202987,0,1,1
58096,1,2,202987,202987,202989,0,2,0
58097,4,3,202991,202991,202994,0,3,2
58098,6,1,202997,202997,202998,0,1,3
58099,5,3,203002,203002,203005,0,3,4
58100,1,2,203003,203005,203007,2,4,0
58101,6,2,203009,203009,203011,0,2,2
58102,4,3,203013,203013,203016,0,3,2
58103,1,3,203014,203016,203019,2,5,0
58104,3,2,203017,203019,203021,2,4,0
58105,4,3,203021,203021,203024,0,3,0
58106,3,3,203024,203024,203027,0,3,0
58107,6,2,203030,203030,203032,0,2,3
58108,1,3,203031,203032,203035,1,4,0
58109,5,1,203036,203036,203037,0,1,1
58110,4,1,203040,203040,203041,0,1,3
58111,4,3,203044,203044,203047,0,3,3
58112,4,3,203048,203048,203051,0,3,1
58113,6,1,203054,203054,203055,0,1,3
58114,5,1,203059,203059,203060,0,1,4
58115,3,3,203062,203062,203065,0,3,2
58116,2,3,203064,203065,203068,1,4,0
58117,1,3,203065,203068,203071,3,6,0
58118,3,3,203068,203071,203074,3,6,0
58119,6,2,203074,203074,203076,0,2,0
58120,5,1,203079,203079,203080,0,1,3
58121,3,3,203082,203082,203085,0,3,2
58122,5,1,203087,203087,203088,0,1,2
58123,5,2,203092,203092,203094,0,2,4
58124,3,3,203095,203095,203098,0,3,1
58125,3,3,203098,203098,203101,0,3,0
58126,4,3,203102,203102,203105,0,3,1
58127,2,3,203104,203105,203108,1,4,0
58128,6,2,203110,203110,203112,0,2,2
58129,6,1,203116,203116,203117,0,1,4
58130,1,1,203117,203117,203118,0,1,0
58131,6,2,203123,203123,203125,0,2,5
58132,2,3,203125,203125,203128,0,3,0
58133,1,3,203126,203128,203131,2,5,0
58134,4,3,203130,203131,203134,1,4,0
58135,2,1,203132,203134,203135,2,3,0
58136,2,1,203134,203135,203136,1,2,0
58137,5,3,203139,203139,203142,0,3,3
58138,3,3,203142,203142,203145,0,3,0
58139,4,2,203146,203146,203148,0,2,1
58140,4,1,203150,203150,203151,0,1,2
58141,4,1,203154,203154,203155,0,1,3
58142,5,1,203159,203159,203160,0,1,4
58143,5,2,203164,203164,203166,0,2,4
58144,6,1,203170,203170,203171,0,1,4
58145,4,3,203174,203174,203177,0,3,3
58146,5,1,203179,203179,203180,0,1,2
58147,6,2,203185,203185,203187,0,2,5
58148,5,3,203190,203190,203193,0,3,3
58149,4,3,203194,203194,203197,0,3,1
58150,6,1,203200,203200,203201,0,1,3
58151,2,1,203202,203202,203203,0,1,1
58152,4,1,203206,203206,203207,0,1,3
58153,2,1,203208,203208,203209,0,1,1
58154,5,3,203213,203213,203216,0,3,4
58155,2,3,203215,203216,203219,1,4,0
58156,2,3,203217,203219,203222,2,5,0
58157,1,2,203218,203222,203224,4,6,0
58158,1,1,203219,203224,203225,5,6,0
58159,2,2,203221,203225,203227,4,6,0
58160,4,2,203225,203227,203229,2,4,0
58161,5,2,203230,203230,203232,0,2,1
58162,2,1,203232,203232,203233,0,1,0
58163,5,3,203237,203237,203240,0,3,4
58164,6,2,203243,203243,203245,0,2,3
58165,5,2,203248,203248,203250,0,2,3
58166,6,2,203254,203254,203256,0,2,4
58167,1,3,203255,203256,203259,1,4,0
58168,3,2,203258,203259,203261,1,3,0
58169,2,3,203260,203261,203264,1,4,0
58170,1,1,203261,203264,203265,3,4,0
58171,1,1,203262,203265,203266,3,4,0
58172,1,1,203263,203266,203267,3,4,0
58173,2,2,203265,203267,203269,2,4,0
58174,4,3,203269,203269,203272,0,3,0
58175,3,2,203272,203272,203274,0,2,0
58176,3,3,203275,203275,203278,0,3,1
58177,4,3,203279,203279,203282,0,3,1
58178,2,2,203281,203282,203284,1,3,0
58179,3,2,203284,203284,203286,0,2,0
58180,3,1,203287,203287,203288,0,1,1
58181,6,2,203293,203293,203295,0,2,5
58182,1,2,203294,203295,203297,1,3,0
58183,6,2,203300,203300,203302,0,2,3
58184,1,1,203301,203302,203303,1,2,0
58185,6,1,203307,203307,203308,0,1,4
58186,3,1,203310,203310,203311,0,1,2
58187,6,2,203316,203316,203318,0,2,5
58188,5,1,203321,203321,203322,0,1,3
58189,2,3,203323,203323,203326,0,3,1
58190,3,3,203326,203326,203329,0,3,0
58191,6,3,203332,203332,203335,0,3,3
58192,4,3,203336,203336,203339,0,3,1
58193,2,1,203338,203339,203340,1,2,0
58194,5,1,203343,203343,203344,0,1,3
58195,4,2,203347,203347,203349,0,2,3
58196,3,1,203350,203350,203351,0,1,1
58197,2,1,203352,203352,203353,0,1,1
58198,3,3,203355,203355,203358,0,3,2
58199,1,3,203356,203358,203361,2,5,0
58200,6,2,203362,203362,203364,0,2,1
58201,1,3,203363,203364,203367,1,4,0
58202,6,1,203369,203369,203370,0,1,2
58203,3,3,203372,203372,203375,0,3,2
58204,1,1,203373,203375,203376,2,3,0
58205,1,1,203374,203376,203377,2,3,0
58206,3,2,203377,203377,203379,0,2,0
58207,2,2,203379,203379,203381,0,2,0
58208,1,1,203380,203381,203382,1,2,0
58209,2,1,203382,203382,203383,0,1,0
58210,6,1,203388,203388,203389,0,1,5
58211,6,1,203394,203394,203395,0,1,5
58212,1,2,203395,203395,203397,0,2,0
58213,3,3,203398,203398,203401,0,3,1
58214,3,3,203401,203401,203404,0,3,0
58215,5,3,203406,203406,203409,0,3,2
58216,2,3,203408,203409,203412,1,4,0
58217,4,2,203412,203412,203414,0,2,0
58218,4,2,203416,203416,203418,0,2,2
58219,1,3,203417,203418,203421,1,4,0
58220,2,3,203419,203421,203424,2,5,0
58221,1,3,203420,203424,203427,4,7,0
58222,3,1,203423,203427,203428,4,5,0
58223,1,2,203424,203428,203430,4,6,0
58224,6,1,203430,203430,203431,0,1,0
58225,2,3,203432,203432,203435,0,3,1
58226,1,1,203433,203435,203436,2,3,0
58227,3,1,203436,203436,203437,0,1,0
58228,5,3,203441,203441,203444,0,3,4
58229,5,2,203446,203446,203448,0,2,2
58230,4,3,203450,203450,203453,0,3,2
58231,6,2,203456,203456,203458,0,2,3
58232,3,1,203459,203459,203460,0,1,1
58233,6,3,203465,203465,203468,0,3,5
58234,1,1,203466,203468,203469,2,3,0
58235,6,3,203472,203472,203475,0,3,3
58236,3,2,203475,203475,203477,0,2,0
58237,2,1,203477,203477,203478,0,1,0
58238,2,2,203479,203479,203481,0,2,1
58239,5,2,203484,203484,203486,0,2,3
58240,6,1,203490,203490,203491,0,1,4
58241,2,1,203492,203492,203493,0,1,1
58242,4,3,203496,203496,203499,0,3,3
58243,5,2,203501,203501,203503,0,2,2
58244,1,2,203502,203503,203505,1,3,0
58245,1,2,203503,203505,203507,2,4,0
58246,1,3,203504,203507,203510,3,6,0
58247,2,2,203506,203510,203512,4,6,0
58248,2,3,203508,203512,203515,4,7,0
58249,6,2,203514,203515,203517,1,3,0
58250,6,2,203520,203520,203522,0,2,3
58251,4,2,203524,203524,203526,0,2,2
58252,2,2,203526,203526,203528,0,2,0
58253,3,2,203529,203529,203531,0,2,1
58254,4,3,203533,203533,203536,0,3,2
58255,4,2,203537,203537,203539,0,2,1
58256,1,1,203538,203539,203540,1,2,0
58257,3,3,203541,203541,203544,0,3,1
58258,3,2,203544,203544,203546,0,2,0
58259,2,2,203546,203546,203548,0,2,0
58260,6,2,203552,203552,203554,0,2,4
58261,1,1,203553,203554,203555,1,2,0
58262,5,3,203558,203558,203561,0,3,3
58263,2,3,203560,203561,203564,1,4,0
58264,6,2,203566,203566,203568,0,2,2
58265,2,3,203568,203568,203571,0,3,0
58266,2,1,203570,203571,203572,1,2,0
58267,4,3,203574,203574,203577,0,3,2
58268,1,3,203575,203577,203580,2,5,0
58269,2,1,203577,203580,203581,3,4,0
58270,2,2,203579,203581,203583,2,4,0
58271,4,2,203583,203583,203585,0,2,0
58272,4,2,203587,203587,203589,0,2,2
58273,6,1,203593,203593,203594,0,1,4
58274,6,2,203599,203599,203601,0,2,5
58275,2,2,203601,203601,203603,0,2,0
58276,6,3,203607,203607,203610,0,3,4
58277,4,1,203611,203611,203612,0,1,1
58278,1,3,203612,203612,203615,0,3,0
58279,4,1,203616,203616,203617,0,1,1
58280,5,3,203621,203621,203624,0,3,4
58281,3,1,203624,203624,203625,0,1,0
58282,5,1,203629,203629,203630,0,1,4
58283,3,1,203632,203632,203633,0,1,2
58284,2,3,203634,203634,203637,0,3,1
58285,5,3,203639,203639,203642,0,3,2
58286,4,2,203643,203643,203645,0,2,1
58287,1,1,203644,203645,203646,1,2,0
58288,1,3,203645,203646,203649,1,4,0
58289,1,2,203646,203649,203651,3,5,0
58290,1,1,203647,203651,203652,4,5,0
58291,6,3,203653,203653,203656,0,3,1
58292,1,2,203654,203656,203658,2,4,0
58293,4,3,203658,203658,203661,0,3,0
58294,5,2,203663,203663,203665,0,2,2
58295,4,1,203667,203667,203668,0,1,2
58296,5,3,203672,203672,203675,0,3,4
58297,1,1,203673,203675,203676,2,3,0
58298,1,3,203674,203676,203679,2,5,0
58299,2,3,203676,203679,203682,3,6,0
58300,6,1,203682,203682,203683,0,1,0
58301,4,1,203686,203686,203687,0,1,3
58302,4,1,203690,203690,203691,0,1,3
58303,5,1,203695,203695,203696,0,1,4
58304,6,1,203701,203701,203702,0,1,5
58305,4,3,203705,203705,203708,0,3,3
58306,2,2,203707,203708,203710,1,3,0
58307,6,2,203713,203713,203715,0,2,3
58308,3,2,203716,203716,203718,0,2,1
58309,4,3,203720,203720,203723,0,3,2
58310,6,2,203726,203726,203728,0,2,3
58311,2,1,203728,203728,203729,0,1,0
58312,3,2,203731,203731,203733,0,2,2
58313,2,2,203733,203733,203735,0,2,0
58314,6,2,203739,203739,203741,0,2,4
58315,2,2,203741,203741,203743,0,2,0
58316,2,3,203743,203743,203746,0,3,0
58317,6,3,203749,203749,203752,0,3,3
58318,4,2,203753,203753,203755,0,2,1
58319,5,3,203758,203758,203761,0,3,3
58320,6,3,203764,203764,203767,0,3,3
58321,2,1,203766,203767,203768,1,2,0
58322,2,3,203768,203768,203771,0,3,0
58323,3,1,203771,203771,203772,0,1,0
58324,5,2,203776,203776,203778,0,2,4
58325,6,2,203782,203782,203784,0,2,4
58326,5,2,203787,203787,203789,0,2,3
58327,4,3,203791,203791,203794,0,3,2
58328,5,3,203796,203796,203799,0,3,2
58329,4,2,203800,203800,203802,0,2,1
58330,4,3,203804,203804,203807,0,3,2
58331,6,3,203810,203810,203813,0,3,3
58332,1,2,203811,203813,203815,2,4,0
58333,1,1,203812,203815,203816,3,4,0
58334,5,3,203817,203817,203820,0,3,1
58335,3,2,203820,203820,203822,0,2,0
58336,5,1,203825,203825,203826,0,1,3
58337,5,3,203830,203830,203833,0,3,4
58338,5,2,203835,203835,203837,0,2,2
58339,4,3,203839,203839,203842,0,3,2
58340,1,3,203840,203842,203845,2,5,0
58341,3,1,203843,203845,203846,2,3,0
58342,6,3,203849,203849,203852,0,3,3
58343,6,3,203855,203855,203858,0,3,3
58344,6,1,203861,203861,203862,0,1,3
58345,6,3,203867,203867,203870,0,3,5
58346,6,1,203873,203873,203874,0,1,3
58347,2,3,203875,203875,203878,0,3,1
58348,6,3,203881,203881,203884,0,3,3
58349,5,3,203886,203886,203889,0,3,2
58350,2,1,203888,203889,203890,1,2,0
58351,5,3,203893,203893,203896,0,3,3
58352,2,1,203895,203896,203897,1,2,0
58353,6,3,203901,203901,203904,0,3,4
58354,3,1,203904,203904,203905,0,1,0
58355,5,3,203909,203909,203912,0,3,4
58356,4,1,203913,203913,203914,0,1,1
58357,6,2,203919,203919,203921,0,2,5
58358,4,3,203923,203923,203926,0,3,2
58359,1,3,203924,203926,203929,2,5,0
58360,6,2,203930,203930,203932,0,2,1
58361,4,3,203934,203934,203937,0,3,2
58362,4,3,203938,203938,203941,0,3,1
58363,5,2,203943,203943,203945,0,2,2
58364,3,3,203946,203946,203949,0,3,1
58365,2,3,203948,203949,203952,1,4,0
58366,6,1,203954,203954,203955,0,1,2
58367,3,2,203957,203957,203959,0,2,2
58368,4,2,203961,203961,203963,0,2,2
58369,6,2,203967,203967,203969,0,2,4
58370,4,3,203971,203971,203974,0,3,2
58371,5,3,203976,203976,203979,0,3,2
58372,6,2,203982,203982,203984,0,2,3
58373,6,2,203988,203988,203990,0,2,4
58374,2,1,203990,203990,203991,0,1,0
58375,6,1,203996,203996,203997,0,1,5
58376,1,1,203997,203997,203998,0,1,0
58377,3,3,204000,204000,204003,0,3,2
58378,1,1,204001,204003,204004,2,3,0
58379,1,3,204002,204004,204007,2,5,0
58380,6,2,204008,204008,204010,0,2,1
58381,1,3,204009,204010,204013,1,4,0
58382,2,2,204011,204013,204015,2,4,0
58383,1,1,204012,204015,204016,3,4,0
58384,5,2,204017,204017,204019,0,2,1
58385,3,1,204020,204020,204021,0,1,1
58386,1,3,204021,204021,204024,0,3,0
58387,4,1,204025,204025,204026,0,1,1
58388,5,3,204030,204030,204033,0,3,4
58389,1,2,204031,204033,204035,2,4,0
58390,5,3,204036,204036,204039,0,3,1
58391,6,3,204042,204042,204045,0,3,3
58392,6,2,204048,204048,204050,0,2,3
58393,6,2,204054,204054,204056,0,2,4
58394,3,1,204057,204057,204058,0,1,1
58395,4,2,204061,204061,204063,0,2,3
58396,6,3,204067,204067,204070,0,3,4
58397,6,1,204073,204073,204074,0,1,3
58398,1,1,204074,204074,204075,0,1,0
58399,2,3,204076,204076,204079,0,3,1
58400,1,3,204077,204079,204082,2,5,0
58401,5,3,204082,204082,204085,0,3,0
58402,6,3,204088,204088,204091,0,3,3
58403,5,3,204093,204093,204096,0,3,2
58404,4,3,204097,204097,204100,0,3,1
58405,5,1,204102,204102,204103,0,1,2
58406,3,1,204105,204105,204106,0,1,2
58407,4,2,204109,204109,204111,0,2,3
58408,4,2,204113,204113,204115,0,2,2
58409,4,3,204117,204117,204120,0,3,2
58410,6,3,204123,204123,204126,0,3,3
58411,1,1,204124,204126,204127,2,3,0
58412,2,3,204126,204127,204130,1,4,0
58413,2,2,204128,204130,204132,2,4,0
58414,3,3,204131,204132,204135,1,4,0
58415,6,1,204137,204137,204138,0,1,2
58416,5,2,204142,204142,204144,0,2,4
58417,4,3,204146,204146,204149,0,3,2
58418,5,2,204151,204151,204153,0,2,2
58419,2,3,204153,204153,204156,0,3,0
58420,3,3,204156,204156,204159,0,3,0
58421,3,3,204159,204159,204162,0,3,0
58422,5,2,204164,204164,204166,0,2,2
58423,3,3,204167,204167,204170,0,3,1
58424,3,1,204170,204170,204171,0,1,0
58425,1,1,204171,204171,204172,0,1,0
58426,1,3,204172,204172,204175,0,3,0
58427,5,2,204177,204177,204179,0,2,2
58428,6,2,204183,204183,204185,0,2,4
58429,3,1,204186,204186,204187,0,1,1
58430,6,2,204192,204192,204194,0,2,5
58431,5,3,204197,204197,204200,0,3,3
58432,6,2,204203,204203,204205,0,2,3
58433,1,3,204204,204205,204208,1,4,0
58434,6,3,204210,204210,204213,0,3,2
58435,2,2,204212,204213,204215,1,3,0
58436,1,3,204213,204215,204218,2,5,0
58437,5,3,204218,204218,204221,0,3,0
58438,2,2,204220,204221,204223,1,3,0
58439,6,3,204226,204226,204229,0,3,3
58440,1,3,204227,204229,204232,2,5,0
58441,1,1,204228,204232,204233,4,5,0
58442,5,3,204233,204233,204236,0,3,0
58443,4,3,204237,204237,204240,0,3,1
58444,2,3,204239,204240,204243,1,4,0
58445,3,2,204242,204243,204245,1,3,0
58446,2,3,204244,204245,204248,1,4,0
58447,3,3,204247,204248,204251,1,4,0
58448,4,2,204251,204251,204253,0,2,0
58449,3,3,204254,204254,204257,0,3,1
58450,5,1,204259,204259,204260,0,1,2
58451,5,2,204264,204264,204266,0,2,4
58452,3,1,204267,204267,204268,0,1,1
58453,3,2,204270,204270,204272,0,2,2
58454,6,1,204276,204276,204277,0,1,4
58455,6,3,204282,204282,204285,0,3,5
58456,3,2,204285,204285,204287,0,2,0
58457,1,2,204286,204287,204289,1,3,0
58458,6,2,204292,204292,204294,0,2,3
58459,4,1,204296,204296,204297,0,1,2
58460,5,3,204301,204301,204304,0,3,4
58461,6,2,204307,204307,204309,0,2,3
58462,2,3,204309,204309,204312,0,3,0
58463,5,1,204314,204314,204315,0,1,2
58464,2,2,204316,204316,204318,0,2,1
58465,4,2,204320,204320,204322,0,2,2
58466,4,2,204324,204324,204326,0,2,2
58467,6,1,204330,204330,204331,0,1,4
58468,4,1,204334,204334,204335,0,1,3
58469,3,1,204337,204337,204338,0,1,2
58470,4,3,204341,204341,204344,0,3,3
58471,6,2,204347,204347,204349,0,2,3
58472,6,3,204353,204353,204356,0,3,4
58473,4,1,204357,204357,204358,0,1,1
58474,3,1,204360,204360,204361,0,1,2
58475,4,1,204364,204364,204365,0,1,3
58476,3,1,204367,204367,204368,0,1,2
58477,4,2,204371,204371,204373,0,2,3
58478,1,1,204372,204373,204374,1,2,0
58479,4,1,204376,204376,204377,0,1,2
58480,1,1,204377,204377,204378,0,1,0
58481,6,1,204383,204383,204384,0,1,5
58482,1,2,204384,204384,204386,0,2,0
58483,3,3,204387,204387,204390,0,3,1
58484,1,2,204388,204390,204392,2,4,0
58485,4,3,204392,204392,204395,0,3,0
58486,2,3,204394,204395,204398,1,4,0
58487,5,3,204399,204399,204402,0,3,1
58488,5,1,204404,204404,204405,0,1,2
58489,6,3,204410,204410,204413,0,3,5
58490,2,2,204412,204413,204415,1,3,0
58491,2,2,204414,204415,204417,1,3,0
58492,4,2,204418,204418,204420,0,2,1
58493,5,1,204423,204423,204424,0,1,3
58494,4,2,204427,204427,204429,0,2,3
58495,2,2,204429,204429,204431,0,2,0
58496,6,2,204435,204435,204437,0,2,4
58497,5,1,204440,204440,204441,0,1,3
58498,4,2,204444,204444,204446,0,2,3
58499,1,1,204445,204446,204447,1,2,0
58500,2,1,204447,204447,204448,0,1,0
58501,6,1,204453,204453,204454,0,1,5
58502,5,1,204458,204458,204459,0,1,4
58503,2,2,204460,204460,204462,0,2,1
58504,2,2,204462,204462,204464,0,2,0
58505,2,3,204464,204464,204467,0,3,0
58506,2,1,204466,204467,204468,1,2,0
58507,1,2,204467,204468,204470,1,3,0
58508,5,3,204472,204472,204475,0,3,2
58509,3,3,204475,204475,204478,0,3,0
58510,6,3,204481,204481,204484,0,3,3
58511,1,3,204482,204484,204487,2,5,0
58512,3,1,204485,204487,204488,2,3,0
58513,3,2,204488,204488,204490,0,2,0
58514,6,1,204494,204494,204495,0,1,4
58515,6,2,204500,204500,204502,0,2,5
58516,6,3,204506,204506,204509,0,3,4
58517,1,3,204507,204509,204512,2,5,0
58518,5,3,204512,204512,204515,0,3,0
58519,2,3,204514,204515,204518,1,4,0
58520,5,2,204519,204519,204521,0,2,1
58521,6,3,204525,204525,204528,0,3,4
58522,1,3,204526,204528,204531,2,5,0
58523,4,3,204530,204531,204534,1,4,0
58524,1,1,204531,204534,204535,3,4,0
58525,3,3,204534,204535,204538,1,4,0
58526,4,2,204538,204538,204540,0,2,0
58527,4,1,204542,204542,204543,0,1,2
58528,6,3,204548,204548,204551,0,3,5
58529,1,2,204549,204551,204553,2,4,0
58530,2,1,204551,204553,204554,2,3,0
58531,1,1,204552,204554,204555,2,3,0
58532,1,3,204553,204555,204558,2,5,0
58533,1,2,204554,204558,204560,4,6,0
58534,4,2,204558,204560,204562,2,4,0
58535,6,2,204564,204564,204566,0,2,2
58536,1,3,204565,204566,204569,1,4,0
58537,5,2,204570,204570,204572,0,2,1
58538,6,2,204576,204576,204578,0,2,4
58539,3,3,204579,204579,204582,0,3,1
58540,4,1,204583,204583,204584,0,1,1
58541,4,3,204587,204587,204590,0,3,3
58542,2,3,204589,204590,204593,1,4,0
58543,1,3,204590,204593,204596,3,6,0
58544,3,3,204593,204596,204599,3,6,0
58545,5,3,204598,204599,204602,1,4,0
58546,1,3,204599,204602,204605,3,6,0
58547,2,3,204601,204605,204608,4,7,0
58548,4,2,204605,204608,204610,3,5,0
58549,5,2,204610,204610,204612,0,2,0
58550,6,3,204616,204616,204619,0,3,4
58551,5,2,204621,204621,204623,0,2,2
58552,6,1,204627,204627,204628,0,1,4
58553,2,2,204629,204629,204631,0,2,1
58554,5,1,204634,204634,204635,0,1,3
58555,5,3,204639,204639,204642,0,3,4
58556,6,1,204645,204645,204646,0,1,3
58557,2,3,204647,204647,204650,0,3,1
58558,5,2,204652,204652,204654,0,2,2
58559,4,3,204656,204656,204659,0,3,2
58560,3,2,204659,204659,204661,0,2,0
58561,4,3,204663,204663,204666,0,3,2
58562,5,2,204668,204668,204670,0,2,2
58563,3,1,204671,204671,204672,0,1,1
58564,1,2,204672,204672,204674,0,2,0
58565,6,3,204678,204678,204681,0,3,4
58566,6,3,204684,204684,204687,0,3,3
58567,4,1,204688,204688,204689,0,1,1
58568,4,2,204692,204692,204694,0,2,3
58569,5,1,204697,204697,204698,0,1,3
58570,3,3,204700,204700,204703,0,3,2
58571,6,3,204706,204706,204709,0,3,3
58572,5,2,204711,204711,204713,0,2,2
58573,3,3,204714,204714,204717,0,3,1
58574,6,2,204720,204720,204722,0,2,3
58575,6,3,204726,204726,204729,0,3,4
58576,6,3,204732,204732,204735,0,3,3
58577,2,3,204734,204735,204738,1,4,0
58578,4,2,204738,204738,204740,0,2,0
58579,1,3,204739,204740,204743,1,4,0
58580,6,3,204745,204745,204748,0,3,2
58581,4,1,204749,204749,204750,0,1,1
58582,3,1,204752,204752,204753,0,1,2
58583,2,1,204754,204754,204755,0,1,1
58584,5,2,204759,204759,204761,0,2,4
58585,6,2,204765,204765,204767,0,2,4
58586,2,2,204767,204767,204769,0,2,0
58587,2,3,204769,204769,204772,0,3,0
58588,4,3,204773,204773,204776,0,3,1
58589,5,1,204778,204778,204779,0,1,2
58590,3,1,204781,204781,204782,0,1,2
58591,1,2,204782,204782,204784,0,2,0
58592,1,3,204783,204784,204787,1,4,0
58593,4,2,204787,204787,204789,0,2,0
58594,3,2,204790,204790,204792,0,2,1
58595,3,1,204793,204793,204794,0,1,1
58596,2,2,204795,204795,204797,0,2,1
58597,2,3,204797,204797,204800,0,3,0
58598,6,2,204803,204803,204805,0,2,3
58599,5,1,204808,204808,204809,0,1,3
58600,6,1,204814,204814,204815,0,1,5
58601,4,1,204818,204818,204819,0,1,3
58602,4,3,204822,204822,204825,0,3,3
58603,2,3,204824,204825,204828,1,4,0
58604,1,3,204825,204828,204831,3,6,0
58605,1,2,204826,204831,204833,5,7,0
58606,1,2,204827,204833,204835,6,8,0
58607,6,3,204833,204835,204838,2,5,0
58608,6,3,204839,204839,204842,0,3,1
58609,1,2,204840,204842,204844,2,4,0
58610,3,3,204843,204844,204847,1,4,0
58611,6,2,204849,204849,204851,0,2,2
58612,1,1,204850,204851,204852,1,2,0
58613,4,1,204854,204854,204855,0,1,2
58614,6,2,204860,204860,204862,0,2,5
58615,4,2,204864,204864,204866,0,2,2
58616,6,3,204870,204870,204873,0,3,4
58617,2,3,204872,204873,204876,1,4,0
58618,5,1,204877,204877,204878,0,1,1
58619,2,3,204879,204879,204882,0,3,1
58620,4,2,204883,204883,204885,0,2,1
58621,5,3,204888,204888,204891,0,3,3
58622,3,1,204891,204891,204892,0,1,0
58623,3,1,204894,204894,204895,0,1,2
58624,1,2,204895,204895,204897,0,2,0
58625,1,2,204896,204897,204899,1,3,0
58626,6,1,204902,204902,204903,0,1,3
58627,6,1,204908,204908,204909,0,1,5
58628,5,2,204913,204913,204915,0,2,4
58629,1,3,204914,204915,204918,1,4,0
58630,6,3,204920,204920,204923,0,3,2
58631,5,3,204925,204925,204928,0,3,2
58632,3,3,204928,204928,204931,0,3,0
58633,4,1,204932,204932,204933,0,1,1
58634,2,3,204934,204934,204937,0,3,1
58635,1,3,204935,204937,204940,2,5,0
58636,6,2,204941,204941,204943,0,2,1
58637,4,3,204945,204945,204948,0,3,2
58638,2,2,204947,204948,204950,1,3,0
58639,2,2,204949,204950,204952,1,3,0
58640,4,1,204953,204953,204954,0,1,1
58641,2,3,204955,204955,204958,0,3,1
58642,4,3,204959,204959,204962,0,3,1
58643,1,2,204960,204962,204964,2,4,0
58644,1,1,204961,204964,204965,3,4,0
58645,3,2,204964,204965,204967,1,3,0
58646,2,2,204966,204967,204969,1,3,0
58647,3,2,204969,204969,204971,0,2,0
58648,2,2,204971,204971,204973,0,2,0
58649,5,1,204976,204976,204977,0,1,3
58650,6,2,204982,204982,204984,0,2,5
58651,1,2,204983,204984,204986,1,3,0
58652,6,3,204989,204989,204992,0,3,3
58653,5,2,204994,204994,204996,0,2,2
58654,6,2,205000,205000,205002,0,2,4
58655,1,1,205001,205002,205003,1,2,0
58656,4,2,205005,205005,205007,0,2,2
58657,3,2,205008,205008,205010,0,2,1
58658,6,1,205014,205014,205015,0,1,4
58659,2,2,205016,205016,205018,0,2,1
58660,1,1,205017,205018,205019,1,2,0
58661,2,1,205019,205019,205020,0,1,0
58662,3,1,205022,205022,205023,0,1,2
58663,6,1,205028,205028,205029,0,1,5
58664,6,2,205034,205034,205036,0,2,5
58665,2,3,205036,205036,205039,0,3,0
58666,6,3,205042,205042,205045,0,3,3
58667,3,3,205045,205045,205048,0,3,0
58668,3,1,205048,205048,205049,0,1,0
58669,2,3,205050,205050,205053,0,3,1
58670,4,2,205054,205054,205056,0,2,1
58671,2,3,205056,205056,205059,0,3,0
58672,6,2,205062,205062,205064,0,2,3
58673,2,3,205064,205064,205067,0,3,0
58674,2,3,205066,205067,205070,1,4,0
58675,1,2,205067,205070,205072,3,5,0
58676,3,3,205070,205072,205075,2,5,0
58677,6,1,205076,205076,205077,0,1,1
58678,1,2,205077,205077,205079,0,2,0
58679,5,2,205082,205082,205084,0,2,3
58680,1,1,205083,205084,205085,1,2,0
58681,3,1,205086,205086,205087,0,1,1
58682,1,1,205087,205087,205088,0,1,0
58683,6,2,205093,205093,205095,0,2,5
58684,6,1,205099,205099,205100,0,1,4
58685,5,1,205104,205104,205105,0,1,4
58686,1,2,205105,205105,205107,0,2,0
58687,5,3,205110,205110,205113,0,3,3
58688,4,1,205114,205114,205115,0,1,1
58689,3,3,205117,205117,205120,0,3,2
58690,6,3,205123,205123,205126,0,3,3
58691,2,2,205125,205126,205128,1,3,0
58692,1,2,205126,205128,205130,2,4,0
58693,6,2,205132,205132,205134,0,2,2
58694,6,1,205138,205138,205139,0,1,4
58695,5,2,205143,205143,205145,0,2,4
58696,3,1,205146,205146,205147,0,1,1
58697,3,2,205149,205149,205151,0,2,2
58698,5,1,205154,205154,205155,0,1,3
58699,2,2,205156,205156,205158,0,2,1
58700,6,3,205162,205162,205165,0,3,4
58701,2,3,205164,205165,205168,1,4,0
58702,1,2,205165,205168,205170,3,5,0
58703,6,1,205171,205171,205172,0,1,1
58704,2,3,205173,205173,205176,0,3,1
58705,2,3,205175,205176,205179,1,4,0
58706,6,3,205181,205181,205184,0,3,2
58707,4,3,205185,205185,205188,0,3,1
58708,2,2,205187,205188,205190,1,3,0
58709,1,1,205188,205190,205191,2,3,0
58710,2,2,205190,205191,205193,1,3,0
58711,1,2,205191,205193,205195,2,4,0
58712,1,1,205192,205195,205196,3,4,0
58713,4,1,205196,205196,205197,0,1,0
58714,2,2,205198,205198,205200,0,2,1
58715,4,3,205202,205202,205205,0,3,2
58716,3,2,205205,205205,205207,0,2,0
58717,6,3,205211,205211,205214,0,3,4
58718,1,3,205212,205214,205217,2,5,0
58719,5,1,205217,205217,205218,0,1,0
58720,6,1,205223,205223,205224,0,1,5
58721,3,3,205226,205226,205229,0,3,2
58722,6,1,205232,205232,205233,0,1,3
58723,4,1,205236,205236,205237,0,1,3
58724,4,2,205240,205240,205242,0,2,3
58725,3,1,205243,205243,205244,0,1,1
58726,5,1,205248,205248,205249,0,1,4
58727,3,2,205251,205251,205253,0,2,2
58728,4,2,205255,205255,205257,0,2,2
58729,3,1,205258,205258,205259,0,1,1
58730,6,3,205264,205264,205267,0,3,5
58731,3,3,205267,205267,205270,0,3,0
58732,6,1,205273,205273,205274,0,1,3
58733,3,1,205276,205276,205277,0,1,2
58734,6,3,205282,205282,205285,0,3,5
58735,4,1,205286,205286,205287,0,1,1
58736,3,2,205289,205289,205291,0,2,2
58737,2,3,205291,205291,205294,0,3,0
58738,2,2,205293,205294,205296,1,3,0
58739,2,2,205295,205296,205298,1,3,0
58740,1,1,205296,205298,205299,2,3,0
58741,4,3,205300,205300,205303,0,3,1
58742,3,1,205303,205303,205304,0,1,0
58743,4,2,205307,205307,205309,0,2,3
58744,3,2,205310,205310,205312,0,2,1
58745,3,3,205313,205313,205316,0,3,1
58746,1,2,205314,205316,205318,2,4,0
58747,1,1,205315,205318,205319,3,4,0
58748,1,1,205316,205319,205320,3,4,0
58749,5,2,205321,205321,205323,0,2,1
58750,5,3,205326,205326,205329,0,3,3
58751,6,1,205332,205332,205333,0,1,3
58752,5,2,205337,205337,205339,0,2,4
58753,1,1,205338,205339,205340,1,2,0
58754,3,2,205341,205341,205343,0,2,1
58755,1,1,205342,205343,205344,1,2,0
58756,6,2,205348,205348,205350,0,2,4
58757,2,1,205350,205350,205351,0,1,0
58758,1,2,205351,205351,205353,0,2,0
58759,2,2,205353,205353,205355,0,2,0
58760,1,3,205354,205355,205358,1,4,0
58761,4,2,205358,205358,205360,0,2,0
58762,6,3,205364,205364,205367,0,3,4
58763,4,2,205368,205368,205370,0,2,1
58764,4,3,205372,205372,205375,0,3,2
58765,5,3,205377,205377,205380,0,3,2
58766,6,1,205383,205383,205384,0,1,3
58767,5,3,205388,205388,205391,0,3,4
58768,2,3,205390,205391,205394,1,4,0
58769,3,1,205393,205394,205395,1,2,0
58770,5,1,205398,205398,205399,0,1,3
58771,4,1,205402,205402,205403,0,1,3
58772,2,3,205404,205404,205407,0,3,1
58773,3,3,205407,205407,205410,0,3,0
58774,2,1,205409,205410,205411,1,2,0
58775,2,1,205411,205411,205412,0,1,0
58776,1,3,205412,205412,205415,0,3,0
58777,1,1,205413,205415,205416,2,3,0
58778,6,2,205419,205419,205421,0,2,3
58779,3,2,205422,205422,205424,0,2,1
58780,2,1,205424,205424,205425,0,1,0
58781,1,3,205425,205425,205428,0,3,0
58782,4,3,205429,205429,205432,0,3,1
58783,1,2,205430,205432,205434,2,4,0
58784,4,2,205434,205434,205436,0,2,0
58785,4,2,205438,205438,205440,0,2,2
58786,1,3,205439,205440,205443,1,4,0
58787,2,2,205441,205443,205445,2,4,0
58788,3,2,205444,205445,205447,1,3,0
58789,4,3,205448,205448,205451,0,3,1
58790,4,3,205452,205452,205455,0,3,1
58791,5,1,205457,205457,205458,0,1,2
58792,6,3,205463,205463,205466,0,3,5
58793,6,2,205469,205469,205471,0,2,3
58794,1,3,205470,205471,205474,1,4,0
58795,3,2,205473,205474,205476,1,3,0
58796,3,1,205476,205476,205477,0,1,0
58797,6,2,205482,205482,205484,0,2,5
58798,5,3,205487,205487,205490,0,3,3
58799,6,3,205493,205493,205496,0,3,3
58800,2,1,205495,205496,205497,1,2,0
58801,6,2,205501,205501,205503,0,2,4
58802,3,3,205504,205504,205507,0,3,1
58803,1,2,205505,205507,205509,2,4,0
58804,5,1,205510,205510,205511,0,1,1
58805,2,1,205512,205512,205513,0,1,1
58806,3,2,205515,205515,205517,0,2,2
58807,1,2,205516,205517,205519,1,3,0
58808,5,3,205521,205521,205524,0,3,2
58809,5,1,205526,205526,205527,0,1,2
58810,3,3,205529,205529,205532,0,3,2
58811,6,2,205535,205535,205537,0,2,3
58812,6,1,205541,205541,205542,0,1,4
58813,6,3,205547,205547,205550,0,3,5
58814,1,1,205548,205550,205551,2,3,0
58815,1,2,205549,205551,205553,2,4,0
58816,4,3,205553,205553,205556,0,3,0
58817,5,1,205558,205558,205559,0,1,2
58818,5,3,205563,205563,205566,0,3,4
58819,5,1,205568,205568,205569,0,1,2
58820,1,3,205569,205569,205572,0,3,0
58821,4,2,205573,205573,205575,0,2,1
58822,6,3,205579,205579,205582,0,3,4
58823,3,3,205582,205582,205585,0,3,0
58824,5,1,205587,205587,205588,0,1,2
58825,4,1,205591,205591,205592,0,1,3
58826,5,1,205596,205596,205597,0,1,4
58827,6,1,205602,205602,205603,0,1,5
58828,6,3,205608,205608,205611,0,3,5
58829,3,2,205611,205611,205613,0,2,0
58830,1,1,205612,205613,205614,1,2,0
58831,6,2,205618,205618,205620,0,2,4
58832,3,1,205621,205621,205622,0,1,1
58833,1,1,205622,205622,205623,0,1,0
58834,2,1,205624,205624,205625,0,1,1
58835,5,3,205629,205629,205632,0,3,4
58836,5,3,205634,205634,205637,0,3,2
58837,5,1,205639,205639,205640,0,1,2
58838,2,1,205641,205641,205642,0,1,1
58839,2,3,205643,205643,205646,0,3,1
58840,4,2,205647,205647,205649,0,2,1
58841,3,1,205650,205650,205651,0,1,1
58842,3,2,205653,205653,205655,0,2,2
58843,4,3,205657,205657,205660,0,3,2
58844,3,2,205660,205660,205662,0,2,0
58845,5,2,205665,205665,205667,0,2,3
58846,5,2,205670,205670,205672,0,2,3
58847,1,2,205671,205672,205674,1,3,0
58848,3,1,205674,205674,205675,0,1,0
58849,3,3,205677,205677,205680,0,3,2
58850,4,2,205681,205681,205683,0,2,1
58851,2,1,205683,205683,205684,0,1,0
58852,6,1,205689,205689,205690,0,1,5
58853,1,2,205690,205690,205692,0,2,0
58854,5,2,205695,205695,205697,0,2,3
58855,3,3,205698,205698,205701,0,3,1
58856,6,2,205704,205704,205706,0,2,3
58857,2,2,205706,205706,205708,0,2,0
58858,1,3,205707,205708,205711,1,4,0
58859,6,2,205713,205713,205715,0,2,2
58860,1,3,205714,205715,205718,1,4,0
58861,1,1,205715,205718,205719,3,4,0
58862,5,2,205720,205720,205722,0,2,1
58863,6,1,205726,205726,205727,0,1,4
58864,3,3,205729,205729,205732,0,3,2
58865,3,2,205732,205732,205734,0,2,0
58866,2,2,205734,205734,205736,0,2,0
58867,1,2,205735,205736,205738,1,3,0
58868,4,2,205739,205739,205741,0,2,1
58869,4,2,205743,205743,205745,0,2,2
58870,3,2,205746,205746,205748,0,2,1
58871,5,3,205751,205751,205754,0,3,3
58872,4,3,205755,205755,205758,0,3,1
58873,4,1,205759,205759,205760,0,1,1
58874,6,1,205765,205765,205766,0,1,5
58875,6,3,205771,205771,205774,0,3,5
58876,2,2,205773,205774,205776,1,3,0
58877,3,3,205776,205776,205779,0,3,0
58878,6,3,205782,205782,205785,0,3,3
58879,3,2,205785,205785,205787,0,2,0
58880,1,1,205786,205787,205788,1,2,0
58881,5,3,205791,205791,205794,0,3,3
58882,6,2,205797,205797,205799,0,2,3
58883,1,2,205798,205799,205801,1,3,0
58884,5,2,205803,205803,205805,0,2,2
58885,4,2,205807,205807,205809,0,2,2
58886,1,2,205808,205809,205811,1,3,0
58887,5,2,205813,205813,205815,0,2,2
58888,4,3,205817,205817,205820,0,3,2
58889,2,3,205819,205820,205823,1,4,0
58890,1,1,205820,205823,205824,3,4,0
58891,4,3,205824,205824,205827,0,3,0
58892,5,3,205829,205829,205832,0,3,2
58893,6,3,205835,205835,205838,0,3,3
58894,1,1,205836,205838,205839,2,3,0
58895,4,3,205840,205840,205843,0,3,1
58896,5,3,205845,205845,205848,0,3,2
58897,5,2,205850,205850,205852,0,2,2
58898,5,3,205855,205855,205858,0,3,3
58899,4,3,205859,205859,205862,0,3,1
58900,2,1,205861,205862,205863,1,2,0
58901,4,1,205865,205865,205866,0,1,2
58902,3,1,205868,205868,205869,0,1,2
58903,1,2,205869,205869,205871,0,2,0
58904,2,2,205871,205871,205873,0,2,0
58905,2,1,205873,205873,205874,0,1,0
58906,4,1,205877,205877,205878,0,1,3
58907,4,2,205881,205881,205883,0,2,3
58908,1,3,205882,205883,205886,1,4,0
58909,1,2,205883,205886,205888,3,5,0
58910,2,2,205885,205888,205890,3,5,0
58911,6,3,205891,205891,205894,0,3,1
58912,5,1,205896,205896,205897,0,1,2
58913,2,3,205898,205898,205901,0,3,1
58914,2,3,205900,205901,205904,1,4,0
58915,1,1,205901,205904,205905,3,4,0
58916,4,3,205905,205905,205908,0,3,0
58917,5,1,205910,205910,205911,0,1,2
58918,4,3,205914,205914,205917,0,3,3
58919,5,3,205919,205919,205922,0,3,2
58920,4,3,205923,205923,205926,0,3,1
58921,6,1,205929,205929,205930,0,1,3
58922,6,2,205935,205935,205937,0,2,5
58923,3,2,205938,205938,205940,0,2,1
58924,1,2,205939,205940,205942,1,3,0
58925,4,1,205943,205943,205944,0,1,1
58926,6,2,205949,205949,205951,0,2,5
58927,2,1,205951,205951,205952,0,1,0
58928,1,2,205952,205952,205954,0,2,0
58929,6,2,205958,205958,205960,0,2,4
58930,4,1,205962,205962,205963,0,1,2
58931,5,3,205967,205967,205970,0,3,4
58932,3,1,205970,205970,205971,0,1,0
58933,1,2,205971,205971,205973,0,2,0
58934,6,1,205977,205977,205978,0,1,4
58935,1,3,205978,205978,205981,0,3,0
58936,4,2,205982,205982,205984,0,2,1
58937,3,1,205985,205985,205986,0,1,1
58938,5,1,205990,205990,205991,0,1,4
58939,5,2,205995,205995,205997,0,2,4
58940,1,2,205996,205997,205999,1,3,0
58941,3,3,205999,205999,206002,0,3,0
58942,4,2,206003,206003,206005,0,2,1
58943,4,1,206007,206007,206008,0,1,2
58944,1,2,206008,206008,206010,0,2,0
58945,6,3,206014,206014,206017,0,3,4
58946,3,3,206017,206017,206020,0,3,0
58947,1,1,206018,206020,206021,2,3,0
58948,3,3,206021,206021,206024,0,3,0
58949,3,3,206024,206024,206027,0,3,0
58950,1,2,206025,206027,206029,2,4,0
58951,2,3,206027,206029,206032,2,5,0
58952,1,1,206028,206032,206033,4,5,0
58953,6,3,206034,206034,206037,0,3,1
58954,5,3,206039,206039,206042,0,3,2
58955,2,1,206041,206042,206043,1,2,0
58956,2,3,206043,206043,206046,0,3,0
58957,5,3,206048,206048,206051,0,3,2
58958,1,2,206049,206051,206053,2,4,0
58959,2,2,206051,206053,206055,2,4,0
58960,5,1,206056,206056,206057,0,1,1
58961,1,1,206057,206057,206058,0,1,0
58962,1,2,206058,206058,206060,0,2,0
58963,2,3,206060,206060,206063,0,3,0
58964,5,1,206065,206065,206066,0,1,2
58965,1,3,206066,206066,206069,0,3,0
58966,6,1,206072,206072,206073,0,1,3
58967,2,2,206074,206074,206076,0,2,1
58968,3,1,206077,206077,206078,0,1,1
58969,6,3,206083,206083,206086,0,3,5
58970,3,1,206086,206086,206087,0,1,0
58971,5,3,206091,206091,206094,0,3,4
58972,1,2,206092,206094,206096,2,4,0
58973,4,1,206096,206096,206097,0,1,0
58974,5,2,206101,206101,206103,0,2,4
58975,4,2,206105,206105,206107,0,2,2
58976,6,2,206111,206111,206113,0,2,4
58977,6,1,206117,206117,206118,0,1,4
58978,4,2,206121,206121,206123,0,2,3
58979,1,1,206122,206123,206124,1,2,0
58980,4,3,206126,206126,206129,0,3,2
58981,6,2,206132,206132,206134,0,2,3
58982,2,1,206134,206134,206135,0,1,0
58983,5,2,206139,206139,206141,0,2,4
58984,4,2,206143,206143,206145,0,2,2
58985,1,3,206144,206145,206148,1,4,0
58986,3,3,206147,206148,206151,1,4,0
58987,3,3,206150,206151,206154,1,4,0
58988,5,2,206155,206155,206157,0,2,1
58989,5,1,206160,206160,206161,0,1,3
58990,2,1,206162,206162,206163,0,1,1
58991,6,3,206168,206168,206171,0,3,5
58992,6,2,206174,206174,206176,0,2,3
58993,4,3,206178,206178,206181,0,3,2
58994,5,2,206183,206183,206185,0,2,2
58995,4,2,206187,206187,206189,0,2,2
58996,2,1,206189,206189,206190,0,1,0
58997,3,2,206192,206192,206194,0,2,2
58998,1,2,206193,206194,206196,1,3,0
58999,3,1,206196,206196,206197,0,1,0
59000,1,1,206197,206197,206198,0,1,0
59001,4,1,206201,206201,206202,0,1,3
59002,2,3,206203,206203,206206,0,3,1
59003,1,1,206204,206206,206207,2,3,0
59004,1,3,206205,206207,206210,2,5,0
59005,2,2,206207,206210,206212,3,5,0
59006,3,3,206210,206212,206215,2,5,0
59007,1,3,206211,206215,206218,4,7,0
59008,4,1,206215,206218,206219,3,4,0
59009,6,2,206221,206221,206223,0,2,2
59010,6,3,206227,206227,206230,0,3,4
59011,6,2,206233,206233,206235,0,2,3
59012,3,1,206236,206236,206237,0,1,1
59013,5,1,206241,206241,206242,0,1,4
59014,3,2,206244,206244,206246,0,2,2
59015,4,2,206248,206248,206250,0,2,2
59016,4,1,206252,206252,206253,0,1,2
59017,5,2,206257,206257,206259,0,2,4
59018,1,1,206258,206259,206260,1,2,0
59019,5,3,206263,206263,206266,0,3,3
59020,6,2,206269,206269,206271,0,2,3
59021,4,3,206273,206273,206276,0,3,2
59022,3,1,206276,206276,206277,0,1,0
59023,4,3,206280,206280,206283,0,3,3
59024,5,3,206285,206285,206288,0,3,2
59025,2,3,206287,206288,206291,1,4,0
59026,5,2,206292,206292,206294,0,2,1
59027,3,1,206295,206295,206296,0,1,1
59028,4,1,206299,206299,206300,0,1,3
59029,3,2,206302,206302,206304,0,2,2
59030,6,1,206308,206308,206309,0,1,4
59031,4,3,206312,206312,206315,0,3,3
59032,6,1,206318,206318,206319,0,1,3
59033,1,2,206319,206319,206321,0,2,0
59034,6,2,206325,206325,206327,0,2,4
59035,2,3,206327,206327,206330,0,3,0
59036,5,2,206332,206332,206334,0,2,2
59037,2,3,206334,206334,206337,0,3,0
59038,2,1,206336,206337,206338,1,2,0
59039,5,2,206341,206341,206343,0,2,3
59040,3,1,206344,206344,206345,0,1,1
59041,2,1,206346,206346,206347,0,1,1
59042,6,2,206352,206352,206354,0,2,5
59043,2,2,206354,206354,206356,0,2,0
59044,3,2,206357,206357,206359,0,2,1
59045,3,1,206360,206360,206361,0,1,1
59046,3,2,206363,206363,206365,0,2,2
59047,4,3,206367,206367,206370,0,3,2
59048,3,2,206370,206370,206372,0,2,0
59049,6,2,206376,206376,206378,0,2,4
59050,3,2,206379,206379,206381,0,2,1
59051,4,2,206383,206383,206385,0,2,2
59052,2,3,206385,206385,206388,0,3,0
59053,1,2,206386,206388,206390,2,4,0
59054,2,3,206388,206390,206393,2,5,0
59055,2,2,206390,206393,206395,3,5,0
59056,4,3,206394,206395,206398,1,4,0
59057,1,1,206395,206398,206399,3,4,0
59058,1,3,206396,206399,206402,3,6,0
59059,5,1,206401,206402,206403,1,2,0
59060,1,2,206402,206403,206405,1,3,0
59061,3,2,206405,206405,206407,0,2,0
59062,2,3,206407,206407,206410,0,3,0
59063,2,2,206409,206410,206412,1,3,0
59064,6,1,206415,206415,206416,0,1,3
59065,5,1,206420,206420,206421,0,1,4
59066,3,2,206423,206423,206425,0,2,2
59067,2,3,206425,206425,206428,0,3,0
59068,4,2,206429,206429,206431,0,2,1
59069,6,2,206435,206435,206437,0,2,4
59070,5,2,206440,206440,206442,0,2,3
59071,6,1,206446,206446,206447,0,1,4
59072,2,1,206448,206448,206449,0,1,1
59073,6,3,206454,206454,206457,0,3,5
59074,5,1,206459,206459,206460,0,1,2
59075,6,1,206465,206465,206466,0,1,5
59076,2,2,206467,206467,206469,0,2,1
59077,3,1,206470,206470,206471,0,1,1
59078,4,3,206474,206474,206477,0,3,3
59079,2,3,206476,206477,206480,1,4,0
59080,3,3,206479,206480,206483,1,4,0
59081,2,2,206481,206483,206485,2,4,0
59082,2,1,206483,206485,206486,2,3,0
59083,6,1,206489,206489,206490,0,1,3
59084,4,1,206493,206493,206494,0,1,3
59085,5,1,206498,206498,206499,0,1,4
59086,1,1,206499,206499,206500,0,1,0
59087,3,1,206502,206502,206503,0,1,2
59088,1,1,206503,206503,206504,0,1,0
59089,1,3,206504,206504,206507,0,3,0
59090,6,3,206510,206510,206513,0,3,3
59091,2,2,206512,206513,206515,1,3,0
59092,4,1,206516,206516,206517,0,1,1
59093,4,2,206520,206520,206522,0,2,3
59094,1,3,206521,206522,206525,1,4,0
59095,2,1,206523,206525,206526,2,3,0
59096,4,2,206527,206527,206529,0,2,1
59097,1,1,206528,206529,206530,1,2,0
59098,6,2,206534,206534,206536,0,2,4
59099,1,3,206535,206536,206539,1,4,0
59100,2,2,206537,206539,206541,2,4,0
59101,5,3,206542,206542,206545,0,3,1
59102,2,3,206544,206545,206548,1,4,0
59103,3,1,206547,206548,206549,1,2,0
59104,4,1,206551,206551,206552,0,1,2
59105,1,2,206552,206552,206554,0,2,0
59106,5,2,206557,206557,206559,0,2,3
59107,1,1,206558,206559,206560,1,2,0
59108,3,3,206561,206561,206564,0,3,1
59109,6,2,206567,206567,206569,0,2,3
59110,1,3,206568,206569,206572,1,4,0
59111,5,3,206573,206573,206576,0,3,1
59112,6,3,206579,206579,206582,0,3,3
59113,2,1,206581,206582,206583,1,2,0
59114,1,3,206582,206583,206586,1,4,0
59115,1,2,206583,206586,206588,3,5,0
59116,2,3,206585,206588,206591,3,6,0
59117,4,3,206589,206591,206594,2,5,0
59118,2,3,206591,206594,206597,3,6,0
59119,1,1,206592,206597,206598,5,6,0
59120,6,3,206598,206598,206601,0,3,0
59121,3,2,206601,206601,206603,0,2,0
59122,4,3,206605,206605,206608,0,3,2
59123,4,3,206609,206609,206612,0,3,1
59124,2,3,206611,206612,206615,1,4,0
59125,4,2,206615,206615,206617,0,2,0
59126,1,2,206616,206617,206619,1,3,0
59127,4,2,206620,206620,206622,0,2,1
59128,4,3,206624,206624,206627,0,3,2
59129,5,1,206629,206629,206630,0,1,2
59130,1,1,206630,206630,206631,0,1,0
59131,6,1,206636,206636,206637,0,1,5
59132,5,1,206641,206641,206642,0,1,4
59133,1,1,206642,206642,206643,0,1,0
59134,6,3,206648,206648,206651,0,3,5
59135,3,1,206651,206651,206652,0,1,0
59136,2,1,206653,206653,206654,0,1,1
59137,4,2,206657,206657,206659,0,2,3
59138,2,3,206659,206659,206662,0,3,0
59139,1,2,206660,206662,206664,2,4,0
59140,4,1,206664,206664,206665,0,1,0
59141,4,1,206668,206668,206669,0,1,3
59142,2,2,206670,206670,206672,0,2,1
59143,6,3,206676,206676,206679,0,3,4
59144,1,1,206677,206679,206680,2,3,0
59145,3,2,206680,206680,206682,0,2,0
59146,1,2,206681,206682,206684,1,3,0
59147,4,2,206685,206685,206687,0,2,1
59148,6,3,206691,206691,206694,0,3,4
59149,4,1,206695,206695,206696,0,1,1
59150,4,2,206699,206699,206701,0,2,3
59151,3,1,206702,206702,206703,0,1,1
59152,5,2,206707,206707,206709,0,2,4
59153,4,1,206711,206711,206712,0,1,2
59154,4,2,206715,206715,206717,0,2,3
59155,4,2,206719,206719,206721,0,2,2
59156,6,3,206725,206725,206728,0,3,4
59157,5,3,206730,206730,206733,0,3,2
59158,4,1,206734,206734,206735,0,1,1
59159,4,2,206738,206738,206740,0,2,3
59160,1,1,206739,206740,206741,1,2,0
59161,3,1,206742,206742,206743,0,1,1
59162,6,3,206748,206748,206751,0,3,5
59163,1,1,206749,206751,206752,2,3,0
59164,3,3,206752,206752,206755,0,3,0
59165,1,3,206753,206755,206758,2,5,0
59166,2,1,206755,206758,206759,3,4,0
59167,1,1,206756,206759,206760,3,4,0
59168,3,1,206759,206760,206761,1,2,0
59169,1,1,206760,206761,206762,1,2,0
59170,6,1,206766,206766,206767,0,1,4
59171,6,3,206772,206772,206775,0,3,5
59172,5,3,206777,206777,206780,0,3,2
59173,2,3,206779,206780,206783,1,4,0
59174,1,1,206780,206783,206784,3,4,0
59175,1,1,206781,206784,206785,3,4,0
59176,6,2,206787,206787,206789,0,2,2
59177,6,3,206793,206793,206796,0,3,4
59178,2,2,206795,206796,206798,1,3,0
59179,4,3,206799,206799,206802,0,3,1
59180,3,1,206802,206802,206803,0,1,0
59181,6,3,206808,206808,206811,0,3,5
59182,4,1,206812,206812,206813,0,1,1
59183,5,1,206817,206817,206818,0,1,4
59184,3,2,206820,206820,206822,0,2,2
59185,5,3,206825,206825,206828,0,3,3
59186,1,3,206826,206828,206831,2,5,0
59187,4,1,206830,206831,206832,1,2,0
59188,6,3,206836,206836,206839,0,3,4
59189,2,1,206838,206839,206840,1,2,0
59190,2,3,206840,206840,206843,0,3,0
59191,4,1,206844,206844,206845,0,1,1
59192,5,2,206849,206849,206851,0,2,4
59193,1,1,206850,206851,206852,1,2,0
59194,1,1,206851,206852,206853,1,2,0
59195,3,1,206854,206854,206855,0,1,1
59196,2,1,206856,206856,206857,0,1,1
59197,3,2,206859,206859,206861,0,2,2
59198,6,3,206865,206865,206868,0,3,4
59199,1,3,206866,206868,206871,2,5,0
59200,6,1,206872,206872,206873,0,1,1
59201,6,3,206878,206878,206881,0,3,5
59202,1,1,206879,206881,206882,2,3,0
59203,1,1,206880,206882,206883,2,3,0
59204,3,2,206883,206883,206885,0,2,0
59205,5,3,206888,206888,206891,0,3,3
59206,2,3,206890,206891,206894,1,4,0
59207,4,3,206894,206894,206897,0,3,0
59208,4,1,206898,206898,206899,0,1,1
59209,4,3,206902,206902,206905,0,3,3
59210,3,3,206905,206905,206908,0,3,0
59211,5,3,206910,206910,206913,0,3,2
59212,3,2,206913,206913,206915,0,2,0
59213,6,1,206919,206919,206920,0,1,4
59214,5,3,206924,206924,206927,0,3,4
59215,4,3,206928,206928,206931,0,3,1
59216,6,2,206934,206934,206936,0,2,3
59217,5,2,206939,206939,206941,0,2,3
59218,3,1,206942,206942,206943,0,1,1
59219,5,2,206947,206947,206949,0,2,4
59220,1,3,206948,206949,206952,1,4,0
59221,3,2,206951,206952,206954,1,3,0
59222,3,2,206954,206954,206956,0,2,0
59223,4,3,206958,206958,206961,0,3,2
59224,6,2,206964,206964,206966,0,2,3
59225,6,1,206970,206970,206971,0,1,4
59226,2,1,206972,206972,206973,0,1,1
59227,1,2,206973,206973,206975,0,2,0
59228,4,1,206977,206977,206978,0,1,2
59229,5,3,206982,206982,206985,0,3,4
59230,3,3,206985,206985,206988,0,3,0
59231,5,2,206990,206990,206992,0,2,2
59232,5,2,206995,206995,206997,0,2,3
59233,1,2,206996,206997,206999,1,3,0
59234,6,3,207002,207002,207005,0,3,3
59235,4,3,207006,207006,207009,0,3,1
59236,3,2,207009,207009,207011,0,2,0
59237,6,1,207015,207015,207016,0,1,4
59238,4,1,207019,207019,207020,0,1,3
59239,3,2,207022,207022,207024,0,2,2
59240,3,2,207025,207025,207027,0,2,1
59241,3,3,207028,207028,207031,0,3,1
59242,1,3,207029,207031,207034,2,5,0
59243,2,3,207031,207034,207037,3,6,0
59244,2,3,207033,207037,207040,4,7,0
59245,6,1,207039,207040,207041,1,2,0
59246,2,1,207041,207041,207042,0,1,0
59247,2,3,207043,207043,207046,0,3,1
59248,6,3,207049,207049,207052,0,3,3
59249,3,1,207052,207052,207053,0,1,0
59250,3,1,207055,207055,207056,0,1,2
59251,2,1,207057,207057,207058,0,1,1
59252,5,2,207062,207062,207064,0,2,4
59253,6,2,207068,207068,207070,0,2,4
59254,4,3,207072,207072,207075,0,3,2
59255,4,1,207076,207076,207077,0,1,1
59256,6,1,207082,207082,207083,0,1,5
59257,3,3,207085,207085,207088,0,3,2
59258,4,3,207089,207089,207092,0,3,1
59259,4,2,207093,207093,207095,0,2,1
59260,3,1,207096,207096,207097,0,1,1
59261,6,3,207102,207102,207105,0,3,5
59262,5,1,207107,207107,207108,0,1,2
59263,5,3,207112,207112,207115,0,3,4
59264,1,3,207113,207115,207118,2,5,0
59265,1,1,207114,207118,207119,4,5,0
59266,4,3,207118,207119,207122,1,4,0
59267,1,2,207119,207122,207124,3,5,0
59268,1,2,207120,207124,207126,4,6,0
59269,4,1,207124,207126,207127,2,3,0
59270,2,2,207126,207127,207129,1,3,0
59271,5,2,207131,207131,207133,0,2,2
59272,5,1,207136,207136,207137,0,1,3
59273,3,3,207139,207139,207142,0,3,2
59274,6,2,207145,207145,207147,0,2,3
59275,3,3,207148,207148,207151,0,3,1
59276,5,2,207153,207153,207155,0,2,2
59277,5,1,207158,207158,207159,0,1,3
59278,6,2,207164,207164,207166,0,2,5
59279,4,3,207168,207168,207171,0,3,2
59280,3,2,207171,207171,207173,0,2,0
59281,6,1,207177,207177,207178,0,1,4
59282,5,3,207182,207182,207185,0,3,4
59283,5,3,207187,207187,207190,0,3,2
59284,3,2,207190,207190,207192,0,2,0
59285,2,2,207192,207192,207194,0,2,0
59286,5,1,207197,207197,207198,0,1,3
59287,2,3,207199,207199,207202,0,3,1
59288,2,1,207201,207202,207203,1,2,0
59289,2,3,207203,207203,207206,0,3,0
59290,6,1,207209,207209,207210,0,1,3
59291,2,1,207211,207211,207212,0,1,1
59292,2,1,207213,207213,207214,0,1,1
59293,3,3,207216,207216,207219,0,3,2
59294,5,3,207221,207221,207224,0,3,2
59295,2,2,207223,207224,207226,1,3,0
59296,1,2,207224,207226,207228,2,4,0
59297,5,2,207229,207229,207231,0,2,1
59298,1,1,207230,207231,207232,1,2,0
59299,2,2,207232,207232,207234,0,2,0
59300,4,3,207236,207236,207239,0,3,2
59301,6,1,207242,207242,207243,0,1,3
59302,3,3,207245,207245,207248,0,3,2
59303,4,1,207249,207249,207250,0,1,1
59304,4,1,207253,207253,207254,0,1,3
59305,5,3,207258,207258,207261,0,3,4
59306,6,2,207264,207264,207266,0,2,3
59307,3,3,207267,207267,207270,0,3,1
59308,5,2,207272,207272,207274,0,2,2
59309,3,2,207275,207275,207277,0,2,1
59310,6,3,207281,207281,207284,0,3,4
59311,1,2,207282,207284,207286,2,4,0
59312,6,2,207288,207288,207290,0,2,2
59313,4,3,207292,207292,207295,0,3,2
59314,2,3,207294,207295,207298,1,4,0
59315,2,1,207296,207298,207299,2,3,0
59316,5,2,207301,207301,207303,0,2,2
59317,2,1,207303,207303,207304,0,1,0
59318,1,3,207304,207304,207307,0,3,0
59319,4,3,207308,207308,207311,0,3,1
59320,3,3,207311,207311,207314,0,3,0
59321,1,3,207312,207314,207317,2,5,0
59322,3,3,207315,207317,207320,2,5,0
59323,6,3,207321,207321,207324,0,3,1
59324,2,1,207323,207324,207325,1,2,0
59325,3,2,207326,207326,207328,0,2,1
59326,4,2,207330,207330,207332,0,2,2
59327,3,3,207333,207333,207336,0,3,1
59328,5,3,207338,207338,207341,0,3,2
59329,6,1,207344,207344,207345,0,1,3
59330,3,2,207347,207347,207349,0,2,2
59331,3,3,207350,207350,207353,0,3,1
59332,3,3,207353,207353,207356,0,3,0
59333,5,3,207358,207358,207361,0,3,2
59334,1,2,207359,207361,207363,2,4,0
59335,1,1,207360,207363,207364,3,4,0
59336,6,3,207366,207366,207369,0,3,2
59337,5,2,207371,207371,207373,0,2,2
59338,5,1,207376,207376,207377,0,1,3
59339,1,1,207377,207377,207378,0,1,0
59340,2,3,207379,207379,207382,0,3,1
59341,2,2,207381,207382,207384,1,3,0
59342,6,1,207387,207387,207388,0,1,3
59343,3,2,207390,207390,207392,0,2,2
59344,4,3,207394,207394,207397,0,3,2
59345,3,2,207397,207397,207399,0,2,0
59346,4,3,207401,207401,207404,0,3,2
59347,4,1,207405,207405,207406,0,1,1
59348,6,1,207411,207411,207412,0,1,5
59349,4,1,207415,207415,207416,0,1,3
59350,1,3,207416,207416,207419,0,3,0
59351,6,2,207422,207422,207424,0,2,3
59352,5,1,207427,207427,207428,0,1,3
59353,2,3,207429,207429,207432,0,3,1
59354,5,2,207434,207434,207436,0,2,2
59355,2,2,207436,207436,207438,0,2,0
59356,2,2,207438,207438,207440,0,2,0
59357,6,3,207444,207444,207447,0,3,4
59358,2,1,207446,207447,207448,1,2,0
59359,1,2,207447,207448,207450,1,3,0
59360,6,3,207453,207453,207456,0,3,3
59361,4,2,207457,207457,207459,0,2,1
59362,1,3,207458,207459,207462,1,4,0
59363,1,1,207459,207462,207463,3,4,0
59364,3,1,207462,207463,207464,1,2,0
59365,2,1,207464,207464,207465,0,1,0
59366,5,1,207469,207469,207470,0,1,4
59367,6,1,207475,207475,207476,0,1,5
59368,2,3,207477,207477,207480,0,3,1
59369,4,3,207481,207481,207484,0,3,1
59370,2,3,207483,207484,207487,1,4,0
59371,5,1,207488,207488,207489,0,1,1
59372,5,1,207493,207493,207494,0,1,4
59373,5,2,207498,207498,207500,0,2,4
59374,3,2,207501,207501,207503,0,2,1
59375,2,1,207503,207503,207504,0,1,0
59376,2,1,207505,207505,207506,0,1,1
59377,3,1,207508,207508,207509,0,1,2
59378,3,1,207511,207511,207512,0,1,2
59379,6,2,207517,207517,207519,0,2,5
59380,5,1,207522,207522,207523,0,1,3
59381,2,1,207524,207524,207525,0,1,1
59382,4,1,207528,207528,207529,0,1,3
59383,1,1,207529,207529,207530,0,1,0
59384,6,3,207535,207535,207538,0,3,5
59385,2,2,207537,207538,207540,1,3,0
59386,1,2,207538,207540,207542,2,4,0
59387,5,2,207543,207543,207545,0,2,1
59388,2,1,207545,207545,207546,0,1,0
59389,5,1,207550,207550,207551,0,1,4
59390,3,3,207553,207553,207556,0,3,2
59391,6,3,207559,207559,207562,0,3,3
59392,3,1,207562,207562,207563,0,1,0
59393,1,3,207563,207563,207566,0,3,0
59394,4,2,207567,207567,207569,0,2,1
59395,3,3,207570,207570,207573,0,3,1
59396,4,3,207574,207574,207577,0,3,1
59397,3,1,207577,207577,207578,0,1,0
59398,4,3,207581,207581,207584,0,3,3
59399,4,3,207585,207585,207588,0,3,1
59400,4,3,207589,207589,207592,0,3,1
59401,1,2,207590,207592,207594,2,4,0
59402,2,1,207592,207594,207595,2,3,0
59403,1,2,207593,207595,207597,2,4,0
59404,4,1,207597,207597,207598,0,1,0
59405,3,1,207600,207600,207601,0,1,2
59406,3,2,207603,207603,207605,0,2,2
59407,2,1,207605,207605,207606,0,1,0
59408,4,3,207609,207609,207612,0,3,3
59409,4,3,207613,207613,207616,0,3,1
59410,5,1,207618,207618,207619,0,1,2
59411,6,2,207624,207624,207626,0,2,5
59412,2,1,207626,207626,207627,0,1,0
59413,4,1,207630,207630,207631,0,1,3
59414,1,2,207631,207631,207633,0,2,0
59415,4,2,207635,207635,207637,0,2,2
59416,5,3,207640,207640,207643,0,3,3
59417,4,2,207644,207644,207646,0,2,1
59418,5,1,207649,207649,207650,0,1,3
59419,4,2,207653,207653,207655,0,2,3
59420,5,2,207658,207658,207660,0,2,3
59421,1,1,207659,207660,207661,1,2,0
59422,3,3,207662,207662,207665,0,3,1
59423,6,2,207668,207668,207670,0,2,3
59424,5,3,207673,207673,207676,0,3,3
59425,2,2,207675,207676,207678,1,3,0
59426,2,3,207677,207678,207681,1,4,0
59427,3,1,207680,207681,207682,1,2,0
59428,5,1,207685,207685,207686,0,1,3
59429,2,3,207687,207687,207690,0,3,1
59430,5,3,207692,207692,207695,0,3,2
59431,6,1,207698,207698,207699,0,1,3
59432,3,2,207701,207701,207703,0,2,2
59433,4,1,207705,207705,207706,0,1,2
59434,5,3,207710,207710,207713,0,3,4
59435,5,3,207715,207715,207718,0,3,2
59436,4,2,207719,207719,207721,0,2,1
59437,1,1,207720,207721,207722,1,2,0
59438,3,1,207723,207723,207724,0,1,1
59439,5,1,207728,207728,207729,0,1,4
59440,3,1,207731,207731,207732,0,1,2
59441,3,3,207734,207734,207737,0,3,2
59442,6,1,207740,207740,207741,0,1,3
59443,5,1,207745,207745,207746,0,1,4
59444,1,3,207746,207746,207749,0,3,0
59445,3,1,207749,207749,207750,0,1,0
59446,3,1,207752,207752,207753,0,1,2
59447,2,3,207754,207754,207757,0,3,1
59448,2,1,207756,207757,207758,1,2,0
59449,4,3,207760,207760,207763,0,3,2
59450,1,1,207761,207763,207764,2,3,0
59451,5,3,207766,207766,207769,0,3,2
59452,3,3,207769,207769,207772,0,3,0
59453,3,1,207772,207772,207773,0,1,0
59454,1,2,207773,207773,207775,0,2,0
59455,4,1,207777,207777,207778,0,1,2
59456,2,1,207779,207779,207780,0,1,1
59457,3,3,207782,207782,207785,0,3,2
59458,4,3,207786,207786,207789,0,3,1
59459,4,2,207790,207790,207792,0,2,1
59460,2,1,207792,207792,207793,0,1,0
59461,3,1,207795,207795,207796,0,1,2
59462,6,1,207801,207801,207802,0,1,5
59463,1,2,207802,207802,207804,0,2,0
59464,5,2,207807,207807,207809,0,2,3
59465,5,3,207812,207812,207815,0,3,3
59466,3,3,207815,207815,207818,0,3,0
59467,3,2,207818,207818,207820,0,2,0
59468,6,2,207824,207824,207826,0,2,4
59469,2,3,207826,207826,207829,0,3,0
59470,3,2,207829,207829,207831,0,2,0
59471,3,2,207832,207832,207834,0,2,1
59472,6,3,207838,207838,207841,0,3,4
59473,4,2,207842,207842,207844,0,2,1
59474,2,3,207844,207844,207847,0,3,0
59475,6,2,207850,207850,207852,0,2,3
59476,6,2,207856,207856,207858,0,2,4
59477,3,1,207859,207859,207860,0,1,1
59478,6,3,207865,207865,207868,0,3,5
59479,6,1,207871,207871,207872,0,1,3
59480,6,2,207877,207877,207879,0,2,5
59481,2,3,207879,207879,207882,0,3,0
59482,1,2,207880,207882,207884,2,4,0
59483,1,1,207881,207884,207885,3,4,0
59484,5,3,207886,207886,207889,0,3,1
59485,4,1,207890,207890,207891,0,1,1
59486,6,1,207896,207896,207897,0,1,5
59487,4,2,207900,207900,207902,0,2,3
59488,2,1,207902,207902,207903,0,1,0
59489,6,1,207908,207908,207909,0,1,5
59490,4,2,207912,207912,207914,0,2,3
59491,3,1,207915,207915,207916,0,1,1
59492,1,3,207916,207916,207919,0,3,0
59493,4,1,207920,207920,207921,0,1,1
59494,2,1,207922,207922,207923,0,1,1
59495,6,2,207928,207928,207930,0,2,5
59496,6,2,207934,207934,207936,0,2,4
59497,2,3,207936,207936,207939,0,3,0
59498,1,3,207937,207939,207942,2,5,0
59499,6,3,207943,207943,207946,0,3,1
59500,6,2,207949,207949,207951,0,2,3
59501,4,3,207953,207953,207956,0,3,2
59502,4,3,207957,207957,207960,0,3,1
59503,3,3,207960,207960,207963,0,3,0
59504,6,3,207966,207966,207969,0,3,3
59505,6,2,207972,207972,207974,0,2,3
59506,4,3,207976,207976,207979,0,3,2
59507,2,1,207978,207979,207980,1,2,0
59508,4,3,207982,207982,207985,0,3,2
59509,5,2,207987,207987,207989,0,2,2
59510,5,3,207992,207992,207995,0,3,3
59511,5,2,207997,207997,207999,0,2,2
59512,6,1,208003,208003,208004,0,1,4
59513,3,3,208006,208006,208009,0,3,2
59514,1,2,208007,208009,208011,2,4,0
59515,4,3,208011,208011,208014,0,3,0
59516,1,3,208012,208014,208017,2,5,0
59517,3,3,208015,208017,208020,2,5,0
59518,4,1,208019,208020,208021,1,2,0
59519,3,3,208022,208022,208025,0,3,1
59520,3,1,208025,208025,208026,0,1,0
59521,1,3,208026,208026,208029,0,3,0
59522,4,2,208030,208030,208032,0,2,1
59523,3,2,208033,208033,208035,0,2,1
59524,3,3,208036,208036,208039,0,3,1
59525,6,1,208042,208042,208043,0,1,3
59526,1,3,208043,208043,208046,0,3,0
59527,5,3,208048,208048,208051,0,3,2
59528,2,3,208050,208051,208054,1,4,0
59529,2,3,208052,208054,208057,2,5,0
59530,1,1,208053,208057,208058,4,5,0
59531,4,1,208057,208058,208059,1,2,0
59532,2,3,208059,208059,208062,0,3,0
59533,4,3,208063,208063,208066,0,3,1
59534,2,2,208065,208066,208068,1,3,0
59535,3,1,208068,208068,208069,0,1,0
59536,1,3,208069,208069,208072,0,3,0
59537,4,1,208073,208073,208074,0,1,1
59538,6,3,208079,208079,208082,0,3,5
59539,1,1,208080,208082,208083,2,3,0
59540,2,1,208082,208083,208084,1,2,0
59541,6,1,208088,208088,208089,0,1,4
59542,2,1,208090,208090,208091,0,1,1
59543,2,2,208092,208092,208094,0,2,1
59544,4,3,208096,208096,208099,0,3,2
59545,5,1,208101,208101,208102,0,1,2
59546,2,1,208103,208103,208104,0,1,1
59547,1,3,208104,208104,208107,0,3,0
59548,4,1,208108,208108,208109,0,1,1
59549,6,1,208114,208114,208115,0,1,5
59550,6,1,208120,208120,208121,0,1,5
59551,5,3,208125,208125,208128,0,3,4
59552,3,3,208128,208128,208131,0,3,0
59553,5,2,208133,208133,208135,0,2,2
59554,5,2,208138,208138,208140,0,2,3
59555,6,2,208144,208144,208146,0,2,4
59556,5,1,208149,208149,208150,0,1,3
59557,5,3,208154,208154,208157,0,3,4
59558,3,1,208157,208157,208158,0,1,0
59559,4,2,208161,208161,208163,0,2,3
59560,1,2,208162,208163,208165,1,3,0
59561,3,1,208165,208165,208166,0,1,0
59562,3,3,208168,208168,208171,0,3,2
59563,5,1,208173,208173,208174,0,1,2
59564,4,2,208177,208177,208179,0,2,3
59565,4,1,208181,208181,208182,0,1,2
59566,3,3,208184,208184,208187,0,3,2
59567,2,3,208186,208187,208190,1,4,0
59568,3,2,208189,208190,208192,1,3,0
59569,1,1,208190,208192,208193,2,3,0
59570,2,1,208192,208193,208194,1,2,0
59571,2,3,208194,208194,208197,0,3,0
59572,3,1,208197,208197,208198,0,1,0
59573,3,2,208200,208200,208202,0,2,2
59574,1,2,208201,208202,208204,1,3,0
59575,4,2,208205,208205,208207,0,2,1
59576,4,3,208209,208209,208212,0,3,2
59577,5,2,208214,208214,208216,0,2,2
59578,6,2,208220,208220,208222,0,2,4
59579,4,1,208224,208224,208225,0,1,2
59580,5,3,208229,208229,208232,0,3,4
59581,5,3,208234,208234,208237,0,3,2
59582,1,1,208235,208237,208238,2,3,0
59583,6,1,208241,208241,208242,0,1,3
59584,2,2,208243,208243,208245,0,2,1
59585,3,1,208246,208246,208247,0,1,1
59586,6,1,208252,208252,208253,0,1,5
59587,4,3,208256,208256,208259,0,3,3
59588,4,2,208260,208260,208262,0,2,1
59589,2,2,208262,208262,208264,0,2,0
59590,4,3,208266,208266,208269,0,3,2
59591,3,3,208269,208269,208272,0,3,0
59592,5,2,208274,208274,208276,0,2,2
59593,4,2,208278,208278,208280,0,2,2
59594,5,2,208283,208283,208285,0,2,3
59595,2,1,208285,208285,208286,0,1,0
59596,4,1,208289,208289,208290,0,1,3
59597,2,1,208291,208291,208292,0,1,1
59598,5,3,208296,208296,208299,0,3,4
59599,5,1,208301,208301,208302,0,1,2
59600,2,3,208303,208303,208306,0,3,1
59601,6,2,208309,208309,208311,0,2,3
59602,3,2,208312,208312,208314,0,2,1
59603,4,3,208316,208316,208319,0,3,2
59604,5,2,208321,208321,208323,0,2,2
59605,2,2,208323,208323,208325,0,2,0
59606,3,3,208326,208326,208329,0,3,1
59607,2,3,208328,208329,208332,1,4,0
59608,6,1,208334,208334,208335,0,1,2
59609,4,1,208338,208338,208339,0,1,3
59610,3,1,208341,208341,208342,0,1,2
59611,6,3,208347,208347,208350,0,3,5
59612,1,1,208348,208350,208351,2,3,0
59613,2,1,208350,208351,208352,1,2,0
59614,3,2,208353,208353,208355,0,2,1
59615,6,1,208359,208359,208360,0,1,4
59616,6,1,208365,208365,208366,0,1,5
59617,5,3,208370,208370,208373,0,3,4
59618,6,1,208376,208376,208377,0,1,3
59619,4,1,208380,208380,208381,0,1,3
59620,2,2,208382,208382,208384,0,2,1
59621,3,2,208385,208385,208387,0,2,1
59622,5,3,208390,208390,208393,0,3,3
59623,1,3,208391,208393,208396,2,5,0
59624,1,3,208392,208396,208399,4,7,0
59625,1,3,208393,208399,208402,6,9,0
59626,4,1,208397,208402,208403,5,6,0
59627,5,2,208402,208403,208405,1,3,0
59628,6,2,208408,208408,208410,0,2,3
59629,3,2,208411,208411,208413,0,2,1
59630,3,2,208414,208414,208416,0,2,1
59631,4,1,208418,208418,208419,0,1,2
59632,4,2,208422,208422,208424,0,2,3
59633,5,3,208427,208427,208430,0,3,3
59634,5,3,208432,208432,208435,0,3,2
59635,2,2,208434,208435,208437,1,3,0
59636,5,1,208439,208439,208440,0,1,2
59637,2,2,208441,208441,208443,0,2,1
59638,2,3,208443,208443,208446,0,3,0
59639,3,1,208446,208446,208447,0,1,0
59640,1,3,208447,208447,208450,0,3,0
59641,1,2,208448,208450,208452,2,4,0
59642,6,3,208454,208454,208457,0,3,2
59643,1,3,208455,208457,208460,2,5,0
59644,6,1,208461,208461,208462,0,1,1
59645,4,3,208465,208465,208468,0,3,3
59646,3,3,208468,208468,208471,0,3,0
59647,6,3,208474,208474,208477,0,3,3
59648,5,3,208479,208479,208482,0,3,2
59649,6,1,208485,208485,208486,0,1,3
59650,4,2,208489,208489,208491,0,2,3
59651,4,3,208493,208493,208496,0,3,2
59652,1,1,208494,208496,208497,2,3,0
59653,1,2,208495,208497,208499,2,4,0
59654,3,2,208498,208499,208501,1,3,0
59655,4,2,208502,208502,208504,0,2,1
59656,2,2,208504,208504,208506,0,2,0
59657,5,1,208509,208509,208510,0,1,3
59658,4,3,208513,208513,208516,0,3,3
59659,1,2,208514,208516,208518,2,4,0
59660,6,3,208520,208520,208523,0,3,2
59661,1,1,208521,208523,208524,2,3,0
59662,4,2,208525,208525,208527,0,2,1
59663,1,2,208526,208527,208529,1,3,0
59664,4,2,208530,208530,208532,0,2,1
59665,4,3,208534,208534,208537,0,3,2
59666,1,3,208535,208537,208540,2,5,0
59667,3,3,208538,208540,208543,2,5,0
59668,1,1,208539,208543,208544,4,5,0
59669,3,3,208542,208544,208547,2,5,0
59670,6,2,208548,208548,208550,0,2,1
59671,5,2,208553,208553,208555,0,2,3
59672,1,3,208554,208555,208558,1,4,0
59673,5,1,208559,208559,208560,0,1,1
59674,6,3,208565,208565,208568,0,3,5
59675,6,3,208571,208571,208574,0,3,3
59676,3,3,208574,208574,208577,0,3,0
59677,4,3,208578,208578,208581,0,3,1
59678,4,1,208582,208582,208583,0,1,1
59679,6,2,208588,208588,208590,0,2,5
59680,5,3,208593,208593,208596,0,3,3
59681,1,2,208594,208596,208598,2,4,0
59682,5,3,208599,208599,208602,0,3,1
59683,2,3,208601,208602,208605,1,4,0
59684,4,2,208605,208605,208607,0,2,0
59685,6,1,208611,208611,208612,0,1,4
59686,3,3,208614,208614,208617,0,3,2
59687,1,3,208615,208617,208620,2,5,0
59688,1,2,208616,208620,208622,4,6,0
59689,4,2,208620,208622,208624,2,4,0
59690,6,3,208626,208626,208629,0,3,2
59691,5,2,208631,208631,208633,0,2,2
59692,1,2,208632,208633,208635,1,3,0
59693,1,3,208633,208635,208638,2,5,0
59694,1,2,208634,208638,208640,4,6,0
59695,3,2,208637,208640,208642,3,5,0
59696,5,2,208642,208642,208644,0,2,0
59697,2,3,208644,208644,208647,0,3,0
59698,5,1,208649,208649,208650,0,1,2
59699,4,1,208653,208653,208654,0,1,3
59700,1,1,208654,208654,208655,0,1,0
59701,6,1,208660,208660,208661,0,1,5
59702,6,1,208666,208666,208667,0,1,5
59703,1,3,208667,208667,208670,0,3,0
59704,5,3,208672,208672,208675,0,3,2
59705,2,3,208674,208675,208678,1,4,0
59706,6,2,208680,208680,208682,0,2,2
59707,5,1,208685,208685,208686,0,1,3
59708,5,3,208690,208690,208693,0,3,4
59709,6,1,208696,208696,208697,0,1,3
59710,5,3,208701,208701,208704,0,3,4
59711,4,2,208705,208705,208707,0,2,1
59712,2,2,208707,208707,208709,0,2,0
59713,2,2,208709,208709,208711,0,2,0
59714,3,2,208712,208712,208714,0,2,1
59715,6,2,208718,208718,208720,0,2,4
59716,4,1,208722,208722,208723,0,1,2
59717,3,1,208725,208725,208726,0,1,2
59718,3,1,208728,208728,208729,0,1,2
59719,3,3,208731,208731,208734,0,3,2
59720,2,2,208733,208734,208736,1,3,0
59721,5,2,208738,208738,208740,0,2,2
59722,1,2,208739,208740,208742,1,3,0
59723,2,1,208741,208742,208743,1,2,0
59724,5,2,208746,208746,208748,0,2,3
59725,6,1,208752,208752,208753,0,1,4
59726,2,1,208754,208754,208755,0,1,1
59727,5,2,208759,208759,208761,0,2,4
59728,5,2,208764,208764,208766,0,2,3
59729,3,1,208767,208767,208768,0,1,1
59730,5,1,208772,208772,208773,0,1,4
59731,5,2,208777,208777,208779,0,2,4
59732,1,1,208778,208779,208780,1,2,0
59733,2,2,208780,208780,208782,0,2,0
59734,3,2,208783,208783,208785,0,2,1
59735,1,1,208784,208785,208786,1,2,0
59736,5,1,208789,208789,208790,0,1,3
59737,5,1,208794,208794,208795,0,1,4
59738,1,1,208795,208795,208796,0,1,0
59739,5,3,208800,208800,208803,0,3,4
59740,6,2,208806,208806,208808,0,2,3
59741,4,2,208810,208810,208812,0,2,2
59742,5,3,208815,208815,208818,0,3,3
59743,1,3,208816,208818,208821,2,5,0
59744,2,1,208818,208821,208822,3,4,0
59745,1,2,208819,208822,208824,3,5,0
59746,1,3,208820,208824,208827,4,7,0
59747,2,3,208822,208827,208830,5,8,0
59748,2,1,208824,208830,208831,6,7,0
59749,1,1,208825,208831,208832,6,7,0
59750,2,1,208827,208832,208833,5,6,0
59751,4,2,208831,208833,208835,2,4,0
59752,6,1,208837,208837,208838,0,1,2
59753,4,3,208841,208841,208844,0,3,3
59754,4,2,208845,208845,208847,0,2,1
59755,1,3,208846,208847,208850,1,4,0
59756,2,2,208848,208850,208852,2,4,0
59757,1,2,208849,208852,208854,3,5,0
59758,1,2,208850,208854,208856,4,6,0
59759,1,3,208851,208856,208859,5,8,0
59760,2,1,208853,208859,208860,6,7,0
59761,4,3,208857,208860,208863,3,6,0
59762,1,3,208858,208863,208866,5,8,0
59763,1,2,208859,208866,208868,7,9,0
59764,4,3,208863,208868,208871,5,8,0
59765,3,1,208866,208871,208872,5,6,0
59766,1,1,208867,208872,208873,5,6,0
59767,3,1,208870,208873,208874,3,4,0
59768,6,2,208876,208876,208878,0,2,2
59769,5,2,208881,208881,208883,0,2,3
59770,3,3,208884,208884,208887,0,3,1
59771,6,1,208890,208890,208891,0,1,3
59772,4,1,208894,208894,208895,0,1,3
59773,1,1,208895,208895,208896,0,1,0
59774,6,3,208901,208901,208904,0,3,5
59775,3,1,208904,208904,208905,0,1,0
59776,1,1,208905,208905,208906,0,1,0
59777,1,2,208906,208906,208908,0,2,0
59778,6,1,208912,208912,208913,0,1,4
59779,1,2,208913,208913,208915,0,2,0
59780,2,3,208915,208915,208918,0,3,0
59781,3,2,208918,208918,208920,0,2,0
59782,4,1,208922,208922,208923,0,1,2
59783,2,1,208924,208924,208925,0,1,1
59784,1,3,208925,208925,208928,0,3,0
59785,6,1,208931,208931,208932,0,1,3
59786,1,3,208932,208932,208935,0,3,0
59787,6,1,208938,208938,208939,0,1,3
59788,1,3,208939,208939,208942,0,3,0
59789,3,3,208942,208942,208945,0,3,0
59790,2,3,208944,208945,208948,1,4,0
59791,2,3,208946,208948,208951,2,5,0
59792,2,2,208948,208951,208953,3,5,0
59793,5,1,208953,208953,208954,0,1,0
59794,5,3,208958,208958,208961,0,3,4
59795,4,3,208962,208962,208965,0,3,1
59796,1,2,208963,208965,208967,2,4,0
59797,1,2,208964,208967,208969,3,5,0
59798,6,2,208970,208970,208972,0,2,1
59799,4,2,208974,208974,208976,0,2,2
59800,1,2,208975,208976,208978,1,3,0
59801,6,2,208981,208981,208983,0,2,3
59802,2,3,208983,208983,208986,0,3,0
59803,4,2,208987,208987,208989,0,2,1
59804,3,1,208990,208990,208991,0,1,1
59805,4,1,208994,208994,208995,0,1,3
59806,4,3,208998,208998,209001,0,3,3
59807,4,2,209002,209002,209004,0,2,1
59808,6,1,209008,209008,209009,0,1,4
59809,5,1,209013,209013,209014,0,1,4
59810,5,2,209018,209018,209020,0,2,4
59811,5,2,209023,209023,209025,0,2,3
59812,5,2,209028,209028,209030,0,2,3
59813,3,1,209031,209031,209032,0,1,1
59814,5,1,209036,209036,209037,0,1,4
59815,2,2,209038,209038,209040,0,2,1
59816,3,3,209041,209041,209044,0,3,1
59817,6,2,209047,209047,209049,0,2,3
59818,1,3,209048,209049,209052,1,4,0
59819,6,3,209054,209054,209057,0,3,2
59820,3,3,209057,209057,209060,0,3,0
59821,4,1,209061,209061,209062,0,1,1
59822,6,3,209067,209067,209070,0,3,5
59823,1,1,209068,209070,209071,2,3,0
59824,6,3,209074,209074,209077,0,3,3
59825,5,1,209079,209079,209080,0,1,2
59826,6,1,209085,209085,209086,0,1,5
59827,5,3,209090,209090,209093,0,3,4
59828,6,1,209096,209096,209097,0,1,3
59829,3,2,209099,209099,209101,0,2,2
59830,6,3,209105,209105,209108,0,3,4
59831,6,2,209111,209111,209113,0,2,3
59832,4,2,209115,209115,209117,0,2,2
59833,3,3,209118,209118,209121,0,3,1
59834,4,2,209122,209122,209124,0,2,1
59835,3,1,209125,209125,209126,0,1,1
59836,1,2,209126,209126,209128,0,2,0
59837,4,1,209130,209130,209131,0,1,2
59838,2,3,209132,209132,209135,0,3,1
59839,4,1,209136,209136,209137,0,1,1
59840,4,2,209140,209140,209142,0,2,3
59841,5,2,209145,209145,209147,0,2,3
59842,6,3,209151,209151,209154,0,3,4
59843,6,2,209157,209157,209159,0,2,3
59844,2,3,209159,209159,209162,0,3,0
59845,4,1,209163,209163,209164,0,1,1
59846,6,3,209169,209169,209172,0,3,5
59847,3,3,209172,209172,209175,0,3,0
59848,6,3,209178,209178,209181,0,3,3
59849,5,1,209183,209183,209184,0,1,2
59850,6,1,209189,209189,209190,0,1,5
59851,3,1,209192,209192,209193,0,1,2
59852,6,3,209198,209198,209201,0,3,5
59853,1,3,209199,209201,209204,2,5,0
59854,5,1,209204,209204,209205,0,1,0
59855,4,1,209208,209208,209209,0,1,3
59856,5,2,209213,209213,209215,0,2,4
59857,2,1,209215,209215,209216,0,1,0
59858,6,3,209221,209221,209224,0,3,5
59859,2,3,209223,209224,209227,1,4,0
59860,4,1,209227,209227,209228,0,1,0
59861,2,1,209229,209229,209230,0,1,1
59862,2,3,209231,209231,209234,0,3,1
59863,3,1,209234,209234,209235,0,1,0
59864,2,1,209236,209236,209237,0,1,1
59865,4,3,209240,209240,209243,0,3,3
59866,2,2,209242,209243,209245,1,3,0
59867,6,2,209248,209248,209250,0,2,3
59868,6,2,209254,209254,209256,0,2,4
59869,3,2,209257,209257,209259,0,2,1
59870,4,2,209261,209261,209263,0,2,2
59871,6,3,209267,209267,209270,0,3,4
59872,1,3,209268,209270,209273,2,5,0
59873,6,2,209274,209274,209276,0,2,1
59874,4,2,209278,209278,209280,0,2,2
59875,3,1,209281,209281,209282,0,1,1
59876,1,3,209282,209282,209285,0,3,0
59877,5,3,209287,209287,209290,0,3,2
59878,2,2,209289,209290,209292,1,3,0
59879,1,3,209290,209292,209295,2,5,0
59880,3,1,209293,209295,209296,2,3,0
59881,4,1,209297,209297,209298,0,1,1
59882,6,2,209303,209303,209305,0,2,5
59883,2,2,209305,209305,209307,0,2,0
59884,5,2,209310,209310,209312,0,2,3
59885,2,2,209312,209312,209314,0,2,0
59886,1,3,209313,209314,209317,1,4,0
59887,1,3,209314,209317,209320,3,6,0
59888,4,3,209318,209320,209323,2,5,0
59889,5,3,209323,209323,209326,0,3,0
59890,6,2,209329,209329,209331,0,2,3
59891,6,3,209335,209335,209338,0,3,4
59892,6,3,209341,209341,209344,0,3,3
59893,5,1,209346,209346,209347,0,1,2
59894,2,1,209348,209348,209349,0,1,1
59895,5,2,209353,209353,209355,0,2,4
59896,2,2,209355,209355,209357,0,2,0
59897,6,3,209361,209361,209364,0,3,4
59898,3,2,209364,209364,209366,0,2,0
59899,2,3,209366,209366,209369,0,3,0
59900,2,3,209368,209369,209372,1,4,0
59901,6,3,209374,209374,209377,0,3,2
59902,6,2,209380,209380,209382,0,2,3
59903,6,2,209386,209386,209388,0,2,4
59904,2,1,209388,209388,209389,0,1,0
59905,6,2,209394,209394,209396,0,2,5
59906,6,1,209400,209400,209401,0,1,4
59907,3,2,209403,209403,209405,0,2,2
59908,5,3,209408,209408,209411,0,3,3
59909,6,3,209414,209414,209417,0,3,3
59910,3,2,209417,209417,209419,0,2,0
59911,1,3,209418,209419,209422,1,4,0
59912,3,2,209421,209422,209424,1,3,0
59913,1,2,209422,209424,209426,2,4,0
59914,6,3,209428,209428,209431,0,3,2
59915,5,1,209433,209433,209434,0,1,2
59916,6,3,209439,209439,209442,0,3,5
59917,3,1,209442,209442,209443,0,1,0
59918,2,2,209444,209444,209446,0,2,1
59919,6,1,209450,209450,209451,0,1,4
59920,4,3,209454,209454,209457,0,3,3
59921,5,3,209459,209459,209462,0,3,2
59922,1,3,209460,209462,209465,2,5,0
59923,5,3,209465,209465,209468,0,3,0
59924,4,1,209469,209469,209470,0,1,1
59925,1,3,209470,209470,209473,0,3,0
59926,4,2,209474,209474,209476,0,2,1
59927,3,3,209477,209477,209480,0,3,1
59928,6,3,209483,209483,209486,0,3,3
59929,3,2,209486,209486,209488,0,2,0
59930,4,2,209490,209490,209492,0,2,2
59931,1,1,209491,209492,209493,1,2,0
59932,5,1,209496,209496,209497,0,1,3
59933,2,3,209498,209498,209501,0,3,1
59934,1,2,209499,209501,209503,2,4,0
59935,3,2,209502,209503,209505,1,3,0
59936,1,2,209503,209505,209507,2,4,0
59937,3,1,209506,209507,209508,1,2,0
59938,1,2,209507,209508,209510,1,3,0
59939,6,1,209513,209513,209514,0,1,3
59940,2,1,209515,209515,209516,0,1,1
59941,4,2,209519,209519,209521,0,2,3
59942,2,3,209521,209521,209524,0,3,0
59943,3,3,209524,209524,209527,0,3,0
59944,3,2,209527,209527,209529,0,2,0
59945,3,3,209530,209530,209533,0,3,1
59946,3,2,209533,209533,209535,0,2,0
59947,5,2,209538,209538,209540,0,2,3
59948,1,2,209539,209540,209542,1,3,0
59949,2,3,209541,209542,209545,1,4,0
59950,1,1,209542,209545,209546,3,4,0
59951,5,1,209547,209547,209548,0,1,1
59952,2,2,209549,209549,209551,0,2,1
59953,3,1,209552,209552,209553,0,1,1
59954,2,2,209554,209554,209556,0,2,1
59955,1,2,209555,209556,209558,1,3,0
59956,2,1,209557,209558,209559,1,2,0
59957,3,3,209560,209560,209563,0,3,1
59958,6,2,209566,209566,209568,0,2,3
59959,5,3,209571,209571,209574,0,3,3
59960,2,3,209573,209574,209577,1,4,0
59961,5,1,209578,209578,209579,0,1,1
59962,4,1,209582,209582,209583,0,1,3
59963,2,3,209584,209584,209587,0,3,1
59964,4,1,209588,209588,209589,0,1,1
59965,4,2,209592,209592,209594,0,2,3
59966,5,1,209597,209597,209598,0,1,3
59967,5,3,209602,209602,209605,0,3,4
59968,5,2,209607,209607,209609,0,2,2
59969,5,3,209612,209612,209615,0,3,3
59970,1,1,209613,209615,209616,2,3,0
59971,6,2,209619,209619,209621,0,2,3
59972,1,2,209620,209621,209623,1,3,0
59973,1,3,209621,209623,209626,2,5,0
59974,5,3,209626,209626,209629,0,3,0
59975,2,1,209628,209629,209630,1,2,0
59976,5,2,209633,209633,209635,0,2,3
59977,6,1,209639,209639,209640,0,1,4
59978,5,1,209644,209644,209645,0,1,4
59979,3,3,209647,209647,209650,0,3,2
59980,3,1,209650,209650,209651,0,1,0
59981,2,2,209652,209652,209654,0,2,1
59982,4,2,209656,209656,209658,0,2,2
59983,6,2,209662,209662,209664,0,2,4
59984,3,3,209665,209665,209668,0,3,1
59985,1,3,209666,209668,209671,2,5,0
59986,6,1,209672,209672,209673,0,1,1
59987,3,2,209675,209675,209677,0,2,2
59988,6,3,209681,209681,209684,0,3,4
59989,5,1,209686,209686,209687,0,1,2
59990,3,2,209689,209689,209691,0,2,2
59991,3,2,209692,209692,209694,0,2,1
59992,3,3,209695,209695,209698,0,3,1
59993,3,2,209698,209698,209700,0,2,0
59994,1,3,209699,209700,209703,1,4,0
59995,3,1,209702,209703,209704,1,2,0
59996,3,1,209705,209705,209706,0,1,1
59997,5,3,209710,209710,209713,0,3,4
59998,2,3,209712,209713,209716,1,4,0
59999,4,2,209716,209716,209718,0,2,0
60000,5,1,209721,209721,209722,0,1,3
60001,6,2,209727,209727,209729,0,2,5
60002,3,3,209730,209730,209733,0,3,1
60003,6,1,209736,209736,209737,0,1,3
60004,4,3,209740,209740,209743,0,3,3
60005,5,2,209745,209745,209747,0,2,2
60006,5,1,209750,209750,209751,0,1,3
60007,4,2,209754,209754,209756,0,2,3
60008,1,1,209755,209756,209757,1,2,0
60009,3,2,209758,209758,209760,0,2,1
60010,2,2,209760,209760,209762,0,2,0
60011,4,3,209764,209764,209767,0,3,2
60012,5,3,209769,209769,209772,0,3,2
60013,2,1,209771,209772,209773,1,2,0
60014,6,3,209777,209777,209780,0,3,4
60015,1,2,209778,209780,209782,2,4,0
60016,1,2,209779,209782,209784,3,5,0
60017,1,1,209780,209784,209785,4,5,0
60018,6,3,209786,209786,209789,0,3,1
60019,5,2,209791,209791,209793,0,2,2
60020,2,1,209793,209793,209794,0,1,0
60021,6,2,209799,209799,209801,0,2,5
60022,1,1,209800,209801,209802,1,2,0
60023,6,1,209806,209806,209807,0,1,4
60024,4,3,209810,209810,209813,0,3,3
60025,5,2,209815,209815,209817,0,2,2
60026,6,2,209821,209821,209823,0,2,4
60027,3,2,209824,209824,209826,0,2,1
60028,1,3,209825,209826,209829,1,4,0
60029,4,3,209829,209829,209832,0,3,0
60030,4,2,209833,209833,209835,0,2,1
60031,4,3,209837,209837,209840,0,3,2
60032,1,1,209838,209840,209841,2,3,0
60033,3,1,209841,209841,209842,0,1,0
60034,3,2,209844,209844,209846,0,2,2
60035,5,1,209849,209849,209850,0,1,3
60036,6,1,209855,209855,209856,0,1,5
60037,6,1,209861,209861,209862,0,1,5
60038,4,3,209865,209865,209868,0,3,3
60039,5,3,209870,209870,209873,0,3,2
60040,2,3,209872,209873,209876,1,4,0
60041,3,2,209875,209876,209878,1,3,0
60042,1,3,209876,209878,209881,2,5,0
60043,1,3,209877,209881,209884,4,7,0
60044,2,2,209879,209884,209886,5,7,0
60045,3,2,209882,209886,209888,4,6,0
60046,5,1,209887,209888,209889,1,2,0
60047,2,2,209889,209889,209891,0,2,0
60048,3,2,209892,209892,209894,0,2,1
60049,3,3,209895,209895,209898,0,3,1
60050,2,1,209897,209898,209899,1,2,0
60051,4,3,209901,209901,209904,0,3,2
60052,1,1,209902,209904,209905,2,3,0
60053,6,2,209908,209908,209910,0,2,3
60054,4,1,209912,209912,209913,0,1,2
60055,3,3,209915,209915,209918,0,3,2
60056,5,1,209920,209920,209921,0,1,2
60057,5,3,209925,209925,209928,0,3,4
60058,1,1,209926,209928,209929,2,3,0
60059,2,1,209928,209929,209930,1,2,0
60060,2,3,209930,209930,209933,0,3,0
60061,5,3,209935,209935,209938,0,3,2
60062,1,2,209936,209938,209940,2,4,0
60063,5,2,209941,209941,209943,0,2,1
60064,6,2,209947,209947,209949,0,2,4
60065,2,2,209949,209949,209951,0,2,0
60066,4,2,209953,209953,209955,0,2,2
60067,3,3,209956,209956,209959,0,3,1
60068,6,2,209962,209962,209964,0,2,3
60069,4,1,209966,209966,209967,0,1,2
60070,1,2,209967,209967,209969,0,2,0
60071,1,2,209968,209969,209971,1,3,0
60072,4,1,209972,209972,209973,0,1,1
60073,5,3,209977,209977,209980,0,3,4
60074,4,1,209981,209981,209982,0,1,1
60075,4,2,209985,209985,209987,0,2,3
60076,4,3,209989,209989,209992,0,3,2
60077,2,2,209991,209992,209994,1,3,0
60078,5,3,209996,209996,209999,0,3,2
60079,2,1,209998,209999,210000,1,2,0
60080,2,1,210000,210000,210001,0,1,0
60081,6,2,210006,210006,210008,0,2,5
60082,6,2,210012,210012,210014,0,2,4
60083,6,2,210018,210018,210020,0,2,4
60084,2,2,210020,210020,210022,0,2,0
60085,2,2,210022,210022,210024,0,2,0
60086,2,2,210024,210024,210026,0,2,0
60087,3,3,210027,210027,210030,0,3,1
60088,2,1,210029,210030,210031,1,2,0
60089,3,1,210032,210032,210033,0,1,1
60090,3,2,210035,210035,210037,0,2,2
60091,5,2,210040,210040,210042,0,2,3
60092,6,1,210046,210046,210047,0,1,4
60093,2,1,210048,210048,210049,0,1,1
60094,1,3,210049,210049,210052,0,3,0
60095,3,1,210052,210052,210053,0,1,0
60096,6,1,210058,210058,210059,0,1,5
60097,6,3,210064,210064,210067,0,3,5
60098,3,3,210067,210067,210070,0,3,0
60099,2,3,210069,210070,210073,1,4,0
60100,6,3,210075,210075,210078,0,3,2
60101,4,3,210079,210079,210082,0,3,1
60102,3,1,210082,210082,210083,0,1,0
60103,4,2,210086,210086,210088,0,2,3
60104,6,3,210092,210092,210095,0,3,4
60105,6,3,210098,210098,210101,0,3,3
60106,4,1,210102,210102,210103,0,1,1
60107,4,3,210106,210106,210109,0,3,3
60108,2,1,210108,210109,210110,1,2,0
60109,1,1,210109,210110,210111,1,2,0
60110,1,3,210110,210111,210114,1,4,0
60111,5,3,210115,210115,210118,0,3,1
60112,1,1,210116,210118,210119,2,3,0
60113,3,3,210119,210119,210122,0,3,0
60114,6,2,210125,210125,210127,0,2,3
60115,3,2,210128,210128,210130,0,2,1
60116,2,3,210130,210130,210133,0,3,0
60117,1,1,210131,210133,210134,2,3,0
60118,3,2,210134,210134,210136,0,2,0
60119,6,2,210140,210140,210142,0,2,4
60120,3,3,210143,210143,210146,0,3,1
60121,2,3,210145,210146,210149,1,4,0
60122,6,2,210151,210151,210153,0,2,2
60123,6,2,210157,210157,210159,0,2,4
60124,3,1,210160,210160,210161,0,1,1
60125,2,2,210162,210162,210164,0,2,1
60126,2,3,210164,210164,210167,0,3,0
60127,2,3,210166,210167,210170,1,4,0
60128,4,2,210170,210170,210172,0,2,0
60129,6,3,210176,210176,210179,0,3,4
60130,5,1,210181,210181,210182,0,1,2
60131,2,3,210183,210183,210186,0,3,1
60132,3,2,210186,210186,210188,0,2,0
60133,6,3,210192,210192,210195,0,3,4
60134,1,2,210193,210195,210197,2,4,0
60135,5,3,210198,210198,210201,0,3,1
60136,3,1,210201,210201,210202,0,1,0
60137,1,2,210202,210202,210204,0,2,0
60138,6,3,210208,210208,210211,0,3,4
60139,6,2,210214,210214,210216,0,2,3
60140,5,2,210219,210219,210221,0,2,3
60141,1,3,210220,210221,210224,1,4,0
60142,6,2,210226,210226,210228,0,2,2
60143,2,2,210228,210228,210230,0,2,0
60144,2,1,210230,210230,210231,0,1,0
60145,5,2,210235,210235,210237,0,2,4
60146,2,3,210237,210237,210240,0,3,0
60147,1,2,210238,210240,210242,2,4,0
60148,1,2,210239,210242,210244,3,5,0
60149,2,3,210241,210244,210247,3,6,0
60150,2,3,210243,210247,210250,4,7,0
60151,3,2,210246,210250,210252,4,6,0
60152,4,1,210250,210252,210253,2,3,0
60153,2,1,210252,210253,210254,1,2,0
60154,6,3,210258,210258,210261,0,3,4
60155,1,1,210259,210261,210262,2,3,0
60156,4,1,210263,210263,210264,0,1,1
60157,2,1,210265,210265,210266,0,1,1
60158,6,2,210271,210271,210273,0,2,5
60159,5,1,210276,210276,210277,0,1,3
60160,2,1,210278,210278,210279,0,1,1
60161,2,3,210280,210280,210283,0,3,1
60162,2,3,210282,210283,210286,1,4,0
60163,6,3,210288,210288,210291,0,3,2
60164,3,1,210291,210291,210292,0,1,0
60165,1,1,210292,210292,210293,0,1,0
60166,6,1,210298,210298,210299,0,1,5
60167,1,1,210299,210299,210300,0,1,0
60168,3,1,210302,210302,210303,0,1,2
60169,4,2,210306,210306,210308,0,2,3
60170,6,3,210312,210312,210315,0,3,4
60171,3,1,210315,210315,210316,0,1,0
60172,2,2,210317,210317,210319,0,2,1
60173,5,1,210322,210322,210323,0,1,3
60174,1,2,210323,210323,210325,0,2,0
60175,4,2,210327,210327,210329,0,2,2
60176,3,3,210330,210330,210333,0,3,1
60177,1,1,210331,210333,210334,2,3,0
60178,3,2,210334,210334,210336,0,2,0
60179,3,1,210337,210337,210338,0,1,1
60180,3,3,210340,210340,210343,0,3,2
60181,2,1,210342,210343,210344,1,2,0
60182,2,3,210344,210344,210347,0,3,0
60183,6,2,210350,210350,210352,0,2,3
60184,1,1,210351,210352,210353,1,2,0
60185,5,2,210356,210356,210358,0,2,3
60186,3,2,210359,210359,210361,0,2,1
60187,5,2,210364,210364,210366,0,2,3
60188,3,2,210367,210367,210369,0,2,1
60189,2,1,210369,210369,210370,0,1,0
60190,3,3,210372,210372,210375,0,3,2
60191,5,3,210377,210377,210380,0,3,2
60192,2,3,210379,210380,210383,1,4,0
60193,2,2,210381,210383,210385,2,4,0
60194,4,2,210385,210385,210387,0,2,0
60195,6,2,210391,210391,210393,0,2,4
60196,4,1,210395,210395,210396,0,1,2
60197,6,2,210401,210401,210403,0,2,5
60198,6,3,210407,210407,210410,0,3,4
60199,5,3,210412,210412,210415,0,3,2
60200,2,2,210414,210415,210417,1,3,0
60201,3,1,210417,210417,210418,0,1,0
60202,4,1,210421,210421,210422,0,1,3
60203,2,2,210423,210423,210425,0,2,1
60204,3,3,210426,210426,210429,0,3,1
60205,3,2,210429,210429,210431,0,2,0
60206,4,1,210433,210433,210434,0,1,2
60207,2,2,210435,210435,210437,0,2,1
60208,4,1,210439,210439,210440,0,1,2
60209,3,1,210442,210442,210443,0,1,2
60210,3,3,210445,210445,210448,0,3,2
60211,2,2,210447,210448,210450,1,3,0
60212,2,2,210449,210450,210452,1,3,0
60213,2,1,210451,210452,210453,1,2,0
60214,3,2,210454,210454,210456,0,2,1
60215,1,2,210455,210456,210458,1,3,0
60216,1,3,210456,210458,210461,2,5,0
60217,1,3,210457,210461,210464,4,7,0
60218,5,3,210462,210464,210467,2,5,0
60219,4,3,210466,210467,210470,1,4,0
60220,1,3,210467,210470,210473,3,6,0
60221,3,2,210470,210473,210475,3,5,0
60222,6,1,210476,210476,210477,0,1,1
60223,5,1,210481,210481,210482,0,1,4
60224,4,2,210485,210485,210487,0,2,3
60225,5,1,210490,210490,210491,0,1,3
60226,2,1,210492,210492,210493,0,1,1
60227,4,3,210496,210496,210499,0,3,3
60228,6,1,210502,210502,210503,0,1,3
60229,1,2,210503,210503,210505,0,2,0
60230,1,1,210504,210505,210506,1,2,0
60231,5,3,210509,210509,210512,0,3,3
60232,2,2,210511,210512,210514,1,3,0
60233,1,3,210512,210514,210517,2,5,0
60234,3,1,210515,210517,210518,2,3,0
60235,3,1,210518,210518,210519,0,1,0
60236,1,3,210519,210519,210522,0,3,0
60237,5,3,210524,210524,210527,0,3,2
60238,5,2,210529,210529,210531,0,2,2
60239,4,1,210533,210533,210534,0,1,2
60240,5,1,210538,210538,210539,0,1,4
60241,1,1,210539,210539,210540,0,1,0
60242,3,3,210542,210542,210545,0,3,2
60243,4,2,210546,210546,210548,0,2,1
60244,2,2,210548,210548,210550,0,2,0
60245,6,2,210554,210554,210556,0,2,4
60246,2,1,210556,210556,210557,0,1,0
60247,6,1,210562,210562,210563,0,1,5
60248,5,3,210567,210567,210570,0,3,4
60249,1,3,210568,210570,210573,2,5,0
60250,5,1,210573,210573,210574,0,1,0
60251,4,2,210577,210577,210579,0,2,3
60252,1,1,210578,210579,210580,1,2,0
60253,2,1,210580,210580,210581,0,1,0
60254,1,2,210581,210581,210583,0,2,0
60255,1,3,210582,210583,210586,1,4,0
60256,3,3,210585,210586,210589,1,4,0
60257,5,1,210590,210590,210591,0,1,1
60258,1,1,210591,210591,210592,0,1,0
60259,3,2,210594,210594,210596,0,2,2
60260,1,3,210595,210596,210599,1,4,0
60261,6,1,210601,210601,210602,0,1,2
60262,1,1,210602,210602,210603,0,1,0
60263,6,3,210608,210608,210611,0,3,5
60264,5,2,210613,210613,210615,0,2,2
60265,4,2,210617,210617,210619,0,2,2
60266,6,2,210623,210623,210625,0,2,4
60267,4,1,210627,210627,210628,0,1,2
60268,3,3,210630,210630,210633,0,3,2
60269,6,1,210636,210636,210637,0,1,3
60270,4,3,210640,210640,210643,0,3,3
60271,4,2,210644,210644,210646,0,2,1
60272,1,3,210645,210646,210649,1,4,0
60273,2,2,210647,210649,210651,2,4,0
60274,1,1,210648,210651,210652,3,4,0
60275,2,1,210650,210652,210653,2,3,0
60276,2,2,210652,210653,210655,1,3,0
60277,3,2,210655,210655,210657,0,2,0
60278,2,3,210657,210657,210660,0,3,0
60279,3,2,210660,210660,210662,0,2,0
60280,6,3,210666,210666,210669,0,3,4
60281,3,2,210669,210669,210671,0,2,0
60282,3,1,210672,210672,210673,0,1,1
60283,4,1,210676,210676,210677,0,1,3
60284,6,1,210682,210682,210683,0,1,5
60285,1,2,210683,210683,210685,0,2,0
60286,2,1,210685,210685,210686,0,1,0
60287,5,1,210690,210690,210691,0,1,4
60288,4,1,210694,210694,210695,0,1,3
60289,5,1,210699,210699,210700,0,1,4
60290,5,1,210704,210704,210705,0,1,4
60291,2,2,210706,210706,210708,0,2,1
60292,3,2,210709,210709,210711,0,2,1
60293,2,1,210711,210711,210712,0,1,0
60294,6,3,210717,210717,210720,0,3,5
60295,1,1,210718,210720,210721,2,3,0
60296,2,2,210720,210721,210723,1,3,0
60297,5,2,210725,210725,210727,0,2,2
60298,2,3,210727,210727,210730,0,3,0
60299,3,1,210730,210730,210731,0,1,0
60300,1,1,210731,210731,210732,0,1,0
60301,2,2,210733,210733,210735,0,2,1
60302,5,2,210738,210738,210740,0,2,3
60303,4,1,210742,210742,210743,0,1,2
60304,4,2,210746,210746,210748,0,2,3
60305,3,2,210749,210749,210751,0,2,1
60306,2,3,210751,210751,210754,0,3,0
60307,1,3,210752,210754,210757,2,5,0
60308,4,2,210756,210757,210759,1,3,0
60309,5,3,210761,210761,210764,0,3,2
60310,1,2,210762,210764,210766,2,4,0
60311,2,1,210764,210766,210767,2,3,0
60312,1,1,210765,210767,210768,2,3,0
60313,5,3,210770,210770,210773,0,3,2
60314,3,1,210773,210773,210774,0,1,0
60315,3,2,210776,210776,210778,0,2,2
60316,6,2,210782,210782,210784,0,2,4
60317,6,2,210788,210788,210790,0,2,4
60318,3,1,210791,210791,210792,0,1,1
60319,3,2,210794,210794,210796,0,2,2
60320,6,2,210800,210800,210802,0,2,4
60321,6,3,210806,210806,210809,0,3,4
60322,5,1,210811,210811,210812,0,1,2
60323,6,1,210817,210817,210818,0,1,5
60324,5,3,210822,210822,210825,0,3,4
60325,2,3,210824,210825,210828,1,4,0
60326,3,1,210827,210828,210829,1,2,0
60327,5,3,210832,210832,210835,0,3,3
60328,3,2,210835,210835,210837,0,2,0
60329,5,1,210840,210840,210841,0,1,3
60330,4,2,210844,210844,210846,0,2,3
60331,6,2,210850,210850,210852,0,2,4
60332,6,2,210856,210856,210858,0,2,4
60333,1,2,210857,210858,210860,1,3,0
60334,5,3,210862,210862,210865,0,3,2
60335,6,2,210868,210868,210870,0,2,3
60336,2,3,210870,210870,210873,0,3,0
60337,6,3,210876,210876,210879,0,3,3
60338,6,3,210882,210882,210885,0,3,3
60339,5,3,210887,210887,210890,0,3,2
60340,5,2,210892,210892,210894,0,2,2
60341,5,1,210897,210897,210898,0,1,3
60342,6,2,210903,210903,210905,0,2,5
60343,6,2,210909,210909,210911,0,2,4
60344,5,3,210914,210914,210917,0,3,3
60345,5,1,210919,210919,210920,0,1,2
60346,2,1,210921,210921,210922,0,1,1
60347,4,3,210925,210925,210928,0,3,3
60348,3,2,210928,210928,210930,0,2,0
60349,4,3,210932,210932,210935,0,3,2
60350,4,3,210936,210936,210939,0,3,1
60351,1,1,210937,210939,210940,2,3,0
60352,6,1,210943,210943,210944,0,1,3
60353,6,3,210949,210949,210952,0,3,5
60354,5,2,210954,210954,210956,0,2,2
60355,2,1,210956,210956,210957,0,1,0
60356,3,1,210959,210959,210960,0,1,2
60357,5,2,210964,210964,210966,0,2,4
60358,5,3,210969,210969,210972,0,3,3
60359,4,2,210973,210973,210975,0,2,1
60360,6,2,210979,210979,210981,0,2,4
60361,5,1,210984,210984,210985,0,1,3
60362,6,1,210990,210990,210991,0,1,5
60363,6,3,210996,210996,210999,0,3,5
60364,4,2,211000,211000,211002,0,2,1
60365,3,3,211003,211003,211006,0,3,1
60366,1,2,211004,211006,211008,2,4,0
60367,6,1,211010,211010,211011,0,1,2
60368,4,1,211014,211014,211015,0,1,3
60369,5,1,211019,211019,211020,0,1,4
60370,3,2,211022,211022,211024,0,2,2
60371,1,3,211023,211024,211027,1,4,0
60372,3,3,211026,211027,211030,1,4,0
60373,4,3,211030,211030,211033,0,3,0
60374,5,2,211035,211035,211037,0,2,2
60375,3,1,211038,211038,211039,0,1,1
60376,3,2,211041,211041,211043,0,2,2
60377,4,2,211045,211045,211047,0,2,2
60378,6,3,211051,211051,211054,0,3,4
60379,5,3,211056,211056,211059,0,3,2
60380,4,2,211060,211060,211062,0,2,1
60381,4,1,211064,211064,211065,0,1,2
60382,5,3,211069,211069,211072,0,3,4
60383,1,2,211070,211072,211074,2,4,0
60384,1,2,211071,211074,211076,3,5,0
60385,5,2,211076,211076,211078,0,2,0
60386,2,1,211078,211078,211079,0,1,0
60387,5,1,211083,211083,211084,0,1,4
60388,4,1,211087,211087,211088,0,1,3
60389,3,3,211090,211090,211093,0,3,2
60390,4,3,211094,211094,211097,0,3,1
60391,2,3,211096,211097,211100,1,4,0
60392,1,1,211097,211100,211101,3,4,0
60393,2,2,211099,211101,211103,2,4,0
60394,3,1,211102,211103,211104,1,2,0
60395,6,3,211108,211108,211111,0,3,4
60396,1,3,211109,211111,211114,2,5,0
60397,1,3,211110,211114,211117,4,7,0
60398,6,2,211116,211117,211119,1,3,0
60399,3,2,211119,211119,211121,0,2,0
60400,3,1,211122,211122,211123,0,1,1
60401,6,2,211128,211128,211130,0,2,5
60402,1,1,211129,211130,211131,1,2,0
60403,1,3,211130,211131,211134,1,4,0
60404,4,1,211134,211134,211135,0,1,0
60405,5,2,211139,211139,211141,0,2,4
60406,4,2,211143,211143,211145,0,2,2
60407,5,2,211148,211148,211150,0,2,3
60408,6,1,211154,211154,211155,0,1,4
60409,4,3,211158,211158,211161,0,3,3
60410,3,3,211161,211161,211164,0,3,0
60411,1,1,211162,211164,211165,2,3,0
60412,1,2,211163,211165,211167,2,4,0
60413,2,1,211165,211167,211168,2,3,0
60414,5,3,211170,211170,211173,0,3,2
60415,2,3,211172,211173,211176,1,4,0
60416,4,1,211176,211176,211177,0,1,0
60417,3,2,211179,211179,211181,0,2,2
60418,3,1,211182,211182,211183,0,1,1
60419,4,2,211186,211186,211188,0,2,3
60420,3,1,211189,211189,211190,0,1,1
60421,5,3,211194,211194,211197,0,3,4
60422,5,2,211199,211199,211201,0,2,2
60423,4,3,211203,211203,211206,0,3,2
60424,4,2,211207,211207,211209,0,2,1
60425,4,1,211211,211211,211212,0,1,2
60426,3,1,211214,211214,211215,0,1,2
60427,2,1,211216,211216,211217,0,1,1
60428,6,1,211222,211222,211223,0,1,5
60429,3,3,211225,211225,211228,0,3,2
60430,3,3,211228,211228,211231,0,3,0
60431,5,1,211233,211233,211234,0,1,2
60432,6,2,211239,211239,211241,0,2,5
60433,4,3,211243,211243,211246,0,3,2
60434,3,1,211246,211246,211247,0,1,0
60435,2,3,211248,211248,211251,0,3,1
60436,2,1,211250,211251,211252,1,2,0
60437,5,1,211255,211255,211256,0,1,3
60438,4,1,211259,211259,211260,0,1,3
60439,3,3,211262,211262,211265,0,3,2
60440,4,1,211266,211266,211267,0,1,1
60441,1,2,211267,211267,211269,0,2,0
60442,3,2,211270,211270,211272,0,2,1
60443,6,1,211276,211276,211277,0,1,4
60444,3,2,211279,211279,211281,0,2,2
60445,2,3,211281,211281,211284,0,3,0
60446,3,3,211284,211284,211287,0,3,0
60447,2,2,211286,211287,211289,1,3,0
60448,2,1,211288,211289,211290,1,2,0
60449,5,1,211293,211293,211294,0,1,3
60450,2,2,211295,211295,211297,0,2,1
60451,1,1,211296,211297,211298,1,2,0
60452,2,2,211298,211298,211300,0,2,0
60453,6,3,211304,211304,211307,0,3,4
60454,3,2,211307,211307,211309,0,2,0
60455,1,1,211308,211309,211310,1,2,0
60456,3,2,211311,211311,211313,0,2,1
60457,3,3,211314,211314,211317,0,3,1
60458,2,3,211316,211317,211320,1,4,0
60459,1,2,211317,211320,211322,3,5,0
60460,2,1,211319,211322,211323,3,4,0
60461,3,2,211322,211323,211325,1,3,0
60462,3,3,211325,211325,211328,0,3,0
60463,5,2,211330,211330,211332,0,2,2
60464,4,1,211334,211334,211335,0,1,2
60465,2,3,211336,211336,211339,0,3,1
60466,6,2,211342,211342,211344,0,2,3
60467,5,3,211347,211347,211350,0,3,3
60468,4,3,211351,211351,211354,0,3,1
60469,4,1,211355,211355,211356,0,1,1
60470,5,1,211360,211360,211361,0,1,4
60471,4,2,211364,211364,211366,0,2,3
60472,2,3,211366,211366,211369,0,3,0
60473,4,3,211370,211370,211373,0,3,1
60474,5,3,211375,211375,211378,0,3,2
60475,4,2,211379,211379,211381,0,2,1
60476,3,3,211382,211382,211385,0,3,1
60477,4,3,211386,211386,211389,0,3,1
60478,4,3,211390,211390,211393,0,3,1
60479,6,2,211396,211396,211398,0,2,3
60480,4,3,211400,211400,211403,0,3,2
60481,2,1,211402,211403,211404,1,2,0
60482,1,1,211403,211404,211405,1,2,0
60483,6,3,211409,211409,211412,0,3,4
60484,6,1,211415,211415,211416,0,1,3
60485,5,2,211420,211420,211422,0,2,4
60486,6,2,211426,211426,211428,0,2,4
60487,1,2,211427,211428,211430,1,3,0
60488,5,2,211432,211432,211434,0,2,2
60489,6,1,211438,211438,211439,0,1,4
60490,3,2,211441,211441,211443,0,2,2
60491,3,2,211444,211444,211446,0,2,1
60492,1,2,211445,211446,211448,1,3,0
60493,5,2,211450,211450,211452,0,2,2
60494,2,1,211452,211452,211453,0,1,0
60495,5,2,211457,211457,211459,0,2,4
60496,1,2,211458,211459,211461,1,3,0
60497,1,1,211459,211461,211462,2,3,0
60498,2,2,211461,211462,211464,1,3,0
60499,5,1,211466,211466,211467,0,1,2
60500,2,2,211468,211468,211470,0,2,1
60501,3,2,211471,211471,211473,0,2,1
60502,6,3,211477,211477,211480,0,3,4
60503,2,3,211479,211480,211483,1,4,0
60504,5,1,211484,211484,211485,0,1,1
60505,4,2,211488,211488,211490,0,2,3
60506,5,3,211493,211493,211496,0,3,3
60507,5,3,211498,211498,211501,0,3,2
60508,3,3,211501,211501,211504,0,3,0
60509,1,2,211502,211504,211506,2,4,0
60510,1,1,211503,211506,211507,3,4,0
60511,1,2,211504,211507,211509,3,5,0
60512,3,2,211507,211509,211511,2,4,0
60513,3,1,211510,211511,211512,1,2,0
60514,6,2,211516,211516,211518,0,2,4
60515,5,3,211521,211521,211524,0,3,3
60516,3,2,211524,211524,211526,0,2,0
60517,3,2,211527,211527,211529,0,2,1
60518,2,2,211529,211529,211531,0,2,0
60519,6,3,211535,211535,211538,0,3,4
60520,5,2,211540,211540,211542,0,2,2
60521,5,1,211545,211545,211546,0,1,3
60522,2,3,211547,211547,211550,0,3,1
60523,1,3,211548,211550,211553,2,5,0
60524,2,2,211550,211553,211555,3,5,0
60525,5,2,211555,211555,211557,0,2,0
60526,5,1,211560,211560,211561,0,1,3
60527,3,2,211563,211563,211565,0,2,2
60528,6,1,211569,211569,211570,0,1,4
60529,1,2,211570,211570,211572,0,2,0
60530,3,1,211573,211573,211574,0,1,1
60531,4,1,211577,211577,211578,0,1,3
60532,5,2,211582,211582,211584,0,2,4
60533,6,3,211588,211588,211591,0,3,4
60534,2,1,211590,211591,211592,1,2,0
60535,3,2,211593,211593,211595,0,2,1
60536,2,3,211595,211595,211598,0,3,0
60537,4,1,211599,211599,211600,0,1,1
60538,5,2,211604,211604,211606,0,2,4
60539,3,3,211607,211607,211610,0,3,1
60540,1,1,211608,211610,211611,2,3,0
60541,2,1,211610,211611,211612,1,2,0
60542,5,2,211615,211615,211617,0,2,3
60543,1,3,211616,211617,211620,1,4,0
60544,2,2,211618,211620,211622,2,4,0
60545,6,2,211624,211624,211626,0,2,2
60546,5,2,211629,211629,211631,0,2,3
60547,2,3,211631,211631,211634,0,3,0
60548,2,2,211633,211634,211636,1,3,0
60549,6,3,211639,211639,211642,0,3,3
60550,2,3,211641,211642,211645,1,4,0
60551,3,2,211644,211645,211647,1,3,0
60552,2,3,211646,211647,211650,1,4,0
60553,2,1,211648,211650,211651,2,3,0
60554,3,1,211651,211651,211652,0,1,0
60555,1,1,211652,211652,211653,0,1,0
60556,2,3,211654,211654,211657,0,3,1
60557,1,2,211655,211657,211659,2,4,0
60558,1,3,211656,211659,211662,3,6,0
60559,6,2,211662,211662,211664,0,2,0
60560,2,1,211664,211664,211665,0,1,0
60561,4,2,211668,211668,211670,0,2,3
60562,6,2,211674,211674,211676,0,2,4
60563,1,3,211675,211676,211679,1,4,0
60564,6,1,211681,211681,211682,0,1,2
60565,4,3,211685,211685,211688,0,3,3
60566,1,1,211686,211688,211689,2,3,0
60567,2,1,211688,211689,211690,1,2,0
60568,5,1,211693,211693,211694,0,1,3
60569,1,1,211694,211694,211695,0,1,0
60570,4,3,211698,211698,211701,0,3,3
60571,4,1,211702,211702,211703,0,1,1
60572,1,3,211703,211703,211706,0,3,0
60573,6,2,211709,211709,211711,0,2,3
60574,1,2,211710,211711,211713,1,3,0
60575,6,1,211716,211716,211717,0,1,3
60576,6,2,211722,211722,211724,0,2,5
60577,2,3,211724,211724,211727,0,3,0
60578,3,2,211727,211727,211729,0,2,0
60579,6,3,211733,211733,211736,0,3,4
60580,6,3,211739,211739,211742,0,3,3
60581,1,1,211740,211742,211743,2,3,0
60582,1,1,211741,211743,211744,2,3,0
60583,2,3,211743,211744,211747,1,4,0
60584,1,3,211744,211747,211750,3,6,0
60585,5,3,211749,211750,211753,1,4,0
60586,4,1,211753,211753,211754,0,1,0
60587,2,3,211755,211755,211758,0,3,1
60588,2,1,211757,211758,211759,1,2,0
60589,4,2,211761,211761,211763,0,2,2
60590,6,1,211767,211767,211768,0,1,4
60591,4,1,211771,211771,211772,0,1,3
60592,1,2,211772,211772,211774,0,2,0
60593,6,1,211778,211778,211779,0,1,4
60594,2,1,211780,211780,211781,0,1,1
60595,1,1,211781,211781,211782,0,1,0
60596,4,3,211785,211785,211788,0,3,3
60597,5,3,211790,211790,211793,0,3,2
60598,4,3,211794,211794,211797,0,3,1
60599,6,3,211800,211800,211803,0,3,3
60600,2,1,211802,211803,211804,1,2,0
60601,1,1,211803,211804,211805,1,2,0
60602,3,2,211806,211806,211808,0,2,1
60603,1,3,211807,211808,211811,1,4,0
60604,1,3,211808,211811,211814,3,6,0
60605,1,1,211809,211814,211815,5,6,0
60606,3,3,211812,211815,211818,3,6,0
60607,4,1,211816,211818,211819,2,3,0
60608,4,2,211820,211820,211822,0,2,1
60609,1,3,211821,211822,211825,1,4,0
60610,5,2,211826,211826,211828,0,2,1
60611,1,2,211827,211828,211830,1,3,0
60612,2,2,211829,211830,211832,1,3,0
60613,3,2,211832,211832,211834,0,2,0
60614,2,2,211834,211834,211836,0,2,0
60615,2,3,211836,211836,211839,0,3,0
60616,5,3,211841,211841,211844,0,3,2
60617,1,3,211842,211844,211847,2,5,0
60618,3,2,211845,211847,211849,2,4,0
60619,1,1,211846,211849,211850,3,4,0
60620,2,1,211848,211850,211851,2,3,0
60621,5,3,211853,211853,211856,0,3,2
60622,4,1,211857,211857,211858,0,1,1
60623,6,3,211863,211863,211866,0,3,5
60624,1,1,211864,211866,211867,2,3,0
60625,1,2,211865,211867,211869,2,4,0
60626,3,3,211868,211869,211872,1,4,0
60627,6,1,211874,211874,211875,0,1,2
60628,1,1,211875,211875,211876,0,1,0
60629,4,2,211879,211879,211881,0,2,3
60630,5,3,211884,211884,211887,0,3,3
60631,2,2,211886,211887,211889,1,3,0
60632,1,3,211887,211889,211892,2,5,0
60633,5,1,211892,211892,211893,0,1,0
60634,3,1,211895,211895,211896,0,1,2
60635,2,3,211897,211897,211900,0,3,1
60636,3,3,211900,211900,211903,0,3,0
60637,6,1,211906,211906,211907,0,1,3
60638,4,1,211910,211910,211911,0,1,3
60639,6,2,211916,211916,211918,0,2,5
60640,5,1,211921,211921,211922,0,1,3
60641,5,1,211926,211926,211927,0,1,4
60642,4,2,211930,211930,211932,0,2,3
60643,6,1,211936,211936,211937,0,1,4
60644,6,2,211942,211942,211944,0,2,5
60645,6,3,211948,211948,211951,0,3,4
60646,4,2,211952,211952,211954,0,2,1
60647,1,2,211953,211954,211956,1,3,0
60648,5,3,211958,211958,211961,0,3,2
60649,6,1,211964,211964,211965,0,1,3
60650,1,1,211965,211965,211966,0,1,0
60651,1,3,211966,211966,211969,0,3,0
60652,3,3,211969,211969,211972,0,3,0
60653,4,3,211973,211973,211976,0,3,1
60654,3,3,211976,211976,211979,0,3,0
60655,6,3,211982,211982,211985,0,3,3
60656,4,2,211986,211986,211988,0,2,1
60657,4,2,211990,211990,211992,0,2,2
60658,1,1,211991,211992,211993,1,2,0
60659,5,2,211996,211996,211998,0,2,3
60660,1,3,211997,211998,212001,1,4,0
60661,2,3,211999,212001,212004,2,5,0
60662,3,3,212002,212004,212007,2,5,0
60663,1,3,212003,212007,212010,4,7,0
60664,4,1,212007,212010,212011,3,4,0
60665,1,1,212008,212011,212012,3,4,0
60666,3,1,212011,212012,212013,1,2,0
60667,2,2,212013,212013,212015,0,2,0
60668,3,3,212016,212016,212019,0,3,1
60669,4,3,212020,212020,212023,0,3,1
60670,1,3,212021,212023,212026,2,5,0
60671,1,1,212022,212026,212027,4,5,0
60672,1,2,212023,212027,212029,4,6,0
60673,5,2,212028,212029,212031,1,3,0
60674,5,1,212033,212033,212034,0,1,2
60675,5,3,212038,212038,212041,0,3,4
60676,4,3,212042,212042,212045,0,3,1
60677,1,2,212043,212045,212047,2,4,0
60678,4,1,212047,212047,212048,0,1,0
60679,4,3,212051,212051,212054,0,3,3
60680,6,1,212057,212057,212058,0,1,3
60681,3,1,212060,212060,212061,0,1,2
60682,5,3,212065,212065,212068,0,3,4
60683,5,2,212070,212070,212072,0,2,2
60684,3,2,212073,212073,212075,0,2,1
60685,4,2,212077,212077,212079,0,2,2
60686,1,1,212078,212079,212080,1,2,0
60687,4,1,212082,212082,212083,0,1,2
60688,2,3,212084,212084,212087,0,3,1
60689,6,2,212090,212090,212092,0,2,3
60690,1,1,212091,212092,212093,1,2,0
60691,1,1,212092,212093,212094,1,2,0
60692,6,3,212098,212098,212101,0,3,4
60693,1,3,212099,212101,212104,2,5,0
60694,6,2,212105,212105,212107,0,2,1
60695,2,2,212107,212107,212109,0,2,0
60696,4,2,212111,212111,212113,0,2,2
60697,3,3,212114,212114,212117,0,3,1
60698,6,1,212120,212120,212121,0,1,3
60699,2,1,212122,212122,212123,0,1,1
60700,4,3,212126,212126,212129,0,3,3
60701,4,2,212130,212130,212132,0,2,1
60702,5,1,212135,212135,212136,0,1,3
60703,4,1,212139,212139,212140,0,1,3
60704,5,2,212144,212144,212146,0,2,4
60705,4,3,212148,212148,212151,0,3,2
60706,3,2,212151,212151,212153,0,2,0
60707,1,3,212152,212153,212156,1,4,0
60708,1,2,212153,212156,212158,3,5,0
60709,1,3,212154,212158,212161,4,7,0
60710,2,1,212156,212161,212162,5,6,0
60711,3,1,212159,212162,212163,3,4,0
60712,3,2,212162,212163,212165,1,3,0
60713,2,3,212164,212165,212168,1,4,0
60714,5,1,212169,212169,212170,0,1,1
60715,1,1,212170,212170,212171,0,1,0
60716,6,1,212176,212176,212177,0,1,5
60717,2,2,212178,212178,212180,0,2,1
60718,1,1,212179,212180,212181,1,2,0
60719,6,2,212185,212185,212187,0,2,4
60720,6,3,212191,212191,212194,0,3,4
60721,4,2,212195,212195,212197,0,2,1
60722,6,1,212201,212201,212202,0,1,4
60723,2,3,212203,212203,212206,0,3,1
60724,6,1,212209,212209,212210,0,1,3
60725,2,3,212211,212211,212214,0,3,1
60726,3,3,212214,212214,212217,0,3,0
60727,6,1,212220,212220,212221,0,1,3
60728,4,2,212224,212224,212226,0,2,3
60729,1,1,212225,212226,212227,1,2,0
60730,4,2,212229,212229,212231,0,2,2
60731,2,1,212231,212231,212232,0,1,0
60732,4,3,212235,212235,212238,0,3,3
60733,5,3,212240,212240,212243,0,3,2
60734,6,1,212246,212246,212247,0,1,3
60735,6,2,212252,212252,212254,0,2,5
60736,1,1,212253,212254,212255,1,2,0
60737,1,3,212254,212255,212258,1,4,0
60738,4,3,212258,212258,212261,0,3,0
60739,1,3,212259,212261,212264,2,5,0
60740,2,2,212261,212264,212266,3,5,0
60741,2,2,212263,212266,212268,3,5,0
60742,2,3,212265,212268,212271,3,6,0
60743,3,3,212268,212271,212274,3,6,0
60744,1,1,212269,212274,212275,5,6,0
60745,6,3,212275,212275,212278,0,3,0
60746,4,2,212279,212279,212281,0,2,1
60747,1,3,212280,212281,212284,1,4,0
60748,6,3,212286,212286,212289,0,3,2
60749,5,2,212291,212291,212293,0,2,2
60750,3,3,212294,212294,212297,0,3,1
60751,4,1,212298,212298,212299,0,1,1
60752,1,2,212299,212299,212301,0,2,0
60753,1,1,212300,212301,212302,1,2,0
60754,4,3,212304,212304,212307,0,3,2
60755,4,3,212308,212308,212311,0,3,1
60756,3,2,212311,212311,212313,0,2,0
60757,4,1,212315,212315,212316,0,1,2
60758,3,3,212318,212318,212321,0,3,2
60759,2,2,212320,212321,212323,1,3,0
60760,1,1,212321,212323,212324,2,3,0
60761,5,2,212326,212326,212328,0,2,2
60762,5,1,212331,212331,212332,0,1,3
60763,5,2,212336,212336,212338,0,2,4
60764,3,1,212339,212339,212340,0,1,1
60765,4,3,212343,212343,212346,0,3,3
60766,1,3,212344,212346,212349,2,5,0
60767,3,1,212347,212349,212350,2,3,0
60768,5,3,212352,212352,212355,0,3,2
60769,5,2,212357,212357,212359,0,2,2
60770,3,2,212360,212360,212362,0,2,1
60771,2,1,212362,212362,212363,0,1,0
60772,3,1,212365,212365,212366,0,1,2
60773,4,1,212369,212369,212370,0,1,3
60774,5,1,212374,212374,212375,0,1,4
60775,3,1,212377,212377,212378,0,1,2
60776,3,3,212380,212380,212383,0,3,2
60777,6,3,212386,212386,212389,0,3,3
60778,5,3,212391,212391,212394,0,3,2
60779,2,1,212393,212394,212395,1,2,0
60780,3,3,212396,212396,212399,0,3,1
60781,3,1,212399,212399,212400,0,1,0
60782,3,1,212402,212402,212403,0,1,2
60783,2,1,212404,212404,212405,0,1,1
60784,6,3,212410,212410,212413,0,3,5
60785,6,1,212416,212416,212417,0,1,3
60786,5,2,212421,212421,212423,0,2,4
60787,1,2,212422,212423,212425,1,3,0
60788,1,3,212423,212425,212428,2,5,0
60789,6,1,212429,212429,212430,0,1,1
60790,4,3,212433,212433,212436,0,3,3
60791,2,2,212435,212436,212438,1,3,0
60792,3,3,212438,212438,212441,0,3,0
60793,2,3,212440,212441,212444,1,4,0
60794,2,2,212442,212444,212446,2,4,0
60795,4,1,212446,212446,212447,0,1,0
60796,4,1,212450,212450,212451,0,1,3
60797,5,3,212455,212455,212458,0,3,4
60798,5,2,212460,212460,212462,0,2,2
60799,2,2,212462,212462,212464,0,2,0
60800,6,3,212468,212468,212471,0,3,4
60801,5,3,212473,212473,212476,0,3,2
60802,3,2,212476,212476,212478,0,2,0
60803,5,2,212481,212481,212483,0,2,3
60804,5,2,212486,212486,212488,0,2,3
60805,4,3,212490,212490,212493,0,3,2
60806,4,1,212494,212494,212495,0,1,1
60807,1,1,212495,212495,212496,0,1,0
60808,5,1,212500,212500,212501,0,1,4
60809,2,2,212502,212502,212504,0,2,1
60810,5,3,212507,212507,212510,0,3,3
60811,3,1,212510,212510,212511,0,1,0
60812,5,1,212515,212515,212516,0,1,4
60813,3,3,212518,212518,212521,0,3,2
60814,6,1,212524,212524,212525,0,1,3
60815,6,3,212530,212530,212533,0,3,5
60816,5,3,212535,212535,212538,0,3,2
60817,3,1,212538,212538,212539,0,1,0
60818,1,3,212539,212539,212542,0,3,0
60819,6,3,212545,212545,212548,0,3,3
60820,1,3,212546,212548,212551,2,5,0
60821,3,2,212549,212551,212553,2,4,0
60822,3,2,212552,212553,212555,1,3,0
60823,2,3,212554,212555,212558,1,4,0
60824,2,1,212556,212558,212559,2,3,0
60825,2,1,212558,212559,212560,1,2,0
60826,6,3,212564,212564,212567,0,3,4
60827,5,2,212569,212569,212571,0,2,2
60828,1,1,212570,212571,212572,1,2,0
60829,1,2,212571,212572,212574,1,3,0
60830,6,2,212577,212577,212579,0,2,3
60831,6,2,212583,212583,212585,0,2,4
60832,3,2,212586,212586,212588,0,2,1
60833,4,2,212590,212590,212592,0,2,2
60834,1,2,212591,212592,212594,1,3,0
60835,5,2,212596,212596,212598,0,2,2
60836,2,2,212598,212598,212600,0,2,0
60837,2,1,212600,212600,212601,0,1,0
60838,5,2,212605,212605,212607,0,2,4
60839,3,2,212608,212608,212610,0,2,1
60840,4,1,212612,212612,212613,0,1,2
60841,3,1,212615,212615,212616,0,1,2
60842,4,3,212619,212619,212622,0,3,3
60843,3,2,212622,212622,212624,0,2,0
60844,3,2,212625,212625,212627,0,2,1
60845,1,1,212626,212627,212628,1,2,0
60846,3,3,212629,212629,212632,0,3,1
60847,4,3,212633,212633,212636,0,3,1
60848,3,2,212636,212636,212638,0,2,0
60849,3,1,212639,212639,212640,0,1,1
60850,6,1,212645,212645,212646,0,1,5
60851,1,1,212646,212646,212647,0,1,0
60852,2,1,212648,212648,212649,0,1,1
60853,6,1,212654,212654,212655,0,1,5
60854,2,2,212656,212656,212658,0,2,1
60855,3,3,212659,212659,212662,0,3,1
60856,3,3,212662,212662,212665,0,3,0
60857,2,3,212664,212665,212668,1,4,0
60858,2,3,212666,212668,212671,2,5,0
60859,2,2,212668,212671,212673,3,5,0
60860,4,2,212672,212673,212675,1,3,0
60861,1,2,212673,212675,212677,2,4,0
60862,3,1,212676,212677,212678,1,2,0
60863,4,3,212680,212680,212683,0,3,2
60864,2,2,212682,212683,212685,1,3,0
60865,5,1,212687,212687,212688,0,1,2
60866,2,3,212689,212689,212692,0,3,1
60867,5,3,212694,212694,212697,0,3,2
60868,4,3,212698,212698,212701,0,3,1
60869,1,3,212699,212701,212704,2,5,0
60870,5,2,212704,212704,212706,0,2,0
60871,3,3,212707,212707,212710,0,3,1
60872,1,1,212708,212710,212711,2,3,0
60873,4,3,212712,212712,212715,0,3,1
60874,4,2,212716,212716,212718,0,2,1
60875,3,2,212719,212719,212721,0,2,1
60876,6,2,212725,212725,212727,0,2,4
60877,4,2,212729,212729,212731,0,2,2
60878,2,2,212731,212731,212733,0,2,0
60879,2,1,212733,212733,212734,0,1,0
60880,6,1,212739,212739,212740,0,1,5
60881,2,1,212741,212741,212742,0,1,1
60882,6,2,212747,212747,212749,0,2,5
60883,3,2,212750,212750,212752,0,2,1
60884,6,3,212756,212756,212759,0,3,4
60885,3,3,212759,212759,212762,0,3,0
60886,6,3,212765,212765,212768,0,3,3
60887,5,3,212770,212770,212773,0,3,2
60888,3,2,212773,212773,212775,0,2,0
60889,1,1,212774,212775,212776,1,2,0
60890,5,3,212779,212779,212782,0,3,3
60891,3,3,212782,212782,212785,0,3,0
60892,3,3,212785,212785,212788,0,3,0
60893,3,2,212788,212788,212790,0,2,0
60894,2,3,212790,212790,212793,0,3,0
60895,4,3,212794,212794,212797,0,3,1
60896,6,3,212800,212800,212803,0,3,3
60897,4,2,212804,212804,212806,0,2,1
60898,4,3,212808,212808,212811,0,3,2
60899,4,1,212812,212812,212813,0,1,1
60900,4,1,212816,212816,212817,0,1,3
60901,4,3,212820,212820,212823,0,3,3
60902,6,1,212826,212826,212827,0,1,3
60903,1,3,212827,212827,212830,0,3,0
60904,2,2,212829,212830,212832,1,3,0
60905,5,1,212834,212834,212835,0,1,2
60906,4,1,212838,212838,212839,0,1,3
60907,6,1,212844,212844,212845,0,1,5
60908,1,3,212845,212845,212848,0,3,0
60909,5,3,212850,212850,212853,0,3,2
60910,2,2,212852,212853,212855,1,3,0
60911,3,3,212855,212855,212858,0,3,0
60912,1,3,212856,212858,212861,2,5,0
60913,2,3,212858,212861,212864,3,6,0
60914,6,2,212864,212864,212866,0,2,0
60915,1,1,212865,212866,212867,1,2,0
60916,2,1,212867,212867,212868,0,1,0
60917,5,3,212872,212872,212875,0,3,4
60918,4,3,212876,212876,212879,0,3,1
60919,6,3,212882,212882,212885,0,3,3
60920,2,1,212884,212885,212886,1,2,0
60921,2,3,212886,212886,212889,0,3,0
60922,6,1,212892,212892,212893,0,1,3
60923,3,3,212895,212895,212898,0,3,2
60924,3,3,212898,212898,212901,0,3,0
60925,5,2,212903,212903,212905,0,2,2
60926,5,3,212908,212908,212911,0,3,3
60927,3,1,212911,212911,212912,0,1,0
60928,6,3,212917,212917,212920,0,3,5
60929,1,1,212918,212920,212921,2,3,0
60930,5,2,212923,212923,212925,0,2,2
60931,5,1,212928,212928,212929,0,1,3
60932,4,2,212932,212932,212934,0,2,3
60933,1,2,212933,212934,212936,1,3,0
60934,6,1,212939,212939,212940,0,1,3
60935,6,2,212945,212945,212947,0,2,5
60936,4,1,212949,212949,212950,0,1,2
60937,1,3,212950,212950,212953,0,3,0
60938,4,1,212954,212954,212955,0,1,1
60939,4,3,212958,212958,212961,0,3,3
60940,4,3,212962,212962,212965,0,3,1
60941,6,2,212968,212968,212970,0,2,3
60942,1,2,212969,212970,212972,1,3,0
60943,6,1,212975,212975,212976,0,1,3
60944,6,1,212981,212981,212982,0,1,5
60945,2,2,212983,212983,212985,0,2,1
60946,2,1,212985,212985,212986,0,1,0
60947,5,1,212990,212990,212991,0,1,4
60948,5,2,212995,212995,212997,0,2,4
60949,3,2,212998,212998,213000,0,2,1
60950,6,2,213004,213004,213006,0,2,4
60951,6,3,213010,213010,213013,0,3,4
60952,4,3,213014,213014,213017,0,3,1
60953,6,1,213020,213020,213021,0,1,3
60954,2,2,213022,213022,213024,0,2,1
60955,6,2,213028,213028,213030,0,2,4
60956,3,3,213031,213031,213034,0,3,1
60957,3,1,213034,213034,213035,0,1,0
60958,4,3,213038,213038,213041,0,3,3
60959,5,3,213043,213043,213046,0,3,2
60960,5,3,213048,213048,213051,0,3,2
60961,2,2,213050,213051,213053,1,3,0
60962,3,2,213053,213053,213055,0,2,0
60963,4,2,213057,213057,213059,0,2,2
60964,1,2,213058,213059,213061,1,3,0
60965,4,1,213062,213062,213063,0,1,1
60966,1,3,213063,213063,213066,0,3,0
60967,6,1,213069,213069,213070,0,1,3
60968,2,3,213071,213071,213074,0,3,1
60969,2,1,213073,213074,213075,1,2,0
60970,4,1,213077,213077,213078,0,1,2
60971,2,1,213079,213079,213080,0,1,1
60972,4,1,213083,213083,213084,0,1,3
60973,4,2,213087,213087,213089,0,2,3
60974,5,1,213092,213092,213093,0,1,3
60975,1,2,213093,213093,213095,0,2,0
60976,5,2,213098,213098,213100,0,2,3
60977,6,2,213104,213104,213106,0,2,4
60978,1,2,213105,213106,213108,1,3,0
60979,4,2,213109,213109,213111,0,2,1
60980,2,1,213111,213111,213112,0,1,0
60981,1,3,213112,213112,213115,0,3,0
60982,5,3,213117,213117,213120,0,3,2
60983,5,1,213122,213122,213123,0,1,2
60984,5,3,213127,213127,213130,0,3,4
60985,4,3,213131,213131,213134,0,3,1
60986,2,1,213133,213134,213135,1,2,0
60987,2,2,213135,213135,213137,0,2,0
60988,5,1,213140,213140,213141,0,1,3
60989,5,2,213145,213145,213147,0,2,4
60990,1,3,213146,213147,213150,1,4,0
60991,3,2,213149,213150,213152,1,3,0
60992,4,2,213153,213153,213155,0,2,1
60993,4,1,213157,213157,213158,0,1,2
60994,1,3,213158,213158,213161,0,3,0
60995,1,2,213159,213161,213163,2,4,0
60996,6,1,213165,213165,213166,0,1,2
60997,5,3,213170,213170,213173,0,3,4
60998,6,2,213176,213176,213178,0,2,3
60999,1,1,213177,213178,213179,1,2,0
61000,4,2,213181,213181,213183,0,2,2
61001,2,1,213183,213183,213184,0,1,0
61002,2,2,213185,213185,213187,0,2,1
61003,1,3,213186,213187,213190,1,4,0
61004,2,2,213188,213190,213192,2,4,0
61005,4,3,213192,213192,213195,0,3,0
61006,3,3,213195,213195,213198,0,3,0
61007,6,2,213201,213201,213203,0,2,3
61008,6,2,213207,213207,213209,0,2,4
61009,6,1,213213,213213,213214,0,1,4
61010,2,3,213215,213215,213218,0,3,1
61011,5,2,213220,213220,213222,0,2,2
61012,3,1,213223,213223,213224,0,1,1
61013,2,3,213225,213225,213228,0,3,1
61014,3,3,213228,213228,213231,0,3,0
61015,6,1,213234,213234,213235,0,1,3
61016,2,3,213236,213236,213239,0,3,1
61017,2,2,213238,213239,213241,1,3,0
61018,2,1,213240,213241,213242,1,2,0
61019,2,1,213242,213242,213243,0,1,0
61020,5,1,213247,213247,213248,0,1,4
61021,2,1,213249,213249,213250,0,1,1
61022,1,2,213250,213250,213252,0,2,0
61023,2,1,213252,213252,213253,0,1,0
61024,6,1,213258,213258,213259,0,1,5
61025,6,3,213264,213264,213267,0,3,5
61026,2,1,213266,213267,213268,1,2,0
61027,4,3,213270,213270,213273,0,3,2
61028,5,1,213275,213275,213276,0,1,2
61029,1,3,213276,213276,213279,0,3,0
61030,5,1,213281,213281,213282,0,1,2
61031,3,1,213284,213284,213285,0,1,2
61032,4,2,213288,213288,213290,0,2,3
61033,6,1,213294,213294,213295,0,1,4
61034,1,3,213295,213295,213298,0,3,0
61035,4,1,213299,213299,213300,0,1,1
61036,5,2,213304,213304,213306,0,2,4
61037,2,3,213306,213306,213309,0,3,0
61038,4,3,213310,213310,213313,0,3,1
61039,1,2,213311,213313,213315,2,4,0
61040,3,2,213314,213315,213317,1,3,0
61041,3,3,213317,213317,213320,0,3,0
61042,5,3,213322,213322,213325,0,3,2
61043,4,3,213326,213326,213329,0,3,1
61044,4,3,213330,213330,213333,0,3,1
61045,5,1,213335,213335,213336,0,1,2
61046,6,3,213341,213341,213344,0,3,5
61047,3,2,213344,213344,213346,0,2,0
61048,2,3,213346,213346,213349,0,3,0
61049,3,2,213349,213349,213351,0,2,0
61050,4,1,213353,213353,213354,0,1,2
61051,6,3,213359,213359,213362,0,3,5
61052,2,1,213361,213362,213363,1,2,0
61053,4,1,213365,213365,213366,0,1,2
61054,4,3,213369,213369,213372,0,3,3
61055,3,3,213372,213372,213375,0,3,0
61056,3,3,213375,213375,213378,0,3,0
61057,2,1,213377,213378,213379,1,2,0
61058,4,2,213381,213381,213383,0,2,2
61059,6,2,213387,213387,213389,0,2,4
61060,2,3,213389,213389,213392,0,3,0
61061,6,3,213395,213395,213398,0,3,3
61062,1,1,213396,213398,213399,2,3,0
61063,2,2,213398,213399,213401,1,3,0
61064,6,3,213404,213404,213407,0,3,3
61065,5,2,213409,213409,213411,0,2,2
61066,1,3,213410,213411,213414,1,4,0
61067,1,3,213411,213414,213417,3,6,0
61068,6,3,213417,213417,213420,0,3,0
61069,5,1,213422,213422,213423,0,1,2
61070,6,1,213428,213428,213429,0,1,5
61071,1,2,213429,213429,213431,0,2,0
61072,5,1,213434,213434,213435,0,1,3
61073,1,2,213435,213435,213437,0,2,0
61074,3,3,213438,213438,213441,0,3,1
61075,1,2,213439,213441,213443,2,4,0
61076,5,2,213444,213444,213446,0,2,1
61077,2,2,213446,213446,213448,0,2,0
61078,1,1,213447,213448,213449,1,2,0
61079,3,3,213450,213450,213453,0,3,1
61080,2,1,213452,213453,213454,1,2,0
61081,3,1,213455,213455,213456,0,1,1
61082,3,2,213458,213458,213460,0,2,2
61083,6,1,213464,213464,213465,0,1,4
61084,5,1,213469,213469,213470,0,1,4
61085,1,1,213470,213470,213471,0,1,0
61086,5,3,213475,213475,213478,0,3,4
61087,1,1,213476,213478,213479,2,3,0
61088,3,2,213479,213479,213481,0,2,0
61089,2,3,213481,213481,213484,0,3,0
61090,4,1,213485,213485,213486,0,1,1
61091,5,1,213490,213490,213491,0,1,4
61092,1,1,213491,213491,213492,0,1,0
61093,3,1,213494,213494,213495,0,1,2
61094,2,1,213496,213496,213497,0,1,1
61095,3,1,213499,213499,213500,0,1,2
61096,3,3,213502,213502,213505,0,3,2
61097,6,2,213508,213508,213510,0,2,3
61098,6,1,213514,213514,213515,0,1,4
61099,1,2,213515,213515,213517,0,2,0
61100,1,1,213516,213517,213518,1,2,0
61101,3,3,213519,213519,213522,0,3,1
61102,5,3,213524,213524,213527,0,3,2
61103,3,3,213527,213527,213530,0,3,0
61104,4,3,213531,213531,213534,0,3,1
61105,3,1,213534,213534,213535,0,1,0
61106,1,1,213535,213535,213536,0,1,0
61107,6,2,213541,213541,213543,0,2,5
61108,3,2,213544,213544,213546,0,2,1
61109,1,2,213545,213546,213548,1,3,0
61110,6,3,213551,213551,213554,0,3,3
61111,6,2,213557,213557,213559,0,2,3
61112,3,3,213560,213560,213563,0,3,1
61113,5,3,213565,213565,213568,0,3,2
61114,4,3,213569,213569,213572,0,3,1
61115,5,3,213574,213574,213577,0,3,2
61116,6,3,213580,213580,213583,0,3,3
61117,6,2,213586,213586,213588,0,2,3
61118,4,1,213590,213590,213591,0,1,2
61119,5,2,213595,213595,213597,0,2,4
61120,4,1,213599,213599,213600,0,1,2
61121,4,2,213603,213603,213605,0,2,3
61122,2,2,213605,213605,213607,0,2,0
61123,5,3,213610,213610,213613,0,3,3
61124,1,1,213611,213613,213614,2,3,0
61125,3,2,213614,213614,213616,0,2,0
61126,6,3,213620,213620,213623,0,3,4
61127,3,1,213623,213623,213624,0,1,0
61128,3,3,213626,213626,213629,0,3,2
61129,5,1,213631,213631,213632,0,1,2
61130,1,1,213632,213632,213633,0,1,0
61131,1,2,213633,213633,213635,0,2,0
61132,1,2,213634,213635,213637,1,3,0
61133,2,2,213636,213637,213639,1,3,0
61134,2,3,213638,213639,213642,1,4,0
61135,5,3,213643,213643,213646,0,3,1
61136,2,1,213645,213646,213647,1,2,0
61137,2,3,213647,213647,213650,0,3,0
61138,5,1,213652,213652,213653,0,1,2
61139,3,2,213655,213655,213657,0,2,2
61140,2,1,213657,213657,213658,0,1,0
61141,6,3,213663,213663,213666,0,3,5
61142,4,1,213667,213667,213668,0,1,1
61143,6,2,213673,213673,213675,0,2,5
61144,5,2,213678,213678,213680,0,2,3
61145,3,1,213681,213681,213682,0,1,1
61146,4,1,213685,213685,213686,0,1,3
61147,5,1,213690,213690,213691,0,1,4
61148,5,2,213695,213695,213697,0,2,4
61149,2,2,213697,213697,213699,0,2,0
61150,4,2,213701,213701,213703,0,2,2
61151,6,2,213707,213707,213709,0,2,4
61152,1,3,213708,213709,213712,1,4,0
61153,1,3,213709,213712,213715,3,6,0
61154,3,3,213712,213715,213718,3,6,0
61155,3,2,213715,213718,213720,3,5,0
61156,6,3,213721,213721,213724,0,3,1
61157,2,1,213723,213724,213725,1,2,0
61158,1,1,213724,213725,213726,1,2,0
61159,5,2,213729,213729,213731,0,2,3
61160,6,3,213735,213735,213738,0,3,4
61161,4,3,213739,213739,213742,0,3,1
61162,4,3,213743,213743,213746,0,3,1
61163,3,3,213746,213746,213749,0,3,0
61164,5,2,213751,213751,213753,0,2,2
61165,6,2,213757,213757,213759,0,2,4
61166,3,3,213760,213760,213763,0,3,1
61167,5,1,213765,213765,213766,0,1,2
61168,5,1,213770,213770,213771,0,1,4
61169,5,1,213775,213775,213776,0,1,4
61170,5,1,213780,213780,213781,0,1,4
61171,3,1,213783,213783,213784,0,1,2
61172,4,1,213787,213787,213788,0,1,3
61173,2,3,213789,213789,213792,0,3,1
61174,4,1,213793,213793,213794,0,1,1
61175,1,2,213794,213794,213796,0,2,0
61176,5,2,213799,213799,213801,0,2,3
61177,1,2,213800,213801,213803,1,3,0
61178,2,2,213802,213803,213805,1,3,0
61179,2,2,213804,213805,213807,1,3,0
61180,5,3,213809,213809,213812,0,3,2
61181,1,3,213810,213812,213815,2,5,0
61182,3,3,213813,213815,213818,2,5,0
61183,4,1,213817,213818,213819,1,2,0
61184,5,3,213822,213822,213825,0,3,3
61185,6,2,213828,213828,213830,0,2,3
61186,6,1,213834,213834,213835,0,1,4
61187,2,3,213836,213836,213839,0,3,1
61188,3,1,213839,213839,213840,0,1,0
61189,5,2,213844,213844,213846,0,2,4
61190,6,2,213850,213850,213852,0,2,4
61191,3,1,213853,213853,213854,0,1,1
61192,6,2,213859,213859,213861,0,2,5
61193,6,3,213865,213865,213868,0,3,4
61194,3,2,213868,213868,213870,0,2,0
61195,4,2,213872,213872,213874,0,2,2
61196,6,3,213878,213878,213881,0,3,4
61197,6,3,213884,213884,213887,0,3,3
61198,6,2,213890,213890,213892,0,2,3
61199,5,1,213895,213895,213896,0,1,3
61200,3,2,213898,213898,213900,0,2,2
61201,4,3,213902,213902,213905,0,3,2
61202,6,3,213908,213908,213911,0,3,3
61203,5,1,213913,213913,213914,0,1,2
61204,2,1,213915,213915,213916,0,1,1
61205,1,3,213916,213916,213919,0,3,0
61206,6,2,213922,213922,213924,0,2,3
61207,2,2,213924,213924,213926,0,2,0
61208,3,3,213927,213927,213930,0,3,1
61209,3,1,213930,213930,213931,0,1,0
61210,1,3,213931,213931,213934,0,3,0
61211,1,3,213932,213934,213937,2,5,0
61212,5,1,213937,213937,213938,0,1,0
61213,2,2,213939,213939,213941,0,2,1
61214,1,1,213940,213941,213942,1,2,0
61215,5,2,213945,213945,213947,0,2,3
61216,3,3,213948,213948,213951,0,3,1
61217,4,1,213952,213952,213953,0,1,1
61218,4,2,213956,213956,213958,0,2,3
61219,1,3,213957,213958,213961,1,4,0
61220,4,2,213961,213961,213963,0,2,0
61221,6,1,213967,213967,213968,0,1,4
61222,4,1,213971,213971,213972,0,1,3
61223,1,2,213972,213972,213974,0,2,0
61224,5,1,213977,213977,213978,0,1,3
61225,4,2,213981,213981,213983,0,2,3
61226,5,1,213986,213986,213987,0,1,3
61227,6,2,213992,213992,213994,0,2,5
61228,2,2,213994,213994,213996,0,2,0
61229,4,3,213998,213998,214001,0,3,2
61230,5,1,214003,214003,214004,0,1,2
61231,3,1,214006,214006,214007,0,1,2
61232,3,2,214009,214009,214011,0,2,2
61233,3,3,214012,214012,214015,0,3,1
61234,3,2,214015,214015,214017,0,2,0
61235,1,1,214016,214017,214018,1,2,0
61236,2,1,214018,214018,214019,0,1,0
61237,1,3,214019,214019,214022,0,3,0
61238,6,1,214025,214025,214026,0,1,3
61239,5,3,214030,214030,214033,0,3,4
61240,3,2,214033,214033,214035,0,2,0
61241,3,1,214036,214036,214037,0,1,1
61242,3,1,214039,214039,214040,0,1,2
61243,6,1,214045,214045,214046,0,1,5
61244,1,3,214046,214046,214049,0,3,0
61245,5,1,214051,214051,214052,0,1,2
61246,1,3,214052,214052,214055,0,3,0
61247,6,1,214058,214058,214059,0,1,3
61248,1,1,214059,214059,214060,0,1,0
61249,2,1,214061,214061,214062,0,1,1
61250,2,1,214063,214063,214064,0,1,1
61251,1,1,214064,214064,214065,0,1,0
61252,2,1,214066,214066,214067,0,1,1
61253,6,3,214072,214072,214075,0,3,5
61254,1,1,214073,214075,214076,2,3,0
61255,1,2,214074,214076,214078,2,4,0
61256,4,2,214078,214078,214080,0,2,0
61257,4,2,214082,214082,214084,0,2,2
61258,4,2,214086,214086,214088,0,2,2
61259,2,2,214088,214088,214090,0,2,0
61260,3,2,214091,214091,214093,0,2,1
61261,6,1,214097,214097,214098,0,1,4
61262,2,1,214099,214099,214100,0,1,1
61263,4,1,214103,214103,214104,0,1,3
61264,6,2,214109,214109,214111,0,2,5
61265,6,2,214115,214115,214117,0,2,4
61266,5,1,214120,214120,214121,0,1,3
61267,5,2,214125,214125,214127,0,2,4
61268,1,2,214126,214127,214129,1,3,0
61269,3,1,214129,214129,214130,0,1,0
61270,4,3,214133,214133,214136,0,3,3
61271,5,2,214138,214138,214140,0,2,2
61272,6,1,214144,214144,214145,0,1,4
61273,2,3,214146,214146,214149,0,3,1
61274,3,3,214149,214149,214152,0,3,0
61275,3,3,214152,214152,214155,0,3,0
61276,1,1,214153,214155,214156,2,3,0
61277,5,3,214158,214158,214161,0,3,2
61278,6,1,214164,214164,214165,0,1,3
61279,5,3,214169,214169,214172,0,3,4
61280,2,1,214171,214172,214173,1,2,0
61281,5,3,214176,214176,214179,0,3,3
61282,1,1,214177,214179,214180,2,3,0
61283,2,3,214179,214180,214183,1,4,0
61284,1,3,214180,214183,214186,3,6,0
61285,6,1,214186,214186,214187,0,1,0
61286,4,3,214190,214190,214193,0,3,3
61287,1,1,214191,214193,214194,2,3,0
61288,4,3,214195,214195,214198,0,3,1
61289,4,2,214199,214199,214201,0,2,1
61290,2,1,214201,214201,214202,0,1,0
61291,4,3,214205,214205,214208,0,3,3
61292,4,3,214209,214209,214212,0,3,1
61293,5,1,214214,214214,214215,0,1,2
61294,5,3,214219,214219,214222,0,3,4
61295,6,2,214225,214225,214227,0,2,3
61296,6,2,214231,214231,214233,0,2,4
61297,5,1,214236,214236,214237,0,1,3
61298,1,3,214237,214237,214240,0,3,0
61299,2,3,214239,214240,214243,1,4,0
61300,4,2,214243,214243,214245,0,2,0
61301,2,2,214245,214245,214247,0,2,0
61302,4,1,214249,214249,214250,0,1,2
61303,6,1,214255,214255,214256,0,1,5
61304,2,3,214257,214257,214260,0,3,1
61305,6,2,214263,214263,214265,0,2,3
61306,1,1,214264,214265,214266,1,2,0
61307,5,2,214269,214269,214271,0,2,3
61308,1,2,214270,214271,214273,1,3,0
61309,6,2,214276,214276,214278,0,2,3
61310,2,3,214278,214278,214281,0,3,0
61311,4,1,214282,214282,214283,0,1,1
61312,3,2,214285,214285,214287,0,2,2
61313,3,1,214288,214288,214289,0,1,1
61314,4,2,214292,214292,214294,0,2,3
61315,4,1,214296,214296,214297,0,1,2
61316,5,2,214301,214301,214303,0,2,4
61317,5,2,214306,214306,214308,0,2,3
61318,1,2,214307,214308,214310,1,3,0
61319,6,2,214313,214313,214315,0,2,3
61320,6,1,214319,214319,214320,0,1,4
61321,4,2,214323,214323,214325,0,2,3
61322,1,1,214324,214325,214326,1,2,0
61323,1,3,214325,214326,214329,1,4,0
61324,6,1,214331,214331,214332,0,1,2
61325,5,3,214336,214336,214339,0,3,4
61326,6,2,214342,214342,214344,0,2,3
61327,5,2,214347,214347,214349,0,2,3
61328,1,1,214348,214349,214350,1,2,0
61329,2,3,214350,214350,214353,0,3,0
61330,5,2,214355,214355,214357,0,2,2
61331,5,3,214360,214360,214363,0,3,3
61332,1,1,214361,214363,214364,2,3,0
61333,6,3,214367,214367,214370,0,3,3
61334,2,2,214369,214370,214372,1,3,0
61335,5,3,214374,214374,214377,0,3,2
61336,1,3,214375,214377,214380,2,5,0
61337,4,2,214379,214380,214382,1,3,0
61338,2,2,214381,214382,214384,1,3,0
61339,4,2,214385,214385,214387,0,2,1
61340,4,2,214389,214389,214391,0,2,2
61341,3,2,214392,214392,214394,0,2,1
61342,5,1,214397,214397,214398,0,1,3
61343,4,1,214401,214401,214402,0,1,3
61344,3,3,214404,214404,214407,0,3,2
61345,5,2,214409,214409,214411,0,2,2
61346,6,2,214415,214415,214417,0,2,4
61347,2,1,214417,214417,214418,0,1,0
61348,2,3,214419,214419,214422,0,3,1
61349,6,2,214425,214425,214427,0,2,3
61350,6,2,214431,214431,214433,0,2,4
61351,5,2,214436,214436,214438,0,2,3
61352,5,3,214441,214441,214444,0,3,3
61353,3,3,214444,214444,214447,0,3,0
61354,1,1,214445,214447,214448,2,3,0
61355,2,1,214447,214448,214449,1,2,0
61356,2,1,214449,214449,214450,0,1,0
61357,2,1,214451,214451,214452,0,1,1
61358,1,1,214452,214452,214453,0,1,0
61359,2,2,214454,214454,214456,0,2,1
61360,5,2,214459,214459,214461,0,2,3
61361,3,2,214462,214462,214464,0,2,1
61362,2,3,214464,214464,214467,0,3,0
61363,4,3,214468,214468,214471,0,3,1
61364,2,1,214470,214471,214472,1,2,0
61365,2,1,214472,214472,214473,0,1,0
61366,6,2,214478,214478,214480,0,2,5
61367,6,3,214484,214484,214487,0,3,4
61368,3,1,214487,214487,214488,0,1,0
61369,5,1,214492,214492,214493,0,1,4
61370,5,2,214497,214497,214499,0,2,4
61371,2,3,214499,214499,214502,0,3,0
61372,6,1,214505,214505,214506,0,1,3
61373,2,1,214507,214507,214508,0,1,1
61374,1,1,214508,214508,214509,0,1,0
61375,3,1,214511,214511,214512,0,1,2
61376,5,1,214516,214516,214517,0,1,4
61377,4,2,214520,214520,214522,0,2,3
61378,6,3,214526,214526,214529,0,3,4
61379,2,2,214528,214529,214531,1,3,0
61380,3,1,214531,214531,214532,0,1,0
61381,6,2,214537,214537,214539,0,2,5
61382,3,3,214540,214540,214543,0,3,1
61383,2,3,214542,214543,214546,1,4,0
61384,4,1,214546,214546,214547,0,1,0
61385,6,3,214552,214552,214555,0,3,5
61386,4,3,214556,214556,214559,0,3,1
61387,4,3,214560,214560,214563,0,3,1
61388,6,3,214566,214566,214569,0,3,3
61389,4,2,214570,214570,214572,0,2,1
61390,6,2,214576,214576,214578,0,2,4
61391,6,3,214582,214582,214585,0,3,4
61392,1,3,214583,214585,214588,2,5,0
61393,2,3,214585,214588,214591,3,6,0
61394,5,2,214590,214591,214593,1,3,0
61395,5,1,214595,214595,214596,0,1,2
61396,3,3,214598,214598,214601,0,3,2
61397,2,2,214600,214601,214603,1,3,0
61398,1,2,214601,214603,214605,2,4,0
61399,2,3,214603,214605,214608,2,5,0
61400,6,1,214609,214609,214610,0,1,1
61401,5,3,214614,214614,214617,0,3,4
61402,4,2,214618,214618,214620,0,2,1
61403,3,3,214621,214621,214624,0,3,1
61404,2,3,214623,214624,214627,1,4,0
61405,1,1,214624,214627,214628,3,4,0
61406,5,2,214629,214629,214631,0,2,1
61407,4,1,214633,214633,214634,0,1,2
61408,1,3,214634,214634,214637,0,3,0
61409,6,3,214640,214640,214643,0,3,3
61410,1,2,214641,214643,214645,2,4,0
61411,4,2,214645,214645,214647,0,2,0
61412,4,1,214649,214649,214650,0,1,2
61413,2,1,214651,214651,214652,0,1,1
61414,2,1,214653,214653,214654,0,1,1
61415,4,3,214657,214657,214660,0,3,3
61416,3,2,214660,214660,214662,0,2,0
61417,2,1,214662,214662,214663,0,1,0
61418,5,1,214667,214667,214668,0,1,4
61419,2,2,214669,214669,214671,0,2,1
61420,1,2,214670,214671,214673,1,3,0
61421,3,2,214673,214673,214675,0,2,0
61422,2,3,214675,214675,214678,0,3,0
61423,1,1,214676,214678,214679,2,3,0
61424,1,3,214677,214679,214682,2,5,0
61425,5,2,214682,214682,214684,0,2,0
61426,1,1,214683,214684,214685,1,2,0
61427,2,3,214685,214685,214688,0,3,0
61428,3,3,214688,214688,214691,0,3,0
61429,2,1,214690,214691,214692,1,2,0
61430,2,1,214692,214692,214693,0,1,0
61431,2,1,214694,214694,214695,0,1,1
61432,1,3,214695,214695,214698,0,3,0
61433,3,3,214698,214698,214701,0,3,0
61434,3,1,214701,214701,214702,0,1,0
61435,1,1,214702,214702,214703,0,1,0
61436,6,1,214708,214708,214709,0,1,5
61437,3,3,214711,214711,214714,0,3,2
61438,4,1,214715,214715,214716,0,1,1
61439,4,2,214719,214719,214721,0,2,3
61440,6,1,214725,214725,214726,0,1,4
61441,5,2,214730,214730,214732,0,2,4
61442,1,3,214731,214732,214735,1,4,0
61443,2,2,214733,214735,214737,2,4,0
61444,6,1,214739,214739,214740,0,1,2
61445,5,2,214744,214744,214746,0,2,4
61446,1,2,214745,214746,214748,1,3,0
61447,6,1,214751,214751,214752,0,1,3
61448,2,2,214753,214753,214755,0,2,1
61449,5,2,214758,214758,214760,0,2,3
61450,6,2,214764,214764,214766,0,2,4
61451,1,2,214765,214766,214768,1,3,0
61452,2,2,214767,214768,214770,1,3,0
61453,4,3,214771,214771,214774,0,3,1
61454,4,2,214775,214775,214777,0,2,1
61455,5,1,214780,214780,214781,0,1,3
61456,5,2,214785,214785,214787,0,2,4
61457,3,3,214788,214788,214791,0,3,1
61458,3,3,214791,214791,214794,0,3,0
61459,5,1,214796,214796,214797,0,1,2
61460,4,2,214800,214800,214802,0,2,3
61461,4,2,214804,214804,214806,0,2,2
61462,2,3,214806,214806,214809,0,3,0
61463,3,3,214809,214809,214812,0,3,0
61464,6,3,214815,214815,214818,0,3,3
61465,5,2,214820,214820,214822,0,2,2
61466,2,2,214822,214822,214824,0,2,0
61467,1,3,214823,214824,214827,1,4,0
61468,2,3,214825,214827,214830,2,5,0
61469,3,2,214828,214830,214832,2,4,0
61470,2,3,214830,214832,214835,2,5,0
61471,1,3,214831,214835,214838,4,7,0
61472,4,2,214835,214838,214840,3,5,0
61473,6,2,214841,214841,214843,0,2,1
61474,3,3,214844,214844,214847,0,3,1
61475,5,1,214849,214849,214850,0,1,2
61476,6,2,214855,214855,214857,0,2,5
61477,1,3,214856,214857,214860,1,4,0
61478,3,1,214859,214860,214861,1,2,0
61479,5,3,214864,214864,214867,0,3,3
61480,1,3,214865,214867,214870,2,5,0
61481,3,3,214868,214870,214873,2,5,0
61482,3,1,214871,214873,214874,2,3,0
61483,3,3,214874,214874,214877,0,3,0
61484,1,3,214875,214877,214880,2,5,0
61485,6,3,214881,214881,214884,0,3,1
61486,6,3,214887,214887,214890,0,3,3
61487,1,1,214888,214890,214891,2,3,0
61488,6,2,214894,214894,214896,0,2,3
61489,6,2,214900,214900,214902,0,2,4
61490,4,2,214904,214904,214906,0,2,2
61491,6,2,214910,214910,214912,0,2,4
61492,3,2,214913,214913,214915,0,2,1
61493,6,3,214919,214919,214922,0,3,4
61494,3,2,214922,214922,214924,0,2,0
61495,1,1,214923,214924,214925,1,2,0
61496,2,2,214925,214925,214927,0,2,0
61497,2,1,214927,214927,214928,0,1,0
61498,5,2,214932,214932,214934,0,2,4
61499,6,1,214938,214938,214939,0,1,4
61500,6,3,214944,214944,214947,0,3,5
61501,4,1,214948,214948,214949,0,1,1
61502,3,2,214951,214951,214953,0,2,2
61503,2,1,214953,214953,214954,0,1,0
61504,6,2,214959,214959,214961,0,2,5
61505,3,1,214962,214962,214963,0,1,1
61506,2,1,214964,214964,214965,0,1,1
61507,1,2,214965,214965,214967,0,2,0
61508,4,3,214969,214969,214972,0,3,2
61509,3,2,214972,214972,214974,0,2,0
61510,4,2,214976,214976,214978,0,2,2
61511,4,3,214980,214980,214983,0,3,2
61512,6,1,214986,214986,214987,0,1,3
61513,2,1,214988,214988,214989,0,1,1
61514,1,3,214989,214989,214992,0,3,0
61515,2,1,214991,214992,214993,1,2,0
61516,1,1,214992,214993,214994,1,2,0
61517,2,1,214994,214994,214995,0,1,0
61518,4,2,214998,214998,215000,0,2,3
61519,3,2,215001,215001,215003,0,2,1
61520,4,2,215005,215005,215007,0,2,2
61521,1,3,215006,215007,215010,1,4,0
61522,1,3,215007,215010,215013,3,6,0
61523,2,1,215009,215013,215014,4,5,0
61524,1,1,215010,215014,215015,4,5,0
61525,6,1,215016,215016,215017,0,1,1
61526,3,3,215019,215019,215022,0,3,2
61527,6,3,215025,215025,215028,0,3,3
61528,3,2,215028,215028,215030,0,2,0
61529,1,3,215029,215030,215033,1,4,0
61530,4,3,215033,215033,215036,0,3,0
61531,1,2,215034,215036,215038,2,4,0
61532,3,3,215037,215038,215041,1,4,0
61533,3,3,215040,215041,215044,1,4,0
61534,5,3,215045,215045,215048,0,3,1
61535,2,1,215047,215048,215049,1,2,0
61536,4,1,215051,215051,215052,0,1,2
61537,4,2,215055,215055,215057,0,2,3
61538,3,2,215058,215058,215060,0,2,1
61539,2,3,215060,215060,215063,0,3,0
61540,1,1,215061,215063,215064,2,3,0
61541,6,3,215067,215067,215070,0,3,3
61542,4,2,215071,215071,215073,0,2,1
61543,3,1,215074,215074,215075,0,1,1
61544,2,1,215076,215076,215077,0,1,1
61545,5,2,215081,215081,215083,0,2,4
61546,1,2,215082,215083,215085,1,3,0
61547,3,3,215085,215085,215088,0,3,0
61548,6,2,215091,215091,215093,0,2,3
61549,5,3,215096,215096,215099,0,3,3
61550,1,3,215097,215099,215102,2,5,0
61551,4,1,215101,215102,215103,1,2,0
61552,6,3,215107,215107,215110,0,3,4
61553,4,3,215111,215111,215114,0,3,1
61554,6,3,215117,215117,215120,0,3,3
61555,5,2,215122,215122,215124,0,2,2
61556,4,2,215126,215126,215128,0,2,2
61557,5,2,215131,215131,215133,0,2,3
61558,3,3,215134,215134,215137,0,3,1
61559,4,1,215138,215138,215139,0,1,1
61560,4,3,215142,215142,215145,0,3,3
61561,4,3,215146,215146,215149,0,3,1
61562,1,2,215147,215149,215151,2,4,0
61563,5,3,215152,215152,215155,0,3,1
61564,4,2,215156,215156,215158,0,2,1
61565,5,3,215161,215161,215164,0,3,3
61566,4,1,215165,215165,215166,0,1,1
61567,1,3,215166,215166,215169,0,3,0
61568,1,3,215167,215169,215172,2,5,0
61569,3,2,215170,215172,215174,2,4,0
61570,2,2,215172,215174,215176,2,4,0
61571,2,3,215174,215176,215179,2,5,0
61572,3,3,215177,215179,215182,2,5,0
61573,2,3,215179,215182,215185,3,6,0
61574,2,2,215181,215185,215187,4,6,0
61575,5,1,215186,215187,215188,1,2,0
61576,5,1,215191,215191,215192,0,1,3
61577,3,2,215194,215194,215196,0,2,2
61578,6,1,215200,215200,215201,0,1,4
61579,4,1,215204,215204,215205,0,1,3
61580,5,2,215209,215209,215211,0,2,4
61581,1,1,215210,215211,215212,1,2,0
61582,1,2,215211,215212,215214,1,3,0
61583,6,2,215217,215217,215219,0,2,3
61584,4,3,215221,215221,215224,0,3,2
61585,5,1,215226,215226,215227,0,1,2
61586,5,3,215231,215231,215234,0,3,4
61587,3,1,215234,215234,215235,0,1,0
61588,4,2,215238,215238,215240,0,2,3
61589,3,2,215241,215241,215243,0,2,1
61590,2,1,215243,215243,215244,0,1,0
61591,6,2,215249,215249,215251,0,2,5
61592,3,2,215252,215252,215254,0,2,1
61593,3,2,215255,215255,215257,0,2,1
61594,1,2,215256,215257,215259,1,3,0
61595,4,3,215260,215260,215263,0,3,1
61596,1,1,215261,215263,215264,2,3,0
61597,3,1,215264,215264,215265,0,1,0
61598,5,2,215269,215269,215271,0,2,4
61599,3,3,215272,215272,215275,0,3,1
61600,2,2,215274,215275,215277,1,3,0
61601,6,2,215280,215280,215282,0,2,3
61602,2,3,215282,215282,215285,0,3,0
61603,6,2,215288,215288,215290,0,2,3
61604,1,2,215289,215290,215292,1,3,0
61605,1,1,215290,215292,215293,2,3,0
61606,2,2,215292,215293,215295,1,3,0
61607,2,1,215294,215295,215296,1,2,0
61608,5,3,215299,215299,215302,0,3,3
61609,5,3,215304,215304,215307,0,3,2
61610,3,1,215307,215307,215308,0,1,0
61611,3,1,215310,215310,215311,0,1,2
61612,4,1,215314,215314,215315,0,1,3
61613,2,3,215316,215316,215319,0,3,1
61614,5,2,215321,215321,215323,0,2,2
61615,3,3,215324,215324,215327,0,3,1
61616,2,3,215326,215327,215330,1,4,0
61617,3,1,215329,215330,215331,1,2,0
61618,4,1,215333,215333,215334,0,1,2
61619,1,3,215334,215334,215337,0,3,0
61620,5,1,215339,215339,215340,0,1,2
61621,1,1,215340,215340,215341,0,1,0
61622,5,2,215345,215345,215347,0,2,4
61623,2,2,215347,215347,215349,0,2,0
61624,6,3,215353,215353,215356,0,3,4
61625,6,2,215359,215359,215361,0,2,3
61626,2,1,215361,215361,215362,0,1,0
61627,3,1,215364,215364,215365,0,1,2
61628,5,1,215369,215369,215370,0,1,4
61629,4,1,215373,215373,215374,0,1,3
61630,4,2,215377,215377,215379,0,2,3
61631,6,3,215383,215383,215386,0,3,4
61632,3,1,215386,215386,215387,0,1,0
61633,1,2,215387,215387,215389,0,2,0
61634,3,3,215390,215390,215393,0,3,1
61635,1,2,215391,215393,215395,2,4,0
61636,3,2,215394,215395,215397,1,3,0
61637,5,3,215399,215399,215402,0,3,2
61638,3,3,215402,215402,215405,0,3,0
61639,5,1,215407,215407,215408,0,1,2
61640,6,2,215413,215413,215415,0,2,5
61641,1,1,215414,215415,215416,1,2,0
61642,1,2,215415,215416,215418,1,3,0
61643,4,2,215419,215419,215421,0,2,1
61644,1,2,215420,215421,215423,1,3,0
61645,6,3,215426,215426,215429,0,3,3
61646,3,1,215429,215429,215430,0,1,0
61647,5,2,215434,215434,215436,0,2,4
61648,1,1,215435,215436,215437,1,2,0
61649,2,3,215437,215437,215440,0,3,0
61650,2,3,215439,215440,215443,1,4,0
61651,6,1,215445,215445,215446,0,1,2
61652,6,2,215451,215451,215453,0,2,5
61653,1,3,215452,215453,215456,1,4,0
61654,1,1,215453,215456,215457,3,4,0
61655,4,2,215457,215457,215459,0,2,0
61656,6,2,215463,215463,215465,0,2,4
61657,3,1,215466,215466,215467,0,1,1
61658,6,1,215472,215472,215473,0,1,5
61659,5,1,215477,215477,215478,0,1,4
61660,4,3,215481,215481,215484,0,3,3
61661,3,1,215484,215484,215485,0,1,0
61662,1,3,215485,215485,215488,0,3,0
61663,6,3,215491,215491,215494,0,3,3
61664,2,1,215493,215494,215495,1,2,0
61665,6,3,215499,215499,215502,0,3,4
61666,3,1,215502,215502,215503,0,1,0
61667,5,3,215507,215507,215510,0,3,4
61668,6,2,215513,215513,215515,0,2,3
61669,5,1,215518,215518,215519,0,1,3
61670,5,2,215523,215523,215525,0,2,4
61671,3,1,215526,215526,215527,0,1,1
61672,2,1,215528,215528,215529,0,1,1
61673,2,3,215530,215530,215533,0,3,1
61674,4,1,215534,215534,215535,0,1,1
61675,4,3,215538,215538,215541,0,3,3
61676,1,3,215539,215541,215544,2,5,0
61677,2,1,215541,215544,215545,3,4,0
61678,3,1,215544,215545,215546,1,2,0
61679,2,3,215546,215546,215549,0,3,0
61680,2,1,215548,215549,215550,1,2,0
61681,2,1,215550,215550,215551,0,1,0
61682,4,3,215554,215554,215557,0,3,3
61683,3,2,215557,215557,215559,0,2,0
61684,2,2,215559,215559,215561,0,2,0
61685,4,2,215563,215563,215565,0,2,2
61686,5,3,215568,215568,215571,0,3,3
61687,4,2,215572,215572,215574,0,2,1
61688,2,1,215574,215574,215575,0,1,0
61689,1,2,215575,215575,215577,0,2,0
61690,1,1,215576,215577,215578,1,2,0
61691,6,2,215582,215582,215584,0,2,4
61692,6,1,215588,215588,215589,0,1,4
61693,2,3,215590,215590,215593,0,3,1
61694,5,2,215595,215595,215597,0,2,2
61695,6,2,215601,215601,215603,0,2,4
61696,4,2,215605,215605,215607,0,2,2
61697,2,1,215607,215607,215608,0,1,0
61698,5,3,215612,215612,215615,0,3,4
61699,3,2,215615,215615,215617,0,2,0
61700,3,1,215618,215618,215619,0,1,1
61701,2,1,215620,215620,215621,0,1,1
61702,6,3,215626,215626,215629,0,3,5
61703,3,3,215629,215629,215632,0,3,0
61704,5,2,215634,215634,215636,0,2,2
61705,5,1,215639,215639,215640,0,1,3
61706,1,2,215640,215640,215642,0,2,0
61707,6,2,215646,215646,215648,0,2,4
61708,6,1,215652,215652,215653,0,1,4
61709,1,1,215653,215653,215654,0,1,0
61710,1,2,215654,215654,215656,0,2,0
61711,3,1,215657,215657,215658,0,1,1
61712,5,3,215662,215662,215665,0,3,4
61713,1,3,215663,215665,215668,2,5,0
61714,6,3,215669,215669,215672,0,3,1
61715,1,3,215670,215672,215675,2,5,0
61716,5,2,215675,215675,215677,0,2,0
61717,4,2,215679,215679,215681,0,2,2
61718,1,3,215680,215681,215684,1,4,0
61719,3,1,215683,215684,215685,1,2,0
61720,5,3,215688,215688,215691,0,3,3
61721,4,3,215692,215692,215695,0,3,1
61722,6,3,215698,215698,215701,0,3,3
61723,1,1,215699,215701,215702,2,3,0
61724,5,2,215704,215704,215706,0,2,2
61725,5,2,215709,215709,215711,0,2,3
61726,2,1,215711,215711,215712,0,1,0
61727,1,1,215712,215712,215713,0,1,0
61728,1,1,215713,215713,215714,0,1,0
61729,4,3,215717,215717,215720,0,3,3
61730,2,2,215719,215720,215722,1,3,0
61731,4,3,215723,215723,215726,0,3,1
61732,3,1,215726,215726,215727,0,1,0
61733,3,2,215729,215729,215731,0,2,2
61734,6,2,215735,215735,215737,0,2,4
61735,1,1,215736,215737,215738,1,2,0
61736,3,1,215739,215739,215740,0,1,1
61737,4,2,215743,215743,215745,0,2,3
61738,3,2,215746,215746,215748,0,2,1
61739,3,1,215749,215749,215750,0,1,1
61740,2,1,215751,215751,215752,0,1,1
61741,2,1,215753,215753,215754,0,1,1
61742,6,1,215759,215759,215760,0,1,5
61743,1,1,215760,215760,215761,0,1,0
61744,3,1,215763,215763,215764,0,1,2
61745,6,3,215769,215769,215772,0,3,5
61746,4,2,215773,215773,215775,0,2,1
61747,6,2,215779,215779,215781,0,2,4
61748,2,2,215781,215781,215783,0,2,0
61749,4,2,215785,215785,215787,0,2,2
61750,3,3,215788,215788,215791,0,3,1
61751,3,3,215791,215791,215794,0,3,0
61752,6,1,215797,215797,215798,0,1,3
61753,4,3,215801,215801,215804,0,3,3
61754,5,1,215806,215806,215807,0,1,2
61755,3,3,215809,215809,215812,0,3,2
61756,5,2,215814,215814,215816,0,2,2
61757,6,2,215820,215820,215822,0,2,4
61758,1,3,215821,215822,215825,1,4,0
61759,1,2,215822,215825,215827,3,5,0
61760,2,3,215824,215827,215830,3,6,0
61761,1,2,215825,215830,215832,5,7,0
61762,6,1,215831,215832,215833,1,2,0
61763,2,2,215833,215833,215835,0,2,0
61764,2,1,215835,215835,215836,0,1,0
61765,3,1,215838,215838,215839,0,1,2
61766,2,2,215840,215840,215842,0,2,1
61767,6,2,215846,215846,215848,0,2,4
61768,5,2,215851,215851,215853,0,2,3
61769,6,3,215857,215857,215860,0,3,4
61770,5,3,215862,215862,215865,0,3,2
61771,3,3,215865,215865,215868,0,3,0
61772,1,2,215866,215868,215870,2,4,0
61773,3,2,215869,215870,215872,1,3,0
61774,6,3,215875,215875,215878,0,3,3
61775,5,1,215880,215880,215881,0,1,2
61776,3,1,215883,215883,215884,0,1,2
61777,4,1,215887,215887,215888,0,1,3
61778,6,3,215893,215893,215896,0,3,5
61779,3,1,215896,215896,215897,0,1,0
61780,1,2,215897,215897,215899,0,2,0
61781,1,1,215898,215899,215900,1,2,0
61782,2,2,215900,215900,215902,0,2,0
61783,5,2,215905,215905,215907,0,2,3
61784,4,2,215909,215909,215911,0,2,2
61785,3,1,215912,215912,215913,0,1,1
61786,6,3,215918,215918,215921,0,3,5
61787,3,2,215921,215921,215923,0,2,0
61788,5,2,215926,215926,215928,0,2,3
61789,4,3,215930,215930,215933,0,3,2
61790,1,3,215931,215933,215936,2,5,0
61791,2,2,215933,215936,215938,3,5,0
61792,4,3,215937,215938,215941,1,4,0
61793,4,1,215941,215941,215942,0,1,0
61794,1,1,215942,215942,215943,0,1,0
61795,5,3,215947,215947,215950,0,3,4
61796,2,2,215949,215950,215952,1,3,0
61797,3,2,215952,215952,215954,0,2,0
61798,4,2,215956,215956,215958,0,2,2
61799,5,2,215961,215961,215963,0,2,3
61800,6,3,215967,215967,215970,0,3,4
61801,2,1,215969,215970,215971,1,2,0
61802,2,3,215971,215971,215974,0,3,0
61803,3,3,215974,215974,215977,0,3,0
61804,3,2,215977,215977,215979,0,2,0
61805,3,3,215980,215980,215983,0,3,1
61806,4,3,215984,215984,215987,0,3,1
61807,5,2,215989,215989,215991,0,2,2
61808,6,2,215995,215995,215997,0,2,4
61809,6,2,216001,216001,216003,0,2,4
61810,2,2,216003,216003,216005,0,2,0
61811,4,3,216007,216007,216010,0,3,2
61812,4,3,216011,216011,216014,0,3,1
61813,6,1,216017,216017,216018,0,1,3
61814,1,1,216018,216018,216019,0,1,0
61815,1,1,216019,216019,216020,0,1,0
61816,3,2,216022,216022,216024,0,2,2
61817,1,1,216023,216024,216025,1,2,0
61818,4,2,216027,216027,216029,0,2,2
61819,3,2,216030,216030,216032,0,2,1
61820,6,2,216036,216036,216038,0,2,4
61821,5,3,216041,216041,216044,0,3,3
61822,2,2,216043,216044,216046,1,3,0
61823,1,1,216044,216046,216047,2,3,0
61824,1,3,216045,216047,216050,2,5,0
61825,2,1,216047,216050,216051,3,4,0
61826,3,2,216050,216051,216053,1,3,0
61827,4,3,216054,216054,216057,0,3,1
61828,5,1,216059,216059,216060,0,1,2
61829,6,1,216065,216065,216066,0,1,5
61830,1,2,216066,216066,216068,0,2,0
61831,3,1,216069,216069,216070,0,1,1
61832,5,1,216074,216074,216075,0,1,4
61833,4,1,216078,216078,216079,0,1,3
61834,5,1,216083,216083,216084,0,1,4
61835,3,2,216086,216086,216088,0,2,2
61836,6,3,216092,216092,216095,0,3,4
61837,2,1,216094,216095,216096,1,2,0
61838,5,3,216099,216099,216102,0,3,3
61839,1,2,216100,216102,216104,2,4,0
61840,5,3,216105,216105,216108,0,3,1
61841,1,3,216106,216108,216111,2,5,0
61842,2,1,216108,216111,216112,3,4,0
61843,5,2,216113,216113,216115,0,2,1
61844,4,3,216117,216117,216120,0,3,2
61845,3,2,216120,216120,216122,0,2,0
61846,2,2,216122,216122,216124,0,2,0
61847,3,3,216125,216125,216128,0,3,1
61848,1,2,216126,216128,216130,2,4,0
61849,3,3,216129,216130,216133,1,4,0
61850,3,1,216132,216133,216134,1,2,0
61851,4,2,216136,216136,216138,0,2,2
61852,4,2,216140,216140,216142,0,2,2
61853,5,3,216145,216145,216148,0,3,3
61854,2,3,216147,216148,216151,1,4,0
61855,1,2,216148,216151,216153,3,5,0
61856,4,2,216152,216153,216155,1,3,0
61857,6,2,216158,216158,216160,0,2,3
61858,2,1,216160,216160,216161,0,1,0
61859,3,3,216163,216163,216166,0,3,2
61860,2,3,216165,216166,216169,1,4,0
61861,3,2,216168,216169,216171,1,3,0
61862,2,3,216170,216171,216174,1,4,0
61863,6,2,216176,216176,216178,0,2,2
61864,1,1,216177,216178,216179,1,2,0
61865,3,1,216180,216180,216181,0,1,1
61866,2,3,216182,216182,216185,0,3,1
61867,6,3,216188,216188,216191,0,3,3
61868,3,3,216191,216191,216194,0,3,0
61869,5,1,216196,216196,216197,0,1,2
61870,4,2,216200,216200,216202,0,2,3
61871,5,3,216205,216205,216208,0,3,3
61872,2,3,216207,216208,216211,1,4,0
61873,6,1,216213,216213,216214,0,1,2
61874,4,2,216217,216217,216219,0,2,3
61875,2,3,216219,216219,216222,0,3,0
61876,4,1,216223,216223,216224,0,1,1
61877,1,2,216224,216224,216226,0,2,0
61878,4,3,216228,216228,216231,0,3,2
61879,1,3,216229,216231,216234,2,5,0
61880,4,2,216233,216234,216236,1,3,0
61881,1,3,216234,216236,216239,2,5,0
61882,5,2,216239,216239,216241,0,2,0
61883,5,1,216244,216244,216245,0,1,3
61884,2,1,216246,216246,216247,0,1,1
61885,4,2,216250,216250,216252,0,2,3
61886,3,2,216253,216253,216255,0,2,1
61887,1,3,216254,216255,216258,1,4,0
61888,3,3,216257,216258,216261,1,4,0
61889,1,2,216258,216261,216263,3,5,0
61890,2,3,216260,216263,216266,3,6,0
61891,6,3,216266,216266,216269,0,3,0
61892,2,3,216268,216269,216272,1,4,0
61893,6,2,216274,216274,216276,0,2,2
61894,6,3,216280,216280,216283,0,3,4
61895,4,2,216284,216284,216286,0,2,1
61896,6,2,216290,216290,216292,0,2,4
61897,4,3,216294,216294,216297,0,3,2
61898,6,2,216300,216300,216302,0,2,3
61899,6,1,216306,216306,216307,0,1,4
61900,1,3,216307,216307,216310,0,3,0
61901,5,3,216312,216312,216315,0,3,2
61902,1,2,216313,216315,216317,2,4,0
61903,5,2,216318,216318,216320,0,2,1
61904,4,1,216322,216322,216323,0,1,2
61905,6,2,216328,216328,216330,0,2,5
61906,5,1,216333,216333,216334,0,1,3
61907,4,1,216337,216337,216338,0,1,3
61908,3,1,216340,216340,216341,0,1,2
61909,5,3,216345,216345,216348,0,3,4
61910,2,1,216347,216348,216349,1,2,0
61911,1,1,216348,216349,216350,1,2,0
61912,5,2,216353,216353,216355,0,2,3
61913,6,1,216359,216359,216360,0,1,4
61914,1,3,216360,216360,216363,0,3,0
61915,1,3,216361,216363,216366,2,5,0
61916,6,3,216367,216367,216370,0,3,1
61917,2,3,216369,216370,216373,1,4,0
61918,5,3,216374,216374,216377,0,3,1
61919,6,3,216380,216380,216383,0,3,3
61920,4,1,216384,216384,216385,0,1,1
61921,6,2,216390,216390,216392,0,2,5
61922,4,3,216394,216394,216397,0,3,2
61923,6,2,216400,216400,216402,0,2,3
61924,6,2,216406,216406,216408,0,2,4
61925,3,1,216409,216409,216410,0,1,1
61926,5,1,216414,216414,216415,0,1,4
61927,4,2,216418,216418,216420,0,2,3
61928,2,1,216420,216420,216421,0,1,0
61929,1,3,216421,216421,216424,0,3,0
61930,2,2,216423,216424,216426,1,3,0
61931,1,1,216424,216426,216427,2,3,0
61932,2,3,216426,216427,216430,1,4,0
61933,5,3,216431,216431,216434,0,3,1
61934,4,3,216435,216435,216438,0,3,1
61935,4,1,216439,216439,216440,0,1,1
61936,3,2,216442,216442,216444,0,2,2
61937,2,3,216444,216444,216447,0,3,0
61938,4,3,216448,216448,216451,0,3,1
61939,3,2,216451,216451,216453,0,2,0
61940,6,1,216457,216457,216458,0,1,4
61941,4,3,216461,216461,216464,0,3,3
61942,5,2,216466,216466,216468,0,2,2
61943,5,1,216471,216471,216472,0,1,3
61944,6,3,216477,216477,216480,0,3,5
61945,1,3,216478,216480,216483,2,5,0
61946,2,1,216480,216483,216484,3,4,0
61947,1,2,216481,216484,216486,3,5,0
61948,5,2,216486,216486,216488,0,2,0
61949,2,3,216488,216488,216491,0,3,0
61950,4,3,216492,216492,216495,0,3,1
61951,6,1,216498,216498,216499,0,1,3
61952,4,2,216502,216502,216504,0,2,3
61953,3,3,216505,216505,216508,0,3,1
61954,6,3,216511,216511,216514,0,3,3
61955,5,1,216516,216516,216517,0,1,2
61956,3,1,216519,216519,216520,0,1,2
61957,1,2,216520,216520,216522,0,2,0
61958,5,3,216525,216525,216528,0,3,3
61959,4,2,216529,216529,216531,0,2,1
61960,4,2,216533,216533,216535,0,2,2
61961,1,3,216534,216535,216538,1,4,0
61962,3,1,216537,216538,216539,1,2,0
61963,1,3,216538,216539,216542,1,4,0
61964,5,1,216543,216543,216544,0,1,1
61965,1,1,216544,216544,216545,0,1,0
61966,4,3,216548,216548,216551,0,3,3
61967,2,1,216550,216551,216552,1,2,0
61968,4,2,216554,216554,216556,0,2,2
61969,1,2,216555,216556,216558,1,3,0
61970,4,2,216559,216559,216561,0,2,1
61971,2,2,216561,216561,216563,0,2,0
61972,1,2,216562,216563,216565,1,3,0
61973,3,1,216565,216565,216566,0,1,0
61974,5,2,216570,216570,216572,0,2,4
61975,3,2,216573,216573,216575,0,2,1
61976,2,2,216575,216575,216577,0,2,0
61977,1,1,216576,216577,216578,1,2,0
61978,6,1,216582,216582,216583,0,1,4
61979,2,2,216584,216584,216586,0,2,1
61980,3,2,216587,216587,216589,0,2,1
61981,6,3,216593,216593,216596,0,3,4
61982,2,2,216595,216596,216598,1,3,0
61983,2,2,216597,216598,216600,1,3,0
61984,1,1,216598,216600,216601,2,3,0
61985,1,1,216599,216601,216602,2,3,0
61986,2,2,216601,216602,216604,1,3,0
61987,6,1,216607,216607,216608,0,1,3
61988,2,3,216609,216609,216612,0,3,1
61989,6,1,216615,216615,216616,0,1,3
61990,5,1,216620,216620,216621,0,1,4
61991,1,1,216621,216621,216622,0,1,0
61992,6,1,216627,216627,216628,0,1,5
61993,6,1,216633,216633,216634,0,1,5
61994,4,3,216637,216637,216640,0,3,3
61995,2,2,216639,216640,216642,1,3,0
61996,1,2,216640,216642,216644,2,4,0
61997,4,2,216644,216644,216646,0,2,0
61998,3,3,216647,216647,216650,0,3,1
61999,4,2,216651,216651,216653,0,2,1
62000,6,3,216657,216657,216660,0,3,4
62001,5,1,216662,216662,216663,0,1,2
62002,4,1,216666,216666,216667,0,1,3
62003,5,1,216671,216671,216672,0,1,4
62004,6,2,216677,216677,216679,0,2,5
62005,2,2,216679,216679,216681,0,2,0
62006,2,3,216681,216681,216684,0,3,0
62007,2,1,216683,216684,216685,1,2,0
62008,4,3,216687,216687,216690,0,3,2
62009,1,2,216688,216690,216692,2,4,0
62010,2,1,216690,216692,216693,2,3,0
62011,4,1,216694,216694,216695,0,1,1
62012,6,2,216700,216700,216702,0,2,5
62013,2,1,216702,216702,216703,0,1,0
62014,3,2,216705,216705,216707,0,2,2
62015,3,3,216708,216708,216711,0,3,1
62016,1,1,216709,216711,216712,2,3,0
62017,5,2,216714,216714,216716,0,2,2
62018,1,2,216715,216716,216718,1,3,0
62019,4,1,216719,216719,216720,0,1,1
62020,2,1,216721,216721,216722,0,1,1
62021,6,2,216727,216727,216729,0,2,5
62022,6,1,216733,216733,216734,0,1,4
62023,6,1,216739,216739,216740,0,1,5
62024,3,1,216742,216742,216743,0,1,2
62025,6,1,216748,216748,216749,0,1,5
62026,4,3,216752,216752,216755,0,3,3
62027,3,3,216755,216755,216758,0,3,0
62028,3,1,216758,216758,216759,0,1,0
62029,4,1,216762,216762,216763,0,1,3
62030,3,2,216765,216765,216767,0,2,2
62031,2,1,216767,216767,216768,0,1,0
62032,1,2,216768,216768,216770,0,2,0
62033,5,1,216773,216773,216774,0,1,3
62034,4,1,216777,216777,216778,0,1,3
62035,5,3,216782,216782,216785,0,3,4
62036,4,1,216786,216786,216787,0,1,1
62037,2,2,216788,216788,216790,0,2,1
62038,3,2,216791,216791,216793,0,2,1
62039,1,2,216792,216793,216795,1,3,0
62040,5,1,216797,216797,216798,0,1,2
62041,2,3,216799,216799,216802,0,3,1
62042,5,1,216804,216804,216805,0,1,2
62043,5,2,216809,216809,216811,0,2,4
62044,4,3,216813,216813,216816,0,3,2
62045,4,2,216817,216817,216819,0,2,1
62046,2,1,216819,216819,216820,0,1,0
62047,6,2,216825,216825,216827,0,2,5
62048,4,2,216829,216829,216831,0,2,2
62049,6,2,216835,216835,216837,0,2,4
62050,1,1,216836,216837,216838,1,2,0
62051,4,2,216840,216840,216842,0,2,2
62052,2,3,216842,216842,216845,0,3,0
62053,3,2,216845,216845,216847,0,2,0
62054,2,3,216847,216847,216850,0,3,0
62055,1,1,216848,216850,216851,2,3,0
62056,6,1,216854,216854,216855,0,1,3
62057,6,3,216860,216860,216863,0,3,5
62058,4,1,216864,216864,216865,0,1,1
62059,4,2,216868,216868,216870,0,2,3
62060,2,1,216870,216870,216871,0,1,0
62061,6,2,216876,216876,216878,0,2,5
62062,2,2,216878,216878,216880,0,2,0
62063,5,2,216883,216883,216885,0,2,3
62064,3,2,216886,216886,216888,0,2,1
62065,6,3,216892,216892,216895,0,3,4
62066,2,1,216894,216895,216896,1,2,0
62067,2,2,216896,216896,216898,0,2,0
62068,6,3,216902,216902,216905,0,3,4
62069,5,2,216907,216907,216909,0,2,2
62070,1,2,216908,216909,216911,1,3,0
62071,6,1,216914,216914,216915,0,1,3
62072,2,3,216916,216916,216919,0,3,1
62073,6,1,216922,216922,216923,0,1,3
62074,5,2,216927,216927,216929,0,2,4
62075,6,2,216933,216933,216935,0,2,4
62076,5,2,216938,216938,216940,0,2,3
62077,2,3,216940,216940,216943,0,3,0
62078,1,1,216941,216943,216944,2,3,0
62079,3,1,216944,216944,216945,0,1,0
62080,5,1,216949,216949,216950,0,1,4
62081,6,1,216955,216955,216956,0,1,5
62082,4,1,216959,216959,216960,0,1,3
62083,3,3,216962,216962,216965,0,3,2
62084,1,1,216963,216965,216966,2,3,0
62085,2,2,216965,216966,216968,1,3,0
62086,6,1,216971,216971,216972,0,1,3
62087,2,1,216973,216973,216974,0,1,1
62088,2,1,216975,216975,216976,0,1,1
62089,1,1,216976,216976,216977,0,1,0
62090,2,3,216978,216978,216981,0,3,1
62091,5,3,216983,216983,216986,0,3,2
62092,6,1,216989,216989,216990,0,1,3
62093,6,3,216995,216995,216998,0,3,5
62094,1,2,216996,216998,217000,2,4,0
62095,6,2,217002,217002,217004,0,2,2
62096,2,3,217004,217004,217007,0,3,0
62097,4,2,217008,217008,217010,0,2,1
62098,2,2,217010,217010,217012,0,2,0
62099,6,2,217016,217016,217018,0,2,4
62100,2,1,217018,217018,217019,0,1,0
62101,6,3,217024,217024,217027,0,3,5
62102,5,1,217029,217029,217030,0,1,2
62103,2,3,217031,217031,217034,0,3,1
62104,5,3,217036,217036,217039,0,3,2
62105,2,2,217038,217039,217041,1,3,0
62106,4,2,217042,217042,217044,0,2,1
62107,5,1,217047,217047,217048,0,1,3
62108,1,2,217048,217048,217050,0,2,0
62109,2,3,217050,217050,217053,0,3,0
62110,1,3,217051,217053,217056,2,5,0
62111,1,1,217052,217056,217057,4,5,0
62112,6,3,217058,217058,217061,0,3,1
62113,2,3,217060,217061,217064,1,4,0
62114,5,1,217065,217065,217066,0,1,1
62115,2,2,217067,217067,217069,0,2,1
62116,5,2,217072,217072,217074,0,2,3
62117,2,3,217074,217074,217077,0,3,0
62118,6,1,217080,217080,217081,0,1,3
62119,1,2,217081,217081,217083,0,2,0
62120,6,1,217087,217087,217088,0,1,4
62121,1,3,217088,217088,217091,0,3,0
62122,6,3,217094,217094,217097,0,3,3
62123,4,3,217098,217098,217101,0,3,1
62124,6,2,217104,217104,217106,0,2,3
62125,5,3,217109,217109,217112,0,3,3
62126,6,3,217115,217115,217118,0,3,3
62127,4,1,217119,217119,217120,0,1,1
62128,4,3,217123,217123,217126,0,3,3
62129,6,3,217129,217129,217132,0,3,3
62130,2,2,217131,217132,217134,1,3,0
62131,6,2,217137,217137,217139,0,2,3
62132,3,1,217140,217140,217141,0,1,1
62133,6,3,217146,217146,217149,0,3,5
62134,4,3,217150,217150,217153,0,3,1
62135,4,1,217154,217154,217155,0,1,1
62136,2,2,217156,217156,217158,0,2,1
62137,4,1,217160,217160,217161,0,1,2
62138,5,3,217165,217165,217168,0,3,4
62139,2,1,217167,217168,217169,1,2,0
62140,6,2,217173,217173,217175,0,2,4
62141,4,2,217177,217177,217179,0,2,2
62142,5,1,217182,217182,217183,0,1,3
62143,6,1,217188,217188,217189,0,1,5
62144,3,3,217191,217191,217194,0,3,2
62145,4,2,217195,217195,217197,0,2,1
62146,3,1,217198,217198,217199,0,1,1
62147,4,1,217202,217202,217203,0,1,3
62148,4,3,217206,217206,217209,0,3,3
62149,3,2,217209,217209,217211,0,2,0
62150,2,1,217211,217211,217212,0,1,0
62151,4,3,217215,217215,217218,0,3,3
62152,5,2,217220,217220,217222,0,2,2
62153,1,2,217221,217222,217224,1,3,0
62154,3,3,217224,217224,217227,0,3,0
62155,6,3,217230,217230,217233,0,3,3
62156,5,3,217235,217235,217238,0,3,2
62157,1,1,217236,217238,217239,2,3,0
62158,5,3,217241,217241,217244,0,3,2
62159,1,1,217242,217244,217245,2,3,0
62160,5,2,217247,217247,217249,0,2,2
62161,4,2,217251,217251,217253,0,2,2
62162,2,3,217253,217253,217256,0,3,0
62163,6,1,217259,217259,217260,0,1,3
62164,1,2,217260,217260,217262,0,2,0
62165,5,2,217265,217265,217267,0,2,3
62166,4,2,217269,217269,217271,0,2,2
62167,6,1,217275,217275,217276,0,1,4
62168,1,3,217276,217276,217279,0,3,0
62169,1,3,217277,217279,217282,2,5,0
62170,3,3,217280,217282,217285,2,5,0
62171,1,3,217281,217285,217288,4,7,0
62172,2,3,217283,217288,217291,5,8,0
62173,4,3,217287,217291,217294,4,7,0
62174,6,1,217293,217294,217295,1,2,0
62175,5,2,217298,217298,217300,0,2,3
62176,1,3,217299,217300,217303,1,4,0
62177,1,2,217300,217303,217305,3,5,0
62178,3,2,217303,217305,217307,2,4,0
62179,4,3,217307,217307,217310,0,3,0
62180,4,1,217311,217311,217312,0,1,1
62181,5,1,217316,217316,217317,0,1,4
62182,3,2,217319,217319,217321,0,2,2
62183,4,2,217323,217323,217325,0,2,2
62184,1,2,217324,217325,217327,1,3,0
62185,3,1,217327,217327,217328,0,1,0
62186,2,3,217329,217329,217332,0,3,1
62187,6,3,217335,217335,217338,0,3,3
62188,5,1,217340,217340,217341,0,1,2
62189,3,2,217343,217343,217345,0,2,2
62190,6,1,217349,217349,217350,0,1,4
62191,5,2,217354,217354,217356,0,2,4
62192,1,1,217355,217356,217357,1,2,0
62193,5,3,217360,217360,217363,0,3,3
62194,5,3,217365,217365,217368,0,3,2
62195,4,3,217369,217369,217372,0,3,1
62196,6,3,217375,217375,217378,0,3,3
62197,6,1,217381,217381,217382,0,1,3
62198,6,1,217387,217387,217388,0,1,5
62199,4,1,217391,217391,217392,0,1,3
62200,4,1,217395,217395,217396,0,1,3
62201,4,2,217399,217399,217401,0,2,3
62202,3,2,217402,217402,217404,0,2,1
62203,3,2,217405,217405,217407,0,2,1
62204,6,3,217411,217411,217414,0,3,4
62205,4,2,217415,217415,217417,0,2,1
62206,5,3,217420,217420,217423,0,3,3
62207,4,3,217424,217424,217427,0,3,1
62208,6,2,217430,217430,217432,0,2,3
62209,3,2,217433,217433,217435,0,2,1
62210,5,2,217438,217438,217440,0,2,3
62211,1,1,217439,217440,217441,1,2,0
62212,5,3,217444,217444,217447,0,3,3
62213,1,2,217445,217447,217449,2,4,0
62214,5,1,217450,217450,217451,0,1,1
62215,2,2,217452,217452,217454,0,2,1
62216,3,1,217455,217455,217456,0,1,1
62217,6,3,217461,217461,217464,0,3,5
62218,6,3,217467,217467,217470,0,3,3
62219,5,2,217472,217472,217474,0,2,2
62220,1,2,217473,217474,217476,1,3,0
62221,5,1,217478,217478,217479,0,1,2
62222,5,3,217483,217483,217486,0,3,4
62223,2,3,217485,217486,217489,1,4,0
62224,6,3,217491,217491,217494,0,3,2
62225,3,3,217494,217494,217497,0,3,0
62226,3,3,217497,217497,217500,0,3,0
62227,3,3,217500,217500,217503,0,3,0
62228,2,2,217502,217503,217505,1,3,0
62229,2,1,217504,217505,217506,1,2,0
62230,1,3,217505,217506,217509,1,4,0
62231,4,3,217509,217509,217512,0,3,0
62232,4,1,217513,217513,217514,0,1,1
62233,3,3,217516,217516,217519,0,3,2
62234,3,2,217519,217519,217521,0,2,0
62235,5,3,217524,217524,217527,0,3,3
62236,3,1,217527,217527,217528,0,1,0
62237,5,3,217532,217532,217535,0,3,4
62238,5,3,217537,217537,217540,0,3,2
62239,4,1,217541,217541,217542,0,1,1
62240,4,3,217545,217545,217548,0,3,3
62241,1,2,217546,217548,217550,2,4,0
62242,5,1,217551,217551,217552,0,1,1
62243,3,1,217554,217554,217555,0,1,2
62244,6,1,217560,217560,217561,0,1,5
62245,4,3,217564,217564,217567,0,3,3
62246,6,2,217570,217570,217572,0,2,3
62247,6,2,217576,217576,217578,0,2,4
62248,3,1,217579,217579,217580,0,1,1
62249,5,3,217584,217584,217587,0,3,4
62250,3,3,217587,217587,217590,0,3,0
62251,2,1,217589,217590,217591,1,2,0
62252,2,1,217591,217591,217592,0,1,0
62253,5,2,217596,217596,217598,0,2,4
62254,6,2,217602,217602,217604,0,2,4
62255,4,3,217606,217606,217609,0,3,2
62256,4,3,217610,217610,217613,0,3,1
62257,1,1,217611,217613,217614,2,3,0
62258,6,3,217617,217617,217620,0,3,3
62259,3,3,217620,217620,217623,0,3,0
62260,3,2,217623,217623,217625,0,2,0
62261,3,1,217626,217626,217627,0,1,1
62262,5,2,217631,217631,217633,0,2,4
62263,1,1,217632,217633,217634,1,2,0
62264,5,1,217637,217637,217638,0,1,3
62265,3,1,217640,217640,217641,0,1,2
62266,1,3,217641,217641,217644,0,3,0
62267,1,3,217642,217644,217647,2,5,0
62268,5,1,217647,217647,217648,0,1,0
62269,5,1,217652,217652,217653,0,1,4
62270,5,1,217657,217657,217658,0,1,4
62271,4,2,217661,217661,217663,0,2,3
62272,6,3,217667,217667,217670,0,3,4
62273,1,1,217668,217670,217671,2,3,0
62274,2,1,217670,217671,217672,1,2,0
62275,3,2,217673,217673,217675,0,2,1
62276,4,2,217677,217677,217679,0,2,2
62277,5,1,217682,217682,217683,0,1,3
62278,6,1,217688,217688,217689,0,1,5
62279,6,3,217694,217694,217697,0,3,5
62280,2,3,217696,217697,217700,1,4,0
62281,1,1,217697,217700,217701,3,4,0
62282,5,3,217702,217702,217705,0,3,1
62283,2,2,217704,217705,217707,1,3,0
62284,1,1,217705,217707,217708,2,3,0
62285,2,2,217707,217708,217710,1,3,0
62286,3,2,217710,217710,217712,0,2,0
62287,3,3,217713,217713,217716,0,3,1
62288,1,2,217714,217716,217718,2,4,0
62289,3,1,217717,217718,217719,1,2,0
62290,6,3,217723,217723,217726,0,3,4
62291,4,3,217727,217727,217730,0,3,1
62292,4,1,217731,217731,217732,0,1,1
62293,3,1,217734,217734,217735,0,1,2
62294,3,3,217737,217737,217740,0,3,2
62295,4,2,217741,217741,217743,0,2,1
62296,1,3,217742,217743,217746,1,4,0
62297,6,2,217748,217748,217750,0,2,2
62298,5,3,217753,217753,217756,0,3,3
62299,3,2,217756,217756,217758,0,2,0
62300,3,2,217759,217759,217761,0,2,1
62301,6,1,217765,217765,217766,0,1,4
62302,1,1,217766,217766,217767,0,1,0
62303,1,2,217767,217767,217769,0,2,0
62304,3,2,217770,217770,217772,0,2,1
62305,3,2,217773,217773,217775,0,2,1
62306,6,3,217779,217779,217782,0,3,4
62307,5,1,217784,217784,217785,0,1,2
62308,3,3,217787,217787,217790,0,3,2
62309,4,1,217791,217791,217792,0,1,1
62310,2,3,217793,217793,217796,0,3,1
62311,5,2,217798,217798,217800,0,2,2
62312,2,3,217800,217800,217803,0,3,0
62313,1,2,217801,217803,217805,2,4,0
62314,1,1,217802,217805,217806,3,4,0
62315,6,1,217808,217808,217809,0,1,2
62316,2,2,217810,217810,217812,0,2,1
62317,6,1,217816,217816,217817,0,1,4
62318,4,2,217820,217820,217822,0,2,3
62319,6,1,217826,217826,217827,0,1,4
62320,5,2,217831,217831,217833,0,2,4
62321,3,3,217834,217834,217837,0,3,1
62322,2,2,217836,217837,217839,1,3,0
62323,6,2,217842,217842,217844,0,2,3
62324,1,1,217843,217844,217845,1,2,0
62325,3,1,217846,217846,217847,0,1,1
62326,1,2,217847,217847,217849,0,2,0
62327,1,3,217848,217849,217852,1,4,0
62328,3,1,217851,217852,217853,1,2,0
62329,2,2,217853,217853,217855,0,2,0
62330,4,1,217857,217857,217858,0,1,2
62331,4,1,217861,217861,217862,0,1,3
62332,5,3,217866,217866,217869,0,3,4
62333,4,3,217870,217870,217873,0,3,1
62334,6,3,217876,217876,217879,0,3,3
62335,2,2,217878,217879,217881,1,3,0
62336,5,3,217883,217883,217886,0,3,2
62337,1,1,217884,217886,217887,2,3,0
62338,1,2,217885,217887,217889,2,4,0
62339,6,3,217891,217891,217894,0,3,2
62340,1,3,217892,217894,217897,2,5,0
62341,6,1,217898,217898,217899,0,1,1
62342,1,3,217899,217899,217902,0,3,0
62343,3,2,217902,217902,217904,0,2,0
62344,1,1,217903,217904,217905,1,2,0
62345,3,1,217906,217906,217907,0,1,1
62346,3,1,217909,217909,217910,0,1,2
62347,3,1,217912,217912,217913,0,1,2
62348,5,2,217917,217917,217919,0,2,4
62349,4,3,217921,217921,217924,0,3,2
62350,1,3,217922,217924,217927,2,5,0
62351,4,2,217926,217927,217929,1,3,0
62352,5,2,217931,217931,217933,0,2,2
62353,3,1,217934,217934,217935,0,1,1
62354,6,1,217940,217940,217941,0,1,5
62355,1,2,217941,217941,217943,0,2,0
62356,5,2,217946,217946,217948,0,2,3
62357,2,1,217948,217948,217949,0,1,0
62358,4,3,217952,217952,217955,0,3,3
62359,4,1,217956,217956,217957,0,1,1
62360,6,3,217962,217962,217965,0,3,5
62361,1,3,217963,217965,217968,2,5,0
62362,1,3,217964,217968,217971,4,7,0
62363,2,2,217966,217971,217973,5,7,0
62364,6,1,217972,217973,217974,1,2,0
62365,2,2,217974,217974,217976,0,2,0
62366,5,3,217979,217979,217982,0,3,3
62367,2,3,217981,217982,217985,1,4,0
62368,1,1,217982,217985,217986,3,4,0
62369,5,2,217987,217987,217989,0,2,1
62370,5,1,217992,217992,217993,0,1,3
62371,6,3,217998,217998,218001,0,3,5
62372,1,3,217999,218001,218004,2,5,0
62373,6,2,218005,218005,218007,0,2,1
62374,6,1,218011,218011,218012,0,1,4
62375,5,3,218016,218016,218019,0,3,4
62376,3,1,218019,218019,218020,0,1,0
62377,3,2,218022,218022,218024,0,2,2
62378,2,2,218024,218024,218026,0,2,0
62379,6,3,218030,218030,218033,0,3,4
62380,5,3,218035,218035,218038,0,3,2
62381,5,3,218040,218040,218043,0,3,2
62382,6,3,218046,218046,218049,0,3,3
62383,6,2,218052,218052,218054,0,2,3
62384,6,2,218058,218058,218060,0,2,4
62385,6,1,218064,218064,218065,0,1,4
62386,3,1,218067,218067,218068,0,1,2
62387,6,1,218073,218073,218074,0,1,5
62388,2,1,218075,218075,218076,0,1,1
62389,3,1,218078,218078,218079,0,1,2
62390,2,3,218080,218080,218083,0,3,1
62391,2,3,218082,218083,218086,1,4,0
62392,6,2,218088,218088,218090,0,2,2
62393,2,3,218090,218090,218093,0,3,0
62394,4,2,218094,218094,218096,0,2,1
62395,1,3,218095,218096,218099,1,4,0
62396,6,1,218101,218101,218102,0,1,2
62397,1,3,218102,218102,218105,0,3,0
62398,6,1,218108,218108,218109,0,1,3
62399,6,1,218114,218114,218115,0,1,5
62400,3,1,218117,218117,218118,0,1,2
62401,3,1,218120,218120,218121,0,1,2
62402,6,3,218126,218126,218129,0,3,5
62403,6,3,218132,218132,218135,0,3,3
62404,2,1,218134,218135,218136,1,2,0
62405,5,3,218139,218139,218142,0,3,3
62406,1,3,218140,218142,218145,2,5,0
62407,1,2,218141,218145,218147,4,6,0
62408,3,1,218144,218147,218148,3,4,0
62409,6,3,218150,218150,218153,0,3,2
62410,2,3,218152,218153,218156,1,4,0
62411,5,2,218157,218157,218159,0,2,1
62412,5,3,218162,218162,218165,0,3,3
62413,4,2,218166,218166,218168,0,2,1
62414,3,1,218169,218169,218170,0,1,1
62415,5,2,218174,218174,218176,0,2,4
62416,4,3,218178,218178,218181,0,3,2
62417,5,2,218183,218183,218185,0,2,2
62418,3,1,218186,218186,218187,0,1,1
62419,6,3,218192,218192,218195,0,3,5
62420,5,1,218197,218197,218198,0,1,2
62421,6,1,218203,218203,218204,0,1,5
62422,1,2,218204,218204,218206,0,2,0
62423,2,1,218206,218206,218207,0,1,0
62424,1,3,218207,218207,218210,0,3,0
62425,5,2,218212,218212,218214,0,2,2
62426,2,2,218214,218214,218216,0,2,0
62427,5,3,218219,218219,218222,0,3,3
62428,4,2,218223,218223,218225,0,2,1
62429,3,3,218226,218226,218229,0,3,1
62430,1,2,218227,218229,218231,2,4,0
62431,6,3,218233,218233,218236,0,3,2
62432,1,1,218234,218236,218237,2,3,0
62433,5,2,218239,218239,218241,0,2,2
62434,4,2,218243,218243,218245,0,2,2
62435,4,3,218247,218247,218250,0,3,2
62436,3,3,218250,218250,218253,0,3,0
62437,3,1,218253,218253,218254,0,1,0
62438,2,2,218255,218255,218257,0,2,1
62439,4,2,218259,218259,218261,0,2,2
62440,4,1,218263,218263,218264,0,1,2
62441,1,2,218264,218264,218266,0,2,0
62442,6,1,218270,218270,218271,0,1,4
62443,1,1,218271,218271,218272,0,1,0
62444,6,3,218277,218277,218280,0,3,5
62445,2,2,218279,218280,218282,1,3,0
62446,2,3,218281,218282,218285,1,4,0
62447,6,2,218287,218287,218289,0,2,2
62448,3,1,218290,218290,218291,0,1,1
62449,4,2,218294,218294,218296,0,2,3
62450,1,2,218295,218296,218298,1,3,0
62451,4,3,218299,218299,218302,0,3,1
62452,3,3,218302,218302,218305,0,3,0
62453,6,3,218308,218308,218311,0,3,3
62454,5,2,218313,218313,218315,0,2,2
62455,2,3,218315,218315,218318,0,3,0
62456,4,1,218319,218319,218320,0,1,1
62457,4,2,218323,218323,218325,0,2,3
62458,4,2,218327,218327,218329,0,2,2
62459,6,3,218333,218333,218336,0,3,4
62460,4,3,218337,218337,218340,0,3,1
62461,1,1,218338,218340,218341,2,3,0
62462,3,2,218341,218341,218343,0,2,0
62463,4,1,218345,218345,218346,0,1,2
62464,4,2,218349,218349,218351,0,2,3
62465,1,3,218350,218351,218354,1,4,0
62466,4,2,218354,218354,218356,0,2,0
62467,3,2,218357,218357,218359,0,2,1
62468,4,3,218361,218361,218364,0,3,2
62469,6,2,218367,218367,218369,0,2,3
62470,2,1,218369,218369,218370,0,1,0
62471,4,2,218373,218373,218375,0,2,3
62472,2,3,218375,218375,218378,0,3,0
62473,4,1,218379,218379,218380,0,1,1
62474,2,3,218381,218381,218384,0,3,1
62475,6,3,218387,218387,218390,0,3,3
62476,3,2,218390,218390,218392,0,2,0
62477,6,1,218396,218396,218397,0,1,4
62478,1,1,218397,218397,218398,0,1,0
62479,6,3,218403,218403,218406,0,3,5
62480,4,3,218407,218407,218410,0,3,1
62481,1,3,218408,218410,218413,2,5,0
62482,3,1,218411,218413,218414,2,3,0
62483,5,3,218416,218416,218419,0,3,2
62484,4,1,218420,218420,218421,0,1,1
62485,4,1,218424,218424,218425,0,1,3
62486,5,1,218429,218429,218430,0,1,4
62487,6,1,218435,218435,218436,0,1,5
62488,2,1,218437,218437,218438,0,1,1
62489,2,2,218439,218439,218441,0,2,1
62490,4,3,218443,218443,218446,0,3,2
62491,1,2,218444,218446,218448,2,4,0
62492,3,2,218447,218448,218450,1,3,0
62493,4,3,218451,218451,218454,0,3,1
62494,5,2,218456,218456,218458,0,2,2
62495,5,3,218461,218461,218464,0,3,3
62496,5,3,218466,218466,218469,0,3,2
62497,3,1,218469,218469,218470,0,1,0
62498,5,3,218474,218474,218477,0,3,4
62499,2,1,218476,218477,218478,1,2,0
62500,4,3,218480,218480,218483,0,3,2
62501,1,2,218481,218483,218485,2,4,0
62502,5,2,218486,218486,218488,0,2,1
62503,2,2,218488,218488,218490,0,2,0
62504,1,2,218489,218490,218492,1,3,0
62505,6,2,218495,218495,218497,0,2,3
62506,6,3,218501,218501,218504,0,3,4
62507,4,2,218505,218505,218507,0,2,1
62508,2,2,218507,218507,218509,0,2,0
62509,2,2,218509,218509,218511,0,2,0
62510,5,1,218514,218514,218515,0,1,3
62511,6,1,218520,218520,218521,0,1,5
62512,4,2,218524,218524,218526,0,2,3
62513,6,3,218530,218530,218533,0,3,4
62514,1,1,218531,218533,218534,2,3,0
62515,1,1,218532,218534,218535,2,3,0
62516,4,2,218536,218536,218538,0,2,1
62517,5,1,218541,218541,218542,0,1,3
62518,6,3,218547,218547,218550,0,3,5
62519,6,3,218553,218553,218556,0,3,3
62520,2,1,218555,218556,218557,1,2,0
62521,4,1,218559,218559,218560,0,1,2
62522,3,1,218562,218562,218563,0,1,2
62523,4,2,218566,218566,218568,0,2,3
62524,4,1,218570,218570,218571,0,1,2
62525,3,2,218573,218573,218575,0,2,2
62526,6,3,218579,218579,218582,0,3,4
62527,1,3,218580,218582,218585,2,5,0
62528,3,3,218583,218585,218588,2,5,0
62529,5,2,218588,218588,218590,0,2,0
62530,2,2,218590,218590,218592,0,2,0
62531,5,1,218595,218595,218596,0,1,3
62532,3,3,218598,218598,218601,0,3,2
62533,1,2,218599,218601,218603,2,4,0
62534,6,1,218605,218605,218606,0,1,2
62535,5,2,218610,218610,218612,0,2,4
62536,1,1,218611,218612,218613,1,2,0
62537,1,1,218612,218613,218614,1,2,0
62538,1,1,218613,218614,218615,1,2,0
62539,1,2,218614,218615,218617,1,3,0
62540,1,3,218615,218617,218620,2,5,0
62541,6,1,218621,218621,218622,0,1,1
62542,6,1,218627,218627,218628,0,1,5
62543,1,3,218628,218628,218631,0,3,0
62544,3,1,218631,218631,218632,0,1,0
62545,1,2,218632,218632,218634,0,2,0
62546,3,1,218635,218635,218636,0,1,1
62547,1,3,218636,218636,218639,0,3,0
62548,5,2,218641,218641,218643,0,2,2
62549,6,3,218647,218647,218650,0,3,4
62550,6,3,218653,218653,218656,0,3,3
62551,5,1,218658,218658,218659,0,1,2
62552,6,1,218664,218664,218665,0,1,5
62553,3,3,218667,218667,218670,0,3,2
62554,5,1,218672,218672,218673,0,1,2
62555,3,3,218675,218675,218678,0,3,2
62556,5,1,218680,218680,218681,0,1,2
62557,2,3,218682,218682,218685,0,3,1
62558,6,2,218688,218688,218690,0,2,3
62559,3,2,218691,218691,218693,0,2,1
62560,2,1,218693,218693,218694,0,1,0
62561,5,2,218698,218698,218700,0,2,4
62562,3,1,218701,218701,218702,0,1,1
62563,5,3,218706,218706,218709,0,3,4
62564,5,2,218711,218711,218713,0,2,2
62565,1,2,218712,218713,218715,1,3,0
62566,4,1,218716,218716,218717,0,1,1
62567,3,1,218719,218719,218720,0,1,2
62568,6,3,218725,218725,218728,0,3,5
62569,3,2,218728,218728,218730,0,2,0
62570,1,1,218729,218730,218731,1,2,0
62571,2,1,218731,218731,218732,0,1,0
62572,2,3,218733,218733,218736,0,3,1
62573,6,3,218739,218739,218742,0,3,3
62574,4,3,218743,218743,218746,0,3,1
62575,4,3,218747,218747,218750,0,3,1
62576,1,3,218748,218750,218753,2,5,0
62577,1,3,218749,218753,218756,4,7,0
62578,5,1,218754,218756,218757,2,3,0
62579,6,2,218760,218760,218762,0,2,3
62580,6,3,218766,218766,218769,0,3,4
62581,6,2,218772,218772,218774,0,2,3
62582,5,2,218777,218777,218779,0,2,3
62583,4,2,218781,218781,218783,0,2,2
62584,1,3,218782,218783,218786,1,4,0
62585,1,1,218783,218786,218787,3,4,0
62586,3,1,218786,218787,218788,1,2,0
62587,3,1,218789,218789,218790,0,1,1
62588,5,2,218794,218794,218796,0,2,4
62589,4,3,218798,218798,218801,0,3,2
62590,2,1,218800,218801,218802,1,2,0
62591,3,2,218803,218803,218805,0,2,1
62592,4,2,218807,218807,218809,0,2,2
62593,6,2,218813,218813,218815,0,2,4
62594,2,1,218815,218815,218816,0,1,0
62595,4,3,218819,218819,218822,0,3,3
62596,1,2,218820,218822,218824,2,4,0
62597,5,1,218825,218825,218826,0,1,1
62598,5,2,218830,218830,218832,0,2,4
62599,2,2,218832,218832,218834,0,2,0
62600,3,3,218835,218835,218838,0,3,1
62601,4,1,218839,218839,218840,0,1,1
62602,4,2,218843,218843,218845,0,2,3
62603,6,2,218849,218849,218851,0,2,4
62604,2,1,218851,218851,218852,0,1,0
62605,1,3,218852,218852,218855,0,3,0
62606,3,3,218855,218855,218858,0,3,0
62607,3,1,218858,218858,218859,0,1,0
62608,4,1,218862,218862,218863,0,1,3
62609,4,1,218866,218866,218867,0,1,3
62610,4,2,218870,218870,218872,0,2,3
62611,2,2,218872,218872,218874,0,2,0
62612,4,3,218876,218876,218879,0,3,2
62613,6,2,218882,218882,218884,0,2,3
62614,4,3,218886,218886,218889,0,3,2
62615,6,3,218892,218892,218895,0,3,3
62616,2,3,218894,218895,218898,1,4,0
62617,5,3,218899,218899,218902,0,3,1
62618,1,2,218900,218902,218904,2,4,0
62619,2,1,218902,218904,218905,2,3,0
62620,2,3,218904,218905,218908,1,4,0
62621,6,2,218910,218910,218912,0,2,2
62622,2,1,218912,218912,218913,0,1,0
62623,1,2,218913,218913,218915,0,2,0
62624,2,3,218915,218915,218918,0,3,0
62625,4,1,218919,218919,218920,0,1,1
62626,1,1,218920,218920,218921,0,1,0
62627,4,3,218924,218924,218927,0,3,3
62628,3,1,218927,218927,218928,0,1,0
62629,6,2,218933,218933,218935,0,2,5
62630,4,1,218937,218937,218938,0,1,2
62631,5,3,218942,218942,218945,0,3,4
62632,1,1,218943,218945,218946,2,3,0
62633,5,2,218948,218948,218950,0,2,2
62634,5,2,218953,218953,218955,0,2,3
62635,2,1,218955,218955,218956,0,1,0
62636,3,3,218958,218958,218961,0,3,2
62637,6,1,218964,218964,218965,0,1,3
62638,5,1,218969,218969,218970,0,1,4
62639,4,2,218973,218973,218975,0,2,3
62640,5,2,218978,218978,218980,0,2,3
62641,3,2,218981,218981,218983,0,2,1
62642,4,1,218985,218985,218986,0,1,2
62643,5,1,218990,218990,218991,0,1,4
62644,5,1,218995,218995,218996,0,1,4
62645,6,2,219001,219001,219003,0,2,5
62646,4,2,219005,219005,219007,0,2,2
62647,1,3,219006,219007,219010,1,4,0
62648,5,3,219011,219011,219014,0,3,1
62649,6,1,219017,219017,219018,0,1,3
62650,2,1,219019,219019,219020,0,1,1
62651,6,3,219025,219025,219028,0,3,5
62652,6,1,219031,219031,219032,0,1,3
62653,4,2,219035,219035,219037,0,2,3
62654,5,3,219040,219040,219043,0,3,3
62655,6,3,219046,219046,219049,0,3,3
62656,5,1,219051,219051,219052,0,1,2
62657,2,3,219053,219053,219056,0,3,1
62658,2,3,219055,219056,219059,1,4,0
62659,6,1,219061,219061,219062,0,1,2
62660,3,1,219064,219064,219065,0,1,2
62661,2,1,219066,219066,219067,0,1,1
62662,1,1,219067,219067,219068,0,1,0
62663,6,2,219073,219073,219075,0,2,5
62664,1,1,219074,219075,219076,1,2,0
62665,3,2,219077,219077,219079,0,2,1
62666,4,3,219081,219081,219084,0,3,2
62667,5,2,219086,219086,219088,0,2,2
62668,6,1,219092,219092,219093,0,1,4
62669,4,3,219096,219096,219099,0,3,3
62670,6,2,219102,219102,219104,0,2,3
62671,6,1,219108,219108,219109,0,1,4
62672,1,3,219109,219109,219112,0,3,0
62673,1,2,219110,219112,219114,2,4,0
62674,2,1,219112,219114,219115,2,3,0
62675,5,2,219117,219117,219119,0,2,2
62676,4,3,219121,219121,219124,0,3,2
62677,5,2,219126,219126,219128,0,2,2
62678,5,1,219131,219131,219132,0,1,3
62679,1,2,219132,219132,219134,0,2,0
62680,1,3,219133,219134,219137,1,4,0
62681,6,3,219139,219139,219142,0,3,2
62682,3,3,219142,219142,219145,0,3,0
62683,6,2,219148,219148,219150,0,2,3
62684,2,3,219150,219150,219153,0,3,0
62685,3,3,219153,219153,219156,0,3,0
62686,3,3,219156,219156,219159,0,3,0
62687,4,3,219160,219160,219163,0,3,1
62688,4,3,219164,219164,219167,0,3,1
62689,1,2,219165,219167,219169,2,4,0
62690,2,2,219167,219169,219171,2,4,0
62691,5,2,219172,219172,219174,0,2,1
62692,4,1,219176,219176,219177,0,1,2
62693,1,2,219177,219177,219179,0,2,0
62694,4,2,219181,219181,219183,0,2,2
62695,3,1,219184,219184,219185,0,1,1
62696,5,2,219189,219189,219191,0,2,4
62697,6,1,219195,219195,219196,0,1,4
62698,3,3,219198,219198,219201,0,3,2
62699,2,2,219200,219201,219203,1,3,0
62700,6,1,219206,219206,219207,0,1,3
62701,1,2,219207,219207,219209,0,2,0
62702,3,1,219210,219210,219211,0,1,1
62703,3,2,219213,219213,219215,0,2,2
62704,4,1,219217,219217,219218,0,1,2
62705,3,3,219220,219220,219223,0,3,2
62706,3,2,219223,219223,219225,0,2,0
62707,4,2,219227,219227,219229,0,2,2
62708,5,1,219232,219232,219233,0,1,3
62709,5,2,219237,219237,219239,0,2,4
62710,1,3,219238,219239,219242,1,4,0
62711,1,3,219239,219242,219245,3,6,0
62712,1,3,219240,219245,219248,5,8,0
62713,5,2,219245,219248,219250,3,5,0
62714,3,1,219248,219250,219251,2,3,0
62715,1,2,219249,219251,219253,2,4,0
62716,6,2,219255,219255,219257,0,2,2
62717,1,2,219256,219257,219259,1,3,0
62718,1,1,219257,219259,219260,2,3,0
62719,5,2,219262,219262,219264,0,2,2
62720,1,1,219263,219264,219265,1,2,0
62721,4,3,219267,219267,219270,0,3,2
62722,6,1,219273,219273,219274,0,1,3
62723,3,2,219276,219276,219278,0,2,2
62724,1,3,219277,219278,219281,1,4,0
62725,3,2,219280,219281,219283,1,3,0
62726,6,2,219286,219286,219288,0,2,3
62727,1,1,219287,219288,219289,1,2,0
62728,6,2,219293,219293,219295,0,2,4
62729,2,3,219295,219295,219298,0,3,0
62730,4,1,219299,219299,219300,0,1,1
62731,1,2,219300,219300,219302,0,2,0
62732,4,2,219304,219304,219306,0,2,2
62733,3,1,219307,219307,219308,0,1,1
62734,3,1,219310,219310,219311,0,1,2
62735,4,3,219314,219314,219317,0,3,3
62736,3,2,219317,219317,219319,0,2,0
62737,5,3,219322,219322,219325,0,3,3
62738,3,1,219325,219325,219326,0,1,0
62739,3,3,219328,219328,219331,0,3,2
62740,1,1,219329,219331,219332,2,3,0
62741,3,3,219332,219332,219335,0,3,0
62742,2,1,219334,219335,219336,1,2,0
62743,4,2,219338,219338,219340,0,2,2
62744,6,2,219344,219344,219346,0,2,4
62745,3,1,219347,219347,219348,0,1,1
62746,1,1,219348,219348,219349,0,1,0
62747,2,2,219350,219350,219352,0,2,1
62748,3,3,219353,219353,219356,0,3,1
62749,2,3,219355,219356,219359,1,4,0
62750,4,2,219359,219359,219361,0,2,0
62751,5,3,219364,219364,219367,0,3,3
62752,4,2,219368,219368,219370,0,2,1
62753,5,3,219373,219373,219376,0,3,3
62754,1,2,219374,219376,219378,2,4,0
62755,4,1,219378,219378,219379,0,1,0
62756,5,3,219383,219383,219386,0,3,4
62757,5,3,219388,219388,219391,0,3,2
62758,2,1,219390,219391,219392,1,2,0
62759,3,3,219393,219393,219396,0,3,1
62760,1,2,219394,219396,219398,2,4,0
62761,5,2,219399,219399,219401,0,2,1
62762,2,1,219401,219401,219402,0,1,0
62763,1,1,219402,219402,219403,0,1,0
62764,2,3,219404,219404,219407,0,3,1
62765,5,2,219409,219409,219411,0,2,2
62766,1,1,219410,219411,219412,1,2,0
62767,1,1,219411,219412,219413,1,2,0
62768,5,2,219416,219416,219418,0,2,3
62769,5,1,219421,219421,219422,0,1,3
62770,4,3,219425,219425,219428,0,3,3
62771,6,2,219431,219431,219433,0,2,3
62772,4,2,219435,219435,219437,0,2,2
62773,3,2,219438,219438,219440,0,2,1
62774,4,3,219442,219442,219445,0,3,2
62775,5,1,219447,219447,219448,0,1,2
62776,1,3,219448,219448,219451,0,3,0
62777,5,1,219453,219453,219454,0,1,2
62778,1,2,219454,219454,219456,0,2,0
62779,6,1,219460,219460,219461,0,1,4
62780,2,3,219462,219462,219465,0,3,1
62781,6,3,219468,219468,219471,0,3,3
62782,1,1,219469,219471,219472,2,3,0
62783,2,2,219471,219472,219474,1,3,0
62784,5,3,219476,219476,219479,0,3,2
62785,6,3,219482,219482,219485,0,3,3
62786,1,2,219483,219485,219487,2,4,0
62787,2,2,219485,219487,219489,2,4,0
62788,6,2,219491,219491,219493,0,2,2
62789,4,3,219495,219495,219498,0,3,2
62790,3,1,219498,219498,219499,0,1,0
62791,5,2,219503,219503,219505,0,2,4
62792,1,2,219504,219505,219507,1,3,0
62793,4,1,219508,219508,219509,0,1,1
62794,5,2,219513,219513,219515,0,2,4
62795,1,1,219514,219515,219516,1,2,0
62796,5,1,219519,219519,219520,0,1,3
62797,6,1,219525,219525,219526,0,1,5
62798,4,2,219529,219529,219531,0,2,3
62799,2,3,219531,219531,219534,0,3,0
62800,3,2,219534,219534,219536,0,2,0
62801,5,3,219539,219539,219542,0,3,3
62802,3,2,219542,219542,219544,0,2,0
62803,6,1,219548,219548,219549,0,1,4
62804,4,1,219552,219552,219553,0,1,3
62805,4,3,219556,219556,219559,0,3,3
62806,1,3,219557,219559,219562,2,5,0
62807,4,2,219561,219562,219564,1,3,0
62808,4,2,219565,219565,219567,0,2,1
62809,4,1,219569,219569,219570,0,1,2
62810,1,2,219570,219570,219572,0,2,0
62811,4,1,219574,219574,219575,0,1,2
62812,6,1,219580,219580,219581,0,1,5
62813,5,2,219585,219585,219587,0,2,4
62814,4,1,219589,219589,219590,0,1,2
62815,1,1,219590,219590,219591,0,1,0
62816,4,3,219594,219594,219597,0,3,3
62817,5,3,219599,219599,219602,0,3,2
62818,6,3,219605,219605,219608,0,3,3
62819,6,1,219611,219611,219612,0,1,3
62820,6,3,219617,219617,219620,0,3,5
62821,5,2,219622,219622,219624,0,2,2
62822,4,1,219626,219626,219627,0,1,2
62823,3,2,219629,219629,219631,0,2,2
62824,1,2,219630,219631,219633,1,3,0
62825,4,1,219634,219634,219635,0,1,1
62826,6,2,219640,219640,219642,0,2,5
62827,5,2,219645,219645,219647,0,2,3
62828,4,3,219649,219649,219652,0,3,2
62829,6,1,219655,219655,219656,0,1,3
62830,4,2,219659,219659,219661,0,2,3
62831,4,3,219663,219663,219666,0,3,2
62832,4,1,219667,219667,219668,0,1,1
62833,2,2,219669,219669,219671,0,2,1
62834,6,3,219675,219675,219678,0,3,4
62835,4,2,219679,219679,219681,0,2,1
62836,5,2,219684,219684,219686,0,2,3
62837,6,2,219690,219690,219692,0,2,4
62838,3,1,219693,219693,219694,0,1,1
62839,1,3,219694,219694,219697,0,3,0
62840,6,1,219700,219700,219701,0,1,3
62841,1,1,219701,219701,219702,0,1,0
62842,1,3,219702,219702,219705,0,3,0
62843,5,3,219707,219707,219710,0,3,2
62844,6,3,219713,219713,219716,0,3,3
62845,4,2,219717,219717,219719,0,2,1
62846,6,2,219723,219723,219725,0,2,4
62847,6,3,219729,219729,219732,0,3,4
62848,1,1,219730,219732,219733,2,3,0
62849,4,1,219734,219734,219735,0,1,1
62850,2,1,219736,219736,219737,0,1,1
62851,4,1,219740,219740,219741,0,1,3
62852,2,2,219742,219742,219744,0,2,1
62853,4,3,219746,219746,219749,0,3,2
62854,2,3,219748,219749,219752,1,4,0
62855,4,3,219752,219752,219755,0,3,0
62856,3,2,219755,219755,219757,0,2,0
62857,3,3,219758,219758,219761,0,3,1
62858,2,2,219760,219761,219763,1,3,0
62859,2,2,219762,219763,219765,1,3,0
62860,3,2,219765,219765,219767,0,2,0
62861,4,3,219769,219769,219772,0,3,2
62862,2,1,219771,219772,219773,1,2,0
62863,6,3,219777,219777,219780,0,3,4
62864,3,1,219780,219780,219781,0,1,0
62865,2,3,219782,219782,219785,0,3,1
62866,1,2,219783,219785,219787,2,4,0
62867,4,2,219787,219787,219789,0,2,0
62868,2,3,219789,219789,219792,0,3,0
62869,3,1,219792,219792,219793,0,1,0
62870,1,3,219793,219793,219796,0,3,0
62871,6,3,219799,219799,219802,0,3,3
62872,2,2,219801,219802,219804,1,3,0
62873,4,1,219805,219805,219806,0,1,1
62874,2,2,219807,219807,219809,0,2,1
62875,3,2,219810,219810,219812,0,2,1
62876,3,3,219813,219813,219816,0,3,1
62877,6,2,219819,219819,219821,0,2,3
62878,3,1,219822,219822,219823,0,1,1
62879,3,1,219825,219825,219826,0,1,2
62880,1,1,219826,219826,219827,0,1,0
62881,2,2,219828,219828,219830,0,2,1
62882,4,3,219832,219832,219835,0,3,2
62883,6,2,219838,219838,219840,0,2,3
62884,4,3,219842,219842,219845,0,3,2
62885,4,1,219846,219846,219847,0,1,1
62886,6,1,219852,219852,219853,0,1,5
62887,4,3,219856,219856,219859,0,3,3
62888,1,2,219857,219859,219861,2,4,0
62889,1,1,219858,219861,219862,3,4,0
62890,3,3,219861,219862,219865,1,4,0
62891,2,1,219863,219865,219866,2,3,0
62892,1,1,219864,219866,219867,2,3,0
62893,1,1,219865,219867,219868,2,3,0
62894,6,2,219871,219871,219873,0,2,3
62895,4,1,219875,219875,219876,0,1,2
62896,5,3,219880,219880,219883,0,3,4
62897,5,1,219885,219885,219886,0,1,2
62898,1,1,219886,219886,219887,0,1,0
62899,5,3,219891,219891,219894,0,3,4
62900,5,1,219896,219896,219897,0,1,2
62901,6,2,219902,219902,219904,0,2,5
62902,1,2,219903,219904,219906,1,3,0
62903,3,2,219906,219906,219908,0,2,0
62904,6,3,219912,219912,219915,0,3,4
62905,4,3,219916,219916,219919,0,3,1
62906,1,2,219917,219919,219921,2,4,0
62907,2,3,219919,219921,219924,2,5,0
62908,2,1,219921,219924,219925,3,4,0
62909,4,2,219925,219925,219927,0,2,0
62910,2,2,219927,219927,219929,0,2,0
62911,4,2,219931,219931,219933,0,2,2
62912,4,2,219935,219935,219937,0,2,2
62913,3,3,219938,219938,219941,0,3,1
62914,4,2,219942,219942,219944,0,2,1
62915,5,2,219947,219947,219949,0,2,3
62916,3,2,219950,219950,219952,0,2,1
62917,5,3,219955,219955,219958,0,3,3
62918,4,3,219959,219959,219962,0,3,1
62919,2,2,219961,219962,219964,1,3,0
62920,6,3,219967,219967,219970,0,3,3
62921,2,3,219969,219970,219973,1,4,0
62922,6,1,219975,219975,219976,0,1,2
62923,5,2,219980,219980,219982,0,2,4
62924,4,2,219984,219984,219986,0,2,2
62925,3,1,219987,219987,219988,0,1,1
62926,1,3,219988,219988,219991,0,3,0
62927,6,1,219994,219994,219995,0,1,3
62928,6,1,220000,220000,220001,0,1,5
62929,2,3,220002,220002,220005,0,3,1
62930,3,1,220005,220005,220006,0,1,0
62931,1,1,220006,220006,220007,0,1,0
62932,3,2,220009,220009,220011,0,2,2
62933,6,2,220015,220015,220017,0,2,4
62934,2,2,220017,220017,220019,0,2,0
62935,3,2,220020,220020,220022,0,2,1
62936,3,2,220023,220023,220025,0,2,1
62937,2,1,220025,220025,220026,0,1,0
62938,6,1,220031,220031,220032,0,1,5
62939,5,2,220036,220036,220038,0,2,4
62940,6,3,220042,220042,220045,0,3,4
62941,6,3,220048,220048,220051,0,3,3
62942,3,1,220051,220051,220052,0,1,0
62943,5,2,220056,220056,220058,0,2,4
62944,2,2,220058,220058,220060,0,2,0
62945,3,1,220061,220061,220062,0,1,1
62946,6,3,220067,220067,220070,0,3,5
62947,2,2,220069,220070,220072,1,3,0
62948,1,3,220070,220072,220075,2,5,0
62949,4,3,220074,220075,220078,1,4,0
62950,5,2,220079,220079,220081,0,2,1
62951,2,2,220081,220081,220083,0,2,0
62952,3,3,220084,220084,220087,0,3,1
62953,6,2,220090,220090,220092,0,2,3
62954,2,1,220092,220092,220093,0,1,0
62955,2,2,220094,220094,220096,0,2,1
62956,2,1,220096,220096,220097,0,1,0
62957,4,2,220100,220100,220102,0,2,3
62958,3,1,220103,220103,220104,0,1,1
62959,6,1,220109,220109,220110,0,1,5
62960,3,2,220112,220112,220114,0,2,2
62961,3,3,220115,220115,220118,0,3,1
62962,6,2,220121,220121,220123,0,2,3
62963,1,3,220122,220123,220126,1,4,0
62964,4,3,220126,220126,220129,0,3,0
62965,4,2,220130,220130,220132,0,2,1
62966,6,2,220136,220136,220138,0,2,4
62967,5,1,220141,220141,220142,0,1,3
62968,3,2,220144,220144,220146,0,2,2
62969,5,1,220149,220149,220150,0,1,3
62970,5,3,220154,220154,220157,0,3,4
62971,1,2,220155,220157,220159,2,4,0
62972,4,2,220159,220159,220161,0,2,0
62973,6,2,220165,220165,220167,0,2,4
62974,1,1,220166,220167,220168,1,2,0
62975,2,1,220168,220168,220169,0,1,0
62976,2,3,220170,220170,220173,0,3,1
62977,1,3,220171,220173,220176,2,5,0
62978,4,3,220175,220176,220179,1,4,0
62979,4,2,220179,220179,220181,0,2,0
62980,6,1,220185,220185,220186,0,1,4
62981,4,3,220189,220189,220192,0,3,3
62982,5,1,220194,220194,220195,0,1,2
62983,2,1,220196,220196,220197,0,1,1
62984,2,2,220198,220198,220200,0,2,1
62985,3,2,220201,220201,220203,0,2,1
62986,1,1,220202,220203,220204,1,2,0
62987,6,1,220208,220208,220209,0,1,4
62988,6,1,220214,220214,220215,0,1,5
62989,3,1,220217,220217,220218,0,1,2
62990,6,2,220223,220223,220225,0,2,5
62991,2,1,220225,220225,220226,0,1,0
62992,2,2,220227,220227,220229,0,2,1
62993,4,1,220231,220231,220232,0,1,2
62994,1,3,220232,220232,220235,0,3,0
62995,5,2,220237,220237,220239,0,2,2
62996,1,2,220238,220239,220241,1,3,0
62997,3,3,220241,220241,220244,0,3,0
62998,1,1,220242,220244,220245,2,3,0
62999,4,2,220246,220246,220248,0,2,1
63000,5,1,220251,220251,220252,0,1,3
63001,6,2,220257,220257,220259,0,2,5
63002,6,3,220263,220263,220266,0,3,4
63003,2,3,220265,220266,220269,1,4,0
63004,2,2,220267,220269,220271,2,4,0
63005,4,3,220271,220271,220274,0,3,0
63006,6,3,220277,220277,220280,0,3,3
63007,4,3,220281,220281,220284,0,3,1
63008,2,2,220283,220284,220286,1,3,0
63009,3,1,220286,220286,220287,0,1,0
63010,5,2,220291,220291,220293,0,2,4
63011,3,3,220294,220294,220297,0,3,1
63012,5,2,220299,220299,220301,0,2,2
63013,5,1,220304,220304,220305,0,1,3
63014,5,1,220309,220309,220310,0,1,4
63015,5,1,220314,220314,220315,0,1,4
63016,3,3,220317,220317,220320,0,3,2
63017,6,1,220323,220323,220324,0,1,3
63018,6,3,220329,220329,220332,0,3,5
63019,3,3,220332,220332,220335,0,3,0
63020,2,2,220334,220335,220337,1,3,0
63021,2,1,220336,220337,220338,1,2,0
63022,6,1,220342,220342,220343,0,1,4
63023,1,3,220343,220343,220346,0,3,0
63024,4,2,220347,220347,220349,0,2,1
63025,1,2,220348,220349,220351,1,3,0
63026,5,1,220353,220353,220354,0,1,2
63027,2,1,220355,220355,220356,0,1,1
63028,4,2,220359,220359,220361,0,2,3
63029,3,3,220362,220362,220365,0,3,1
63030,6,1,220368,220368,220369,0,1,3
63031,3,3,220371,220371,220374,0,3,2
63032,2,1,220373,220374,220375,1,2,0
63033,4,2,220377,220377,220379,0,2,2
63034,1,2,220378,220379,220381,1,3,0
63035,3,2,220381,220381,220383,0,2,0
63036,5,3,220386,220386,220389,0,3,3
63037,2,1,220388,220389,220390,1,2,0
63038,5,1,220393,220393,220394,0,1,3
63039,4,3,220397,220397,220400,0,3,3
63040,5,3,220402,220402,220405,0,3,2
63041,4,1,220406,220406,220407,0,1,1
63042,1,2,220407,220407,220409,0,2,0
63043,2,2,220409,220409,220411,0,2,0
63044,3,3,220412,220412,220415,0,3,1
63045,2,2,220414,220415,220417,1,3,0
63046,2,1,220416,220417,220418,1,2,0
63047,4,2,220420,220420,220422,0,2,2
63048,4,3,220424,220424,220427,0,3,2
63049,6,2,220430,220430,220432,0,2,3
63050,6,3,220436,220436,220439,0,3,4
63051,5,1,220441,220441,220442,0,1,2
63052,2,3,220443,220443,220446,0,3,1
63053,4,3,220447,220447,220450,0,3,1
63054,4,3,220451,220451,220454,0,3,1
63055,2,1,220453,220454,220455,1,2,0
63056,4,2,220457,220457,220459,0,2,2
63057,1,2,220458,220459,220461,1,3,0
63058,5,2,220463,220463,220465,0,2,2
63059,1,2,220464,220465,220467,1,3,0
63060,6,2,220470,220470,220472,0,2,3
63061,2,1,220472,220472,220473,0,1,0
63062,4,2,220476,220476,220478,0,2,3
63063,1,1,220477,220478,220479,1,2,0
63064,1,1,220478,220479,220480,1,2,0
63065,2,3,220480,220480,220483,0,3,0
63066,2,1,220482,220483,220484,1,2,0
63067,6,3,220488,220488,220491,0,3,4
63068,5,1,220493,220493,220494,0,1,2
63069,1,2,220494,220494,220496,0,2,0
63070,5,3,220499,220499,220502,0,3,3
63071,4,2,220503,220503,220505,0,2,1
63072,5,1,220508,220508,220509,0,1,3
63073,6,1,220514,220514,220515,0,1,5
63074,6,3,220520,220520,220523,0,3,5
63075,2,3,220522,220523,220526,1,4,0
63076,3,2,220525,220526,220528,1,3,0
63077,5,3,220530,220530,220533,0,3,2
63078,1,3,220531,220533,220536,2,5,0
63079,5,1,220536,220536,220537,0,1,0
63080,1,3,220537,220537,220540,0,3,0
63081,6,2,220543,220543,220545,0,2,3
63082,3,1,220546,220546,220547,0,1,1
63083,6,2,220552,220552,220554,0,2,5
63084,4,3,220556,220556,220559,0,3,2
63085,1,1,220557,220559,220560,2,3,0
63086,3,2,220560,220560,220562,0,2,0
63087,1,2,220561,220562,220564,1,3,0
63088,5,1,220566,220566,220567,0,1,2
63089,6,3,220572,220572,220575,0,3,5
63090,2,1,220574,220575,220576,1,2,0
63091,6,1,220580,220580,220581,0,1,4
63092,2,1,220582,220582,220583,0,1,1
63093,2,2,220584,220584,220586,0,2,1
63094,5,3,220589,220589,220592,0,3,3
63095,4,2,220593,220593,220595,0,2,1
63096,3,2,220596,220596,220598,0,2,1
63097,1,3,220597,220598,220601,1,4,0
63098,1,2,220598,220601,220603,3,5,0
63099,4,2,220602,220603,220605,1,3,0
63100,6,3,220608,220608,220611,0,3,3
63101,1,2,220609,220611,220613,2,4,0
63102,4,2,220613,220613,220615,0,2,0
63103,2,3,220615,220615,220618,0,3,0
63104,5,1,220620,220620,220621,0,1,2
63105,1,3,220621,220621,220624,0,3,0
63106,1,1,220622,220624,220625,2,3,0
63107,4,3,220626,220626,220629,0,3,1
63108,4,1,220630,220630,220631,0,1,1
63109,5,1,220635,220635,220636,0,1,4
63110,6,2,220641,220641,220643,0,2,5
63111,3,1,220644,220644,220645,0,1,1
63112,2,2,220646,220646,220648,0,2,1
63113,4,3,220650,220650,220653,0,3,2
63114,6,1,220656,220656,220657,0,1,3
63115,6,1,220662,220662,220663,0,1,5
63116,1,1,220663,220663,220664,0,1,0
63117,1,1,220664,220664,220665,0,1,0
63118,5,3,220669,220669,220672,0,3,4
63119,3,2,220672,220672,220674,0,2,0
63120,3,2,220675,220675,220677,0,2,1
63121,4,1,220679,220679,220680,0,1,2
63122,1,1,220680,220680,220681,0,1,0
63123,5,2,220685,220685,220687,0,2,4
63124,1,2,220686,220687,220689,1,3,0
63125,4,1,220690,220690,220691,0,1,1
63126,5,3,220695,220695,220698,0,3,4
63127,4,2,220699,220699,220701,0,2,1
63128,6,3,220705,220705,220708,0,3,4
63129,3,2,220708,220708,220710,0,2,0
63130,5,2,220713,220713,220715,0,2,3
63131,3,2,220716,220716,220718,0,2,1
63132,4,3,220720,220720,220723,0,3,2
63133,1,2,220721,220723,220725,2,4,0
63134,5,2,220726,220726,220728,0,2,1
63135,1,2,220727,220728,220730,1,3,0
63136,2,2,220729,220730,220732,1,3,0
63137,4,2,220733,220733,220735,0,2,1
63138,1,1,220734,220735,220736,1,2,0
63139,1,3,220735,220736,220739,1,4,0
63140,2,1,220737,220739,220740,2,3,0
63141,5,3,220742,220742,220745,0,3,2
63142,6,1,220748,220748,220749,0,1,3
63143,2,2,220750,220750,220752,0,2,1
63144,1,3,220751,220752,220755,1,4,0
63145,5,2,220756,220756,220758,0,2,1
63146,4,3,220760,220760,220763,0,3,2
63147,4,2,220764,220764,220766,0,2,1
63148,2,3,220766,220766,220769,0,3,0
63149,1,2,220767,220769,220771,2,4,0
63150,2,2,220769,220771,220773,2,4,0
63151,2,3,220771,220773,220776,2,5,0
63152,2,3,220773,220776,220779,3,6,0
63153,3,2,220776,220779,220781,3,5,0
63154,6,3,220782,220782,220785,0,3,1
63155,5,2,220787,220787,220789,0,2,2
63156,3,2,220790,220790,220792,0,2,1
63157,6,1,220796,220796,220797,0,1,4
63158,6,3,220802,220802,220805,0,3,5
63159,2,3,220804,220805,220808,1,4,0
63160,3,3,220807,220808,220811,1,4,0
63161,5,1,220812,220812,220813,0,1,1
63162,5,1,220817,220817,220818,0,1,4
63163,1,2,220818,220818,220820,0,2,0
63164,1,1,220819,220820,220821,1,2,0
63165,5,2,220824,220824,220826,0,2,3
63166,1,3,220825,220826,220829,1,4,0
63167,6,1,220831,220831,220832,0,1,2
63168,1,1,220832,220832,220833,0,1,0
63169,3,1,220835,220835,220836,0,1,2
63170,2,3,220837,220837,220840,0,3,1
63171,3,2,220840,220840,220842,0,2,0
63172,2,2,220842,220842,220844,0,2,0
63173,4,2,220846,220846,220848,0,2,2
63174,4,2,220850,220850,220852,0,2,2
63175,2,1,220852,220852,220853,0,1,0
63176,1,2,220853,220853,220855,0,2,0
63177,4,2,220857,220857,220859,0,2,2
63178,5,2,220862,220862,220864,0,2,3
63179,2,1,220864,220864,220865,0,1,0
63180,4,3,220868,220868,220871,0,3,3
63181,5,3,220873,220873,220876,0,3,2
63182,1,3,220874,220876,220879,2,5,0
63183,3,2,220877,220879,220881,2,4,0
63184,5,1,220882,220882,220883,0,1,1
63185,5,3,220887,220887,220890,0,3,4
63186,6,1,220893,220893,220894,0,1,3
63187,5,3,220898,220898,220901,0,3,4
63188,4,2,220902,220902,220904,0,2,1
63189,3,1,220905,220905,220906,0,1,1
63190,6,3,220911,220911,220914,0,3,5
63191,2,1,220913,220914,220915,1,2,0
63192,2,1,220915,220915,220916,0,1,0
63193,4,2,220919,220919,220921,0,2,3
63194,3,1,220922,220922,220923,0,1,1
63195,5,2,220927,220927,220929,0,2,4
63196,5,2,220932,220932,220934,0,2,3
63197,1,1,220933,220934,220935,1,2,0
63198,3,1,220936,220936,220937,0,1,1
63199,1,2,220937,220937,220939,0,2,0
63200,4,1,220941,220941,220942,0,1,2
63201,2,2,220943,220943,220945,0,2,1
63202,3,1,220946,220946,220947,0,1,1
63203,1,1,220947,220947,220948,0,1,0
63204,5,2,220952,220952,220954,0,2,4
63205,6,3,220958,220958,220961,0,3,4
63206,5,3,220963,220963,220966,0,3,2
63207,5,2,220968,220968,220970,0,2,2
63208,4,1,220972,220972,220973,0,1,2
63209,3,2,220975,220975,220977,0,2,2
63210,6,3,220981,220981,220984,0,3,4
63211,5,1,220986,220986,220987,0,1,2
63212,5,3,220991,220991,220994,0,3,4
63213,1,2,220992,220994,220996,2,4,0
63214,5,2,220997,220997,220999,0,2,1
63215,1,2,220998,220999,221001,1,3,0
63216,4,1,221002,221002,221003,0,1,1
63217,2,3,221004,221004,221007,0,3,1
63218,6,2,221010,221010,221012,0,2,3
63219,2,3,221012,221012,221015,0,3,0
63220,1,2,221013,221015,221017,2,4,0
63221,3,2,221016,221017,221019,1,3,0
63222,2,2,221018,221019,221021,1,3,0
63223,1,3,221019,221021,221024,2,5,0
63224,1,2,221020,221024,221026,4,6,0
63225,3,2,221023,221026,221028,3,5,0
63226,2,1,221025,221028,221029,3,4,0
63227,3,2,221028,221029,221031,1,3,0
63228,4,1,221032,221032,221033,0,1,1
63229,1,1,221033,221033,221034,0,1,0
63230,1,2,221034,221034,221036,0,2,0
63231,3,2,221037,221037,221039,0,2,1
63232,1,3,221038,221039,221042,1,4,0
63233,2,3,221040,221042,221045,2,5,0
63234,5,1,221045,221045,221046,0,1,0
63235,2,2,221047,221047,221049,0,2,1
63236,1,2,221048,221049,221051,1,3,0
63237,6,2,221054,221054,221056,0,2,3
63238,5,3,221059,221059,221062,0,3,3
63239,6,1,221065,221065,221066,0,1,3
63240,5,2,221070,221070,221072,0,2,4
63241,2,1,221072,221072,221073,0,1,0
63242,2,3,221074,221074,221077,0,3,1
63243,3,1,221077,221077,221078,0,1,0
63244,6,1,221083,221083,221084,0,1,5
63245,4,1,221087,221087,221088,0,1,3
63246,1,2,221088,221088,221090,0,2,0
63247,5,1,221093,221093,221094,0,1,3
63248,3,1,221096,221096,221097,0,1,2
63249,5,2,221101,221101,221103,0,2,4
63250,4,2,221105,221105,221107,0,2,2
63251,2,3,221107,221107,221110,0,3,0
63252,3,2,221110,221110,221112,0,2,0
63253,2,3,221112,221112,221115,0,3,0
63254,6,3,221118,221118,221121,0,3,3
63255,2,1,221120,221121,221122,1,2,0
63256,5,1,221125,221125,221126,0,1,3
63257,5,3,221130,221130,221133,0,3,4
63258,2,3,221132,221133,221136,1,4,0
63259,4,2,221136,221136,221138,0,2,0
63260,3,2,221139,221139,221141,0,2,1
63261,3,3,221142,221142,221145,0,3,1
63262,1,1,221143,221145,221146,2,3,0
63263,2,3,221145,221146,221149,1,4,0
63264,4,2,221149,221149,221151,0,2,0
63265,4,3,221153,221153,221156,0,3,2
63266,2,2,221155,221156,221158,1,3,0
63267,4,2,221159,221159,221161,0,2,1
63268,6,1,221165,221165,221166,0,1,4
63269,6,2,221171,221171,221173,0,2,5
63270,5,3,221176,221176,221179,0,3,3
63271,6,1,221182,221182,221183,0,1,3
63272,2,3,221184,221184,221187,0,3,1
63273,5,3,221189,221189,221192,0,3,2
63274,1,1,221190,221192,221193,2,3,0
63275,2,1,221192,221193,221194,1,2,0
63276,1,2,221193,221194,221196,1,3,0
63277,3,3,221196,221196,221199,0,3,0
63278,3,1,221199,221199,221200,0,1,0
63279,1,3,221200,221200,221203,0,3,0
63280,4,2,221204,221204,221206,0,2,1
63281,5,2,221209,221209,221211,0,2,3
63282,6,1,221215,221215,221216,0,1,4
63283,3,1,221218,221218,221219,0,1,2
63284,5,2,221223,221223,221225,0,2,4
63285,1,1,221224,221225,221226,1,2,0
63286,4,1,221228,221228,221229,0,1,2
63287,5,1,221233,221233,221234,0,1,4
63288,3,3,221236,221236,221239,0,3,2
63289,2,2,221238,221239,221241,1,3,0
63290,3,3,221241,221241,221244,0,3,0
63291,5,3,221246,221246,221249,0,3,2
63292,2,2,221248,221249,221251,1,3,0
63293,6,2,221254,221254,221256,0,2,3
63294,1,3,221255,221256,221259,1,4,0
63295,3,3,221258,221259,221262,1,4,0
63296,2,1,221260,221262,221263,2,3,0
63297,6,1,221266,221266,221267,0,1,3
63298,3,1,221269,221269,221270,0,1,2
63299,3,2,221272,221272,221274,0,2,2
63300,2,2,221274,221274,221276,0,2,0
63301,6,1,221280,221280,221281,0,1,4
63302,5,2,221285,221285,221287,0,2,4
63303,6,1,221291,221291,221292,0,1,4
63304,1,2,221292,221292,221294,0,2,0
63305,6,2,221298,221298,221300,0,2,4
63306,5,3,221303,221303,221306,0,3,3
63307,5,3,221308,221308,221311,0,3,2
63308,3,3,221311,221311,221314,0,3,0
63309,1,2,221312,221314,221316,2,4,0
63310,4,3,221316,221316,221319,0,3,0
63311,1,2,221317,221319,221321,2,4,0
63312,5,1,221322,221322,221323,0,1,1
63313,1,1,221323,221323,221324,0,1,0
63314,6,3,221329,221329,221332,0,3,5
63315,4,1,221333,221333,221334,0,1,1
63316,2,1,221335,221335,221336,0,1,1
63317,5,1,221340,221340,221341,0,1,4
63318,3,2,221343,221343,221345,0,2,2
63319,2,2,221345,221345,221347,0,2,0
63320,3,2,221348,221348,221350,0,2,1
63321,2,3,221350,221350,221353,0,3,0
63322,2,3,221352,221353,221356,1,4,0
63323,2,3,221354,221356,221359,2,5,0
63324,5,1,221359,221359,221360,0,1,0
63325,6,3,221365,221365,221368,0,3,5
63326,3,1,221368,221368,221369,0,1,0
63327,5,2,221373,221373,221375,0,2,4
63328,5,2,221378,221378,221380,0,2,3
63329,2,2,221380,221380,221382,0,2,0
63330,4,1,221384,221384,221385,0,1,2
63331,2,1,221386,221386,221387,0,1,1
63332,1,2,221387,221387,221389,0,2,0
63333,4,2,221391,221391,221393,0,2,2
63334,1,1,221392,221393,221394,1,2,0
63335,1,2,221393,221394,221396,1,3,0
63336,2,3,221395,221396,221399,1,4,0
63337,5,1,221400,221400,221401,0,1,1
63338,6,1,221406,221406,221407,0,1,5
63339,5,2,221411,221411,221413,0,2,4
63340,5,2,221416,221416,221418,0,2,3
63341,4,1,221420,221420,221421,0,1,2
63342,4,1,221424,221424,221425,0,1,3
63343,4,1,221428,221428,221429,0,1,3
63344,2,1,221430,221430,221431,0,1,1
63345,6,2,221436,221436,221438,0,2,5
63346,4,1,221440,221440,221441,0,1,2
63347,5,2,221445,221445,221447,0,2,4
63348,2,1,221447,221447,221448,0,1,0
63349,3,1,221450,221450,221451,0,1,2
63350,6,1,221456,221456,221457,0,1,5
63351,3,2,221459,221459,221461,0,2,2
63352,2,2,221461,221461,221463,0,2,0
63353,2,3,221463,221463,221466,0,3,0
63354,1,3,221464,221466,221469,2,5,0
63355,5,3,221469,221469,221472,0,3,0
63356,4,3,221473,221473,221476,0,3,1
63357,3,3,221476,221476,221479,0,3,0
63358,4,2,221480,221480,221482,0,2,1
63359,6,1,221486,221486,221487,0,1,4
63360,3,2,221489,221489,221491,0,2,2
63361,2,2,221491,221491,221493,0,2,0
63362,2,1,221493,221493,221494,0,1,0
63363,2,3,221495,221495,221498,0,3,1
63364,6,1,221501,221501,221502,0,1,3
63365,6,1,221507,221507,221508,0,1,5
63366,4,3,221511,221511,221514,0,3,3
63367,5,2,221516,221516,221518,0,2,2
63368,1,3,221517,221518,221521,1,4,0
63369,5,2,221522,221522,221524,0,2,1
63370,1,3,221523,221524,221527,1,4,0
63371,6,1,221529,221529,221530,0,1,2
63372,1,2,221530,221530,221532,0,2,0
63373,4,1,221534,221534,221535,0,1,2
63374,2,2,221536,221536,221538,0,2,1
63375,4,3,221540,221540,221543,0,3,2
63376,6,2,221546,221546,221548,0,2,3
63377,2,3,221548,221548,221551,0,3,0
63378,5,3,221553,221553,221556,0,3,2
63379,1,3,221554,221556,221559,2,5,0
63380,6,2,221560,221560,221562,0,2,1
63381,2,2,221562,221562,221564,0,2,0
63382,5,2,221567,221567,221569,0,2,3
63383,4,2,221571,221571,221573,0,2,2
63384,6,3,221577,221577,221580,0,3,4
63385,5,3,221582,221582,221585,0,3,2
63386,1,1,221583,221585,221586,2,3,0
63387,3,3,221586,221586,221589,0,3,0
63388,4,2,221590,221590,221592,0,2,1
63389,5,3,221595,221595,221598,0,3,3
63390,3,1,221598,221598,221599,0,1,0
63391,1,1,221599,221599,221600,0,1,0
63392,5,1,221604,221604,221605,0,1,4
63393,2,3,221606,221606,221609,0,3,1
63394,5,3,221611,221611,221614,0,3,2
63395,1,2,221612,221614,221616,2,4,0
63396,6,1,221618,221618,221619,0,1,2
63397,4,1,221622,221622,221623,0,1,3
63398,2,1,221624,221624,221625,0,1,1
63399,3,2,221627,221627,221629,0,2,2
63400,6,3,221633,221633,221636,0,3,4
63401,4,1,221637,221637,221638,0,1,1
63402,5,3,221642,221642,221645,0,3,4
63403,1,2,221643,221645,221647,2,4,0
63404,4,1,221647,221647,221648,0,1,0
63405,5,2,221652,221652,221654,0,2,4
63406,2,1,221654,221654,221655,0,1,0
63407,1,1,221655,221655,221656,0,1,0
63408,6,3,221661,221661,221664,0,3,5
63409,3,3,221664,221664,221667,0,3,0
63410,5,2,221669,221669,221671,0,2,2
63411,3,1,221672,221672,221673,0,1,1
63412,6,2,221678,221678,221680,0,2,5
63413,4,1,221682,221682,221683,0,1,2
63414,6,1,221688,221688,221689,0,1,5
63415,2,2,221690,221690,221692,0,2,1
63416,5,3,221695,221695,221698,0,3,3
63417,2,1,221697,221698,221699,1,2,0
63418,5,1,221702,221702,221703,0,1,3
63419,5,3,221707,221707,221710,0,3,4
63420,6,3,221713,221713,221716,0,3,3
63421,1,1,221714,221716,221717,2,3,0
63422,1,1,221715,221717,221718,2,3,0
63423,2,1,221717,221718,221719,1,2,0
63424,1,1,221718,221719,221720,1,2,0
63425,6,3,221724,221724,221727,0,3,4
63426,5,3,221729,221729,221732,0,3,2
63427,1,1,221730,221732,221733,2,3,0
63428,4,2,221734,221734,221736,0,2,1
63429,5,3,221739,221739,221742,0,3,3
63430,5,1,221744,221744,221745,0,1,2
63431,6,2,221750,221750,221752,0,2,5
63432,4,3,221754,221754,221757,0,3,2
63433,5,2,221759,221759,221761,0,2,2
63434,2,2,221761,221761,221763,0,2,0
63435,2,2,221763,221763,221765,0,2,0
63436,3,3,221766,221766,221769,0,3,1
63437,2,1,221768,221769,221770,1,2,0
63438,2,2,221770,221770,221772,0,2,0
63439,1,1,221771,221772,221773,1,2,0
63440,1,3,221772,221773,221776,1,4,0
63441,4,1,221776,221776,221777,0,1,0
63442,4,3,221780,221780,221783,0,3,3
63443,3,1,221783,221783,221784,0,1,0
63444,4,1,221787,221787,221788,0,1,3
63445,5,3,221792,221792,221795,0,3,4
63446,3,1,221795,221795,221796,0,1,0
63447,2,1,221797,221797,221798,0,1,1
63448,3,3,221800,221800,221803,0,3,2
63449,1,1,221801,221803,221804,2,3,0
63450,2,3,221803,221804,221807,1,4,0
63451,3,3,221806,221807,221810,1,4,0
63452,4,3,221810,221810,221813,0,3,0
63453,4,3,221814,221814,221817,0,3,1
63454,6,1,221820,221820,221821,0,1,3
63455,1,2,221821,221821,221823,0,2,0
63456,4,1,221825,221825,221826,0,1,2
63457,4,1,221829,221829,221830,0,1,3
63458,1,1,221830,221830,221831,0,1,0
63459,5,2,221835,221835,221837,0,2,4
63460,5,2,221840,221840,221842,0,2,3
63461,1,1,221841,221842,221843,1,2,0
63462,3,3,221844,221844,221847,0,3,1
63463,6,2,221850,221850,221852,0,2,3
63464,4,1,221854,221854,221855,0,1,2
63465,3,2,221857,221857,221859,0,2,2
63466,3,1,221860,221860,221861,0,1,1
63467,2,3,221862,221862,221865,0,3,1
63468,6,2,221868,221868,221870,0,2,3
63469,5,3,221873,221873,221876,0,3,3
63470,4,1,221877,221877,221878,0,1,1
63471,5,3,221882,221882,221885,0,3,4
63472,3,3,221885,221885,221888,0,3,0
63473,1,3,221886,221888,221891,2,5,0
63474,5,2,221891,221891,221893,0,2,0
63475,4,1,221895,221895,221896,0,1,2
63476,1,2,221896,221896,221898,0,2,0
63477,1,1,221897,221898,221899,1,2,0
63478,1,1,221898,221899,221900,1,2,0
63479,3,3,221901,221901,221904,0,3,1
63480,2,3,221903,221904,221907,1,4,0
63481,3,1,221906,221907,221908,1,2,0
63482,3,3,221909,221909,221912,0,3,1
63483,5,1,221914,221914,221915,0,1,2
63484,6,3,221920,221920,221923,0,3,5
63485,1,1,221921,221923,221924,2,3,0
63486,2,3,221923,221924,221927,1,4,0
63487,1,1,221924,221927,221928,3,4,0
63488,6,1,221930,221930,221931,0,1,2
63489,1,3,221931,221931,221934,0,3,0
63490,6,1,221937,221937,221938,0,1,3
63491,2,3,221939,221939,221942,0,3,1
63492,1,3,221940,221942,221945,2,5,0
63493,6,3,221946,221946,221949,0,3,1
63494,4,2,221950,221950,221952,0,2,1
63495,3,2,221953,221953,221955,0,2,1
63496,3,2,221956,221956,221958,0,2,1
63497,6,2,221962,221962,221964,0,2,4
63498,1,3,221963,221964,221967,1,4,0
63499,4,2,221967,221967,221969,0,2,0
63500,2,1,221969,221969,221970,0,1,0
63501,5,1,221974,221974,221975,0,1,4
63502,4,1,221978,221978,221979,0,1,3
63503,1,2,221979,221979,221981,0,2,0
63504,2,2,221981,221981,221983,0,2,0
63505,1,2,221982,221983,221985,1,3,0
63506,3,2,221985,221985,221987,0,2,0
63507,2,3,221987,221987,221990,0,3,0
63508,4,3,221991,221991,221994,0,3,1
63509,4,1,221995,221995,221996,0,1,1
63510,2,3,221997,221997,222000,0,3,1
63511,6,3,222003,222003,222006,0,3,3
63512,3,2,222006,222006,222008,0,2,0
63513,2,1,222008,222008,222009,0,1,0
63514,1,1,222009,222009,222010,0,1,0
63515,5,3,222014,222014,222017,0,3,4
63516,4,3,222018,222018,222021,0,3,1
63517,6,3,222024,222024,222027,0,3,3
63518,4,3,222028,222028,222031,0,3,1
63519,6,1,222034,222034,222035,0,1,3
63520,2,3,222036,222036,222039,0,3,1
63521,3,1,222039,222039,222040,0,1,0
63522,5,2,222044,222044,222046,0,2,4
63523,2,3,222046,222046,222049,0,3,0
63524,3,3,222049,222049,222052,0,3,0
63525,6,3,222055,222055,222058,0,3,3
63526,6,1,222061,222061,222062,0,1,3
63527,4,2,222065,222065,222067,0,2,3
63528,2,2,222067,222067,222069,0,2,0
63529,1,3,222068,222069,222072,1,4,0
63530,2,3,222070,222072,222075,2,5,0
63531,1,1,222071,222075,222076,4,5,0
63532,1,2,222072,222076,222078,4,6,0
63533,2,1,222074,222078,222079,4,5,0
63534,4,3,222078,222079,222082,1,4,0
63535,6,2,222084,222084,222086,0,2,2
63536,5,3,222089,222089,222092,0,3,3
63537,6,1,222095,222095,222096,0,1,3
63538,2,1,222097,222097,222098,0,1,1
63539,4,1,222101,222101,222102,0,1,3
63540,3,1,222104,222104,222105,0,1,2
63541,1,1,222105,222105,222106,0,1,0
63542,6,1,222111,222111,222112,0,1,5
63543,5,2,222116,222116,222118,0,2,4
63544,1,3,222117,222118,222121,1,4,0
63545,5,1,222122,222122,222123,0,1,1
63546,3,3,222125,222125,222128,0,3,2
63547,6,1,222131,222131,222132,0,1,3
63548,5,1,222136,222136,222137,0,1,4
63549,6,2,222142,222142,222144,0,2,5
63550,2,2,222144,222144,222146,0,2,0
63551,4,3,222148,222148,222151,0,3,2
63552,3,1,222151,222151,222152,0,1,0
63553,5,1,222156,222156,222157,0,1,4
63554,2,2,222158,222158,222160,0,2,1
63555,4,1,222162,222162,222163,0,1,2
63556,3,3,222165,222165,222168,0,3,2
63557,3,1,222168,222168,222169,0,1,0
63558,5,3,222173,222173,222176,0,3,4
63559,1,2,222174,222176,222178,2,4,0
63560,6,1,222180,222180,222181,0,1,2
63561,2,2,222182,222182,222184,0,2,1
63562,4,3,222186,222186,222189,0,3,2
63563,6,1,222192,222192,222193,0,1,3
63564,6,2,222198,222198,222200,0,2,5
63565,4,3,222202,222202,222205,0,3,2
63566,6,3,222208,222208,222211,0,3,3
63567,5,1,222213,222213,222214,0,1,2
63568,4,3,222217,222217,222220,0,3,3
63569,1,3,222218,222220,222223,2,5,0
63570,1,3,222219,222223,222226,4,7,0
63571,1,1,222220,222226,222227,6,7,0
63572,2,3,222222,222227,222230,5,8,0
63573,1,2,222223,222230,222232,7,9,0
63574,4,3,222227,222232,222235,5,8,0
63575,5,2,222232,222235,222237,3,5,0
63576,5,1,222237,222237,222238,0,1,0
63577,5,1,222242,222242,222243,0,1,4
63578,5,3,222247,222247,222250,0,3,4
63579,3,2,222250,222250,222252,0,2,0
63580,4,1,222254,222254,222255,0,1,2
63581,6,1,222260,222260,222261,0,1,5
63582,2,3,222262,222262,222265,0,3,1
63583,5,3,222267,222267,222270,0,3,2
63584,6,1,222273,222273,222274,0,1,3
63585,1,1,222274,222274,222275,0,1,0
63586,5,1,222279,222279,222280,0,1,4
63587,1,1,222280,222280,222281,0,1,0
63588,4,1,222284,222284,222285,0,1,3
63589,6,3,222290,222290,222293,0,3,5
63590,5,1,222295,222295,222296,0,1,2
63591,5,3,222300,222300,222303,0,3,4
63592,1,3,222301,222303,222306,2,5,0
63593,4,3,222305,222306,222309,1,4,0
63594,1,2,222306,222309,222311,3,5,0
63595,2,3,222308,222311,222314,3,6,0
63596,4,3,222312,222314,222317,2,5,0
63597,1,3,222313,222317,222320,4,7,0
63598,4,1,222317,222320,222321,3,4,0
63599,6,3,222323,222323,222326,0,3,2
63600,4,2,222327,222327,222329,0,2,1
63601,4,3,222331,222331,222334,0,3,2
63602,6,2,222337,222337,222339,0,2,3
63603,2,3,222339,222339,222342,0,3,0
63604,6,2,222345,222345,222347,0,2,3
63605,1,1,222346,222347,222348,1,2,0
63606,4,2,222350,222350,222352,0,2,2
63607,1,3,222351,222352,222355,1,4,0
63608,3,1,222354,222355,222356,1,2,0
63609,1,3,222355,222356,222359,1,4,0
63610,2,3,222357,222359,222362,2,5,0
63611,6,1,222363,222363,222364,0,1,1
63612,1,2,222364,222364,222366,0,2,0
63613,6,1,222370,222370,222371,0,1,4
63614,6,3,222376,222376,222379,0,3,5
63615,4,3,222380,222380,222383,0,3,1
63616,1,1,222381,222383,222384,2,3,0
63617,1,2,222382,222384,222386,2,4,0
63618,2,2,222384,222386,222388,2,4,0
63619,6,3,222390,222390,222393,0,3,2
63620,5,3,222395,222395,222398,0,3,2
63621,4,2,222399,222399,222401,0,2,1
63622,3,3,222402,222402,222405,0,3,1
63623,1,1,222403,222405,222406,2,3,0
63624,1,1,222404,222406,222407,2,3,0
63625,2,1,222406,222407,222408,1,2,0
63626,6,3,222412,222412,222415,0,3,4
63627,4,1,222416,222416,222417,0,1,1
63628,6,1,222422,222422,222423,0,1,5
63629,4,3,222426,222426,222429,0,3,3
63630,3,3,222429,222429,222432,0,3,0
63631,3,1,222432,222432,222433,0,1,0
63632,2,2,222434,222434,222436,0,2,1
63633,5,2,222439,222439,222441,0,2,3
63634,5,2,222444,222444,222446,0,2,3
63635,5,1,222449,222449,222450,0,1,3
63636,6,1,222455,222455,222456,0,1,5
63637,6,3,222461,222461,222464,0,3,5
63638,1,1,222462,222464,222465,2,3,0
63639,3,1,222465,222465,222466,0,1,0
63640,5,2,222470,222470,222472,0,2,4
63641,4,1,222474,222474,222475,0,1,2
63642,2,1,222476,222476,222477,0,1,1
63643,5,1,222481,222481,222482,0,1,4
63644,4,3,222485,222485,222488,0,3,3
63645,3,2,222488,222488,222490,0,2,0
63646,3,3,222491,222491,222494,0,3,1
63647,4,1,222495,222495,222496,0,1,1
63648,5,1,222500,222500,222501,0,1,4
63649,4,1,222504,222504,222505,0,1,3
63650,4,2,222508,222508,222510,0,2,3
63651,2,2,222510,222510,222512,0,2,0
63652,2,3,222512,222512,222515,0,3,0
63653,5,1,222517,222517,222518,0,1,2
63654,3,1,222520,222520,222521,0,1,2
63655,2,1,222522,222522,222523,0,1,1
63656,6,2,222528,222528,222530,0,2,5
63657,5,1,222533,222533,222534,0,1,3
63658,5,3,222538,222538,222541,0,3,4
63659,2,2,222540,222541,222543,1,3,0
63660,5,2,222545,222545,222547,0,2,2
63661,4,3,222549,222549,222552,0,3,2
63662,1,1,222550,222552,222553,2,3,0
63663,3,1,222553,222553,222554,0,1,0
63664,3,3,222556,222556,222559,0,3,2
63665,1,2,222557,222559,222561,2,4,0
63666,6,2,222563,222563,222565,0,2,2
63667,1,1,222564,222565,222566,1,2,0
63668,2,1,222566,222566,222567,0,1,0
63669,6,3,222572,222572,222575,0,3,5
63670,6,2,222578,222578,222580,0,2,3
63671,5,3,222583,222583,222586,0,3,3
63672,6,2,222589,222589,222591,0,2,3
63673,5,1,222594,222594,222595,0,1,3
63674,5,2,222599,222599,222601,0,2,4
63675,6,2,222605,222605,222607,0,2,4
63676,5,3,222610,222610,222613,0,3,3
63677,3,1,222613,222613,222614,0,1,0
63678,6,2,222619,222619,222621,0,2,5
63679,1,1,222620,222621,222622,1,2,0
63680,4,3,222624,222624,222627,0,3,2
63681,5,3,222629,222629,222632,0,3,2
63682,3,1,222632,222632,222633,0,1,0
63683,1,3,222633,222633,222636,0,3,0
63684,3,3,222636,222636,222639,0,3,0
63685,4,3,222640,222640,222643,0,3,1
63686,3,3,222643,222643,222646,0,3,0
63687,2,2,222645,222646,222648,1,3,0
63688,2,1,222647,222648,222649,1,2,0
63689,5,2,222652,222652,222654,0,2,3
63690,2,1,222654,222654,222655,0,1,0
63691,1,3,222655,222655,222658,0,3,0
63692,5,1,222660,222660,222661,0,1,2
63693,6,1,222666,222666,222667,0,1,5
63694,5,1,222671,222671,222672,0,1,4
63695,3,3,222674,222674,222677,0,3,2
63696,6,3,222680,222680,222683,0,3,3
63697,3,3,222683,222683,222686,0,3,0
63698,4,3,222687,222687,222690,0,3,1
63699,5,2,222692,222692,222694,0,2,2
63700,1,1,222693,222694,222695,1,2,0
63701,5,3,222698,222698,222701,0,3,3
63702,2,1,222700,222701,222702,1,2,0
63703,4,3,222704,222704,222707,0,3,2
63704,6,3,222710,222710,222713,0,3,3
63705,2,1,222712,222713,222714,1,2,0
63706,2,3,222714,222714,222717,0,3,0
63707,6,2,222720,222720,222722,0,2,3
63708,5,1,222725,222725,222726,0,1,3
63709,5,2,222730,222730,222732,0,2,4
63710,5,3,222735,222735,222738,0,3,3
63711,2,1,222737,222738,222739,1,2,0
63712,1,2,222738,222739,222741,1,3,0
63713,4,3,222742,222742,222745,0,3,1
63714,4,2,222746,222746,222748,0,2,1
63715,2,1,222748,222748,222749,0,1,0
63716,2,2,222750,222750,222752,0,2,1
63717,2,3,222752,222752,222755,0,3,0
63718,3,2,222755,222755,222757,0,2,0
63719,6,3,222761,222761,222764,0,3,4
63720,5,1,222766,222766,222767,0,1,2
63721,3,1,222769,222769,222770,0,1,2
63722,1,3,222770,222770,222773,0,3,0
63723,2,1,222772,222773,222774,1,2,0
63724,6,2,222778,222778,222780,0,2,4
63725,2,1,222780,222780,222781,0,1,0
63726,6,3,222786,222786,222789,0,3,5
63727,2,1,222788,222789,222790,1,2,0
63728,1,2,222789,222790,222792,1,3,0
63729,5,3,222794,222794,222797,0,3,2
63730,4,3,222798,222798,222801,0,3,1
63731,2,1,222800,222801,222802,1,2,0
63732,6,3,222806,222806,222809,0,3,4
63733,2,1,222808,222809,222810,1,2,0
63734,2,1,222810,222810,222811,0,1,0
63735,5,1,222815,222815,222816,0,1,4
63736,4,1,222819,222819,222820,0,1,3
63737,3,1,222822,222822,222823,0,1,2
63738,2,1,222824,222824,222825,0,1,1
63739,4,1,222828,222828,222829,0,1,3
63740,6,1,222834,222834,222835,0,1,5
63741,6,1,222840,222840,222841,0,1,5
63742,5,2,222845,222845,222847,0,2,4
63743,3,1,222848,222848,222849,0,1,1
63744,1,1,222849,222849,222850,0,1,0
63745,4,1,222853,222853,222854,0,1,3
63746,3,1,222856,222856,222857,0,1,2
63747,2,2,222858,222858,222860,0,2,1
63748,4,3,222862,222862,222865,0,3,2
63749,4,2,222866,222866,222868,0,2,1
63750,3,1,222869,222869,222870,0,1,1
63751,6,3,222875,222875,222878,0,3,5
63752,5,1,222880,222880,222881,0,1,2
63753,2,2,222882,222882,222884,0,2,1
63754,2,2,222884,222884,222886,0,2,0
63755,2,2,222886,222886,222888,0,2,0
63756,1,1,222887,222888,222889,1,2,0
63757,5,3,222892,222892,222895,0,3,3
63758,4,1,222896,222896,222897,0,1,1
63759,6,3,222902,222902,222905,0,3,5
63760,1,1,222903,222905,222906,2,3,0
63761,5,3,222908,222908,222911,0,3,2
63762,2,1,222910,222911,222912,1,2,0
63763,1,1,222911,222912,222913,1,2,0
63764,6,1,222917,222917,222918,0,1,4
63765,1,2,222918,222918,222920,0,2,0
63766,2,2,222920,222920,222922,0,2,0
63767,2,1,222922,222922,222923,0,1,0
63768,4,1,222926,222926,222927,0,1,3
63769,3,3,222929,222929,222932,0,3,2
63770,6,1,222935,222935,222936,0,1,3
63771,2,3,222937,222937,222940,0,3,1
63772,2,3,222939,222940,222943,1,4,0
63773,4,1,222943,222943,222944,0,1,0
63774,4,1,222947,222947,222948,0,1,3
63775,1,3,222948,222948,222951,0,3,0
63776,2,1,222950,222951,222952,1,2,0
63777,4,2,222954,222954,222956,0,2,2
63778,6,1,222960,222960,222961,0,1,4
63779,6,3,222966,222966,222969,0,3,5
63780,1,3,222967,222969,222972,2,5,0
63781,6,1,222973,222973,222974,0,1,1
63782,4,2,222977,222977,222979,0,2,3
63783,4,3,222981,222981,222984,0,3,2
63784,6,3,222987,222987,222990,0,3,3
63785,2,3,222989,222990,222993,1,4,0
63786,5,2,222994,222994,222996,0,2,1
63787,1,1,222995,222996,222997,1,2,0
63788,2,2,222997,222997,222999,0,2,0
63789,2,3,222999,222999,223002,0,3,0
63790,5,3,223004,223004,223007,0,3,2
63791,2,2,223006,223007,223009,1,3,0
63792,3,3,223009,223009,223012,0,3,0
63793,2,1,223011,223012,223013,1,2,0
63794,6,2,223017,223017,223019,0,2,4
63795,2,3,223019,223019,223022,0,3,0
63796,2,2,223021,223022,223024,1,3,0
63797,6,3,223027,223027,223030,0,3,3
63798,1,1,223028,223030,223031,2,3,0
63799,6,1,223034,223034,223035,0,1,3
63800,1,1,223035,223035,223036,0,1,0
63801,1,1,223036,223036,223037,0,1,0
63802,6,3,223042,223042,223045,0,3,5
63803,3,1,223045,223045,223046,0,1,0
63804,1,1,223046,223046,223047,0,1,0
63805,2,3,223048,223048,223051,0,3,1
63806,6,1,223054,223054,223055,0,1,3
63807,2,2,223056,223056,223058,0,2,1
63808,4,2,223060,223060,223062,0,2,2
63809,2,3,223062,223062,223065,0,3,0
63810,1,3,223063,223065,223068,2,5,0
63811,5,3,223068,223068,223071,0,3,0
63812,4,3,223072,223072,223075,0,3,1
63813,2,3,223074,223075,223078,1,4,0
63814,3,1,223077,223078,223079,1,2,0
63815,3,2,223080,223080,223082,0,2,1
63816,1,3,223081,223082,223085,1,4,0
63817,2,2,223083,223085,223087,2,4,0
63818,5,2,223088,223088,223090,0,2,1
63819,5,3,223093,223093,223096,0,3,3
63820,6,1,223099,223099,223100,0,1,3
63821,1,1,223100,223100,223101,0,1,0
63822,6,2,223106,223106,223108,0,2,5
63823,3,3,223109,223109,223112,0,3,1
63824,4,3,223113,223113,223116,0,3,1
63825,6,1,223119,223119,223120,0,1,3
63826,4,1,223123,223123,223124,0,1,3
63827,5,2,223128,223128,223130,0,2,4
63828,4,3,223132,223132,223135,0,3,2
63829,1,2,223133,223135,223137,2,4,0
63830,2,1,223135,223137,223138,2,3,0
63831,5,2,223140,223140,223142,0,2,2
63832,5,1,223145,223145,223146,0,1,3
63833,1,2,223146,223146,223148,0,2,0
63834,5,3,223151,223151,223154,0,3,3
63835,5,3,223156,223156,223159,0,3,2
63836,4,2,223160,223160,223162,0,2,1
63837,5,1,223165,223165,223166,0,1,3
63838,2,2,223167,223167,223169,0,2,1
63839,1,2,223168,223169,223171,1,3,0
63840,5,2,223173,223173,223175,0,2,2
63841,6,1,223179,223179,223180,0,1,4
63842,4,3,223183,223183,223186,0,3,3
63843,3,3,223186,223186,223189,0,3,0
63844,3,2,223189,223189,223191,0,2,0
63845,1,1,223190,223191,223192,1,2,0
63846,1,1,223191,223192,223193,1,2,0
63847,5,2,223196,223196,223198,0,2,3
63848,2,3,223198,223198,223201,0,3,0
63849,2,3,223200,223201,223204,1,4,0
63850,1,2,223201,223204,223206,3,5,0
63851,4,2,223205,223206,223208,1,3,0
63852,1,3,223206,223208,223211,2,5,0
63853,1,2,223207,223211,223213,4,6,0
63854,5,1,223212,223213,223214,1,2,0
63855,5,2,223217,223217,223219,0,2,3
63856,4,1,223221,223221,223222,0,1,2
63857,4,2,223225,223225,223227,0,2,3
63858,1,2,223226,223227,223229,1,3,0
63859,4,1,223230,223230,223231,0,1,1
63860,1,1,223231,223231,223232,0,1,0
63861,4,3,223235,223235,223238,0,3,3
63862,2,1,223237,223238,223239,1,2,0
63863,4,3,223241,223241,223244,0,3,2
63864,3,2,223244,223244,223246,0,2,0
63865,1,1,223245,223246,223247,1,2,0
63866,5,1,223250,223250,223251,0,1,3
63867,1,3,223251,223251,223254,0,3,0
63868,4,3,223255,223255,223258,0,3,1
63869,2,3,223257,223258,223261,1,4,0
63870,3,2,223260,223261,223263,1,3,0
63871,1,1,223261,223263,223264,2,3,0
63872,5,3,223266,223266,223269,0,3,2
63873,1,1,223267,223269,223270,2,3,0
63874,3,1,223270,223270,223271,0,1,0
63875,4,2,223274,223274,223276,0,2,3
63876,6,3,223280,223280,223283,0,3,4
63877,2,3,223282,223283,223286,1,4,0
63878,4,3,223286,223286,223289,0,3,0
63879,4,2,223290,223290,223292,0,2,1
63880,2,1,223292,223292,223293,0,1,0
63881,4,3,223296,223296,223299,0,3,3
63882,5,3,223301,223301,223304,0,3,2
63883,3,2,223304,223304,223306,0,2,0
63884,6,1,223310,223310,223311,0,1,4
63885,6,3,223316,223316,223319,0,3,5
63886,1,3,223317,223319,223322,2,5,0
63887,3,1,223320,223322,223323,2,3,0
63888,2,1,223322,223323,223324,1,2,0
63889,4,2,223326,223326,223328,0,2,2
63890,6,3,223332,223332,223335,0,3,4
63891,3,3,223335,223335,223338,0,3,0
63892,2,2,223337,223338,223340,1,3,0
63893,3,1,223340,223340,223341,0,1,0
63894,2,3,223342,223342,223345,0,3,1
63895,1,3,223343,223345,223348,2,5,0
63896,5,1,223348,223348,223349,0,1,0
63897,6,3,223354,223354,223357,0,3,5
63898,3,2,223357,223357,223359,0,2,0
63899,6,2,223363,223363,223365,0,2,4
63900,5,3,223368,223368,223371,0,3,3
63901,1,3,223369,223371,223374,2,5,0
63902,2,2,223371,223374,223376,3,5,0
63903,6,3,223377,223377,223380,0,3,1
63904,1,3,223378,223380,223383,2,5,0
63905,3,1,223381,223383,223384,2,3,0
63906,3,2,223384,223384,223386,0,2,0
63907,1,2,223385,223386,223388,1,3,0
63908,2,3,223387,223388,223391,1,4,0
63909,1,3,223388,223391,223394,3,6,0
63910,5,1,223393,223394,223395,1,2,0
63911,4,2,223397,223397,223399,0,2,2
63912,3,1,223400,223400,223401,0,1,1
63913,1,3,223401,223401,223404,0,3,0
63914,6,1,223407,223407,223408,0,1,3
63915,5,3,223412,223412,223415,0,3,4
63916,5,1,223417,223417,223418,0,1,2
63917,4,3,223421,223421,223424,0,3,3
63918,6,3,223427,223427,223430,0,3,3
63919,3,2,223430,223430,223432,0,2,0
63920,4,3,223434,223434,223437,0,3,2
63921,5,1,223439,223439,223440,0,1,2
63922,4,1,223443,223443,223444,0,1,3
63923,4,3,223447,223447,223450,0,3,3
63924,1,2,223448,223450,223452,2,4,0
63925,2,3,223450,223452,223455,2,5,0
63926,5,3,223455,223455,223458,0,3,0
63927,6,1,223461,223461,223462,0,1,3
63928,3,1,223464,223464,223465,0,1,2
63929,5,2,223469,223469,223471,0,2,4
63930,5,2,223474,223474,223476,0,2,3
63931,6,1,223480,223480,223481,0,1,4
63932,3,1,223483,223483,223484,0,1,2
63933,3,2,223486,223486,223488,0,2,2
63934,6,2,223492,223492,223494,0,2,4
63935,4,3,223496,223496,223499,0,3,2
63936,1,3,223497,223499,223502,2,5,0
63937,5,3,223502,223502,223505,0,3,0
63938,4,3,223506,223506,223509,0,3,1
63939,5,3,223511,223511,223514,0,3,2
63940,6,1,223517,223517,223518,0,1,3
63941,4,1,223521,223521,223522,0,1,3
63942,4,2,223525,223525,223527,0,2,3
63943,1,3,223526,223527,223530,1,4,0
63944,5,3,223531,223531,223534,0,3,1
63945,2,3,223533,223534,223537,1,4,0
63946,2,2,223535,223537,223539,2,4,0
63947,3,2,223538,223539,223541,1,3,0
63948,3,1,223541,223541,223542,0,1,0
63949,1,3,223542,223542,223545,0,3,0
63950,4,2,223546,223546,223548,0,2,1
63951,6,1,223552,223552,223553,0,1,4
63952,4,1,223556,223556,223557,0,1,3
63953,3,1,223559,223559,223560,0,1,2
63954,3,1,223562,223562,223563,0,1,2
63955,1,3,223563,223563,223566,0,3,0
63956,3,2,223566,223566,223568,0,2,0
63957,6,2,223572,223572,223574,0,2,4
63958,1,1,223573,223574,223575,1,2,0
63959,4,2,223577,223577,223579,0,2,2
63960,4,2,223581,223581,223583,0,2,2
63961,4,1,223585,223585,223586,0,1,2
63962,2,2,223587,223587,223589,0,2,1
63963,5,2,223592,223592,223594,0,2,3
63964,5,3,223597,223597,223600,0,3,3
63965,2,1,223599,223600,223601,1,2,0
63966,3,2,223602,223602,223604,0,2,1
63967,2,1,223604,223604,223605,0,1,0
63968,2,2,223606,223606,223608,0,2,1
63969,1,1,223607,223608,223609,1,2,0
63970,5,3,223612,223612,223615,0,3,3
63971,1,1,223613,223615,223616,2,3,0
63972,2,3,223615,223616,223619,1,4,0
63973,2,2,223617,223619,223621,2,4,0
63974,6,2,223623,223623,223625,0,2,2
63975,3,1,223626,223626,223627,0,1,1
63976,5,1,223631,223631,223632,0,1,4
63977,2,3,223633,223633,223636,0,3,1
63978,6,2,223639,223639,223641,0,2,3
63979,2,1,223641,223641,223642,0,1,0
63980,2,3,223643,223643,223646,0,3,1
63981,5,1,223648,223648,223649,0,1,2
63982,1,2,223649,223649,223651,0,2,0
63983,2,3,223651,223651,223654,0,3,0
63984,1,3,223652,223654,223657,2,5,0
63985,4,1,223656,223657,223658,1,2,0
63986,3,2,223659,223659,223661,0,2,1
63987,6,2,223665,223665,223667,0,2,4
63988,1,2,223666,223667,223669,1,3,0
63989,6,3,223672,223672,223675,0,3,3
63990,6,3,223678,223678,223681,0,3,3
63991,4,1,223682,223682,223683,0,1,1
63992,1,1,223683,223683,223684,0,1,0
63993,2,2,223685,223685,223687,0,2,1
63994,4,1,223689,223689,223690,0,1,2
63995,4,1,223693,223693,223694,0,1,3
63996,6,1,223699,223699,223700,0,1,5
63997,5,1,223704,223704,223705,0,1,4
63998,4,2,223708,223708,223710,0,2,3
63999,3,2,223711,223711,223713,0,2,1
64000,4,3,223715,223715,223718,0,3,2
64001,2,2,223717,223718,223720,1,3,0
64002,6,3,223723,223723,223726,0,3,3
64003,1,3,223724,223726,223729,2,5,0
64004,3,1,223727,223729,223730,2,3,0
64005,4,2,223731,223731,223733,0,2,1
64006,2,3,223733,223733,223736,0,3,0
64007,6,1,223739,223739,223740,0,1,3
64008,1,1,223740,223740,223741,0,1,0
64009,1,3,223741,223741,223744,0,3,0
64010,5,3,223746,223746,223749,0,3,2
64011,4,3,223750,223750,223753,0,3,1
64012,3,1,223753,223753,223754,0,1,0
64013,5,2,223758,223758,223760,0,2,4
64014,2,2,223760,223760,223762,0,2,0
64015,2,2,223762,223762,223764,0,2,0
64016,2,3,223764,223764,223767,0,3,0
64017,4,2,223768,223768,223770,0,2,1
64018,4,2,223772,223772,223774,0,2,2
64019,5,2,223777,223777,223779,0,2,3
64020,2,3,223779,223779,223782,0,3,0
64021,5,2,223784,223784,223786,0,2,2
64022,6,3,223790,223790,223793,0,3,4
64023,3,1,223793,223793,223794,0,1,0
64024,3,2,223796,223796,223798,0,2,2
64025,6,2,223802,223802,223804,0,2,4
64026,4,2,223806,223806,223808,0,2,2
64027,1,1,223807,223808,223809,1,2,0
64028,6,1,223813,223813,223814,0,1,4
64029,2,2,223815,223815,223817,0,2,1
64030,2,1,223817,223817,223818,0,1,0
64031,3,3,223820,223820,223823,0,3,2
64032,3,2,223823,223823,223825,0,2,0
64033,3,2,223826,223826,223828,0,2,1
64034,1,1,223827,223828,223829,1,2,0
64035,2,3,223829,223829,223832,0,3,0
64036,4,3,223833,223833,223836,0,3,1
64037,2,2,223835,223836,223838,1,3,0
64038,1,1,223836,223838,223839,2,3,0
64039,2,2,223838,223839,223841,1,3,0
64040,5,2,223843,223843,223845,0,2,2
64041,5,3,223848,223848,223851,0,3,3
64042,3,3,223851,223851,223854,0,3,0
64043,3,1,223854,223854,223855,0,1,0
64044,3,3,223857,223857,223860,0,3,2
64045,6,3,223863,223863,223866,0,3,3
64046,1,3,223864,223866,223869,2,5,0
64047,3,1,223867,223869,223870,2,3,0
64048,5,1,223872,223872,223873,0,1,2
64049,3,1,223875,223875,223876,0,1,2
64050,4,2,223879,223879,223881,0,2,3
64051,1,1,223880,223881,223882,1,2,0
64052,5,2,223885,223885,223887,0,2,3
64053,5,1,223890,223890,223891,0,1,3
64054,3,2,223893,223893,223895,0,2,2
64055,2,2,223895,223895,223897,0,2,0
64056,1,2,223896,223897,223899,1,3,0
64057,5,2,223901,223901,223903,0,2,2
64058,4,3,223905,223905,223908,0,3,2
64059,2,2,223907,223908,223910,1,3,0
64060,2,3,223909,223910,223913,1,4,0
64061,4,2,223913,223913,223915,0,2,0
64062,3,3,223916,223916,223919,0,3,1
64063,6,3,223922,223922,223925,0,3,3
64064,5,2,223927,223927,223929,0,2,2
64065,3,1,223930,223930,223931,0,1,1
64066,3,1,223933,223933,223934,0,1,2
64067,4,1,223937,223937,223938,0,1,3
64068,1,3,223938,223938,223941,0,3,0
64069,4,2,223942,223942,223944,0,2,1
64070,2,1,223944,223944,223945,0,1,0
64071,1,3,223945,223945,223948,0,3,0
64072,1,3,223946,223948,223951,2,5,0
64073,4,3,223950,223951,223954,1,4,0
64074,3,1,223953,223954,223955,1,2,0
64075,1,1,223954,223955,223956,1,2,0
64076,5,3,223959,223959,223962,0,3,3
64077,6,2,223965,223965,223967,0,2,3
64078,2,3,223967,223967,223970,0,3,0
64079,4,2,223971,223971,223973,0,2,1
64080,2,1,223973,223973,223974,0,1,0
64081,3,1,223976,223976,223977,0,1,2
64082,1,1,223977,223977,223978,0,1,0
64083,6,2,223983,223983,223985,0,2,5
64084,6,1,223989,223989,223990,0,1,4
64085,2,2,223991,223991,223993,0,2,1
64086,6,3,223997,223997,224000,0,3,4
64087,5,3,224002,224002,224005,0,3,2
64088,6,2,224008,224008,224010,0,2,3
64089,4,1,224012,224012,224013,0,1,2
64090,1,2,224013,224013,224015,0,2,0
64091,4,3,224017,224017,224020,0,3,2
64092,4,2,224021,224021,224023,0,2,1
64093,1,1,224022,224023,224024,1,2,0
64094,1,1,224023,224024,224025,1,2,0
64095,3,1,224026,224026,224027,0,1,1
64096,4,3,224030,224030,224033,0,3,3
64097,2,1,224032,224033,224034,1,2,0
64098,2,2,224034,224034,224036,0,2,0
64099,6,1,224040,224040,224041,0,1,4
64100,6,2,224046,224046,224048,0,2,5
64101,3,3,224049,224049,224052,0,3,1
64102,5,1,224054,224054,224055,0,1,2
64103,1,3,224055,224055,224058,0,3,0
64104,3,3,224058,224058,224061,0,3,0
64105,1,2,224059,224061,224063,2,4,0
64106,5,3,224064,224064,224067,0,3,1
64107,6,3,224070,224070,224073,0,3,3
64108,6,2,224076,224076,224078,0,2,3
64109,6,1,224082,224082,224083,0,1,4
64110,2,2,224084,224084,224086,0,2,1
64111,6,2,224090,224090,224092,0,2,4
64112,5,3,224095,224095,224098,0,3,3
64113,1,2,224096,224098,224100,2,4,0
64114,2,2,224098,224100,224102,2,4,0
64115,6,1,224104,224104,224105,0,1,2
64116,5,1,224109,224109,224110,0,1,4
64117,5,3,224114,224114,224117,0,3,4
64118,6,1,224120,224120,224121,0,1,3
64119,2,3,224122,224122,224125,0,3,1
64120,5,2,224127,224127,224129,0,2,2
64121,1,1,224128,224129,224130,1,2,0
64122,4,3,224132,224132,224135,0,3,2
64123,6,3,224138,224138,224141,0,3,3
64124,4,2,224142,224142,224144,0,2,1
64125,2,1,224144,224144,224145,0,1,0
64126,4,1,224148,224148,224149,0,1,3
64127,4,2,224152,224152,224154,0,2,3
64128,2,3,224154,224154,224157,0,3,0
64129,2,2,224156,224157,224159,1,3,0
64130,6,3,224162,224162,224165,0,3,3
64131,2,3,224164,224165,224168,1,4,0
64132,2,2,224166,224168,224170,2,4,0
64133,6,2,224172,224172,224174,0,2,2
64134,4,1,224176,224176,224177,0,1,2
64135,1,2,224177,224177,224179,0,2,0
64136,4,1,224181,224181,224182,0,1,2
64137,6,3,224187,224187,224190,0,3,5
64138,2,3,224189,224190,224193,1,4,0
64139,5,1,224194,224194,224195,0,1,1
64140,6,2,224200,224200,224202,0,2,5
64141,2,2,224202,224202,224204,0,2,0
64142,4,2,224206,224206,224208,0,2,2
64143,5,1,224211,224211,224212,0,1,3
64144,1,1,224212,224212,224213,0,1,0
64145,3,1,224215,224215,224216,0,1,2
64146,5,1,224220,224220,224221,0,1,4
64147,1,2,224221,224221,224223,0,2,0
64148,6,3,224227,224227,224230,0,3,4
64149,5,2,224232,224232,224234,0,2,2
64150,6,3,224238,224238,224241,0,3,4
64151,4,1,224242,224242,224243,0,1,1
64152,5,3,224247,224247,224250,0,3,4
64153,2,2,224249,224250,224252,1,3,0
64154,1,3,224250,224252,224255,2,5,0
64155,5,3,224255,224255,224258,0,3,0
64156,3,2,224258,224258,224260,0,2,0
64157,2,3,224260,224260,224263,0,3,0
64158,3,3,224263,224263,224266,0,3,0
64159,4,1,224267,224267,224268,0,1,1
64160,3,3,224270,224270,224273,0,3,2
64161,3,1,224273,224273,224274,0,1,0
64162,1,1,224274,224274,224275,0,1,0
64163,2,2,224276,224276,224278,0,2,1
64164,2,1,224278,224278,224279,0,1,0
64165,2,1,224280,224280,224281,0,1,1
64166,5,3,224285,224285,224288,0,3,4
64167,6,3,224291,224291,224294,0,3,3
64168,3,2,224294,224294,224296,0,2,0
64169,6,3,224300,224300,224303,0,3,4
64170,6,1,224306,224306,224307,0,1,3
64171,2,3,224308,224308,224311,0,3,1
64172,3,3,224311,224311,224314,0,3,0
64173,2,1,224313,224314,224315,1,2,0
64174,6,3,224319,224319,224322,0,3,4
64175,3,2,224322,224322,224324,0,2,0
64176,6,2,224328,224328,224330,0,2,4
64177,1,2,224329,224330,224332,1,3,0
64178,3,3,224332,224332,224335,0,3,0
64179,4,1,224336,224336,224337,0,1,1
64180,5,1,224341,224341,224342,0,1,4
64181,4,3,224345,224345,224348,0,3,3
64182,4,2,224349,224349,224351,0,2,1
64183,2,3,224351,224351,224354,0,3,0
64184,4,3,224355,224355,224358,0,3,1
64185,2,3,224357,224358,224361,1,4,0
64186,3,3,224360,224361,224364,1,4,0
64187,5,1,224365,224365,224366,0,1,1
64188,6,1,224371,224371,224372,0,1,5
64189,3,1,224374,224374,224375,0,1,2
64190,5,1,224379,224379,224380,0,1,4
64191,3,1,224382,224382,224383,0,1,2
64192,3,3,224385,224385,224388,0,3,2
64193,5,3,224390,224390,224393,0,3,2
64194,6,3,224396,224396,224399,0,3,3
64195,6,3,224402,224402,224405,0,3,3
64196,5,2,224407,224407,224409,0,2,2
64197,4,3,224411,224411,224414,0,3,2
64198,5,1,224416,224416,224417,0,1,2
64199,6,2,224422,224422,224424,0,2,5
64200,1,1,224423,224424,224425,1,2,0
64201,1,1,224424,224425,224426,1,2,0
64202,2,1,224426,224426,224427,0,1,0
64203,2,2,224428,224428,224430,0,2,1
64204,3,2,224431,224431,224433,0,2,1
64205,5,2,224436,224436,224438,0,2,3
64206,4,2,224440,224440,224442,0,2,2
64207,4,2,224444,224444,224446,0,2,2
64208,2,2,224446,224446,224448,0,2,0
64209,3,2,224449,224449,224451,0,2,1
64210,2,1,224451,224451,224452,0,1,0
64211,4,3,224455,224455,224458,0,3,3
64212,5,2,224460,224460,224462,0,2,2
64213,4,3,224464,224464,224467,0,3,2
64214,1,1,224465,224467,224468,2,3,0
64215,4,2,224469,224469,224471,0,2,1
64216,5,1,224474,224474,224475,0,1,3
64217,1,1,224475,224475,224476,0,1,0
64218,4,2,224479,224479,224481,0,2,3
64219,2,3,224481,224481,224484,0,3,0
64220,5,3,224486,224486,224489,0,3,2
64221,4,2,224490,224490,224492,0,2,1
64222,6,2,224496,224496,224498,0,2,4
64223,6,3,224502,224502,224505,0,3,4
64224,2,1,224504,224505,224506,1,2,0
64225,3,2,224507,224507,224509,0,2,1
64226,3,2,224510,224510,224512,0,2,1
64227,4,1,224514,224514,224515,0,1,2
64228,2,3,224516,224516,224519,0,3,1
64229,6,3,224522,224522,224525,0,3,3
64230,6,3,224528,224528,224531,0,3,3
64231,4,3,224532,224532,224535,0,3,1
64232,3,3,224535,224535,224538,0,3,0
64233,2,2,224537,224538,224540,1,3,0
64234,4,1,224541,224541,224542,0,1,1
64235,4,1,224545,224545,224546,0,1,3
64236,3,2,224548,224548,224550,0,2,2
64237,3,3,224551,224551,224554,0,3,1
64238,6,2,224557,224557,224559,0,2,3
64239,1,1,224558,224559,224560,1,2,0
64240,6,1,224564,224564,224565,0,1,4
64241,6,3,224570,224570,224573,0,3,5
64242,2,3,224572,224573,224576,1,4,0
64243,2,2,224574,224576,224578,2,4,0
64244,2,1,224576,224578,224579,2,3,0
64245,1,1,224577,224579,224580,2,3,0
64246,2,2,224579,224580,224582,1,3,0
64247,6,3,224585,224585,224588,0,3,3
64248,6,3,224591,224591,224594,0,3,3
64249,2,2,224593,224594,224596,1,3,0
64250,3,2,224596,224596,224598,0,2,0
64251,3,2,224599,224599,224601,0,2,1
64252,5,1,224604,224604,224605,0,1,3
64253,6,2,224610,224610,224612,0,2,5
64254,6,3,224616,224616,224619,0,3,4
64255,1,1,224617,224619,224620,2,3,0
64256,4,2,224621,224621,224623,0,2,1
64257,5,3,224626,224626,224629,0,3,3
64258,4,1,224630,224630,224631,0,1,1
64259,2,3,224632,224632,224635,0,3,1
64260,4,2,224636,224636,224638,0,2,1
64261,3,3,224639,224639,224642,0,3,1
64262,4,2,224643,224643,224645,0,2,1
64263,2,1,224645,224645,224646,0,1,0
64264,1,1,224646,224646,224647,0,1,0
64265,5,2,224651,224651,224653,0,2,4
64266,6,1,224657,224657,224658,0,1,4
64267,6,1,224663,224663,224664,0,1,5
64268,2,3,224665,224665,224668,0,3,1
64269,6,3,224671,224671,224674,0,3,3
64270,4,3,224675,224675,224678,0,3,1
64271,3,2,224678,224678,224680,0,2,0
64272,5,1,224683,224683,224684,0,1,3
64273,1,2,224684,224684,224686,0,2,0
64274,1,2,224685,224686,224688,1,3,0
64275,3,3,224688,224688,224691,0,3,0
64276,1,1,224689,224691,224692,2,3,0
64277,5,1,224694,224694,224695,0,1,2
64278,6,1,224700,224700,224701,0,1,5
64279,6,2,224706,224706,224708,0,2,5
64280,1,1,224707,224708,224709,1,2,0
64281,2,1,224709,224709,224710,0,1,0
64282,6,3,224715,224715,224718,0,3,5
64283,3,2,224718,224718,224720,0,2,0
64284,6,2,224724,224724,224726,0,2,4
64285,2,1,224726,224726,224727,0,1,0
64286,6,2,224732,224732,224734,0,2,5
64287,6,2,224738,224738,224740,0,2,4
64288,1,2,224739,224740,224742,1,3,0
64289,4,3,224743,224743,224746,0,3,1
64290,4,3,224747,224747,224750,0,3,1
64291,3,3,224750,224750,224753,0,3,0
64292,5,2,224755,224755,224757,0,2,2
64293,1,2,224756,224757,224759,1,3,0
64294,2,2,224758,224759,224761,1,3,0
64295,2,1,224760,224761,224762,1,2,0
64296,5,3,224765,224765,224768,0,3,3
64297,4,1,224769,224769,224770,0,1,1
64298,6,2,224775,224775,224777,0,2,5
64299,2,3,224777,224777,224780,0,3,0
64300,3,1,224780,224780,224781,0,1,0
64301,2,3,224782,224782,224785,0,3,1
64302,6,2,224788,224788,224790,0,2,3
64303,5,2,224793,224793,224795,0,2,3
64304,4,2,224797,224797,224799,0,2,2
64305,1,3,224798,224799,224802,1,4,0
64306,1,2,224799,224802,224804,3,5,0
64307,5,1,224804,224804,224805,0,1,0
64308,2,1,224806,224806,224807,0,1,1
64309,6,1,224812,224812,224813,0,1,5
64310,6,1,224818,224818,224819,0,1,5
64311,6,2,224824,224824,224826,0,2,5
64312,5,3,224829,224829,224832,0,3,3
64313,5,1,224834,224834,224835,0,1,2
64314,5,3,224839,224839,224842,0,3,4
64315,2,1,224841,224842,224843,1,2,0
64316,5,1,224846,224846,224847,0,1,3
64317,5,3,224851,224851,224854,0,3,4
64318,1,2,224852,224854,224856,2,4,0
64319,6,3,224858,224858,224861,0,3,2
64320,3,3,224861,224861,224864,0,3,0
64321,3,2,224864,224864,224866,0,2,0
64322,6,2,224870,224870,224872,0,2,4
64323,6,2,224876,224876,224878,0,2,4
64324,3,2,224879,224879,224881,0,2,1
64325,5,2,224884,224884,224886,0,2,3
64326,1,1,224885,224886,224887,1,2,0
64327,6,3,224891,224891,224894,0,3,4
64328,2,1,224893,224894,224895,1,2,0
64329,4,2,224897,224897,224899,0,2,2
64330,1,3,224898,224899,224902,1,4,0
64331,2,1,224900,224902,224903,2,3,0
64332,2,1,224902,224903,224904,1,2,0
64333,5,3,224907,224907,224910,0,3,3
64334,3,2,224910,224910,224912,0,2,0
64335,5,3,224915,224915,224918,0,3,3
64336,1,2,224916,224918,224920,2,4,0
64337,4,3,224920,224920,224923,0,3,0
64338,6,2,224926,224926,224928,0,2,3
64339,3,1,224929,224929,224930,0,1,1
64340,1,1,224930,224930,224931,0,1,0
64341,5,1,224935,224935,224936,0,1,4
64342,5,3,224940,224940,224943,0,3,4
64343,6,2,224946,224946,224948,0,2,3
64344,2,2,224948,224948,224950,0,2,0
64345,6,1,224954,224954,224955,0,1,4
64346,5,1,224959,224959,224960,0,1,4
64347,1,1,224960,224960,224961,0,1,0
64348,4,3,224964,224964,224967,0,3,3
64349,6,3,224970,224970,224973,0,3,3
64350,4,1,224974,224974,224975,0,1,1
64351,2,3,224976,224976,224979,0,3,1
64352,3,1,224979,224979,224980,0,1,0
64353,5,3,224984,224984,224987,0,3,4
64354,4,3,224988,224988,224991,0,3,1
64355,3,2,224991,224991,224993,0,2,0
64356,6,1,224997,224997,224998,0,1,4
64357,5,2,225002,225002,225004,0,2,4
64358,6,2,225008,225008,225010,0,2,4
64359,3,1,225011,225011,225012,0,1,1
64360,5,2,225016,225016,225018,0,2,4
64361,3,1,225019,225019,225020,0,1,1
64362,3,3,225022,225022,225025,0,3,2
64363,6,2,225028,225028,225030,0,2,3
64364,5,3,225033,225033,225036,0,3,3
64365,2,3,225035,225036,225039,1,4,0
64366,5,3,225040,225040,225043,0,3,1
64367,1,2,225041,225043,225045,2,4,0
64368,4,2,225045,225045,225047,0,2,0
64369,4,1,225049,225049,225050,0,1,2
64370,2,2,225051,225051,225053,0,2,1
64371,2,2,225053,225053,225055,0,2,0
64372,1,3,225054,225055,225058,1,4,0
64373,3,2,225057,225058,225060,1,3,0
64374,3,2,225060,225060,225062,0,2,0
64375,2,1,225062,225062,225063,0,1,0
64376,2,1,225064,225064,225065,0,1,1
64377,1,1,225065,225065,225066,0,1,0
64378,4,2,225069,225069,225071,0,2,3
64379,5,3,225074,225074,225077,0,3,3
64380,1,3,225075,225077,225080,2,5,0
64381,4,1,225079,225080,225081,1,2,0
64382,2,2,225081,225081,225083,0,2,0
64383,1,2,225082,225083,225085,1,3,0
64384,6,1,225088,225088,225089,0,1,3
64385,3,3,225091,225091,225094,0,3,2
64386,2,3,225093,225094,225097,1,4,0
64387,4,3,225097,225097,225100,0,3,0
64388,6,1,225103,225103,225104,0,1,3
64389,2,1,225105,225105,225106,0,1,1
64390,3,3,225108,225108,225111,0,3,2
64391,4,1,225112,225112,225113,0,1,1
64392,1,3,225113,225113,225116,0,3,0
64393,3,1,225116,225116,225117,0,1,0
64394,1,1,225117,225117,225118,0,1,0
64395,2,3,225119,225119,225122,0,3,1
64396,6,1,225125,225125,225126,0,1,3
64397,2,2,225127,225127,225129,0,2,1
64398,3,2,225130,225130,225132,0,2,1
64399,2,2,225132,225132,225134,0,2,0
64400,3,2,225135,225135,225137,0,2,1
64401,6,3,225141,225141,225144,0,3,4
64402,5,2,225146,225146,225148,0,2,2
64403,2,2,225148,225148,225150,0,2,0
64404,4,3,225152,225152,225155,0,3,2
64405,4,3,225156,225156,225159,0,3,1
64406,3,1,225159,225159,225160,0,1,0
64407,3,1,225162,225162,225163,0,1,2
64408,1,3,225163,225163,225166,0,3,0
64409,6,1,225169,225169,225170,0,1,3
64410,3,2,225172,225172,225174,0,2,2
64411,4,1,225176,225176,225177,0,1,2
64412,1,3,225177,225177,225180,0,3,0
64413,3,1,225180,225180,225181,0,1,0
64414,3,2,225183,225183,225185,0,2,2
64415,6,2,225189,225189,225191,0,2,4
64416,1,2,225190,225191,225193,1,3,0
64417,5,1,225195,225195,225196,0,1,2
64418,3,2,225198,225198,225200,0,2,2
64419,5,1,225203,225203,225204,0,1,3
64420,2,2,225205,225205,225207,0,2,1
64421,3,3,225208,225208,225211,0,3,1
64422,6,2,225214,225214,225216,0,2,3
64423,2,2,225216,225216,225218,0,2,0
64424,1,3,225217,225218,225221,1,4,0
64425,2,3,225219,225221,225224,2,5,0
64426,6,3,225225,225225,225228,0,3,1
64427,2,3,225227,225228,225231,1,4,0
64428,1,2,225228,225231,225233,3,5,0
64429,6,3,225234,225234,225237,0,3,1
64430,2,1,225236,225237,225238,1,2,0
64431,6,2,225242,225242,225244,0,2,4
64432,5,3,225247,225247,225250,0,3,3
64433,2,2,225249,225250,225252,1,3,0
64434,1,1,225250,225252,225253,2,3,0
64435,5,3,225255,225255,225258,0,3,2
64436,4,3,225259,225259,225262,0,3,1
64437,2,2,225261,225262,225264,1,3,0
64438,5,1,225266,225266,225267,0,1,2
64439,3,3,225269,225269,225272,0,3,2
64440,3,2,225272,225272,225274,0,2,0
64441,3,3,225275,225275,225278,0,3,1
64442,1,2,225276,225278,225280,2,4,0
64443,2,3,225278,225280,225283,2,5,0
64444,6,2,225284,225284,225286,0,2,1
64445,2,2,225286,225286,225288,0,2,0
64446,2,2,225288,225288,225290,0,2,0
64447,5,3,225293,225293,225296,0,3,3
64448,4,2,225297,225297,225299,0,2,1
64449,4,1,225301,225301,225302,0,1,2
64450,5,2,225306,225306,225308,0,2,4
64451,1,2,225307,225308,225310,1,3,0
64452,5,2,225312,225312,225314,0,2,2
64453,3,3,225315,225315,225318,0,3,1
64454,3,1,225318,225318,225319,0,1,0
64455,4,3,225322,225322,225325,0,3,3
64456,4,1,225326,225326,225327,0,1,1
64457,6,1,225332,225332,225333,0,1,5
64458,4,1,225336,225336,225337,0,1,3
64459,4,1,225340,225340,225341,0,1,3
64460,4,2,225344,225344,225346,0,2,3
64461,6,3,225350,225350,225353,0,3,4
64462,5,1,225355,225355,225356,0,1,2
64463,2,2,225357,225357,225359,0,2,1
64464,4,3,225361,225361,225364,0,3,2
64465,4,1,225365,225365,225366,0,1,1
64466,5,2,225370,225370,225372,0,2,4
64467,4,3,225374,225374,225377,0,3,2
64468,3,3,225377,225377,225380,0,3,0
64469,1,3,225378,225380,225383,2,5,0
64470,2,2,225380,225383,225385,3,5,0
64471,2,2,225382,225385,225387,3,5,0
64472,2,1,225384,225387,225388,3,4,0
64473,2,2,225386,225388,225390,2,4,0
64474,6,2,225392,225392,225394,0,2,2
64475,5,2,225397,225397,225399,0,2,3
64476,3,2,225400,225400,225402,0,2,1
64477,3,2,225403,225403,225405,0,2,1
64478,2,3,225405,225405,225408,0,3,0
64479,3,3,225408,225408,225411,0,3,0
64480,6,2,225414,225414,225416,0,2,3
64481,2,2,225416,225416,225418,0,2,0
64482,2,3,225418,225418,225421,0,3,0
64483,2,1,225420,225421,225422,1,2,0
64484,6,3,225426,225426,225429,0,3,4
64485,6,3,225432,225432,225435,0,3,3
64486,1,1,225433,225435,225436,2,3,0
64487,5,3,225438,225438,225441,0,3,2
64488,4,2,225442,225442,225444,0,2,1
64489,5,2,225447,225447,225449,0,2,3
64490,4,1,225451,225451,225452,0,1,2
64491,6,1,225457,225457,225458,0,1,5
64492,2,2,225459,225459,225461,0,2,1
64493,4,1,225463,225463,225464,0,1,2
64494,4,3,225467,225467,225470,0,3,3
64495,5,3,225472,225472,225475,0,3,2
64496,6,1,225478,225478,225479,0,1,3
64497,2,3,225480,225480,225483,0,3,1
64498,4,3,225484,225484,225487,0,3,1
64499,2,2,225486,225487,225489,1,3,0
64500,4,2,225490,225490,225492,0,2,1
64501,5,1,225495,225495,225496,0,1,3
64502,6,1,225501,225501,225502,0,1,5
64503,3,1,225504,225504,225505,0,1,2
64504,6,3,225510,225510,225513,0,3,5
64505,5,2,225515,225515,225517,0,2,2
64506,2,2,225517,225517,225519,0,2,0
64507,4,2,225521,225521,225523,0,2,2
64508,1,3,225522,225523,225526,1,4,0
64509,2,1,225524,225526,225527,2,3,0
64510,2,1,225526,225527,225528,1,2,0
64511,4,1,225530,225530,225531,0,1,2
64512,5,2,225535,225535,225537,0,2,4
64513,6,1,225541,225541,225542,0,1,4
64514,4,3,225545,225545,225548,0,3,3
64515,4,1,225549,225549,225550,0,1,1
64516,6,3,225555,225555,225558,0,3,5
64517,6,2,225561,225561,225563,0,2,3
64518,3,1,225564,225564,225565,0,1,1
64519,6,3,225570,225570,225573,0,3,5
64520,3,1,225573,225573,225574,0,1,0
64521,5,1,225578,225578,225579,0,1,4
64522,3,3,225581,225581,225584,0,3,2
64523,1,1,225582,225584,225585,2,3,0
64524,6,3,225588,225588,225591,0,3,3
64525,6,1,225594,225594,225595,0,1,3
64526,3,1,225597,225597,225598,0,1,2
64527,2,1,225599,225599,225600,0,1,1
64528,1,2,225600,225600,225602,0,2,0
64529,1,3,225601,225602,225605,1,4,0
64530,2,1,225603,225605,225606,2,3,0
64531,5,1,225608,225608,225609,0,1,2
64532,5,1,225613,225613,225614,0,1,4
64533,4,1,225617,225617,225618,0,1,3
64534,2,1,225619,225619,225620,0,1,1
64535,3,3,225622,225622,225625,0,3,2
64536,1,1,225623,225625,225626,2,3,0
64537,4,2,225627,225627,225629,0,2,1
64538,6,1,225633,225633,225634,0,1,4
64539,4,3,225637,225637,225640,0,3,3
64540,1,3,225638,225640,225643,2,5,0
64541,2,2,225640,225643,225645,3,5,0
64542,4,1,225644,225645,225646,1,2,0
64543,1,1,225645,225646,225647,1,2,0
64544,4,2,225649,225649,225651,0,2,2
64545,5,3,225654,225654,225657,0,3,3
64546,5,3,225659,225659,225662,0,3,2
64547,5,1,225664,225664,225665,0,1,2
64548,4,3,225668,225668,225671,0,3,3
64549,4,2,225672,225672,225674,0,2,1
64550,5,2,225677,225677,225679,0,2,3
64551,1,1,225678,225679,225680,1,2,0
64552,3,1,225681,225681,225682,0,1,1
64553,4,1,225685,225685,225686,0,1,3
64554,3,3,225688,225688,225691,0,3,2
64555,2,3,225690,225691,225694,1,4,0
64556,5,3,225695,225695,225698,0,3,1
64557,3,3,225698,225698,225701,0,3,0
64558,2,2,225700,225701,225703,1,3,0
64559,4,3,225704,225704,225707,0,3,1
64560,3,1,225707,225707,225708,0,1,0
64561,1,3,225708,225708,225711,0,3,0
64562,6,2,225714,225714,225716,0,2,3
64563,6,2,225720,225720,225722,0,2,4
64564,5,2,225725,225725,225727,0,2,3
64565,3,2,225728,225728,225730,0,2,1
64566,2,3,225730,225730,225733,0,3,0
64567,1,2,225731,225733,225735,2,4,0
64568,5,3,225736,225736,225739,0,3,1
64569,2,2,225738,225739,225741,1,3,0
64570,4,2,225742,225742,225744,0,2,1
64571,4,1,225746,225746,225747,0,1,2
64572,4,2,225750,225750,225752,0,2,3
64573,4,3,225754,225754,225757,0,3,2
64574,3,2,225757,225757,225759,0,2,0
64575,6,3,225763,225763,225766,0,3,4
64576,3,3,225766,225766,225769,0,3,0
64577,5,1,225771,225771,225772,0,1,2
64578,4,3,225775,225775,225778,0,3,3
64579,6,2,225781,225781,225783,0,2,3
64580,2,1,225783,225783,225784,0,1,0
64581,4,2,225787,225787,225789,0,2,3
64582,6,2,225793,225793,225795,0,2,4
64583,4,2,225797,225797,225799,0,2,2
64584,2,1,225799,225799,225800,0,1,0
64585,6,1,225805,225805,225806,0,1,5
64586,3,2,225808,225808,225810,0,2,2
64587,1,1,225809,225810,225811,1,2,0
64588,2,1,225811,225811,225812,0,1,0
64589,6,2,225817,225817,225819,0,2,5
64590,4,3,225821,225821,225824,0,3,2
64591,3,3,225824,225824,225827,0,3,0
64592,4,3,225828,225828,225831,0,3,1
64593,5,2,225833,225833,225835,0,2,2
64594,5,1,225838,225838,225839,0,1,3
64595,3,3,225841,225841,225844,0,3,2
64596,3,1,225844,225844,225845,0,1,0
64597,6,2,225850,225850,225852,0,2,5
64598,5,3,225855,225855,225858,0,3,3
64599,5,3,225860,225860,225863,0,3,2
64600,6,2,225866,225866,225868,0,2,3
64601,4,2,225870,225870,225872,0,2,2
64602,4,3,225874,225874,225877,0,3,2
64603,6,2,225880,225880,225882,0,2,3
64604,4,1,225884,225884,225885,0,1,2
64605,2,2,225886,225886,225888,0,2,1
64606,1,2,225887,225888,225890,1,3,0
64607,2,3,225889,225890,225893,1,4,0
64608,2,2,225891,225893,225895,2,4,0
64609,4,1,225895,225895,225896,0,1,0
64610,4,1,225899,225899,225900,0,1,3
64611,2,3,225901,225901,225904,0,3,1
64612,3,2,225904,225904,225906,0,2,0
64613,2,3,225906,225906,225909,0,3,0
64614,4,1,225910,225910,225911,0,1,1
64615,2,1,225912,225912,225913,0,1,1
64616,1,2,225913,225913,225915,0,2,0
64617,5,3,225918,225918,225921,0,3,3
64618,4,2,225922,225922,225924,0,2,1
64619,5,3,225927,225927,225930,0,3,3
64620,1,3,225928,225930,225933,2,5,0
64621,3,2,225931,225933,225935,2,4,0
64622,3,2,225934,225935,225937,1,3,0
64623,6,3,225940,225940,225943,0,3,3
64624,5,1,225945,225945,225946,0,1,2
64625,6,2,225951,225951,225953,0,2,5
64626,1,1,225952,225953,225954,1,2,0
64627,5,1,225957,225957,225958,0,1,3
64628,3,1,225960,225960,225961,0,1,2
64629,3,3,225963,225963,225966,0,3,2
64630,3,1,225966,225966,225967,0,1,0
64631,2,3,225968,225968,225971,0,3,1
64632,1,2,225969,225971,225973,2,4,0
64633,5,1,225974,225974,225975,0,1,1
64634,4,2,225978,225978,225980,0,2,3
64635,1,3,225979,225980,225983,1,4,0
64636,6,3,225985,225985,225988,0,3,2
64637,3,3,225988,225988,225991,0,3,0
64638,5,1,225993,225993,225994,0,1,2
64639,6,3,225999,225999,226002,0,3,5
64640,2,1,226001,226002,226003,1,2,0
64641,3,3,226004,226004,226007,0,3,1
64642,4,1,226008,226008,226009,0,1,1
64643,4,1,226012,226012,226013,0,1,3
64644,3,1,226015,226015,226016,0,1,2
64645,1,3,226016,226016,226019,0,3,0
64646,6,1,226022,226022,226023,0,1,3
64647,3,3,226025,226025,226028,0,3,2
64648,2,1,226027,226028,226029,1,2,0
64649,5,3,226032,226032,226035,0,3,3
64650,4,1,226036,226036,226037,0,1,1
64651,2,3,226038,226038,226041,0,3,1
64652,4,3,226042,226042,226045,0,3,1
64653,2,2,226044,226045,226047,1,3,0
64654,6,1,226050,226050,226051,0,1,3
64655,2,1,226052,226052,226053,0,1,1
64656,4,1,226056,226056,226057,0,1,3
64657,3,2,226059,226059,226061,0,2,2
64658,5,2,226064,226064,226066,0,2,3
64659,1,1,226065,226066,226067,1,2,0
64660,6,1,226071,226071,226072,0,1,4
64661,6,1,226077,226077,226078,0,1,5
64662,3,2,226080,226080,226082,0,2,2
64663,5,1,226085,226085,226086,0,1,3
64664,2,1,226087,226087,226088,0,1,1
64665,1,2,226088,226088,226090,0,2,0
64666,4,3,226092,226092,226095,0,3,2
64667,3,2,226095,226095,226097,0,2,0
64668,4,3,226099,226099,226102,0,3,2
64669,3,1,226102,226102,226103,0,1,0
64670,6,2,226108,226108,226110,0,2,5
64671,4,2,226112,226112,226114,0,2,2
64672,1,1,226113,226114,226115,1,2,0
64673,3,1,226116,226116,226117,0,1,1
64674,3,1,226119,226119,226120,0,1,2
64675,6,3,226125,226125,226128,0,3,5
64676,3,1,226128,226128,226129,0,1,0
64677,2,2,226130,226130,226132,0,2,1
64678,6,3,226136,226136,226139,0,3,4
64679,4,3,226140,226140,226143,0,3,1
64680,1,2,226141,226143,226145,2,4,0
64681,4,1,226145,226145,226146,0,1,0
64682,6,1,226151,226151,226152,0,1,5
64683,3,1,226154,226154,226155,0,1,2
64684,4,3,226158,226158,226161,0,3,3
64685,4,2,226162,226162,226164,0,2,1
64686,6,3,226168,226168,226171,0,3,4
64687,2,1,226170,226171,226172,1,2,0
64688,3,3,226173,226173,226176,0,3,1
64689,4,1,226177,226177,226178,0,1,1
64690,1,1,226178,226178,226179,0,1,0
64691,6,1,226184,226184,226185,0,1,5
64692,6,2,226190,226190,226192,0,2,5
64693,1,3,226191,226192,226195,1,4,0
64694,6,3,226197,226197,226200,0,3,2
64695,4,1,226201,226201,226202,0,1,1
64696,6,2,226207,226207,226209,0,2,5
64697,2,3,226209,226209,226212,0,3,0
64698,5,1,226214,226214,226215,0,1,2
64699,4,1,226218,226218,226219,0,1,3
64700,3,2,226221,226221,226223,0,2,2
64701,6,2,226227,226227,226229,0,2,4
64702,1,1,226228,226229,226230,1,2,0
64703,4,2,226232,226232,226234,0,2,2
64704,5,3,226237,226237,226240,0,3,3
64705,3,3,226240,226240,226243,0,3,0
64706,6,3,226246,226246,226249,0,3,3
64707,2,1,226248,226249,226250,1,2,0
64708,2,3,226250,226250,226253,0,3,0
64709,1,1,226251,226253,226254,2,3,0
64710,1,2,226252,226254,226256,2,4,0
64711,2,1,226254,226256,226257,2,3,0
64712,4,1,226258,226258,226259,0,1,1
64713,3,2,226261,226261,226263,0,2,2
64714,1,3,226262,226263,226266,1,4,0
64715,6,3,226268,226268,226271,0,3,2
64716,1,3,226269,226271,226274,2,5,0
64717,5,3,226274,226274,226277,0,3,0
64718,3,3,226277,226277,226280,0,3,0
64719,4,1,226281,226281,226282,0,1,1
64720,2,1,226283,226283,226284,0,1,1
64721,2,1,226285,226285,226286,0,1,1
64722,6,2,226291,226291,226293,0,2,5
64723,2,2,226293,226293,226295,0,2,0
64724,5,3,226298,226298,226301,0,3,3
64725,5,3,226303,226303,226306,0,3,2
64726,3,3,226306,226306,226309,0,3,0
64727,5,2,226311,226311,226313,0,2,2
64728,1,1,226312,226313,226314,1,2,0
64729,2,3,226314,226314,226317,0,3,0
64730,3,3,226317,226317,226320,0,3,0
64731,5,2,226322,226322,226324,0,2,2
64732,3,2,226325,226325,226327,0,2,1
64733,2,1,226327,226327,226328,0,1,0
64734,5,1,226332,226332,226333,0,1,4
64735,1,2,226333,226333,226335,0,2,0
64736,1,3,226334,226335,226338,1,4,0
64737,6,2,226340,226340,226342,0,2,2
64738,1,2,226341,226342,226344,1,3,0
64739,1,2,226342,226344,226346,2,4,0
64740,2,1,226344,226346,226347,2,3,0
64741,5,1,226349,226349,226350,0,1,2
64742,1,1,226350,226350,226351,0,1,0
64743,4,3,226354,226354,226357,0,3,3
64744,4,1,226358,226358,226359,0,1,1
64745,2,1,226360,226360,226361,0,1,1
64746,4,3,226364,226364,226367,0,3,3
64747,2,1,226366,226367,226368,1,2,0
64748,4,3,226370,226370,226373,0,3,2
64749,1,1,226371,226373,226374,2,3,0
64750,4,3,226375,226375,226378,0,3,1
64751,4,1,226379,226379,226380,0,1,1
64752,3,3,226382,226382,226385,0,3,2
64753,4,3,226386,226386,226389,0,3,1
64754,5,3,226391,226391,226394,0,3,2
64755,1,1,226392,226394,226395,2,3,0
64756,5,3,226397,226397,226400,0,3,2
64757,3,2,226400,226400,226402,0,2,0
64758,2,2,226402,226402,226404,0,2,0
64759,1,3,226403,226404,226407,1,4,0
64760,4,3,226407,226407,226410,0,3,0
64761,2,2,226409,226410,226412,1,3,0
64762,5,1,226414,226414,226415,0,1,2
64763,4,2,226418,226418,226420,0,2,3
64764,4,2,226422,226422,226424,0,2,2
64765,4,1,226426,226426,226427,0,1,2
64766,5,2,226431,226431,226433,0,2,4
64767,3,3,226434,226434,226437,0,3,1
64768,2,1,226436,226437,226438,1,2,0
64769,2,1,226438,226438,226439,0,1,0
64770,4,3,226442,226442,226445,0,3,3
64771,6,3,226448,226448,226451,0,3,3
64772,5,2,226453,226453,226455,0,2,2
64773,1,2,226454,226455,226457,1,3,0
64774,6,2,226460,226460,226462,0,2,3
64775,2,3,226462,226462,226465,0,3,0
64776,6,1,226468,226468,226469,0,1,3
64777,2,3,226470,226470,226473,0,3,1
64778,3,2,226473,226473,226475,0,2,0
64779,3,3,226476,226476,226479,0,3,1
64780,4,3,226480,226480,226483,0,3,1
64781,6,1,226486,226486,226487,0,1,3
64782,5,1,226491,226491,226492,0,1,4
64783,6,2,226497,226497,226499,0,2,5
64784,2,1,226499,226499,226500,0,1,0
64785,3,2,226502,226502,226504,0,2,2
64786,3,3,226505,226505,226508,0,3,1
64787,3,1,226508,226508,226509,0,1,0
64788,2,1,226510,226510,226511,0,1,1
64789,1,2,226511,226511,226513,0,2,0
64790,2,2,226513,226513,226515,0,2,0
64791,3,3,226516,226516,226519,0,3,1
64792,6,3,226522,226522,226525,0,3,3
64793,2,2,226524,226525,226527,1,3,0
64794,2,2,226526,226527,226529,1,3,0
64795,2,1,226528,226529,226530,1,2,0
64796,3,2,226531,226531,226533,0,2,1
64797,6,1,226537,226537,226538,0,1,4
64798,1,2,226538,226538,226540,0,2,0
64799,6,1,226544,226544,226545,0,1,4
64800,2,2,226546,226546,226548,0,2,1
64801,1,1,226547,226548,226549,1,2,0
64802,6,2,226553,226553,226555,0,2,4
64803,6,3,226559,226559,226562,0,3,4
64804,3,1,226562,226562,226563,0,1,0
64805,1,2,226563,226563,226565,0,2,0
64806,6,1,226569,226569,226570,0,1,4
64807,3,2,226572,226572,226574,0,2,2
64808,3,1,226575,226575,226576,0,1,1
64809,1,3,226576,226576,226579,0,3,0
64810,4,1,226580,226580,226581,0,1,1
64811,5,1,226585,226585,226586,0,1,4
64812,1,1,226586,226586,226587,0,1,0
64813,6,3,226592,226592,226595,0,3,5
64814,6,2,226598,226598,226600,0,2,3
64815,3,3,226601,226601,226604,0,3,1
64816,1,1,226602,226604,226605,2,3,0
64817,6,1,226608,226608,226609,0,1,3
64818,6,3,226614,226614,226617,0,3,5
64819,5,1,226619,226619,226620,0,1,2
64820,3,1,226622,226622,226623,0,1,2
64821,2,2,226624,226624,226626,0,2,1
64822,3,3,226627,226627,226630,0,3,1
64823,2,2,226629,226630,226632,1,3,0
64824,3,2,226632,226632,226634,0,2,0
64825,2,3,226634,226634,226637,0,3,0
64826,2,1,226636,226637,226638,1,2,0
64827,3,2,226639,226639,226641,0,2,1
64828,2,1,226641,226641,226642,0,1,0
64829,2,2,226643,226643,226645,0,2,1
64830,5,1,226648,226648,226649,0,1,3
64831,2,3,226650,226650,226653,0,3,1
64832,2,3,226652,226653,226656,1,4,0
64833,1,1,226653,226656,226657,3,4,0
64834,5,2,226658,226658,226660,0,2,1
64835,2,2,226660,226660,226662,0,2,0
64836,6,2,226666,226666,226668,0,2,4
64837,6,1,226672,226672,226673,0,1,4
64838,4,1,226676,226676,226677,0,1,3
64839,2,1,226678,226678,226679,0,1,1
64840,3,2,226681,226681,226683,0,2,2
64841,6,3,226687,226687,226690,0,3,4
64842,2,3,226689,226690,226693,1,4,0
64843,4,1,226693,226693,226694,0,1,0
64844,1,1,226694,226694,226695,0,1,0
64845,3,1,226697,226697,226698,0,1,2
64846,6,1,226703,226703,226704,0,1,5
64847,3,2,226706,226706,226708,0,2,2
64848,5,1,226711,226711,226712,0,1,3
64849,2,2,226713,226713,226715,0,2,1
64850,2,2,226715,226715,226717,0,2,0
64851,2,3,226717,226717,226720,0,3,0
64852,6,1,226723,226723,226724,0,1,3
64853,2,3,226725,226725,226728,0,3,1
64854,6,3,226731,226731,226734,0,3,3
64855,6,3,226737,226737,226740,0,3,3
64856,4,1,226741,226741,226742,0,1,1
64857,2,3,226743,226743,226746,0,3,1
64858,3,2,226746,226746,226748,0,2,0
64859,5,2,226751,226751,226753,0,2,3
64860,3,1,226754,226754,226755,0,1,1
64861,1,2,226755,226755,226757,0,2,0
64862,5,1,226760,226760,226761,0,1,3
64863,5,1,226765,226765,226766,0,1,4
64864,5,3,226770,226770,226773,0,3,4
64865,4,1,226774,226774,226775,0,1,1
64866,2,3,226776,226776,226779,0,3,1
64867,1,2,226777,226779,226781,2,4,0
64868,4,3,226781,226781,226784,0,3,0
64869,5,2,226786,226786,226788,0,2,2
64870,1,2,226787,226788,226790,1,3,0
64871,1,3,226788,226790,226793,2,5,0
64872,4,2,226792,226793,226795,1,3,0
64873,4,3,226796,226796,226799,0,3,1
64874,3,1,226799,226799,226800,0,1,0
64875,2,3,226801,226801,226804,0,3,1
64876,3,1,226804,226804,226805,0,1,0
64877,3,1,226807,226807,226808,0,1,2
64878,6,1,226813,226813,226814,0,1,5
64879,1,3,226814,226814,226817,0,3,0
64880,2,1,226816,226817,226818,1,2,0
64881,3,3,226819,226819,226822,0,3,1
64882,2,3,226821,226822,226825,1,4,0
64883,2,3,226823,226825,226828,2,5,0
64884,5,2,226828,226828,226830,0,2,0
64885,6,1,226834,226834,226835,0,1,4
64886,6,3,226840,226840,226843,0,3,5
64887,3,1,226843,226843,226844,0,1,0
64888,5,3,226848,226848,226851,0,3,4
64889,6,1,226854,226854,226855,0,1,3
64890,6,3,226860,226860,226863,0,3,5
64891,4,1,226864,226864,226865,0,1,1
64892,6,1,226870,226870,226871,0,1,5
64893,2,1,226872,226872,226873,0,1,1
64894,5,3,226877,226877,226880,0,3,4
64895,5,3,226882,226882,226885,0,3,2
64896,3,1,226885,226885,226886,0,1,0
64897,1,3,226886,226886,226889,0,3,0
64898,4,1,226890,226890,226891,0,1,1
64899,6,2,226896,226896,226898,0,2,5
64900,1,3,226897,226898,226901,1,4,0
64901,6,1,226903,226903,226904,0,1,2
64902,1,3,226904,226904,226907,0,3,0
64903,1,2,226905,226907,226909,2,4,0
64904,6,3,226911,226911,226914,0,3,2
64905,3,3,226914,226914,226917,0,3,0
64906,4,1,226918,226918,226919,0,1,1
64907,1,3,226919,226919,226922,0,3,0
64908,3,3,226922,226922,226925,0,3,0
64909,3,3,226925,226925,226928,0,3,0
64910,2,2,226927,226928,226930,1,3,0
64911,3,2,226930,226930,226932,0,2,0
64912,2,3,226932,226932,226935,0,3,0
64913,5,1,226937,226937,226938,0,1,2
64914,1,1,226938,226938,226939,0,1,0
64915,2,3,226940,226940,226943,0,3,1
64916,5,3,226945,226945,226948,0,3,2
64917,2,1,226947,226948,226949,1,2,0
64918,5,1,226952,226952,226953,0,1,3
64919,1,1,226953,226953,226954,0,1,0
64920,4,1,226957,226957,226958,0,1,3
64921,1,2,226958,226958,226960,0,2,0
64922,2,2,226960,226960,226962,0,2,0
64923,1,2,226961,226962,226964,1,3,0
64924,3,3,226964,226964,226967,0,3,0
64925,6,3,226970,226970,226973,0,3,3
64926,1,2,226971,226973,226975,2,4,0
64927,6,2,226977,226977,226979,0,2,2
64928,5,3,226982,226982,226985,0,3,3
64929,6,1,226988,226988,226989,0,1,3
64930,2,2,226990,226990,226992,0,2,1
64931,4,2,226994,226994,226996,0,2,2
64932,4,3,226998,226998,227001,0,3,2
64933,1,2,226999,227001,227003,2,4,0
64934,6,2,227005,227005,227007,0,2,2
64935,6,1,227011,227011,227012,0,1,4
64936,3,3,227014,227014,227017,0,3,2
64937,1,3,227015,227017,227020,2,5,0
64938,3,3,227018,227020,227023,2,5,0
64939,2,3,227020,227023,227026,3,6,0
64940,6,1,227026,227026,227027,0,1,0
64941,3,1,227029,227029,227030,0,1,2
64942,6,1,227035,227035,227036,0,1,5
64943,4,1,227039,227039,227040,0,1,3
64944,1,3,227040,227040,227043,0,3,0
64945,3,2,227043,227043,227045,0,2,0
64946,3,1,227046,227046,227047,0,1,1
64947,3,2,227049,227049,227051,0,2,2
64948,1,2,227050,227051,227053,1,3,0
64949,2,1,227052,227053,227054,1,2,0
64950,1,2,227053,227054,227056,1,3,0
64951,6,1,227059,227059,227060,0,1,3
64952,2,1,227061,227061,227062,0,1,1
64953,5,3,227066,227066,227069,0,3,4
64954,6,3,227072,227072,227075,0,3,3
64955,6,2,227078,227078,227080,0,2,3
64956,5,1,227083,227083,227084,0,1,3
64957,1,3,227084,227084,227087,0,3,0
64958,3,3,227087,227087,227090,0,3,0
64959,5,1,227092,227092,227093,0,1,2
64960,3,2,227095,227095,227097,0,2,2
64961,3,2,227098,227098,227100,0,2,1
64962,6,3,227104,227104,227107,0,3,4
64963,5,1,227109,227109,227110,0,1,2
64964,5,1,227114,227114,227115,0,1,4
64965,4,1,227118,227118,227119,0,1,3
64966,4,3,227122,227122,227125,0,3,3
64967,4,3,227126,227126,227129,0,3,1
64968,2,3,227128,227129,227132,1,4,0
64969,1,2,227129,227132,227134,3,5,0
64970,1,2,227130,227134,227136,4,6,0
64971,1,2,227131,227136,227138,5,7,0
64972,2,2,227133,227138,227140,5,7,0
64973,6,3,227139,227140,227143,1,4,0
64974,4,3,227143,227143,227146,0,3,0
64975,5,1,227148,227148,227149,0,1,2
64976,6,3,227154,227154,227157,0,3,5
64977,2,2,227156,227157,227159,1,3,0
64978,2,2,227158,227159,227161,1,3,0
64979,1,1,227159,227161,227162,2,3,0
64980,1,3,227160,227162,227165,2,5,0
64981,1,2,227161,227165,227167,4,6,0
64982,6,2,227167,227167,227169,0,2,0
64983,1,2,227168,227169,227171,1,3,0
64984,5,2,227173,227173,227175,0,2,2
64985,2,2,227175,227175,227177,0,2,0
64986,3,2,227178,227178,227180,0,2,1
64987,1,1,227179,227180,227181,1,2,0
64988,2,2,227181,227181,227183,0,2,0
64989,5,1,227186,227186,227187,0,1,3
64990,5,1,227191,227191,227192,0,1,4
64991,1,1,227192,227192,227193,0,1,0
64992,3,2,227195,227195,227197,0,2,2
64993,5,2,227200,227200,227202,0,2,3
64994,4,2,227204,227204,227206,0,2,2
64995,2,3,227206,227206,227209,0,3,0
64996,1,3,227207,227209,227212,2,5,0
64997,6,3,227213,227213,227216,0,3,1
64998,3,2,227216,227216,227218,0,2,0
64999,4,3,227220,227220,227223,0,3,2
65000,1,3,227221,227223,227226,2,5,0
65001,2,2,227223,227226,227228,3,5,0
65002,4,1,227227,227228,227229,1,2,0
65003,6,1,227233,227233,227234,0,1,4
65004,6,2,227239,227239,227241,0,2,5
65005,6,1,227245,227245,227246,0,1,4
65006,5,1,227250,227250,227251,0,1,4
65007,1,3,227251,227251,227254,0,3,0
65008,6,2,227257,227257,227259,0,2,3
65009,3,2,227260,227260,227262,0,2,1
65010,2,3,227262,227262,227265,0,3,0
65011,6,2,227268,227268,227270,0,2,3
65012,5,2,227273,227273,227275,0,2,3
65013,3,3,227276,227276,227279,0,3,1
65014,1,3,227277,227279,227282,2,5,0
65015,1,1,227278,227282,227283,4,5,0
65016,4,2,227282,227283,227285,1,3,0
65017,3,1,227285,227285,227286,0,1,0
65018,6,1,227291,227291,227292,0,1,5
65019,2,3,227293,227293,227296,0,3,1
65020,4,1,227297,227297,227298,0,1,1
65021,6,1,227303,227303,227304,0,1,5
65022,3,1,227306,227306,227307,0,1,2
65023,2,3,227308,227308,227311,0,3,1
65024,4,3,227312,227312,227315,0,3,1
65025,2,2,227314,227315,227317,1,3,0
65026,5,1,227319,227319,227320,0,1,2
65027,3,1,227322,227322,227323,0,1,2
65028,1,1,227323,227323,227324,0,1,0
65029,1,2,227324,227324,227326,0,2,0
65030,1,2,227325,227326,227328,1,3,0
65031,5,3,227330,227330,227333,0,3,2
65032,6,3,227336,227336,227339,0,3,3
65033,6,2,227342,227342,227344,0,2,3
65034,2,2,227344,227344,227346,0,2,0
65035,5,2,227349,227349,227351,0,2,3
65036,1,2,227350,227351,227353,1,3,0
65037,3,3,227353,227353,227356,0,3,0
65038,4,1,227357,227357,227358,0,1,1
65039,4,2,227361,227361,227363,0,2,3
65040,2,2,227363,227363,227365,0,2,0
65041,4,1,227367,227367,227368,0,1,2
65042,5,1,227372,227372,227373,0,1,4
65043,3,3,227375,227375,227378,0,3,2
65044,2,1,227377,227378,227379,1,2,0
65045,1,2,227378,227379,227381,1,3,0
65046,2,3,227380,227381,227384,1,4,0
65047,5,1,227385,227385,227386,0,1,1
65048,4,1,227389,227389,227390,0,1,3
65049,6,3,227395,227395,227398,0,3,5
65050,5,3,227400,227400,227403,0,3,2
65051,1,1,227401,227403,227404,2,3,0
65052,5,3,227406,227406,227409,0,3,2
65053,3,2,227409,227409,227411,0,2,0
65054,3,3,227412,227412,227415,0,3,1
65055,1,1,227413,227415,227416,2,3,0
65056,4,1,227417,227417,227418,0,1,1
65057,2,1,227419,227419,227420,0,1,1
65058,6,1,227425,227425,227426,0,1,5
65059,6,3,227431,227431,227434,0,3,5
65060,6,2,227437,227437,227439,0,2,3
65061,5,2,227442,227442,227444,0,2,3
65062,5,1,227447,227447,227448,0,1,3
65063,2,3,227449,227449,227452,0,3,1
65064,6,1,227455,227455,227456,0,1,3
65065,5,2,227460,227460,227462,0,2,4
65066,1,1,227461,227462,227463,1,2,0
65067,2,3,227463,227463,227466,0,3,0
65068,3,2,227466,227466,227468,0,2,0
65069,4,2,227470,227470,227472,0,2,2
65070,3,2,227473,227473,227475,0,2,1
65071,3,2,227476,227476,227478,0,2,1
65072,1,2,227477,227478,227480,1,3,0
65073,6,3,227483,227483,227486,0,3,3
65074,2,3,227485,227486,227489,1,4,0
65075,1,2,227486,227489,227491,3,5,0
65076,2,1,227488,227491,227492,3,4,0
65077,2,2,227490,227492,227494,2,4,0
65078,3,2,227493,227494,227496,1,3,0
65079,1,2,227494,227496,227498,2,4,0
65080,6,1,227500,227500,227501,0,1,2
65081,1,2,227501,227501,227503,0,2,0
65082,6,1,227507,227507,227508,0,1,4
65083,5,1,227512,227512,227513,0,1,4
65084,2,3,227514,227514,227517,0,3,1
65085,5,3,227519,227519,227522,0,3,2
65086,6,1,227525,227525,227526,0,1,3
65087,4,1,227529,227529,227530,0,1,3
65088,3,1,227532,227532,227533,0,1,2
65089,3,1,227535,227535,227536,0,1,2
65090,1,3,227536,227536,227539,0,3,0
65091,4,3,227540,227540,227543,0,3,1
65092,2,1,227542,227543,227544,1,2,0
65093,1,1,227543,227544,227545,1,2,0
65094,2,3,227545,227545,227548,0,3,0
65095,2,1,227547,227548,227549,1,2,0
65096,1,1,227548,227549,227550,1,2,0
65097,2,3,227550,227550,227553,0,3,0
65098,6,1,227556,227556,227557,0,1,3
65099,2,3,227558,227558,227561,0,3,1
65100,3,1,227561,227561,227562,0,1,0
65101,4,1,227565,227565,227566,0,1,3
65102,3,2,227568,227568,227570,0,2,2
65103,4,3,227572,227572,227575,0,3,2
65104,4,3,227576,227576,227579,0,3,1
65105,2,3,227578,227579,227582,1,4,0
65106,2,1,227580,227582,227583,2,3,0
65107,6,2,227586,227586,227588,0,2,3
65108,5,1,227591,227591,227592,0,1,3
65109,3,1,227594,227594,227595,0,1,2
65110,1,1,227595,227595,227596,0,1,0
65111,5,2,227600,227600,227602,0,2,4
65112,2,3,227602,227602,227605,0,3,0
65113,2,2,227604,227605,227607,1,3,0
65114,5,2,227609,227609,227611,0,2,2
65115,4,2,227613,227613,227615,0,2,2
65116,6,1,227619,227619,227620,0,1,4
65117,5,3,227624,227624,227627,0,3,4
65118,1,1,227625,227627,227628,2,3,0
65119,4,3,227629,227629,227632,0,3,1
65120,1,3,227630,227632,227635,2,5,0
65121,2,2,227632,227635,227637,3,5,0
65122,5,1,227637,227637,227638,0,1,0
65123,6,1,227643,227643,227644,0,1,5
65124,1,3,227644,227644,227647,0,3,0
65125,3,2,227647,227647,227649,0,2,0
65126,5,1,227652,227652,227653,0,1,3
65127,6,2,227658,227658,227660,0,2,5
65128,3,2,227661,227661,227663,0,2,1
65129,1,1,227662,227663,227664,1,2,0
65130,2,2,227664,227664,227666,0,2,0
65131,6,1,227670,227670,227671,0,1,4
65132,5,1,227675,227675,227676,0,1,4
65133,5,3,227680,227680,227683,0,3,4
65134,2,1,227682,227683,227684,1,2,0
65135,1,2,227683,227684,227686,1,3,0
65136,3,2,227686,227686,227688,0,2,0
65137,2,2,227688,227688,227690,0,2,0
65138,6,2,227694,227694,227696,0,2,4
65139,4,1,227698,227698,227699,0,1,2
65140,6,2,227704,227704,227706,0,2,5
65141,2,1,227706,227706,227707,0,1,0
65142,1,3,227707,227707,227710,0,3,0
65143,5,3,227712,227712,227715,0,3,2
65144,6,3,227718,227718,227721,0,3,3
65145,2,3,227720,227721,227724,1,4,0
65146,3,1,227723,227724,227725,1,2,0
65147,3,1,227726,227726,227727,0,1,1
65148,3,1,227729,227729,227730,0,1,2
65149,4,3,227733,227733,227736,0,3,3
65150,2,3,227735,227736,227739,1,4,0
65151,1,2,227736,227739,227741,3,5,0
65152,3,1,227739,227741,227742,2,3,0
65153,3,2,227742,227742,227744,0,2,0
65154,5,1,227747,227747,227748,0,1,3
65155,1,1,227748,227748,227749,0,1,0
65156,5,2,227753,227753,227755,0,2,4
65157,5,1,227758,227758,227759,0,1,3
65158,3,2,227761,227761,227763,0,2,2
65159,3,1,227764,227764,227765,0,1,1
65160,1,2,227765,227765,227767,0,2,0
65161,1,1,227766,227767,227768,1,2,0
65162,2,3,227768,227768,227771,0,3,0
65163,4,3,227772,227772,227775,0,3,1
65164,4,1,227776,227776,227777,0,1,1
65165,5,1,227781,227781,227782,0,1,4
65166,3,2,227784,227784,227786,0,2,2
65167,1,2,227785,227786,227788,1,3,0
65168,6,1,227791,227791,227792,0,1,3
65169,4,1,227795,227795,227796,0,1,3
65170,1,1,227796,227796,227797,0,1,0
65171,3,3,227799,227799,227802,0,3,2
65172,4,1,227803,227803,227804,0,1,1
65173,1,3,227804,227804,227807,0,3,0
65174,4,1,227808,227808,227809,0,1,1
65175,6,2,227814,227814,227816,0,2,5
65176,2,3,227816,227816,227819,0,3,0
65177,3,3,227819,227819,227822,0,3,0
65178,3,2,227822,227822,227824,0,2,0
65179,6,3,227828,227828,227831,0,3,4
65180,3,3,227831,227831,227834,0,3,0
65181,1,3,227832,227834,227837,2,5,0
65182,4,3,227836,227837,227840,1,4,0
65183,4,1,227840,227840,227841,0,1,0
65184,2,1,227842,227842,227843,0,1,1
65185,2,1,227844,227844,227845,0,1,1
65186,3,3,227847,227847,227850,0,3,2
65187,5,3,227852,227852,227855,0,3,2
65188,5,1,227857,227857,227858,0,1,2
65189,6,3,227863,227863,227866,0,3,5
65190,2,1,227865,227866,227867,1,2,0
65191,1,1,227866,227867,227868,1,2,0
65192,1,2,227867,227868,227870,1,3,0
65193,5,3,227872,227872,227875,0,3,2
65194,1,1,227873,227875,227876,2,3,0
65195,6,3,227879,227879,227882,0,3,3
65196,6,3,227885,227885,227888,0,3,3
65197,4,2,227889,227889,227891,0,2,1
65198,5,3,227894,227894,227897,0,3,3
65199,3,3,227897,227897,227900,0,3,0
65200,5,3,227902,227902,227905,0,3,2
65201,6,3,227908,227908,227911,0,3,3
65202,1,3,227909,227911,227914,2,5,0
65203,5,2,227914,227914,227916,0,2,0
65204,4,1,227918,227918,227919,0,1,2
65205,5,1,227923,227923,227924,0,1,4
65206,4,3,227927,227927,227930,0,3,3
65207,6,3,227933,227933,227936,0,3,3
65208,5,1,227938,227938,227939,0,1,2
65209,4,3,227942,227942,227945,0,3,3
65210,1,2,227943,227945,227947,2,4,0
65211,4,3,227947,227947,227950,0,3,0
65212,6,1,227953,227953,227954,0,1,3
65213,1,1,227954,227954,227955,0,1,0
65214,1,3,227955,227955,227958,0,3,0
65215,2,2,227957,227958,227960,1,3,0
65216,1,3,227958,227960,227963,2,5,0
65217,3,3,227961,227963,227966,2,5,0
65218,4,2,227965,227966,227968,1,3,0
65219,6,2,227971,227971,227973,0,2,3
65220,6,1,227977,227977,227978,0,1,4
65221,1,1,227978,227978,227979,0,1,0
65222,4,3,227982,227982,227985,0,3,3
65223,1,2,227983,227985,227987,2,4,0
65224,2,3,227985,227987,227990,2,5,0
65225,1,1,227986,227990,227991,4,5,0
65226,1,3,227987,227991,227994,4,7,0
65227,5,1,227992,227994,227995,2,3,0
65228,5,3,227997,227997,228000,0,3,2
65229,2,1,227999,228000,228001,1,2,0
65230,6,3,228005,228005,228008,0,3,4
65231,4,1,228009,228009,228010,0,1,1
65232,3,1,228012,228012,228013,0,1,2
65233,3,3,228015,228015,228018,0,3,2
65234,3,1,228018,228018,228019,0,1,0
65235,1,3,228019,228019,228022,0,3,0
65236,3,1,228022,228022,228023,0,1,0
65237,4,1,228026,228026,228027,0,1,3
65238,1,1,228027,228027,228028,0,1,0
65239,5,2,228032,228032,228034,0,2,4
65240,2,1,228034,228034,228035,0,1,0
65241,2,1,228036,228036,228037,0,1,1
65242,2,3,228038,228038,228041,0,3,1
65243,2,1,228040,228041,228042,1,2,0
65244,4,1,228044,228044,228045,0,1,2
65245,6,2,228050,228050,228052,0,2,5
65246,4,1,228054,228054,228055,0,1,2
65247,2,2,228056,228056,228058,0,2,1
65248,3,3,228059,228059,228062,0,3,1
65249,1,3,228060,228062,228065,2,5,0
65250,5,1,228065,228065,228066,0,1,0
65251,2,1,228067,228067,228068,0,1,1
65252,5,3,228072,228072,228075,0,3,4
65253,5,3,228077,228077,228080,0,3,2
65254,5,2,228082,228082,228084,0,2,2
65255,2,2,228084,228084,228086,0,2,0
65256,3,2,228087,228087,228089,0,2,1
65257,4,1,228091,228091,228092,0,1,2
65258,5,1,228096,228096,228097,0,1,4
65259,3,1,228099,228099,228100,0,1,2
65260,1,3,228100,228100,228103,0,3,0
65261,6,2,228106,228106,228108,0,2,3
65262,1,1,228107,228108,228109,1,2,0
65263,2,2,228109,228109,228111,0,2,0
65264,2,3,228111,228111,228114,0,3,0
65265,3,1,228114,228114,228115,0,1,0
65266,2,1,228116,228116,228117,0,1,1
65267,4,3,228120,228120,228123,0,3,3
65268,1,3,228121,228123,228126,2,5,0
65269,5,2,228126,228126,228128,0,2,0
65270,5,3,228131,228131,228134,0,3,3
65271,3,3,228134,228134,228137,0,3,0
65272,4,2,228138,228138,228140,0,2,1
65273,2,3,228140,228140,228143,0,3,0
65274,3,3,228143,228143,228146,0,3,0
65275,3,3,228146,228146,228149,0,3,0
65276,5,3,228151,228151,228154,0,3,2
65277,5,2,228156,228156,228158,0,2,2
65278,2,1,228158,228158,228159,0,1,0
65279,4,1,228162,228162,228163,0,1,3
65280,2,1,228164,228164,228165,0,1,1
65281,1,2,228165,228165,228167,0,2,0
65282,2,1,228167,228167,228168,0,1,0
65283,2,3,228169,228169,228172,0,3,1
65284,2,2,228171,228172,228174,1,3,0
65285,1,2,228172,228174,228176,2,4,0
65286,1,3,228173,228176,228179,3,6,0
65287,4,2,228177,228179,228181,2,4,0
65288,1,3,228178,228181,228184,3,6,0
65289,5,2,228183,228184,228186,1,3,0
65290,5,3,228188,228188,228191,0,3,2
65291,2,2,228190,228191,228193,1,3,0
65292,1,2,228191,228193,228195,2,4,0
65293,4,1,228195,228195,228196,0,1,0
65294,1,1,228196,228196,228197,0,1,0
65295,1,2,228197,228197,228199,0,2,0
65296,1,1,228198,228199,228200,1,2,0
65297,6,3,228204,228204,228207,0,3,4
65298,2,3,228206,228207,228210,1,4,0
65299,4,1,228210,228210,228211,0,1,0
65300,5,1,228215,228215,228216,0,1,4
65301,4,3,228219,228219,228222,0,3,3
65302,1,2,228220,228222,228224,2,4,0
65303,4,1,228224,228224,228225,0,1,0
65304,6,3,228230,228230,228233,0,3,5
65305,4,3,228234,228234,228237,0,3,1
65306,5,2,228239,228239,228241,0,2,2
65307,2,1,228241,228241,228242,0,1,0
65308,2,2,228243,228243,228245,0,2,1
65309,6,1,228249,228249,228250,0,1,4
65310,6,2,228255,228255,228257,0,2,5
65311,2,3,228257,228257,228260,0,3,0
65312,6,3,228263,228263,228266,0,3,3
65313,4,3,228267,228267,228270,0,3,1
65314,1,1,228268,228270,228271,2,3,0
65315,5,3,228273,228273,228276,0,3,2
65316,5,2,228278,228278,228280,0,2,2
65317,6,2,228284,228284,228286,0,2,4
65318,4,3,228288,228288,228291,0,3,2
65319,5,3,228293,228293,228296,0,3,2
65320,4,3,228297,228297,228300,0,3,1
65321,5,1,228302,228302,228303,0,1,2
65322,3,2,228305,228305,228307,0,2,2
65323,5,1,228310,228310,228311,0,1,3
65324,1,1,228311,228311,228312,0,1,0
65325,1,2,228312,228312,228314,0,2,0
65326,2,1,228314,228314,228315,0,1,0
65327,5,3,228319,228319,228322,0,3,4
65328,1,2,228320,228322,228324,2,4,0
65329,3,2,228323,228324,228326,1,3,0
65330,4,1,228327,228327,228328,0,1,1
65331,6,3,228333,228333,228336,0,3,5
65332,3,3,228336,228336,228339,0,3,0
65333,5,1,228341,228341,228342,0,1,2
65334,2,2,228343,228343,228345,0,2,1
65335,5,2,228348,228348,228350,0,2,3
65336,4,3,228352,228352,228355,0,3,2
65337,5,2,228357,228357,228359,0,2,2
65338,1,3,228358,228359,228362,1,4,0
65339,6,1,228364,228364,228365,0,1,2
65340,1,1,228365,228365,228366,0,1,0
65341,6,1,228371,228371,228372,0,1,5
65342,3,2,228374,228374,228376,0,2,2
65343,1,3,228375,228376,228379,1,4,0
65344,5,1,228380,228380,228381,0,1,1
65345,6,3,228386,228386,228389,0,3,5
65346,1,3,228387,228389,228392,2,5,0
65347,1,3,228388,228392,228395,4,7,0
65348,6,2,228394,228395,228397,1,3,0
65349,2,3,228396,228397,228400,1,4,0
65350,6,3,228402,228402,228405,0,3,2
65351,6,1,228408,228408,228409,0,1,3
65352,6,3,228414,228414,228417,0,3,5
65353,3,1,228417,228417,228418,0,1,0
65354,3,1,228420,228420,228421,0,1,2
65355,1,2,228421,228421,228423,0,2,0
65356,5,2,228426,228426,228428,0,2,3
65357,5,1,228431,228431,228432,0,1,3
65358,2,2,228433,228433,228435,0,2,1
65359,5,2,228438,228438,228440,0,2,3
65360,3,3,228441,228441,228444,0,3,1
65361,2,3,228443,228444,228447,1,4,0
65362,4,2,228447,228447,228449,0,2,0
65363,6,1,228453,228453,228454,0,1,4
65364,3,3,228456,228456,228459,0,3,2
65365,6,2,228462,228462,228464,0,2,3
65366,6,2,228468,228468,228470,0,2,4
65367,3,3,228471,228471,228474,0,3,1
65368,3,2,228474,228474,228476,0,2,0
65369,4,2,228478,228478,228480,0,2,2
65370,6,3,228484,228484,228487,0,3,4
65371,4,1,228488,228488,228489,0,1,1
65372,6,2,228494,228494,228496,0,2,5
65373,3,1,228497,228497,228498,0,1,1
65374,4,2,228501,228501,228503,0,2,3
65375,3,3,228504,228504,228507,0,3,1
65376,1,3,228505,228507,228510,2,5,0
65377,2,3,228507,228510,228513,3,6,0
65378,4,2,228511,228513,228515,2,4,0
65379,3,2,228514,228515,228517,1,3,0
65380,4,2,228518,228518,228520,0,2,1
65381,6,3,228524,228524,228527,0,3,4
65382,1,3,228525,228527,228530,2,5,0
65383,6,2,228531,228531,228533,0,2,1
65384,3,1,228534,228534,228535,0,1,1
65385,6,3,228540,228540,228543,0,3,5
65386,4,2,228544,228544,228546,0,2,1
65387,2,3,228546,228546,228549,0,3,0
65388,4,2,228550,228550,228552,0,2,1
65389,6,2,228556,228556,228558,0,2,4
65390,1,3,228557,228558,228561,1,4,0
65391,3,2,228560,228561,228563,1,3,0
65392,3,3,228563,228563,228566,0,3,0
65393,3,2,228566,228566,228568,0,2,0
65394,1,3,228567,228568,228571,1,4,0
65395,4,2,228571,228571,228573,0,2,0
65396,3,1,228574,228574,228575,0,1,1
65397,4,1,228578,228578,228579,0,1,3
65398,6,1,228584,228584,228585,0,1,5
65399,3,3,228587,228587,228590,0,3,2
65400,3,1,228590,228590,228591,0,1,0
65401,2,2,228592,228592,228594,0,2,1
65402,2,3,228594,228594,228597,0,3,0
65403,6,1,228600,228600,228601,0,1,3
65404,1,2,228601,228601,228603,0,2,0
65405,2,1,228603,228603,228604,0,1,0
65406,5,1,228608,228608,228609,0,1,4
65407,4,1,228612,228612,228613,0,1,3
65408,2,1,228614,228614,228615,0,1,1
65409,4,2,228618,228618,228620,0,2,3
65410,5,1,228623,228623,228624,0,1,3
65411,2,1,228625,228625,228626,0,1,1
65412,2,3,228627,228627,228630,0,3,1
65413,5,3,228632,228632,228635,0,3,2
65414,4,2,228636,228636,228638,0,2,1
65415,2,2,228638,228638,228640,0,2,0
65416,2,2,228640,228640,228642,0,2,0
65417,6,2,228646,228646,228648,0,2,4
65418,4,1,228650,228650,228651,0,1,2
65419,1,1,228651,228651,228652,0,1,0
65420,4,2,228655,228655,228657,0,2,3
65421,3,3,228658,228658,228661,0,3,1
65422,6,1,228664,228664,228665,0,1,3
65423,2,3,228666,228666,228669,0,3,1
65424,3,2,228669,228669,228671,0,2,0
65425,6,3,228675,228675,228678,0,3,4
65426,1,1,228676,228678,228679,2,3,0
65427,3,3,228679,228679,228682,0,3,0
65428,6,2,228685,228685,228687,0,2,3
65429,3,1,228688,228688,228689,0,1,1
65430,4,3,228692,228692,228695,0,3,3
65431,5,3,228697,228697,228700,0,3,2
65432,6,2,228703,228703,228705,0,2,3
65433,2,2,228705,228705,228707,0,2,0
65434,1,3,228706,228707,228710,1,4,0
65435,6,1,228712,228712,228713,0,1,2
65436,2,2,228714,228714,228716,0,2,1
65437,3,1,228717,228717,228718,0,1,1
65438,1,2,228718,228718,228720,0,2,0
65439,4,2,228722,228722,228724,0,2,2
65440,2,3,228724,228724,228727,0,3,0
65441,6,3,228730,228730,228733,0,3,3
65442,5,1,228735,228735,228736,0,1,2
65443,2,1,228737,228737,228738,0,1,1
65444,1,2,228738,228738,228740,0,2,0
65445,4,2,228742,228742,228744,0,2,2
65446,3,1,228745,228745,228746,0,1,1
65447,5,1,228750,228750,228751,0,1,4
65448,5,3,228755,228755,228758,0,3,4
65449,3,3,228758,228758,228761,0,3,0
65450,3,1,228761,228761,228762,0,1,0
65451,4,2,228765,228765,228767,0,2,3
65452,4,3,228769,228769,228772,0,3,2
65453,6,1,228775,228775,228776,0,1,3
65454,4,2,228779,228779,228781,0,2,3
65455,1,2,228780,228781,228783,1,3,0
65456,3,1,228783,228783,228784,0,1,0
65457,6,1,228789,228789,228790,0,1,5
65458,1,2,228790,228790,228792,0,2,0
65459,3,3,228793,228793,228796,0,3,1
65460,2,1,228795,228796,228797,1,2,0
65461,4,2,228799,228799,228801,0,2,2
65462,5,1,228804,228804,228805,0,1,3
65463,1,2,228805,228805,228807,0,2,0
65464,2,1,228807,228807,228808,0,1,0
65465,1,1,228808,228808,228809,0,1,0
65466,5,1,228813,228813,228814,0,1,4
65467,6,2,228819,228819,228821,0,2,5
65468,4,3,228823,228823,228826,0,3,2
65469,4,2,228827,228827,228829,0,2,1
65470,2,2,228829,228829,228831,0,2,0
65471,5,1,228834,228834,228835,0,1,3
65472,3,3,228837,228837,228840,0,3,2
65473,1,3,228838,228840,228843,2,5,0
65474,1,3,228839,228843,228846,4,7,0
65475,6,3,228845,228846,228849,1,4,0
65476,6,3,228851,228851,228854,0,3,2
65477,6,3,228857,228857,228860,0,3,3
65478,3,1,228860,228860,228861,0,1,0
65479,6,2,228866,228866,228868,0,2,5
65480,1,2,228867,228868,228870,1,3,0
65481,2,3,228869,228870,228873,1,4,0
65482,5,3,228874,228874,228877,0,3,1
65483,2,3,228876,228877,228880,1,4,0
65484,2,2,228878,228880,228882,2,4,0
65485,2,1,228880,228882,228883,2,3,0
65486,1,1,228881,228883,228884,2,3,0
65487,2,3,228883,228884,228887,1,4,0
65488,4,3,228887,228887,228890,0,3,0
65489,3,3,228890,228890,228893,0,3,0
65490,5,2,228895,228895,228897,0,2,2
65491,5,3,228900,228900,228903,0,3,3
65492,3,2,228903,228903,228905,0,2,0
65493,4,3,228907,228907,228910,0,3,2
65494,4,1,228911,228911,228912,0,1,1
65495,5,1,228916,228916,228917,0,1,4
65496,6,3,228922,228922,228925,0,3,5
65497,2,1,228924,228925,228926,1,2,0
65498,6,3,228930,228930,228933,0,3,4
65499,1,1,228931,228933,228934,2,3,0
65500,2,2,228933,228934,228936,1,3,0
65501,6,2,228939,228939,228941,0,2,3
65502,2,2,228941,228941,228943,0,2,0
65503,3,3,228944,228944,228947,0,3,1
65504,2,2,228946,228947,228949,1,3,0
65505,3,2,228949,228949,228951,0,2,0
65506,1,1,228950,228951,228952,1,2,0
65507,5,3,228955,228955,228958,0,3,3
65508,2,3,228957,228958,228961,1,4,0
65509,6,1,228963,228963,228964,0,1,2
65510,6,3,228969,228969,228972,0,3,5
65511,6,2,228975,228975,228977,0,2,3
65512,2,1,228977,228977,228978,0,1,0
65513,4,1,228981,228981,228982,0,1,3
65514,2,1,228983,228983,228984,0,1,1
65515,1,3,228984,228984,228987,0,3,0
65516,6,1,228990,228990,228991,0,1,3
65517,3,2,228993,228993,228995,0,2,2
65518,5,2,228998,228998,229000,0,2,3
65519,3,3,229001,229001,229004,0,3,1
65520,6,2,229007,229007,229009,0,2,3
65521,6,2,229013,229013,229015,0,2,4
65522,3,1,229016,229016,229017,0,1,1
65523,5,1,229021,229021,229022,0,1,4
65524,2,3,229023,229023,229026,0,3,1
65525,3,1,229026,229026,229027,0,1,0
65526,3,2,229029,229029,229031,0,2,2
65527,4,1,229033,229033,229034,0,1,2
65528,1,1,229034,229034,229035,0,1,0
65529,2,3,229036,229036,229039,0,3,1
65530,2,2,229038,229039,229041,1,3,0
65531,5,3,229043,229043,229046,0,3,2
65532,1,2,229044,229046,229048,2,4,0
65533,1,1,229045,229048,229049,3,4,0
65534,5,1,229050,229050,229051,0,1,1
65535,1,3,229051,229051,229054,0,3,0
65536,5,1,229056,229056,229057,0,1,2
65537,6,3,229062,229062,229065,0,3,5
65538,3,1,229065,229065,229066,0,1,0
65539,5,2,229070,229070,229072,0,2,4
65540,3,2,229073,229073,229075,0,2,1
65541,4,3,229077,229077,229080,0,3,2
65542,4,2,229081,229081,229083,0,2,1
65543,5,1,229086,229086,229087,0,1,3
65544,2,3,229088,229088,229091,0,3,1
65545,1,2,229089,229091,229093,2,4,0
65546,4,1,229093,229093,229094,0,1,0
65547,2,1,229095,229095,229096,0,1,1
65548,1,2,229096,229096,229098,0,2,0
65549,6,1,229102,229102,229103,0,1,4
65550,4,3,229106,229106,229109,0,3,3
65551,3,1,229109,229109,229110,0,1,0
65552,4,1,229113,229113,229114,0,1,3
65553,5,3,229118,229118,229121,0,3,4
65554,5,1,229123,229123,229124,0,1,2
65555,2,1,229125,229125,229126,0,1,1
65556,3,2,229128,229128,229130,0,2,2
65557,2,2,229130,229130,229132,0,2,0
65558,3,3,229133,229133,229136,0,3,1
65559,2,1,229135,229136,229137,1,2,0
65560,3,1,229138,229138,229139,0,1,1
65561,1,3,229139,229139,229142,0,3,0
65562,3,2,229142,229142,229144,0,2,0
65563,3,2,229145,229145,229147,0,2,1
65564,4,3,229149,229149,229152,0,3,2
65565,6,1,229155,229155,229156,0,1,3
65566,4,1,229159,229159,229160,0,1,3
65567,1,3,229160,229160,229163,0,3,0
65568,5,2,229165,229165,229167,0,2,2
65569,3,3,229168,229168,229171,0,3,1
65570,2,2,229170,229171,229173,1,3,0
65571,2,3,229172,229173,229176,1,4,0
65572,5,3,229177,229177,229180,0,3,1
65573,1,2,229178,229180,229182,2,4,0
65574,1,1,229179,229182,229183,3,4,0
65575,3,2,229182,229183,229185,1,3,0
65576,1,3,229183,229185,229188,2,5,0
65577,4,3,229187,229188,229191,1,4,0
65578,6,1,229193,229193,229194,0,1,2
65579,5,3,229198,229198,229201,0,3,4
65580,2,2,229200,229201,229203,1,3,0
65581,3,3,229203,229203,229206,0,3,0
65582,1,2,229204,229206,229208,2,4,0
65583,1,3,229205,229208,229211,3,6,0
65584,2,3,229207,229211,229214,4,7,0
65585,1,3,229208,229214,229217,6,9,0
65586,1,2,229209,229217,229219,8,10,0
65587,4,2,229213,229219,229221,6,8,0
65588,4,1,229217,229221,229222,4,5,0
65589,1,3,229218,229222,229225,4,7,0
65590,1,1,229219,229225,229226,6,7,0
65591,1,2,229220,229226,229228,6,8,0
65592,5,3,229225,229228,229231,3,6,0
65593,6,2,229231,229231,229233,0,2,0
65594,3,1,229234,229234,229235,0,1,1
65595,4,2,229238,229238,229240,0,2,3
65596,6,1,229244,229244,229245,0,1,4
65597,3,1,229247,229247,229248,0,1,2
65598,4,3,229251,229251,229254,0,3,3
65599,3,2,229254,229254,229256,0,2,0
65600,5,2,229259,229259,229261,0,2,3
65601,5,2,229264,229264,229266,0,2,3
65602,4,3,229268,229268,229271,0,3,2
65603,6,2,229274,229274,229276,0,2,3
65604,6,1,229280,229280,229281,0,1,4
65605,5,2,229285,229285,229287,0,2,4
65606,2,2,229287,229287,229289,0,2,0
65607,1,2,229288,229289,229291,1,3,0
65608,5,2,229293,229293,229295,0,2,2
65609,6,1,229299,229299,229300,0,1,4
65610,3,2,229302,229302,229304,0,2,2
65611,2,2,229304,229304,229306,0,2,0
65612,4,3,229308,229308,229311,0,3,2
65613,3,3,229311,229311,229314,0,3,0
65614,1,1,229312,229314,229315,2,3,0
65615,1,3,229313,229315,229318,2,5,0
65616,3,1,229316,229318,229319,2,3,0
65617,2,1,229318,229319,229320,1,2,0
65618,5,3,229323,229323,229326,0,3,3
65619,4,1,229327,229327,229328,0,1,1
65620,6,1,229333,229333,229334,0,1,5
65621,5,1,229338,229338,229339,0,1,4
65622,4,3,229342,229342,229345,0,3,3
65623,1,3,229343,229345,229348,2,5,0
65624,3,1,229346,229348,229349,2,3,0
65625,2,1,229348,229349,229350,1,2,0
65626,6,1,229354,229354,229355,0,1,4
65627,3,1,229357,229357,229358,0,1,2
65628,3,1,229360,229360,229361,0,1,2
65629,2,2,229362,229362,229364,0,2,1
65630,5,1,229367,229367,229368,0,1,3
65631,4,1,229371,229371,229372,0,1,3
65632,1,1,229372,229372,229373,0,1,0
65633,3,3,229375,229375,229378,0,3,2
65634,3,2,229378,229378,229380,0,2,0
65635,6,3,229384,229384,229387,0,3,4
65636,3,1,229387,229387,229388,0,1,0
65637,6,1,229393,229393,229394,0,1,5
65638,1,3,229394,229394,229397,0,3,0
65639,5,3,229399,229399,229402,0,3,2
65640,3,1,229402,229402,229403,0,1,0
65641,5,3,229407,229407,229410,0,3,4
65642,3,3,229410,229410,229413,0,3,0
65643,4,2,229414,229414,229416,0,2,1
65644,1,3,229415,229416,229419,1,4,0
65645,2,2,229417,229419,229421,2,4,0
65646,3,1,229420,229421,229422,1,2,0
65647,1,2,229421,229422,229424,1,3,0
65648,5,1,229426,229426,229427,0,1,2
65649,5,3,229431,229431,229434,0,3,4
65650,1,3,229432,229434,229437,2,5,0
65651,1,3,229433,229437,229440,4,7,0
65652,2,1,229435,229440,229441,5,6,0
65653,2,3,229437,229441,229444,4,7,0
65654,1,3,229438,229444,229447,6,9,0
65655,3,2,229441,229447,229449,6,8,0
65656,5,1,229446,229449,229450,3,4,0
65657,6,2,229452,229452,229454,0,2,2
65658,6,2,229458,229458,229460,0,2,4
65659,3,3,229461,229461,229464,0,3,1
65660,4,2,229465,229465,229467,0,2,1
65661,1,3,229466,229467,229470,1,4,0
65662,3,1,229469,229470,229471,1,2,0
65663,1,2,229470,229471,229473,1,3,0
65664,4,1,229474,229474,229475,0,1,1
65665,4,2,229478,229478,229480,0,2,3
65666,5,3,229483,229483,229486,0,3,3
65667,3,1,229486,229486,229487,0,1,0
65668,1,3,229487,229487,229490,0,3,0
65669,6,1,229493,229493,229494,0,1,3
65670,2,2,229495,229495,229497,0,2,1
65671,4,3,229499,229499,229502,0,3,2
65672,4,2,229503,229503,229505,0,2,1
65673,5,1,229508,229508,229509,0,1,3
65674,1,2,229509,229509,229511,0,2,0
65675,4,2,229513,229513,229515,0,2,2
65676,6,3,229519,229519,229522,0,3,4
65677,2,1,229521,229522,229523,1,2,0
65678,4,2,229525,229525,229527,0,2,2
65679,1,3,229526,229527,229530,1,4,0
65680,1,1,229527,229530,229531,3,4,0
65681,2,2,229529,229531,229533,2,4,0
65682,3,3,229532,229533,229536,1,4,0
65683,4,2,229536,229536,229538,0,2,0
65684,1,3,229537,229538,229541,1,4,0
65685,1,1,229538,229541,229542,3,4,0
65686,6,1,229544,229544,229545,0,1,2
65687,2,2,229546,229546,229548,0,2,1
65688,2,2,229548,229548,229550,0,2,0
65689,4,1,229552,229552,229553,0,1,2
65690,1,3,229553,229553,229556,0,3,0
65691,4,3,229557,229557,229560,0,3,1
65692,4,3,229561,229561,229564,0,3,1
65693,5,2,229566,229566,229568,0,2,2
65694,4,3,229570,229570,229573,0,3,2
65695,6,2,229576,229576,229578,0,2,3
65696,5,1,229581,229581,229582,0,1,3
65697,2,3,229583,229583,229586,0,3,1
65698,3,1,229586,229586,229587,0,1,0
65699,2,3,229588,229588,229591,0,3,1
65700,6,1,229594,229594,229595,0,1,3
65701,1,2,229595,229595,229597,0,2,0
65702,5,2,229600,229600,229602,0,2,3
65703,4,3,229604,229604,229607,0,3,2
65704,6,3,229610,229610,229613,0,3,3
65705,4,1,229614,229614,229615,0,1,1
65706,2,1,229616,229616,229617,0,1,1
65707,1,3,229617,229617,229620,0,3,0
65708,1,1,229618,229620,229621,2,3,0
65709,6,3,229624,229624,229627,0,3,3
65710,5,3,229629,229629,229632,0,3,2
65711,4,2,229633,229633,229635,0,2,1
65712,2,3,229635,229635,229638,0,3,0
65713,4,2,229639,229639,229641,0,2,1
65714,2,1,229641,229641,229642,0,1,0
65715,2,3,229643,229643,229646,0,3,1
65716,3,2,229646,229646,229648,0,2,0
65717,4,1,229650,229650,229651,0,1,2
65718,2,2,229652,229652,229654,0,2,1
65719,4,3,229656,229656,229659,0,3,2
65720,1,1,229657,229659,229660,2,3,0
65721,5,1,229662,229662,229663,0,1,2
65722,3,2,229665,229665,229667,0,2,2
65723,2,1,229667,229667,229668,0,1,0
65724,1,2,229668,229668,229670,0,2,0
65725,3,1,229671,229671,229672,0,1,1
65726,6,2,229677,229677,229679,0,2,5
65727,2,2,229679,229679,229681,0,2,0
65728,2,1,229681,229681,229682,0,1,0
65729,5,1,229686,229686,229687,0,1,4
65730,1,2,229687,229687,229689,0,2,0
65731,6,2,229693,229693,229695,0,2,4
65732,6,1,229699,229699,229700,0,1,4
65733,6,1,229705,229705,229706,0,1,5
65734,3,1,229708,229708,229709,0,1,2
65735,2,2,229710,229710,229712,0,2,1
65736,2,1,229712,229712,229713,0,1,0
65737,2,3,229714,229714,229717,0,3,1
65738,4,2,229718,229718,229720,0,2,1
65739,2,2,229720,229720,229722,0,2,0
65740,1,3,229721,229722,229725,1,4,0
65741,2,1,229723,229725,229726,2,3,0
65742,4,3,229727,229727,229730,0,3,1
65743,2,1,229729,229730,229731,1,2,0
65744,1,1,229730,229731,229732,1,2,0
65745,1,2,229731,229732,229734,1,3,0
65746,4,2,229735,229735,229737,0,2,1
65747,4,1,229739,229739,229740,0,1,2
65748,6,3,229745,229745,229748,0,3,5
65749,5,1,229750,229750,229751,0,1,2
65750,5,3,229755,229755,229758,0,3,4
65751,2,1,229757,229758,229759,1,2,0
65752,1,2,229758,229759,229761,1,3,0
65753,6,3,229764,229764,229767,0,3,3
65754,3,2,229767,229767,229769,0,2,0
65755,4,1,229771,229771,229772,0,1,2
65756,5,1,229776,229776,229777,0,1,4
65757,4,3,229780,229780,229783,0,3,3
65758,2,1,229782,229783,229784,1,2,0
65759,4,1,229786,229786,229787,0,1,2
65760,5,2,229791,229791,229793,0,2,4
65761,2,2,229793,229793,229795,0,2,0
65762,6,1,229799,229799,229800,0,1,4
65763,5,1,229804,229804,229805,0,1,4
65764,4,1,229808,229808,229809,0,1,3
65765,2,1,229810,229810,229811,0,1,1
65766,3,1,229813,229813,229814,0,1,2
65767,2,3,229815,229815,229818,0,3,1
65768,6,1,229821,229821,229822,0,1,3
65769,5,2,229826,229826,229828,0,2,4
65770,2,1,229828,229828,229829,0,1,0
65771,6,1,229834,229834,229835,0,1,5
65772,6,3,229840,229840,229843,0,3,5
65773,1,2,229841,229843,229845,2,4,0
65774,5,3,229846,229846,229849,0,3,1
65775,1,1,229847,229849,229850,2,3,0
65776,2,1,229849,229850,229851,1,2,0
65777,3,3,229852,229852,229855,0,3,1
65778,3,2,229855,229855,229857,0,2,0
65779,1,2,229856,229857,229859,1,3,0
65780,5,3,229861,229861,229864,0,3,2
65781,2,1,229863,229864,229865,1,2,0
65782,4,2,229867,229867,229869,0,2,2
65783,3,3,229870,229870,229873,0,3,1
65784,3,2,229873,229873,229875,0,2,0
65785,2,3,229875,229875,229878,0,3,0
65786,5,2,229880,229880,229882,0,2,2
65787,1,2,229881,229882,229884,1,3,0
65788,6,2,229887,229887,229889,0,2,3
65789,3,1,229890,229890,229891,0,1,1
65790,4,3,229894,229894,229897,0,3,3
65791,3,2,229897,229897,229899,0,2,0
65792,5,1,229902,229902,229903,0,1,3
65793,4,2,229906,229906,229908,0,2,3
65794,2,2,229908,229908,229910,0,2,0
65795,6,3,229914,229914,229917,0,3,4
65796,1,3,229915,229917,229920,2,5,0
65797,3,3,229918,229920,229923,2,5,0
65798,2,3,229920,229923,229926,3,6,0
65799,1,2,229921,229926,229928,5,7,0
65800,2,1,229923,229928,229929,5,6,0
65801,2,3,229925,229929,229932,4,7,0
65802,6,3,229931,229932,229935,1,4,0
65803,2,1,229933,229935,229936,2,3,0
65804,6,1,229939,229939,229940,0,1,3
65805,2,3,229941,229941,229944,0,3,1
65806,1,3,229942,229944,229947,2,5,0
65807,5,3,229947,229947,229950,0,3,0
65808,1,3,229948,229950,229953,2,5,0
65809,3,2,229951,229953,229955,2,4,0
65810,6,1,229957,229957,229958,0,1,2
65811,3,1,229960,229960,229961,0,1,2
65812,1,1,229961,229961,229962,0,1,0
65813,1,1,229962,229962,229963,0,1,0
65814,6,3,229968,229968,229971,0,3,5
65815,6,3,229974,229974,229977,0,3,3
65816,5,1,229979,229979,229980,0,1,2
65817,3,2,229982,229982,229984,0,2,2
65818,2,1,229984,229984,229985,0,1,0
65819,5,1,229989,229989,229990,0,1,4
65820,1,2,229990,229990,229992,0,2,0
65821,3,3,229993,229993,229996,0,3,1
65822,2,3,229995,229996,229999,1,4,0
65823,5,2,230000,230000,230002,0,2,1
65824,3,3,230003,230003,230006,0,3,1
65825,3,3,230006,230006,230009,0,3,0
65826,5,2,230011,230011,230013,0,2,2
65827,6,2,230017,230017,230019,0,2,4
65828,6,2,230023,230023,230025,0,2,4
65829,1,1,230024,230025,230026,1,2,0
65830,6,2,230030,230030,230032,0,2,4
65831,4,2,230034,230034,230036,0,2,2
65832,1,2,230035,230036,230038,1,3,0
65833,5,3,230040,230040,230043,0,3,2
65834,4,3,230044,230044,230047,0,3,1
65835,3,1,230047,230047,230048,0,1,0
65836,3,1,230050,230050,230051,0,1,2
65837,2,1,230052,230052,230053,0,1,1
65838,1,3,230053,230053,230056,0,3,0
65839,6,2,230059,230059,230061,0,2,3
65840,5,3,230064,230064,230067,0,3,3
65841,4,2,230068,230068,230070,0,2,1
65842,1,2,230069,230070,230072,1,3,0
65843,1,3,230070,230072,230075,2,5,0
65844,6,1,230076,230076,230077,0,1,1
65845,3,1,230079,230079,230080,0,1,2
65846,5,1,230084,230084,230085,0,1,4
65847,4,1,230088,230088,230089,0,1,3
65848,4,2,230092,230092,230094,0,2,3
65849,5,1,230097,230097,230098,0,1,3
65850,3,2,230100,230100,230102,0,2,2
65851,1,3,230101,230102,230105,1,4,0
65852,4,1,230105,230105,230106,0,1,0
65853,2,1,230107,230107,230108,0,1,1
65854,5,1,230112,230112,230113,0,1,4
65855,1,3,230113,230113,230116,0,3,0
65856,2,3,230115,230116,230119,1,4,0
65857,5,1,230120,230120,230121,0,1,1
65858,5,1,230125,230125,230126,0,1,4
65859,2,3,230127,230127,230130,0,3,1
65860,3,3,230130,230130,230133,0,3,0
65861,2,3,230132,230133,230136,1,4,0
65862,5,1,230137,230137,230138,0,1,1
65863,3,1,230140,230140,230141,0,1,2
65864,4,3,230144,230144,230147,0,3,3
65865,5,2,230149,230149,230151,0,2,2
65866,4,2,230153,230153,230155,0,2,2
65867,2,2,230155,230155,230157,0,2,0
65868,2,2,230157,230157,230159,0,2,0
65869,5,1,230162,230162,230163,0,1,3
65870,3,2,230165,230165,230167,0,2,2
65871,5,3,230170,230170,230173,0,3,3
65872,4,2,230174,230174,230176,0,2,1
65873,2,3,230176,230176,230179,0,3,0
65874,6,2,230182,230182,230184,0,2,3
65875,1,1,230183,230184,230185,1,2,0
65876,4,3,230187,230187,230190,0,3,2
65877,4,2,230191,230191,230193,0,2,1
65878,6,1,230197,230197,230198,0,1,4
65879,1,3,230198,230198,230201,0,3,0
65880,2,3,230200,230201,230204,1,4,0
65881,1,2,230201,230204,230206,3,5,0
65882,4,1,230205,230206,230207,1,2,0
65883,3,1,230208,230208,230209,0,1,1
65884,2,3,230210,230210,230213,0,3,1
65885,4,2,230214,230214,230216,0,2,1
65886,3,2,230217,230217,230219,0,2,1
65887,6,2,230223,230223,230225,0,2,4
65888,4,1,230227,230227,230228,0,1,2
65889,1,1,230228,230228,230229,0,1,0
65890,5,1,230233,230233,230234,0,1,4
65891,3,2,230236,230236,230238,0,2,2
65892,6,3,230242,230242,230245,0,3,4
65893,3,2,230245,230245,230247,0,2,0
65894,6,2,230251,230251,230253,0,2,4
65895,3,1,230254,230254,230255,0,1,1
65896,3,3,230257,230257,230260,0,3,2
65897,5,3,230262,230262,230265,0,3,2
65898,6,1,230268,230268,230269,0,1,3
65899,4,2,230272,230272,230274,0,2,3
65900,5,2,230277,230277,230279,0,2,3
65901,1,3,230278,230279,230282,1,4,0
65902,5,1,230283,230283,230284,0,1,1
65903,3,3,230286,230286,230289,0,3,2
65904,5,1,230291,230291,230292,0,1,2
65905,4,2,230295,230295,230297,0,2,3
65906,1,1,230296,230297,230298,1,2,0
65907,5,1,230301,230301,230302,0,1,3
65908,4,1,230305,230305,230306,0,1,3
65909,5,3,230310,230310,230313,0,3,4
65910,4,3,230314,230314,230317,0,3,1
65911,6,3,230320,230320,230323,0,3,3
65912,3,3,230323,230323,230326,0,3,0
65913,2,1,230325,230326,230327,1,2,0
65914,1,3,230326,230327,230330,1,4,0
65915,6,2,230332,230332,230334,0,2,2
65916,5,3,230337,230337,230340,0,3,3
65917,2,2,230339,230340,230342,1,3,0
65918,1,1,230340,230342,230343,2,3,0
65919,1,1,230341,230343,230344,2,3,0
65920,6,2,230347,230347,230349,0,2,3
65921,3,1,230350,230350,230351,0,1,1
65922,1,1,230351,230351,230352,0,1,0
65923,4,3,230355,230355,230358,0,3,3
65924,2,2,230357,230358,230360,1,3,0
65925,3,3,230360,230360,230363,0,3,0
65926,5,3,230365,230365,230368,0,3,2
65927,2,3,230367,230368,230371,1,4,0
65928,5,1,230372,230372,230373,0,1,1
65929,6,3,230378,230378,230381,0,3,5
65930,4,1,230382,230382,230383,0,1,1
65931,6,3,230388,230388,230391,0,3,5
65932,5,1,230393,230393,230394,0,1,2
65933,1,1,230394,230394,230395,0,1,0
65934,6,3,230400,230400,230403,0,3,5
65935,5,2,230405,230405,230407,0,2,2
65936,1,2,230406,230407,230409,1,3,0
65937,6,2,230412,230412,230414,0,2,3
65938,2,2,230414,230414,230416,0,2,0
65939,4,1,230418,230418,230419,0,1,2
65940,6,3,230424,230424,230427,0,3,5
65941,1,2,230425,230427,230429,2,4,0
65942,5,2,230430,230430,230432,0,2,1
65943,5,3,230435,230435,230438,0,3,3
65944,6,3,230441,230441,230444,0,3,3
65945,6,3,230447,230447,230450,0,3,3
65946,4,1,230451,230451,230452,0,1,1
65947,6,1,230457,230457,230458,0,1,5
65948,6,1,230463,230463,230464,0,1,5
65949,4,2,230467,230467,230469,0,2,3
65950,3,3,230470,230470,230473,0,3,1
65951,4,2,230474,230474,230476,0,2,1
65952,2,1,230476,230476,230477,0,1,0
65953,3,3,230479,230479,230482,0,3,2
65954,2,1,230481,230482,230483,1,2,0
65955,3,2,230484,230484,230486,0,2,1
65956,4,3,230488,230488,230491,0,3,2
65957,2,1,230490,230491,230492,1,2,0
65958,2,1,230492,230492,230493,0,1,0
65959,2,1,230494,230494,230495,0,1,1
65960,3,3,230497,230497,230500,0,3,2
65961,1,3,230498,230500,230503,2,5,0
65962,5,2,230503,230503,230505,0,2,0
65963,3,3,230506,230506,230509,0,3,1
65964,6,1,230512,230512,230513,0,1,3
65965,2,2,230514,230514,230516,0,2,1
65966,3,2,230517,230517,230519,0,2,1
65967,2,1,230519,230519,230520,0,1,0
65968,6,2,230525,230525,230527,0,2,5
65969,1,1,230526,230527,230528,1,2,0
65970,4,3,230530,230530,230533,0,3,2
65971,2,1,230532,230533,230534,1,2,0
65972,1,1,230533,230534,230535,1,2,0
65973,3,1,230536,230536,230537,0,1,1
65974,6,1,230542,230542,230543,0,1,5
65975,4,3,230546,230546,230549,0,3,3
65976,2,1,230548,230549,230550,1,2,0
65977,6,2,230554,230554,230556,0,2,4
65978,5,1,230559,230559,230560,0,1,3
65979,1,1,230560,230560,230561,0,1,0
65980,4,1,230564,230564,230565,0,1,3
65981,3,3,230567,230567,230570,0,3,2
65982,3,3,230570,230570,230573,0,3,0
65983,6,2,230576,230576,230578,0,2,3
65984,2,3,230578,230578,230581,0,3,0
65985,5,2,230583,230583,230585,0,2,2
65986,6,3,230589,230589,230592,0,3,4
65987,4,2,230593,230593,230595,0,2,1
65988,6,1,230599,230599,230600,0,1,4
65989,6,2,230605,230605,230607,0,2,5
65990,1,1,230606,230607,230608,1,2,0
65991,3,1,230609,230609,230610,0,1,1
65992,4,2,230613,230613,230615,0,2,3
65993,2,3,230615,230615,230618,0,3,0
65994,1,2,230616,230618,230620,2,4,0
65995,1,3,230617,230620,230623,3,6,0
65996,3,3,230620,230623,230626,3,6,0
65997,6,2,230626,230626,230628,0,2,0
65998,5,1,230631,230631,230632,0,1,3
65999,2,2,230633,230633,230635,0,2,1
66000,2,1,230635,230635,230636,0,1,0
66001,4,1,230639,230639,230640,0,1,3
66002,4,3,230643,230643,230646,0,3,3
66003,6,3,230649,230649,230652,0,3,3
66004,5,2,230654,230654,230656,0,2,2
66005,6,2,230660,230660,230662,0,2,4
66006,5,1,230665,230665,230666,0,1,3
66007,3,2,230668,230668,230670,0,2,2
66008,5,1,230673,230673,230674,0,1,3
66009,5,1,230678,230678,230679,0,1,4
66010,3,3,230681,230681,230684,0,3,2
66011,6,3,230687,230687,230690,0,3,3
66012,5,3,230692,230692,230695,0,3,2
66013,2,1,230694,230695,230696,1,2,0
66014,1,1,230695,230696,230697,1,2,0
66015,3,1,230698,230698,230699,0,1,1
66016,5,1,230703,230703,230704,0,1,4
66017,2,3,230705,230705,230708,0,3,1
66018,2,3,230707,230708,230711,1,4,0
66019,3,1,230710,230711,230712,1,2,0
66020,3,3,230713,230713,230716,0,3,1
66021,5,1,230718,230718,230719,0,1,2
66022,1,2,230719,230719,230721,0,2,0
66023,1,2,230720,230721,230723,1,3,0
66024,4,3,230724,230724,230727,0,3,1
66025,5,2,230729,230729,230731,0,2,2
66026,4,2,230733,230733,230735,0,2,2
66027,3,1,230736,230736,230737,0,1,1
66028,3,2,230739,230739,230741,0,2,2
66029,3,1,230742,230742,230743,0,1,1
66030,2,1,230744,230744,230745,0,1,1
66031,3,3,230747,230747,230750,0,3,2
66032,6,2,230753,230753,230755,0,2,3
66033,1,1,230754,230755,230756,1,2,0
66034,6,3,230760,230760,230763,0,3,4
66035,5,2,230765,230765,230767,0,2,2
66036,5,2,230770,230770,230772,0,2,3
66037,3,1,230773,230773,230774,0,1,1
66038,6,2,230779,230779,230781,0,2,5
66039,5,2,230784,230784,230786,0,2,3
66040,3,2,230787,230787,230789,0,2,1
66041,4,1,230791,230791,230792,0,1,2
66042,3,1,230794,230794,230795,0,1,2
66043,3,3,230797,230797,230800,0,3,2
66044,2,2,230799,230800,230802,1,3,0
66045,5,1,230804,230804,230805,0,1,2
66046,4,3,230808,230808,230811,0,3,3
66047,1,1,230809,230811,230812,2,3,0
66048,4,3,230813,230813,230816,0,3,1
66049,2,2,230815,230816,230818,1,3,0
66050,6,2,230821,230821,230823,0,2,3
66051,3,3,230824,230824,230827,0,3,1
66052,5,1,230829,230829,230830,0,1,2
66053,2,1,230831,230831,230832,0,1,1
66054,4,3,230835,230835,230838,0,3,3
66055,1,2,230836,230838,230840,2,4,0
66056,4,3,230840,230840,230843,0,3,0
66057,3,1,230843,230843,230844,0,1,0
66058,1,3,230844,230844,230847,0,3,0
66059,3,2,230847,230847,230849,0,2,0
66060,6,1,230853,230853,230854,0,1,4
66061,5,1,230858,230858,230859,0,1,4
66062,4,3,230862,230862,230865,0,3,3
66063,4,2,230866,230866,230868,0,2,1
66064,6,1,230872,230872,230873,0,1,4
66065,4,1,230876,230876,230877,0,1,3
66066,2,2,230878,230878,230880,0,2,1
66067,5,1,230883,230883,230884,0,1,3
66068,2,3,230885,230885,230888,0,3,1
66069,4,2,230889,230889,230891,0,2,1
66070,5,1,230894,230894,230895,0,1,3
66071,3,2,230897,230897,230899,0,2,2
66072,5,2,230902,230902,230904,0,2,3
66073,3,3,230905,230905,230908,0,3,1
66074,3,3,230908,230908,230911,0,3,0
66075,4,2,230912,230912,230914,0,2,1
66076,5,2,230917,230917,230919,0,2,3
66077,6,2,230923,230923,230925,0,2,4
66078,2,3,230925,230925,230928,0,3,0
66079,5,3,230930,230930,230933,0,3,2
66080,1,1,230931,230933,230934,2,3,0
66081,6,2,230937,230937,230939,0,2,3
66082,5,3,230942,230942,230945,0,3,3
66083,5,2,230947,230947,230949,0,2,2
66084,4,1,230951,230951,230952,0,1,2
66085,6,1,230957,230957,230958,0,1,5
66086,1,3,230958,230958,230961,0,3,0
66087,5,3,230963,230963,230966,0,3,2
66088,6,3,230969,230969,230972,0,3,3
66089,2,1,230971,230972,230973,1,2,0
66090,2,3,230973,230973,230976,0,3,0
66091,5,2,230978,230978,230980,0,2,2
66092,3,2,230981,230981,230983,0,2,1
66093,6,1,230987,230987,230988,0,1,4
66094,1,2,230988,230988,230990,0,2,0
66095,1,3,230989,230990,230993,1,4,0
66096,6,3,230995,230995,230998,0,3,2
66097,1,1,230996,230998,230999,2,3,0
66098,2,1,230998,230999,231000,1,2,0
66099,2,3,231000,231000,231003,0,3,0
66100,5,1,231005,231005,231006,0,1,2
66101,5,2,231010,231010,231012,0,2,4
66102,1,2,231011,231012,231014,1,3,0
66103,2,1,231013,231014,231015,1,2,0
66104,6,2,231019,231019,231021,0,2,4
66105,2,1,231021,231021,231022,0,1,0
66106,5,3,231026,231026,231029,0,3,4
66107,4,2,231030,231030,231032,0,2,1
66108,2,2,231032,231032,231034,0,2,0
66109,2,3,231034,231034,231037,0,3,0
66110,5,2,231039,231039,231041,0,2,2
66111,5,2,231044,231044,231046,0,2,3
66112,1,3,231045,231046,231049,1,4,0
66113,4,1,231049,231049,231050,0,1,0
66114,6,2,231055,231055,231057,0,2,5
66115,6,3,231061,231061,231064,0,3,4
66116,6,2,231067,231067,231069,0,2,3
66117,2,2,231069,231069,231071,0,2,0
66118,6,3,231075,231075,231078,0,3,4
66119,2,1,231077,231078,231079,1,2,0
66120,2,3,231079,231079,231082,0,3,0
66121,1,1,231080,231082,231083,2,3,0
66122,4,1,231084,231084,231085,0,1,1
66123,3,2,231087,231087,231089,0,2,2
66124,3,3,231090,231090,231093,0,3,1
66125,5,2,231095,231095,231097,0,2,2
66126,4,2,231099,231099,231101,0,2,2
66127,3,3,231102,231102,231105,0,3,1
66128,1,2,231103,231105,231107,2,4,0
66129,3,3,231106,231107,231110,1,4,0
66130,6,1,231112,231112,231113,0,1,2
66131,2,3,231114,231114,231117,0,3,1
66132,6,2,231120,231120,231122,0,2,3
66133,4,2,231124,231124,231126,0,2,2
66134,1,1,231125,231126,231127,1,2,0
66135,3,3,231128,231128,231131,0,3,1
66136,5,1,231133,231133,231134,0,1,2
66137,3,2,231136,231136,231138,0,2,2
66138,2,1,231138,231138,231139,0,1,0
66139,6,3,231144,231144,231147,0,3,5
66140,4,2,231148,231148,231150,0,2,1
66141,1,3,231149,231150,231153,1,4,0
66142,1,1,231150,231153,231154,3,4,0
66143,5,1,231155,231155,231156,0,1,1
66144,6,1,231161,231161,231162,0,1,5
66145,2,1,231163,231163,231164,0,1,1
66146,3,2,231166,231166,231168,0,2,2
66147,2,3,231168,231168,231171,0,3,0
66148,5,1,231173,231173,231174,0,1,2
66149,3,2,231176,231176,231178,0,2,2
66150,3,2,231179,231179,231181,0,2,1
66151,1,1,231180,231181,231182,1,2,0
66152,6,2,231186,231186,231188,0,2,4
66153,6,3,231192,231192,231195,0,3,4
66154,2,1,231194,231195,231196,1,2,0
66155,4,2,231198,231198,231200,0,2,2
66156,6,2,231204,231204,231206,0,2,4
66157,5,3,231209,231209,231212,0,3,3
66158,3,1,231212,231212,231213,0,1,0
66159,6,3,231218,231218,231221,0,3,5
66160,4,2,231222,231222,231224,0,2,1
66161,6,3,231228,231228,231231,0,3,4
66162,4,2,231232,231232,231234,0,2,1
66163,2,2,231234,231234,231236,0,2,0
66164,5,2,231239,231239,231241,0,2,3
66165,1,3,231240,231241,231244,1,4,0
66166,2,2,231242,231244,231246,2,4,0
66167,5,1,231247,231247,231248,0,1,1
66168,5,2,231252,231252,231254,0,2,4
66169,6,3,231258,231258,231261,0,3,4
66170,1,2,231259,231261,231263,2,4,0
66171,4,3,231263,231263,231266,0,3,0
66172,6,1,231269,231269,231270,0,1,3
66173,2,1,231271,231271,231272,0,1,1
66174,1,3,231272,231272,231275,0,3,0
66175,2,1,231274,231275,231276,1,2,0
66176,1,2,231275,231276,231278,1,3,0
66177,6,1,231281,231281,231282,0,1,3
66178,1,3,231282,231282,231285,0,3,0
66179,1,3,231283,231285,231288,2,5,0
66180,6,3,231289,231289,231292,0,3,1
66181,1,3,231290,231292,231295,2,5,0
66182,3,3,231293,231295,231298,2,5,0
66183,4,2,231297,231298,231300,1,3,0
66184,5,2,231302,231302,231304,0,2,2
66185,2,2,231304,231304,231306,0,2,0
66186,3,3,231307,231307,231310,0,3,1
66187,6,1,231313,231313,231314,0,1,3
66188,2,2,231315,231315,231317,0,2,1
66189,2,1,231317,231317,231318,0,1,0
66190,2,3,231319,231319,231322,0,3,1
66191,4,3,231323,231323,231326,0,3,1
66192,5,3,231328,231328,231331,0,3,2
66193,6,2,231334,231334,231336,0,2,3
66194,3,1,231337,231337,231338,0,1,1
66195,3,1,231340,231340,231341,0,1,2
66196,6,2,231346,231346,231348,0,2,5
66197,3,2,231349,231349,231351,0,2,1
66198,4,2,231353,231353,231355,0,2,2
66199,1,2,231354,231355,231357,1,3,0
66200,2,3,231356,231357,231360,1,4,0
66201,1,3,231357,231360,231363,3,6,0
66202,3,3,231360,231363,231366,3,6,0
66203,4,1,231364,231366,231367,2,3,0
66204,6,2,231370,231370,231372,0,2,3
66205,5,3,231375,231375,231378,0,3,3
66206,6,2,231381,231381,231383,0,2,3
66207,3,1,231384,231384,231385,0,1,1
66208,3,1,231387,231387,231388,0,1,2
66209,3,2,231390,231390,231392,0,2,2
66210,6,3,231396,231396,231399,0,3,4
66211,5,1,231401,231401,231402,0,1,2
66212,3,2,231404,231404,231406,0,2,2
66213,2,1,231406,231406,231407,0,1,0
66214,6,1,231412,231412,231413,0,1,5
66215,1,3,231413,231413,231416,0,3,0
66216,6,2,231419,231419,231421,0,2,3
66217,4,1,231423,231423,231424,0,1,2
66218,4,1,231427,231427,231428,0,1,3
66219,5,3,231432,231432,231435,0,3,4
66220,4,2,231436,231436,231438,0,2,1
66221,2,1,231438,231438,231439,0,1,0
66222,2,2,231440,231440,231442,0,2,1
66223,3,1,231443,231443,231444,0,1,1
66224,2,3,231445,231445,231448,0,3,1
66225,1,2,231446,231448,231450,2,4,0
66226,4,2,231450,231450,231452,0,2,0
66227,2,1,231452,231452,231453,0,1,0
66228,5,2,231457,231457,231459,0,2,4
66229,4,3,231461,231461,231464,0,3,2
66230,6,3,231467,231467,231470,0,3,3
66231,6,1,231473,231473,231474,0,1,3
66232,4,1,231477,231477,231478,0,1,3
66233,2,1,231479,231479,231480,0,1,1
66234,5,3,231484,231484,231487,0,3,4
66235,4,2,231488,231488,231490,0,2,1
66236,4,3,231492,231492,231495,0,3,2
66237,4,3,231496,231496,231499,0,3,1
66238,1,3,231497,231499,231502,2,5,0
66239,5,2,231502,231502,231504,0,2,0
66240,4,2,231506,231506,231508,0,2,2
66241,1,1,231507,231508,231509,1,2,0
66242,4,2,231511,231511,231513,0,2,2
66243,4,3,231515,231515,231518,0,3,2
66244,6,1,231521,231521,231522,0,1,3
66245,6,1,231527,231527,231528,0,1,5
66246,3,3,231530,231530,231533,0,3,2
66247,4,3,231534,231534,231537,0,3,1
66248,4,2,231538,231538,231540,0,2,1
66249,5,3,231543,231543,231546,0,3,3
66250,6,1,231549,231549,231550,0,1,3
66251,3,3,231552,231552,231555,0,3,2
66252,3,1,231555,231555,231556,0,1,0
66253,5,2,231560,231560,231562,0,2,4
66254,3,3,231563,231563,231566,0,3,1
66255,5,1,231568,231568,231569,0,1,2
66256,5,2,231573,231573,231575,0,2,4
66257,4,1,231577,231577,231578,0,1,2
66258,6,1,231583,231583,231584,0,1,5
66259,4,1,231587,231587,231588,0,1,3
66260,1,1,231588,231588,231589,0,1,0
66261,6,3,231594,231594,231597,0,3,5
66262,5,3,231599,231599,231602,0,3,2
66263,3,2,231602,231602,231604,0,2,0
66264,6,3,231608,231608,231611,0,3,4
66265,5,2,231613,231613,231615,0,2,2
66266,3,1,231616,231616,231617,0,1,1
66267,4,2,231620,231620,231622,0,2,3
66268,5,3,231625,231625,231628,0,3,3
66269,2,3,231627,231628,231631,1,4,0
66270,5,2,231632,231632,231634,0,2,1
66271,5,2,231637,231637,231639,0,2,3
66272,2,3,231639,231639,231642,0,3,0
66273,4,1,231643,231643,231644,0,1,1
66274,6,1,231649,231649,231650,0,1,5
66275,3,1,231652,231652,231653,0,1,2
66276,2,1,231654,231654,231655,0,1,1
66277,4,2,231658,231658,231660,0,2,3
66278,5,1,231663,231663,231664,0,1,3
66279,1,2,231664,231664,231666,0,2,0
66280,5,3,231669,231669,231672,0,3,3
66281,4,3,231673,231673,231676,0,3,1
66282,6,1,231679,231679,231680,0,1,3
66283,4,2,231683,231683,231685,0,2,3
66284,3,1,231686,231686,231687,0,1,1
66285,3,1,231689,231689,231690,0,1,2
66286,3,3,231692,231692,231695,0,3,2
66287,6,2,231698,231698,231700,0,2,3
66288,5,3,231703,231703,231706,0,3,3
66289,1,1,231704,231706,231707,2,3,0
66290,5,2,231709,231709,231711,0,2,2
66291,6,2,231715,231715,231717,0,2,4
66292,1,2,231716,231717,231719,1,3,0
66293,5,2,231721,231721,231723,0,2,2
66294,5,2,231726,231726,231728,0,2,3
66295,5,2,231731,231731,231733,0,2,3
66296,3,1,231734,231734,231735,0,1,1
66297,3,1,231737,231737,231738,0,1,2
66298,5,2,231742,231742,231744,0,2,4
66299,5,3,231747,231747,231750,0,3,3
66300,4,1,231751,231751,231752,0,1,1
66301,1,3,231752,231752,231755,0,3,0
66302,3,3,231755,231755,231758,0,3,0
66303,6,3,231761,231761,231764,0,3,3
66304,6,3,231767,231767,231770,0,3,3
66305,1,1,231768,231770,231771,2,3,0
66306,5,3,231773,231773,231776,0,3,2
66307,5,1,231778,231778,231779,0,1,2
66308,5,2,231783,231783,231785,0,2,4
66309,3,1,231786,231786,231787,0,1,1
66310,1,3,231787,231787,231790,0,3,0
66311,4,1,231791,231791,231792,0,1,1
66312,4,2,231795,231795,231797,0,2,3
66313,2,2,231797,231797,231799,0,2,0
66314,3,1,231800,231800,231801,0,1,1
66315,5,2,231805,231805,231807,0,2,4
66316,4,3,231809,231809,231812,0,3,2
66317,1,2,231810,231812,231814,2,4,0
66318,2,3,231812,231814,231817,2,5,0
66319,2,3,231814,231817,231820,3,6,0
66320,2,1,231816,231820,231821,4,5,0
66321,4,2,231820,231821,231823,1,3,0
66322,3,3,231823,231823,231826,0,3,0
66323,2,1,231825,231826,231827,1,2,0
66324,1,1,231826,231827,231828,1,2,0
66325,6,2,231832,231832,231834,0,2,4
66326,6,3,231838,231838,231841,0,3,4
66327,6,1,231844,231844,231845,0,1,3
66328,4,1,231848,231848,231849,0,1,3
66329,3,1,231851,231851,231852,0,1,2
66330,6,3,231857,231857,231860,0,3,5
66331,5,3,231862,231862,231865,0,3,2
66332,2,2,231864,231865,231867,1,3,0
66333,6,2,231870,231870,231872,0,2,3
66334,2,3,231872,231872,231875,0,3,0
66335,2,3,231874,231875,231878,1,4,0
66336,2,2,231876,231878,231880,2,4,0
66337,5,2,231881,231881,231883,0,2,1
66338,3,3,231884,231884,231887,0,3,1
66339,5,3,231889,231889,231892,0,3,2
66340,4,2,231893,231893,231895,0,2,1
66341,1,2,231894,231895,231897,1,3,0
66342,6,1,231900,231900,231901,0,1,3
66343,5,1,231905,231905,231906,0,1,4
66344,3,3,231908,231908,231911,0,3,2
66345,5,2,231913,231913,231915,0,2,2
66346,4,3,231917,231917,231920,0,3,2
66347,4,3,231921,231921,231924,0,3,1
66348,2,3,231923,231924,231927,1,4,0
66349,5,3,231928,231928,231931,0,3,1
66350,6,2,231934,231934,231936,0,2,3
66351,2,2,231936,231936,231938,0,2,0
66352,4,3,231940,231940,231943,0,3,2
66353,4,3,231944,231944,231947,0,3,1
66354,4,3,231948,231948,231951,0,3,1
66355,1,1,231949,231951,231952,2,3,0
66356,5,3,231954,231954,231957,0,3,2
66357,4,1,231958,231958,231959,0,1,1
66358,4,3,231962,231962,231965,0,3,3
66359,3,3,231965,231965,231968,0,3,0
66360,5,2,231970,231970,231972,0,2,2
66361,1,2,231971,231972,231974,1,3,0
66362,6,3,231977,231977,231980,0,3,3
66363,6,1,231983,231983,231984,0,1,3
66364,5,1,231988,231988,231989,0,1,4
66365,3,3,231991,231991,231994,0,3,2
66366,3,3,231994,231994,231997,0,3,0
66367,6,1,232000,232000,232001,0,1,3
66368,6,2,232006,232006,232008,0,2,5
66369,1,1,232007,232008,232009,1,2,0
66370,1,3,232008,232009,232012,1,4,0
66371,3,3,232011,232012,232015,1,4,0
66372,6,3,232017,232017,232020,0,3,2
66373,6,3,232023,232023,232026,0,3,3
66374,5,2,232028,232028,232030,0,2,2
66375,4,3,232032,232032,232035,0,3,2
66376,6,2,232038,232038,232040,0,2,3
66377,6,2,232044,232044,232046,0,2,4
66378,5,2,232049,232049,232051,0,2,3
66379,5,2,232054,232054,232056,0,2,3
66380,3,3,232057,232057,232060,0,3,1
66381,6,1,232063,232063,232064,0,1,3
66382,4,1,232067,232067,232068,0,1,3
66383,1,1,232068,232068,232069,0,1,0
66384,4,2,232072,232072,232074,0,2,3
66385,5,2,232077,232077,232079,0,2,3
66386,3,3,232080,232080,232083,0,3,1
66387,1,2,232081,232083,232085,2,4,0
66388,3,1,232084,232085,232086,1,2,0
66389,3,3,232087,232087,232090,0,3,1
66390,2,3,232089,232090,232093,1,4,0
66391,1,3,232090,232093,232096,3,6,0
66392,4,2,232094,232096,232098,2,4,0
66393,6,1,232100,232100,232101,0,1,2
66394,3,2,232103,232103,232105,0,2,2
66395,4,1,232107,232107,232108,0,1,2
66396,6,3,232113,232113,232116,0,3,5
66397,4,2,232117,232117,232119,0,2,1
66398,6,2,232123,232123,232125,0,2,4
66399,2,2,232125,232125,232127,0,2,0
66400,2,2,232127,232127,232129,0,2,0
66401,3,1,232130,232130,232131,0,1,1
66402,3,3,232133,232133,232136,0,3,2
66403,5,2,232138,232138,232140,0,2,2
66404,6,3,232144,232144,232147,0,3,4
66405,4,2,232148,232148,232150,0,2,1
66406,2,3,232150,232150,232153,0,3,0
66407,4,3,232154,232154,232157,0,3,1
66408,6,1,232160,232160,232161,0,1,3
66409,6,2,232166,232166,232168,0,2,5
66410,3,1,232169,232169,232170,0,1,1
66411,1,2,232170,232170,232172,0,2,0
66412,5,3,232175,232175,232178,0,3,3
66413,5,1,232180,232180,232181,0,1,2
66414,1,1,232181,232181,232182,0,1,0
66415,2,1,232183,232183,232184,0,1,1
66416,3,3,232186,232186,232189,0,3,2
66417,4,3,232190,232190,232193,0,3,1
66418,5,3,232195,232195,232198,0,3,2
66419,1,2,232196,232198,232200,2,4,0
66420,2,1,232198,232200,232201,2,3,0
66421,6,2,232204,232204,232206,0,2,3
66422,6,3,232210,232210,232213,0,3,4
66423,5,3,232215,232215,232218,0,3,2
66424,5,2,232220,232220,232222,0,2,2
66425,6,1,232226,232226,232227,0,1,4
66426,2,3,232228,232228,232231,0,3,1
66427,5,1,232233,232233,232234,0,1,2
66428,4,1,232237,232237,232238,0,1,3
66429,4,3,232241,232241,232244,0,3,3
66430,2,1,232243,232244,232245,1,2,0
66431,3,2,232246,232246,232248,0,2,1
66432,4,1,232250,232250,232251,0,1,2
66433,1,1,232251,232251,232252,0,1,0
66434,4,2,232255,232255,232257,0,2,3
66435,6,2,232261,232261,232263,0,2,4
66436,2,1,232263,232263,232264,0,1,0
66437,1,1,232264,232264,232265,0,1,0
66438,1,3,232265,232265,232268,0,3,0
66439,3,1,232268,232268,232269,0,1,0
66440,4,3,232272,232272,232275,0,3,3
66441,5,3,232277,232277,232280,0,3,2
66442,5,2,232282,232282,232284,0,2,2
66443,3,3,232285,232285,232288,0,3,1
66444,3,3,232288,232288,232291,0,3,0
66445,5,2,232293,232293,232295,0,2,2
66446,2,2,232295,232295,232297,0,2,0
66447,3,1,232298,232298,232299,0,1,1
66448,3,1,232301,232301,232302,0,1,2
66449,1,3,232302,232302,232305,0,3,0
66450,5,3,232307,232307,232310,0,3,2
66451,1,1,232308,232310,232311,2,3,0
66452,5,3,232313,232313,232316,0,3,2
66453,6,3,232319,232319,232322,0,3,3
66454,4,1,232323,232323,232324,0,1,1
66455,2,3,232325,232325,232328,0,3,1
66456,6,3,232331,232331,232334,0,3,3
66457,1,2,232332,232334,232336,2,4,0
66458,4,3,232336,232336,232339,0,3,0
66459,5,1,232341,232341,232342,0,1,2
66460,4,1,232345,232345,232346,0,1,3
66461,6,3,232351,232351,232354,0,3,5
66462,2,2,232353,232354,232356,1,3,0
66463,6,1,232359,232359,232360,0,1,3
66464,4,1,232363,232363,232364,0,1,3
66465,4,1,232367,232367,232368,0,1,3
66466,6,2,232373,232373,232375,0,2,5
66467,3,2,232376,232376,232378,0,2,1
66468,5,3,232381,232381,232384,0,3,3
66469,3,2,232384,232384,232386,0,2,0
66470,5,2,232389,232389,232391,0,2,3
66471,6,3,232395,232395,232398,0,3,4
66472,5,1,232400,232400,232401,0,1,2
66473,2,2,232402,232402,232404,0,2,1
66474,4,2,232406,232406,232408,0,2,2
66475,5,2,232411,232411,232413,0,2,3
66476,6,3,232417,232417,232420,0,3,4
66477,5,2,232422,232422,232424,0,2,2
66478,6,3,232428,232428,232431,0,3,4
66479,3,2,232431,232431,232433,0,2,0
66480,5,2,232436,232436,232438,0,2,3
66481,4,3,232440,232440,232443,0,3,2
66482,2,1,232442,232443,232444,1,2,0
66483,5,1,232447,232447,232448,0,1,3
66484,1,3,232448,232448,232451,0,3,0
66485,3,1,232451,232451,232452,0,1,0
66486,1,2,232452,232452,232454,0,2,0
66487,5,3,232457,232457,232460,0,3,3
66488,5,1,232462,232462,232463,0,1,2
66489,1,2,232463,232463,232465,0,2,0
66490,6,1,232469,232469,232470,0,1,4
66491,1,1,232470,232470,232471,0,1,0
66492,5,1,232475,232475,232476,0,1,4
66493,6,2,232481,232481,232483,0,2,5
66494,2,3,232483,232483,232486,0,3,0
66495,2,2,232485,232486,232488,1,3,0
66496,6,1,232491,232491,232492,0,1,3
66497,6,2,232497,232497,232499,0,2,5
66498,5,2,232502,232502,232504,0,2,3
66499,5,3,232507,232507,232510,0,3,3
66500,6,1,232513,232513,232514,0,1,3
66501,3,2,232516,232516,232518,0,2,2
66502,2,2,232518,232518,232520,0,2,0
66503,5,3,232523,232523,232526,0,3,3
66504,6,1,232529,232529,232530,0,1,3
66505,2,2,232531,232531,232533,0,2,1
66506,6,2,232537,232537,232539,0,2,4
66507,5,1,232542,232542,232543,0,1,3
66508,5,3,232547,232547,232550,0,3,4
66509,5,1,232552,232552,232553,0,1,2
66510,5,2,232557,232557,232559,0,2,4
66511,5,2,232562,232562,232564,0,2,3
66512,4,2,232566,232566,232568,0,2,2
66513,4,1,232570,232570,232571,0,1,2
66514,1,3,232571,232571,232574,0,3,0
66515,4,3,232575,232575,232578,0,3,1
66516,4,1,232579,232579,232580,0,1,1
66517,1,2,232580,232580,232582,0,2,0
66518,6,2,232586,232586,232588,0,2,4
66519,3,3,232589,232589,232592,0,3,1
66520,3,2,232592,232592,232594,0,2,0
66521,4,1,232596,232596,232597,0,1,2
66522,1,1,232597,232597,232598,0,1,0
66523,5,3,232602,232602,232605,0,3,4
66524,5,3,232607,232607,232610,0,3,2
66525,1,3,232608,232610,232613,2,5,0
66526,4,3,232612,232613,232616,1,4,0
66527,5,3,232617,232617,232620,0,3,1
66528,2,3,232619,232620,232623,1,4,0
66529,3,1,232622,232623,232624,1,2,0
66530,5,2,232627,232627,232629,0,2,3
66531,4,1,232631,232631,232632,0,1,2
66532,5,2,232636,232636,232638,0,2,4
66533,2,2,232638,232638,232640,0,2,0
66534,2,2,232640,232640,232642,0,2,0
66535,6,3,232646,232646,232649,0,3,4
66536,5,1,232651,232651,232652,0,1,2
66537,6,1,232657,232657,232658,0,1,5
66538,3,1,232660,232660,232661,0,1,2
66539,2,1,232662,232662,232663,0,1,1
66540,3,3,232665,232665,232668,0,3,2
66541,1,1,232666,232668,232669,2,3,0
66542,3,2,232669,232669,232671,0,2,0
66543,3,3,232672,232672,232675,0,3,1
66544,5,1,232677,232677,232678,0,1,2
66545,2,3,232679,232679,232682,0,3,1
66546,5,1,232684,232684,232685,0,1,2
66547,1,1,232685,232685,232686,0,1,0
66548,5,3,232690,232690,232693,0,3,4
66549,4,3,232694,232694,232697,0,3,1
66550,2,2,232696,232697,232699,1,3,0
66551,1,3,232697,232699,232702,2,5,0
66552,2,2,232699,232702,232704,3,5,0
66553,6,2,232705,232705,232707,0,2,1
66554,1,2,232706,232707,232709,1,3,0
66555,4,2,232710,232710,232712,0,2,1
66556,6,1,232716,232716,232717,0,1,4
66557,4,3,232720,232720,232723,0,3,3
66558,2,1,232722,232723,232724,1,2,0
66559,3,1,232725,232725,232726,0,1,1
66560,5,2,232730,232730,232732,0,2,4
66561,6,2,232736,232736,232738,0,2,4
66562,6,1,232742,232742,232743,0,1,4
66563,6,1,232748,232748,232749,0,1,5
66564,6,3,232754,232754,232757,0,3,5
66565,3,3,232757,232757,232760,0,3,0
66566,2,1,232759,232760,232761,1,2,0
66567,4,1,232763,232763,232764,0,1,2
66568,3,3,232766,232766,232769,0,3,2
66569,6,1,232772,232772,232773,0,1,3
66570,2,3,232774,232774,232777,0,3,1
66571,6,2,232780,232780,232782,0,2,3
66572,3,2,232783,232783,232785,0,2,1
66573,1,3,232784,232785,232788,1,4,0
66574,1,2,232785,232788,232790,3,5,0
66575,3,2,232788,232790,232792,2,4,0
66576,4,2,232792,232792,232794,0,2,0
66577,1,1,232793,232794,232795,1,2,0
66578,1,3,232794,232795,232798,1,4,0
66579,5,1,232799,232799,232800,0,1,1
66580,1,2,232800,232800,232802,0,2,0
66581,4,1,232804,232804,232805,0,1,2
66582,4,1,232808,232808,232809,0,1,3
66583,6,3,232814,232814,232817,0,3,5
66584,6,3,232820,232820,232823,0,3,3
66585,1,3,232821,232823,232826,2,5,0
66586,5,1,232826,232826,232827,0,1,0
66587,6,2,232832,232832,232834,0,2,5
66588,6,3,232838,232838,232841,0,3,4
66589,1,1,232839,232841,232842,2,3,0
66590,4,3,232843,232843,232846,0,3,1
66591,5,1,232848,232848,232849,0,1,2
66592,5,3,232853,232853,232856,0,3,4
66593,2,2,232855,232856,232858,1,3,0
66594,1,2,232856,232858,232860,2,4,0
66595,2,1,232858,232860,232861,2,3,0
66596,3,1,232861,232861,232862,0,1,0
66597,1,1,232862,232862,232863,0,1,0
66598,4,3,232866,232866,232869,0,3,3
66599,4,3,232870,232870,232873,0,3,1
66600,5,2,232875,232875,232877,0,2,2
66601,1,2,232876,232877,232879,1,3,0
66602,4,1,232880,232880,232881,0,1,1
66603,1,3,232881,232881,232884,0,3,0
66604,6,2,232887,232887,232889,0,2,3
66605,1,2,232888,232889,232891,1,3,0
66606,1,1,232889,232891,232892,2,3,0
66607,1,2,232890,232892,232894,2,4,0
66608,1,2,232891,232894,232896,3,5,0
66609,4,3,232895,232896,232899,1,4,0
66610,6,3,232901,232901,232904,0,3,2
66611,1,2,232902,232904,232906,2,4,0
66612,6,3,232908,232908,232911,0,3,2
66613,6,2,232914,232914,232916,0,2,3
66614,3,1,232917,232917,232918,0,1,1
66615,4,3,232921,232921,232924,0,3,3
66616,3,3,232924,232924,232927,0,3,0
66617,5,1,232929,232929,232930,0,1,2
66618,2,2,232931,232931,232933,0,2,1
66619,3,1,232934,232934,232935,0,1,1
66620,4,2,232938,232938,232940,0,2,3
66621,4,1,232942,232942,232943,0,1,2
66622,2,3,232944,232944,232947,0,3,1
66623,2,3,232946,232947,232950,1,4,0
66624,3,1,232949,232950,232951,1,2,0
66625,1,1,232950,232951,232952,1,2,0
66626,3,2,232953,232953,232955,0,2,1
66627,6,3,232959,232959,232962,0,3,4
66628,4,3,232963,232963,232966,0,3,1
66629,3,3,232966,232966,232969,0,3,0
66630,1,3,232967,232969,232972,2,5,0
66631,6,1,232973,232973,232974,0,1,1
66632,4,1,232977,232977,232978,0,1,3
66633,6,3,232983,232983,232986,0,3,5
66634,2,3,232985,232986,232989,1,4,0
66635,1,2,232986,232989,232991,3,5,0
66636,2,3,232988,232991,232994,3,6,0
66637,6,1,232994,232994,232995,0,1,0
66638,4,2,232998,232998,233000,0,2,3
66639,5,2,233003,233003,233005,0,2,3
66640,4,1,233007,233007,233008,0,1,2
66641,6,1,233013,233013,233014,0,1,5
66642,5,3,233018,233018,233021,0,3,4
66643,4,3,233022,233022,233025,0,3,1
66644,5,3,233027,233027,233030,0,3,2
66645,2,3,233029,233030,233033,1,4,0
66646,6,3,233035,233035,233038,0,3,2
66647,3,2,233038,233038,233040,0,2,0
66648,2,2,233040,233040,233042,0,2,0
66649,1,1,233041,233042,233043,1,2,0
66650,2,3,233043,233043,233046,0,3,0
66651,3,1,233046,233046,233047,0,1,0
66652,2,3,233048,233048,233051,0,3,1
66653,6,1,233054,233054,233055,0,1,3
66654,5,1,233059,233059,233060,0,1,4
66655,1,1,233060,233060,233061,0,1,0
66656,4,2,233064,233064,233066,0,2,3
66657,6,1,233070,233070,233071,0,1,4
66658,2,1,233072,233072,233073,0,1,1
66659,3,1,233075,233075,233076,0,1,2
66660,4,1,233079,233079,233080,0,1,3
66661,6,3,233085,233085,233088,0,3,5
66662,3,2,233088,233088,233090,0,2,0
66663,6,2,233094,233094,233096,0,2,4
66664,2,3,233096,233096,233099,0,3,0
66665,6,1,233102,233102,233103,0,1,3
66666,5,2,233107,233107,233109,0,2,4
66667,2,1,233109,233109,233110,0,1,0
66668,3,2,233112,233112,233114,0,2,2
66669,4,3,233116,233116,233119,0,3,2
66670,3,1,233119,233119,233120,0,1,0
66671,3,1,233122,233122,233123,0,1,2
66672,5,1,233127,233127,233128,0,1,4
66673,4,1,233131,233131,233132,0,1,3
66674,6,1,233137,233137,233138,0,1,5
66675,4,3,233141,233141,233144,0,3,3
66676,2,1,233143,233144,233145,1,2,0
66677,5,2,233148,233148,233150,0,2,3
66678,6,3,233154,233154,233157,0,3,4
66679,2,3,233156,233157,233160,1,4,0
66680,6,1,233162,233162,233163,0,1,2
66681,5,1,233167,233167,233168,0,1,4
66682,3,1,233170,233170,233171,0,1,2
66683,5,1,233175,233175,233176,0,1,4
66684,6,1,233181,233181,233182,0,1,5
66685,2,3,233183,233183,233186,0,3,1
66686,5,2,233188,233188,233190,0,2,2
66687,1,2,233189,233190,233192,1,3,0
66688,1,1,233190,233192,233193,2,3,0
66689,1,1,233191,233193,233194,2,3,0
66690,2,3,233193,233194,233197,1,4,0
66691,4,2,233197,233197,233199,0,2,0
66692,5,1,233202,233202,233203,0,1,3
66693,6,2,233208,233208,233210,0,2,5
66694,1,2,233209,233210,233212,1,3,0
66695,3,1,233212,233212,233213,0,1,0
66696,1,2,233213,233213,233215,0,2,0
66697,5,2,233218,233218,233220,0,2,3
66698,1,1,233219,233220,233221,1,2,0
66699,6,3,233225,233225,233228,0,3,4
66700,6,3,233231,233231,233234,0,3,3
66701,3,3,233234,233234,233237,0,3,0
66702,5,1,233239,233239,233240,0,1,2
66703,6,2,233245,233245,233247,0,2,5
66704,3,3,233248,233248,233251,0,3,1
66705,6,3,233254,233254,233257,0,3,3
66706,3,1,233257,233257,233258,0,1,0
66707,2,2,233259,233259,233261,0,2,1
66708,2,3,233261,233261,233264,0,3,0
66709,2,3,233263,233264,233267,1,4,0
66710,4,3,233267,233267,233270,0,3,0
66711,3,1,233270,233270,233271,0,1,0
66712,6,2,233276,233276,233278,0,2,5
66713,5,2,233281,233281,233283,0,2,3
66714,6,1,233287,233287,233288,0,1,4
66715,1,1,233288,233288,233289,0,1,0
66716,3,1,233291,233291,233292,0,1,2
66717,3,2,233294,233294,233296,0,2,2
66718,4,1,233298,233298,233299,0,1,2
66719,6,2,233304,233304,233306,0,2,5
66720,6,3,233310,233310,233313,0,3,4
66721,4,3,233314,233314,233317,0,3,1
66722,6,1,233320,233320,233321,0,1,3
66723,2,3,233322,233322,233325,0,3,1
66724,2,2,233324,233325,233327,1,3,0
66725,6,1,233330,233330,233331,0,1,3
66726,6,1,233336,233336,233337,0,1,5
66727,6,3,233342,233342,233345,0,3,5
66728,1,1,233343,233345,233346,2,3,0
66729,1,3,233344,233346,233349,2,5,0
66730,2,3,233346,233349,233352,3,6,0
66731,6,1,233352,233352,233353,0,1,0
66732,5,2,233357,233357,233359,0,2,4
66733,3,3,233360,233360,233363,0,3,1
66734,6,3,233366,233366,233369,0,3,3
66735,3,3,233369,233369,233372,0,3,0
66736,2,1,233371,233372,233373,1,2,0
66737,4,2,233375,233375,233377,0,2,2
66738,6,3,233381,233381,233384,0,3,4
66739,1,2,233382,233384,233386,2,4,0
66740,1,1,233383,233386,233387,3,4,0
66741,5,3,233388,233388,233391,0,3,1
66742,3,1,233391,233391,233392,0,1,0
66743,3,1,233394,233394,233395,0,1,2
66744,2,1,233396,233396,233397,0,1,1
66745,6,1,233402,233402,233403,0,1,5
66746,3,1,233405,233405,233406,0,1,2
66747,5,3,233410,233410,233413,0,3,4
66748,5,2,233415,233415,233417,0,2,2
66749,5,3,233420,233420,233423,0,3,3
66750,1,1,233421,233423,233424,2,3,0
66751,3,1,233424,233424,233425,0,1,0
66752,6,1,233430,233430,233431,0,1,5
66753,2,2,233432,233432,233434,0,2,1
66754,6,2,233438,233438,233440,0,2,4
66755,5,3,233443,233443,233446,0,3,3
66756,3,2,233446,233446,233448,0,2,0
66757,1,1,233447,233448,233449,1,2,0
66758,1,1,233448,233449,233450,1,2,0
66759,1,3,233449,233450,233453,1,4,0
66760,3,3,233452,233453,233456,1,4,0
66761,2,2,233454,233456,233458,2,4,0
66762,2,1,233456,233458,233459,2,3,0
66763,1,3,233457,233459,233462,2,5,0
66764,6,1,233463,233463,233464,0,1,1
66765,2,2,233465,233465,233467,0,2,1
66766,4,2,233469,233469,233471,0,2,2
66767,5,2,233474,233474,233476,0,2,3
66768,4,3,233478,233478,233481,0,3,2
66769,5,3,233483,233483,233486,0,3,2
66770,5,3,233488,233488,233491,0,3,2
66771,6,2,233494,233494,233496,0,2,3
66772,4,1,233498,233498,233499,0,1,2
66773,6,3,233504,233504,233507,0,3,5
66774,6,1,233510,233510,233511,0,1,3
66775,1,1,233511,233511,233512,0,1,0
66776,2,1,233513,233513,233514,0,1,1
66777,5,2,233518,233518,233520,0,2,4
66778,2,3,233520,233520,233523,0,3,0
66779,5,2,233525,233525,233527,0,2,2
66780,2,2,233527,233527,233529,0,2,0
66781,4,3,233531,233531,233534,0,3,2
66782,4,1,233535,233535,233536,0,1,1
66783,3,1,233538,233538,233539,0,1,2
66784,5,2,233543,233543,233545,0,2,4
66785,6,2,233549,233549,233551,0,2,4
66786,2,3,233551,233551,233554,0,3,0
66787,5,2,233556,233556,233558,0,2,2
66788,2,1,233558,233558,233559,0,1,0
66789,2,2,233560,233560,233562,0,2,1
66790,6,2,233566,233566,233568,0,2,4
66791,2,2,233568,233568,233570,0,2,0
66792,4,2,233572,233572,233574,0,2,2
66793,5,2,233577,233577,233579,0,2,3
66794,1,2,233578,233579,233581,1,3,0
66795,6,2,233584,233584,233586,0,2,3
66796,6,2,233590,233590,233592,0,2,4
66797,6,2,233596,233596,233598,0,2,4
66798,6,3,233602,233602,233605,0,3,4
66799,1,2,233603,233605,233607,2,4,0
66800,4,3,233607,233607,233610,0,3,0
66801,5,2,233612,233612,233614,0,2,2
66802,3,1,233615,233615,233616,0,1,1
66803,2,3,233617,233617,233620,0,3,1
66804,6,3,233623,233623,233626,0,3,3
66805,1,3,233624,233626,233629,2,5,0
66806,3,2,233627,233629,233631,2,4,0
66807,6,1,233633,233633,233634,0,1,2
66808,5,1,233638,233638,233639,0,1,4
66809,5,3,233643,233643,233646,0,3,4
66810,1,1,233644,233646,233647,2,3,0
66811,4,1,233648,233648,233649,0,1,1
66812,5,1,233653,233653,233654,0,1,4
66813,2,1,233655,233655,233656,0,1,1
66814,5,1,233660,233660,233661,0,1,4
66815,5,3,233665,233665,233668,0,3,4
66816,3,1,233668,233668,233669,0,1,0
66817,5,1,233673,233673,233674,0,1,4
66818,6,3,233679,233679,233682,0,3,5
66819,3,1,233682,233682,233683,0,1,0
66820,6,1,233688,233688,233689,0,1,5
66821,4,1,233692,233692,233693,0,1,3
66822,6,3,233698,233698,233701,0,3,5
66823,6,1,233704,233704,233705,0,1,3
66824,2,3,233706,233706,233709,0,3,1
66825,5,2,233711,233711,233713,0,2,2
66826,2,1,233713,233713,233714,0,1,0
66827,5,1,233718,233718,233719,0,1,4
66828,4,2,233722,233722,233724,0,2,3
66829,1,3,233723,233724,233727,1,4,0
66830,3,2,233726,233727,233729,1,3,0
66831,1,2,233727,233729,233731,2,4,0
66832,4,2,233731,233731,233733,0,2,0
66833,2,2,233733,233733,233735,0,2,0
66834,4,3,233737,233737,233740,0,3,2
66835,4,2,233741,233741,233743,0,2,1
66836,2,1,233743,233743,233744,0,1,0
66837,4,2,233747,233747,233749,0,2,3
66838,6,2,233753,233753,233755,0,2,4
66839,1,1,233754,233755,233756,1,2,0
66840,1,2,233755,233756,233758,1,3,0
66841,3,2,233758,233758,233760,0,2,0
66842,4,2,233762,233762,233764,0,2,2
66843,3,1,233765,233765,233766,0,1,1
66844,4,2,233769,233769,233771,0,2,3
66845,4,2,233773,233773,233775,0,2,2
66846,2,1,233775,233775,233776,0,1,0
66847,5,3,233780,233780,233783,0,3,4
66848,4,3,233784,233784,233787,0,3,1
66849,3,1,233787,233787,233788,0,1,0
66850,6,2,233793,233793,233795,0,2,5
66851,3,3,233796,233796,233799,0,3,1
66852,2,2,233798,233799,233801,1,3,0
66853,5,3,233803,233803,233806,0,3,2
66854,3,3,233806,233806,233809,0,3,0
66855,5,3,233811,233811,233814,0,3,2
66856,5,3,233816,233816,233819,0,3,2
66857,3,3,233819,233819,233822,0,3,0
66858,2,1,233821,233822,233823,1,2,0
66859,1,3,233822,233823,233826,1,4,0
66860,4,2,233826,233826,233828,0,2,0
66861,6,1,233832,233832,233833,0,1,4
66862,3,1,233835,233835,233836,0,1,2
66863,5,2,233840,233840,233842,0,2,4
66864,4,3,233844,233844,233847,0,3,2
66865,5,1,233849,233849,233850,0,1,2
66866,6,3,233855,233855,233858,0,3,5
66867,3,2,233858,233858,233860,0,2,0
66868,5,1,233863,233863,233864,0,1,3
66869,3,3,233866,233866,233869,0,3,2
66870,2,3,233868,233869,233872,1,4,0
66871,5,1,233873,233873,233874,0,1,1
66872,5,3,233878,233878,233881,0,3,4
66873,3,3,233881,233881,233884,0,3,0
66874,1,3,233882,233884,233887,2,5,0
66875,5,2,233887,233887,233889,0,2,0
66876,6,1,233893,233893,233894,0,1,4
66877,2,1,233895,233895,233896,0,1,1
66878,2,1,233897,233897,233898,0,1,1
66879,1,2,233898,233898,233900,0,2,0
66880,3,1,233901,233901,233902,0,1,1
66881,1,1,233902,233902,233903,0,1,0
66882,5,3,233907,233907,233910,0,3,4
66883,1,2,233908,233910,233912,2,4,0
66884,4,3,233912,233912,233915,0,3,0
66885,1,1,233913,233915,233916,2,3,0
66886,1,3,233914,233916,233919,2,5,0
66887,1,2,233915,233919,233921,4,6,0
66888,3,2,233918,233921,233923,3,5,0
66889,6,1,233924,233924,233925,0,1,1
66890,6,2,233930,233930,233932,0,2,5
66891,6,1,233936,233936,233937,0,1,4
66892,1,2,233937,233937,233939,0,2,0
66893,1,3,233938,233939,233942,1,4,0
66894,4,2,233942,233942,233944,0,2,0
66895,6,3,233948,233948,233951,0,3,4
66896,2,1,233950,233951,233952,1,2,0
66897,2,1,233952,233952,233953,0,1,0
66898,3,2,233955,233955,233957,0,2,2
66899,2,2,233957,233957,233959,0,2,0
66900,2,2,233959,233959,233961,0,2,0
66901,1,1,233960,233961,233962,1,2,0
66902,5,3,233965,233965,233968,0,3,3
66903,4,2,233969,233969,233971,0,2,1
66904,2,1,233971,233971,233972,0,1,0
66905,6,1,233977,233977,233978,0,1,5
66906,6,3,233983,233983,233986,0,3,5
66907,5,3,233988,233988,233991,0,3,2
66908,3,2,233991,233991,233993,0,2,0
66909,4,1,233995,233995,233996,0,1,2
66910,4,3,233999,233999,234002,0,3,3
66911,6,2,234005,234005,234007,0,2,3
66912,1,3,234006,234007,234010,1,4,0
66913,5,1,234011,234011,234012,0,1,1
66914,1,2,234012,234012,234014,0,2,0
66915,1,1,234013,234014,234015,1,2,0
66916,2,3,234015,234015,234018,0,3,0
66917,4,3,234019,234019,234022,0,3,1
66918,6,1,234025,234025,234026,0,1,3
66919,1,1,234026,234026,234027,0,1,0
66920,6,2,234032,234032,234034,0,2,5
66921,5,2,234037,234037,234039,0,2,3
66922,3,3,234040,234040,234043,0,3,1
66923,3,2,234043,234043,234045,0,2,0
66924,3,1,234046,234046,234047,0,1,1
66925,1,1,234047,234047,234048,0,1,0
66926,1,1,234048,234048,234049,0,1,0
66927,5,1,234053,234053,234054,0,1,4
66928,2,1,234055,234055,234056,0,1,1
66929,3,3,234058,234058,234061,0,3,2
66930,4,3,234062,234062,234065,0,3,1
66931,5,3,234067,234067,234070,0,3,2
66932,1,3,234068,234070,234073,2,5,0
66933,1,3,234069,234073,234076,4,7,0
66934,6,1,234075,234076,234077,1,2,0
66935,3,2,234078,234078,234080,0,2,1
66936,1,2,234079,234080,234082,1,3,0
66937,1,3,234080,234082,234085,2,5,0
66938,6,3,234086,234086,234089,0,3,1
66939,5,1,234091,234091,234092,0,1,2
66940,4,2,234095,234095,234097,0,2,3
66941,6,3,234101,234101,234104,0,3,4
66942,6,1,234107,234107,234108,0,1,3
66943,5,3,234112,234112,234115,0,3,4
66944,4,1,234116,234116,234117,0,1,1
66945,4,2,234120,234120,234122,0,2,3
66946,2,3,234122,234122,234125,0,3,0
66947,3,3,234125,234125,234128,0,3,0
66948,5,2,234130,234130,234132,0,2,2
66949,4,3,234134,234134,234137,0,3,2
66950,1,2,234135,234137,234139,2,4,0
66951,5,1,234140,234140,234141,0,1,1
66952,3,2,234143,234143,234145,0,2,2
66953,2,3,234145,234145,234148,0,3,0
66954,2,1,234147,234148,234149,1,2,0
66955,5,1,234152,234152,234153,0,1,3
66956,3,1,234155,234155,234156,0,1,2
66957,2,1,234157,234157,234158,0,1,1
66958,4,2,234161,234161,234163,0,2,3
66959,2,2,234163,234163,234165,0,2,0
66960,6,3,234169,234169,234172,0,3,4
66961,6,1,234175,234175,234176,0,1,3
66962,1,2,234176,234176,234178,0,2,0
66963,1,2,234177,234178,234180,1,3,0
66964,5,2,234182,234182,234184,0,2,2
66965,4,1,234186,234186,234187,0,1,2
66966,3,3,234189,234189,234192,0,3,2
66967,4,2,234193,234193,234195,0,2,1
66968,1,3,234194,234195,234198,1,4,0
66969,4,3,234198,234198,234201,0,3,0
66970,6,1,234204,234204,234205,0,1,3
66971,5,2,234209,234209,234211,0,2,4
66972,1,2,234210,234211,234213,1,3,0
66973,4,2,234214,234214,234216,0,2,1
66974,1,1,234215,234216,234217,1,2,0
66975,1,1,234216,234217,234218,1,2,0
66976,6,3,234222,234222,234225,0,3,4
66977,1,3,234223,234225,234228,2,5,0
66978,2,2,234225,234228,234230,3,5,0
66979,5,3,234230,234230,234233,0,3,0
66980,5,3,234235,234235,234238,0,3,2
66981,2,1,234237,234238,234239,1,2,0
66982,1,3,234238,234239,234242,1,4,0
66983,4,3,234242,234242,234245,0,3,0
66984,1,3,234243,234245,234248,2,5,0
66985,3,3,234246,234248,234251,2,5,0
66986,2,3,234248,234251,234254,3,6,0
66987,5,3,234253,234254,234257,1,4,0
66988,1,3,234254,234257,234260,3,6,0
66989,1,1,234255,234260,234261,5,6,0
66990,1,1,234256,234261,234262,5,6,0
66991,4,2,234260,234262,234264,2,4,0
66992,3,2,234263,234264,234266,1,3,0
66993,1,1,234264,234266,234267,2,3,0
66994,5,2,234269,234269,234271,0,2,2
66995,3,1,234272,234272,234273,0,1,1
66996,1,1,234273,234273,234274,0,1,0
66997,4,2,234277,234277,234279,0,2,3
66998,5,3,234282,234282,234285,0,3,3
66999,4,1,234286,234286,234287,0,1,1
67000,4,3,234290,234290,234293,0,3,3
67001,1,1,234291,234293,234294,2,3,0
67002,5,3,234296,234296,234299,0,3,2
67003,4,2,234300,234300,234302,0,2,1
67004,1,1,234301,234302,234303,1,2,0
67005,3,2,234304,234304,234306,0,2,1
67006,2,1,234306,234306,234307,0,1,0
67007,4,3,234310,234310,234313,0,3,3
67008,3,2,234313,234313,234315,0,2,0
67009,3,1,234316,234316,234317,0,1,1
67010,5,3,234321,234321,234324,0,3,4
67011,5,2,234326,234326,234328,0,2,2
67012,5,2,234331,234331,234333,0,2,3
67013,6,2,234337,234337,234339,0,2,4
67014,5,3,234342,234342,234345,0,3,3
67015,1,3,234343,234345,234348,2,5,0
67016,6,2,234349,234349,234351,0,2,1
67017,4,1,234353,234353,234354,0,1,2
67018,2,2,234355,234355,234357,0,2,1
67019,3,3,234358,234358,234361,0,3,1
67020,5,3,234363,234363,234366,0,3,2
67021,6,1,234369,234369,234370,0,1,3
67022,3,3,234372,234372,234375,0,3,2
67023,6,1,234378,234378,234379,0,1,3
67024,2,1,234380,234380,234381,0,1,1
67025,6,1,234386,234386,234387,0,1,5
67026,4,1,234390,234390,234391,0,1,3
67027,6,3,234396,234396,234399,0,3,5
67028,3,2,234399,234399,234401,0,2,0
67029,2,1,234401,234401,234402,0,1,0
67030,3,3,234404,234404,234407,0,3,2
67031,4,3,234408,234408,234411,0,3,1
67032,1,3,234409,234411,234414,2,5,0
67033,5,3,234414,234414,234417,0,3,0
67034,4,2,234418,234418,234420,0,2,1
67035,4,3,234422,234422,234425,0,3,2
67036,1,2,234423,234425,234427,2,4,0
67037,2,1,234425,234427,234428,2,3,0
67038,1,2,234426,234428,234430,2,4,0
67039,1,1,234427,234430,234431,3,4,0
67040,6,3,234433,234433,234436,0,3,2
67041,5,1,234438,234438,234439,0,1,2
67042,6,2,234444,234444,234446,0,2,5
67043,1,3,234445,234446,234449,1,4,0
67044,4,2,234449,234449,234451,0,2,0
67045,6,2,234455,234455,234457,0,2,4
67046,4,3,234459,234459,234462,0,3,2
67047,6,3,234465,234465,234468,0,3,3
67048,1,2,234466,234468,234470,2,4,0
67049,3,2,234469,234470,234472,1,3,0
67050,1,3,234470,234472,234475,2,5,0
67051,4,3,234474,234475,234478,1,4,0
67052,3,3,234477,234478,234481,1,4,0
67053,6,3,234483,234483,234486,0,3,2
67054,3,1,234486,234486,234487,0,1,0
67055,4,2,234490,234490,234492,0,2,3
67056,6,3,234496,234496,234499,0,3,4
67057,2,1,234498,234499,234500,1,2,0
67058,4,2,234502,234502,234504,0,2,2
67059,5,3,234507,234507,234510,0,3,3
67060,6,1,234513,234513,234514,0,1,3
67061,5,3,234518,234518,234521,0,3,4
67062,4,3,234522,234522,234525,0,3,1
67063,1,3,234523,234525,234528,2,5,0
67064,2,2,234525,234528,234530,3,5,0
67065,6,2,234531,234531,234533,0,2,1
67066,5,1,234536,234536,234537,0,1,3
67067,6,1,234542,234542,234543,0,1,5
67068,5,3,234547,234547,234550,0,3,4
67069,1,3,234548,234550,234553,2,5,0
67070,6,3,234554,234554,234557,0,3,1
67071,1,3,234555,234557,234560,2,5,0
67072,3,1,234558,234560,234561,2,3,0
67073,1,1,234559,234561,234562,2,3,0
67074,3,3,234562,234562,234565,0,3,0
67075,3,1,234565,234565,234566,0,1,0
67076,4,1,234569,234569,234570,0,1,3
67077,1,2,234570,234570,234572,0,2,0
67078,4,3,234574,234574,234577,0,3,2
67079,1,2,234575,234577,234579,2,4,0
67080,2,2,234577,234579,234581,2,4,0
67081,1,2,234578,234581,234583,3,5,0
67082,6,1,234584,234584,234585,0,1,1
67083,6,3,234590,234590,234593,0,3,5
67084,4,3,234594,234594,234597,0,3,1
67085,1,2,234595,234597,234599,2,4,0
67086,1,1,234596,234599,234600,3,4,0
67087,2,1,234598,234600,234601,2,3,0
67088,3,2,234601,234601,234603,0,2,0
67089,1,3,234602,234603,234606,1,4,0
67090,6,3,234608,234608,234611,0,3,2
67091,3,3,234611,234611,234614,0,3,0
67092,5,2,234616,234616,234618,0,2,2
67093,1,2,234617,234618,234620,1,3,0
67094,2,3,234619,234620,234623,1,4,0
67095,1,3,234620,234623,234626,3,6,0
67096,2,2,234622,234626,234628,4,6,0
67097,5,1,234627,234628,234629,1,2,0
67098,6,1,234633,234633,234634,0,1,4
67099,5,2,234638,234638,234640,0,2,4
67100,4,3,234642,234642,234645,0,3,2
67101,1,2,234643,234645,234647,2,4,0
67102,3,3,234646,234647,234650,1,4,0
67103,5,1,234651,234651,234652,0,1,1
67104,3,2,234654,234654,234656,0,2,2
67105,3,3,234657,234657,234660,0,3,1
67106,4,2,234661,234661,234663,0,2,1
67107,4,3,234665,234665,234668,0,3,2
67108,5,2,234670,234670,234672,0,2,2
67109,6,1,234676,234676,234677,0,1,4
67110,1,2,234677,234677,234679,0,2,0
67111,3,3,234680,234680,234683,0,3,1
67112,1,2,234681,234683,234685,2,4,0
67113,6,2,234687,234687,234689,0,2,2
67114,5,1,234692,234692,234693,0,1,3
67115,4,3,234696,234696,234699,0,3,3
67116,4,1,234700,234700,234701,0,1,1
67117,3,1,234703,234703,234704,0,1,2
67118,3,2,234706,234706,234708,0,2,2
67119,3,3,234709,234709,234712,0,3,1
67120,6,2,234715,234715,234717,0,2,3
67121,3,3,234718,234718,234721,0,3,1
67122,6,2,234724,234724,234726,0,2,3
67123,3,1,234727,234727,234728,0,1,1
67124,4,2,234731,234731,234733,0,2,3
67125,3,3,234734,234734,234737,0,3,1
67126,2,1,234736,234737,234738,1,2,0
67127,5,3,234741,234741,234744,0,3,3
67128,5,1,234746,234746,234747,0,1,2
67129,2,1,234748,234748,234749,0,1,1
67130,5,3,234753,234753,234756,0,3,4
67131,6,3,234759,234759,234762,0,3,3
67132,2,3,234761,234762,234765,1,4,0
67133,6,3,234767,234767,234770,0,3,2
67134,5,2,234772,234772,234774,0,2,2
67135,4,3,234776,234776,234779,0,3,2
67136,3,2,234779,234779,234781,0,2,0
67137,4,2,234783,234783,234785,0,2,2
67138,4,2,234787,234787,234789,0,2,2
67139,6,2,234793,234793,234795,0,2,4
67140,4,1,234797,234797,234798,0,1,2
67141,2,1,234799,234799,234800,0,1,1
67142,2,3,234801,234801,234804,0,3,1
67143,1,1,234802,234804,234805,2,3,0
67144,2,2,234804,234805,234807,1,3,0
67145,6,3,234810,234810,234813,0,3,3
67146,4,1,234814,234814,234815,0,1,1
67147,4,3,234818,234818,234821,0,3,3
67148,6,1,234824,234824,234825,0,1,3
67149,1,1,234825,234825,234826,0,1,0
67150,2,3,234827,234827,234830,0,3,1
67151,4,2,234831,234831,234833,0,2,1
67152,2,2,234833,234833,234835,0,2,0
67153,6,3,234839,234839,234842,0,3,4
67154,4,2,234843,234843,234845,0,2,1
67155,5,3,234848,234848,234851,0,3,3
67156,2,1,234850,234851,234852,1,2,0
67157,1,3,234851,234852,234855,1,4,0
67158,6,3,234857,234857,234860,0,3,2
67159,5,2,234862,234862,234864,0,2,2
67160,4,2,234866,234866,234868,0,2,2
67161,5,1,234871,234871,234872,0,1,3
67162,5,2,234876,234876,234878,0,2,4
67163,6,2,234882,234882,234884,0,2,4
67164,4,2,234886,234886,234888,0,2,2
67165,3,1,234889,234889,234890,0,1,1
67166,5,2,234894,234894,234896,0,2,4
67167,1,1,234895,234896,234897,1,2,0
67168,4,1,234899,234899,234900,0,1,2
67169,1,1,234900,234900,234901,0,1,0
67170,1,1,234901,234901,234902,0,1,0
67171,2,2,234903,234903,234905,0,2,1
67172,4,2,234907,234907,234909,0,2,2
67173,4,1,234911,234911,234912,0,1,2
67174,6,2,234917,234917,234919,0,2,5
67175,6,1,234923,234923,234924,0,1,4
67176,3,2,234926,234926,234928,0,2,2
67177,3,3,234929,234929,234932,0,3,1
67178,3,3,234932,234932,234935,0,3,0
67179,5,1,234937,234937,234938,0,1,2
67180,4,3,234941,234941,234944,0,3,3
67181,1,2,234942,234944,234946,2,4,0
67182,4,2,234946,234946,234948,0,2,0
67183,5,1,234951,234951,234952,0,1,3
67184,1,2,234952,234952,234954,0,2,0
67185,2,1,234954,234954,234955,0,1,0
67186,5,3,234959,234959,234962,0,3,4
67187,6,2,234965,234965,234967,0,2,3
67188,2,1,234967,234967,234968,0,1,0
67189,3,1,234970,234970,234971,0,1,2
67190,5,1,234975,234975,234976,0,1,4
67191,4,2,234979,234979,234981,0,2,3
67192,6,3,234985,234985,234988,0,3,4
67193,3,2,234988,234988,234990,0,2,0
67194,1,1,234989,234990,234991,1,2,0
67195,1,2,234990,234991,234993,1,3,0
67196,5,1,234995,234995,234996,0,1,2
67197,4,2,234999,234999,235001,0,2,3
67198,4,3,235003,235003,235006,0,3,2
67199,4,1,235007,235007,235008,0,1,1
67200,1,1,235008,235008,235009,0,1,0
67201,5,1,235013,235013,235014,0,1,4
67202,3,3,235016,235016,235019,0,3,2
67203,1,1,235017,235019,235020,2,3,0
67204,2,2,235019,235020,235022,1,3,0
67205,1,1,235020,235022,235023,2,3,0
67206,2,2,235022,235023,235025,1,3,0
67207,6,3,235028,235028,235031,0,3,3
67208,6,2,235034,235034,235036,0,2,3
67209,4,1,235038,235038,235039,0,1,2
67210,1,1,235039,235039,235040,0,1,0
67211,5,2,235044,235044,235046,0,2,4
67212,6,1,235050,235050,235051,0,1,4
67213,4,3,235054,235054,235057,0,3,3
67214,5,3,235059,235059,235062,0,3,2
67215,3,2,235062,235062,235064,0,2,0
67216,2,1,235064,235064,235065,0,1,0
67217,6,3,235070,235070,235073,0,3,5
67218,3,2,235073,235073,235075,0,2,0
67219,5,3,235078,235078,235081,0,3,3
67220,6,3,235084,235084,235087,0,3,3
67221,3,2,235087,235087,235089,0,2,0
67222,6,2,235093,235093,235095,0,2,4
67223,3,2,235096,235096,235098,0,2,1
67224,6,1,235102,235102,235103,0,1,4
67225,2,1,235104,235104,235105,0,1,1
67226,2,2,235106,235106,235108,0,2,1
67227,4,3,235110,235110,235113,0,3,2
67228,3,3,235113,235113,235116,0,3,0
67229,4,3,235117,235117,235120,0,3,1
67230,4,2,235121,235121,235123,0,2,1
67231,6,3,235127,235127,235130,0,3,4
67232,5,2,235132,235132,235134,0,2,2
67233,3,1,235135,235135,235136,0,1,1
67234,5,3,235140,235140,235143,0,3,4
67235,5,3,235145,235145,235148,0,3,2
67236,2,1,235147,235148,235149,1,2,0
67237,1,3,235148,235149,235152,1,4,0
67238,5,1,235153,235153,235154,0,1,1
67239,4,2,235157,235157,235159,0,2,3
67240,1,2,235158,235159,235161,1,3,0
67241,6,2,235164,235164,235166,0,2,3
67242,3,2,235167,235167,235169,0,2,1
67243,2,1,235169,235169,235170,0,1,0
67244,2,3,235171,235171,235174,0,3,1
67245,6,2,235177,235177,235179,0,2,3
67246,5,2,235182,235182,235184,0,2,3
67247,5,3,235187,235187,235190,0,3,3
67248,2,2,235189,235190,235192,1,3,0
67249,3,3,235192,235192,235195,0,3,0
67250,6,3,235198,235198,235201,0,3,3
67251,3,3,235201,235201,235204,0,3,0
67252,5,1,235206,235206,235207,0,1,2
67253,3,3,235209,235209,235212,0,3,2
67254,4,1,235213,235213,235214,0,1,1
67255,5,1,235218,235218,235219,0,1,4
67256,2,2,235220,235220,235222,0,2,1
67257,6,2,235226,235226,235228,0,2,4
67258,4,1,235230,235230,235231,0,1,2
67259,5,1,235235,235235,235236,0,1,4
67260,3,2,235238,235238,235240,0,2,2
67261,3,1,235241,235241,235242,0,1,1
67262,3,1,235244,235244,235245,0,1,2
67263,1,1,235245,235245,235246,0,1,0
67264,5,1,235250,235250,235251,0,1,4
67265,2,1,235252,235252,235253,0,1,1
67266,1,2,235253,235253,235255,0,2,0
67267,4,2,235257,235257,235259,0,2,2
67268,3,1,235260,235260,235261,0,1,1
67269,2,2,235262,235262,235264,0,2,1
67270,4,2,235266,235266,235268,0,2,2
67271,2,1,235268,235268,235269,0,1,0
67272,6,1,235274,235274,235275,0,1,5
67273,3,2,235277,235277,235279,0,2,2
67274,2,1,235279,235279,235280,0,1,0
67275,3,1,235282,235282,235283,0,1,2
67276,6,2,235288,235288,235290,0,2,5
67277,5,1,235293,235293,235294,0,1,3
67278,6,3,235299,235299,235302,0,3,5
67279,2,3,235301,235302,235305,1,4,0
67280,6,2,235307,235307,235309,0,2,2
67281,3,3,235310,235310,235313,0,3,1
67282,2,1,235312,235313,235314,1,2,0
67283,6,1,235318,235318,235319,0,1,4
67284,1,1,235319,235319,235320,0,1,0
67285,3,1,235322,235322,235323,0,1,2
67286,2,1,235324,235324,235325,0,1,1
67287,6,2,235330,235330,235332,0,2,5
67288,4,1,235334,235334,235335,0,1,2
67289,3,2,235337,235337,235339,0,2,2
67290,3,1,235340,235340,235341,0,1,1
67291,2,2,235342,235342,235344,0,2,1
67292,6,2,235348,235348,235350,0,2,4
67293,3,3,235351,235351,235354,0,3,1
67294,3,2,235354,235354,235356,0,2,0
67295,1,3,235355,235356,235359,1,4,0
67296,5,1,235360,235360,235361,0,1,1
67297,2,2,235362,235362,235364,0,2,1
67298,2,1,235364,235364,235365,0,1,0
67299,5,3,235369,235369,235372,0,3,4
67300,3,2,235372,235372,235374,0,2,0
67301,6,1,235378,235378,235379,0,1,4
67302,2,1,235380,235380,235381,0,1,1
67303,2,3,235382,235382,235385,0,3,1
67304,3,3,235385,235385,235388,0,3,0
67305,5,3,235390,235390,235393,0,3,2
67306,1,2,235391,235393,235395,2,4,0
67307,5,1,235396,235396,235397,0,1,1
67308,5,1,235401,235401,235402,0,1,4
67309,5,3,235406,235406,235409,0,3,4
67310,4,1,235410,235410,235411,0,1,1
67311,4,2,235414,235414,235416,0,2,3
67312,4,3,235418,235418,235421,0,3,2
67313,1,2,235419,235421,235423,2,4,0
67314,2,1,235421,235423,235424,2,3,0
67315,6,1,235427,235427,235428,0,1,3
67316,4,3,235431,235431,235434,0,3,3
67317,5,1,235436,235436,235437,0,1,2
67318,2,2,235438,235438,235440,0,2,1
67319,6,1,235444,235444,235445,0,1,4
67320,2,3,235446,235446,235449,0,3,1
67321,4,1,235450,235450,235451,0,1,1
67322,5,2,235455,235455,235457,0,2,4
67323,2,3,235457,235457,235460,0,3,0
67324,5,1,235462,235462,235463,0,1,2
67325,6,1,235468,235468,235469,0,1,5
67326,1,2,235469,235469,235471,0,2,0
67327,4,1,235473,235473,235474,0,1,2
67328,2,1,235475,235475,235476,0,1,1
67329,3,1,235478,235478,235479,0,1,2
67330,2,1,235480,235480,235481,0,1,1
67331,2,1,235482,235482,235483,0,1,1
67332,3,1,235485,235485,235486,0,1,2
67333,1,2,235486,235486,235488,0,2,0
67334,3,1,235489,235489,235490,0,1,1
67335,1,1,235490,235490,235491,0,1,0
67336,2,3,235492,235492,235495,0,3,1
67337,4,3,235496,235496,235499,0,3,1
67338,5,3,235501,235501,235504,0,3,2
67339,3,3,235504,235504,235507,0,3,0
67340,2,2,235506,235507,235509,1,3,0
67341,3,2,235509,235509,235511,0,2,0
67342,5,3,235514,235514,235517,0,3,3
67343,3,3,235517,235517,235520,0,3,0
67344,5,2,235522,235522,235524,0,2,2
67345,1,1,235523,235524,235525,1,2,0
67346,6,2,235529,235529,235531,0,2,4
67347,6,3,235535,235535,235538,0,3,4
67348,5,1,235540,235540,235541,0,1,2
67349,3,1,235543,235543,235544,0,1,2
67350,6,3,235549,235549,235552,0,3,5
67351,3,2,235552,235552,235554,0,2,0
67352,5,1,235557,235557,235558,0,1,3
67353,1,3,235558,235558,235561,0,3,0
67354,1,1,235559,235561,235562,2,3,0
67355,4,1,235563,235563,235564,0,1,1
67356,3,2,235566,235566,235568,0,2,2
67357,5,2,235571,235571,235573,0,2,3
67358,1,1,235572,235573,235574,1,2,0
67359,4,3,235576,235576,235579,0,3,2
67360,2,1,235578,235579,235580,1,2,0
67361,5,1,235583,235583,235584,0,1,3
67362,4,3,235587,235587,235590,0,3,3
67363,5,2,235592,235592,235594,0,2,2
67364,1,3,235593,235594,235597,1,4,0
67365,5,3,235598,235598,235601,0,3,1
67366,2,1,235600,235601,235602,1,2,0
67367,3,3,235603,235603,235606,0,3,1
67368,3,1,235606,235606,235607,0,1,0
67369,2,3,235608,235608,235611,0,3,1
67370,1,2,235609,235611,235613,2,4,0
67371,5,2,235614,235614,235616,0,2,1
67372,2,2,235616,235616,235618,0,2,0
67373,2,2,235618,235618,235620,0,2,0
67374,5,3,235623,235623,235626,0,3,3
67375,5,2,235628,235628,235630,0,2,2
67376,5,3,235633,235633,235636,0,3,3
67377,4,1,235637,235637,235638,0,1,1
67378,4,3,235641,235641,235644,0,3,3
67379,2,2,235643,235644,235646,1,3,0
67380,1,2,235644,235646,235648,2,4,0
67381,3,3,235647,235648,235651,1,4,0
67382,2,2,235649,235651,235653,2,4,0
67383,3,3,235652,235653,235656,1,4,0
67384,6,1,235658,235658,235659,0,1,2
67385,5,2,235663,235663,235665,0,2,4
67386,1,3,235664,235665,235668,1,4,0
67387,2,1,235666,235668,235669,2,3,0
67388,5,1,235671,235671,235672,0,1,2
67389,3,3,235674,235674,235677,0,3,2
67390,5,3,235679,235679,235682,0,3,2
67391,2,2,235681,235682,235684,1,3,0
67392,3,2,235684,235684,235686,0,2,0
67393,1,2,235685,235686,235688,1,3,0
67394,3,2,235688,235688,235690,0,2,0
67395,2,1,235690,235690,235691,0,1,0
67396,6,1,235696,235696,235697,0,1,5
67397,3,1,235699,235699,235700,0,1,2
67398,3,1,235702,235702,235703,0,1,2
67399,4,2,235706,235706,235708,0,2,3
67400,6,2,235712,235712,235714,0,2,4
67401,1,3,235713,235714,235717,1,4,0
67402,6,2,235719,235719,235721,0,2,2
67403,1,3,235720,235721,235724,1,4,0
67404,3,2,235723,235724,235726,1,3,0
67405,1,3,235724,235726,235729,2,5,0
67406,2,1,235726,235729,235730,3,4,0
67407,4,1,235730,235730,235731,0,1,0
67408,2,1,235732,235732,235733,0,1,1
67409,5,2,235737,235737,235739,0,2,4
67410,5,1,235742,235742,235743,0,1,3
67411,1,1,235743,235743,235744,0,1,0
67412,5,3,235748,235748,235751,0,3,4
67413,3,3,235751,235751,235754,0,3,0
67414,2,2,235753,235754,235756,1,3,0
67415,3,2,235756,235756,235758,0,2,0
67416,1,2,235757,235758,235760,1,3,0
67417,6,2,235763,235763,235765,0,2,3
67418,3,3,235766,235766,235769,0,3,1
67419,1,2,235767,235769,235771,2,4,0
67420,2,1,235769,235771,235772,2,3,0
67421,6,1,235775,235775,235776,0,1,3
67422,2,1,235777,235777,235778,0,1,1
67423,2,3,235779,235779,235782,0,3,1
67424,2,3,235781,235782,235785,1,4,0
67425,1,2,235782,235785,235787,3,5,0
67426,2,1,235784,235787,235788,3,4,0
67427,2,2,235786,235788,235790,2,4,0
67428,6,2,235792,235792,235794,0,2,2
67429,5,1,235797,235797,235798,0,1,3
67430,5,2,235802,235802,235804,0,2,4
67431,5,2,235807,235807,235809,0,2,3
67432,2,2,235809,235809,235811,0,2,0
67433,5,3,235814,235814,235817,0,3,3
67434,5,1,235819,235819,235820,0,1,2
67435,4,3,235823,235823,235826,0,3,3
67436,3,3,235826,235826,235829,0,3,0
67437,3,1,235829,235829,235830,0,1,0
67438,4,2,235833,235833,235835,0,2,3
67439,5,3,235838,235838,235841,0,3,3
67440,2,1,235840,235841,235842,1,2,0
67441,4,3,235844,235844,235847,0,3,2
67442,3,2,235847,235847,235849,0,2,0
67443,1,2,235848,235849,235851,1,3,0
67444,5,1,235853,235853,235854,0,1,2
67445,5,1,235858,235858,235859,0,1,4
67446,3,1,235861,235861,235862,0,1,2
67447,5,2,235866,235866,235868,0,2,4
67448,1,3,235867,235868,235871,1,4,0
67449,6,1,235873,235873,235874,0,1,2
67450,4,3,235877,235877,235880,0,3,3
67451,3,3,235880,235880,235883,0,3,0
67452,6,2,235886,235886,235888,0,2,3
67453,3,3,235889,235889,235892,0,3,1
67454,3,1,235892,235892,235893,0,1,0
67455,5,3,235897,235897,235900,0,3,4
67456,2,3,235899,235900,235903,1,4,0
67457,5,3,235904,235904,235907,0,3,1
67458,4,2,235908,235908,235910,0,2,1
67459,1,1,235909,235910,235911,1,2,0
67460,4,1,235913,235913,235914,0,1,2
67461,4,2,235917,235917,235919,0,2,3
67462,4,1,235921,235921,235922,0,1,2
67463,2,1,235923,235923,235924,0,1,1
67464,6,3,235929,235929,235932,0,3,5
67465,1,3,235930,235932,235935,2,5,0
67466,2,3,235932,235935,235938,3,6,0
67467,6,2,235938,235938,235940,0,2,0
67468,4,3,235942,235942,235945,0,3,2
67469,1,1,235943,235945,235946,2,3,0
67470,6,2,235949,235949,235951,0,2,3
67471,4,3,235953,235953,235956,0,3,2
67472,1,3,235954,235956,235959,2,5,0
67473,5,3,235959,235959,235962,0,3,0
67474,4,2,235963,235963,235965,0,2,1
67475,2,1,235965,235965,235966,0,1,0
67476,5,2,235970,235970,235972,0,2,4
67477,4,1,235974,235974,235975,0,1,2
67478,2,3,235976,235976,235979,0,3,1
67479,3,1,235979,235979,235980,0,1,0
67480,5,2,235984,235984,235986,0,2,4
67481,1,3,235985,235986,235989,1,4,0
67482,1,2,235986,235989,235991,3,5,0
67483,2,1,235988,235991,235992,3,4,0
67484,1,2,235989,235992,235994,3,5,0
67485,6,3,235995,235995,235998,0,3,1
67486,4,3,235999,235999,236002,0,3,1
67487,6,3,236005,236005,236008,0,3,3
67488,4,1,236009,236009,236010,0,1,1
67489,4,3,236013,236013,236016,0,3,3
67490,6,1,236019,236019,236020,0,1,3
67491,1,1,236020,236020,236021,0,1,0
67492,1,2,236021,236021,236023,0,2,0
67493,3,3,236024,236024,236027,0,3,1
67494,6,3,236030,236030,236033,0,3,3
67495,6,1,236036,236036,236037,0,1,3
67496,4,2,236040,236040,236042,0,2,3
67497,1,3,236041,236042,236045,1,4,0
67498,3,2,236044,236045,236047,1,3,0
67499,5,3,236049,236049,236052,0,3,2
67500,5,2,236054,236054,236056,0,2,2
67501,6,3,236060,236060,236063,0,3,4
67502,3,2,236063,236063,236065,0,2,0
67503,3,3,236066,236066,236069,0,3,1
67504,1,1,236067,236069,236070,2,3,0
67505,6,1,236073,236073,236074,0,1,3
67506,1,1,236074,236074,236075,0,1,0
67507,2,2,236076,236076,236078,0,2,1
67508,2,3,236078,236078,236081,0,3,0
67509,2,2,236080,236081,236083,1,3,0
67510,5,2,236085,236085,236087,0,2,2
67511,4,2,236089,236089,236091,0,2,2
67512,4,1,236093,236093,236094,0,1,2
67513,5,3,236098,236098,236101,0,3,4
67514,2,3,236100,236101,236104,1,4,0
67515,2,3,236102,236104,236107,2,5,0
67516,2,1,236104,236107,236108,3,4,0
67517,2,3,236106,236108,236111,2,5,0
67518,3,2,236109,236111,236113,2,4,0
67519,3,3,236112,236113,236116,1,4,0
67520,3,3,236115,236116,236119,1,4,0
67521,2,1,236117,236119,236120,2,3,0
67522,6,1,236123,236123,236124,0,1,3
67523,3,1,236126,236126,236127,0,1,2
67524,5,2,236131,236131,236133,0,2,4
67525,3,1,236134,236134,236135,0,1,1
67526,2,1,236136,236136,236137,0,1,1
67527,5,1,236141,236141,236142,0,1,4
67528,4,2,236145,236145,236147,0,2,3
67529,2,2,236147,236147,236149,0,2,0
67530,5,1,236152,236152,236153,0,1,3
67531,2,3,236154,236154,236157,0,3,1
67532,2,3,236156,236157,236160,1,4,0
67533,4,2,236160,236160,236162,0,2,0
67534,1,1,236161,236162,236163,1,2,0
67535,3,1,236164,236164,236165,0,1,1
67536,5,1,236169,236169,236170,0,1,4
67537,5,3,236174,236174,236177,0,3,4
67538,3,2,236177,236177,236179,0,2,0
67539,3,2,236180,236180,236182,0,2,1
67540,4,2,236184,236184,236186,0,2,2
67541,3,1,236187,236187,236188,0,1,1
67542,1,3,236188,236188,236191,0,3,0
67543,1,1,236189,236191,236192,2,3,0
67544,2,3,236191,236192,236195,1,4,0
67545,2,1,236193,236195,236196,2,3,0
67546,2,2,236195,236196,236198,1,3,0
67547,1,1,236196,236198,236199,2,3,0
67548,3,3,236199,236199,236202,0,3,0
67549,1,1,236200,236202,236203,2,3,0
67550,3,1,236203,236203,236204,0,1,0
67551,3,3,236206,236206,236209,0,3,2
67552,4,1,236210,236210,236211,0,1,1
67553,5,3,236215,236215,236218,0,3,4
67554,3,2,236218,236218,236220,0,2,0
67555,1,3,236219,236220,236223,1,4,0
67556,3,2,236222,236223,236225,1,3,0
67557,1,3,236223,236225,236228,2,5,0
67558,2,3,236225,236228,236231,3,6,0
67559,3,2,236228,236231,236233,3,5,0
67560,2,3,236230,236233,236236,3,6,0
67561,1,2,236231,236236,236238,5,7,0
67562,2,1,236233,236238,236239,5,6,0
67563,3,2,236236,236239,236241,3,5,0
67564,6,2,236242,236242,236244,0,2,1
67565,4,2,236246,236246,236248,0,2,2
67566,4,3,236250,236250,236253,0,3,2
67567,4,1,236254,236254,236255,0,1,1
67568,6,3,236260,236260,236263,0,3,5
67569,1,3,236261,236263,236266,2,5,0
67570,2,3,236263,236266,236269,3,6,0
67571,4,1,236267,236269,236270,2,3,0
67572,3,1,236270,236270,236271,0,1,0
67573,5,3,236275,236275,236278,0,3,4
67574,1,2,236276,236278,236280,2,4,0
67575,3,1,236279,236280,236281,1,2,0
67576,6,1,236285,236285,236286,0,1,4
67577,2,1,236287,236287,236288,0,1,1
67578,3,3,236290,236290,236293,0,3,2
67579,6,2,236296,236296,236298,0,2,3
67580,2,3,236298,236298,236301,0,3,0
67581,2,1,236300,236301,236302,1,2,0
67582,3,3,236303,236303,236306,0,3,1
67583,1,1,236304,236306,236307,2,3,0
67584,2,1,236306,236307,236308,1,2,0
67585,5,1,236311,236311,236312,0,1,3
67586,6,2,236317,236317,236319,0,2,5
67587,5,3,236322,236322,236325,0,3,3
67588,1,1,236323,236325,236326,2,3,0
67589,2,3,236325,236326,236329,1,4,0
67590,6,2,236331,236331,236333,0,2,2
67591,4,2,236335,236335,236337,0,2,2
67592,3,1,236338,236338,236339,0,1,1
67593,4,2,236342,236342,236344,0,2,3
67594,3,2,236345,236345,236347,0,2,1
67595,2,3,236347,236347,236350,0,3,0
67596,5,3,236352,236352,236355,0,3,2
67597,1,1,236353,236355,236356,2,3,0
67598,4,1,236357,236357,236358,0,1,1
67599,4,3,236361,236361,236364,0,3,3
67600,4,1,236365,236365,236366,0,1,1
67601,1,3,236366,236366,236369,0,3,0
67602,1,2,236367,236369,236371,2,4,0
67603,2,3,236369,236371,236374,2,5,0
67604,3,1,236372,236374,236375,2,3,0
67605,3,3,236375,236375,236378,0,3,0
67606,3,1,236378,236378,236379,0,1,0
67607,2,1,236380,236380,236381,0,1,1
67608,4,2,236384,236384,236386,0,2,3
67609,4,2,236388,236388,236390,0,2,2
67610,2,2,236390,236390,236392,0,2,0
67611,4,1,236394,236394,236395,0,1,2
67612,4,2,236398,236398,236400,0,2,3
67613,3,2,236401,236401,236403,0,2,1
67614,6,2,236407,236407,236409,0,2,4
67615,5,1,236412,236412,236413,0,1,3
67616,4,3,236416,236416,236419,0,3,3
67617,5,3,236421,236421,236424,0,3,2
67618,3,3,236424,236424,236427,0,3,0
67619,4,3,236428,236428,236431,0,3,1
67620,5,1,236433,236433,236434,0,1,2
67621,1,1,236434,236434,236435,0,1,0
67622,1,1,236435,236435,236436,0,1,0
67623,5,3,236440,236440,236443,0,3,4
67624,5,3,236445,236445,236448,0,3,2
67625,4,2,236449,236449,236451,0,2,1
67626,4,2,236453,236453,236455,0,2,2
67627,6,2,236459,236459,236461,0,2,4
67628,5,2,236464,236464,236466,0,2,3
67629,6,1,236470,236470,236471,0,1,4
67630,4,2,236474,236474,236476,0,2,3
67631,2,2,236476,236476,236478,0,2,0
67632,4,2,236480,236480,236482,0,2,2
67633,5,2,236485,236485,236487,0,2,3
67634,4,3,236489,236489,236492,0,3,2
67635,4,1,236493,236493,236494,0,1,1
67636,2,2,236495,236495,236497,0,2,1
67637,2,2,236497,236497,236499,0,2,0
67638,6,2,236503,236503,236505,0,2,4
67639,5,1,236508,236508,236509,0,1,3
67640,5,3,236513,236513,236516,0,3,4
67641,4,3,236517,236517,236520,0,3,1
67642,5,2,236522,236522,236524,0,2,2
67643,4,3,236526,236526,236529,0,3,2
67644,4,2,236530,236530,236532,0,2,1
67645,2,3,236532,236532,236535,0,3,0
67646,6,2,236538,236538,236540,0,2,3
67647,2,2,236540,236540,236542,0,2,0
67648,1,1,236541,236542,236543,1,2,0
67649,2,3,236543,236543,236546,0,3,0
67650,4,2,236547,236547,236549,0,2,1
67651,2,3,236549,236549,236552,0,3,0
67652,4,3,236553,236553,236556,0,3,1
67653,6,1,236559,236559,236560,0,1,3
67654,2,3,236561,236561,236564,0,3,1
67655,6,3,236567,236567,236570,0,3,3
67656,1,2,236568,236570,236572,2,4,0
67657,3,3,236571,236572,236575,1,4,0
67658,1,1,236572,236575,236576,3,4,0
67659,4,2,236576,236576,236578,0,2,0
67660,2,1,236578,236578,236579,0,1,0
67661,5,2,236583,236583,236585,0,2,4
67662,1,1,236584,236585,236586,1,2,0
67663,3,1,236587,236587,236588,0,1,1
67664,5,3,236592,236592,236595,0,3,4
67665,5,1,236597,236597,236598,0,1,2
67666,6,2,236603,236603,236605,0,2,5
67667,5,1,236608,236608,236609,0,1,3
67668,1,3,236609,236609,236612,0,3,0
67669,1,1,236610,236612,236613,2,3,0
67670,4,3,236614,236614,236617,0,3,1
67671,4,2,236618,236618,236620,0,2,1
67672,1,3,236619,236620,236623,1,4,0
67673,4,1,236623,236623,236624,0,1,0
67674,2,1,236625,236625,236626,0,1,1
67675,3,1,236628,236628,236629,0,1,2
67676,1,3,236629,236629,236632,0,3,0
67677,5,3,236634,236634,236637,0,3,2
67678,3,2,236637,236637,236639,0,2,0
67679,3,3,236640,236640,236643,0,3,1
67680,6,1,236646,236646,236647,0,1,3
67681,3,2,236649,236649,236651,0,2,2
67682,4,1,236653,236653,236654,0,1,2
67683,5,2,236658,236658,236660,0,2,4
67684,4,2,236662,236662,236664,0,2,2
67685,3,1,236665,236665,236666,0,1,1
67686,4,3,236669,236669,236672,0,3,3
67687,4,3,236673,236673,236676,0,3,1
67688,1,1,236674,236676,236677,2,3,0
67689,5,1,236679,236679,236680,0,1,2
67690,1,1,236680,236680,236681,0,1,0
67691,3,2,236683,236683,236685,0,2,2
67692,4,3,236687,236687,236690,0,3,2
67693,4,1,236691,236691,236692,0,1,1
67694,2,3,236693,236693,236696,0,3,1
67695,3,2,236696,236696,236698,0,2,0
67696,2,3,236698,236698,236701,0,3,0
67697,2,2,236700,236701,236703,1,3,0
67698,3,3,236703,236703,236706,0,3,0
67699,2,3,236705,236706,236709,1,4,0
67700,2,2,236707,236709,236711,2,4,0
67701,3,2,236710,236711,236713,1,3,0
67702,6,1,236716,236716,236717,0,1,3
67703,3,3,236719,236719,236722,0,3,2
67704,4,2,236723,236723,236725,0,2,1
67705,2,3,236725,236725,236728,0,3,0
67706,4,1,236729,236729,236730,0,1,1
67707,6,3,236735,236735,236738,0,3,5
67708,3,1,236738,236738,236739,0,1,0
67709,1,3,236739,236739,236742,0,3,0
67710,3,3,236742,236742,236745,0,3,0
67711,1,2,236743,236745,236747,2,4,0
67712,2,2,236745,236747,236749,2,4,0
67713,1,1,236746,236749,236750,3,4,0
67714,6,2,236752,236752,236754,0,2,2
67715,5,3,236757,236757,236760,0,3,3
67716,2,3,236759,236760,236763,1,4,0
67717,4,3,236763,236763,236766,0,3,0
67718,2,3,236765,236766,236769,1,4,0
67719,6,1,236771,236771,236772,0,1,2
67720,1,1,236772,236772,236773,0,1,0
67721,1,2,236773,236773,236775,0,2,0
67722,6,3,236779,236779,236782,0,3,4
67723,4,1,236783,236783,236784,0,1,1
67724,6,1,236789,236789,236790,0,1,5
67725,1,2,236790,236790,236792,0,2,0
67726,4,2,236794,236794,236796,0,2,2
67727,2,2,236796,236796,236798,0,2,0
67728,1,1,236797,236798,236799,1,2,0
67729,4,3,236801,236801,236804,0,3,2
67730,1,3,236802,236804,236807,2,5,0
67731,1,3,236803,236807,236810,4,7,0
67732,4,2,236807,236810,236812,3,5,0
67733,2,1,236809,236812,236813,3,4,0
67734,1,1,236810,236813,236814,3,4,0
67735,6,2,236816,236816,236818,0,2,2
67736,3,2,236819,236819,236821,0,2,1
67737,5,1,236824,236824,236825,0,1,3
67738,1,2,236825,236825,236827,0,2,0
67739,2,3,236827,236827,236830,0,3,0
67740,6,3,236833,236833,236836,0,3,3
67741,1,3,236834,236836,236839,2,5,0
67742,1,2,236835,236839,236841,4,6,0
67743,2,2,236837,236841,236843,4,6,0
67744,4,1,236841,236843,236844,2,3,0
67745,4,3,236845,236845,236848,0,3,1
67746,6,3,236851,236851,236854,0,3,3
67747,4,1,236855,236855,236856,0,1,1
67748,1,2,236856,236856,236858,0,2,0
67749,5,3,236861,236861,236864,0,3,3
67750,1,3,236862,236864,236867,2,5,0
67751,6,2,236868,236868,236870,0,2,1
67752,1,3,236869,236870,236873,1,4,0
67753,5,3,236874,236874,236877,0,3,1
67754,6,1,236880,236880,236881,0,1,3
67755,4,3,236884,236884,236887,0,3,3
67756,6,1,236890,236890,236891,0,1,3
67757,4,2,236894,236894,236896,0,2,3
67758,1,2,236895,236896,236898,1,3,0
67759,3,2,236898,236898,236900,0,2,0
67760,6,3,236904,236904,236907,0,3,4
67761,3,3,236907,236907,236910,0,3,0
67762,4,3,236911,236911,236914,0,3,1
67763,1,1,236912,236914,236915,2,3,0
67764,1,3,236913,236915,236918,2,5,0
67765,5,3,236918,236918,236921,0,3,0
67766,2,1,236920,236921,236922,1,2,0
67767,5,3,236925,236925,236928,0,3,3
67768,5,2,236930,236930,236932,0,2,2
67769,4,3,236934,236934,236937,0,3,2
67770,4,3,236938,236938,236941,0,3,1
67771,2,3,236940,236941,236944,1,4,0
67772,2,1,236942,236944,236945,2,3,0
67773,4,2,236946,236946,236948,0,2,1
67774,2,3,236948,236948,236951,0,3,0
67775,1,2,236949,236951,236953,2,4,0
67776,3,1,236952,236953,236954,1,2,0
67777,5,3,236957,236957,236960,0,3,3
67778,4,3,236961,236961,236964,0,3,1
67779,2,2,236963,236964,236966,1,3,0
67780,3,1,236966,236966,236967,0,1,0
67781,4,3,236970,236970,236973,0,3,3
67782,6,3,236976,236976,236979,0,3,3
67783,4,2,236980,236980,236982,0,2,1
67784,5,1,236985,236985,236986,0,1,3
67785,1,3,236986,236986,236989,0,3,0
67786,1,1,236987,236989,236990,2,3,0
67787,1,3,236988,236990,236993,2,5,0
67788,4,1,236992,236993,236994,1,2,0
67789,6,1,236998,236998,236999,0,1,4
67790,1,2,236999,236999,237001,0,2,0
67791,1,1,237000,237001,237002,1,2,0
67792,5,1,237005,237005,237006,0,1,3
67793,6,1,237011,237011,237012,0,1,5
67794,4,2,237015,237015,237017,0,2,3
67795,3,2,237018,237018,237020,0,2,1
67796,5,2,237023,237023,237025,0,2,3
67797,5,2,237028,237028,237030,0,2,3
67798,1,3,237029,237030,237033,1,4,0
67799,5,1,237034,237034,237035,0,1,1
67800,6,2,237040,237040,237042,0,2,5
67801,5,2,237045,237045,237047,0,2,3
67802,5,1,237050,237050,237051,0,1,3
67803,2,3,237052,237052,237055,0,3,1
67804,2,1,237054,237055,237056,1,2,0
67805,4,2,237058,237058,237060,0,2,2
67806,2,3,237060,237060,237063,0,3,0
67807,2,1,237062,237063,237064,1,2,0
67808,1,2,237063,237064,237066,1,3,0
67809,6,1,237069,237069,237070,0,1,3
67810,4,2,237073,237073,237075,0,2,3
67811,6,3,237079,237079,237082,0,3,4
67812,6,3,237085,237085,237088,0,3,3
67813,2,2,237087,237088,237090,1,3,0
67814,1,3,237088,237090,237093,2,5,0
67815,2,1,237090,237093,237094,3,4,0
67816,2,2,237092,237094,237096,2,4,0
67817,1,1,237093,237096,237097,3,4,0
67818,2,1,237095,237097,237098,2,3,0
67819,6,3,237101,237101,237104,0,3,3
67820,5,3,237106,237106,237109,0,3,2
67821,6,2,237112,237112,237114,0,2,3
67822,4,3,237116,237116,237119,0,3,2
67823,1,2,237117,237119,237121,2,4,0
67824,6,1,237123,237123,237124,0,1,2
67825,1,2,237124,237124,237126,0,2,0
67826,6,1,237130,237130,237131,0,1,4
67827,1,2,237131,237131,237133,0,2,0
67828,5,1,237136,237136,237137,0,1,3
67829,2,3,237138,237138,237141,0,3,1
67830,1,2,237139,237141,237143,2,4,0
67831,2,2,237141,237143,237145,2,4,0
67832,6,3,237147,237147,237150,0,3,2
67833,3,2,237150,237150,237152,0,2,0
67834,5,2,237155,237155,237157,0,2,3
67835,5,2,237160,237160,237162,0,2,3
67836,6,3,237166,237166,237169,0,3,4
67837,4,3,237170,237170,237173,0,3,1
67838,2,3,237172,237173,237176,1,4,0
67839,6,3,237178,237178,237181,0,3,2
67840,1,1,237179,237181,237182,2,3,0
67841,5,2,237184,237184,237186,0,2,2
67842,5,2,237189,237189,237191,0,2,3
67843,4,2,237193,237193,237195,0,2,2
67844,1,3,237194,237195,237198,1,4,0
67845,1,2,237195,237198,237200,3,5,0
67846,3,1,237198,237200,237201,2,3,0
67847,3,1,237201,237201,237202,0,1,0
67848,4,2,237205,237205,237207,0,2,3
67849,1,2,237206,237207,237209,1,3,0
67850,6,3,237212,237212,237215,0,3,3
67851,5,3,237217,237217,237220,0,3,2
67852,4,2,237221,237221,237223,0,2,1
67853,6,3,237227,237227,237230,0,3,4
67854,1,1,237228,237230,237231,2,3,0
67855,3,1,237231,237231,237232,0,1,0
67856,4,1,237235,237235,237236,0,1,3
67857,6,2,237241,237241,237243,0,2,5
67858,6,2,237247,237247,237249,0,2,4
67859,5,2,237252,237252,237254,0,2,3
67860,6,3,237258,237258,237261,0,3,4
67861,1,3,237259,237261,237264,2,5,0
67862,3,2,237262,237264,237266,2,4,0
67863,2,2,237264,237266,237268,2,4,0
67864,1,3,237265,237268,237271,3,6,0
67865,6,3,237271,237271,237274,0,3,0
67866,5,1,237276,237276,237277,0,1,2
67867,6,2,237282,237282,237284,0,2,5
67868,5,2,237287,237287,237289,0,2,3
67869,5,1,237292,237292,237293,0,1,3
67870,6,1,237298,237298,237299,0,1,5
67871,3,3,237301,237301,237304,0,3,2
67872,3,3,237304,237304,237307,0,3,0
67873,4,2,237308,237308,237310,0,2,1
67874,3,2,237311,237311,237313,0,2,1
67875,3,1,237314,237314,237315,0,1,1
67876,3,1,237317,237317,237318,0,1,2
67877,4,1,237321,237321,237322,0,1,3
67878,2,2,237323,237323,237325,0,2,1
67879,5,1,237328,237328,237329,0,1,3
67880,5,2,237333,237333,237335,0,2,4
67881,4,1,237337,237337,237338,0,1,2
67882,2,3,237339,237339,237342,0,3,1
67883,1,3,237340,237342,237345,2,5,0
67884,6,1,237346,237346,237347,0,1,1
67885,1,1,237347,237347,237348,0,1,0
67886,5,3,237352,237352,237355,0,3,4
67887,6,1,237358,237358,237359,0,1,3
67888,1,1,237359,237359,237360,0,1,0
67889,1,2,237360,237360,237362,0,2,0
67890,4,1,237364,237364,237365,0,1,2
67891,5,2,237369,237369,237371,0,2,4
67892,6,2,237375,237375,237377,0,2,4
67893,1,3,237376,237377,237380,1,4,0
67894,5,3,237381,237381,237384,0,3,1
67895,3,1,237384,237384,237385,0,1,0
67896,6,1,237390,237390,237391,0,1,5
67897,6,1,237396,237396,237397,0,1,5
67898,3,2,237399,237399,237401,0,2,2
67899,5,3,237404,237404,237407,0,3,3
67900,6,2,237410,237410,237412,0,2,3
67901,5,3,237415,237415,237418,0,3,3
67902,1,2,237416,237418,237420,2,4,0
67903,3,1,237419,237420,237421,1,2,0
67904,3,3,237422,237422,237425,0,3,1
67905,3,2,237425,237425,237427,0,2,0
67906,1,2,237426,237427,237429,1,3,0
67907,1,3,237427,237429,237432,2,5,0
67908,6,3,237433,237433,237436,0,3,1
67909,2,3,237435,237436,237439,1,4,0
67910,5,2,237440,237440,237442,0,2,1
67911,6,1,237446,237446,237447,0,1,4
67912,1,3,237447,237447,237450,0,3,0
67913,6,2,237453,237453,237455,0,2,3
67914,5,1,237458,237458,237459,0,1,3
67915,2,2,237460,237460,237462,0,2,1
67916,2,1,237462,237462,237463,0,1,0
67917,4,3,237466,237466,237469,0,3,3
67918,4,3,237470,237470,237473,0,3,1
67919,4,2,237474,237474,237476,0,2,1
67920,1,3,237475,237476,237479,1,4,0
67921,6,2,237481,237481,237483,0,2,2
67922,1,1,237482,237483,237484,1,2,0
67923,6,2,237488,237488,237490,0,2,4
67924,2,1,237490,237490,237491,0,1,0
67925,5,1,237495,237495,237496,0,1,4
67926,3,1,237498,237498,237499,0,1,2
67927,6,2,237504,237504,237506,0,2,5
67928,1,1,237505,237506,237507,1,2,0
67929,4,3,237509,237509,237512,0,3,2
67930,4,1,237513,237513,237514,0,1,1
67931,3,3,237516,237516,237519,0,3,2
67932,4,2,237520,237520,237522,0,2,1
67933,2,3,237522,237522,237525,0,3,0
67934,4,1,237526,237526,237527,0,1,1
67935,6,2,237532,237532,237534,0,2,5
67936,1,3,237533,237534,237537,1,4,0
67937,2,1,237535,237537,237538,2,3,0
67938,1,2,237536,237538,237540,2,4,0
67939,1,2,237537,237540,237542,3,5,0
67940,5,3,237542,237542,237545,0,3,0
67941,3,3,237545,237545,237548,0,3,0
67942,2,3,237547,237548,237551,1,4,0
67943,2,2,237549,237551,237553,2,4,0
67944,5,3,237554,237554,237557,0,3,1
67945,2,1,237556,237557,237558,1,2,0
67946,2,2,237558,237558,237560,0,2,0
67947,4,1,237562,237562,237563,0,1,2
67948,5,1,237567,237567,237568,0,1,4
67949,1,3,237568,237568,237571,0,3,0
67950,3,1,237571,237571,237572,0,1,0
67951,3,2,237574,237574,237576,0,2,2
67952,4,3,237578,237578,237581,0,3,2
67953,5,3,237583,237583,237586,0,3,2
67954,5,1,237588,237588,237589,0,1,2
67955,2,2,237590,237590,237592,0,2,1
67956,5,3,237595,237595,237598,0,3,3
67957,5,3,237600,237600,237603,0,3,2
67958,6,2,237606,237606,237608,0,2,3
67959,3,2,237609,237609,237611,0,2,1
67960,2,2,237611,237611,237613,0,2,0
67961,5,3,237616,237616,237619,0,3,3
67962,2,3,237618,237619,237622,1,4,0
67963,6,2,237624,237624,237626,0,2,2
67964,2,2,237626,237626,237628,0,2,0
67965,6,1,237632,237632,237633,0,1,4
67966,3,3,237635,237635,237638,0,3,2
67967,6,1,237641,237641,237642,0,1,3
67968,6,3,237647,237647,237650,0,3,5
67969,2,3,237649,237650,237653,1,4,0
67970,2,2,237651,237653,237655,2,4,0
67971,1,2,237652,237655,237657,3,5,0
67972,2,2,237654,237657,237659,3,5,0
67973,4,3,237658,237659,237662,1,4,0
67974,3,2,237661,237662,237664,1,3,0
67975,3,2,237664,237664,237666,0,2,0
67976,6,1,237670,237670,237671,0,1,4
67977,3,3,237673,237673,237676,0,3,2
67978,1,1,237674,237676,237677,2,3,0
67979,3,3,237677,237677,237680,0,3,0
67980,3,3,237680,237680,237683,0,3,0
67981,1,2,237681,237683,237685,2,4,0
67982,4,1,237685,237685,237686,0,1,0
67983,5,3,237690,237690,237693,0,3,4
67984,1,1,237691,237693,237694,2,3,0
67985,4,2,237695,237695,237697,0,2,1
67986,4,3,237699,237699,237702,0,3,2
67987,2,1,237701,237702,237703,1,2,0
67988,5,3,237706,237706,237709,0,3,3
67989,5,1,237711,237711,237712,0,1,2
67990,2,1,237713,237713,237714,0,1,1
67991,1,1,237714,237714,237715,0,1,0
67992,5,3,237719,237719,237722,0,3,4
67993,2,2,237721,237722,237724,1,3,0
67994,4,1,237725,237725,237726,0,1,1
67995,3,2,237728,237728,237730,0,2,2
67996,2,2,237730,237730,237732,0,2,0
67997,3,2,237733,237733,237735,0,2,1
67998,4,3,237737,237737,237740,0,3,2
67999,5,3,237742,237742,237745,0,3,2
68000,1,2,237743,237745,237747,2,4,0
68001,1,1,237744,237747,237748,3,4,0
68002,4,2,237748,237748,237750,0,2,0
68003,3,1,237751,237751,237752,0,1,1
68004,3,3,237754,237754,237757,0,3,2
68005,6,2,237760,237760,237762,0,2,3
68006,6,3,237766,237766,237769,0,3,4
68007,5,3,237771,237771,237774,0,3,2
68008,6,2,237777,237777,237779,0,2,3
68009,1,2,237778,237779,237781,1,3,0
68010,5,3,237783,237783,237786,0,3,2
68011,3,1,237786,237786,237787,0,1,0
68012,2,2,237788,237788,237790,0,2,1
68013,1,3,237789,237790,237793,1,4,0
68014,2,3,237791,237793,237796,2,5,0
68015,5,2,237796,237796,237798,0,2,0
68016,5,2,237801,237801,237803,0,2,3
68017,3,1,237804,237804,237805,0,1,1
68018,6,1,237810,237810,237811,0,1,5
68019,3,3,237813,237813,237816,0,3,2
68020,5,2,237818,237818,237820,0,2,2
68021,4,3,237822,237822,237825,0,3,2
68022,4,2,237826,237826,237828,0,2,1
68023,1,3,237827,237828,237831,1,4,0
68024,3,1,237830,237831,237832,1,2,0
68025,2,2,237832,237832,237834,0,2,0
68026,6,2,237838,237838,237840,0,2,4
68027,1,3,237839,237840,237843,1,4,0
68028,2,2,237841,237843,237845,2,4,0
68029,5,2,237846,237846,237848,0,2,1
68030,1,3,237847,237848,237851,1,4,0
68031,5,1,237852,237852,237853,0,1,1
68032,3,2,237855,237855,237857,0,2,2
68033,6,2,237861,237861,237863,0,2,4
68034,6,3,237867,237867,237870,0,3,4
68035,1,3,237868,237870,237873,2,5,0
68036,4,1,237872,237873,237874,1,2,0
68037,4,1,237876,237876,237877,0,1,2
68038,1,2,237877,237877,237879,0,2,0
68039,6,2,237883,237883,237885,0,2,4
68040,6,1,237889,237889,237890,0,1,4
68041,4,2,237893,237893,237895,0,2,3
68042,6,1,237899,237899,237900,0,1,4
68043,6,2,237905,237905,237907,0,2,5
68044,1,2,237906,237907,237909,1,3,0
68045,3,3,237909,237909,237912,0,3,0
68046,5,2,237914,237914,237916,0,2,2
68047,2,3,237916,237916,237919,0,3,0
68048,6,3,237922,237922,237925,0,3,3
68049,5,2,237927,237927,237929,0,2,2
68050,3,3,237930,237930,237933,0,3,1
68051,3,1,237933,237933,237934,0,1,0
68052,2,1,237935,237935,237936,0,1,1
68053,2,1,237937,237937,237938,0,1,1
68054,5,2,237942,237942,237944,0,2,4
68055,5,2,237947,237947,237949,0,2,3
68056,3,3,237950,237950,237953,0,3,1
68057,1,1,237951,237953,237954,2,3,0
68058,5,1,237956,237956,237957,0,1,2
68059,5,1,237961,237961,237962,0,1,4
68060,4,2,237965,237965,237967,0,2,3
68061,5,3,237970,237970,237973,0,3,3
68062,2,1,237972,237973,237974,1,2,0
68063,2,1,237974,237974,237975,0,1,0
68064,5,2,237979,237979,237981,0,2,4
68065,2,3,237981,237981,237984,0,3,0
68066,2,2,237983,237984,237986,1,3,0
68067,2,2,237985,237986,237988,1,3,0
68068,4,1,237989,237989,237990,0,1,1
68069,6,1,237995,237995,237996,0,1,5
68070,3,2,237998,237998,238000,0,2,2
68071,3,1,238001,238001,238002,0,1,1
68072,4,3,238005,238005,238008,0,3,3
68073,2,2,238007,238008,238010,1,3,0
68074,6,1,238013,238013,238014,0,1,3
68075,3,3,238016,238016,238019,0,3,2
68076,3,2,238019,238019,238021,0,2,0
68077,4,1,238023,238023,238024,0,1,2
68078,1,2,238024,238024,238026,0,2,0
68079,1,1,238025,238026,238027,1,2,0
68080,6,2,238031,238031,238033,0,2,4
68081,2,3,238033,238033,238036,0,3,0
68082,5,2,238038,238038,238040,0,2,2
68083,3,3,238041,238041,238044,0,3,1
68084,3,2,238044,238044,238046,0,2,0
68085,4,3,238048,238048,238051,0,3,2
68086,6,1,238054,238054,238055,0,1,3
68087,4,3,238058,238058,238061,0,3,3
68088,6,3,238064,238064,238067,0,3,3
68089,3,3,238067,238067,238070,0,3,0
68090,5,3,238072,238072,238075,0,3,2
68091,6,1,238078,238078,238079,0,1,3
68092,5,1,238083,238083,238084,0,1,4
68093,6,2,238089,238089,238091,0,2,5
68094,3,2,238092,238092,238094,0,2,1
68095,2,3,238094,238094,238097,0,3,0
68096,4,2,238098,238098,238100,0,2,1
68097,2,3,238100,238100,238103,0,3,0
68098,1,1,238101,238103,238104,2,3,0
68099,2,1,238103,238104,238105,1,2,0
68100,5,2,238108,238108,238110,0,2,3
68101,6,2,238114,238114,238116,0,2,4
68102,3,1,238117,238117,238118,0,1,1
68103,6,1,238123,238123,238124,0,1,5
68104,2,1,238125,238125,238126,0,1,1
68105,3,3,238128,238128,238131,0,3,2
68106,6,2,238134,238134,238136,0,2,3
68107,5,3,238139,238139,238142,0,3,3
68108,2,2,238141,238142,238144,1,3,0
68109,1,1,238142,238144,238145,2,3,0
68110,5,2,238147,238147,238149,0,2,2
68111,2,3,238149,238149,238152,0,3,0
68112,2,3,238151,238152,238155,1,4,0
68113,1,3,238152,238155,238158,3,6,0
68114,1,3,238153,238158,238161,5,8,0
68115,5,1,238158,238161,238162,3,4,0
68116,5,1,238163,238163,238164,0,1,1
68117,5,1,238168,238168,238169,0,1,4
68118,5,2,238173,238173,238175,0,2,4
68119,5,3,238178,238178,238181,0,3,3
68120,3,2,238181,238181,238183,0,2,0
68121,4,2,238185,238185,238187,0,2,2
68122,2,3,238187,238187,238190,0,3,0
68123,3,1,238190,238190,238191,0,1,0
68124,6,1,238196,238196,238197,0,1,5
68125,2,2,238198,238198,238200,0,2,1
68126,5,2,238203,238203,238205,0,2,3
68127,3,2,238206,238206,238208,0,2,1
68128,5,2,238211,238211,238213,0,2,3
68129,6,2,238217,238217,238219,0,2,4
68130,3,3,238220,238220,238223,0,3,1
68131,5,2,238225,238225,238227,0,2,2
68132,5,1,238230,238230,238231,0,1,3
68133,5,1,238235,238235,238236,0,1,4
68134,2,1,238237,238237,238238,0,1,1
68135,6,3,238243,238243,238246,0,3,5
68136,6,3,238249,238249,238252,0,3,3
68137,5,1,238254,238254,238255,0,1,2
68138,6,2,238260,238260,238262,0,2,5
68139,6,1,238266,238266,238267,0,1,4
68140,3,2,238269,238269,238271,0,2,2
68141,5,3,238274,238274,238277,0,3,3
68142,5,1,238279,238279,238280,0,1,2
68143,2,3,238281,238281,238284,0,3,1
68144,5,3,238286,238286,238289,0,3,2
68145,6,1,238292,238292,238293,0,1,3
68146,3,2,238295,238295,238297,0,2,2
68147,4,2,238299,238299,238301,0,2,2
68148,6,2,238305,238305,238307,0,2,4
68149,2,1,238307,238307,238308,0,1,0
68150,3,2,238310,238310,238312,0,2,2
68151,1,1,238311,238312,238313,1,2,0
68152,4,2,238315,238315,238317,0,2,2
68153,4,2,238319,238319,238321,0,2,2
68154,3,1,238322,238322,238323,0,1,1
68155,6,1,238328,238328,238329,0,1,5
68156,3,3,238331,238331,238334,0,3,2
68157,3,3,238334,238334,238337,0,3,0
68158,2,2,238336,238337,238339,1,3,0
68159,5,1,238341,238341,238342,0,1,2
68160,2,3,238343,238343,238346,0,3,1
68161,4,3,238347,238347,238350,0,3,1
68162,5,2,238352,238352,238354,0,2,2
68163,6,2,238358,238358,238360,0,2,4
68164,5,1,238363,238363,238364,0,1,3
68165,2,3,238365,238365,238368,0,3,1
68166,4,3,238369,238369,238372,0,3,1
68167,5,2,238374,238374,238376,0,2,2
68168,4,1,238378,238378,238379,0,1,2
68169,4,2,238382,238382,238384,0,2,3
68170,6,2,238388,238388,238390,0,2,4
68171,2,1,238390,238390,238391,0,1,0
68172,4,1,238394,238394,238395,0,1,3
68173,4,3,238398,238398,238401,0,3,3
68174,4,3,238402,238402,238405,0,3,1
68175,3,1,238405,238405,238406,0,1,0
68176,5,1,238410,238410,238411,0,1,4
68177,5,2,238415,238415,238417,0,2,4
68178,6,2,238421,238421,238423,0,2,4
68179,5,1,238426,238426,238427,0,1,3
68180,5,1,238431,238431,238432,0,1,4
68181,3,1,238434,238434,238435,0,1,2
68182,2,3,238436,238436,238439,0,3,1
68183,3,2,238439,238439,238441,0,2,0
68184,5,3,238444,238444,238447,0,3,3
68185,5,3,238449,238449,238452,0,3,2
68186,4,1,238453,238453,238454,0,1,1
68187,5,3,238458,238458,238461,0,3,4
68188,6,3,238464,238464,238467,0,3,3
68189,3,2,238467,238467,238469,0,2,0
68190,5,2,238472,238472,238474,0,2,3
68191,1,1,238473,238474,238475,1,2,0
68192,2,3,238475,238475,238478,0,3,0
68193,4,2,238479,238479,238481,0,2,1
68194,2,1,238481,238481,238482,0,1,0
68195,2,3,238483,238483,238486,0,3,1
68196,4,3,238487,238487,238490,0,3,1
68197,2,3,238489,238490,238493,1,4,0
68198,3,3,238492,238493,238496,1,4,0
68199,3,3,238495,238496,238499,1,4,0
68200,2,1,238497,238499,238500,2,3,0
68201,3,3,238500,238500,238503,0,3,0
68202,3,2,238503,238503,238505,0,2,0
68203,1,1,238504,238505,238506,1,2,0
68204,4,2,238508,238508,238510,0,2,2
68205,1,2,238509,238510,238512,1,3,0
68206,2,1,238511,238512,238513,1,2,0
68207,1,2,238512,238513,238515,1,3,0
68208,4,1,238516,238516,238517,0,1,1
68209,4,3,238520,238520,238523,0,3,3
68210,3,1,238523,238523,238524,0,1,0
68211,1,3,238524,238524,238527,0,3,0
68212,4,1,238528,238528,238529,0,1,1
68213,5,1,238533,238533,238534,0,1,4
68214,3,3,238536,238536,238539,0,3,2
68215,3,1,238539,238539,238540,0,1,0
68216,3,2,238542,238542,238544,0,2,2
68217,4,1,238546,238546,238547,0,1,2
68218,4,2,238550,238550,238552,0,2,3
68219,3,3,238553,238553,238556,0,3,1
68220,4,1,238557,238557,238558,0,1,1
68221,4,1,238561,238561,238562,0,1,3
68222,4,1,238565,238565,238566,0,1,3
68223,5,2,238570,238570,238572,0,2,4
68224,5,1,238575,238575,238576,0,1,3
68225,1,2,238576,238576,238578,0,2,0
68226,5,2,238581,238581,238583,0,2,3
68227,6,2,238587,238587,238589,0,2,4
68228,6,1,238593,238593,238594,0,1,4
68229,3,1,238596,238596,238597,0,1,2
68230,5,1,238601,238601,238602,0,1,4
68231,6,3,238607,238607,238610,0,3,5
68232,3,3,238610,238610,238613,0,3,0
68233,1,2,238611,238613,238615,2,4,0
68234,2,3,238613,238615,238618,2,5,0
68235,4,1,238617,238618,238619,1,2,0
68236,5,1,238622,238622,238623,0,1,3
68237,1,3,238623,238623,238626,0,3,0
68238,3,1,238626,238626,238627,0,1,0
68239,2,2,238628,238628,238630,0,2,1
68240,2,1,238630,238630,238631,0,1,0
68241,3,2,238633,238633,238635,0,2,2
68242,5,3,238638,238638,238641,0,3,3
68243,5,2,238643,238643,238645,0,2,2
68244,6,2,238649,238649,238651,0,2,4
68245,6,1,238655,238655,238656,0,1,4
68246,4,1,238659,238659,238660,0,1,3
68247,6,3,238665,238665,238668,0,3,5
68248,1,2,238666,238668,238670,2,4,0
68249,2,2,238668,238670,238672,2,4,0
68250,5,1,238673,238673,238674,0,1,1
68251,4,1,238677,238677,238678,0,1,3
68252,6,1,238683,238683,238684,0,1,5
68253,4,1,238687,238687,238688,0,1,3
68254,5,2,238692,238692,238694,0,2,4
68255,4,3,238696,238696,238699,0,3,2
68256,4,3,238700,238700,238703,0,3,1
68257,2,2,238702,238703,238705,1,3,0
68258,4,1,238706,238706,238707,0,1,1
68259,1,2,238707,238707,238709,0,2,0
68260,2,2,238709,238709,238711,0,2,0
68261,5,2,238714,238714,238716,0,2,3
68262,2,3,238716,238716,238719,0,3,0
68263,5,1,238721,238721,238722,0,1,2
68264,6,2,238727,238727,238729,0,2,5
68265,4,3,238731,238731,238734,0,3,2
68266,2,3,238733,238734,238737,1,4,0
68267,6,3,238739,238739,238742,0,3,2
68268,6,2,238745,238745,238747,0,2,3
68269,4,2,238749,238749,238751,0,2,2
68270,2,3,238751,238751,238754,0,3,0
68271,1,3,238752,238754,238757,2,5,0
68272,6,2,238758,238758,238760,0,2,1
68273,4,2,238762,238762,238764,0,2,2
68274,5,3,238767,238767,238770,0,3,3
68275,4,3,238771,238771,238774,0,3,1
68276,2,2,238773,238774,238776,1,3,0
68277,6,3,238779,238779,238782,0,3,3
68278,6,3,238785,238785,238788,0,3,3
68279,1,2,238786,238788,238790,2,4,0
68280,2,2,238788,238790,238792,2,4,0
68281,3,3,238791,238792,238795,1,4,0
68282,2,2,238793,238795,238797,2,4,0
68283,5,3,238798,238798,238801,0,3,1
68284,5,1,238803,238803,238804,0,1,2
68285,2,3,238805,238805,238808,0,3,1
68286,1,2,238806,238808,238810,2,4,0
68287,4,2,238810,238810,238812,0,2,0
68288,4,3,238814,238814,238817,0,3,2
68289,2,3,238816,238817,238820,1,4,0
68290,5,1,238821,238821,238822,0,1,1
68291,4,2,238825,238825,238827,0,2,3
68292,2,1,238827,238827,238828,0,1,0
68293,4,2,238831,238831,238833,0,2,3
68294,1,1,238832,238833,238834,1,2,0
68295,2,1,238834,238834,238835,0,1,0
68296,5,1,238839,238839,238840,0,1,4
68297,2,1,238841,238841,238842,0,1,1
68298,1,1,238842,238842,238843,0,1,0
68299,2,2,238844,238844,238846,0,2,1
68300,4,1,238848,238848,238849,0,1,2
68301,6,1,238854,238854,238855,0,1,5
68302,4,2,238858,238858,238860,0,2,3
68303,5,3,238863,238863,238866,0,3,3
68304,3,3,238866,238866,238869,0,3,0
68305,6,3,238872,238872,238875,0,3,3
68306,3,2,238875,238875,238877,0,2,0
68307,3,3,238878,238878,238881,0,3,1
68308,3,1,238881,238881,238882,0,1,0
68309,1,1,238882,238882,238883,0,1,0
68310,1,3,238883,238883,238886,0,3,0
68311,1,2,238884,238886,238888,2,4,0
68312,3,2,238887,238888,238890,1,3,0
68313,3,3,238890,238890,238893,0,3,0
68314,5,3,238895,238895,238898,0,3,2
68315,4,3,238899,238899,238902,0,3,1
68316,6,1,238905,238905,238906,0,1,3
68317,3,1,238908,238908,238909,0,1,2
68318,2,1,238910,238910,238911,0,1,1
68319,4,3,238914,238914,238917,0,3,3
68320,3,1,238917,238917,238918,0,1,0
68321,2,1,238919,238919,238920,0,1,1
68322,5,3,238924,238924,238927,0,3,4
68323,2,1,238926,238927,238928,1,2,0
68324,1,2,238927,238928,238930,1,3,0
68325,2,1,238929,238930,238931,1,2,0
68326,4,1,238933,238933,238934,0,1,2
68327,6,2,238939,238939,238941,0,2,5
68328,4,2,238943,238943,238945,0,2,2
68329,5,1,238948,238948,238949,0,1,3
68330,1,1,238949,238949,238950,0,1,0
68331,6,1,238955,238955,238956,0,1,5
68332,1,1,238956,238956,238957,0,1,0
68333,1,2,238957,238957,238959,0,2,0
68334,4,3,238961,238961,238964,0,3,2
68335,2,3,238963,238964,238967,1,4,0
68336,3,3,238966,238967,238970,1,4,0
68337,5,3,238971,238971,238974,0,3,1
68338,5,1,238976,238976,238977,0,1,2
68339,2,1,238978,238978,238979,0,1,1
68340,6,3,238984,238984,238987,0,3,5
68341,2,3,238986,238987,238990,1,4,0
68342,4,1,238990,238990,238991,0,1,0
68343,1,1,238991,238991,238992,0,1,0
68344,2,1,238993,238993,238994,0,1,1
68345,3,2,238996,238996,238998,0,2,2
68346,5,2,239001,239001,239003,0,2,3
68347,6,3,239007,239007,239010,0,3,4
68348,5,2,239012,239012,239014,0,2,2
68349,1,1,239013,239014,239015,1,2,0
68350,1,3,239014,239015,239018,1,4,0
68351,3,1,239017,239018,239019,1,2,0
68352,5,3,239022,239022,239025,0,3,3
68353,4,2,239026,239026,239028,0,2,1
68354,4,3,239030,239030,239033,0,3,2
68355,4,2,239034,239034,239036,0,2,1
68356,1,3,239035,239036,239039,1,4,0
68357,5,3,239040,239040,239043,0,3,1
68358,1,1,239041,239043,239044,2,3,0
68359,3,2,239044,239044,239046,0,2,0
68360,6,1,239050,239050,239051,0,1,4
68361,2,2,239052,239052,239054,0,2,1
68362,6,2,239058,239058,239060,0,2,4
68363,2,2,239060,239060,239062,0,2,0
68364,6,1,239066,239066,239067,0,1,4
68365,2,3,239068,239068,239071,0,3,1
68366,5,1,239073,239073,239074,0,1,2
68367,2,1,239075,239075,239076,0,1,1
68368,2,1,239077,239077,239078,0,1,1
68369,6,2,239083,239083,239085,0,2,5
68370,4,3,239087,239087,239090,0,3,2
68371,3,1,239090,239090,239091,0,1,0
68372,3,2,239093,239093,239095,0,2,2
68373,6,3,239099,239099,239102,0,3,4
68374,6,2,239105,239105,239107,0,2,3
68375,2,2,239107,239107,239109,0,2,0
68376,4,1,239111,239111,239112,0,1,2
68377,1,3,239112,239112,239115,0,3,0
68378,4,3,239116,239116,239119,0,3,1
68379,5,2,239121,239121,239123,0,2,2
68380,3,2,239124,239124,239126,0,2,1
68381,6,1,239130,239130,239131,0,1,4
68382,2,2,239132,239132,239134,0,2,1
68383,4,1,239136,239136,239137,0,1,2
68384,5,1,239141,239141,239142,0,1,4
68385,1,2,239142,239142,239144,0,2,0
68386,3,1,239145,239145,239146,0,1,1
68387,4,3,239149,239149,239152,0,3,3
68388,6,1,239155,239155,239156,0,1,3
68389,6,1,239161,239161,239162,0,1,5
68390,1,1,239162,239162,239163,0,1,0
68391,6,1,239168,239168,239169,0,1,5
68392,3,1,239171,239171,239172,0,1,2
68393,4,1,239175,239175,239176,0,1,3
68394,3,3,239178,239178,239181,0,3,2
68395,5,3,239183,239183,239186,0,3,2
68396,1,2,239184,239186,239188,2,4,0
68397,1,2,239185,239188,239190,3,5,0
68398,6,3,239191,239191,239194,0,3,1
68399,4,1,239195,239195,239196,0,1,1
68400,1,1,239196,239196,239197,0,1,0
68401,2,1,239198,239198,239199,0,1,1
68402,5,2,239203,239203,239205,0,2,4
68403,2,1,239205,239205,239206,0,1,0
68404,5,1,239210,239210,239211,0,1,4
68405,5,2,239215,239215,239217,0,2,4
68406,6,3,239221,239221,239224,0,3,4
68407,4,3,239225,239225,239228,0,3,1
68408,2,3,239227,239228,239231,1,4,0
68409,6,3,239233,239233,239236,0,3,2
68410,6,1,239239,239239,239240,0,1,3
68411,2,3,239241,239241,239244,0,3,1
68412,4,3,239245,239245,239248,0,3,1
68413,1,3,239246,239248,239251,2,5,0
68414,6,2,239252,239252,239254,0,2,1
68415,2,1,239254,239254,239255,0,1,0
68416,3,3,239257,239257,239260,0,3,2
68417,1,3,239258,239260,239263,2,5,0
68418,4,1,239262,239263,239264,1,2,0
68419,5,1,239267,239267,239268,0,1,3
68420,1,3,239268,239268,239271,0,3,0
68421,3,3,239271,239271,239274,0,3,0
68422,1,2,239272,239274,239276,2,4,0
68423,3,3,239275,239276,239279,1,4,0
68424,2,3,239277,239279,239282,2,5,0
68425,5,2,239282,239282,239284,0,2,0
68426,3,1,239285,239285,239286,0,1,1
68427,2,2,239287,239287,239289,0,2,1
68428,3,1,239290,239290,239291,0,1,1
68429,1,3,239291,239291,239294,0,3,0
68430,1,2,239292,239294,239296,2,4,0
68431,3,3,239295,239296,239299,1,4,0
68432,5,2,239300,239300,239302,0,2,1
68433,5,3,239305,239305,239308,0,3,3
68434,1,2,239306,239308,239310,2,4,0
68435,4,3,239310,239310,239313,0,3,0
68436,3,2,239313,239313,239315,0,2,0
68437,6,3,239319,239319,239322,0,3,4
68438,3,1,239322,239322,239323,0,1,0
68439,4,3,239326,239326,239329,0,3,3
68440,3,3,239329,239329,239332,0,3,0
68441,5,1,239334,239334,239335,0,1,2
68442,4,1,239338,239338,239339,0,1,3
68443,1,2,239339,239339,239341,0,2,0
68444,3,2,239342,239342,239344,0,2,1
68445,4,3,239346,239346,239349,0,3,2
68446,5,3,239351,239351,239354,0,3,2
68447,3,1,239354,239354,239355,0,1,0
68448,2,1,239356,239356,239357,0,1,1
68449,6,3,239362,239362,239365,0,3,5
68450,6,1,239368,239368,239369,0,1,3
68451,5,3,239373,239373,239376,0,3,4
68452,6,3,239379,239379,239382,0,3,3
68453,6,2,239385,239385,239387,0,2,3
68454,6,1,239391,239391,239392,0,1,4
68455,3,1,239394,239394,239395,0,1,2
68456,2,1,239396,239396,239397,0,1,1
68457,3,2,239399,239399,239401,0,2,2
68458,6,1,239405,239405,239406,0,1,4
68459,1,2,239406,239406,239408,0,2,0
68460,2,2,239408,239408,239410,0,2,0
68461,4,2,239412,239412,239414,0,2,2
68462,1,2,239413,239414,239416,1,3,0
68463,4,1,239417,239417,239418,0,1,1
68464,4,3,239421,239421,239424,0,3,3
68465,5,1,239426,239426,239427,0,1,2
68466,6,2,239432,239432,239434,0,2,5
68467,2,1,239434,239434,239435,0,1,0
68468,4,2,239438,239438,239440,0,2,3
68469,6,1,239444,239444,239445,0,1,4
68470,4,1,239448,239448,239449,0,1,3
68471,3,1,239451,239451,239452,0,1,2
68472,6,2,239457,239457,239459,0,2,5
68473,1,1,239458,239459,239460,1,2,0
68474,3,2,239461,239461,239463,0,2,1
68475,4,1,239465,239465,239466,0,1,2
68476,4,1,239469,239469,239470,0,1,3
68477,6,1,239475,239475,239476,0,1,5
68478,2,1,239477,239477,239478,0,1,1
68479,6,1,239483,239483,239484,0,1,5
68480,5,1,239488,239488,239489,0,1,4
68481,6,1,239494,239494,239495,0,1,5
68482,1,1,239495,239495,239496,0,1,0
68483,6,3,239501,239501,239504,0,3,5
68484,5,1,239506,239506,239507,0,1,2
68485,1,2,239507,239507,239509,0,2,0
68486,2,2,239509,239509,239511,0,2,0
68487,5,1,239514,239514,239515,0,1,3
68488,3,2,239517,239517,239519,0,2,2
68489,4,2,239521,239521,239523,0,2,2
68490,6,3,239527,239527,239530,0,3,4
68491,3,2,239530,239530,239532,0,2,0
68492,2,3,239532,239532,239535,0,3,0
68493,2,2,239534,239535,239537,1,3,0
68494,2,3,239536,239537,239540,1,4,0
68495,4,3,239540,239540,239543,0,3,0
68496,1,3,239541,239543,239546,2,5,0
68497,5,3,239546,239546,239549,0,3,0
68498,5,2,239551,239551,239553,0,2,2
68499,3,2,239554,239554,239556,0,2,1
68500,6,2,239560,239560,239562,0,2,4
68501,4,2,239564,239564,239566,0,2,2
68502,5,3,239569,239569,239572,0,3,3
68503,1,2,239570,239572,239574,2,4,0
68504,1,1,239571,239574,239575,3,4,0
68505,3,3,239574,239575,239578,1,4,0
68506,3,3,239577,239578,239581,1,4,0
68507,2,1,239579,239581,239582,2,3,0
68508,5,2,239584,239584,239586,0,2,2
68509,2,1,239586,239586,239587,0,1,0
68510,4,2,239590,239590,239592,0,2,3
68511,6,1,239596,239596,239597,0,1,4
68512,1,1,239597,239597,239598,0,1,0
68513,5,1,239602,239602,239603,0,1,4
68514,3,1,239605,239605,239606,0,1,2
68515,1,2,239606,239606,239608,0,2,0
68516,6,2,239612,239612,239614,0,2,4
68517,4,3,239616,239616,239619,0,3,2
68518,3,3,239619,239619,239622,0,3,0
68519,4,1,239623,239623,239624,0,1,1
68520,1,1,239624,239624,239625,0,1,0
68521,5,3,239629,239629,239632,0,3,4
68522,6,3,239635,239635,239638,0,3,3
68523,5,3,239640,239640,239643,0,3,2
68524,4,3,239644,239644,239647,0,3,1
68525,4,1,239648,239648,239649,0,1,1
68526,5,3,239653,239653,239656,0,3,4
68527,3,1,239656,239656,239657,0,1,0
68528,3,2,239659,239659,239661,0,2,2
68529,4,2,239663,239663,239665,0,2,2
68530,1,3,239664,239665,239668,1,4,0
68531,5,2,239669,239669,239671,0,2,1
68532,3,1,239672,239672,239673,0,1,1
68533,4,2,239676,239676,239678,0,2,3
68534,4,3,239680,239680,239683,0,3,2
68535,5,2,239685,239685,239687,0,2,2
68536,6,2,239691,239691,239693,0,2,4
68537,4,1,239695,239695,239696,0,1,2
68538,1,1,239696,239696,239697,0,1,0
68539,5,1,239701,239701,239702,0,1,4
68540,1,1,239702,239702,239703,0,1,0
68541,5,3,239707,239707,239710,0,3,4
68542,6,1,239713,239713,239714,0,1,3
68543,6,3,239719,239719,239722,0,3,5
68544,5,2,239724,239724,239726,0,2,2
68545,4,2,239728,239728,239730,0,2,2
68546,5,1,239733,239733,239734,0,1,3
68547,5,3,239738,239738,239741,0,3,4
68548,3,2,239741,239741,239743,0,2,0
68549,1,1,239742,239743,239744,1,2,0
68550,3,3,239745,239745,239748,0,3,1
68551,4,1,239749,239749,239750,0,1,1
68552,2,3,239751,239751,239754,0,3,1
68553,3,3,239754,239754,239757,0,3,0
68554,4,2,239758,239758,239760,0,2,1
68555,6,2,239764,239764,239766,0,2,4
68556,1,3,239765,239766,239769,1,4,0
68557,5,1,239770,239770,239771,0,1,1
68558,1,3,239771,239771,239774,0,3,0
68559,5,2,239776,239776,239778,0,2,2
68560,1,1,239777,239778,239779,1,2,0
68561,4,3,239781,239781,239784,0,3,2
68562,4,3,239785,239785,239788,0,3,1
68563,1,3,239786,239788,239791,2,5,0
68564,1,3,239787,239791,239794,4,7,0
68565,4,1,239791,239794,239795,3,4,0
68566,6,3,239797,239797,239800,0,3,2
68567,5,3,239802,239802,239805,0,3,2
68568,1,2,239803,239805,239807,2,4,0
68569,6,3,239809,239809,239812,0,3,2
68570,1,2,239810,239812,239814,2,4,0
68571,5,2,239815,239815,239817,0,2,1
68572,6,3,239821,239821,239824,0,3,4
68573,4,2,239825,239825,239827,0,2,1
68574,6,1,239831,239831,239832,0,1,4
68575,2,1,239833,239833,239834,0,1,1
68576,4,3,239837,239837,239840,0,3,3
68577,6,3,239843,239843,239846,0,3,3
68578,6,2,239849,239849,239851,0,2,3
68579,6,3,239855,239855,239858,0,3,4
68580,4,1,239859,239859,239860,0,1,1
68581,2,2,239861,239861,239863,0,2,1
68582,3,3,239864,239864,239867,0,3,1
68583,3,2,239867,239867,239869,0,2,0
68584,2,3,239869,239869,239872,0,3,0
68585,2,3,239871,239872,239875,1,4,0
68586,2,1,239873,239875,239876,2,3,0
68587,2,1,239875,239876,239877,1,2,0
68588,1,2,239876,239877,239879,1,3,0
68589,1,2,239877,239879,239881,2,4,0
68590,2,2,239879,239881,239883,2,4,0
68591,1,3,239880,239883,239886,3,6,0
68592,2,2,239882,239886,239888,4,6,0
68593,4,2,239886,239888,239890,2,4,0
68594,5,2,239891,239891,239893,0,2,1
68595,5,1,239896,239896,239897,0,1,3
68596,2,1,239898,239898,239899,0,1,1
68597,3,1,239901,239901,239902,0,1,2
68598,3,2,239904,239904,239906,0,2,2
68599,2,2,239906,239906,239908,0,2,0
68600,3,2,239909,239909,239911,0,2,1
68601,2,1,239911,239911,239912,0,1,0
68602,5,1,239916,239916,239917,0,1,4
68603,5,3,239921,239921,239924,0,3,4
68604,3,2,239924,239924,239926,0,2,0
68605,6,3,239930,239930,239933,0,3,4
68606,5,3,239935,239935,239938,0,3,2
68607,4,1,239939,239939,239940,0,1,1
68608,1,3,239940,239940,239943,0,3,0
68609,6,3,239946,239946,239949,0,3,3
68610,3,2,239949,239949,239951,0,2,0
68611,4,2,239953,239953,239955,0,2,2
68612,4,2,239957,239957,239959,0,2,2
68613,1,2,239958,239959,239961,1,3,0
68614,2,3,239960,239961,239964,1,4,0
68615,5,1,239965,239965,239966,0,1,1
68616,6,3,239971,239971,239974,0,3,5
68617,5,3,239976,239976,239979,0,3,2
68618,6,3,239982,239982,239985,0,3,3
68619,4,1,239986,239986,239987,0,1,1
68620,5,3,239991,239991,239994,0,3,4
68621,6,3,239997,239997,240000,0,3,3
68622,4,3,240001,240001,240004,0,3,1
68623,5,2,240006,240006,240008,0,2,2
68624,6,2,240012,240012,240014,0,2,4
68625,1,1,240013,240014,240015,1,2,0
68626,1,2,240014,240015,240017,1,3,0
68627,5,2,240019,240019,240021,0,2,2
68628,6,3,240025,240025,240028,0,3,4
68629,5,1,240030,240030,240031,0,1,2
68630,2,2,240032,240032,240034,0,2,1
68631,1,3,240033,240034,240037,1,4,0
68632,5,3,240038,240038,240041,0,3,1
68633,3,1,240041,240041,240042,0,1,0
68634,1,1,240042,240042,240043,0,1,0
68635,3,2,240045,240045,240047,0,2,2
68636,2,1,240047,240047,240048,0,1,0
68637,2,2,240049,240049,240051,0,2,1
68638,5,2,240054,240054,240056,0,2,3
68639,4,3,240058,240058,240061,0,3,2
68640,6,1,240064,240064,240065,0,1,3
68641,4,2,240068,240068,240070,0,2,3
68642,5,1,240073,240073,240074,0,1,3
68643,4,2,240077,240077,240079,0,2,3
68644,1,1,240078,240079,240080,1,2,0
68645,1,3,240079,240080,240083,1,4,0
68646,2,3,240081,240083,240086,2,5,0
68647,3,3,240084,240086,240089,2,5,0
68648,5,1,240089,240089,240090,0,1,0
68649,3,3,240092,240092,240095,0,3,2
68650,1,1,240093,240095,240096,2,3,0
68651,5,2,240098,240098,240100,0,2,2
68652,6,2,240104,240104,240106,0,2,4
68653,2,2,240106,240106,240108,0,2,0
68654,1,1,240107,240108,240109,1,2,0
68655,2,2,240109,240109,240111,0,2,0
68656,4,1,240113,240113,240114,0,1,2
68657,1,1,240114,240114,240115,0,1,0
68658,6,1,240120,240120,240121,0,1,5
68659,1,2,240121,240121,240123,0,2,0
68660,2,2,240123,240123,240125,0,2,0
68661,4,2,240127,240127,240129,0,2,2
68662,5,1,240132,240132,240133,0,1,3
68663,2,3,240134,240134,240137,0,3,1
68664,4,1,240138,240138,240139,0,1,1
68665,5,1,240143,240143,240144,0,1,4
68666,5,3,240148,240148,240151,0,3,4
68667,6,1,240154,240154,240155,0,1,3
68668,1,3,240155,240155,240158,0,3,0
68669,1,1,240156,240158,240159,2,3,0
68670,6,3,240162,240162,240165,0,3,3
68671,2,1,240164,240165,240166,1,2,0
68672,2,1,240166,240166,240167,0,1,0
68673,6,2,240172,240172,240174,0,2,5
68674,1,1,240173,240174,240175,1,2,0
68675,1,1,240174,240175,240176,1,2,0
68676,5,1,240179,240179,240180,0,1,3
68677,3,3,240182,240182,240185,0,3,2
68678,2,2,240184,240185,240187,1,3,0
68679,6,2,240190,240190,240192,0,2,3
68680,1,3,240191,240192,240195,1,4,0
68681,2,3,240193,240195,240198,2,5,0
68682,3,1,240196,240198,240199,2,3,0
68683,5,3,240201,240201,240204,0,3,2
68684,5,3,240206,240206,240209,0,3,2
68685,2,3,240208,240209,240212,1,4,0
68686,4,1,240212,240212,240213,0,1,0
68687,1,3,240213,240213,240216,0,3,0
68688,4,1,240217,240217,240218,0,1,1
68689,4,2,240221,240221,240223,0,2,3
68690,6,1,240227,240227,240228,0,1,4
68691,2,1,240229,240229,240230,0,1,1
68692,1,1,240230,240230,240231,0,1,0
68693,5,3,240235,240235,240238,0,3,4
68694,1,3,240236,240238,240241,2,5,0
68695,6,1,240242,240242,240243,0,1,1
68696,3,2,240245,240245,240247,0,2,2
68697,5,1,240250,240250,240251,0,1,3
68698,5,3,240255,240255,240258,0,3,4
68699,1,1,240256,240258,240259,2,3,0
68700,3,3,240259,240259,240262,0,3,0
68701,2,1,240261,240262,240263,1,2,0
68702,5,3,240266,240266,240269,0,3,3
68703,4,2,240270,240270,240272,0,2,1
68704,6,3,240276,240276,240279,0,3,4
68705,5,1,240281,240281,240282,0,1,2
68706,1,1,240282,240282,240283,0,1,0
68707,5,2,240287,240287,240289,0,2,4
68708,2,3,240289,240289,240292,0,3,0
68709,3,2,240292,240292,240294,0,2,0
68710,5,2,240297,240297,240299,0,2,3
68711,6,1,240303,240303,240304,0,1,4
68712,4,1,240307,240307,240308,0,1,3
68713,6,2,240313,240313,240315,0,2,5
68714,1,3,240314,240315,240318,1,4,0
68715,5,1,240319,240319,240320,0,1,1
68716,1,3,240320,240320,240323,0,3,0
68717,5,2,240325,240325,240327,0,2,2
68718,6,3,240331,240331,240334,0,3,4
68719,2,1,240333,240334,240335,1,2,0
68720,2,2,240335,240335,240337,0,2,0
68721,4,1,240339,240339,240340,0,1,2
68722,4,1,240343,240343,240344,0,1,3
68723,2,3,240345,240345,240348,0,3,1
68724,4,1,240349,240349,240350,0,1,1
68725,6,3,240355,240355,240358,0,3,5
68726,1,1,240356,240358,240359,2,3,0
68727,1,3,240357,240359,240362,2,5,0
68728,4,3,240361,240362,240365,1,4,0
68729,1,2,240362,240365,240367,3,5,0
68730,6,2,240368,240368,240370,0,2,1
68731,3,1,240371,240371,240372,0,1,1
68732,1,3,240372,240372,240375,0,3,0
68733,6,2,240378,240378,240380,0,2,3
68734,6,1,240384,240384,240385,0,1,4
68735,3,1,240387,240387,240388,0,1,2
68736,3,2,240390,240390,240392,0,2,2
68737,3,1,240393,240393,240394,0,1,1
68738,4,1,240397,240397,240398,0,1,3
68739,5,1,240402,240402,240403,0,1,4
68740,1,3,240403,240403,240406,0,3,0
68741,6,3,240409,240409,240412,0,3,3
68742,3,2,240412,240412,240414,0,2,0
68743,1,2,240413,240414,240416,1,3,0
68744,4,3,240417,240417,240420,0,3,1
68745,3,3,240420,240420,240423,0,3,0
68746,1,3,240421,240423,240426,2,5,0
68747,2,3,240423,240426,240429,3,6,0
68748,4,1,240427,240429,240430,2,3,0
68749,1,3,240428,240430,240433,2,5,0
68750,4,1,240432,240433,240434,1,2,0
68751,4,1,240436,240436,240437,0,1,2
68752,4,2,240440,240440,240442,0,2,3
68753,5,1,240445,240445,240446,0,1,3
68754,1,2,240446,240446,240448,0,2,0
68755,4,1,240450,240450,240451,0,1,2
68756,4,3,240454,240454,240457,0,3,3
68757,6,1,240460,240460,240461,0,1,3
68758,3,2,240463,240463,240465,0,2,2
68759,5,2,240468,240468,240470,0,2,3
68760,3,1,240471,240471,240472,0,1,1
68761,4,2,240475,240475,240477,0,2,3
68762,6,2,240481,240481,240483,0,2,4
68763,1,1,240482,240483,240484,1,2,0
68764,4,3,240486,240486,240489,0,3,2
68765,5,1,240491,240491,240492,0,1,2
68766,6,1,240497,240497,240498,0,1,5
68767,2,2,240499,240499,240501,0,2,1
68768,2,3,240501,240501,240504,0,3,0
68769,3,1,240504,240504,240505,0,1,0
68770,3,3,240507,240507,240510,0,3,2
68771,4,2,240511,240511,240513,0,2,1
68772,1,1,240512,240513,240514,1,2,0
68773,2,3,240514,240514,240517,0,3,0
68774,2,3,240516,240517,240520,1,4,0
68775,1,1,240517,240520,240521,3,4,0
68776,5,1,240522,240522,240523,0,1,1
68777,2,3,240524,240524,240527,0,3,1
68778,3,1,240527,240527,240528,0,1,0
68779,6,1,240533,240533,240534,0,1,5
68780,2,2,240535,240535,240537,0,2,1
68781,1,3,240536,240537,240540,1,4,0
68782,4,2,240540,240540,240542,0,2,0
68783,2,3,240542,240542,240545,0,3,0
68784,1,1,240543,240545,240546,2,3,0
68785,4,1,240547,240547,240548,0,1,1
68786,6,2,240553,240553,240555,0,2,5
68787,2,2,240555,240555,240557,0,2,0
68788,4,3,240559,240559,240562,0,3,2
68789,5,3,240564,240564,240567,0,3,2
68790,2,1,240566,240567,240568,1,2,0
68791,4,1,240570,240570,240571,0,1,2
68792,5,1,240575,240575,240576,0,1,4
68793,3,2,240578,240578,240580,0,2,2
68794,4,1,240582,240582,240583,0,1,2
68795,1,2,240583,240583,240585,0,2,0
68796,2,1,240585,240585,240586,0,1,0
68797,4,1,240589,240589,240590,0,1,3
68798,2,2,240591,240591,240593,0,2,1
68799,1,2,240592,240593,240595,1,3,0
68800,6,3,240598,240598,240601,0,3,3
68801,3,1,240601,240601,240602,0,1,0
68802,1,1,240602,240602,240603,0,1,0
68803,6,1,240608,240608,240609,0,1,5
68804,5,2,240613,240613,240615,0,2,4
68805,1,1,240614,240615,240616,1,2,0
68806,2,3,240616,240616,240619,0,3,0
68807,1,3,240617,240619,240622,2,5,0
68808,4,3,240621,240622,240625,1,4,0
68809,1,1,240622,240625,240626,3,4,0
68810,2,2,240624,240626,240628,2,4,0
68811,6,3,240630,240630,240633,0,3,2
68812,4,1,240634,240634,240635,0,1,1
68813,4,3,240638,240638,240641,0,3,3
68814,1,1,240639,240641,240642,2,3,0
68815,5,1,240644,240644,240645,0,1,2
68816,2,3,240646,240646,240649,0,3,1
68817,5,1,240651,240651,240652,0,1,2
68818,3,3,240654,240654,240657,0,3,2
68819,3,1,240657,240657,240658,0,1,0
68820,3,1,240660,240660,240661,0,1,2
68821,4,1,240664,240664,240665,0,1,3
68822,1,3,240665,240665,240668,0,3,0
68823,5,3,240670,240670,240673,0,3,2
68824,1,3,240671,240673,240676,2,5,0
68825,1,2,240672,240676,240678,4,6,0
68826,6,1,240678,240678,240679,0,1,0
68827,2,1,240680,240680,240681,0,1,1
68828,6,2,240686,240686,240688,0,2,5
68829,2,1,240688,240688,240689,0,1,0
68830,3,2,240691,240691,240693,0,2,2
68831,1,3,240692,240693,240696,1,4,0
68832,2,2,240694,240696,240698,2,4,0
68833,5,2,240699,240699,240701,0,2,1
68834,2,2,240701,240701,240703,0,2,0
68835,3,1,240704,240704,240705,0,1,1
68836,2,3,240706,240706,240709,0,3,1
68837,1,1,240707,240709,240710,2,3,0
68838,5,1,240712,240712,240713,0,1,2
68839,4,2,240716,240716,240718,0,2,3
68840,1,3,240717,240718,240721,1,4,0
68841,6,2,240723,240723,240725,0,2,2
68842,4,3,240727,240727,240730,0,3,2
68843,5,1,240732,240732,240733,0,1,2
68844,1,2,240733,240733,240735,0,2,0
68845,6,1,240739,240739,240740,0,1,4
68846,1,2,240740,240740,240742,0,2,0
68847,2,3,240742,240742,240745,0,3,0
68848,3,3,240745,240745,240748,0,3,0
68849,6,2,240751,240751,240753,0,2,3
68850,6,1,240757,240757,240758,0,1,4
68851,3,1,240760,240760,240761,0,1,2
68852,3,1,240763,240763,240764,0,1,2
68853,6,1,240769,240769,240770,0,1,5
68854,2,3,240771,240771,240774,0,3,1
68855,2,3,240773,240774,240777,1,4,0
68856,4,3,240777,240777,240780,0,3,0
68857,1,1,240778,240780,240781,2,3,0
68858,4,1,240782,240782,240783,0,1,1
68859,6,1,240788,240788,240789,0,1,5
68860,6,3,240794,240794,240797,0,3,5
68861,3,2,240797,240797,240799,0,2,0
68862,5,2,240802,240802,240804,0,2,3
68863,3,3,240805,240805,240808,0,3,1
68864,1,1,240806,240808,240809,2,3,0
68865,3,1,240809,240809,240810,0,1,0
68866,3,1,240812,240812,240813,0,1,2
68867,3,1,240815,240815,240816,0,1,2
68868,1,3,240816,240816,240819,0,3,0
68869,5,1,240821,240821,240822,0,1,2
68870,4,1,240825,240825,240826,0,1,3
68871,6,1,240831,240831,240832,0,1,5
68872,1,3,240832,240832,240835,0,3,0
68873,1,1,240833,240835,240836,2,3,0
68874,4,2,240837,240837,240839,0,2,1
68875,5,2,240842,240842,240844,0,2,3
68876,5,3,240847,240847,240850,0,3,3
68877,6,1,240853,240853,240854,0,1,3
68878,1,1,240854,240854,240855,0,1,0
68879,4,2,240858,240858,240860,0,2,3
68880,2,2,240860,240860,240862,0,2,0
68881,2,1,240862,240862,240863,0,1,0
68882,5,1,240867,240867,240868,0,1,4
68883,5,3,240872,240872,240875,0,3,4
68884,4,1,240876,240876,240877,0,1,1
68885,5,2,240881,240881,240883,0,2,4
68886,5,1,240886,240886,240887,0,1,3
68887,3,3,240889,240889,240892,0,3,2
68888,4,3,240893,240893,240896,0,3,1
68889,4,2,240897,240897,240899,0,2,1
68890,2,1,240899,240899,240900,0,1,0
68891,4,1,240903,240903,240904,0,1,3
68892,3,1,240906,240906,240907,0,1,2
68893,5,2,240911,240911,240913,0,2,4
68894,3,3,240914,240914,240917,0,3,1
68895,3,3,240917,240917,240920,0,3,0
68896,2,3,240919,240920,240923,1,4,0
68897,5,3,240924,240924,240927,0,3,1
68898,6,1,240930,240930,240931,0,1,3
68899,4,2,240934,240934,240936,0,2,3
68900,6,3,240940,240940,240943,0,3,4
68901,1,3,240941,240943,240946,2,5,0
68902,5,2,240946,240946,240948,0,2,0
68903,1,1,240947,240948,240949,1,2,0
68904,5,1,240952,240952,240953,0,1,3
68905,6,3,240958,240958,240961,0,3,5
68906,4,3,240962,240962,240965,0,3,1
68907,2,2,240964,240965,240967,1,3,0
68908,5,2,240969,240969,240971,0,2,2
68909,1,1,240970,240971,240972,1,2,0
68910,5,1,240975,240975,240976,0,1,3
68911,2,1,240977,240977,240978,0,1,1
68912,3,2,240980,240980,240982,0,2,2
68913,5,2,240985,240985,240987,0,2,3
68914,2,3,240987,240987,240990,0,3,0
68915,6,1,240993,240993,240994,0,1,3
68916,1,1,240994,240994,240995,0,1,0
68917,5,2,240999,240999,241001,0,2,4
68918,5,2,241004,241004,241006,0,2,3
68919,5,3,241009,241009,241012,0,3,3
68920,6,3,241015,241015,241018,0,3,3
68921,1,3,241016,241018,241021,2,5,0
68922,3,2,241019,241021,241023,2,4,0
68923,2,1,241021,241023,241024,2,3,0
68924,4,1,241025,241025,241026,0,1,1
68925,1,2,241026,241026,241028,0,2,0
68926,1,2,241027,241028,241030,1,3,0
68927,4,1,241031,241031,241032,0,1,1
68928,6,2,241037,241037,241039,0,2,5
68929,5,2,241042,241042,241044,0,2,3
68930,3,3,241045,241045,241048,0,3,1
68931,5,3,241050,241050,241053,0,3,2
68932,5,1,241055,241055,241056,0,1,2
68933,1,1,241056,241056,241057,0,1,0
68934,1,3,241057,241057,241060,0,3,0
68935,3,1,241060,241060,241061,0,1,0
68936,3,1,241063,241063,241064,0,1,2
68937,4,1,241067,241067,241068,0,1,3
68938,1,1,241068,241068,241069,0,1,0
68939,2,2,241070,241070,241072,0,2,1
68940,1,3,241071,241072,241075,1,4,0
68941,6,3,241077,241077,241080,0,3,2
68942,5,1,241082,241082,241083,0,1,2
68943,1,2,241083,241083,241085,0,2,0
68944,5,2,241088,241088,241090,0,2,3
68945,3,2,241091,241091,241093,0,2,1
68946,4,2,241095,241095,241097,0,2,2
68947,3,1,241098,241098,241099,0,1,1
68948,6,3,241104,241104,241107,0,3,5
68949,5,2,241109,241109,241111,0,2,2
68950,3,2,241112,241112,241114,0,2,1
68951,6,1,241118,241118,241119,0,1,4
68952,5,1,241123,241123,241124,0,1,4
68953,5,2,241128,241128,241130,0,2,4
68954,1,3,241129,241130,241133,1,4,0
68955,4,2,241133,241133,241135,0,2,0
68956,4,1,241137,241137,241138,0,1,2
68957,2,2,241139,241139,241141,0,2,1
68958,3,3,241142,241142,241145,0,3,1
68959,3,3,241145,241145,241148,0,3,0
68960,6,1,241151,241151,241152,0,1,3
68961,2,1,241153,241153,241154,0,1,1
68962,6,1,241159,241159,241160,0,1,5
68963,4,3,241163,241163,241166,0,3,3
68964,1,2,241164,241166,241168,2,4,0
68965,6,1,241170,241170,241171,0,1,2
68966,5,1,241175,241175,241176,0,1,4
68967,2,3,241177,241177,241180,0,3,1
68968,4,2,241181,241181,241183,0,2,1
68969,6,2,241187,241187,241189,0,2,4
68970,1,1,241188,241189,241190,1,2,0
68971,1,3,241189,241190,241193,1,4,0
68972,4,3,241193,241193,241196,0,3,0
68973,2,2,241195,241196,241198,1,3,0
68974,1,1,241196,241198,241199,2,3,0
68975,5,3,241201,241201,241204,0,3,2
68976,2,3,241203,241204,241207,1,4,0
68977,5,2,241208,241208,241210,0,2,1
68978,1,3,241209,241210,241213,1,4,0
68979,3,2,241212,241213,241215,1,3,0
68980,4,3,241216,241216,241219,0,3,1
68981,1,1,241217,241219,241220,2,3,0
68982,5,2,241222,241222,241224,0,2,2
68983,6,2,241228,241228,241230,0,2,4
68984,6,2,241234,241234,241236,0,2,4
68985,3,1,241237,241237,241238,0,1,1
68986,3,1,241240,241240,241241,0,1,2
68987,5,1,241245,241245,241246,0,1,4
68988,5,1,241250,241250,241251,0,1,4
68989,5,2,241255,241255,241257,0,2,4
68990,2,2,241257,241257,241259,0,2,0
68991,5,3,241262,241262,241265,0,3,3
68992,3,3,241265,241265,241268,0,3,0
68993,5,3,241270,241270,241273,0,3,2
68994,6,1,241276,241276,241277,0,1,3
68995,3,3,241279,241279,241282,0,3,2
68996,5,2,241284,241284,241286,0,2,2
68997,5,1,241289,241289,241290,0,1,3
68998,2,2,241291,241291,241293,0,2,1
68999,4,1,241295,241295,241296,0,1,2
69000,1,1,241296,241296,241297,0,1,0
69001,4,2,241300,241300,241302,0,2,3
69002,6,2,241306,241306,241308,0,2,4
69003,4,2,241310,241310,241312,0,2,2
69004,3,2,241313,241313,241315,0,2,1
69005,4,3,241317,241317,241320,0,3,2
69006,6,1,241323,241323,241324,0,1,3
69007,2,1,241325,241325,241326,0,1,1
69008,6,2,241331,241331,241333,0,2,5
69009,5,2,241336,241336,241338,0,2,3
69010,1,1,241337,241338,241339,1,2,0
69011,1,1,241338,241339,241340,1,2,0
69012,3,3,241341,241341,241344,0,3,1
69013,5,1,241346,241346,241347,0,1,2
69014,5,3,241351,241351,241354,0,3,4
69015,2,3,241353,241354,241357,1,4,0
69016,2,2,241355,241357,241359,2,4,0
69017,2,3,241357,241359,241362,2,5,0
69018,4,2,241361,241362,241364,1,3,0
69019,6,3,241367,241367,241370,0,3,3
69020,2,1,241369,241370,241371,1,2,0
69021,3,2,241372,241372,241374,0,2,1
69022,1,3,241373,241374,241377,1,4,0
69023,5,3,241378,241378,241381,0,3,1
69024,6,3,241384,241384,241387,0,3,3
69025,3,3,241387,241387,241390,0,3,0
69026,1,3,241388,241390,241393,2,5,0
69027,5,1,241393,241393,241394,0,1,0
69028,4,2,241397,241397,241399,0,2,3
69029,5,1,241402,241402,241403,0,1,3
69030,5,2,241407,241407,241409,0,2,4
69031,2,2,241409,241409,241411,0,2,0
69032,2,3,241411,241411,241414,0,3,0
69033,2,2,241413,241414,241416,1,3,0
69034,6,1,241419,241419,241420,0,1,3
69035,5,2,241424,241424,241426,0,2,4
69036,3,2,241427,241427,241429,0,2,1
69037,2,2,241429,241429,241431,0,2,0
69038,2,3,241431,241431,241434,0,3,0
69039,4,3,241435,241435,241438,0,3,1
69040,1,1,241436,241438,241439,2,3,0
69041,3,2,241439,241439,241441,0,2,0
69042,2,1,241441,241441,241442,0,1,0
69043,6,3,241447,241447,241450,0,3,5
69044,3,1,241450,241450,241451,0,1,0
69045,5,3,241455,241455,241458,0,3,4
69046,5,3,241460,241460,241463,0,3,2
69047,5,3,241465,241465,241468,0,3,2
69048,1,3,241466,241468,241471,2,5,0
69049,1,1,241467,241471,241472,4,5,0
69050,5,2,241472,241472,241474,0,2,0
69051,1,3,241473,241474,241477,1,4,0
69052,1,3,241474,241477,241480,3,6,0
69053,1,1,241475,241480,241481,5,6,0
69054,5,1,241480,241481,241482,1,2,0
69055,4,3,241484,241484,241487,0,3,2
69056,3,3,241487,241487,241490,0,3,0
69057,4,1,241491,241491,241492,0,1,1
69058,6,3,241497,241497,241500,0,3,5
69059,2,2,241499,241500,241502,1,3,0
69060,4,1,241503,241503,241504,0,1,1
69061,5,1,241508,241508,241509,0,1,4
69062,3,2,241511,241511,241513,0,2,2
69063,2,2,241513,241513,241515,0,2,0
69064,4,2,241517,241517,241519,0,2,2
69065,2,3,241519,241519,241522,0,3,0
69066,3,1,241522,241522,241523,0,1,0
69067,5,3,241527,241527,241530,0,3,4
69068,3,1,241530,241530,241531,0,1,0
69069,2,3,241532,241532,241535,0,3,1
69070,4,3,241536,241536,241539,0,3,1
69071,6,1,241542,241542,241543,0,1,3
69072,4,1,241546,241546,241547,0,1,3
69073,5,3,241551,241551,241554,0,3,4
69074,5,3,241556,241556,241559,0,3,2
69075,5,3,241561,241561,241564,0,3,2
69076,2,2,241563,241564,241566,1,3,0
69077,2,1,241565,241566,241567,1,2,0
69078,4,2,241569,241569,241571,0,2,2
69079,1,3,241570,241571,241574,1,4,0
69080,2,3,241572,241574,241577,2,5,0
69081,3,1,241575,241577,241578,2,3,0
69082,3,3,241578,241578,241581,0,3,0
69083,3,2,241581,241581,241583,0,2,0
69084,6,2,241587,241587,241589,0,2,4
69085,6,2,241593,241593,241595,0,2,4
69086,3,1,241596,241596,241597,0,1,1
69087,4,3,241600,241600,241603,0,3,3
69088,2,1,241602,241603,241604,1,2,0
69089,6,1,241608,241608,241609,0,1,4
69090,1,1,241609,241609,241610,0,1,0
69091,4,1,241613,241613,241614,0,1,3
69092,2,3,241615,241615,241618,0,3,1
69093,4,3,241619,241619,241622,0,3,1
69094,6,1,241625,241625,241626,0,1,3
69095,5,2,241630,241630,241632,0,2,4
69096,6,2,241636,241636,241638,0,2,4
69097,6,1,241642,241642,241643,0,1,4
69098,2,2,241644,241644,241646,0,2,1
69099,4,2,241648,241648,241650,0,2,2
69100,3,3,241651,241651,241654,0,3,1
69101,6,2,241657,241657,241659,0,2,3
69102,5,1,241662,241662,241663,0,1,3
69103,3,3,241665,241665,241668,0,3,2
69104,5,2,241670,241670,241672,0,2,2
69105,1,3,241671,241672,241675,1,4,0
69106,4,1,241675,241675,241676,0,1,0
69107,2,3,241677,241677,241680,0,3,1
69108,6,2,241683,241683,241685,0,2,3
69109,1,2,241684,241685,241687,1,3,0
69110,4,2,241688,241688,241690,0,2,1
69111,3,3,241691,241691,241694,0,3,1
69112,4,2,241695,241695,241697,0,2,1
69113,6,3,241701,241701,241704,0,3,4
69114,1,2,241702,241704,241706,2,4,0
69115,1,2,241703,241706,241708,3,5,0
69116,1,1,241704,241708,241709,4,5,0
69117,1,2,241705,241709,241711,4,6,0
69118,6,1,241711,241711,241712,0,1,0
69119,3,2,241714,241714,241716,0,2,2
69120,2,2,241716,241716,241718,0,2,0
69121,1,2,241717,241718,241720,1,3,0
69122,6,3,241723,241723,241726,0,3,3
69123,4,1,241727,241727,241728,0,1,1
69124,6,1,241733,241733,241734,0,1,5
69125,2,3,241735,241735,241738,0,3,1
69126,3,1,241738,241738,241739,0,1,0
69127,4,1,241742,241742,241743,0,1,3
69128,6,1,241748,241748,241749,0,1,5
69129,3,1,241751,241751,241752,0,1,2
69130,2,1,241753,241753,241754,0,1,1
69131,5,1,241758,241758,241759,0,1,4
69132,6,3,241764,241764,241767,0,3,5
69133,3,1,241767,241767,241768,0,1,0
69134,4,3,241771,241771,241774,0,3,3
69135,5,1,241776,241776,241777,0,1,2
69136,2,1,241778,241778,241779,0,1,1
69137,3,1,241781,241781,241782,0,1,2
69138,3,2,241784,241784,241786,0,2,2
69139,3,2,241787,241787,241789,0,2,1
69140,6,1,241793,241793,241794,0,1,4
69141,3,2,241796,241796,241798,0,2,2
69142,2,2,241798,241798,241800,0,2,0
69143,6,2,241804,241804,241806,0,2,4
69144,4,3,241808,241808,241811,0,3,2
69145,1,1,241809,241811,241812,2,3,0
69146,4,1,241813,241813,241814,0,1,1
69147,4,3,241817,241817,241820,0,3,3
69148,5,3,241822,241822,241825,0,3,2
69149,2,2,241824,241825,241827,1,3,0
69150,6,1,241830,241830,241831,0,1,3
69151,6,3,241836,241836,241839,0,3,5
69152,2,2,241838,241839,241841,1,3,0
69153,4,1,241842,241842,241843,0,1,1
69154,5,1,241847,241847,241848,0,1,4
69155,6,3,241853,241853,241856,0,3,5
69156,6,1,241859,241859,241860,0,1,3
69157,3,1,241862,241862,241863,0,1,2
69158,4,3,241866,241866,241869,0,3,3
69159,1,2,241867,241869,241871,2,4,0
69160,5,1,241872,241872,241873,0,1,1
69161,3,1,241875,241875,241876,0,1,2
69162,3,3,241878,241878,241881,0,3,2
69163,6,2,241884,241884,241886,0,2,3
69164,3,1,241887,241887,241888,0,1,1
69165,4,2,241891,241891,241893,0,2,3
69166,6,1,241897,241897,241898,0,1,4
69167,5,3,241902,241902,241905,0,3,4
69168,3,3,241905,241905,241908,0,3,0
69169,1,1,241906,241908,241909,2,3,0
69170,1,3,241907,241909,241912,2,5,0
69171,2,3,241909,241912,241915,3,6,0
69172,3,1,241912,241915,241916,3,4,0
69173,4,1,241916,241916,241917,0,1,0
69174,6,3,241922,241922,241925,0,3,5
69175,2,2,241924,241925,241927,1,3,0
69176,4,2,241928,241928,241930,0,2,1
69177,1,2,241929,241930,241932,1,3,0
69178,6,3,241935,241935,241938,0,3,3
69179,2,2,241937,241938,241940,1,3,0
69180,4,3,241941,241941,241944,0,3,1
69181,1,1,241942,241944,241945,2,3,0
69182,6,2,241948,241948,241950,0,2,3
69183,5,3,241953,241953,241956,0,3,3
69184,4,1,241957,241957,241958,0,1,1
69185,1,2,241958,241958,241960,0,2,0
69186,5,2,241963,241963,241965,0,2,3
69187,5,3,241968,241968,241971,0,3,3
69188,3,1,241971,241971,241972,0,1,0
69189,4,3,241975,241975,241978,0,3,3
69190,1,1,241976,241978,241979,2,3,0
69191,6,1,241982,241982,241983,0,1,3
69192,1,2,241983,241983,241985,0,2,0
69193,5,3,241988,241988,241991,0,3,3
69194,6,3,241994,241994,241997,0,3,3
69195,1,3,241995,241997,242000,2,5,0
69196,3,2,241998,242000,242002,2,4,0
69197,5,1,242003,242003,242004,0,1,1
69198,5,2,242008,242008,242010,0,2,4
69199,4,3,242012,242012,242015,0,3,2
69200,2,2,242014,242015,242017,1,3,0
69201,6,3,242020,242020,242023,0,3,3
69202,4,1,242024,242024,242025,0,1,1
69203,2,3,242026,242026,242029,0,3,1
69204,5,1,242031,242031,242032,0,1,2
69205,3,2,242034,242034,242036,0,2,2
69206,5,3,242039,242039,242042,0,3,3
69207,4,3,242043,242043,242046,0,3,1
69208,3,3,242046,242046,242049,0,3,0
69209,3,2,242049,242049,242051,0,2,0
69210,1,3,242050,242051,242054,1,4,0
69211,3,2,242053,242054,242056,1,3,0
69212,1,3,242054,242056,242059,2,5,0
69213,5,3,242059,242059,242062,0,3,0
69214,5,2,242064,242064,242066,0,2,2
69215,4,1,242068,242068,242069,0,1,2
69216,6,2,242074,242074,242076,0,2,5
69217,3,2,242077,242077,242079,0,2,1
69218,2,1,242079,242079,242080,0,1,0
69219,6,1,242085,242085,242086,0,1,5
69220,4,2,242089,242089,242091,0,2,3
69221,5,2,242094,242094,242096,0,2,3
69222,1,3,242095,242096,242099,1,4,0
69223,1,2,242096,242099,242101,3,5,0
69224,3,3,242099,242101,242104,2,5,0
69225,6,1,242105,242105,242106,0,1,1
69226,2,2,242107,242107,242109,0,2,1
69227,3,3,242110,242110,242113,0,3,1
69228,4,2,242114,242114,242116,0,2,1
69229,1,1,242115,242116,242117,1,2,0
69230,2,3,242117,242117,242120,0,3,0
69231,3,2,242120,242120,242122,0,2,0
69232,3,1,242123,242123,242124,0,1,1
69233,5,3,242128,242128,242131,0,3,4
69234,2,2,242130,242131,242133,1,3,0
69235,6,3,242136,242136,242139,0,3,3
69236,3,2,242139,242139,242141,0,2,0
69237,5,3,242144,242144,242147,0,3,3
69238,2,3,242146,242147,242150,1,4,0
69239,1,1,242147,242150,242151,3,4,0
69240,4,3,242151,242151,242154,0,3,0
69241,3,2,242154,242154,242156,0,2,0
69242,3,2,242157,242157,242159,0,2,1
69243,2,2,242159,242159,242161,0,2,0
69244,5,1,242164,242164,242165,0,1,3
69245,3,1,242167,242167,242168,0,1,2
69246,6,2,242173,242173,242175,0,2,5
69247,1,2,242174,242175,242177,1,3,0
69248,2,1,242176,242177,242178,1,2,0
69249,5,3,242181,242181,242184,0,3,3
69250,5,2,242186,242186,242188,0,2,2
69251,4,2,242190,242190,242192,0,2,2
69252,2,3,242192,242192,242195,0,3,0
69253,3,3,242195,242195,242198,0,3,0
69254,1,2,242196,242198,242200,2,4,0
69255,3,3,242199,242200,242203,1,4,0
69256,4,3,242203,242203,242206,0,3,0
69257,5,3,242208,242208,242211,0,3,2
69258,5,2,242213,242213,242215,0,2,2
69259,4,2,242217,242217,242219,0,2,2
69260,6,2,242223,242223,242225,0,2,4
69261,5,3,242228,242228,242231,0,3,3
69262,5,1,242233,242233,242234,0,1,2
69263,5,1,242238,242238,242239,0,1,4
69264,2,3,242240,242240,242243,0,3,1
69265,5,3,242245,242245,242248,0,3,2
69266,2,2,242247,242248,242250,1,3,0
69267,2,1,242249,242250,242251,1,2,0
69268,4,2,242253,242253,242255,0,2,2
69269,1,1,242254,242255,242256,1,2,0
69270,4,1,242258,242258,242259,0,1,2
69271,3,3,242261,242261,242264,0,3,2
69272,1,1,242262,242264,242265,2,3,0
69273,5,2,242267,242267,242269,0,2,2
69274,4,3,242271,242271,242274,0,3,2
69275,2,3,242273,242274,242277,1,4,0
69276,5,2,242278,242278,242280,0,2,1
69277,3,3,242281,242281,242284,0,3,1
69278,3,3,242284,242284,242287,0,3,0
69279,6,2,242290,242290,242292,0,2,3
69280,6,1,242296,242296,242297,0,1,4
69281,5,1,242301,242301,242302,0,1,4
69282,2,1,242303,242303,242304,0,1,1
69283,1,2,242304,242304,242306,0,2,0
69284,1,2,242305,242306,242308,1,3,0
69285,6,2,242311,242311,242313,0,2,3
69286,5,2,242316,242316,242318,0,2,3
69287,6,3,242322,242322,242325,0,3,4
69288,6,1,242328,242328,242329,0,1,3
69289,5,3,242333,242333,242336,0,3,4
69290,4,3,242337,242337,242340,0,3,1
69291,5,1,242342,242342,242343,0,1,2
69292,4,2,242346,242346,242348,0,2,3
69293,2,3,242348,242348,242351,0,3,0
69294,2,3,242350,242351,242354,1,4,0
69295,1,3,242351,242354,242357,3,6,0
69296,3,2,242354,242357,242359,3,5,0
69297,1,2,242355,242359,242361,4,6,0
69298,4,1,242359,242361,242362,2,3,0
69299,3,1,242362,242362,242363,0,1,0
69300,6,1,242368,242368,242369,0,1,5
69301,6,2,242374,242374,242376,0,2,5
69302,1,1,242375,242376,242377,1,2,0
69303,4,1,242379,242379,242380,0,1,2
69304,2,3,242381,242381,242384,0,3,1
69305,6,3,242387,242387,242390,0,3,3
69306,3,3,242390,242390,242393,0,3,0
69307,3,2,242393,242393,242395,0,2,0
69308,4,1,242397,242397,242398,0,1,2
69309,1,1,242398,242398,242399,0,1,0
69310,1,1,242399,242399,242400,0,1,0
69311,2,2,242401,242401,242403,0,2,1
69312,1,3,242402,242403,242406,1,4,0
69313,3,1,242405,242406,242407,1,2,0
69314,3,2,242408,242408,242410,0,2,1
69315,1,3,242409,242410,242413,1,4,0
69316,1,1,242410,242413,242414,3,4,0
69317,3,2,242413,242414,242416,1,3,0
69318,4,1,242417,242417,242418,0,1,1
69319,5,2,242422,242422,242424,0,2,4
69320,6,2,242428,242428,242430,0,2,4
69321,1,1,242429,242430,242431,1,2,0
69322,3,1,242432,242432,242433,0,1,1
69323,5,3,242437,242437,242440,0,3,4
69324,3,3,242440,242440,242443,0,3,0
69325,2,2,242442,242443,242445,1,3,0
69326,5,3,242447,242447,242450,0,3,2
69327,6,3,242453,242453,242456,0,3,3
69328,1,3,242454,242456,242459,2,5,0
69329,6,1,242460,242460,242461,0,1,1
69330,1,1,242461,242461,242462,0,1,0
69331,5,3,242466,242466,242469,0,3,4
69332,1,2,242467,242469,242471,2,4,0
69333,5,2,242472,242472,242474,0,2,1
69334,6,3,242478,242478,242481,0,3,4
69335,4,3,242482,242482,242485,0,3,1
69336,1,1,242483,242485,242486,2,3,0
69337,1,2,242484,242486,242488,2,4,0
69338,2,3,242486,242488,242491,2,5,0
69339,6,3,242492,242492,242495,0,3,1
69340,3,1,242495,242495,242496,0,1,0
69341,4,1,242499,242499,242500,0,1,3
69342,6,1,242505,242505,242506,0,1,5
69343,5,3,242510,242510,242513,0,3,4
69344,3,3,242513,242513,242516,0,3,0
69345,4,2,242517,242517,242519,0,2,1
69346,4,3,242521,242521,242524,0,3,2
69347,4,1,242525,242525,242526,0,1,1
69348,2,2,242527,242527,242529,0,2,1
69349,5,1,242532,242532,242533,0,1,3
69350,6,3,242538,242538,242541,0,3,5
69351,2,2,242540,242541,242543,1,3,0
69352,2,1,242542,242543,242544,1,2,0
69353,3,2,242545,242545,242547,0,2,1
69354,1,2,242546,242547,242549,1,3,0
69355,2,2,242548,242549,242551,1,3,0
69356,1,1,242549,242551,242552,2,3,0
69357,6,1,242555,242555,242556,0,1,3
69358,3,2,242558,242558,242560,0,2,2
69359,5,1,242563,242563,242564,0,1,3
69360,1,3,242564,242564,242567,0,3,0
69361,4,3,242568,242568,242571,0,3,1
69362,4,1,242572,242572,242573,0,1,1
69363,6,3,242578,242578,242581,0,3,5
69364,1,2,242579,242581,242583,2,4,0
69365,1,1,242580,242583,242584,3,4,0
69366,1,2,242581,242584,242586,3,5,0
69367,2,3,242583,242586,242589,3,6,0
69368,2,2,242585,242589,242591,4,6,0
69369,6,1,242591,242591,242592,0,1,0
69370,6,1,242597,242597,242598,0,1,5
69371,4,1,242601,242601,242602,0,1,3
69372,6,3,242607,242607,242610,0,3,5
69373,4,3,242611,242611,242614,0,3,1
69374,4,2,242615,242615,242617,0,2,1
69375,2,1,242617,242617,242618,0,1,0
69376,3,3,242620,242620,242623,0,3,2
69377,1,3,242621,242623,242626,2,5,0
69378,3,1,242624,242626,242627,2,3,0
69379,6,3,242630,242630,242633,0,3,3
69380,6,2,242636,242636,242638,0,2,3
69381,5,3,242641,242641,242644,0,3,3
69382,6,3,242647,242647,242650,0,3,3
69383,2,3,242649,242650,242653,1,4,0
69384,5,3,242654,242654,242657,0,3,1
69385,6,2,242660,242660,242662,0,2,3
69386,4,2,242664,242664,242666,0,2,2
69387,1,3,242665,242666,242669,1,4,0
69388,5,3,242670,242670,242673,0,3,1
69389,6,3,242676,242676,242679,0,3,3
69390,1,1,242677,242679,242680,2,3,0
69391,5,2,242682,242682,242684,0,2,2
69392,2,2,242684,242684,242686,0,2,0
69393,1,2,242685,242686,242688,1,3,0
69394,6,3,242691,242691,242694,0,3,3
69395,6,2,242697,242697,242699,0,2,3
69396,4,1,242701,242701,242702,0,1,2
69397,3,3,242704,242704,242707,0,3,2
69398,3,1,242707,242707,242708,0,1,0
69399,3,2,242710,242710,242712,0,2,2
69400,3,2,242713,242713,242715,0,2,1
69401,3,3,242716,242716,242719,0,3,1
69402,4,1,242720,242720,242721,0,1,1
69403,5,2,242725,242725,242727,0,2,4
69404,2,2,242727,242727,242729,0,2,0
69405,3,2,242730,242730,242732,0,2,1
69406,6,3,242736,242736,242739,0,3,4
69407,6,1,242742,242742,242743,0,1,3
69408,4,1,242746,242746,242747,0,1,3
69409,1,2,242747,242747,242749,0,2,0
69410,5,2,242752,242752,242754,0,2,3
69411,1,3,242753,242754,242757,1,4,0
69412,4,3,242757,242757,242760,0,3,0
69413,6,1,242763,242763,242764,0,1,3
69414,4,1,242767,242767,242768,0,1,3
69415,2,3,242769,242769,242772,0,3,1
69416,5,3,242774,242774,242777,0,3,2
69417,2,3,242776,242777,242780,1,4,0
69418,4,2,242780,242780,242782,0,2,0
69419,1,1,242781,242782,242783,1,2,0
69420,2,2,242783,242783,242785,0,2,0
69421,3,1,242786,242786,242787,0,1,1
69422,5,2,242791,242791,242793,0,2,4
69423,3,3,242794,242794,242797,0,3,1
69424,5,3,242799,242799,242802,0,3,2
69425,1,2,242800,242802,242804,2,4,0
69426,1,3,242801,242804,242807,3,6,0
69427,4,3,242805,242807,242810,2,5,0
69428,4,3,242809,242810,242813,1,4,0
69429,4,2,242813,242813,242815,0,2,0
69430,1,2,242814,242815,242817,1,3,0
69431,6,3,242820,242820,242823,0,3,3
69432,4,2,242824,242824,242826,0,2,1
69433,4,3,242828,242828,242831,0,3,2
69434,4,1,242832,242832,242833,0,1,1
69435,4,3,242836,242836,242839,0,3,3
69436,3,1,242839,242839,242840,0,1,0
69437,4,1,242843,242843,242844,0,1,3
69438,3,2,242846,242846,242848,0,2,2
69439,3,3,242849,242849,242852,0,3,1
69440,5,3,242854,242854,242857,0,3,2
69441,3,3,242857,242857,242860,0,3,0
69442,5,3,242862,242862,242865,0,3,2
69443,5,1,242867,242867,242868,0,1,2
69444,6,3,242873,242873,242876,0,3,5
69445,3,3,242876,242876,242879,0,3,0
69446,2,2,242878,242879,242881,1,3,0
69447,5,3,242883,242883,242886,0,3,2
69448,2,1,242885,242886,242887,1,2,0
69449,6,3,242891,242891,242894,0,3,4
69450,1,3,242892,242894,242897,2,5,0
69451,2,1,242894,242897,242898,3,4,0
69452,5,2,242899,242899,242901,0,2,1
69453,1,1,242900,242901,242902,1,2,0
69454,6,1,242906,242906,242907,0,1,4
69455,5,3,242911,242911,242914,0,3,4
69456,5,1,242916,242916,242917,0,1,2
69457,1,3,242917,242917,242920,0,3,0
69458,3,1,242920,242920,242921,0,1,0
69459,1,3,242921,242921,242924,0,3,0
69460,3,1,242924,242924,242925,0,1,0
69461,4,1,242928,242928,242929,0,1,3
69462,4,2,242932,242932,242934,0,2,3
69463,5,1,242937,242937,242938,0,1,3
69464,4,1,242941,242941,242942,0,1,3
69465,4,2,242945,242945,242947,0,2,3
69466,6,1,242951,242951,242952,0,1,4
69467,4,3,242955,242955,242958,0,3,3
69468,5,3,242960,242960,242963,0,3,2
69469,6,1,242966,242966,242967,0,1,3
69470,1,1,242967,242967,242968,0,1,0
69471,1,2,242968,242968,242970,0,2,0
69472,3,1,242971,242971,242972,0,1,1
69473,5,2,242976,242976,242978,0,2,4
69474,1,1,242977,242978,242979,1,2,0
69475,1,1,242978,242979,242980,1,2,0
69476,5,2,242983,242983,242985,0,2,3
69477,1,2,242984,242985,242987,1,3,0
69478,1,3,242985,242987,242990,2,5,0
69479,1,3,242986,242990,242993,4,7,0
69480,3,1,242989,242993,242994,4,5,0
69481,6,3,242995,242995,242998,0,3,1
69482,6,3,243001,243001,243004,0,3,3
69483,3,2,243004,243004,243006,0,2,0
69484,3,2,243007,243007,243009,0,2,1
69485,4,1,243011,243011,243012,0,1,2
69486,1,3,243012,243012,243015,0,3,0
69487,6,2,243018,243018,243020,0,2,3
69488,5,1,243023,243023,243024,0,1,3
69489,6,3,243029,243029,243032,0,3,5
69490,1,2,243030,243032,243034,2,4,0
69491,3,3,243033,243034,243037,1,4,0
69492,1,2,243034,243037,243039,3,5,0
69493,4,1,243038,243039,243040,1,2,0
69494,2,1,243040,243040,243041,0,1,0
69495,5,2,243045,243045,243047,0,2,4
69496,2,2,243047,243047,243049,0,2,0
69497,2,2,243049,243049,243051,0,2,0
69498,4,1,243053,243053,243054,0,1,2
69499,6,1,243059,243059,243060,0,1,5
69500,2,3,243061,243061,243064,0,3,1
69501,4,2,243065,243065,243067,0,2,1
69502,4,2,243069,243069,243071,0,2,2
69503,1,3,243070,243071,243074,1,4,0
69504,1,2,243071,243074,243076,3,5,0
69505,6,3,243077,243077,243080,0,3,1
69506,3,3,243080,243080,243083,0,3,0
69507,5,3,243085,243085,243088,0,3,2
69508,1,3,243086,243088,243091,2,5,0
69509,4,1,243090,243091,243092,1,2,0
69510,6,3,243096,243096,243099,0,3,4
69511,6,3,243102,243102,243105,0,3,3
69512,1,2,243103,243105,243107,2,4,0
69513,6,2,243109,243109,243111,0,2,2
69514,6,3,243115,243115,243118,0,3,4
69515,6,3,243121,243121,243124,0,3,3
69516,2,1,243123,243124,243125,1,2,0
69517,6,1,243129,243129,243130,0,1,4
69518,6,2,243135,243135,243137,0,2,5
69519,6,1,243141,243141,243142,0,1,4
69520,5,2,243146,243146,243148,0,2,4
69521,5,2,243151,243151,243153,0,2,3
69522,1,2,243152,243153,243155,1,3,0
69523,5,1,243157,243157,243158,0,1,2
69524,3,3,243160,243160,243163,0,3,2
69525,4,2,243164,243164,243166,0,2,1
69526,1,3,243165,243166,243169,1,4,0
69527,4,2,243169,243169,243171,0,2,0
69528,4,2,243173,243173,243175,0,2,2
69529,5,1,243178,243178,243179,0,1,3
69530,1,3,243179,243179,243182,0,3,0
69531,2,1,243181,243182,243183,1,2,0
69532,6,1,243187,243187,243188,0,1,4
69533,4,2,243191,243191,243193,0,2,3
69534,3,1,243194,243194,243195,0,1,1
69535,3,3,243197,243197,243200,0,3,2
69536,2,3,243199,243200,243203,1,4,0
69537,1,1,243200,243203,243204,3,4,0
69538,2,3,243202,243204,243207,2,5,0
69539,3,2,243205,243207,243209,2,4,0
69540,2,3,243207,243209,243212,2,5,0
69541,1,3,243208,243212,243215,4,7,0
69542,1,3,243209,243215,243218,6,9,0
69543,1,2,243210,243218,243220,8,10,0
69544,4,2,243214,243220,243222,6,8,0
69545,1,1,243215,243222,243223,7,8,0
69546,5,1,243220,243223,243224,3,4,0
69547,1,1,243221,243224,243225,3,4,0
69548,1,1,243222,243225,243226,3,4,0
69549,5,3,243227,243227,243230,0,3,1
69550,1,2,243228,243230,243232,2,4,0
69551,2,2,243230,243232,243234,2,4,0
69552,6,3,243236,243236,243239,0,3,2
69553,4,1,243240,243240,243241,0,1,1
69554,3,1,243243,243243,243244,0,1,2
69555,5,2,243248,243248,243250,0,2,4
69556,1,3,243249,243250,243253,1,4,0
69557,5,2,243254,243254,243256,0,2,1
69558,1,3,243255,243256,243259,1,4,0
69559,1,1,243256,243259,243260,3,4,0
69560,2,1,243258,243260,243261,2,3,0
69561,4,2,243262,243262,243264,0,2,1
69562,5,1,243267,243267,243268,0,1,3
69563,2,3,243269,243269,243272,0,3,1
69564,3,1,243272,243272,243273,0,1,0
69565,2,1,243274,243274,243275,0,1,1
69566,1,2,243275,243275,243277,0,2,0
69567,4,1,243279,243279,243280,0,1,2
69568,1,2,243280,243280,243282,0,2,0
69569,1,1,243281,243282,243283,1,2,0
69570,3,2,243284,243284,243286,0,2,1
69571,3,2,243287,243287,243289,0,2,1
69572,2,1,243289,243289,243290,0,1,0
69573,2,2,243291,243291,243293,0,2,1
69574,5,1,243296,243296,243297,0,1,3
69575,1,2,243297,243297,243299,0,2,0
69576,2,1,243299,243299,243300,0,1,0
69577,3,2,243302,243302,243304,0,2,2
69578,2,2,243304,243304,243306,0,2,0
69579,6,3,243310,243310,243313,0,3,4
69580,1,3,243311,243313,243316,2,5,0
69581,1,2,243312,243316,243318,4,6,0
69582,1,3,243313,243318,243321,5,8,0
69583,2,3,243315,243321,243324,6,9,0
69584,6,1,243321,243324,243325,3,4,0
69585,4,1,243325,243325,243326,0,1,0
69586,2,2,243327,243327,243329,0,2,1
69587,3,1,243330,243330,243331,0,1,1
69588,2,2,243332,243332,243334,0,2,1
69589,3,2,243335,243335,243337,0,2,1
69590,3,2,243338,243338,243340,0,2,1
69591,4,1,243342,243342,243343,0,1,2
69592,1,1,243343,243343,243344,0,1,0
69593,5,2,243348,243348,243350,0,2,4
69594,1,1,243349,243350,243351,1,2,0
69595,3,2,243352,243352,243354,0,2,1
69596,6,1,243358,243358,243359,0,1,4
69597,5,2,243363,243363,243365,0,2,4
69598,5,3,243368,243368,243371,0,3,3
69599,2,1,243370,243371,243372,1,2,0
69600,5,1,243375,243375,243376,0,1,3
69601,3,1,243378,243378,243379,0,1,2
69602,6,1,243384,243384,243385,0,1,5
69603,1,2,243385,243385,243387,0,2,0
69604,4,3,243389,243389,243392,0,3,2
69605,5,1,243394,243394,243395,0,1,2
69606,5,3,243399,243399,243402,0,3,4
69607,2,1,243401,243402,243403,1,2,0
69608,2,2,243403,243403,243405,0,2,0
69609,5,3,243408,243408,243411,0,3,3
69610,3,3,243411,243411,243414,0,3,0
69611,6,2,243417,243417,243419,0,2,3
69612,6,2,243423,243423,243425,0,2,4
69613,3,1,243426,243426,243427,0,1,1
69614,5,3,243431,243431,243434,0,3,4
69615,4,1,243435,243435,243436,0,1,1
69616,3,3,243438,243438,243441,0,3,2
69617,4,1,243442,243442,243443,0,1,1
69618,4,3,243446,243446,243449,0,3,3
69619,5,3,243451,243451,243454,0,3,2
69620,4,2,243455,243455,243457,0,2,1
69621,1,1,243456,243457,243458,1,2,0
69622,4,2,243460,243460,243462,0,2,2
69623,3,1,243463,243463,243464,0,1,1
69624,5,3,243468,243468,243471,0,3,4
69625,4,1,243472,243472,243473,0,1,1
69626,4,1,243476,243476,243477,0,1,3
69627,4,1,243480,243480,243481,0,1,3
69628,5,3,243485,243485,243488,0,3,4
69629,1,3,243486,243488,243491,2,5,0
69630,5,3,243491,243491,243494,0,3,0
69631,6,1,243497,243497,243498,0,1,3
69632,3,2,243500,243500,243502,0,2,2
69633,3,2,243503,243503,243505,0,2,1
69634,6,3,243509,243509,243512,0,3,4
69635,3,1,243512,243512,243513,0,1,0
69636,2,2,243514,243514,243516,0,2,1
69637,3,1,243517,243517,243518,0,1,1
69638,5,2,243522,243522,243524,0,2,4
69639,4,3,243526,243526,243529,0,3,2
69640,5,1,243531,243531,243532,0,1,2
69641,3,3,243534,243534,243537,0,3,2
69642,4,2,243538,243538,243540,0,2,1
69643,3,2,243541,243541,243543,0,2,1
69644,6,3,243547,243547,243550,0,3,4
69645,3,2,243550,243550,243552,0,2,0
69646,4,2,243554,243554,243556,0,2,2
69647,1,2,243555,243556,243558,1,3,0
69648,4,3,243559,243559,243562,0,3,1
69649,1,3,243560,243562,243565,2,5,0
69650,5,2,243565,243565,243567,0,2,0
69651,4,1,243569,243569,243570,0,1,2
69652,5,2,243574,243574,243576,0,2,4
69653,5,2,243579,243579,243581,0,2,3
69654,4,2,243583,243583,243585,0,2,2
69655,2,1,243585,243585,243586,0,1,0
69656,6,3,243591,243591,243594,0,3,5
69657,3,2,243594,243594,243596,0,2,0
69658,4,3,243598,243598,243601,0,3,2
69659,5,3,243603,243603,243606,0,3,2
69660,3,2,243606,243606,243608,0,2,0
69661,6,2,243612,243612,243614,0,2,4
69662,6,1,243618,243618,243619,0,1,4
69663,6,1,243624,243624,243625,0,1,5
69664,2,2,243626,243626,243628,0,2,1
69665,1,2,243627,243628,243630,1,3,0
69666,3,3,243630,243630,243633,0,3,0
69667,3,2,243633,243633,243635,0,2,0
69668,5,3,243638,243638,243641,0,3,3
69669,4,3,243642,243642,243645,0,3,1
69670,1,3,243643,243645,243648,2,5,0
69671,3,1,243646,243648,243649,2,3,0
69672,2,3,243648,243649,243652,1,4,0
69673,2,2,243650,243652,243654,2,4,0
69674,6,3,243656,243656,243659,0,3,2
69675,2,2,243658,243659,243661,1,3,0
69676,6,2,243664,243664,243666,0,2,3
69677,1,2,243665,243666,243668,1,3,0
69678,4,3,243669,243669,243672,0,3,1
69679,2,3,243671,243672,243675,1,4,0
69680,6,2,243677,243677,243679,0,2,2
69681,5,3,243682,243682,243685,0,3,3
69682,2,1,243684,243685,243686,1,2,0
69683,4,1,243688,243688,243689,0,1,2
69684,1,2,243689,243689,243691,0,2,0
69685,2,2,243691,243691,243693,0,2,0
69686,4,2,243695,243695,243697,0,2,2
69687,2,1,243697,243697,243698,0,1,0
69688,4,2,243701,243701,243703,0,2,3
69689,5,1,243706,243706,243707,0,1,3
69690,5,1,243711,243711,243712,0,1,4
69691,6,3,243717,243717,243720,0,3,5
69692,1,2,243718,243720,243722,2,4,0
69693,3,3,243721,243722,243725,1,4,0
69694,6,1,243727,243727,243728,0,1,2
69695,1,3,243728,243728,243731,0,3,0
69696,6,1,243734,243734,243735,0,1,3
69697,3,1,243737,243737,243738,0,1,2
69698,2,3,243739,243739,243742,0,3,1
69699,3,2,243742,243742,243744,0,2,0
69700,1,2,243743,243744,243746,1,3,0
69701,3,3,243746,243746,243749,0,3,0
69702,5,1,243751,243751,243752,0,1,2
69703,5,3,243756,243756,243759,0,3,4
69704,1,3,243757,243759,243762,2,5,0
69705,1,1,243758,243762,243763,4,5,0
69706,4,3,243762,243763,243766,1,4,0
69707,1,3,243763,243766,243769,3,6,0
69708,6,3,243769,243769,243772,0,3,0
69709,4,1,243773,243773,243774,0,1,1
69710,5,3,243778,243778,243781,0,3,4
69711,1,3,243779,243781,243784,2,5,0
69712,3,2,243782,243784,243786,2,4,0
69713,5,1,243787,243787,243788,0,1,1
69714,1,2,243788,243788,243790,0,2,0
69715,4,1,243792,243792,243793,0,1,2
69716,1,1,243793,243793,243794,0,1,0
69717,6,3,243799,243799,243802,0,3,5
69718,3,1,243802,243802,243803,0,1,0
69719,1,3,243803,243803,243806,0,3,0
69720,3,3,243806,243806,243809,0,3,0
69721,3,3,243809,243809,243812,0,3,0
69722,3,1,243812,243812,243813,0,1,0
69723,3,1,243815,243815,243816,0,1,2
69724,2,1,243817,243817,243818,0,1,1
69725,4,2,243821,243821,243823,0,2,3
69726,4,2,243825,243825,243827,0,2,2
69727,4,1,243829,243829,243830,0,1,2
69728,3,1,243832,243832,243833,0,1,2
69729,4,1,243836,243836,243837,0,1,3
69730,6,3,243842,243842,243845,0,3,5
69731,3,3,243845,243845,243848,0,3,0
69732,3,1,243848,243848,243849,0,1,0
69733,1,1,243849,243849,243850,0,1,0
69734,6,3,243855,243855,243858,0,3,5
69735,6,2,243861,243861,243863,0,2,3
69736,3,3,243864,243864,243867,0,3,1
69737,1,2,243865,243867,243869,2,4,0
69738,5,1,243870,243870,243871,0,1,1
69739,2,3,243872,243872,243875,0,3,1
69740,1,3,243873,243875,243878,2,5,0
69741,6,1,243879,243879,243880,0,1,1
69742,6,2,243885,243885,243887,0,2,5
69743,1,1,243886,243887,243888,1,2,0
69744,2,1,243888,243888,243889,0,1,0
69745,5,2,243893,243893,243895,0,2,4
69746,4,1,243897,243897,243898,0,1,2
69747,3,3,243900,243900,243903,0,3,2
69748,4,1,243904,243904,243905,0,1,1
69749,2,3,243906,243906,243909,0,3,1
69750,6,1,243912,243912,243913,0,1,3
69751,1,2,243913,243913,243915,0,2,0
69752,1,2,243914,243915,243917,1,3,0
69753,5,2,243919,243919,243921,0,2,2
69754,4,2,243923,243923,243925,0,2,2
69755,4,1,243927,243927,243928,0,1,2
69756,2,2,243929,243929,243931,0,2,1
69757,1,1,243930,243931,243932,1,2,0
69758,2,2,243932,243932,243934,0,2,0
69759,1,3,243933,243934,243937,1,4,0
69760,1,1,243934,243937,243938,3,4,0
69761,3,3,243937,243938,243941,1,4,0
69762,1,2,243938,243941,243943,3,5,0
69763,2,2,243940,243943,243945,3,5,0
69764,3,1,243943,243945,243946,2,3,0
69765,2,2,243945,243946,243948,1,3,0
69766,6,2,243951,243951,243953,0,2,3
69767,4,3,243955,243955,243958,0,3,2
69768,2,1,243957,243958,243959,1,2,0
69769,1,1,243958,243959,243960,1,2,0
69770,3,3,243961,243961,243964,0,3,1
69771,2,1,243963,243964,243965,1,2,0
69772,3,1,243966,243966,243967,0,1,1
69773,1,2,243967,243967,243969,0,2,0
69774,1,1,243968,243969,243970,1,2,0
69775,4,2,243972,243972,243974,0,2,2
69776,4,2,243976,243976,243978,0,2,2
69777,3,2,243979,243979,243981,0,2,1
69778,3,2,243982,243982,243984,0,2,1
69779,1,1,243983,243984,243985,1,2,0
69780,3,1,243986,243986,243987,0,1,1
69781,4,2,243990,243990,243992,0,2,3
69782,2,2,243992,243992,243994,0,2,0
69783,3,3,243995,243995,243998,0,3,1
69784,3,3,243998,243998,244001,0,3,0
69785,3,2,244001,244001,244003,0,2,0
69786,2,2,244003,244003,244005,0,2,0
69787,4,1,244007,244007,244008,0,1,2
69788,5,1,244012,244012,244013,0,1,4
69789,6,1,244018,244018,244019,0,1,5
69790,3,3,244021,244021,244024,0,3,2
69791,4,3,244025,244025,244028,0,3,1
69792,5,2,244030,244030,244032,0,2,2
69793,3,2,244033,244033,244035,0,2,1
69794,5,2,244038,244038,244040,0,2,3
69795,2,1,244040,244040,244041,0,1,0
69796,3,3,244043,244043,244046,0,3,2
69797,5,1,244048,244048,244049,0,1,2
69798,2,2,244050,244050,244052,0,2,1
69799,6,1,244056,244056,244057,0,1,4
69800,6,2,244062,244062,244064,0,2,5
69801,2,1,244064,244064,244065,0,1,0
69802,6,1,244070,244070,244071,0,1,5
69803,5,2,244075,244075,244077,0,2,4
69804,6,2,244081,244081,244083,0,2,4
69805,6,2,244087,244087,244089,0,2,4
69806,3,2,244090,244090,244092,0,2,1
69807,2,2,244092,244092,244094,0,2,0
69808,3,1,244095,244095,244096,0,1,1
69809,1,3,244096,244096,244099,0,3,0
69810,3,3,244099,244099,244102,0,3,0
69811,6,2,244105,244105,244107,0,2,3
69812,1,3,244106,244107,244110,1,4,0
69813,1,2,244107,244110,244112,3,5,0
69814,6,2,244113,244113,244115,0,2,1
69815,5,1,244118,244118,244119,0,1,3
69816,1,2,244119,244119,244121,0,2,0
69817,3,2,244122,244122,244124,0,2,1
69818,2,1,244124,244124,244125,0,1,0
69819,6,1,244130,244130,244131,0,1,5
69820,3,3,244133,244133,244136,0,3,2
69821,2,1,244135,244136,244137,1,2,0
69822,6,2,244141,244141,244143,0,2,4
69823,3,2,244144,244144,244146,0,2,1
69824,2,1,244146,244146,244147,0,1,0
69825,1,1,244147,244147,244148,0,1,0
69826,2,3,244149,244149,244152,0,3,1
69827,3,3,244152,244152,244155,0,3,0
69828,1,2,244153,244155,244157,2,4,0
69829,2,2,244155,244157,244159,2,4,0
69830,4,3,244159,244159,244162,0,3,0
69831,6,1,244165,244165,244166,0,1,3
69832,5,1,244170,244170,244171,0,1,4
69833,2,2,244172,244172,244174,0,2,1
69834,5,3,244177,244177,244180,0,3,3
69835,4,1,244181,244181,244182,0,1,1
69836,1,3,244182,244182,244185,0,3,0
69837,6,2,244188,244188,244190,0,2,3
69838,3,3,244191,244191,244194,0,3,1
69839,1,2,244192,244194,244196,2,4,0
69840,5,3,244197,244197,244200,0,3,1
69841,3,2,244200,244200,244202,0,2,0
69842,1,1,244201,244202,244203,1,2,0
69843,3,1,244204,244204,244205,0,1,1
69844,2,1,244206,244206,244207,0,1,1
69845,1,3,244207,244207,244210,0,3,0
69846,6,3,244213,244213,244216,0,3,3
69847,4,1,244217,244217,244218,0,1,1
69848,6,3,244223,244223,244226,0,3,5
69849,4,3,244227,244227,244230,0,3,1
69850,6,2,244233,244233,244235,0,2,3
69851,2,3,244235,244235,244238,0,3,0
69852,6,1,244241,244241,244242,0,1,3
69853,1,2,244242,244242,244244,0,2,0
69854,4,2,244246,244246,244248,0,2,2
69855,2,2,244248,244248,244250,0,2,0
69856,2,1,244250,244250,244251,0,1,0
69857,3,3,244253,244253,244256,0,3,2
69858,2,3,244255,244256,244259,1,4,0
69859,2,2,244257,244259,244261,2,4,0
69860,5,3,244262,244262,244265,0,3,1
69861,3,1,244265,244265,244266,0,1,0
69862,4,3,244269,244269,244272,0,3,3
69863,6,1,244275,244275,244276,0,1,3
69864,4,3,244279,244279,244282,0,3,3
69865,5,2,244284,244284,244286,0,2,2
69866,3,1,244287,244287,244288,0,1,1
69867,4,3,244291,244291,244294,0,3,3
69868,2,1,244293,244294,244295,1,2,0
69869,2,1,244295,244295,244296,0,1,0
69870,2,2,244297,244297,244299,0,2,1
69871,6,2,244303,244303,244305,0,2,4
69872,5,3,244308,244308,244311,0,3,3
69873,4,1,244312,244312,244313,0,1,1
69874,6,1,244318,244318,244319,0,1,5
69875,3,2,244321,244321,244323,0,2,2
69876,6,3,244327,244327,244330,0,3,4
69877,4,2,244331,244331,244333,0,2,1
69878,4,1,244335,244335,244336,0,1,2
69879,1,3,244336,244336,244339,0,3,0
69880,3,3,244339,244339,244342,0,3,0
69881,4,2,244343,244343,244345,0,2,1
69882,5,3,244348,244348,244351,0,3,3
69883,1,1,244349,244351,244352,2,3,0
69884,3,2,244352,244352,244354,0,2,0
69885,4,3,244356,244356,244359,0,3,2
69886,1,3,244357,244359,244362,2,5,0
69887,3,1,244360,244362,244363,2,3,0
69888,1,3,244361,244363,244366,2,5,0
69889,4,1,244365,244366,244367,1,2,0
69890,3,1,244368,244368,244369,0,1,1
69891,5,3,244373,244373,244376,0,3,4
69892,2,2,244375,244376,244378,1,3,0
69893,2,3,244377,244378,244381,1,4,0
69894,4,2,244381,244381,244383,0,2,0
69895,3,2,244384,244384,244386,0,2,1
69896,2,3,244386,244386,244389,0,3,0
69897,1,1,244387,244389,244390,2,3,0
69898,4,1,244391,244391,244392,0,1,1
69899,3,1,244394,244394,244395,0,1,2
69900,5,3,244399,244399,244402,0,3,4
69901,5,3,244404,244404,244407,0,3,2
69902,2,1,244406,244407,244408,1,2,0
69903,4,1,244410,244410,244411,0,1,2
69904,3,3,244413,244413,244416,0,3,2
69905,1,2,244414,244416,244418,2,4,0
69906,2,3,244416,244418,244421,2,5,0
69907,4,3,244420,244421,244424,1,4,0
69908,3,1,244423,244424,244425,1,2,0
69909,5,3,244428,244428,244431,0,3,3
69910,1,2,244429,244431,244433,2,4,0
69911,6,3,244435,244435,244438,0,3,2
69912,6,2,244441,244441,244443,0,2,3
69913,3,3,244444,244444,244447,0,3,1
69914,4,3,244448,244448,244451,0,3,1
69915,3,1,244451,244451,244452,0,1,0
69916,3,3,244454,244454,244457,0,3,2
69917,4,1,244458,244458,244459,0,1,1
69918,4,2,244462,244462,244464,0,2,3
69919,4,1,244466,244466,244467,0,1,2
69920,3,2,244469,244469,244471,0,2,2
69921,6,1,244475,244475,244476,0,1,4
69922,6,3,244481,244481,244484,0,3,5
69923,6,3,244487,244487,244490,0,3,3
69924,5,2,244492,244492,244494,0,2,2
69925,1,1,244493,244494,244495,1,2,0
69926,3,1,244496,244496,244497,0,1,1
69927,5,3,244501,244501,244504,0,3,4
69928,4,3,244505,244505,244508,0,3,1
69929,2,1,244507,244508,244509,1,2,0
69930,2,1,244509,244509,244510,0,1,0
69931,2,1,244511,244511,244512,0,1,1
69932,2,1,244513,244513,244514,0,1,1
69933,4,1,244517,244517,244518,0,1,3
69934,2,2,244519,244519,244521,0,2,1
69935,2,1,244521,244521,244522,0,1,0
69936,2,2,244523,244523,244525,0,2,1
69937,4,3,244527,244527,244530,0,3,2
69938,1,3,244528,244530,244533,2,5,0
69939,2,3,244530,244533,244536,3,6,0
69940,1,3,244531,244536,244539,5,8,0
69941,1,2,244532,244539,244541,7,9,0
69942,5,2,244537,244541,244543,4,6,0
69943,4,3,244541,244543,244546,2,5,0
69944,6,1,244547,244547,244548,0,1,1
69945,6,1,244553,244553,244554,0,1,5
69946,3,1,244556,244556,244557,0,1,2
69947,2,3,244558,244558,244561,0,3,1
69948,4,2,244562,244562,244564,0,2,1
69949,4,1,244566,244566,244567,0,1,2
69950,6,3,244572,244572,244575,0,3,5
69951,1,1,244573,244575,244576,2,3,0
69952,2,3,244575,244576,244579,1,4,0
69953,3,2,244578,244579,244581,1,3,0
69954,1,2,244579,244581,244583,2,4,0
69955,2,3,244581,244583,244586,2,5,0
69956,6,1,244587,244587,244588,0,1,1
69957,2,2,244589,244589,244591,0,2,1
69958,6,2,244595,244595,244597,0,2,4
69959,2,2,244597,244597,244599,0,2,0
69960,3,1,244600,244600,244601,0,1,1
69961,1,1,244601,244601,244602,0,1,0
69962,4,2,244605,244605,244607,0,2,3
69963,1,3,244606,244607,244610,1,4,0
69964,1,3,244607,244610,244613,3,6,0
69965,2,1,244609,244613,244614,4,5,0
69966,6,1,244615,244615,244616,0,1,1
69967,5,1,244620,244620,244621,0,1,4
69968,3,1,244623,244623,244624,0,1,2
69969,2,3,244625,244625,244628,0,3,1
69970,4,1,244629,244629,244630,0,1,1
69971,2,1,244631,244631,244632,0,1,1
69972,5,2,244636,244636,244638,0,2,4
69973,3,3,244639,244639,244642,0,3,1
69974,1,3,244640,244642,244645,2,5,0
69975,4,3,244644,244645,244648,1,4,0
69976,6,1,244650,244650,244651,0,1,2
69977,2,3,244652,244652,244655,0,3,1
69978,2,3,244654,244655,244658,1,4,0
69979,5,3,244659,244659,244662,0,3,1
69980,5,3,244664,244664,244667,0,3,2
69981,3,1,244667,244667,244668,0,1,0
69982,1,2,244668,244668,244670,0,2,0
69983,6,2,244674,244674,244676,0,2,4
69984,4,1,244678,244678,244679,0,1,2
69985,6,2,244684,244684,244686,0,2,5
69986,3,1,244687,244687,244688,0,1,1
69987,4,2,244691,244691,244693,0,2,3
69988,6,2,244697,244697,244699,0,2,4
69989,3,1,244700,244700,244701,0,1,1
69990,4,3,244704,244704,244707,0,3,3
69991,5,2,244709,244709,244711,0,2,2
69992,1,3,244710,244711,244714,1,4,0
69993,2,3,244712,244714,244717,2,5,0
69994,1,3,244713,244717,244720,4,7,0
69995,4,1,244717,244720,244721,3,4,0
69996,6,3,244723,244723,244726,0,3,2
69997,6,3,244729,244729,244732,0,3,3
69998,1,1,244730,244732,244733,2,3,0
69999,4,3,244734,244734,244737,0,3,1
70000,1,3,244735,244737,244740,2,5,0
70001,5,3,244740,244740,244743,0,3,0
70002,5,3,244745,244745,244748,0,3,2
70003,3,2,244748,244748,244750,0,2,0
70004,3,2,244751,244751,244753,0,2,1
70005,1,3,244752,244753,244756,1,4,0
70006,2,3,244754,244756,244759,2,5,0
70007,3,3,244757,244759,244762,2,5,0
70008,4,2,244761,244762,244764,1,3,0
70009,6,2,244767,244767,244769,0,2,3
70010,2,2,244769,244769,244771,0,2,0
70011,4,2,244773,244773,244775,0,2,2
70012,1,1,244774,244775,244776,1,2,0
70013,5,2,244779,244779,244781,0,2,3
70014,3,2,244782,244782,244784,0,2,1
70015,4,2,244786,244786,244788,0,2,2
70016,1,3,244787,244788,244791,1,4,0
70017,5,3,244792,244792,244795,0,3,1
70018,6,2,244798,244798,244800,0,2,3
70019,1,2,244799,244800,244802,1,3,0
70020,4,3,244803,244803,244806,0,3,1
70021,5,3,244808,244808,244811,0,3,2
70022,1,1,244809,244811,244812,2,3,0
70023,3,1,244812,244812,244813,0,1,0
70024,1,3,244813,244813,244816,0,3,0
70025,3,1,244816,244816,244817,0,1,0
70026,2,1,244818,244818,244819,0,1,1
70027,6,2,244824,244824,244826,0,2,5
70028,1,3,244825,244826,244829,1,4,0
70029,5,3,244830,244830,244833,0,3,1
70030,6,1,244836,244836,244837,0,1,3
70031,4,3,244840,244840,244843,0,3,3
70032,1,1,244841,244843,244844,2,3,0
70033,6,2,244847,244847,244849,0,2,3
70034,1,1,244848,244849,244850,1,2,0
70035,5,1,244853,244853,244854,0,1,3
70036,5,1,244858,244858,244859,0,1,4
70037,6,3,244864,244864,244867,0,3,5
70038,1,2,244865,244867,244869,2,4,0
70039,1,2,244866,244869,244871,3,5,0
70040,4,3,244870,244871,244874,1,4,0
70041,6,1,244876,244876,244877,0,1,2
70042,6,2,244882,244882,244884,0,2,5
70043,1,3,244883,244884,244887,1,4,0
70044,2,2,244885,244887,244889,2,4,0
70045,6,1,244891,244891,244892,0,1,2
70046,5,3,244896,244896,244899,0,3,4
70047,5,2,244901,244901,244903,0,2,2
70048,2,2,244903,244903,244905,0,2,0
70049,4,3,244907,244907,244910,0,3,2
70050,3,3,244910,244910,244913,0,3,0
70051,5,2,244915,244915,244917,0,2,2
70052,1,2,244916,244917,244919,1,3,0
70053,5,1,244921,244921,244922,0,1,2
70054,1,2,244922,244922,244924,0,2,0
70055,4,1,244926,244926,244927,0,1,2
70056,2,1,244928,244928,244929,0,1,1
70057,2,2,244930,244930,244932,0,2,1
70058,5,2,244935,244935,244937,0,2,3
70059,1,1,244936,244937,244938,1,2,0
70060,6,1,244942,244942,244943,0,1,4
70061,4,2,244946,244946,244948,0,2,3
70062,5,2,244951,244951,244953,0,2,3
70063,3,3,244954,244954,244957,0,3,1
70064,3,2,244957,244957,244959,0,2,0
70065,1,3,244958,244959,244962,1,4,0
70066,1,2,244959,244962,244964,3,5,0
70067,5,1,244964,244964,244965,0,1,0
70068,2,2,244966,244966,244968,0,2,1
70069,1,3,244967,244968,244971,1,4,0
70070,6,2,244973,244973,244975,0,2,2
70071,4,2,244977,244977,244979,0,2,2
70072,4,1,244981,244981,244982,0,1,2
70073,5,3,244986,244986,244989,0,3,4
70074,4,2,244990,244990,244992,0,2,1
70075,6,2,244996,244996,244998,0,2,4
70076,1,1,244997,244998,244999,1,2,0
70077,4,3,245001,245001,245004,0,3,2
70078,1,3,245002,245004,245007,2,5,0
70079,5,2,245007,245007,245009,0,2,0
70080,5,3,245012,245012,245015,0,3,3
70081,1,2,245013,245015,245017,2,4,0
70082,6,3,245019,245019,245022,0,3,2
70083,4,2,245023,245023,245025,0,2,1
70084,5,1,245028,245028,245029,0,1,3
70085,1,2,245029,245029,245031,0,2,0
70086,2,3,245031,245031,245034,0,3,0
70087,2,2,245033,245034,245036,1,3,0
70088,5,1,245038,245038,245039,0,1,2
70089,2,2,245040,245040,245042,0,2,1
70090,6,1,245046,245046,245047,0,1,4
70091,3,3,245049,245049,245052,0,3,2
70092,6,2,245055,245055,245057,0,2,3
70093,4,2,245059,245059,245061,0,2,2
70094,1,2,245060,245061,245063,1,3,0
70095,5,1,245065,245065,245066,0,1,2
70096,5,1,245070,245070,245071,0,1,4
70097,4,3,245074,245074,245077,0,3,3
70098,6,2,245080,245080,245082,0,2,3
70099,5,1,245085,245085,245086,0,1,3
70100,1,3,245086,245086,245089,0,3,0
70101,6,2,245092,245092,245094,0,2,3
70102,2,1,245094,245094,245095,0,1,0
70103,6,2,245100,245100,245102,0,2,5
70104,1,2,245101,245102,245104,1,3,0
70105,1,2,245102,245104,245106,2,4,0
70106,5,1,245107,245107,245108,0,1,1
70107,1,3,245108,245108,245111,0,3,0
70108,3,3,245111,245111,245114,0,3,0
70109,2,1,245113,245114,245115,1,2,0
70110,5,2,245118,245118,245120,0,2,3
70111,6,1,245124,245124,245125,0,1,4
70112,5,2,245129,245129,245131,0,2,4
70113,6,2,245135,245135,245137,0,2,4
70114,2,2,245137,245137,245139,0,2,0
70115,2,3,245139,245139,245142,0,3,0
70116,3,1,245142,245142,245143,0,1,0
70117,3,1,245145,245145,245146,0,1,2
70118,3,3,245148,245148,245151,0,3,2
70119,5,2,245153,245153,245155,0,2,2
70120,6,1,245159,245159,245160,0,1,4
70121,6,1,245165,245165,245166,0,1,5
70122,1,2,245166,245166,245168,0,2,0
70123,5,1,245171,245171,245172,0,1,3
70124,4,2,245175,245175,245177,0,2,3
70125,3,1,245178,245178,245179,0,1,1
70126,5,3,245183,245183,245186,0,3,4
70127,4,1,245187,245187,245188,0,1,1
70128,4,1,245191,245191,245192,0,1,3
70129,4,3,245195,245195,245198,0,3,3
70130,4,2,245199,245199,245201,0,2,1
70131,5,2,245204,245204,245206,0,2,3
70132,2,2,245206,245206,245208,0,2,0
70133,5,2,245211,245211,245213,0,2,3
70134,3,1,245214,245214,245215,0,1,1
70135,3,2,245217,245217,245219,0,2,2
70136,5,1,245222,245222,245223,0,1,3
70137,3,3,245225,245225,245228,0,3,2
70138,4,2,245229,245229,245231,0,2,1
70139,5,1,245234,245234,245235,0,1,3
70140,3,1,245237,245237,245238,0,1,2
70141,4,2,245241,245241,245243,0,2,3
70142,4,3,245245,245245,245248,0,3,2
70143,2,2,245247,245248,245250,1,3,0
70144,3,2,245250,245250,245252,0,2,0
70145,2,3,245252,245252,245255,0,3,0
70146,2,1,245254,245255,245256,1,2,0
70147,2,3,245256,245256,245259,0,3,0
70148,3,3,245259,245259,245262,0,3,0
70149,2,3,245261,245262,245265,1,4,0
70150,5,3,245266,245266,245269,0,3,1
70151,4,1,245270,245270,245271,0,1,1
70152,1,2,245271,245271,245273,0,2,0
70153,3,2,245274,245274,245276,0,2,1
70154,2,1,245276,245276,245277,0,1,0
70155,3,3,245279,245279,245282,0,3,2
70156,6,3,245285,245285,245288,0,3,3
70157,2,2,245287,245288,245290,1,3,0
70158,1,1,245288,245290,245291,2,3,0
70159,2,3,245290,245291,245294,1,4,0
70160,5,1,245295,245295,245296,0,1,1
70161,5,1,245300,245300,245301,0,1,4
70162,2,2,245302,245302,245304,0,2,1
70163,1,1,245303,245304,245305,1,2,0
70164,1,2,245304,245305,245307,1,3,0
70165,1,2,245305,245307,245309,2,4,0
70166,5,3,245310,245310,245313,0,3,1
70167,6,3,245316,245316,245319,0,3,3
70168,1,2,245317,245319,245321,2,4,0
70169,1,1,245318,245321,245322,3,4,0
70170,4,2,245322,245322,245324,0,2,0
70171,3,3,245325,245325,245328,0,3,1
70172,4,2,245329,245329,245331,0,2,1
70173,5,3,245334,245334,245337,0,3,3
70174,4,2,245338,245338,245340,0,2,1
70175,2,3,245340,245340,245343,0,3,0
70176,4,1,245344,245344,245345,0,1,1
70177,6,2,245350,245350,245352,0,2,5
70178,4,2,245354,245354,245356,0,2,2
70179,6,2,245360,245360,245362,0,2,4
70180,6,2,245366,245366,245368,0,2,4
70181,4,1,245370,245370,245371,0,1,2
70182,6,1,245376,245376,245377,0,1,5
70183,1,2,245377,245377,245379,0,2,0
70184,3,3,245380,245380,245383,0,3,1
70185,5,3,245385,245385,245388,0,3,2
70186,4,2,245389,245389,245391,0,2,1
70187,4,3,245393,245393,245396,0,3,2
70188,2,2,245395,245396,245398,1,3,0
70189,2,1,245397,245398,245399,1,2,0
70190,2,1,245399,245399,245400,0,1,0
70191,6,1,245405,245405,245406,0,1,5
70192,4,3,245409,245409,245412,0,3,3
70193,1,1,245410,245412,245413,2,3,0
70194,6,3,245416,245416,245419,0,3,3
70195,3,2,245419,245419,245421,0,2,0
70196,1,2,245420,245421,245423,1,3,0
70197,1,3,245421,245423,245426,2,5,0
70198,5,3,245426,245426,245429,0,3,0
70199,1,3,245427,245429,245432,2,5,0
70200,2,3,245429,245432,245435,3,6,0
70201,1,3,245430,245435,245438,5,8,0
70202,5,2,245435,245438,245440,3,5,0
70203,1,2,245436,245440,245442,4,6,0
70204,3,1,245439,245442,245443,3,4,0
70205,2,3,245441,245443,245446,2,5,0
70206,5,3,245446,245446,245449,0,3,0
70207,1,2,245447,245449,245451,2,4,0
70208,4,2,245451,245451,245453,0,2,0
70209,4,3,245455,245455,245458,0,3,2
70210,4,1,245459,245459,245460,0,1,1
70211,6,2,245465,245465,245467,0,2,5
70212,2,3,245467,245467,245470,0,3,0
70213,3,3,245470,245470,245473,0,3,0
70214,6,2,245476,245476,245478,0,2,3
70215,1,1,245477,245478,245479,1,2,0
70216,2,3,245479,245479,245482,0,3,0
70217,2,3,245481,245482,245485,1,4,0
70218,3,1,245484,245485,245486,1,2,0
70219,5,1,245489,245489,245490,0,1,3
70220,5,3,245494,245494,245497,0,3,4
70221,5,2,245499,245499,245501,0,2,2
70222,5,3,245504,245504,245507,0,3,3
70223,6,3,245510,245510,245513,0,3,3
70224,1,1,245511,245513,245514,2,3,0
70225,4,1,245515,245515,245516,0,1,1
70226,6,1,245521,245521,245522,0,1,5
70227,3,1,245524,245524,245525,0,1,2
70228,4,2,245528,245528,245530,0,2,3
70229,5,2,245533,245533,245535,0,2,3
70230,5,1,245538,245538,245539,0,1,3
70231,5,1,245543,245543,245544,0,1,4
70232,6,3,245549,245549,245552,0,3,5
70233,2,1,245551,245552,245553,1,2,0
70234,3,3,245554,245554,245557,0,3,1
70235,1,1,245555,245557,245558,2,3,0
70236,4,3,245559,245559,245562,0,3,1
70237,1,3,245560,245562,245565,2,5,0
70238,5,1,245565,245565,245566,0,1,0
70239,2,1,245567,245567,245568,0,1,1
70240,6,2,245573,245573,245575,0,2,5
70241,3,1,245576,245576,245577,0,1,1
70242,6,2,245582,245582,245584,0,2,5
70243,6,1,245588,245588,245589,0,1,4
70244,3,2,245591,245591,245593,0,2,2
70245,3,2,245594,245594,245596,0,2,1
70246,3,3,245597,245597,245600,0,3,1
70247,6,3,245603,245603,245606,0,3,3
70248,1,1,245604,245606,245607,2,3,0
70249,3,3,245607,245607,245610,0,3,0
70250,4,1,245611,245611,245612,0,1,1
70251,1,2,245612,245612,245614,0,2,0
70252,2,1,245614,245614,245615,0,1,0
70253,1,2,245615,245615,245617,0,2,0
70254,4,1,245619,245619,245620,0,1,2
70255,5,1,245624,245624,245625,0,1,4
70256,6,2,245630,245630,245632,0,2,5
70257,1,1,245631,245632,245633,1,2,0
70258,4,2,245635,245635,245637,0,2,2
70259,2,3,245637,245637,245640,0,3,0
70260,5,1,245642,245642,245643,0,1,2
70261,1,1,245643,245643,245644,0,1,0
70262,4,3,245647,245647,245650,0,3,3
70263,6,3,245653,245653,245656,0,3,3
70264,2,1,245655,245656,245657,1,2,0
70265,3,2,245658,245658,245660,0,2,1
70266,3,3,245661,245661,245664,0,3,1
70267,4,1,245665,245665,245666,0,1,1
70268,3,1,245668,245668,245669,0,1,2
70269,3,2,245671,245671,245673,0,2,2
70270,5,2,245676,245676,245678,0,2,3
70271,4,3,245680,245680,245683,0,3,2
70272,4,1,245684,245684,245685,0,1,1
70273,5,2,245689,245689,245691,0,2,4
70274,3,2,245692,245692,245694,0,2,1
70275,1,1,245693,245694,245695,1,2,0
70276,1,1,245694,245695,245696,1,2,0
70277,3,3,245697,245697,245700,0,3,1
70278,6,1,245703,245703,245704,0,1,3
70279,3,3,245706,245706,245709,0,3,2
70280,3,2,245709,245709,245711,0,2,0
70281,3,2,245712,245712,245714,0,2,1
70282,5,3,245717,245717,245720,0,3,3
70283,2,3,245719,245720,245723,1,4,0
70284,2,3,245721,245723,245726,2,5,0
70285,1,2,245722,245726,245728,4,6,0
70286,1,1,245723,245728,245729,5,6,0
70287,6,1,245729,245729,245730,0,1,0
70288,5,1,245734,245734,245735,0,1,4
70289,4,3,245738,245738,245741,0,3,3
70290,6,2,245744,245744,245746,0,2,3
70291,3,3,245747,245747,245750,0,3,1
70292,3,3,245750,245750,245753,0,3,0
70293,3,2,245753,245753,245755,0,2,0
70294,4,2,245757,245757,245759,0,2,2
70295,6,3,245763,245763,245766,0,3,4
70296,5,3,245768,245768,245771,0,3,2
70297,6,1,245774,245774,245775,0,1,3
70298,3,3,245777,245777,245780,0,3,2
70299,2,3,245779,245780,245783,1,4,0
70300,6,3,245785,245785,245788,0,3,2
70301,4,3,245789,245789,245792,0,3,1
70302,6,1,245795,245795,245796,0,1,3
70303,3,2,245798,245798,245800,0,2,2
70304,2,2,245800,245800,245802,0,2,0
70305,4,1,245804,245804,245805,0,1,2
70306,1,1,245805,245805,245806,0,1,0
70307,6,3,245811,245811,245814,0,3,5
70308,4,3,245815,245815,245818,0,3,1
70309,4,1,245819,245819,245820,0,1,1
70310,5,2,245824,245824,245826,0,2,4
70311,3,2,245827,245827,245829,0,2,1
70312,3,1,245830,245830,245831,0,1,1
70313,6,2,245836,245836,245838,0,2,5
70314,6,2,245842,245842,245844,0,2,4
70315,3,2,245845,245845,245847,0,2,1
70316,3,2,245848,245848,245850,0,2,1
70317,4,1,245852,245852,245853,0,1,2
70318,2,1,245854,245854,245855,0,1,1
70319,2,3,245856,245856,245859,0,3,1
70320,2,3,245858,245859,245862,1,4,0
70321,5,1,245863,245863,245864,0,1,1
70322,1,1,245864,245864,245865,0,1,0
70323,1,1,245865,245865,245866,0,1,0
70324,3,1,245868,245868,245869,0,1,2
70325,6,1,245874,245874,245875,0,1,5
70326,5,3,245879,245879,245882,0,3,4
70327,2,1,245881,245882,245883,1,2,0
70328,2,1,245883,245883,245884,0,1,0
70329,1,3,245884,245884,245887,0,3,0
70330,1,2,245885,245887,245889,2,4,0
70331,3,2,245888,245889,245891,1,3,0
70332,6,3,245894,245894,245897,0,3,3
70333,6,2,245900,245900,245902,0,2,3
70334,3,2,245903,245903,245905,0,2,1
70335,3,2,245906,245906,245908,0,2,1
70336,1,1,245907,245908,245909,1,2,0
70337,5,2,245912,245912,245914,0,2,3
70338,5,3,245917,245917,245920,0,3,3
70339,4,3,245921,245921,245924,0,3,1
70340,3,3,245924,245924,245927,0,3,0
70341,6,3,245930,245930,245933,0,3,3
70342,4,3,245934,245934,245937,0,3,1
70343,4,1,245938,245938,245939,0,1,1
70344,1,3,245939,245939,245942,0,3,0
70345,2,1,245941,245942,245943,1,2,0
70346,5,3,245946,245946,245949,0,3,3
70347,4,3,245950,245950,245953,0,3,1
70348,4,3,245954,245954,245957,0,3,1
70349,1,1,245955,245957,245958,2,3,0
70350,3,1,245958,245958,245959,0,1,0
70351,2,1,245960,245960,245961,0,1,1
70352,5,3,245965,245965,245968,0,3,4
70353,5,3,245970,245970,245973,0,3,2
70354,6,2,245976,245976,245978,0,2,3
70355,6,3,245982,245982,245985,0,3,4
70356,2,3,245984,245985,245988,1,4,0
70357,3,1,245987,245988,245989,1,2,0
70358,1,2,245988,245989,245991,1,3,0
70359,6,3,245994,245994,245997,0,3,3
70360,4,3,245998,245998,246001,0,3,1
70361,3,3,246001,246001,246004,0,3,0
70362,6,3,246007,246007,246010,0,3,3
70363,6,2,246013,246013,246015,0,2,3
70364,5,3,246018,246018,246021,0,3,3
70365,5,3,246023,246023,246026,0,3,2
70366,3,3,246026,246026,246029,0,3,0
70367,5,3,246031,246031,246034,0,3,2
70368,3,2,246034,246034,246036,0,2,0
70369,1,3,246035,246036,246039,1,4,0
70370,5,2,246040,246040,246042,0,2,1
70371,5,1,246045,246045,246046,0,1,3
70372,6,1,246051,246051,246052,0,1,5
70373,5,1,246056,246056,246057,0,1,4
70374,3,3,246059,246059,246062,0,3,2
70375,4,2,246063,246063,246065,0,2,1
70376,2,2,246065,246065,246067,0,2,0
70377,1,2,246066,246067,246069,1,3,0
70378,2,1,246068,246069,246070,1,2,0
70379,5,1,246073,246073,246074,0,1,3
70380,3,1,246076,246076,246077,0,1,2
70381,5,3,246081,246081,246084,0,3,4
70382,3,2,246084,246084,246086,0,2,0
70383,4,3,246088,246088,246091,0,3,2
70384,6,1,246094,246094,246095,0,1,3
70385,6,2,246100,246100,246102,0,2,5
70386,3,1,246103,246103,246104,0,1,1
70387,5,1,246108,246108,246109,0,1,4
70388,5,3,246113,246113,246116,0,3,4
70389,4,2,246117,246117,246119,0,2,1
70390,2,2,246119,246119,246121,0,2,0
70391,2,1,246121,246121,246122,0,1,0
70392,4,1,246125,246125,246126,0,1,3
70393,6,2,246131,246131,246133,0,2,5
70394,6,2,246137,246137,246139,0,2,4
70395,2,1,246139,246139,246140,0,1,0
70396,3,1,246142,246142,246143,0,1,2
70397,1,1,246143,246143,246144,0,1,0
70398,2,3,246145,246145,246148,0,3,1
70399,3,1,246148,246148,246149,0,1,0
70400,2,3,246150,246150,246153,0,3,1
70401,4,1,246154,246154,246155,0,1,1
70402,3,1,246157,246157,246158,0,1,2
70403,4,2,246161,246161,246163,0,2,3
70404,5,2,246166,246166,246168,0,2,3
70405,6,3,246172,246172,246175,0,3,4
70406,5,2,246177,246177,246179,0,2,2
70407,2,3,246179,246179,246182,0,3,0
70408,4,2,246183,246183,246185,0,2,1
70409,2,2,246185,246185,246187,0,2,0
70410,3,3,246188,246188,246191,0,3,1
70411,6,2,246194,246194,246196,0,2,3
70412,2,2,246196,246196,246198,0,2,0
70413,2,2,246198,246198,246200,0,2,0
70414,6,1,246204,246204,246205,0,1,4
70415,2,3,246206,246206,246209,0,3,1
70416,6,1,246212,246212,246213,0,1,3
70417,6,2,246218,246218,246220,0,2,5
70418,1,2,246219,246220,246222,1,3,0
70419,2,2,246221,246222,246224,1,3,0
70420,5,1,246226,246226,246227,0,1,2
70421,5,1,246231,246231,246232,0,1,4
70422,6,3,246237,246237,246240,0,3,5
70423,1,3,246238,246240,246243,2,5,0
70424,2,3,246240,246243,246246,3,6,0
70425,5,1,246245,246246,246247,1,2,0
70426,1,2,246246,246247,246249,1,3,0
70427,2,3,246248,246249,246252,1,4,0
70428,2,2,246250,246252,246254,2,4,0
70429,6,2,246256,246256,246258,0,2,2
70430,6,3,246262,246262,246265,0,3,4
70431,2,1,246264,246265,246266,1,2,0
70432,6,1,246270,246270,246271,0,1,4
70433,5,2,246275,246275,246277,0,2,4
70434,1,1,246276,246277,246278,1,2,0
70435,3,3,246279,246279,246282,0,3,1
70436,3,2,246282,246282,246284,0,2,0
70437,4,3,246286,246286,246289,0,3,2
70438,6,2,246292,246292,246294,0,2,3
70439,2,2,246294,246294,246296,0,2,0
70440,2,1,246296,246296,246297,0,1,0
70441,5,1,246301,246301,246302,0,1,4
70442,5,3,246306,246306,246309,0,3,4
70443,3,3,246309,246309,246312,0,3,0
70444,2,1,246311,246312,246313,1,2,0
70445,4,2,246315,246315,246317,0,2,2
70446,4,2,246319,246319,246321,0,2,2
70447,4,2,246323,246323,246325,0,2,2
70448,6,3,246329,246329,246332,0,3,4
70449,6,3,246335,246335,246338,0,3,3
70450,4,1,246339,246339,246340,0,1,1
70451,2,3,246341,246341,246344,0,3,1
70452,3,3,246344,246344,246347,0,3,0
70453,5,1,246349,246349,246350,0,1,2
70454,5,3,246354,246354,246357,0,3,4
70455,4,3,246358,246358,246361,0,3,1
70456,3,1,246361,246361,246362,0,1,0
70457,4,3,246365,246365,246368,0,3,3
70458,6,3,246371,246371,246374,0,3,3
70459,3,2,246374,246374,246376,0,2,0
70460,4,1,246378,246378,246379,0,1,2
70461,2,3,246380,246380,246383,0,3,1
70462,6,3,246386,246386,246389,0,3,3
70463,3,1,246389,246389,246390,0,1,0
70464,3,3,246392,246392,246395,0,3,2
70465,3,1,246395,246395,246396,0,1,0
70466,2,3,246397,246397,246400,0,3,1
70467,4,3,246401,246401,246404,0,3,1
70468,4,1,246405,246405,246406,0,1,1
70469,3,1,246408,246408,246409,0,1,2
70470,6,1,246414,246414,246415,0,1,5
70471,6,1,246420,246420,246421,0,1,5
70472,1,1,246421,246421,246422,0,1,0
70473,3,1,246424,246424,246425,0,1,2
70474,4,1,246428,246428,246429,0,1,3
70475,6,2,246434,246434,246436,0,2,5
70476,4,1,246438,246438,246439,0,1,2
70477,5,3,246443,246443,246446,0,3,4
70478,2,3,246445,246446,246449,1,4,0
70479,6,3,246451,246451,246454,0,3,2
70480,3,1,246454,246454,246455,0,1,0
70481,1,1,246455,246455,246456,0,1,0
70482,1,1,246456,246456,246457,0,1,0
70483,4,3,246460,246460,246463,0,3,3
70484,1,1,246461,246463,246464,2,3,0
70485,1,2,246462,246464,246466,2,4,0
70486,5,2,246467,246467,246469,0,2,1
70487,4,3,246471,246471,246474,0,3,2
70488,4,2,246475,246475,246477,0,2,1
70489,1,2,246476,246477,246479,1,3,0
70490,2,1,246478,246479,246480,1,2,0
70491,3,2,246481,246481,246483,0,2,1
70492,3,1,246484,246484,246485,0,1,1
70493,2,2,246486,246486,246488,0,2,1
70494,6,3,246492,246492,246495,0,3,4
70495,6,1,246498,246498,246499,0,1,3
70496,5,1,246503,246503,246504,0,1,4
70497,5,3,246508,246508,246511,0,3,4
70498,2,1,246510,246511,246512,1,2,0
70499,6,2,246516,246516,246518,0,2,4
70500,3,1,246519,246519,246520,0,1,1
70501,3,1,246522,246522,246523,0,1,2
70502,6,2,246528,246528,246530,0,2,5
70503,6,1,246534,246534,246535,0,1,4
70504,3,3,246537,246537,246540,0,3,2
70505,2,3,246539,246540,246543,1,4,0
70506,6,2,246545,246545,246547,0,2,2
70507,4,1,246549,246549,246550,0,1,2
70508,6,2,246555,246555,246557,0,2,5
70509,2,2,246557,246557,246559,0,2,0
70510,4,2,246561,246561,246563,0,2,2
70511,4,2,246565,246565,246567,0,2,2
70512,3,1,246568,246568,246569,0,1,1
70513,2,1,246570,246570,246571,0,1,1
70514,4,3,246574,246574,246577,0,3,3
70515,5,1,246579,246579,246580,0,1,2
70516,3,1,246582,246582,246583,0,1,2
70517,1,2,246583,246583,246585,0,2,0
70518,1,2,246584,246585,246587,1,3,0
70519,2,1,246586,246587,246588,1,2,0
70520,3,1,246589,246589,246590,0,1,1
70521,4,2,246593,246593,246595,0,2,3
70522,4,3,246597,246597,246600,0,3,2
70523,4,2,246601,246601,246603,0,2,1
70524,4,2,246605,246605,246607,0,2,2
70525,1,2,246606,246607,246609,1,3,0
70526,6,2,246612,246612,246614,0,2,3
70527,3,2,246615,246615,246617,0,2,1
70528,3,2,246618,246618,246620,0,2,1
70529,5,1,246623,246623,246624,0,1,3
70530,4,1,246627,246627,246628,0,1,3
70531,4,2,246631,246631,246633,0,2,3
70532,3,2,246634,246634,246636,0,2,1
70533,2,1,246636,246636,246637,0,1,0
70534,4,1,246640,246640,246641,0,1,3
70535,3,2,246643,246643,246645,0,2,2
70536,2,1,246645,246645,246646,0,1,0
70537,2,3,246647,246647,246650,0,3,1
70538,3,2,246650,246650,246652,0,2,0
70539,6,2,246656,246656,246658,0,2,4
70540,5,1,246661,246661,246662,0,1,3
70541,6,2,246667,246667,246669,0,2,5
70542,4,3,246671,246671,246674,0,3,2
70543,4,1,246675,246675,246676,0,1,1
70544,4,1,246679,246679,246680,0,1,3
70545,1,2,246680,246680,246682,0,2,0
70546,5,3,246685,246685,246688,0,3,3
70547,2,1,246687,246688,246689,1,2,0
70548,1,1,246688,246689,246690,1,2,0
70549,4,1,246692,246692,246693,0,1,2
70550,2,2,246694,246694,246696,0,2,1
70551,2,1,246696,246696,246697,0,1,0
70552,4,3,246700,246700,246703,0,3,3
70553,3,3,246703,246703,246706,0,3,0
70554,1,3,246704,246706,246709,2,5,0
70555,6,1,246710,246710,246711,0,1,1
70556,5,3,246715,246715,246718,0,3,4
70557,6,3,246721,246721,246724,0,3,3
70558,4,2,246725,246725,246727,0,2,1
70559,6,3,246731,246731,246734,0,3,4
70560,5,2,246736,246736,246738,0,2,2
70561,5,2,246741,246741,246743,0,2,3
70562,2,2,246743,246743,246745,0,2,0
70563,3,2,246746,246746,246748,0,2,1
70564,5,2,246751,246751,246753,0,2,3
70565,1,2,246752,246753,246755,1,3,0
70566,4,1,246756,246756,246757,0,1,1
70567,4,3,246760,246760,246763,0,3,3
70568,1,1,246761,246763,246764,2,3,0
70569,4,2,246765,246765,246767,0,2,1
70570,5,3,246770,246770,246773,0,3,3
70571,4,2,246774,246774,246776,0,2,1
70572,4,3,246778,246778,246781,0,3,2
70573,5,3,246783,246783,246786,0,3,2
70574,4,1,246787,246787,246788,0,1,1
70575,6,1,246793,246793,246794,0,1,5
70576,1,3,246794,246794,246797,0,3,0
70577,3,1,246797,246797,246798,0,1,0
70578,4,3,246801,246801,246804,0,3,3
70579,1,1,246802,246804,246805,2,3,0
70580,1,3,246803,246805,246808,2,5,0
70581,5,1,246808,246808,246809,0,1,0
70582,5,3,246813,246813,246816,0,3,4
70583,4,3,246817,246817,246820,0,3,1
70584,2,3,246819,246820,246823,1,4,0
70585,1,1,246820,246823,246824,3,4,0
70586,5,2,246825,246825,246827,0,2,1
70587,4,3,246829,246829,246832,0,3,2
70588,3,2,246832,246832,246834,0,2,0
70589,5,2,246837,246837,246839,0,2,3
70590,2,1,246839,246839,246840,0,1,0
70591,1,1,246840,246840,246841,0,1,0
70592,6,3,246846,246846,246849,0,3,5
70593,3,3,246849,246849,246852,0,3,0
70594,6,1,246855,246855,246856,0,1,3
70595,1,1,246856,246856,246857,0,1,0
70596,6,2,246862,246862,246864,0,2,5
70597,4,1,246866,246866,246867,0,1,2
70598,4,2,246870,246870,246872,0,2,3
70599,1,1,246871,246872,246873,1,2,0
70600,4,2,246875,246875,246877,0,2,2
70601,4,1,246879,246879,246880,0,1,2
70602,2,2,246881,246881,246883,0,2,1
70603,2,1,246883,246883,246884,0,1,0
70604,4,2,246887,246887,246889,0,2,3
70605,6,3,246893,246893,246896,0,3,4
70606,4,3,246897,246897,246900,0,3,1
70607,4,1,246901,246901,246902,0,1,1
70608,3,2,246904,246904,246906,0,2,2
70609,2,3,246906,246906,246909,0,3,0
70610,3,1,246909,246909,246910,0,1,0
70611,2,3,246911,246911,246914,0,3,1
70612,4,1,246915,246915,246916,0,1,1
70613,3,2,246918,246918,246920,0,2,2
70614,4,2,246922,246922,246924,0,2,2
70615,1,1,246923,246924,246925,1,2,0
70616,1,1,246924,246925,246926,1,2,0
70617,3,1,246927,246927,246928,0,1,1
70618,1,3,246928,246928,246931,0,3,0
70619,1,3,246929,246931,246934,2,5,0
70620,4,2,246933,246934,246936,1,3,0
70621,3,2,246936,246936,246938,0,2,0
70622,2,1,246938,246938,246939,0,1,0
70623,3,1,246941,246941,246942,0,1,2
70624,5,3,246946,246946,246949,0,3,4
70625,3,2,246949,246949,246951,0,2,0
70626,2,2,246951,246951,246953,0,2,0
70627,6,3,246957,246957,246960,0,3,4
70628,4,3,246961,246961,246964,0,3,1
70629,3,2,246964,246964,246966,0,2,0
70630,2,2,246966,246966,246968,0,2,0
70631,3,2,246969,246969,246971,0,2,1
70632,2,1,246971,246971,246972,0,1,0
70633,3,2,246974,246974,246976,0,2,2
70634,6,3,246980,246980,246983,0,3,4
70635,1,3,246981,246983,246986,2,5,0
70636,5,2,246986,246986,246988,0,2,0
70637,3,1,246989,246989,246990,0,1,1
70638,1,3,246990,246990,246993,0,3,0
70639,6,2,246996,246996,246998,0,2,3
70640,1,2,246997,246998,247000,1,3,0
70641,2,1,246999,247000,247001,1,2,0
70642,6,1,247005,247005,247006,0,1,4
70643,3,3,247008,247008,247011,0,3,2
70644,3,3,247011,247011,247014,0,3,0
70645,3,3,247014,247014,247017,0,3,0
70646,4,2,247018,247018,247020,0,2,1
70647,1,2,247019,247020,247022,1,3,0
70648,6,3,247025,247025,247028,0,3,3
70649,6,3,247031,247031,247034,0,3,3
70650,5,2,247036,247036,247038,0,2,2
70651,3,1,247039,247039,247040,0,1,1
70652,1,3,247040,247040,247043,0,3,0
70653,5,1,247045,247045,247046,0,1,2
70654,5,3,247050,247050,247053,0,3,4
70655,2,2,247052,247053,247055,1,3,0
70656,2,3,247054,247055,247058,1,4,0
70657,4,3,247058,247058,247061,0,3,0
70658,1,2,247059,247061,247063,2,4,0
70659,2,2,247061,247063,247065,2,4,0
70660,4,3,247065,247065,247068,0,3,0
70661,2,3,247067,247068,247071,1,4,0
70662,1,2,247068,247071,247073,3,5,0
70663,4,2,247072,247073,247075,1,3,0
70664,2,2,247074,247075,247077,1,3,0
70665,2,3,247076,247077,247080,1,4,0
70666,1,1,247077,247080,247081,3,4,0
70667,4,2,247081,247081,247083,0,2,0
70668,5,3,247086,247086,247089,0,3,3
70669,1,3,247087,247089,247092,2,5,0
70670,4,1,247091,247092,247093,1,2,0
70671,1,3,247092,247093,247096,1,4,0
70672,2,1,247094,247096,247097,2,3,0
70673,6,2,247100,247100,247102,0,2,3
70674,6,1,247106,247106,247107,0,1,4
70675,6,1,247112,247112,247113,0,1,5
70676,3,2,247115,247115,247117,0,2,2
70677,6,1,247121,247121,247122,0,1,4
70678,5,3,247126,247126,247129,0,3,4
70679,2,2,247128,247129,247131,1,3,0
70680,6,1,247134,247134,247135,0,1,3
70681,6,1,247140,247140,247141,0,1,5
70682,6,1,247146,247146,247147,0,1,5
70683,1,1,247147,247147,247148,0,1,0
70684,6,1,247153,247153,247154,0,1,5
70685,5,3,247158,247158,247161,0,3,4
70686,5,2,247163,247163,247165,0,2,2
70687,5,1,247168,247168,247169,0,1,3
70688,2,3,247170,247170,247173,0,3,1
70689,2,3,247172,247173,247176,1,4,0
70690,4,2,247176,247176,247178,0,2,0
70691,1,2,247177,247178,247180,1,3,0
70692,1,1,247178,247180,247181,2,3,0
70693,5,2,247183,247183,247185,0,2,2
70694,4,3,247187,247187,247190,0,3,2
70695,6,1,247193,247193,247194,0,1,3
70696,1,1,247194,247194,247195,0,1,0
70697,3,2,247197,247197,247199,0,2,2
70698,5,3,247202,247202,247205,0,3,3
70699,4,3,247206,247206,247209,0,3,1
70700,6,1,247212,247212,247213,0,1,3
70701,6,1,247218,247218,247219,0,1,5
70702,3,3,247221,247221,247224,0,3,2
70703,4,2,247225,247225,247227,0,2,1
70704,2,2,247227,247227,247229,0,2,0
70705,4,1,247231,247231,247232,0,1,2
70706,3,3,247234,247234,247237,0,3,2
70707,5,2,247239,247239,247241,0,2,2
70708,1,3,247240,247241,247244,1,4,0
70709,3,2,247243,247244,247246,1,3,0
70710,6,1,247249,247249,247250,0,1,3
70711,2,2,247251,247251,247253,0,2,1
70712,4,3,247255,247255,247258,0,3,2
70713,5,3,247260,247260,247263,0,3,2
70714,6,3,247266,247266,247269,0,3,3
70715,1,3,247267,247269,247272,2,5,0
70716,6,1,247273,247273,247274,0,1,1
70717,3,2,247276,247276,247278,0,2,2
70718,4,2,247280,247280,247282,0,2,2
70719,5,1,247285,247285,247286,0,1,3
70720,6,1,247291,247291,247292,0,1,5
70721,4,2,247295,247295,247297,0,2,3
70722,6,3,247301,247301,247304,0,3,4
70723,5,2,247306,247306,247308,0,2,2
70724,2,3,247308,247308,247311,0,3,0
70725,6,1,247314,247314,247315,0,1,3
70726,5,1,247319,247319,247320,0,1,4
70727,4,1,247323,247323,247324,0,1,3
70728,3,2,247326,247326,247328,0,2,2
70729,5,2,247331,247331,247333,0,2,3
70730,6,2,247337,247337,247339,0,2,4
70731,4,2,247341,247341,247343,0,2,2
70732,4,3,247345,247345,247348,0,3,2
70733,3,2,247348,247348,247350,0,2,0
70734,2,2,247350,247350,247352,0,2,0
70735,1,3,247351,247352,247355,1,4,0
70736,4,1,247355,247355,247356,0,1,0
70737,5,1,247360,247360,247361,0,1,4
70738,6,3,247366,247366,247369,0,3,5
70739,1,3,247367,247369,247372,2,5,0
70740,2,2,247369,247372,247374,3,5,0
70741,6,3,247375,247375,247378,0,3,1
70742,4,1,247379,247379,247380,0,1,1
70743,5,3,247384,247384,247387,0,3,4
70744,5,1,247389,247389,247390,0,1,2
70745,5,3,247394,247394,247397,0,3,4
70746,2,1,247396,247397,247398,1,2,0
70747,1,1,247397,247398,247399,1,2,0
70748,3,3,247400,247400,247403,0,3,1
70749,5,1,247405,247405,247406,0,1,2
70750,1,1,247406,247406,247407,0,1,0
70751,6,3,247412,247412,247415,0,3,5
70752,4,2,247416,247416,247418,0,2,1
70753,1,2,247417,247418,247420,1,3,0
70754,2,1,247419,247420,247421,1,2,0
70755,6,2,247425,247425,247427,0,2,4
70756,3,3,247428,247428,247431,0,3,1
70757,5,2,247433,247433,247435,0,2,2
70758,3,2,247436,247436,247438,0,2,1
70759,1,1,247437,247438,247439,1,2,0
70760,6,2,247443,247443,247445,0,2,4
70761,1,2,247444,247445,247447,1,3,0
70762,5,2,247449,247449,247451,0,2,2
70763,5,3,247454,247454,247457,0,3,3
70764,3,3,247457,247457,247460,0,3,0
70765,1,2,247458,247460,247462,2,4,0
70766,1,3,247459,247462,247465,3,6,0
70767,6,2,247465,247465,247467,0,2,0
70768,1,1,247466,247467,247468,1,2,0
70769,4,3,247470,247470,247473,0,3,2
70770,6,1,247476,247476,247477,0,1,3
70771,1,3,247477,247477,247480,0,3,0
70772,3,1,247480,247480,247481,0,1,0
70773,5,2,247485,247485,247487,0,2,4
70774,5,1,247490,247490,247491,0,1,3
70775,6,1,247496,247496,247497,0,1,5
70776,4,1,247500,247500,247501,0,1,3
70777,3,2,247503,247503,247505,0,2,2
70778,5,1,247508,247508,247509,0,1,3
70779,3,1,247511,247511,247512,0,1,2
70780,3,1,247514,247514,247515,0,1,2
70781,3,3,247517,247517,247520,0,3,2
70782,4,1,247521,247521,247522,0,1,1
70783,2,1,247523,247523,247524,0,1,1
70784,4,2,247527,247527,247529,0,2,3
70785,4,1,247531,247531,247532,0,1,2
70786,5,1,247536,247536,247537,0,1,4
70787,4,1,247540,247540,247541,0,1,3
70788,6,2,247546,247546,247548,0,2,5
70789,1,1,247547,247548,247549,1,2,0
70790,3,2,247550,247550,247552,0,2,1
70791,3,3,247553,247553,247556,0,3,1
70792,1,3,247554,247556,247559,2,5,0
70793,4,3,247558,247559,247562,1,4,0
70794,2,1,247560,247562,247563,2,3,0
70795,1,3,247561,247563,247566,2,5,0
70796,3,3,247564,247566,247569,2,5,0
70797,6,2,247570,247570,247572,0,2,1
70798,3,2,247573,247573,247575,0,2,1
70799,5,3,247578,247578,247581,0,3,3
70800,6,2,247584,247584,247586,0,2,3
70801,2,2,247586,247586,247588,0,2,0
70802,4,2,247590,247590,247592,0,2,2
70803,6,3,247596,247596,247599,0,3,4
70804,3,3,247599,247599,247602,0,3,0
70805,4,1,247603,247603,247604,0,1,1
70806,1,2,247604,247604,247606,0,2,0
70807,4,3,247608,247608,247611,0,3,2
70808,2,2,247610,247611,247613,1,3,0
70809,3,3,247613,247613,247616,0,3,0
70810,6,2,247619,247619,247621,0,2,3
70811,1,1,247620,247621,247622,1,2,0
70812,6,1,247626,247626,247627,0,1,4
70813,5,1,247631,247631,247632,0,1,4
70814,5,2,247636,247636,247638,0,2,4
70815,4,2,247640,247640,247642,0,2,2
70816,6,2,247646,247646,247648,0,2,4
70817,3,2,247649,247649,247651,0,2,1
70818,5,2,247654,247654,247656,0,2,3
70819,3,3,247657,247657,247660,0,3,1
70820,1,2,247658,247660,247662,2,4,0
70821,5,3,247663,247663,247666,0,3,1
70822,2,3,247665,247666,247669,1,4,0
70823,4,2,247669,247669,247671,0,2,0
70824,1,1,247670,247671,247672,1,2,0
70825,6,3,247676,247676,247679,0,3,4
70826,1,3,247677,247679,247682,2,5,0
70827,6,3,247683,247683,247686,0,3,1
70828,6,3,247689,247689,247692,0,3,3
70829,3,1,247692,247692,247693,0,1,0
70830,3,3,247695,247695,247698,0,3,2
70831,2,3,247697,247698,247701,1,4,0
70832,2,3,247699,247701,247704,2,5,0
70833,1,2,247700,247704,247706,4,6,0
70834,1,1,247701,247706,247707,5,6,0
70835,1,3,247702,247707,247710,5,8,0
70836,1,1,247703,247710,247711,7,8,0
70837,6,2,247709,247711,247713,2,4,0
70838,1,3,247710,247713,247716,3,6,0
70839,3,1,247713,247716,247717,3,4,0
70840,4,3,247717,247717,247720,0,3,0
70841,4,1,247721,247721,247722,0,1,1
70842,6,2,247727,247727,247729,0,2,5
70843,2,3,247729,247729,247732,0,3,0
70844,2,3,247731,247732,247735,1,4,0
70845,6,2,247737,247737,247739,0,2,2
70846,2,3,247739,247739,247742,0,3,0
70847,1,1,247740,247742,247743,2,3,0
70848,5,1,247745,247745,247746,0,1,2
70849,3,3,247748,247748,247751,0,3,2
70850,3,3,247751,247751,247754,0,3,0
70851,6,3,247757,247757,247760,0,3,3
70852,2,2,247759,247760,247762,1,3,0
70853,6,3,247765,247765,247768,0,3,3
70854,5,2,247770,247770,247772,0,2,2
70855,2,3,247772,247772,247775,0,3,0
70856,4,1,247776,247776,247777,0,1,1
70857,1,1,247777,247777,247778,0,1,0
70858,6,3,247783,247783,247786,0,3,5
70859,3,3,247786,247786,247789,0,3,0
70860,3,3,247789,247789,247792,0,3,0
70861,2,1,247791,247792,247793,1,2,0
70862,1,3,247792,247793,247796,1,4,0
70863,1,1,247793,247796,247797,3,4,0
70864,4,3,247797,247797,247800,0,3,0
70865,6,2,247803,247803,247805,0,2,3
70866,2,3,247805,247805,247808,0,3,0
70867,6,2,247811,247811,247813,0,2,3
70868,6,1,247817,247817,247818,0,1,4
70869,2,1,247819,247819,247820,0,1,1
70870,5,3,247824,247824,247827,0,3,4
70871,5,2,247829,247829,247831,0,2,2
70872,5,1,247834,247834,247835,0,1,3
70873,5,3,247839,247839,247842,0,3,4
70874,4,1,247843,247843,247844,0,1,1
70875,4,1,247847,247847,247848,0,1,3
70876,4,2,247851,247851,247853,0,2,3
70877,6,3,247857,247857,247860,0,3,4
70878,4,3,247861,247861,247864,0,3,1
70879,6,2,247867,247867,247869,0,2,3
70880,4,2,247871,247871,247873,0,2,2
70881,1,2,247872,247873,247875,1,3,0
70882,3,2,247875,247875,247877,0,2,0
70883,3,2,247878,247878,247880,0,2,1
70884,2,2,247880,247880,247882,0,2,0
70885,6,1,247886,247886,247887,0,1,4
70886,2,1,247888,247888,247889,0,1,1
70887,6,1,247894,247894,247895,0,1,5
70888,4,3,247898,247898,247901,0,3,3
70889,4,2,247902,247902,247904,0,2,1
70890,5,1,247907,247907,247908,0,1,3
70891,3,2,247910,247910,247912,0,2,2
70892,4,2,247914,247914,247916,0,2,2
70893,5,2,247919,247919,247921,0,2,3
70894,3,2,247922,247922,247924,0,2,1
70895,4,3,247926,247926,247929,0,3,2
70896,1,1,247927,247929,247930,2,3,0
70897,4,2,247931,247931,247933,0,2,1
70898,4,3,247935,247935,247938,0,3,2
70899,1,3,247936,247938,247941,2,5,0
70900,4,2,247940,247941,247943,1,3,0
70901,6,2,247946,247946,247948,0,2,3
70902,5,3,247951,247951,247954,0,3,3
70903,4,2,247955,247955,247957,0,2,1
70904,6,1,247961,247961,247962,0,1,4
70905,3,2,247964,247964,247966,0,2,2
70906,2,3,247966,247966,247969,0,3,0
70907,1,3,247967,247969,247972,2,5,0
70908,5,3,247972,247972,247975,0,3,0
70909,1,1,247973,247975,247976,2,3,0
70910,6,3,247979,247979,247982,0,3,3
70911,2,2,247981,247982,247984,1,3,0
70912,3,3,247984,247984,247987,0,3,0
70913,4,2,247988,247988,247990,0,2,1
70914,2,1,247990,247990,247991,0,1,0
70915,2,3,247992,247992,247995,0,3,1
70916,1,2,247993,247995,247997,2,4,0
70917,4,1,247997,247997,247998,0,1,0
70918,2,2,247999,247999,248001,0,2,1
70919,4,1,248003,248003,248004,0,1,2
70920,6,1,248009,248009,248010,0,1,5
70921,3,1,248012,248012,248013,0,1,2
70922,2,3,248014,248014,248017,0,3,1
70923,4,2,248018,248018,248020,0,2,1
70924,2,2,248020,248020,248022,0,2,0
70925,2,3,248022,248022,248025,0,3,0
70926,2,3,248024,248025,248028,1,4,0
70927,2,2,248026,248028,248030,2,4,0
70928,6,3,248032,248032,248035,0,3,2
70929,2,3,248034,248035,248038,1,4,0
70930,1,2,248035,248038,248040,3,5,0
70931,6,1,248041,248041,248042,0,1,1
70932,6,1,248047,248047,248048,0,1,5
70933,5,1,248052,248052,248053,0,1,4
70934,6,3,248058,248058,248061,0,3,5
70935,2,1,248060,248061,248062,1,2,0
70936,1,1,248061,248062,248063,1,2,0
70937,5,1,248066,248066,248067,0,1,3
70938,3,1,248069,248069,248070,0,1,2
70939,5,3,248074,248074,248077,0,3,4
70940,6,1,248080,248080,248081,0,1,3
70941,5,1,248085,248085,248086,0,1,4
70942,2,3,248087,248087,248090,0,3,1
70943,3,1,248090,248090,248091,0,1,0
70944,4,1,248094,248094,248095,0,1,3
70945,5,3,248099,248099,248102,0,3,4
70946,2,1,248101,248102,248103,1,2,0
70947,5,3,248106,248106,248109,0,3,3
70948,3,3,248109,248109,248112,0,3,0
70949,4,2,248113,248113,248115,0,2,1
70950,5,3,248118,248118,248121,0,3,3
70951,3,1,248121,248121,248122,0,1,0
70952,4,2,248125,248125,248127,0,2,3
70953,5,3,248130,248130,248133,0,3,3
70954,6,3,248136,248136,248139,0,3,3
70955,5,3,248141,248141,248144,0,3,2
70956,1,2,248142,248144,248146,2,4,0
70957,6,1,248148,248148,248149,0,1,2
70958,2,1,248150,248150,248151,0,1,1
70959,2,1,248152,248152,248153,0,1,1
70960,2,2,248154,248154,248156,0,2,1
70961,6,2,248160,248160,248162,0,2,4
70962,5,2,248165,248165,248167,0,2,3
70963,2,3,248167,248167,248170,0,3,0
70964,1,2,248168,248170,248172,2,4,0
70965,1,2,248169,248172,248174,3,5,0
70966,1,1,248170,248174,248175,4,5,0
70967,2,1,248172,248175,248176,3,4,0
70968,3,1,248175,248176,248177,1,2,0
70969,6,2,248181,248181,248183,0,2,4
70970,5,2,248186,248186,248188,0,2,3
70971,6,1,248192,248192,248193,0,1,4
70972,5,3,248197,248197,248200,0,3,4
70973,6,2,248203,248203,248205,0,2,3
70974,2,2,248205,248205,248207,0,2,0
70975,2,3,248207,248207,248210,0,3,0
70976,1,2,248208,248210,248212,2,4,0
70977,3,1,248211,248212,248213,1,2,0
70978,2,3,248213,248213,248216,0,3,0
70979,1,2,248214,248216,248218,2,4,0
70980,2,2,248216,248218,248220,2,4,0
70981,2,2,248218,248220,248222,2,4,0
70982,5,2,248223,248223,248225,0,2,1
70983,3,3,248226,248226,248229,0,3,1
70984,5,3,248231,248231,248234,0,3,2
70985,2,2,248233,248234,248236,1,3,0
70986,3,2,248236,248236,248238,0,2,0
70987,3,1,248239,248239,248240,0,1,1
70988,5,2,248244,248244,248246,0,2,4
70989,2,3,248246,248246,248249,0,3,0
70990,6,2,248252,248252,248254,0,2,3
70991,3,1,248255,248255,248256,0,1,1
70992,2,2,248257,248257,248259,0,2,1
70993,6,3,248263,248263,248266,0,3,4
70994,6,2,248269,248269,248271,0,2,3
70995,5,3,248274,248274,248277,0,3,3
70996,4,3,248278,248278,248281,0,3,1
70997,1,3,248279,248281,248284,2,5,0
70998,1,3,248280,248284,248287,4,7,0
70999,2,2,248282,248287,248289,5,7,0
71000,3,1,248285,248289,248290,4,5,0
71001,2,2,248287,248290,248292,3,5,0
71002,1,1,248288,248292,248293,4,5,0
71003,1,2,248289,248293,248295,4,6,0
71004,6,3,248295,248295,248298,0,3,0
71005,5,3,248300,248300,248303,0,3,2
71006,2,1,248302,248303,248304,1,2,0
71007,4,3,248306,248306,248309,0,3,2
71008,4,1,248310,248310,248311,0,1,1
71009,1,1,248311,248311,248312,0,1,0
71010,5,3,248316,248316,248319,0,3,4
71011,2,3,248318,248319,248322,1,4,0
71012,2,3,248320,248322,248325,2,5,0
71013,2,1,248322,248325,248326,3,4,0
71014,4,1,248326,248326,248327,0,1,0
71015,2,1,248328,248328,248329,0,1,1
71016,4,1,248332,248332,248333,0,1,3
71017,2,2,248334,248334,248336,0,2,1
71018,3,3,248337,248337,248340,0,3,1
71019,4,1,248341,248341,248342,0,1,1
71020,5,1,248346,248346,248347,0,1,4
71021,4,2,248350,248350,248352,0,2,3
71022,1,2,248351,248352,248354,1,3,0
71023,4,1,248355,248355,248356,0,1,1
71024,2,1,248357,248357,248358,0,1,1
71025,2,1,248359,248359,248360,0,1,1
71026,2,2,248361,248361,248363,0,2,1
71027,5,2,248366,248366,248368,0,2,3
71028,6,1,248372,248372,248373,0,1,4
71029,6,2,248378,248378,248380,0,2,5
71030,5,1,248383,248383,248384,0,1,3
71031,2,1,248385,248385,248386,0,1,1
71032,3,3,248388,248388,248391,0,3,2
71033,1,1,248389,248391,248392,2,3,0
71034,1,2,248390,248392,248394,2,4,0
71035,2,3,248392,248394,248397,2,5,0
71036,5,3,248397,248397,248400,0,3,0
71037,5,3,248402,248402,248405,0,3,2
71038,3,1,248405,248405,248406,0,1,0
71039,5,1,248410,248410,248411,0,1,4
71040,6,2,248416,248416,248418,0,2,5
71041,2,3,248418,248418,248421,0,3,0
71042,2,3,248420,248421,248424,1,4,0
71043,1,1,248421,248424,248425,3,4,0
71044,5,2,248426,248426,248428,0,2,1
71045,1,2,248427,248428,248430,1,3,0
71046,4,2,248431,248431,248433,0,2,1
71047,5,2,248436,248436,248438,0,2,3
71048,4,2,248440,248440,248442,0,2,2
71049,6,2,248446,248446,248448,0,2,4
71050,6,2,248452,248452,248454,0,2,4
71051,2,2,248454,248454,248456,0,2,0
71052,3,1,248457,248457,248458,0,1,1
71053,6,1,248463,248463,248464,0,1,5
71054,3,3,248466,248466,248469,0,3,2
71055,4,2,248470,248470,248472,0,2,1
71056,2,2,248472,248472,248474,0,2,0
71057,4,1,248476,248476,248477,0,1,2
71058,6,3,248482,248482,248485,0,3,5
71059,3,3,248485,248485,248488,0,3,0
71060,5,2,248490,248490,248492,0,2,2
71061,4,3,248494,248494,248497,0,3,2
71062,6,1,248500,248500,248501,0,1,3
71063,3,3,248503,248503,248506,0,3,2
71064,3,3,248506,248506,248509,0,3,0
71065,5,1,248511,248511,248512,0,1,2
71066,3,2,248514,248514,248516,0,2,2
71067,3,1,248517,248517,248518,0,1,1
71068,2,2,248519,248519,248521,0,2,1
71069,5,1,248524,248524,248525,0,1,3
71070,1,1,248525,248525,248526,0,1,0
71071,1,2,248526,248526,248528,0,2,0
71072,4,1,248530,248530,248531,0,1,2
71073,2,2,248532,248532,248534,0,2,1
71074,4,1,248536,248536,248537,0,1,2
71075,3,1,248539,248539,248540,0,1,2
71076,1,3,248540,248540,248543,0,3,0
71077,2,1,248542,248543,248544,1,2,0
71078,2,2,248544,248544,248546,0,2,0
71079,5,2,248549,248549,248551,0,2,3
71080,3,3,248552,248552,248555,0,3,1
71081,6,3,248558,248558,248561,0,3,3
71082,2,2,248560,248561,248563,1,3,0
71083,2,3,248562,248563,248566,1,4,0
71084,1,3,248563,248566,248569,3,6,0
71085,6,1,248569,248569,248570,0,1,0
71086,5,3,248574,248574,248577,0,3,4
71087,1,2,248575,248577,248579,2,4,0
71088,4,2,248579,248579,248581,0,2,0
71089,3,1,248582,248582,248583,0,1,1
71090,2,3,248584,248584,248587,0,3,1
71091,2,1,248586,248587,248588,1,2,0
71092,4,1,248590,248590,248591,0,1,2
71093,6,1,248596,248596,248597,0,1,5
71094,6,2,248602,248602,248604,0,2,5
71095,5,3,248607,248607,248610,0,3,3
71096,3,3,248610,248610,248613,0,3,0
71097,3,2,248613,248613,248615,0,2,0
71098,2,3,248615,248615,248618,0,3,0
71099,5,2,248620,248620,248622,0,2,2
71100,6,2,248626,248626,248628,0,2,4
71101,4,1,248630,248630,248631,0,1,2
71102,1,2,248631,248631,248633,0,2,0
71103,3,1,248634,248634,248635,0,1,1
71104,1,2,248635,248635,248637,0,2,0
71105,2,3,248637,248637,248640,0,3,0
71106,1,1,248638,248640,248641,2,3,0
71107,1,1,248639,248641,248642,2,3,0
71108,1,3,248640,248642,248645,2,5,0
71109,5,3,248645,248645,248648,0,3,0
71110,5,3,248650,248650,248653,0,3,2
71111,1,2,248651,248653,248655,2,4,0
71112,3,2,248654,248655,248657,1,3,0
71113,4,1,248658,248658,248659,0,1,1
71114,5,2,248663,248663,248665,0,2,4
71115,3,2,248666,248666,248668,0,2,1
71116,1,3,248667,248668,248671,1,4,0
71117,3,2,248670,248671,248673,1,3,0
71118,4,3,248674,248674,248677,0,3,1
71119,3,2,248677,248677,248679,0,2,0
71120,2,3,248679,248679,248682,0,3,0
71121,6,3,248685,248685,248688,0,3,3
71122,3,1,248688,248688,248689,0,1,0
71123,6,3,248694,248694,248697,0,3,5
71124,5,2,248699,248699,248701,0,2,2
71125,3,1,248702,248702,248703,0,1,1
71126,6,1,248708,248708,248709,0,1,5
71127,2,1,248710,248710,248711,0,1,1
71128,2,1,248712,248712,248713,0,1,1
71129,3,1,248715,248715,248716,0,1,2
71130,1,3,248716,248716,248719,0,3,0
71131,3,2,248719,248719,248721,0,2,0
71132,3,2,248722,248722,248724,0,2,1
71133,3,2,248725,248725,248727,0,2,1
71134,6,1,248731,248731,248732,0,1,4
71135,2,1,248733,248733,248734,0,1,1
71136,1,2,248734,248734,248736,0,2,0
71137,3,2,248737,248737,248739,0,2,1
71138,2,2,248739,248739,248741,0,2,0
71139,4,3,248743,248743,248746,0,3,2
71140,6,3,248749,248749,248752,0,3,3
71141,1,1,248750,248752,248753,2,3,0
71142,3,1,248753,248753,248754,0,1,0
71143,6,1,248759,248759,248760,0,1,5
71144,1,3,248760,248760,248763,0,3,0
71145,3,2,248763,248763,248765,0,2,0
71146,4,2,248767,248767,248769,0,2,2
71147,3,2,248770,248770,248772,0,2,1
71148,5,1,248775,248775,248776,0,1,3
71149,2,2,248777,248777,248779,0,2,1
71150,3,3,248780,248780,248783,0,3,1
71151,5,2,248785,248785,248787,0,2,2
71152,2,1,248787,248787,248788,0,1,0
71153,4,1,248791,248791,248792,0,1,3
71154,6,1,248797,248797,248798,0,1,5
71155,3,1,248800,248800,248801,0,1,2
71156,6,2,248806,248806,248808,0,2,5
71157,6,2,248812,248812,248814,0,2,4
71158,3,3,248815,248815,248818,0,3,1
71159,4,2,248819,248819,248821,0,2,1
71160,2,1,248821,248821,248822,0,1,0
71161,6,3,248827,248827,248830,0,3,5
71162,4,3,248831,248831,248834,0,3,1
71163,4,2,248835,248835,248837,0,2,1
71164,6,2,248841,248841,248843,0,2,4
71165,3,3,248844,248844,248847,0,3,1
71166,1,2,248845,248847,248849,2,4,0
71167,2,3,248847,248849,248852,2,5,0
71168,6,3,248853,248853,248856,0,3,1
71169,4,3,248857,248857,248860,0,3,1
71170,1,3,248858,248860,248863,2,5,0
71171,5,3,248863,248863,248866,0,3,0
71172,6,3,248869,248869,248872,0,3,3
71173,5,3,248874,248874,248877,0,3,2
71174,3,3,248877,248877,248880,0,3,0
71175,1,2,248878,248880,248882,2,4,0
71176,1,1,248879,248882,248883,3,4,0
71177,6,1,248885,248885,248886,0,1,2
71178,6,3,248891,248891,248894,0,3,5
71179,2,1,248893,248894,248895,1,2,0
71180,4,2,248897,248897,248899,0,2,2
71181,2,2,248899,248899,248901,0,2,0
71182,1,2,248900,248901,248903,1,3,0
71183,1,2,248901,248903,248905,2,4,0
71184,1,2,248902,248905,248907,3,5,0
71185,2,2,248904,248907,248909,3,5,0
71186,5,2,248909,248909,248911,0,2,0
71187,5,1,248914,248914,248915,0,1,3
71188,2,3,248916,248916,248919,0,3,1
71189,2,1,248918,248919,248920,1,2,0
71190,3,3,248921,248921,248924,0,3,1
71191,5,2,248926,248926,248928,0,2,2
71192,1,1,248927,248928,248929,1,2,0
71193,3,3,248930,248930,248933,0,3,1
71194,3,1,248933,248933,248934,0,1,0
71195,6,3,248939,248939,248942,0,3,5
71196,3,2,248942,248942,248944,0,2,0
71197,2,2,248944,248944,248946,0,2,0
71198,6,3,248950,248950,248953,0,3,4
71199,3,2,248953,248953,248955,0,2,0
71200,2,1,248955,248955,248956,0,1,0
71201,4,2,248959,248959,248961,0,2,3
71202,1,3,248960,248961,248964,1,4,0
71203,5,2,248965,248965,248967,0,2,1
71204,2,1,248967,248967,248968,0,1,0
71205,2,2,248969,248969,248971,0,2,1
71206,1,1,248970,248971,248972,1,2,0
71207,4,2,248974,248974,248976,0,2,2
71208,3,3,248977,248977,248980,0,3,1
71209,1,3,248978,248980,248983,2,5,0
71210,6,2,248984,248984,248986,0,2,1
71211,5,1,248989,248989,248990,0,1,3
71212,4,2,248993,248993,248995,0,2,3
71213,2,2,248995,248995,248997,0,2,0
71214,2,2,248997,248997,248999,0,2,0
71215,6,3,249003,249003,249006,0,3,4
71216,6,3,249009,249009,249012,0,3,3
71217,5,1,249014,249014,249015,0,1,2
71218,3,3,249017,249017,249020,0,3,2
71219,1,2,249018,249020,249022,2,4,0
71220,4,1,249022,249022,249023,0,1,0
71221,4,3,249026,249026,249029,0,3,3
71222,2,3,249028,249029,249032,1,4,0
71223,1,1,249029,249032,249033,3,4,0
71224,4,2,249033,249033,249035,0,2,0
71225,4,3,249037,249037,249040,0,3,2
71226,1,3,249038,249040,249043,2,5,0
71227,1,2,249039,249043,249045,4,6,0
71228,4,1,249043,249045,249046,2,3,0
71229,5,1,249048,249048,249049,0,1,2
71230,1,1,249049,249049,249050,0,1,0
71231,6,1,249055,249055,249056,0,1,5
71232,3,3,249058,249058,249061,0,3,2
71233,2,1,249060,249061,249062,1,2,0
71234,3,3,249063,249063,249066,0,3,1
71235,4,3,249067,249067,249070,0,3,1
71236,2,2,249069,249070,249072,1,3,0
71237,3,2,249072,249072,249074,0,2,0
71238,2,1,249074,249074,249075,0,1,0
71239,3,1,249077,249077,249078,0,1,2
71240,2,3,249079,249079,249082,0,3,1
71241,2,3,249081,249082,249085,1,4,0
71242,4,1,249085,249085,249086,0,1,0
71243,6,2,249091,249091,249093,0,2,5
71244,3,2,249094,249094,249096,0,2,1
71245,5,2,249099,249099,249101,0,2,3
71246,3,2,249102,249102,249104,0,2,1
71247,1,3,249103,249104,249107,1,4,0
71248,2,3,249105,249107,249110,2,5,0
71249,6,2,249111,249111,249113,0,2,1
71250,4,1,249115,249115,249116,0,1,2
71251,1,2,249116,249116,249118,0,2,0
71252,1,2,249117,249118,249120,1,3,0
71253,2,1,249119,249120,249121,1,2,0
71254,1,1,249120,249121,249122,1,2,0
71255,5,1,249125,249125,249126,0,1,3
71256,1,1,249126,249126,249127,0,1,0
71257,2,1,249128,249128,249129,0,1,1
71258,6,2,249134,249134,249136,0,2,5
71259,4,3,249138,249138,249141,0,3,2
71260,6,3,249144,249144,249147,0,3,3
71261,5,1,249149,249149,249150,0,1,2
71262,6,2,249155,249155,249157,0,2,5
71263,4,2,249159,249159,249161,0,2,2
71264,2,3,249161,249161,249164,0,3,0
71265,3,1,249164,249164,249165,0,1,0
71266,1,2,249165,249165,249167,0,2,0
71267,1,2,249166,249167,249169,1,3,0
71268,5,3,249171,249171,249174,0,3,2
71269,4,3,249175,249175,249178,0,3,1
71270,3,1,249178,249178,249179,0,1,0
71271,2,3,249180,249180,249183,0,3,1
71272,4,2,249184,249184,249186,0,2,1
71273,2,2,249186,249186,249188,0,2,0
71274,6,1,249192,249192,249193,0,1,4
71275,6,1,249198,249198,249199,0,1,5
71276,3,1,249201,249201,249202,0,1,2
71277,4,3,249205,249205,249208,0,3,3
71278,6,1,249211,249211,249212,0,1,3
71279,2,1,249213,249213,249214,0,1,1
71280,1,1,249214,249214,249215,0,1,0
71281,1,3,249215,249215,249218,0,3,0
71282,4,2,249219,249219,249221,0,2,1
71283,4,1,249223,249223,249224,0,1,2
71284,5,1,249228,249228,249229,0,1,4
71285,4,1,249232,249232,249233,0,1,3
71286,5,3,249237,249237,249240,0,3,4
71287,5,2,249242,249242,249244,0,2,2
71288,3,2,249245,249245,249247,0,2,1
71289,1,2,249246,249247,249249,1,3,0
71290,1,1,249247,249249,249250,2,3,0
71291,5,1,249252,249252,249253,0,1,2
71292,3,2,249255,249255,249257,0,2,2
71293,4,1,249259,249259,249260,0,1,2
71294,6,1,249265,249265,249266,0,1,5
71295,5,2,249270,249270,249272,0,2,4
71296,5,1,249275,249275,249276,0,1,3
71297,1,3,249276,249276,249279,0,3,0
71298,1,2,249277,249279,249281,2,4,0
71299,4,3,249281,249281,249284,0,3,0
71300,1,1,249282,249284,249285,2,3,0
71301,2,3,249284,249285,249288,1,4,0
71302,6,3,249290,249290,249293,0,3,2
71303,1,2,249291,249293,249295,2,4,0
71304,4,3,249295,249295,249298,0,3,0
71305,3,1,249298,249298,249299,0,1,0
71306,4,2,249302,249302,249304,0,2,3
71307,6,3,249308,249308,249311,0,3,4
71308,1,1,249309,249311,249312,2,3,0
71309,2,3,249311,249312,249315,1,4,0
71310,6,2,249317,249317,249319,0,2,2
71311,5,2,249322,249322,249324,0,2,3
71312,6,1,249328,249328,249329,0,1,4
71313,5,2,249333,249333,249335,0,2,4
71314,4,1,249337,249337,249338,0,1,2
71315,4,3,249341,249341,249344,0,3,3
71316,1,2,249342,249344,249346,2,4,0
71317,4,1,249346,249346,249347,0,1,0
71318,4,1,249350,249350,249351,0,1,3
71319,4,1,249354,249354,249355,0,1,3
71320,2,2,249356,249356,249358,0,2,1
71321,6,2,249362,249362,249364,0,2,4
71322,5,1,249367,249367,249368,0,1,3
71323,2,3,249369,249369,249372,0,3,1
71324,2,1,249371,249372,249373,1,2,0
71325,1,1,249372,249373,249374,1,2,0
71326,2,1,249374,249374,249375,0,1,0
71327,2,1,249376,249376,249377,0,1,1
71328,3,2,249379,249379,249381,0,2,2
71329,4,2,249383,249383,249385,0,2,2
71330,4,3,249387,249387,249390,0,3,2
71331,4,3,249391,249391,249394,0,3,1
71332,6,2,249397,249397,249399,0,2,3
71333,1,1,249398,249399,249400,1,2,0
71334,3,3,249401,249401,249404,0,3,1
71335,4,2,249405,249405,249407,0,2,1
71336,5,3,249410,249410,249413,0,3,3
71337,6,3,249416,249416,249419,0,3,3
71338,4,2,249420,249420,249422,0,2,1
71339,4,3,249424,249424,249427,0,3,2
71340,5,3,249429,249429,249432,0,3,2
71341,1,2,249430,249432,249434,2,4,0
71342,2,1,249432,249434,249435,2,3,0
71343,4,3,249436,249436,249439,0,3,1
71344,3,2,249439,249439,249441,0,2,0
71345,6,3,249445,249445,249448,0,3,4
71346,5,2,249450,249450,249452,0,2,2
71347,1,1,249451,249452,249453,1,2,0
71348,1,2,249452,249453,249455,1,3,0
71349,1,1,249453,249455,249456,2,3,0
71350,2,1,249455,249456,249457,1,2,0
71351,3,2,249458,249458,249460,0,2,1
71352,6,1,249464,249464,249465,0,1,4
71353,1,2,249465,249465,249467,0,2,0
71354,6,1,249471,249471,249472,0,1,4
71355,3,1,249474,249474,249475,0,1,2
71356,2,3,249476,249476,249479,0,3,1
71357,6,1,249482,249482,249483,0,1,3
71358,6,3,249488,249488,249491,0,3,5
71359,1,3,249489,249491,249494,2,5,0
71360,2,1,249491,249494,249495,3,4,0
71361,1,3,249492,249495,249498,3,6,0
71362,2,3,249494,249498,249501,4,7,0
71363,3,1,249497,249501,249502,4,5,0
71364,1,1,249498,249502,249503,4,5,0
71365,2,1,249500,249503,249504,3,4,0
71366,6,3,249506,249506,249509,0,3,2
71367,5,2,249511,249511,249513,0,2,2
71368,4,1,249515,249515,249516,0,1,2
71369,5,2,249520,249520,249522,0,2,4
71370,1,1,249521,249522,249523,1,2,0
71371,6,3,249527,249527,249530,0,3,4
71372,2,2,249529,249530,249532,1,3,0
71373,3,2,249532,249532,249534,0,2,0
71374,3,2,249535,249535,249537,0,2,1
71375,5,3,249540,249540,249543,0,3,3
71376,1,3,249541,249543,249546,2,5,0
71377,5,2,249546,249546,249548,0,2,0
71378,3,2,249549,249549,249551,0,2,1
71379,5,2,249554,249554,249556,0,2,3
71380,1,3,249555,249556,249559,1,4,0
71381,3,3,249558,249559,249562,1,4,0
71382,1,2,249559,249562,249564,3,5,0
71383,2,1,249561,249564,249565,3,4,0
71384,3,1,249564,249565,249566,1,2,0
71385,3,1,249567,249567,249568,0,1,1
71386,3,1,249570,249570,249571,0,1,2
71387,5,3,249575,249575,249578,0,3,4
71388,2,2,249577,249578,249580,1,3,0
71389,4,3,249581,249581,249584,0,3,1
71390,4,2,249585,249585,249587,0,2,1
71391,6,1,249591,249591,249592,0,1,4
71392,2,2,249593,249593,249595,0,2,1
71393,3,1,249596,249596,249597,0,1,1
71394,2,2,249598,249598,249600,0,2,1
71395,6,2,249604,249604,249606,0,2,4
71396,1,3,249605,249606,249609,1,4,0
71397,3,1,249608,249609,249610,1,2,0
71398,6,3,249614,249614,249617,0,3,4
71399,2,2,249616,249617,249619,1,3,0
71400,6,1,249622,249622,249623,0,1,3
71401,2,1,249624,249624,249625,0,1,1
71402,4,1,249628,249628,249629,0,1,3
71403,3,1,249631,249631,249632,0,1,2
71404,6,3,249637,249637,249640,0,3,5
71405,6,1,249643,249643,249644,0,1,3
71406,5,1,249648,249648,249649,0,1,4
71407,4,1,249652,249652,249653,0,1,3
71408,4,1,249656,249656,249657,0,1,3
71409,4,2,249660,249660,249662,0,2,3
71410,6,1,249666,249666,249667,0,1,4
71411,2,1,249668,249668,249669,0,1,1
71412,4,3,249672,249672,249675,0,3,3
71413,1,3,249673,249675,249678,2,5,0
71414,1,3,249674,249678,249681,4,7,0
71415,2,2,249676,249681,249683,5,7,0
71416,4,1,249680,249683,249684,3,4,0
71417,4,1,249684,249684,249685,0,1,0
71418,2,3,249686,249686,249689,0,3,1
71419,6,1,249692,249692,249693,0,1,3
71420,5,1,249697,249697,249698,0,1,4
71421,4,1,249701,249701,249702,0,1,3
71422,2,1,249703,249703,249704,0,1,1
71423,5,2,249708,249708,249710,0,2,4
71424,3,2,249711,249711,249713,0,2,1
71425,5,3,249716,249716,249719,0,3,3
71426,4,1,249720,249720,249721,0,1,1
71427,3,2,249723,249723,249725,0,2,2
71428,5,1,249728,249728,249729,0,1,3
71429,4,1,249732,249732,249733,0,1,3
71430,5,2,249737,249737,249739,0,2,4
71431,3,2,249740,249740,249742,0,2,1
71432,1,1,249741,249742,249743,1,2,0
71433,3,2,249744,249744,249746,0,2,1
71434,4,2,249748,249748,249750,0,2,2
71435,1,1,249749,249750,249751,1,2,0
71436,5,1,249754,249754,249755,0,1,3
71437,2,2,249756,249756,249758,0,2,1
71438,3,1,249759,249759,249760,0,1,1
71439,1,2,249760,249760,249762,0,2,0
71440,1,3,249761,249762,249765,1,4,0
71441,4,2,249765,249765,249767,0,2,0
71442,1,3,249766,249767,249770,1,4,0
71443,1,2,249767,249770,249772,3,5,0
71444,6,2,249773,249773,249775,0,2,1
71445,1,1,249774,249775,249776,1,2,0
71446,3,1,249777,249777,249778,0,1,1
71447,5,3,249782,249782,249785,0,3,4
71448,4,1,249786,249786,249787,0,1,1
71449,4,1,249790,249790,249791,0,1,3
71450,5,2,249795,249795,249797,0,2,4
71451,4,1,249799,249799,249800,0,1,2
71452,1,1,249800,249800,249801,0,1,0
71453,4,1,249804,249804,249805,0,1,3
71454,6,3,249810,249810,249813,0,3,5
71455,2,3,249812,249813,249816,1,4,0
71456,2,1,249814,249816,249817,2,3,0
71457,3,3,249817,249817,249820,0,3,0
71458,4,2,249821,249821,249823,0,2,1
71459,1,1,249822,249823,249824,1,2,0
71460,4,3,249826,249826,249829,0,3,2
71461,2,3,249828,249829,249832,1,4,0
71462,1,1,249829,249832,249833,3,4,0
71463,4,3,249833,249833,249836,0,3,0
71464,4,1,249837,249837,249838,0,1,1
71465,6,2,249843,249843,249845,0,2,5
71466,2,3,249845,249845,249848,0,3,0
71467,4,1,249849,249849,249850,0,1,1
71468,3,2,249852,249852,249854,0,2,2
71469,1,3,249853,249854,249857,1,4,0
71470,2,1,249855,249857,249858,2,3,0
71471,4,2,249859,249859,249861,0,2,1
71472,3,3,249862,249862,249865,0,3,1
71473,5,3,249867,249867,249870,0,3,2
71474,5,3,249872,249872,249875,0,3,2
71475,1,2,249873,249875,249877,2,4,0
71476,1,2,249874,249877,249879,3,5,0
71477,4,2,249878,249879,249881,1,3,0
71478,5,1,249883,249883,249884,0,1,2
71479,1,3,249884,249884,249887,0,3,0
71480,5,2,249889,249889,249891,0,2,2
71481,1,1,249890,249891,249892,1,2,0
71482,5,1,249895,249895,249896,0,1,3
71483,2,2,249897,249897,249899,0,2,1
71484,5,2,249902,249902,249904,0,2,3
71485,1,3,249903,249904,249907,1,4,0
71486,2,2,249905,249907,249909,2,4,0
71487,5,1,249910,249910,249911,0,1,1
71488,5,1,249915,249915,249916,0,1,4
71489,5,3,249920,249920,249923,0,3,4
71490,1,1,249921,249923,249924,2,3,0
71491,1,1,249922,249924,249925,2,3,0
71492,6,2,249928,249928,249930,0,2,3
71493,4,2,249932,249932,249934,0,2,2
71494,2,2,249934,249934,249936,0,2,0
71495,3,3,249937,249937,249940,0,3,1
71496,1,2,249938,249940,249942,2,4,0
71497,5,3,249943,249943,249946,0,3,1
71498,4,1,249947,249947,249948,0,1,1
71499,2,2,249949,249949,249951,0,2,1
71500,3,1,249952,249952,249953,0,1,1
71501,3,2,249955,249955,249957,0,2,2
71502,1,1,249956,249957,249958,1,2,0
71503,5,2,249961,249961,249963,0,2,3
71504,6,1,249967,249967,249968,0,1,4
71505,6,3,249973,249973,249976,0,3,5
71506,4,3,249977,249977,249980,0,3,1
71507,5,3,249982,249982,249985,0,3,2
71508,5,2,249987,249987,249989,0,2,2
71509,4,3,249991,249991,249994,0,3,2
71510,6,2,249997,249997,249999,0,2,3
71511,6,1,250003,250003,250004,0,1,4
71512,2,3,250005,250005,250008,0,3,1
71513,4,2,250009,250009,250011,0,2,1
71514,6,2,250015,250015,250017,0,2,4
71515,6,3,250021,250021,250024,0,3,4
71516,4,2,250025,250025,250027,0,2,1
71517,6,3,250031,250031,250034,0,3,4
71518,5,2,250036,250036,250038,0,2,2
71519,2,1,250038,250038,250039,0,1,0
71520,1,3,250039,250039,250042,0,3,0
71521,6,2,250045,250045,250047,0,2,3
71522,1,1,250046,250047,250048,1,2,0
71523,2,1,250048,250048,250049,0,1,0
71524,4,2,250052,250052,250054,0,2,3
71525,4,2,250056,250056,250058,0,2,2
71526,4,2,250060,250060,250062,0,2,2
71527,4,3,250064,250064,250067,0,3,2
71528,4,2,250068,250068,250070,0,2,1
71529,4,1,250072,250072,250073,0,1,2
71530,1,3,250073,250073,250076,0,3,0
71531,5,3,250078,250078,250081,0,3,2
71532,1,2,250079,250081,250083,2,4,0
71533,5,2,250084,250084,250086,0,2,1
71534,2,3,250086,250086,250089,0,3,0
71535,1,3,250087,250089,250092,2,5,0
71536,4,1,250091,250092,250093,1,2,0
71537,2,1,250093,250093,250094,0,1,0
71538,3,1,250096,250096,250097,0,1,2
71539,5,3,250101,250101,250104,0,3,4
71540,5,2,250106,250106,250108,0,2,2
71541,1,3,250107,250108,250111,1,4,0
71542,5,3,250112,250112,250115,0,3,1
71543,2,3,250114,250115,250118,1,4,0
71544,3,1,250117,250118,250119,1,2,0
71545,2,1,250119,250119,250120,0,1,0
71546,2,2,250121,250121,250123,0,2,1
71547,3,2,250124,250124,250126,0,2,1
71548,5,1,250129,250129,250130,0,1,3
71549,2,2,250131,250131,250133,0,2,1
71550,6,1,250137,250137,250138,0,1,4
71551,4,3,250141,250141,250144,0,3,3
71552,3,1,250144,250144,250145,0,1,0
71553,5,1,250149,250149,250150,0,1,4
71554,4,1,250153,250153,250154,0,1,3
71555,4,1,250157,250157,250158,0,1,3
71556,1,3,250158,250158,250161,0,3,0
71557,3,2,250161,250161,250163,0,2,0
71558,2,1,250163,250163,250164,0,1,0
71559,2,1,250165,250165,250166,0,1,1
71560,2,3,250167,250167,250170,0,3,1
71561,3,3,250170,250170,250173,0,3,0
71562,4,1,250174,250174,250175,0,1,1
71563,4,1,250178,250178,250179,0,1,3
71564,1,1,250179,250179,250180,0,1,0
71565,2,3,250181,250181,250184,0,3,1
71566,2,3,250183,250184,250187,1,4,0
71567,2,2,250185,250187,250189,2,4,0
71568,5,3,250190,250190,250193,0,3,1
71569,6,1,250196,250196,250197,0,1,3
71570,4,2,250200,250200,250202,0,2,3
71571,1,3,250201,250202,250205,1,4,0
71572,6,3,250207,250207,250210,0,3,2
71573,2,2,250209,250210,250212,1,3,0
71574,4,2,250213,250213,250215,0,2,1
71575,4,2,250217,250217,250219,0,2,2
71576,5,2,250222,250222,250224,0,2,3
71577,2,3,250224,250224,250227,0,3,0
71578,4,2,250228,250228,250230,0,2,1
71579,5,3,250233,250233,250236,0,3,3
71580,4,3,250237,250237,250240,0,3,1
71581,4,1,250241,250241,250242,0,1,1
71582,4,1,250245,250245,250246,0,1,3
71583,3,1,250248,250248,250249,0,1,2
71584,6,2,250254,250254,250256,0,2,5
71585,4,2,250258,250258,250260,0,2,2
71586,1,3,250259,250260,250263,1,4,0
71587,5,1,250264,250264,250265,0,1,1
71588,5,1,250269,250269,250270,0,1,4
71589,6,2,250275,250275,250277,0,2,5
71590,5,1,250280,250280,250281,0,1,3
71591,6,2,250286,250286,250288,0,2,5
71592,3,1,250289,250289,250290,0,1,1
71593,5,1,250294,250294,250295,0,1,4
71594,2,3,250296,250296,250299,0,3,1
71595,3,1,250299,250299,250300,0,1,0
71596,4,2,250303,250303,250305,0,2,3
71597,1,2,250304,250305,250307,1,3,0
71598,6,3,250310,250310,250313,0,3,3
71599,3,2,250313,250313,250315,0,2,0
71600,4,1,250317,250317,250318,0,1,2
71601,3,2,250320,250320,250322,0,2,2
71602,1,3,250321,250322,250325,1,4,0
71603,5,3,250326,250326,250329,0,3,1
71604,3,1,250329,250329,250330,0,1,0
71605,2,1,250331,250331,250332,0,1,1
71606,1,1,250332,250332,250333,0,1,0
71607,3,2,250335,250335,250337,0,2,2
71608,6,3,250341,250341,250344,0,3,4
71609,1,1,250342,250344,250345,2,3,0
71610,6,3,250348,250348,250351,0,3,3
71611,1,3,250349,250351,250354,2,5,0
71612,6,3,250355,250355,250358,0,3,1
71613,2,2,250357,250358,250360,1,3,0
71614,1,1,250358,250360,250361,2,3,0
71615,6,3,250364,250364,250367,0,3,3
71616,1,1,250365,250367,250368,2,3,0
71617,2,3,250367,250368,250371,1,4,0
71618,1,3,250368,250371,250374,3,6,0
71619,1,2,250369,250374,250376,5,7,0
71620,3,1,250372,250376,250377,4,5,0
71621,5,3,250377,250377,250380,0,3,0
71622,3,3,250380,250380,250383,0,3,0
71623,5,3,250385,250385,250388,0,3,2
71624,2,1,250387,250388,250389,1,2,0
71625,5,3,250392,250392,250395,0,3,3
71626,6,2,250398,250398,250400,0,2,3
71627,5,1,250403,250403,250404,0,1,3
71628,6,3,250409,250409,250412,0,3,5
71629,4,3,250413,250413,250416,0,3,1
71630,5,1,250418,250418,250419,0,1,2
71631,6,2,250424,250424,250426,0,2,5
71632,4,1,250428,250428,250429,0,1,2
71633,1,1,250429,250429,250430,0,1,0
71634,5,1,250434,250434,250435,0,1,4
71635,1,3,250435,250435,250438,0,3,0
71636,2,3,250437,250438,250441,1,4,0
71637,3,1,250440,250441,250442,1,2,0
71638,1,1,250441,250442,250443,1,2,0
71639,6,3,250447,250447,250450,0,3,4
71640,4,2,250451,250451,250453,0,2,1
71641,2,3,250453,250453,250456,0,3,0
71642,2,1,250455,250456,250457,1,2,0
71643,3,1,250458,250458,250459,0,1,1
71644,5,3,250463,250463,250466,0,3,4
71645,3,3,250466,250466,250469,0,3,0
71646,4,1,250470,250470,250471,0,1,1
71647,4,3,250474,250474,250477,0,3,3
71648,4,1,250478,250478,250479,0,1,1
71649,1,2,250479,250479,250481,0,2,0
71650,5,3,250484,250484,250487,0,3,3
71651,5,2,250489,250489,250491,0,2,2
71652,5,3,250494,250494,250497,0,3,3
71653,1,2,250495,250497,250499,2,4,0
71654,3,1,250498,250499,250500,1,2,0
71655,1,3,250499,250500,250503,1,4,0
71656,6,3,250505,250505,250508,0,3,2
71657,1,3,250506,250508,250511,2,5,0
71658,6,1,250512,250512,250513,0,1,1
71659,5,3,250517,250517,250520,0,3,4
71660,4,3,250521,250521,250524,0,3,1
71661,4,3,250525,250525,250528,0,3,1
71662,3,2,250528,250528,250530,0,2,0
71663,3,1,250531,250531,250532,0,1,1
71664,6,3,250537,250537,250540,0,3,5
71665,4,1,250541,250541,250542,0,1,1
71666,5,3,250546,250546,250549,0,3,4
71667,1,2,250547,250549,250551,2,4,0
71668,6,3,250553,250553,250556,0,3,2
71669,6,2,250559,250559,250561,0,2,3
71670,6,1,250565,250565,250566,0,1,4
71671,4,2,250569,250569,250571,0,2,3
71672,5,1,250574,250574,250575,0,1,3
71673,1,2,250575,250575,250577,0,2,0
71674,6,3,250581,250581,250584,0,3,4
71675,5,2,250586,250586,250588,0,2,2
71676,1,2,250587,250588,250590,1,3,0
71677,5,2,250592,250592,250594,0,2,2
71678,6,2,250598,250598,250600,0,2,4
71679,1,1,250599,250600,250601,1,2,0
71680,2,1,250601,250601,250602,0,1,0
71681,6,3,250607,250607,250610,0,3,5
71682,6,3,250613,250613,250616,0,3,3
71683,1,2,250614,250616,250618,2,4,0
71684,2,1,250616,250618,250619,2,3,0
71685,1,1,250617,250619,250620,2,3,0
71686,6,1,250623,250623,250624,0,1,3
71687,4,2,250627,250627,250629,0,2,3
71688,3,3,250630,250630,250633,0,3,1
71689,3,2,250633,250633,250635,0,2,0
71690,3,3,250636,250636,250639,0,3,1
71691,2,1,250638,250639,250640,1,2,0
71692,1,1,250639,250640,250641,1,2,0
71693,6,3,250645,250645,250648,0,3,4
71694,4,2,250649,250649,250651,0,2,1
71695,5,3,250654,250654,250657,0,3,3
71696,2,2,250656,250657,250659,1,3,0
71697,2,2,250658,250659,250661,1,3,0
71698,2,1,250660,250661,250662,1,2,0
71699,3,2,250663,250663,250665,0,2,1
71700,4,2,250667,250667,250669,0,2,2
71701,5,1,250672,250672,250673,0,1,3
71702,6,2,250678,250678,250680,0,2,5
71703,2,1,250680,250680,250681,0,1,0
71704,1,1,250681,250681,250682,0,1,0
71705,3,3,250684,250684,250687,0,3,2
71706,2,1,250686,250687,250688,1,2,0
71707,2,3,250688,250688,250691,0,3,0
71708,3,1,250691,250691,250692,0,1,0
71709,1,2,250692,250692,250694,0,2,0
71710,4,1,250696,250696,250697,0,1,2
71711,3,2,250699,250699,250701,0,2,2
71712,5,1,250704,250704,250705,0,1,3
71713,2,1,250706,250706,250707,0,1,1
71714,3,2,250709,250709,250711,0,2,2
71715,4,2,250713,250713,250715,0,2,2
71716,4,2,250717,250717,250719,0,2,2
71717,4,3,250721,250721,250724,0,3,2
71718,3,3,250724,250724,250727,0,3,0
71719,2,3,250726,250727,250730,1,4,0
71720,3,2,250729,250730,250732,1,3,0
71721,4,2,250733,250733,250735,0,2,1
71722,2,3,250735,250735,250738,0,3,0
71723,6,2,250741,250741,250743,0,2,3
71724,2,1,250743,250743,250744,0,1,0
71725,5,1,250748,250748,250749,0,1,4
71726,6,1,250754,250754,250755,0,1,5
71727,5,1,250759,250759,250760,0,1,4
71728,5,2,250764,250764,250766,0,2,4
71729,3,3,250767,250767,250770,0,3,1
71730,2,3,250769,250770,250773,1,4,0
71731,5,2,250774,250774,250776,0,2,1
71732,4,2,250778,250778,250780,0,2,2
71733,1,1,250779,250780,250781,1,2,0
71734,3,3,250782,250782,250785,0,3,1
71735,4,1,250786,250786,250787,0,1,1
71736,6,1,250792,250792,250793,0,1,5
71737,1,3,250793,250793,250796,0,3,0
71738,3,2,250796,250796,250798,0,2,0
71739,5,1,250801,250801,250802,0,1,3
71740,5,1,250806,250806,250807,0,1,4
71741,6,2,250812,250812,250814,0,2,5
71742,5,2,250817,250817,250819,0,2,3
71743,3,3,250820,250820,250823,0,3,1
71744,5,1,250825,250825,250826,0,1,2
71745,3,2,250828,250828,250830,0,2,2
71746,3,2,250831,250831,250833,0,2,1
71747,5,2,250836,250836,250838,0,2,3
71748,2,2,250838,250838,250840,0,2,0
71749,6,1,250844,250844,250845,0,1,4
71750,2,2,250846,250846,250848,0,2,1
71751,1,1,250847,250848,250849,1,2,0
71752,4,2,250851,250851,250853,0,2,2
71753,5,1,250856,250856,250857,0,1,3
71754,6,1,250862,250862,250863,0,1,5
71755,6,2,250868,250868,250870,0,2,5
71756,4,2,250872,250872,250874,0,2,2
71757,3,2,250875,250875,250877,0,2,1
71758,5,2,250880,250880,250882,0,2,3
71759,4,2,250884,250884,250886,0,2,2
71760,1,2,250885,250886,250888,1,3,0
71761,2,2,250887,250888,250890,1,3,0
71762,6,3,250893,250893,250896,0,3,3
71763,4,1,250897,250897,250898,0,1,1
71764,2,3,250899,250899,250902,0,3,1
71765,5,2,250904,250904,250906,0,2,2
71766,1,1,250905,250906,250907,1,2,0
71767,4,1,250909,250909,250910,0,1,2
71768,1,3,250910,250910,250913,0,3,0
71769,6,3,250916,250916,250919,0,3,3
71770,1,1,250917,250919,250920,2,3,0
71771,1,1,250918,250920,250921,2,3,0
71772,2,2,250920,250921,250923,1,3,0
71773,5,1,250925,250925,250926,0,1,2
71774,6,2,250931,250931,250933,0,2,5
71775,5,3,250936,250936,250939,0,3,3
71776,5,1,250941,250941,250942,0,1,2
71777,1,1,250942,250942,250943,0,1,0
71778,1,2,250943,250943,250945,0,2,0
71779,6,3,250949,250949,250952,0,3,4
71780,1,2,250950,250952,250954,2,4,0
71781,5,3,250955,250955,250958,0,3,1
71782,3,3,250958,250958,250961,0,3,0
71783,4,3,250962,250962,250965,0,3,1
71784,6,3,250968,250968,250971,0,3,3
71785,5,2,250973,250973,250975,0,2,2
71786,1,2,250974,250975,250977,1,3,0
71787,6,1,250980,250980,250981,0,1,3
71788,4,3,250984,250984,250987,0,3,3
71789,1,1,250985,250987,250988,2,3,0
71790,3,1,250988,250988,250989,0,1,0
71791,3,1,250991,250991,250992,0,1,2
71792,1,2,250992,250992,250994,0,2,0
71793,1,1,250993,250994,250995,1,2,0
71794,4,1,250997,250997,250998,0,1,2
71795,2,2,250999,250999,251001,0,2,1
71796,6,1,251005,251005,251006,0,1,4
71797,4,2,251009,251009,251011,0,2,3
71798,6,2,251015,251015,251017,0,2,4
71799,1,2,251016,251017,251019,1,3,0
71800,2,3,251018,251019,251022,1,4,0
71801,3,1,251021,251022,251023,1,2,0
71802,2,1,251023,251023,251024,0,1,0
71803,3,3,251026,251026,251029,0,3,2
71804,4,2,251030,251030,251032,0,2,1
71805,1,3,251031,251032,251035,1,4,0
71806,2,1,251033,251035,251036,2,3,0
71807,1,2,251034,251036,251038,2,4,0
71808,3,3,251037,251038,251041,1,4,0
71809,1,3,251038,251041,251044,3,6,0
71810,3,3,251041,251044,251047,3,6,0
71811,3,3,251044,251047,251050,3,6,0
71812,2,1,251046,251050,251051,4,5,0
71813,3,3,251049,251051,251054,2,5,0
71814,6,2,251055,251055,251057,0,2,1
71815,3,1,251058,251058,251059,0,1,1
71816,3,2,251061,251061,251063,0,2,2
71817,3,3,251064,251064,251067,0,3,1
71818,6,1,251070,251070,251071,0,1,3
71819,6,3,251076,251076,251079,0,3,5
71820,3,3,251079,251079,251082,0,3,0
71821,4,3,251083,251083,251086,0,3,1
71822,3,1,251086,251086,251087,0,1,0
71823,6,1,251092,251092,251093,0,1,5
71824,4,1,251096,251096,251097,0,1,3
71825,2,3,251098,251098,251101,0,3,1
71826,3,1,251101,251101,251102,0,1,0
71827,2,1,251103,251103,251104,0,1,1
71828,1,3,251104,251104,251107,0,3,0
71829,1,3,251105,251107,251110,2,5,0
71830,1,2,251106,251110,251112,4,6,0
71831,5,2,251111,251112,251114,1,3,0
71832,3,3,251114,251114,251117,0,3,0
71833,1,3,251115,251117,251120,2,5,0
71834,2,1,251117,251120,251121,3,4,0
71835,3,3,251120,251121,251124,1,4,0
71836,2,1,251122,251124,251125,2,3,0
71837,1,3,251123,251125,251128,2,5,0
71838,6,1,251129,251129,251130,0,1,1
71839,4,1,251133,251133,251134,0,1,3
71840,1,3,251134,251134,251137,0,3,0
71841,6,1,251140,251140,251141,0,1,3
71842,2,2,251142,251142,251144,0,2,1
71843,4,1,251146,251146,251147,0,1,2
71844,3,2,251149,251149,251151,0,2,2
71845,6,3,251155,251155,251158,0,3,4
71846,3,2,251158,251158,251160,0,2,0
71847,5,2,251163,251163,251165,0,2,3
71848,6,3,251169,251169,251172,0,3,4
71849,4,3,251173,251173,251176,0,3,1
71850,6,2,251179,251179,251181,0,2,3
71851,6,2,251185,251185,251187,0,2,4
71852,3,3,251188,251188,251191,0,3,1
71853,6,1,251194,251194,251195,0,1,3
71854,3,1,251197,251197,251198,0,1,2
71855,2,3,251199,251199,251202,0,3,1
71856,4,3,251203,251203,251206,0,3,1
71857,2,1,251205,251206,251207,1,2,0
71858,3,3,251208,251208,251211,0,3,1
71859,3,2,251211,251211,251213,0,2,0
71860,5,1,251216,251216,251217,0,1,3
71861,5,3,251221,251221,251224,0,3,4
71862,2,2,251223,251224,251226,1,3,0
71863,1,3,251224,251226,251229,2,5,0
71864,5,2,251229,251229,251231,0,2,0
71865,3,3,251232,251232,251235,0,3,1
71866,4,2,251236,251236,251238,0,2,1
71867,5,2,251241,251241,251243,0,2,3
71868,3,3,251244,251244,251247,0,3,1
71869,1,2,251245,251247,251249,2,4,0
71870,6,2,251251,251251,251253,0,2,2
71871,4,1,251255,251255,251256,0,1,2
71872,1,3,251256,251256,251259,0,3,0
71873,5,3,251261,251261,251264,0,3,2
71874,2,1,251263,251264,251265,1,2,0
71875,4,2,251267,251267,251269,0,2,2
71876,4,1,251271,251271,251272,0,1,2
71877,2,1,251273,251273,251274,0,1,1
71878,5,3,251278,251278,251281,0,3,4
71879,4,3,251282,251282,251285,0,3,1
71880,2,3,251284,251285,251288,1,4,0
71881,2,1,251286,251288,251289,2,3,0
71882,5,3,251291,251291,251294,0,3,2
71883,5,1,251296,251296,251297,0,1,2
71884,4,2,251300,251300,251302,0,2,3
71885,3,1,251303,251303,251304,0,1,1
71886,4,3,251307,251307,251310,0,3,3
71887,1,2,251308,251310,251312,2,4,0
71888,1,3,251309,251312,251315,3,6,0
71889,2,3,251311,251315,251318,4,7,0
71890,1,1,251312,251318,251319,6,7,0
71891,6,2,251318,251319,251321,1,3,0
71892,2,1,251320,251321,251322,1,2,0
71893,1,1,251321,251322,251323,1,2,0
71894,3,2,251324,251324,251326,0,2,1
71895,1,1,251325,251326,251327,1,2,0
71896,6,1,251331,251331,251332,0,1,4
71897,1,1,251332,251332,251333,0,1,0
71898,5,3,251337,251337,251340,0,3,4
71899,2,3,251339,251340,251343,1,4,0
71900,6,2,251345,251345,251347,0,2,2
71901,3,2,251348,251348,251350,0,2,1
71902,3,3,251351,251351,251354,0,3,1
71903,3,2,251354,251354,251356,0,2,0
71904,1,1,251355,251356,251357,1,2,0
71905,6,2,251361,251361,251363,0,2,4
71906,6,2,251367,251367,251369,0,2,4
71907,6,1,251373,251373,251374,0,1,4
71908,5,2,251378,251378,251380,0,2,4
71909,6,2,251384,251384,251386,0,2,4
71910,4,1,251388,251388,251389,0,1,2
71911,2,3,251390,251390,251393,0,3,1
71912,5,1,251395,251395,251396,0,1,2
71913,6,3,251401,251401,251404,0,3,5
71914,2,3,251403,251404,251407,1,4,0
71915,3,2,251406,251407,251409,1,3,0
71916,1,1,251407,251409,251410,2,3,0
71917,3,2,251410,251410,251412,0,2,0
71918,3,3,251413,251413,251416,0,3,1
71919,1,2,251414,251416,251418,2,4,0
71920,2,1,251416,251418,251419,2,3,0
71921,5,2,251421,251421,251423,0,2,2
71922,6,3,251427,251427,251430,0,3,4
71923,2,2,251429,251430,251432,1,3,0
71924,2,1,251431,251432,251433,1,2,0
71925,2,1,251433,251433,251434,0,1,0
71926,4,3,251437,251437,251440,0,3,3
71927,5,1,251442,251442,251443,0,1,2
71928,5,3,251447,251447,251450,0,3,4
71929,5,2,251452,251452,251454,0,2,2
71930,2,2,251454,251454,251456,0,2,0
71931,1,2,251455,251456,251458,1,3,0
71932,3,3,251458,251458,251461,0,3,0
71933,3,1,251461,251461,251462,0,1,0
71934,6,2,251467,251467,251469,0,2,5
71935,5,1,251472,251472,251473,0,1,3
71936,6,3,251478,251478,251481,0,3,5
71937,5,3,251483,251483,251486,0,3,2
71938,6,1,251489,251489,251490,0,1,3
71939,3,1,251492,251492,251493,0,1,2
71940,6,3,251498,251498,251501,0,3,5
71941,6,3,251504,251504,251507,0,3,3
71942,5,3,251509,251509,251512,0,3,2
71943,5,3,251514,251514,251517,0,3,2
71944,3,3,251517,251517,251520,0,3,0
71945,5,2,251522,251522,251524,0,2,2
71946,1,3,251523,251524,251527,1,4,0
71947,1,2,251524,251527,251529,3,5,0
71948,1,1,251525,251529,251530,4,5,0
71949,5,2,251530,251530,251532,0,2,0
71950,1,2,251531,251532,251534,1,3,0
71951,1,1,251532,251534,251535,2,3,0
71952,5,3,251537,251537,251540,0,3,2
71953,2,1,251539,251540,251541,1,2,0
71954,4,3,251543,251543,251546,0,3,2
71955,2,1,251545,251546,251547,1,2,0
71956,3,3,251548,251548,251551,0,3,1
71957,1,3,251549,251551,251554,2,5,0
71958,6,2,251555,251555,251557,0,2,1
71959,1,1,251556,251557,251558,1,2,0
71960,1,1,251557,251558,251559,1,2,0
71961,3,2,251560,251560,251562,0,2,1
71962,1,3,251561,251562,251565,1,4,0
71963,5,3,251566,251566,251569,0,3,1
71964,2,2,251568,251569,251571,1,3,0
71965,3,1,251571,251571,251572,0,1,0
71966,4,3,251575,251575,251578,0,3,3
71967,6,1,251581,251581,251582,0,1,3
71968,1,3,251582,251582,251585,0,3,0
71969,6,1,251588,251588,251589,0,1,3
71970,2,2,251590,251590,251592,0,2,1
71971,4,2,251594,251594,251596,0,2,2
71972,3,2,251597,251597,251599,0,2,1
71973,3,3,251600,251600,251603,0,3,1
71974,1,1,251601,251603,251604,2,3,0
71975,3,2,251604,251604,251606,0,2,0
71976,4,2,251608,251608,251610,0,2,2
71977,4,1,251612,251612,251613,0,1,2
71978,2,2,251614,251614,251616,0,2,1
71979,3,3,251617,251617,251620,0,3,1
71980,6,2,251623,251623,251625,0,2,3
71981,2,3,251625,251625,251628,0,3,0
71982,4,1,251629,251629,251630,0,1,1
71983,1,3,251630,251630,251633,0,3,0
71984,6,1,251636,251636,251637,0,1,3
71985,5,3,251641,251641,251644,0,3,4
71986,4,1,251645,251645,251646,0,1,1
71987,4,1,251649,251649,251650,0,1,3
71988,6,2,251655,251655,251657,0,2,5
71989,2,2,251657,251657,251659,0,2,0
71990,5,3,251662,251662,251665,0,3,3
71991,3,2,251665,251665,251667,0,2,0
71992,2,2,251667,251667,251669,0,2,0
71993,5,1,251672,251672,251673,0,1,3
71994,6,3,251678,251678,251681,0,3,5
71995,3,1,251681,251681,251682,0,1,0
71996,3,1,251684,251684,251685,0,1,2
71997,4,1,251688,251688,251689,0,1,3
71998,2,3,251690,251690,251693,0,3,1
71999,6,3,251696,251696,251699,0,3,3
72000,1,1,251697,251699,251700,2,3,0
72001,2,2,251699,251700,251702,1,3,0
72002,4,3,251703,251703,251706,0,3,1
72003,2,1,251705,251706,251707,1,2,0
72004,5,1,251710,251710,251711,0,1,3
72005,3,1,251713,251713,251714,0,1,2
72006,4,3,251717,251717,251720,0,3,3
72007,2,3,251719,251720,251723,1,4,0
72008,5,2,251724,251724,251726,0,2,1
72009,6,1,251730,251730,251731,0,1,4
72010,4,1,251734,251734,251735,0,1,3
72011,1,2,251735,251735,251737,0,2,0
72012,6,3,251741,251741,251744,0,3,4
72013,2,1,251743,251744,251745,1,2,0
72014,3,3,251746,251746,251749,0,3,1
72015,6,2,251752,251752,251754,0,2,3
72016,6,2,251758,251758,251760,0,2,4
72017,3,2,251761,251761,251763,0,2,1
72018,2,1,251763,251763,251764,0,1,0
72019,3,1,251766,251766,251767,0,1,2
72020,2,2,251768,251768,251770,0,2,1
72021,6,1,251774,251774,251775,0,1,4
72022,6,2,251780,251780,251782,0,2,5
72023,1,2,251781,251782,251784,1,3,0
72024,1,3,251782,251784,251787,2,5,0
72025,1,1,251783,251787,251788,4,5,0
72026,5,3,251788,251788,251791,0,3,0
72027,4,3,251792,251792,251795,0,3,1
72028,1,2,251793,251795,251797,2,4,0
72029,6,2,251799,251799,251801,0,2,2
72030,6,1,251805,251805,251806,0,1,4
72031,2,1,251807,251807,251808,0,1,1
72032,1,1,251808,251808,251809,0,1,0
72033,1,2,251809,251809,251811,0,2,0
72034,2,1,251811,251811,251812,0,1,0
72035,3,2,251814,251814,251816,0,2,2
72036,6,2,251820,251820,251822,0,2,4
72037,2,2,251822,251822,251824,0,2,0
72038,5,1,251827,251827,251828,0,1,3
72039,2,2,251829,251829,251831,0,2,1
72040,6,3,251835,251835,251838,0,3,4
72041,1,1,251836,251838,251839,2,3,0
72042,2,3,251838,251839,251842,1,4,0
72043,5,1,251843,251843,251844,0,1,1
72044,1,1,251844,251844,251845,0,1,0
72045,5,3,251849,251849,251852,0,3,4
72046,5,2,251854,251854,251856,0,2,2
72047,5,2,251859,251859,251861,0,2,3
72048,6,1,251865,251865,251866,0,1,4
72049,4,2,251869,251869,251871,0,2,3
72050,2,1,251871,251871,251872,0,1,0
72051,3,3,251874,251874,251877,0,3,2
72052,4,2,251878,251878,251880,0,2,1
72053,1,1,251879,251880,251881,1,2,0
72054,4,2,251883,251883,251885,0,2,2
72055,5,3,251888,251888,251891,0,3,3
72056,4,2,251892,251892,251894,0,2,1
72057,5,3,251897,251897,251900,0,3,3
72058,5,2,251902,251902,251904,0,2,2
72059,5,1,251907,251907,251908,0,1,3
72060,6,3,251913,251913,251916,0,3,5
72061,1,2,251914,251916,251918,2,4,0
72062,5,1,251919,251919,251920,0,1,1
72063,5,3,251924,251924,251927,0,3,4
72064,6,2,251930,251930,251932,0,2,3
72065,3,3,251933,251933,251936,0,3,1
72066,1,3,251934,251936,251939,2,5,0
72067,5,3,251939,251939,251942,0,3,0
72068,5,3,251944,251944,251947,0,3,2
72069,2,2,251946,251947,251949,1,3,0
72070,5,2,251951,251951,251953,0,2,2
72071,2,1,251953,251953,251954,0,1,0
72072,5,1,251958,251958,251959,0,1,4
72073,4,2,251962,251962,251964,0,2,3
72074,2,2,251964,251964,251966,0,2,0
72075,5,2,251969,251969,251971,0,2,3
72076,3,2,251972,251972,251974,0,2,1
72077,6,3,251978,251978,251981,0,3,4
72078,3,2,251981,251981,251983,0,2,0
72079,6,3,251987,251987,251990,0,3,4
72080,2,3,251989,251990,251993,1,4,0
72081,1,2,251990,251993,251995,3,5,0
72082,6,3,251996,251996,251999,0,3,1
72083,6,2,252002,252002,252004,0,2,3
72084,1,1,252003,252004,252005,1,2,0
72085,3,1,252006,252006,252007,0,1,1
72086,4,3,252010,252010,252013,0,3,3
72087,5,1,252015,252015,252016,0,1,2
72088,1,3,252016,252016,252019,0,3,0
72089,3,1,252019,252019,252020,0,1,0
72090,1,2,252020,252020,252022,0,2,0
72091,4,1,252024,252024,252025,0,1,2
72092,5,2,252029,252029,252031,0,2,4
72093,3,3,252032,252032,252035,0,3,1
72094,6,3,252038,252038,252041,0,3,3
72095,6,2,252044,252044,252046,0,2,3
72096,4,2,252048,252048,252050,0,2,2
72097,5,3,252053,252053,252056,0,3,3
72098,3,3,252056,252056,252059,0,3,0
72099,5,3,252061,252061,252064,0,3,2
72100,3,3,252064,252064,252067,0,3,0
72101,6,3,252070,252070,252073,0,3,3
72102,3,3,252073,252073,252076,0,3,0
72103,3,2,252076,252076,252078,0,2,0
72104,2,3,252078,252078,252081,0,3,0
72105,1,1,252079,252081,252082,2,3,0
72106,5,3,252084,252084,252087,0,3,2
72107,2,2,252086,252087,252089,1,3,0
72108,2,2,252088,252089,252091,1,3,0
72109,4,3,252092,252092,252095,0,3,1
72110,6,2,252098,252098,252100,0,2,3
72111,4,1,252102,252102,252103,0,1,2
72112,5,1,252107,252107,252108,0,1,4
72113,5,3,252112,252112,252115,0,3,4
72114,5,2,252117,252117,252119,0,2,2
72115,2,1,252119,252119,252120,0,1,0
72116,2,3,252121,252121,252124,0,3,1
72117,5,1,252126,252126,252127,0,1,2
72118,6,1,252132,252132,252133,0,1,5
72119,5,2,252137,252137,252139,0,2,4
72120,4,3,252141,252141,252144,0,3,2
72121,2,3,252143,252144,252147,1,4,0
72122,1,2,252144,252147,252149,3,5,0
72123,5,1,252149,252149,252150,0,1,0
72124,4,2,252153,252153,252155,0,2,3
72125,5,2,252158,252158,252160,0,2,3
72126,5,3,252163,252163,252166,0,3,3
72127,6,3,252169,252169,252172,0,3,3
72128,1,2,252170,252172,252174,2,4,0
72129,6,2,252176,252176,252178,0,2,2
72130,5,1,252181,252181,252182,0,1,3
72131,2,1,252183,252183,252184,0,1,1
72132,5,2,252188,252188,252190,0,2,4
72133,3,1,252191,252191,252192,0,1,1
72134,1,2,252192,252192,252194,0,2,0
72135,2,1,252194,252194,252195,0,1,0
72136,6,1,252200,252200,252201,0,1,5
72137,1,3,252201,252201,252204,0,3,0
72138,3,2,252204,252204,252206,0,2,0
72139,6,2,252210,252210,252212,0,2,4
72140,5,3,252215,252215,252218,0,3,3
72141,6,1,252221,252221,252222,0,1,3
72142,6,2,252227,252227,252229,0,2,5
72143,2,2,252229,252229,252231,0,2,0
72144,1,1,252230,252231,252232,1,2,0
72145,1,1,252231,252232,252233,1,2,0
72146,5,2,252236,252236,252238,0,2,3
72147,5,2,252241,252241,252243,0,2,3
72148,2,1,252243,252243,252244,0,1,0
72149,1,3,252244,252244,252247,0,3,0
72150,5,2,252249,252249,252251,0,2,2
72151,3,2,252252,252252,252254,0,2,1
72152,6,1,252258,252258,252259,0,1,4
72153,6,3,252264,252264,252267,0,3,5
72154,4,1,252268,252268,252269,0,1,1
72155,6,2,252274,252274,252276,0,2,5
72156,6,3,252280,252280,252283,0,3,4
72157,1,3,252281,252283,252286,2,5,0
72158,3,2,252284,252286,252288,2,4,0
72159,6,1,252290,252290,252291,0,1,2
72160,6,1,252296,252296,252297,0,1,5
72161,4,3,252300,252300,252303,0,3,3
72162,2,3,252302,252303,252306,1,4,0
72163,3,3,252305,252306,252309,1,4,0
72164,3,1,252308,252309,252310,1,2,0
72165,6,2,252314,252314,252316,0,2,4
72166,6,1,252320,252320,252321,0,1,4
72167,4,2,252324,252324,252326,0,2,3
72168,4,2,252328,252328,252330,0,2,2
72169,3,3,252331,252331,252334,0,3,1
72170,3,2,252334,252334,252336,0,2,0
72171,5,3,252339,252339,252342,0,3,3
72172,1,1,252340,252342,252343,2,3,0
72173,4,2,252344,252344,252346,0,2,1
72174,5,2,252349,252349,252351,0,2,3
72175,6,1,252355,252355,252356,0,1,4
72176,6,2,252361,252361,252363,0,2,5
72177,3,3,252364,252364,252367,0,3,1
72178,1,1,252365,252367,252368,2,3,0
72179,3,3,252368,252368,252371,0,3,0
72180,2,3,252370,252371,252374,1,4,0
72181,1,1,252371,252374,252375,3,4,0
72182,5,2,252376,252376,252378,0,2,1
72183,6,1,252382,252382,252383,0,1,4
72184,1,1,252383,252383,252384,0,1,0
72185,5,3,252388,252388,252391,0,3,4
72186,4,2,252392,252392,252394,0,2,1
72187,4,2,252396,252396,252398,0,2,2
72188,4,2,252400,252400,252402,0,2,2
72189,1,3,252401,252402,252405,1,4,0
72190,5,2,252406,252406,252408,0,2,1
72191,4,3,252410,252410,252413,0,3,2
72192,1,1,252411,252413,252414,2,3,0
72193,6,1,252417,252417,252418,0,1,3
72194,6,3,252423,252423,252426,0,3,5
72195,1,1,252424,252426,252427,2,3,0
72196,4,3,252428,252428,252431,0,3,1
72197,3,2,252431,252431,252433,0,2,0
72198,2,3,252433,252433,252436,0,3,0
72199,1,3,252434,252436,252439,2,5,0
72200,5,2,252439,252439,252441,0,2,0
72201,3,1,252442,252442,252443,0,1,1
72202,5,2,252447,252447,252449,0,2,4
72203,2,3,252449,252449,252452,0,3,0
72204,6,3,252455,252455,252458,0,3,3
72205,6,1,252461,252461,252462,0,1,3
72206,3,1,252464,252464,252465,0,1,2
72207,3,3,252467,252467,252470,0,3,2
72208,5,1,252472,252472,252473,0,1,2
72209,6,2,252478,252478,252480,0,2,5
72210,3,3,252481,252481,252484,0,3,1
72211,6,3,252487,252487,252490,0,3,3
72212,1,2,252488,252490,252492,2,4,0
72213,5,3,252493,252493,252496,0,3,1
72214,5,3,252498,252498,252501,0,3,2
72215,1,3,252499,252501,252504,2,5,0
72216,5,1,252504,252504,252505,0,1,0
72217,6,2,252510,252510,252512,0,2,5
72218,4,2,252514,252514,252516,0,2,2
72219,6,1,252520,252520,252521,0,1,4
72220,2,3,252522,252522,252525,0,3,1
72221,6,2,252528,252528,252530,0,2,3
72222,2,2,252530,252530,252532,0,2,0
72223,3,1,252533,252533,252534,0,1,1
72224,5,3,252538,252538,252541,0,3,4
72225,2,1,252540,252541,252542,1,2,0
72226,5,3,252545,252545,252548,0,3,3
72227,5,3,252550,252550,252553,0,3,2
72228,6,3,252556,252556,252559,0,3,3
72229,5,1,252561,252561,252562,0,1,2
72230,3,3,252564,252564,252567,0,3,2
72231,6,1,252570,252570,252571,0,1,3
72232,4,3,252574,252574,252577,0,3,3
72233,5,1,252579,252579,252580,0,1,2
72234,6,1,252585,252585,252586,0,1,5
72235,4,2,252589,252589,252591,0,2,3
72236,2,1,252591,252591,252592,0,1,0
72237,5,1,252596,252596,252597,0,1,4
72238,4,2,252600,252600,252602,0,2,3
72239,4,3,252604,252604,252607,0,3,2
72240,1,1,252605,252607,252608,2,3,0
72241,6,3,252611,252611,252614,0,3,3
72242,1,3,252612,252614,252617,2,5,0
72243,5,3,252617,252617,252620,0,3,0
72244,5,1,252622,252622,252623,0,1,2
72245,3,2,252625,252625,252627,0,2,2
72246,6,1,252631,252631,252632,0,1,4
72247,6,2,252637,252637,252639,0,2,5
72248,6,2,252643,252643,252645,0,2,4
72249,4,3,252647,252647,252650,0,3,2
72250,1,1,252648,252650,252651,2,3,0
72251,5,2,252653,252653,252655,0,2,2
72252,5,3,252658,252658,252661,0,3,3
72253,3,1,252661,252661,252662,0,1,0
72254,3,2,252664,252664,252666,0,2,2
72255,6,2,252670,252670,252672,0,2,4
72256,2,1,252672,252672,252673,0,1,0
72257,1,2,252673,252673,252675,0,2,0
72258,3,3,252676,252676,252679,0,3,1
72259,4,1,252680,252680,252681,0,1,1
72260,2,2,252682,252682,252684,0,2,1
72261,3,2,252685,252685,252687,0,2,1
72262,2,2,252687,252687,252689,0,2,0
72263,4,2,252691,252691,252693,0,2,2
72264,1,3,252692,252693,252696,1,4,0
72265,5,1,252697,252697,252698,0,1,1
72266,5,3,252702,252702,252705,0,3,4
72267,4,2,252706,252706,252708,0,2,1
72268,2,2,252708,252708,252710,0,2,0
72269,4,2,252712,252712,252714,0,2,2
72270,5,2,252717,252717,252719,0,2,3
72271,3,1,252720,252720,252721,0,1,1
72272,4,1,252724,252724,252725,0,1,3
72273,1,3,252725,252725,252728,0,3,0
72274,5,1,252730,252730,252731,0,1,2
72275,5,1,252735,252735,252736,0,1,4
72276,6,2,252741,252741,252743,0,2,5
72277,5,2,252746,252746,252748,0,2,3
72278,4,2,252750,252750,252752,0,2,2
72279,6,1,252756,252756,252757,0,1,4
72280,3,1,252759,252759,252760,0,1,2
72281,6,3,252765,252765,252768,0,3,5
72282,3,2,252768,252768,252770,0,2,0
72283,2,3,252770,252770,252773,0,3,0
72284,6,2,252776,252776,252778,0,2,3
72285,4,2,252780,252780,252782,0,2,2
72286,4,1,252784,252784,252785,0,1,2
72287,6,3,252790,252790,252793,0,3,5
72288,3,3,252793,252793,252796,0,3,0
72289,3,1,252796,252796,252797,0,1,0
72290,5,3,252801,252801,252804,0,3,4
72291,1,3,252802,252804,252807,2,5,0
72292,3,2,252805,252807,252809,2,4,0
72293,2,2,252807,252809,252811,2,4,0
72294,6,1,252813,252813,252814,0,1,2
72295,5,1,252818,252818,252819,0,1,4
72296,5,1,252823,252823,252824,0,1,4
72297,1,1,252824,252824,252825,0,1,0
72298,1,2,252825,252825,252827,0,2,0
72299,2,2,252827,252827,252829,0,2,0
72300,5,1,252832,252832,252833,0,1,3
72301,2,3,252834,252834,252837,0,3,1
72302,4,2,252838,252838,252840,0,2,1
72303,2,2,252840,252840,252842,0,2,0
72304,5,3,252845,252845,252848,0,3,3
72305,4,3,252849,252849,252852,0,3,1
72306,2,3,252851,252852,252855,1,4,0
72307,2,2,252853,252855,252857,2,4,0
72308,3,1,252856,252857,252858,1,2,0
72309,5,1,252861,252861,252862,0,1,3
72310,5,3,252866,252866,252869,0,3,4
72311,1,3,252867,252869,252872,2,5,0
72312,3,1,252870,252872,252873,2,3,0
72313,6,2,252876,252876,252878,0,2,3
72314,6,1,252882,252882,252883,0,1,4
72315,5,3,252887,252887,252890,0,3,4
72316,1,2,252888,252890,252892,2,4,0
72317,3,1,252891,252892,252893,1,2,0
72318,5,3,252896,252896,252899,0,3,3
72319,5,1,252901,252901,252902,0,1,2
72320,3,1,252904,252904,252905,0,1,2
72321,5,2,252909,252909,252911,0,2,4
72322,6,1,252915,252915,252916,0,1,4
72323,1,3,252916,252916,252919,0,3,0
72324,4,3,252920,252920,252923,0,3,1
72325,6,3,252926,252926,252929,0,3,3
72326,1,3,252927,252929,252932,2,5,0
72327,5,1,252932,252932,252933,0,1,0
72328,2,3,252934,252934,252937,0,3,1
72329,1,1,252935,252937,252938,2,3,0
72330,4,2,252939,252939,252941,0,2,1
72331,2,2,252941,252941,252943,0,2,0
72332,4,2,252945,252945,252947,0,2,2
72333,1,1,252946,252947,252948,1,2,0
72334,4,1,252950,252950,252951,0,1,2
72335,2,1,252952,252952,252953,0,1,1
72336,4,3,252956,252956,252959,0,3,3
72337,4,3,252960,252960,252963,0,3,1
72338,1,3,252961,252963,252966,2,5,0
72339,3,3,252964,252966,252969,2,5,0
72340,5,3,252969,252969,252972,0,3,0
72341,2,1,252971,252972,252973,1,2,0
72342,1,1,252972,252973,252974,1,2,0
72343,3,1,252975,252975,252976,0,1,1
72344,6,3,252981,252981,252984,0,3,5
72345,4,3,252985,252985,252988,0,3,1
72346,1,2,252986,252988,252990,2,4,0
72347,3,1,252989,252990,252991,1,2,0
72348,5,3,252994,252994,252997,0,3,3
72349,6,2,253000,253000,253002,0,2,3
72350,4,2,253004,253004,253006,0,2,2
72351,2,3,253006,253006,253009,0,3,0
72352,3,2,253009,253009,253011,0,2,0
72353,4,2,253013,253013,253015,0,2,2
72354,4,3,253017,253017,253020,0,3,2
72355,3,2,253020,253020,253022,0,2,0
72356,6,3,253026,253026,253029,0,3,4
72357,5,3,253031,253031,253034,0,3,2
72358,1,1,253032,253034,253035,2,3,0
72359,6,3,253038,253038,253041,0,3,3
72360,4,1,253042,253042,253043,0,1,1
72361,4,3,253046,253046,253049,0,3,3
72362,4,2,253050,253050,253052,0,2,1
72363,5,2,253055,253055,253057,0,2,3
72364,2,3,253057,253057,253060,0,3,0
72365,1,3,253058,253060,253063,2,5,0
72366,5,2,253063,253063,253065,0,2,0
72367,1,1,253064,253065,253066,1,2,0
72368,5,3,253069,253069,253072,0,3,3
72369,2,1,253071,253072,253073,1,2,0
72370,4,1,253075,253075,253076,0,1,2
72371,5,3,253080,253080,253083,0,3,4
72372,6,3,253086,253086,253089,0,3,3
72373,5,3,253091,253091,253094,0,3,2
72374,3,1,253094,253094,253095,0,1,0
72375,1,2,253095,253095,253097,0,2,0
72376,4,3,253099,253099,253102,0,3,2
72377,6,2,253105,253105,253107,0,2,3
72378,5,1,253110,253110,253111,0,1,3
72379,3,1,253113,253113,253114,0,1,2
72380,1,2,253114,253114,253116,0,2,0
72381,6,1,253120,253120,253121,0,1,4
72382,3,3,253123,253123,253126,0,3,2
72383,4,2,253127,253127,253129,0,2,1
72384,4,1,253131,253131,253132,0,1,2
72385,5,2,253136,253136,253138,0,2,4
72386,1,2,253137,253138,253140,1,3,0
72387,5,2,253142,253142,253144,0,2,2
72388,2,1,253144,253144,253145,0,1,0
72389,6,3,253150,253150,253153,0,3,5
72390,1,1,253151,253153,253154,2,3,0
72391,2,3,253153,253154,253157,1,4,0
72392,1,2,253154,253157,253159,3,5,0
72393,4,3,253158,253159,253162,1,4,0
72394,1,2,253159,253162,253164,3,5,0
72395,3,3,253162,253164,253167,2,5,0
72396,2,3,253164,253167,253170,3,6,0
72397,5,2,253169,253170,253172,1,3,0
72398,5,3,253174,253174,253177,0,3,2
72399,6,1,253180,253180,253181,0,1,3
72400,4,3,253184,253184,253187,0,3,3
72401,4,2,253188,253188,253190,0,2,1
72402,4,2,253192,253192,253194,0,2,2
72403,6,2,253198,253198,253200,0,2,4
72404,5,3,253203,253203,253206,0,3,3
72405,1,2,253204,253206,253208,2,4,0
72406,1,1,253205,253208,253209,3,4,0
72407,1,3,253206,253209,253212,3,6,0
72408,1,2,253207,253212,253214,5,7,0
72409,2,3,253209,253214,253217,5,8,0
72410,3,3,253212,253217,253220,5,8,0
72411,5,3,253217,253220,253223,3,6,0
72412,2,1,253219,253223,253224,4,5,0
72413,5,3,253224,253224,253227,0,3,0
72414,6,3,253230,253230,253233,0,3,3
72415,4,1,253234,253234,253235,0,1,1
72416,3,2,253237,253237,253239,0,2,2
72417,2,2,253239,253239,253241,0,2,0
72418,6,3,253245,253245,253248,0,3,4
72419,5,3,253250,253250,253253,0,3,2
72420,5,2,253255,253255,253257,0,2,2
72421,5,1,253260,253260,253261,0,1,3
72422,3,3,253263,253263,253266,0,3,2
72423,6,3,253269,253269,253272,0,3,3
72424,4,2,253273,253273,253275,0,2,1
72425,4,3,253277,253277,253280,0,3,2
72426,4,3,253281,253281,253284,0,3,1
72427,6,1,253287,253287,253288,0,1,3
72428,6,2,253293,253293,253295,0,2,5
72429,3,1,253296,253296,253297,0,1,1
72430,6,1,253302,253302,253303,0,1,5
72431,4,1,253306,253306,253307,0,1,3
72432,3,3,253309,253309,253312,0,3,2
72433,6,2,253315,253315,253317,0,2,3
72434,5,2,253320,253320,253322,0,2,3
72435,6,3,253326,253326,253329,0,3,4
72436,1,3,253327,253329,253332,2,5,0
72437,3,1,253330,253332,253333,2,3,0
72438,4,1,253334,253334,253335,0,1,1
72439,6,3,253340,253340,253343,0,3,5
72440,6,1,253346,253346,253347,0,1,3
72441,3,1,253349,253349,253350,0,1,2
72442,4,1,253353,253353,253354,0,1,3
72443,2,3,253355,253355,253358,0,3,1
72444,1,2,253356,253358,253360,2,4,0
72445,5,2,253361,253361,253363,0,2,1
72446,2,1,253363,253363,253364,0,1,0
72447,1,3,253364,253364,253367,0,3,0
72448,2,3,253366,253367,253370,1,4,0
72449,4,1,253370,253370,253371,0,1,0
72450,1,1,253371,253371,253372,0,1,0
72451,3,3,253374,253374,253377,0,3,2
72452,3,3,253377,253377,253380,0,3,0
72453,1,3,253378,253380,253383,2,5,0
72454,2,3,253380,253383,253386,3,6,0
72455,1,1,253381,253386,253387,5,6,0
72456,1,1,253382,253387,253388,5,6,0
72457,2,3,253384,253388,253391,4,7,0
72458,3,1,253387,253391,253392,4,5,0
72459,4,2,253391,253392,253394,1,3,0
72460,6,3,253397,253397,253400,0,3,3
72461,5,2,253402,253402,253404,0,2,2
72462,1,3,253403,253404,253407,1,4,0
72463,3,3,253406,253407,253410,1,4,0
72464,2,3,253408,253410,253413,2,5,0
72465,6,2,253414,253414,253416,0,2,1
72466,6,2,253420,253420,253422,0,2,4
72467,2,1,253422,253422,253423,0,1,0
72468,6,2,253428,253428,253430,0,2,5
72469,6,2,253434,253434,253436,0,2,4
72470,1,3,253435,253436,253439,1,4,0
72471,4,2,253439,253439,253441,0,2,0
72472,3,1,253442,253442,253443,0,1,1
72473,3,3,253445,253445,253448,0,3,2
72474,4,3,253449,253449,253452,0,3,1
72475,4,2,253453,253453,253455,0,2,1
72476,3,1,253456,253456,253457,0,1,1
72477,4,2,253460,253460,253462,0,2,3
72478,5,2,253465,253465,253467,0,2,3
72479,4,1,253469,253469,253470,0,1,2
72480,6,1,253475,253475,253476,0,1,5
72481,1,1,253476,253476,253477,0,1,0
72482,6,3,253482,253482,253485,0,3,5
72483,5,2,253487,253487,253489,0,2,2
72484,6,3,253493,253493,253496,0,3,4
72485,3,1,253496,253496,253497,0,1,0
72486,3,1,253499,253499,253500,0,1,2
72487,1,2,253500,253500,253502,0,2,0
72488,1,2,253501,253502,253504,1,3,0
72489,1,3,253502,253504,253507,2,5,0
72490,6,2,253508,253508,253510,0,2,1
72491,1,1,253509,253510,253511,1,2,0
72492,4,2,253513,253513,253515,0,2,2
72493,1,2,253514,253515,253517,1,3,0
72494,5,3,253519,253519,253522,0,3,2
72495,5,3,253524,253524,253527,0,3,2
72496,5,3,253529,253529,253532,0,3,2
72497,1,3,253530,253532,253535,2,5,0
72498,5,2,253535,253535,253537,0,2,0
72499,2,3,253537,253537,253540,0,3,0
72500,4,2,253541,253541,253543,0,2,1
72501,3,1,253544,253544,253545,0,1,1
72502,1,3,253545,253545,253548,0,3,0
72503,4,2,253549,253549,253551,0,2,1
72504,5,2,253554,253554,253556,0,2,3
72505,4,1,253558,253558,253559,0,1,2
72506,1,2,253559,253559,253561,0,2,0
72507,2,3,253561,253561,253564,0,3,0
72508,3,1,253564,253564,253565,0,1,0
72509,5,2,253569,253569,253571,0,2,4
72510,1,1,253570,253571,253572,1,2,0
72511,5,1,253575,253575,253576,0,1,3
72512,4,1,253579,253579,253580,0,1,3
72513,1,1,253580,253580,253581,0,1,0
72514,1,1,253581,253581,253582,0,1,0
72515,2,2,253583,253583,253585,0,2,1
72516,6,2,253589,253589,253591,0,2,4
72517,1,3,253590,253591,253594,1,4,0
72518,5,1,253595,253595,253596,0,1,1
72519,4,2,253599,253599,253601,0,2,3
72520,3,3,253602,253602,253605,0,3,1
72521,4,1,253606,253606,253607,0,1,1
72522,5,3,253611,253611,253614,0,3,4
72523,4,3,253615,253615,253618,0,3,1
72524,3,3,253618,253618,253621,0,3,0
72525,2,3,253620,253621,253624,1,4,0
72526,4,3,253624,253624,253627,0,3,0
72527,3,2,253627,253627,253629,0,2,0
72528,1,2,253628,253629,253631,1,3,0
72529,6,1,253634,253634,253635,0,1,3
72530,1,3,253635,253635,253638,0,3,0
72531,4,1,253639,253639,253640,0,1,1
72532,2,1,253641,253641,253642,0,1,1
72533,1,1,253642,253642,253643,0,1,0
72534,3,1,253645,253645,253646,0,1,2
72535,5,1,253650,253650,253651,0,1,4
72536,1,3,253651,253651,253654,0,3,0
72537,2,1,253653,253654,253655,1,2,0
72538,6,3,253659,253659,253662,0,3,4
72539,6,1,253665,253665,253666,0,1,3
72540,4,2,253669,253669,253671,0,2,3
72541,6,2,253675,253675,253677,0,2,4
72542,1,1,253676,253677,253678,1,2,0
72543,6,3,253682,253682,253685,0,3,4
72544,6,2,253688,253688,253690,0,2,3
72545,3,3,253691,253691,253694,0,3,1
72546,4,2,253695,253695,253697,0,2,1
72547,2,3,253697,253697,253700,0,3,0
72548,3,2,253700,253700,253702,0,2,0
72549,6,2,253706,253706,253708,0,2,4
72550,1,1,253707,253708,253709,1,2,0
72551,4,2,253711,253711,253713,0,2,2
72552,1,3,253712,253713,253716,1,4,0
72553,2,1,253714,253716,253717,2,3,0
72554,6,1,253720,253720,253721,0,1,3
72555,5,3,253725,253725,253728,0,3,4
72556,1,3,253726,253728,253731,2,5,0
72557,5,3,253731,253731,253734,0,3,0
72558,1,2,253732,253734,253736,2,4,0
72559,6,3,253738,253738,253741,0,3,2
72560,3,3,253741,253741,253744,0,3,0
72561,3,1,253744,253744,253745,0,1,0
72562,3,2,253747,253747,253749,0,2,2
72563,6,1,253753,253753,253754,0,1,4
72564,5,2,253758,253758,253760,0,2,4
72565,6,2,253764,253764,253766,0,2,4
72566,5,1,253769,253769,253770,0,1,3
72567,4,3,253773,253773,253776,0,3,3
72568,6,3,253779,253779,253782,0,3,3
72569,4,2,253783,253783,253785,0,2,1
72570,6,2,253789,253789,253791,0,2,4
72571,6,2,253795,253795,253797,0,2,4
72572,5,2,253800,253800,253802,0,2,3
72573,4,3,253804,253804,253807,0,3,2
72574,3,1,253807,253807,253808,0,1,0
72575,5,3,253812,253812,253815,0,3,4
72576,2,3,253814,253815,253818,1,4,0
72577,5,1,253819,253819,253820,0,1,1
72578,6,3,253825,253825,253828,0,3,5
72579,1,1,253826,253828,253829,2,3,0
72580,2,3,253828,253829,253832,1,4,0
72581,4,1,253832,253832,253833,0,1,0
72582,6,2,253838,253838,253840,0,2,5
72583,1,1,253839,253840,253841,1,2,0
72584,5,3,253844,253844,253847,0,3,3
72585,1,2,253845,253847,253849,2,4,0
72586,2,1,253847,253849,253850,2,3,0
72587,4,1,253851,253851,253852,0,1,1
72588,1,2,253852,253852,253854,0,2,0
72589,6,1,253858,253858,253859,0,1,4
72590,5,3,253863,253863,253866,0,3,4
72591,4,1,253867,253867,253868,0,1,1
72592,2,2,253869,253869,253871,0,2,1
72593,3,2,253872,253872,253874,0,2,1
72594,5,2,253877,253877,253879,0,2,3
72595,3,3,253880,253880,253883,0,3,1
72596,3,2,253883,253883,253885,0,2,0
72597,1,1,253884,253885,253886,1,2,0
72598,6,3,253890,253890,253893,0,3,4
72599,6,1,253896,253896,253897,0,1,3
72600,1,3,253897,253897,253900,0,3,0
72601,5,2,253902,253902,253904,0,2,2
72602,4,2,253906,253906,253908,0,2,2
72603,2,2,253908,253908,253910,0,2,0
72604,3,2,253911,253911,253913,0,2,1
72605,2,2,253913,253913,253915,0,2,0
72606,4,1,253917,253917,253918,0,1,2
72607,6,3,253923,253923,253926,0,3,5
72608,2,2,253925,253926,253928,1,3,0
72609,5,3,253930,253930,253933,0,3,2
72610,5,1,253935,253935,253936,0,1,2
72611,1,2,253936,253936,253938,0,2,0
72612,3,1,253939,253939,253940,0,1,1
72613,6,1,253945,253945,253946,0,1,5
72614,6,1,253951,253951,253952,0,1,5
72615,4,1,253955,253955,253956,0,1,3
72616,2,1,253957,253957,253958,0,1,1
72617,5,3,253962,253962,253965,0,3,4
72618,1,1,253963,253965,253966,2,3,0
72619,2,2,253965,253966,253968,1,3,0
72620,1,1,253966,253968,253969,2,3,0
72621,2,2,253968,253969,253971,1,3,0
72622,5,2,253973,253973,253975,0,2,2
72623,3,2,253976,253976,253978,0,2,1
72624,5,1,253981,253981,253982,0,1,3
72625,4,2,253985,253985,253987,0,2,3
72626,6,3,253991,253991,253994,0,3,4
72627,6,2,253997,253997,253999,0,2,3
72628,6,2,254003,254003,254005,0,2,4
72629,3,1,254006,254006,254007,0,1,1
72630,6,3,254012,254012,254015,0,3,5
72631,3,3,254015,254015,254018,0,3,0
72632,2,1,254017,254018,254019,1,2,0
72633,3,1,254020,254020,254021,0,1,1
72634,1,2,254021,254021,254023,0,2,0
72635,4,2,254025,254025,254027,0,2,2
72636,1,2,254026,254027,254029,1,3,0
72637,4,2,254030,254030,254032,0,2,1
72638,2,3,254032,254032,254035,0,3,0
72639,5,3,254037,254037,254040,0,3,2
72640,4,2,254041,254041,254043,0,2,1
72641,2,2,254043,254043,254045,0,2,0
72642,4,2,254047,254047,254049,0,2,2
72643,5,1,254052,254052,254053,0,1,3
72644,5,2,254057,254057,254059,0,2,4
72645,6,2,254063,254063,254065,0,2,4
72646,5,3,254068,254068,254071,0,3,3
72647,5,2,254073,254073,254075,0,2,2
72648,6,1,254079,254079,254080,0,1,4
72649,4,1,254083,254083,254084,0,1,3
72650,5,2,254088,254088,254090,0,2,4
72651,5,1,254093,254093,254094,0,1,3
72652,1,1,254094,254094,254095,0,1,0
72653,5,3,254099,254099,254102,0,3,4
72654,1,2,254100,254102,254104,2,4,0
72655,4,2,254104,254104,254106,0,2,0
72656,5,3,254109,254109,254112,0,3,3
72657,1,2,254110,254112,254114,2,4,0
72658,3,2,254113,254114,254116,1,3,0
72659,4,1,254117,254117,254118,0,1,1
72660,2,3,254119,254119,254122,0,3,1
72661,2,1,254121,254122,254123,1,2,0
72662,3,2,254124,254124,254126,0,2,1
72663,3,1,254127,254127,254128,0,1,1
72664,6,2,254133,254133,254135,0,2,5
72665,6,1,254139,254139,254140,0,1,4
72666,2,3,254141,254141,254144,0,3,1
72667,4,2,254145,254145,254147,0,2,1
72668,2,3,254147,254147,254150,0,3,0
72669,4,3,254151,254151,254154,0,3,1
72670,5,1,254156,254156,254157,0,1,2
72671,3,3,254159,254159,254162,0,3,2
72672,3,1,254162,254162,254163,0,1,0
72673,2,1,254164,254164,254165,0,1,1
72674,3,3,254167,254167,254170,0,3,2
72675,5,3,254172,254172,254175,0,3,2
72676,5,1,254177,254177,254178,0,1,2
72677,6,2,254183,254183,254185,0,2,5
72678,6,1,254189,254189,254190,0,1,4
72679,5,3,254194,254194,254197,0,3,4
72680,6,3,254200,254200,254203,0,3,3
72681,5,1,254205,254205,254206,0,1,2
72682,2,2,254207,254207,254209,0,2,1
72683,4,2,254211,254211,254213,0,2,2
72684,2,2,254213,254213,254215,0,2,0
72685,6,1,254219,254219,254220,0,1,4
72686,3,1,254222,254222,254223,0,1,2
72687,2,3,254224,254224,254227,0,3,1
72688,4,2,254228,254228,254230,0,2,1
72689,5,3,254233,254233,254236,0,3,3
72690,2,2,254235,254236,254238,1,3,0
72691,1,3,254236,254238,254241,2,5,0
72692,2,1,254238,254241,254242,3,4,0
72693,2,2,254240,254242,254244,2,4,0
72694,1,2,254241,254244,254246,3,5,0
72695,5,2,254246,254246,254248,0,2,0
72696,4,3,254250,254250,254253,0,3,2
72697,2,1,254252,254253,254254,1,2,0
72698,4,1,254256,254256,254257,0,1,2
72699,3,1,254259,254259,254260,0,1,2
72700,3,2,254262,254262,254264,0,2,2
72701,5,1,254267,254267,254268,0,1,3
72702,1,3,254268,254268,254271,0,3,0
72703,5,1,254273,254273,254274,0,1,2
72704,5,2,254278,254278,254280,0,2,4
72705,3,1,254281,254281,254282,0,1,1
72706,5,1,254286,254286,254287,0,1,4
72707,1,3,254287,254287,254290,0,3,0
72708,4,3,254291,254291,254294,0,3,1
72709,3,1,254294,254294,254295,0,1,0
72710,3,3,254297,254297,254300,0,3,2
72711,5,1,254302,254302,254303,0,1,2
72712,1,1,254303,254303,254304,0,1,0
72713,1,2,254304,254304,254306,0,2,0
72714,2,1,254306,254306,254307,0,1,0
72715,3,3,254309,254309,254312,0,3,2
72716,4,1,254313,254313,254314,0,1,1
72717,5,1,254318,254318,254319,0,1,4
72718,1,3,254319,254319,254322,0,3,0
72719,4,3,254323,254323,254326,0,3,1
72720,5,1,254328,254328,254329,0,1,2
72721,1,1,254329,254329,254330,0,1,0
72722,3,3,254332,254332,254335,0,3,2
72723,3,2,254335,254335,254337,0,2,0
72724,3,2,254338,254338,254340,0,2,1
72725,3,1,254341,254341,254342,0,1,1
72726,2,2,254343,254343,254345,0,2,1
72727,5,1,254348,254348,254349,0,1,3
72728,2,3,254350,254350,254353,0,3,1
72729,4,2,254354,254354,254356,0,2,1
72730,2,1,254356,254356,254357,0,1,0
72731,1,2,254357,254357,254359,0,2,0
72732,3,2,254360,254360,254362,0,2,1
72733,5,2,254365,254365,254367,0,2,3
72734,6,1,254371,254371,254372,0,1,4
72735,5,3,254376,254376,254379,0,3,4
72736,3,1,254379,254379,254380,0,1,0
72737,6,2,254385,254385,254387,0,2,5
72738,6,1,254391,254391,254392,0,1,4
72739,6,2,254397,254397,254399,0,2,5
72740,2,2,254399,254399,254401,0,2,0
72741,1,3,254400,254401,254404,1,4,0
72742,6,1,254406,254406,254407,0,1,2
72743,2,1,254408,254408,254409,0,1,1
72744,1,2,254409,254409,254411,0,2,0
72745,1,2,254410,254411,254413,1,3,0
72746,1,3,254411,254413,254416,2,5,0
72747,1,2,254412,254416,254418,4,6,0
72748,4,2,254416,254418,254420,2,4,0
72749,4,2,254420,254420,254422,0,2,0
72750,3,3,254423,254423,254426,0,3,1
72751,1,3,254424,254426,254429,2,5,0
72752,5,1,254429,254429,254430,0,1,0
72753,3,2,254432,254432,254434,0,2,2
72754,1,2,254433,254434,254436,1,3,0
72755,3,3,254436,254436,254439,0,3,0
72756,2,2,254438,254439,254441,1,3,0
72757,1,2,254439,254441,254443,2,4,0
72758,2,3,254441,254443,254446,2,5,0
72759,2,2,254443,254446,254448,3,5,0
72760,5,1,254448,254448,254449,0,1,0
72761,3,2,254451,254451,254453,0,2,2
72762,4,1,254455,254455,254456,0,1,2
72763,3,1,254458,254458,254459,0,1,2
72764,6,3,254464,254464,254467,0,3,5
72765,6,2,254470,254470,254472,0,2,3
72766,4,1,254474,254474,254475,0,1,2
72767,3,3,254477,254477,254480,0,3,2
72768,1,3,254478,254480,254483,2,5,0
72769,2,2,254480,254483,254485,3,5,0
72770,4,2,254484,254485,254487,1,3,0
72771,4,3,254488,254488,254491,0,3,1
72772,6,1,254494,254494,254495,0,1,3
72773,2,1,254496,254496,254497,0,1,1
72774,3,3,254499,254499,254502,0,3,2
72775,3,3,254502,254502,254505,0,3,0
72776,4,2,254506,254506,254508,0,2,1
72777,5,3,254511,254511,254514,0,3,3
72778,2,1,254513,254514,254515,1,2,0
72779,5,2,254518,254518,254520,0,2,3
72780,5,1,254523,254523,254524,0,1,3
72781,5,2,254528,254528,254530,0,2,4
72782,2,2,254530,254530,254532,0,2,0
72783,3,2,254533,254533,254535,0,2,1
72784,5,3,254538,254538,254541,0,3,3
72785,5,1,254543,254543,254544,0,1,2
72786,6,2,254549,254549,254551,0,2,5
72787,5,1,254554,254554,254555,0,1,3
72788,3,2,254557,254557,254559,0,2,2
72789,4,1,254561,254561,254562,0,1,2
72790,5,2,254566,254566,254568,0,2,4
72791,5,2,254571,254571,254573,0,2,3
72792,3,1,254574,254574,254575,0,1,1
72793,1,2,254575,254575,254577,0,2,0
72794,2,1,254577,254577,254578,0,1,0
72795,3,2,254580,254580,254582,0,2,2
72796,2,2,254582,254582,254584,0,2,0
72797,6,3,254588,254588,254591,0,3,4
72798,1,1,254589,254591,254592,2,3,0
72799,6,1,254595,254595,254596,0,1,3
72800,6,1,254601,254601,254602,0,1,5
72801,2,3,254603,254603,254606,0,3,1
72802,1,3,254604,254606,254609,2,5,0
72803,5,2,254609,254609,254611,0,2,0
72804,3,1,254612,254612,254613,0,1,1
72805,6,1,254618,254618,254619,0,1,5
72806,2,1,254620,254620,254621,0,1,1
72807,4,3,254624,254624,254627,0,3,3
72808,2,3,254626,254627,254630,1,4,0
72809,6,1,254632,254632,254633,0,1,2
72810,2,2,254634,254634,254636,0,2,1
72811,1,2,254635,254636,254638,1,3,0
72812,4,1,254639,254639,254640,0,1,1
72813,3,2,254642,254642,254644,0,2,2
72814,4,3,254646,254646,254649,0,3,2
72815,6,2,254652,254652,254654,0,2,3
72816,3,3,254655,254655,254658,0,3,1
72817,3,3,254658,254658,254661,0,3,0
72818,3,1,254661,254661,254662,0,1,0
72819,6,1,254667,254667,254668,0,1,5
72820,5,3,254672,254672,254675,0,3,4
72821,3,1,254675,254675,254676,0,1,0
72822,6,2,254681,254681,254683,0,2,5
72823,2,2,254683,254683,254685,0,2,0
72824,5,2,254688,254688,254690,0,2,3
72825,4,1,254692,254692,254693,0,1,2
72826,5,1,254697,254697,254698,0,1,4
72827,4,1,254701,254701,254702,0,1,3
72828,3,2,254704,254704,254706,0,2,2
72829,6,2,254710,254710,254712,0,2,4
72830,5,1,254715,254715,254716,0,1,3
72831,1,1,254716,254716,254717,0,1,0
72832,4,3,254720,254720,254723,0,3,3
72833,4,3,254724,254724,254727,0,3,1
72834,4,1,254728,254728,254729,0,1,1
72835,1,3,254729,254729,254732,0,3,0
72836,6,3,254735,254735,254738,0,3,3
72837,6,1,254741,254741,254742,0,1,3
72838,5,3,254746,254746,254749,0,3,4
72839,5,1,254751,254751,254752,0,1,2
72840,1,1,254752,254752,254753,0,1,0
72841,6,3,254758,254758,254761,0,3,5
72842,2,3,254760,254761,254764,1,4,0
72843,1,3,254761,254764,254767,3,6,0
72844,2,2,254763,254767,254769,4,6,0
72845,6,3,254769,254769,254772,0,3,0
72846,4,2,254773,254773,254775,0,2,1
72847,4,3,254777,254777,254780,0,3,2
72848,6,2,254783,254783,254785,0,2,3
72849,6,1,254789,254789,254790,0,1,4
72850,2,3,254791,254791,254794,0,3,1
72851,3,1,254794,254794,254795,0,1,0
72852,1,3,254795,254795,254798,0,3,0
72853,4,2,254799,254799,254801,0,2,1
72854,3,1,254802,254802,254803,0,1,1
72855,1,1,254803,254803,254804,0,1,0
72856,6,3,254809,254809,254812,0,3,5
72857,6,1,254815,254815,254816,0,1,3
72858,2,1,254817,254817,254818,0,1,1
72859,5,3,254822,254822,254825,0,3,4
72860,5,1,254827,254827,254828,0,1,2
72861,2,2,254829,254829,254831,0,2,1
72862,6,1,254835,254835,254836,0,1,4
72863,6,2,254841,254841,254843,0,2,5
72864,6,2,254847,254847,254849,0,2,4
72865,6,2,254853,254853,254855,0,2,4
72866,3,1,254856,254856,254857,0,1,1
72867,5,1,254861,254861,254862,0,1,4
72868,4,3,254865,254865,254868,0,3,3
72869,4,3,254869,254869,254872,0,3,1
72870,1,1,254870,254872,254873,2,3,0
72871,3,1,254873,254873,254874,0,1,0
72872,6,3,254879,254879,254882,0,3,5
72873,6,1,254885,254885,254886,0,1,3
72874,6,3,254891,254891,254894,0,3,5
72875,5,2,254896,254896,254898,0,2,2
72876,5,1,254901,254901,254902,0,1,3
72877,1,1,254902,254902,254903,0,1,0
72878,4,1,254906,254906,254907,0,1,3
72879,3,3,254909,254909,254912,0,3,2
72880,1,2,254910,254912,254914,2,4,0
72881,5,2,254915,254915,254917,0,2,1
72882,6,2,254921,254921,254923,0,2,4
72883,4,3,254925,254925,254928,0,3,2
72884,1,1,254926,254928,254929,2,3,0
72885,2,2,254928,254929,254931,1,3,0
72886,5,1,254933,254933,254934,0,1,2
72887,2,3,254935,254935,254938,0,3,1
72888,2,3,254937,254938,254941,1,4,0
72889,5,2,254942,254942,254944,0,2,1
72890,3,1,254945,254945,254946,0,1,1
72891,5,2,254950,254950,254952,0,2,4
72892,3,1,254953,254953,254954,0,1,1
72893,5,1,254958,254958,254959,0,1,4
72894,4,1,254962,254962,254963,0,1,3
72895,4,1,254966,254966,254967,0,1,3
72896,1,1,254967,254967,254968,0,1,0
72897,3,1,254970,254970,254971,0,1,2
72898,2,2,254972,254972,254974,0,2,1
72899,5,3,254977,254977,254980,0,3,3
72900,2,1,254979,254980,254981,1,2,0
72901,3,2,254982,254982,254984,0,2,1
72902,4,2,254986,254986,254988,0,2,2
72903,1,3,254987,254988,254991,1,4,0
72904,3,3,254990,254991,254994,1,4,0
72905,5,3,254995,254995,254998,0,3,1
72906,1,2,254996,254998,255000,2,4,0
72907,3,1,254999,255000,255001,1,2,0
72908,3,3,255002,255002,255005,0,3,1
72909,4,2,255006,255006,255008,0,2,1
72910,1,1,255007,255008,255009,1,2,0
72911,6,3,255013,255013,255016,0,3,4
72912,6,3,255019,255019,255022,0,3,3
72913,4,1,255023,255023,255024,0,1,1
72914,1,1,255024,255024,255025,0,1,0
72915,1,3,255025,255025,255028,0,3,0
72916,2,1,255027,255028,255029,1,2,0
72917,2,1,255029,255029,255030,0,1,0
72918,6,2,255035,255035,255037,0,2,5
72919,1,3,255036,255037,255040,1,4,0
72920,1,1,255037,255040,255041,3,4,0
72921,1,2,255038,255041,255043,3,5,0
72922,5,1,255043,255043,255044,0,1,0
72923,4,3,255047,255047,255050,0,3,3
72924,4,2,255051,255051,255053,0,2,1
72925,3,2,255054,255054,255056,0,2,1
72926,5,1,255059,255059,255060,0,1,3
72927,3,3,255062,255062,255065,0,3,2
72928,2,2,255064,255065,255067,1,3,0
72929,3,3,255067,255067,255070,0,3,0
72930,5,3,255072,255072,255075,0,3,2
72931,4,2,255076,255076,255078,0,2,1
72932,5,2,255081,255081,255083,0,2,3
72933,2,3,255083,255083,255086,0,3,0
72934,4,3,255087,255087,255090,0,3,1
72935,3,1,255090,255090,255091,0,1,0
72936,1,2,255091,255091,255093,0,2,0
72937,6,1,255097,255097,255098,0,1,4
72938,1,3,255098,255098,255101,0,3,0
72939,1,3,255099,255101,255104,2,5,0
72940,6,1,255105,255105,255106,0,1,1
72941,2,1,255107,255107,255108,0,1,1
72942,6,2,255113,255113,255115,0,2,5
72943,3,2,255116,255116,255118,0,2,1
72944,6,1,255122,255122,255123,0,1,4
72945,6,3,255128,255128,255131,0,3,5
72946,3,3,255131,255131,255134,0,3,0
72947,6,3,255137,255137,255140,0,3,3
72948,1,3,255138,255140,255143,2,5,0
72949,6,1,255144,255144,255145,0,1,1
72950,6,2,255150,255150,255152,0,2,5
72951,3,1,255153,255153,255154,0,1,1
72952,6,2,255159,255159,255161,0,2,5
72953,4,2,255163,255163,255165,0,2,2
72954,5,3,255168,255168,255171,0,3,3
72955,1,2,255169,255171,255173,2,4,0
72956,2,2,255171,255173,255175,2,4,0
72957,1,3,255172,255175,255178,3,6,0
72958,5,1,255177,255178,255179,1,2,0
72959,6,3,255183,255183,255186,0,3,4
72960,5,1,255188,255188,255189,0,1,2
72961,1,2,255189,255189,255191,0,2,0
72962,5,3,255194,255194,255197,0,3,3
72963,1,1,255195,255197,255198,2,3,0
72964,6,2,255201,255201,255203,0,2,3
72965,5,1,255206,255206,255207,0,1,3
72966,3,3,255209,255209,255212,0,3,2
72967,1,1,255210,255212,255213,2,3,0
72968,5,3,255215,255215,255218,0,3,2
72969,5,3,255220,255220,255223,0,3,2
72970,4,1,255224,255224,255225,0,1,1
72971,1,3,255225,255225,255228,0,3,0
72972,1,3,255226,255228,255231,2,5,0
72973,5,1,255231,255231,255232,0,1,0
72974,5,2,255236,255236,255238,0,2,4
72975,1,2,255237,255238,255240,1,3,0
72976,3,3,255240,255240,255243,0,3,0
72977,5,1,255245,255245,255246,0,1,2
72978,3,1,255248,255248,255249,0,1,2
72979,4,2,255252,255252,255254,0,2,3
72980,4,2,255256,255256,255258,0,2,2
72981,1,3,255257,255258,255261,1,4,0
72982,2,2,255259,255261,255263,2,4,0
72983,4,1,255263,255263,255264,0,1,0
72984,5,3,255268,255268,255271,0,3,4
72985,1,3,255269,255271,255274,2,5,0
72986,5,2,255274,255274,255276,0,2,0
72987,4,2,255278,255278,255280,0,2,2
72988,1,3,255279,255280,255283,1,4,0
72989,2,2,255281,255283,255285,2,4,0
72990,2,1,255283,255285,255286,2,3,0
72991,2,3,255285,255286,255289,1,4,0
72992,6,1,255291,255291,255292,0,1,2
72993,2,3,255293,255293,255296,0,3,1
72994,2,1,255295,255296,255297,1,2,0
72995,1,3,255296,255297,255300,1,4,0
72996,6,1,255302,255302,255303,0,1,2
72997,4,3,255306,255306,255309,0,3,3
72998,6,3,255312,255312,255315,0,3,3
72999,5,3,255317,255317,255320,0,3,2
73000,5,1,255322,255322,255323,0,1,2
73001,4,1,255326,255326,255327,0,1,3
73002,1,3,255327,255327,255330,0,3,0
73003,1,2,255328,255330,255332,2,4,0
73004,3,1,255331,255332,255333,1,2,0
73005,2,2,255333,255333,255335,0,2,0
73006,1,2,255334,255335,255337,1,3,0
73007,6,1,255340,255340,255341,0,1,3
73008,4,2,255344,255344,255346,0,2,3
73009,2,1,255346,255346,255347,0,1,0
73010,2,3,255348,255348,255351,0,3,1
73011,1,2,255349,255351,255353,2,4,0
73012,6,2,255355,255355,255357,0,2,2
73013,2,2,255357,255357,255359,0,2,0
73014,1,3,255358,255359,255362,1,4,0
73015,4,3,255362,255362,255365,0,3,0
73016,1,3,255363,255365,255368,2,5,0
73017,6,1,255369,255369,255370,0,1,1
73018,5,1,255374,255374,255375,0,1,4
73019,4,2,255378,255378,255380,0,2,3
73020,3,1,255381,255381,255382,0,1,1
73021,3,3,255384,255384,255387,0,3,2
73022,6,2,255390,255390,255392,0,2,3
73023,6,3,255396,255396,255399,0,3,4
73024,3,2,255399,255399,255401,0,2,0
73025,6,3,255405,255405,255408,0,3,4
73026,2,2,255407,255408,255410,1,3,0
73027,1,3,255408,255410,255413,2,5,0
73028,1,1,255409,255413,255414,4,5,0
73029,5,2,255414,255414,255416,0,2,0
73030,5,2,255419,255419,255421,0,2,3
73031,5,2,255424,255424,255426,0,2,3
73032,2,2,255426,255426,255428,0,2,0
73033,1,2,255427,255428,255430,1,3,0
73034,6,3,255433,255433,255436,0,3,3
73035,5,1,255438,255438,255439,0,1,2
73036,5,3,255443,255443,255446,0,3,4
73037,5,1,255448,255448,255449,0,1,2
73038,3,3,255451,255451,255454,0,3,2
73039,1,1,255452,255454,255455,2,3,0
73040,1,2,255453,255455,255457,2,4,0
73041,3,3,255456,255457,255460,1,4,0
73042,3,3,255459,255460,255463,1,4,0
73043,5,3,255464,255464,255467,0,3,1
73044,2,1,255466,255467,255468,1,2,0
73045,5,1,255471,255471,255472,0,1,3
73046,3,1,255474,255474,255475,0,1,2
73047,2,3,255476,255476,255479,0,3,1
73048,4,3,255480,255480,255483,0,3,1
73049,6,1,255486,255486,255487,0,1,3
73050,1,2,255487,255487,255489,0,2,0
73051,3,2,255490,255490,255492,0,2,1
73052,5,1,255495,255495,255496,0,1,3
73053,3,2,255498,255498,255500,0,2,2
73054,1,3,255499,255500,255503,1,4,0
73055,4,3,255503,255503,255506,0,3,0
73056,3,1,255506,255506,255507,0,1,0
73057,2,1,255508,255508,255509,0,1,1
73058,6,2,255514,255514,255516,0,2,5
73059,3,2,255517,255517,255519,0,2,1
73060,1,1,255518,255519,255520,1,2,0
73061,3,1,255521,255521,255522,0,1,1
73062,4,3,255525,255525,255528,0,3,3
73063,3,1,255528,255528,255529,0,1,0
73064,2,2,255530,255530,255532,0,2,1
73065,1,1,255531,255532,255533,1,2,0
73066,2,3,255533,255533,255536,0,3,0
73067,3,3,255536,255536,255539,0,3,0
73068,5,2,255541,255541,255543,0,2,2
73069,3,2,255544,255544,255546,0,2,1
73070,5,3,255549,255549,255552,0,3,3
73071,1,3,255550,255552,255555,2,5,0
73072,1,3,255551,255555,255558,4,7,0
73073,1,1,255552,255558,255559,6,7,0
73074,2,2,255554,255559,255561,5,7,0
73075,3,2,255557,255561,255563,4,6,0
73076,4,2,255561,255563,255565,2,4,0
73077,3,2,255564,255565,255567,1,3,0
73078,6,1,255570,255570,255571,0,1,3
73079,3,1,255573,255573,255574,0,1,2
73080,5,3,255578,255578,255581,0,3,4
73081,2,3,255580,255581,255584,1,4,0
73082,2,3,255582,255584,255587,2,5,0
73083,4,3,255586,255587,255590,1,4,0
73084,6,2,255592,255592,255594,0,2,2
73085,2,2,255594,255594,255596,0,2,0
73086,4,3,255598,255598,255601,0,3,2
73087,3,2,255601,255601,255603,0,2,0
73088,3,1,255604,255604,255605,0,1,1
73089,1,2,255605,255605,255607,0,2,0
73090,6,3,255611,255611,255614,0,3,4
73091,6,3,255617,255617,255620,0,3,3
73092,1,2,255618,255620,255622,2,4,0
73093,3,1,255621,255622,255623,1,2,0
73094,3,2,255624,255624,255626,0,2,1
73095,4,3,255628,255628,255631,0,3,2
73096,6,2,255634,255634,255636,0,2,3
73097,1,2,255635,255636,255638,1,3,0
73098,5,3,255640,255640,255643,0,3,2
73099,6,3,255646,255646,255649,0,3,3
73100,4,3,255650,255650,255653,0,3,1
73101,5,3,255655,255655,255658,0,3,2
73102,6,2,255661,255661,255663,0,2,3
73103,3,3,255664,255664,255667,0,3,1
73104,5,3,255669,255669,255672,0,3,2
73105,6,3,255675,255675,255678,0,3,3
73106,6,2,255681,255681,255683,0,2,3
73107,6,2,255687,255687,255689,0,2,4
73108,2,3,255689,255689,255692,0,3,0
73109,4,1,255693,255693,255694,0,1,1
73110,5,3,255698,255698,255701,0,3,4
73111,2,3,255700,255701,255704,1,4,0
73112,2,3,255702,255704,255707,2,5,0
73113,4,1,255706,255707,255708,1,2,0
73114,2,2,255708,255708,255710,0,2,0
73115,1,2,255709,255710,255712,1,3,0
73116,5,3,255714,255714,255717,0,3,2
73117,4,1,255718,255718,255719,0,1,1
73118,5,1,255723,255723,255724,0,1,4
73119,1,1,255724,255724,255725,0,1,0
73120,6,2,255730,255730,255732,0,2,5
73121,3,1,255733,255733,255734,0,1,1
73122,1,1,255734,255734,255735,0,1,0
73123,3,2,255737,255737,255739,0,2,2
73124,4,1,255741,255741,255742,0,1,2
73125,1,2,255742,255742,255744,0,2,0
73126,4,2,255746,255746,255748,0,2,2
73127,1,3,255747,255748,255751,1,4,0
73128,5,2,255752,255752,255754,0,2,1
73129,2,2,255754,255754,255756,0,2,0
73130,3,1,255757,255757,255758,0,1,1
73131,2,1,255759,255759,255760,0,1,1
73132,3,2,255762,255762,255764,0,2,2
73133,6,1,255768,255768,255769,0,1,4
73134,4,1,255772,255772,255773,0,1,3
73135,5,3,255777,255777,255780,0,3,4
73136,3,2,255780,255780,255782,0,2,0
73137,1,1,255781,255782,255783,1,2,0
73138,1,3,255782,255783,255786,1,4,0
73139,4,1,255786,255786,255787,0,1,0
73140,1,2,255787,255787,255789,0,2,0
73141,3,1,255790,255790,255791,0,1,1
73142,3,1,255793,255793,255794,0,1,2
73143,1,3,255794,255794,255797,0,3,0
73144,4,1,255798,255798,255799,0,1,1
73145,6,1,255804,255804,255805,0,1,5
73146,4,2,255808,255808,255810,0,2,3
73147,4,2,255812,255812,255814,0,2,2
73148,3,3,255815,255815,255818,0,3,1
73149,4,2,255819,255819,255821,0,2,1
73150,4,3,255823,255823,255826,0,3,2
73151,5,3,255828,255828,255831,0,3,2
73152,1,3,255829,255831,255834,2,5,0
73153,5,2,255834,255834,255836,0,2,0
73154,5,3,255839,255839,255842,0,3,3
73155,4,2,255843,255843,255845,0,2,1
73156,3,2,255846,255846,255848,0,2,1
73157,2,2,255848,255848,255850,0,2,0
73158,1,3,255849,255850,255853,1,4,0
73159,1,3,255850,255853,255856,3,6,0
73160,2,3,255852,255856,255859,4,7,0
73161,2,2,255854,255859,255861,5,7,0
73162,6,1,255860,255861,255862,1,2,0
73163,5,1,255865,255865,255866,0,1,3
73164,4,2,255869,255869,255871,0,2,3
73165,1,2,255870,255871,255873,1,3,0
73166,4,3,255874,255874,255877,0,3,1
73167,1,1,255875,255877,255878,2,3,0
73168,6,2,255881,255881,255883,0,2,3
73169,5,1,255886,255886,255887,0,1,3
73170,1,2,255887,255887,255889,0,2,0
73171,1,3,255888,255889,255892,1,4,0
73172,5,2,255893,255893,255895,0,2,1
73173,3,1,255896,255896,255897,0,1,1
73174,3,2,255899,255899,255901,0,2,2
73175,5,3,255904,255904,255907,0,3,3
73176,6,3,255910,255910,255913,0,3,3
73177,4,2,255914,255914,255916,0,2,1
73178,6,2,255920,255920,255922,0,2,4
73179,2,1,255922,255922,255923,0,1,0
73180,6,3,255928,255928,255931,0,3,5
73181,4,2,255932,255932,255934,0,2,1
73182,2,3,255934,255934,255937,0,3,0
73183,6,2,255940,255940,255942,0,2,3
73184,1,1,255941,255942,255943,1,2,0
73185,6,1,255947,255947,255948,0,1,4
73186,1,3,255948,255948,255951,0,3,0
73187,3,1,255951,255951,255952,0,1,0
73188,1,2,255952,255952,255954,0,2,0
73189,6,1,255958,255958,255959,0,1,4
73190,3,1,255961,255961,255962,0,1,2
73191,5,3,255966,255966,255969,0,3,4
73192,5,2,255971,255971,255973,0,2,2
73193,3,2,255974,255974,255976,0,2,1
73194,5,1,255979,255979,255980,0,1,3
73195,1,1,255980,255980,255981,0,1,0
73196,3,1,255983,255983,255984,0,1,2
73197,2,2,255985,255985,255987,0,2,1
73198,1,1,255986,255987,255988,1,2,0
73199,1,1,255987,255988,255989,1,2,0
73200,3,1,255990,255990,255991,0,1,1
73201,1,2,255991,255991,255993,0,2,0
73202,5,2,255996,255996,255998,0,2,3
73203,5,1,256001,256001,256002,0,1,3
73204,4,1,256005,256005,256006,0,1,3
73205,1,3,256006,256006,256009,0,3,0
73206,1,2,256007,256009,256011,2,4,0
73207,6,3,256013,256013,256016,0,3,2
73208,4,1,256017,256017,256018,0,1,1
73209,1,1,256018,256018,256019,0,1,0
73210,4,2,256022,256022,256024,0,2,3
73211,4,2,256026,256026,256028,0,2,2
73212,4,1,256030,256030,256031,0,1,2
73213,5,3,256035,256035,256038,0,3,4
73214,3,2,256038,256038,256040,0,2,0
73215,4,1,256042,256042,256043,0,1,2
73216,6,3,256048,256048,256051,0,3,5
73217,2,3,256050,256051,256054,1,4,0
73218,3,1,256053,256054,256055,1,2,0
73219,6,1,256059,256059,256060,0,1,4
73220,1,1,256060,256060,256061,0,1,0
73221,6,2,256066,256066,256068,0,2,5
73222,6,3,256072,256072,256075,0,3,4
73223,6,3,256078,256078,256081,0,3,3
73224,6,2,256084,256084,256086,0,2,3
73225,1,1,256085,256086,256087,1,2,0
73226,5,1,256090,256090,256091,0,1,3
73227,1,1,256091,256091,256092,0,1,0
73228,5,1,256096,256096,256097,0,1,4
73229,2,1,256098,256098,256099,0,1,1
73230,2,2,256100,256100,256102,0,2,1
73231,3,1,256103,256103,256104,0,1,1
73232,5,3,256108,256108,256111,0,3,4
73233,3,3,256111,256111,256114,0,3,0
73234,3,3,256114,256114,256117,0,3,0
73235,5,1,256119,256119,256120,0,1,2
73236,3,1,256122,256122,256123,0,1,2
73237,1,1,256123,256123,256124,0,1,0
73238,1,2,256124,256124,256126,0,2,0
73239,2,1,256126,256126,256127,0,1,0
73240,1,2,256127,256127,256129,0,2,0
73241,5,3,256132,256132,256135,0,3,3
73242,1,2,256133,256135,256137,2,4,0
73243,6,2,256139,256139,256141,0,2,2
73244,6,1,256145,256145,256146,0,1,4
73245,5,2,256150,256150,256152,0,2,4
73246,6,3,256156,256156,256159,0,3,4
73247,5,2,256161,256161,256163,0,2,2
73248,2,1,256163,256163,256164,0,1,0
73249,3,1,256166,256166,256167,0,1,2
73250,3,2,256169,256169,256171,0,2,2
73251,2,2,256171,256171,256173,0,2,0
73252,5,2,256176,256176,256178,0,2,3
73253,3,2,256179,256179,256181,0,2,1
73254,1,1,256180,256181,256182,1,2,0
73255,2,3,256182,256182,256185,0,3,0
73256,4,2,256186,256186,256188,0,2,1
73257,2,1,256188,256188,256189,0,1,0
73258,4,3,256192,256192,256195,0,3,3
73259,3,3,256195,256195,256198,0,3,0
73260,5,1,256200,256200,256201,0,1,2
73261,2,3,256202,256202,256205,0,3,1
73262,6,3,256208,256208,256211,0,3,3
73263,5,2,256213,256213,256215,0,2,2
73264,3,2,256216,256216,256218,0,2,1
73265,6,2,256222,256222,256224,0,2,4
73266,2,3,256224,256224,256227,0,3,0
73267,2,2,256226,256227,256229,1,3,0
73268,5,1,256231,256231,256232,0,1,2
73269,3,2,256234,256234,256236,0,2,2
73270,6,1,256240,256240,256241,0,1,4
73271,1,3,256241,256241,256244,0,3,0
73272,6,2,256247,256247,256249,0,2,3
73273,3,2,256250,256250,256252,0,2,1
73274,1,2,256251,256252,256254,1,3,0
73275,3,3,256254,256254,256257,0,3,0
73276,2,3,256256,256257,256260,1,4,0
73277,3,3,256259,256260,256263,1,4,0
73278,5,1,256264,256264,256265,0,1,1
73279,3,3,256267,256267,256270,0,3,2
73280,1,2,256268,256270,256272,2,4,0
73281,2,1,256270,256272,256273,2,3,0
73282,1,1,256271,256273,256274,2,3,0
73283,1,1,256272,256274,256275,2,3,0
73284,3,1,256275,256275,256276,0,1,0
73285,5,1,256280,256280,256281,0,1,4
73286,2,1,256282,256282,256283,0,1,1
73287,5,1,256287,256287,256288,0,1,4
73288,3,1,256290,256290,256291,0,1,2
73289,6,3,256296,256296,256299,0,3,5
73290,4,3,256300,256300,256303,0,3,1
73291,4,1,256304,256304,256305,0,1,1
73292,5,2,256309,256309,256311,0,2,4
73293,6,3,256315,256315,256318,0,3,4
73294,2,1,256317,256318,256319,1,2,0
73295,6,3,256323,256323,256326,0,3,4
73296,1,3,256324,256326,256329,2,5,0
73297,4,3,256328,256329,256332,1,4,0
73298,6,3,256334,256334,256337,0,3,2
73299,4,2,256338,256338,256340,0,2,1
73300,5,3,256343,256343,256346,0,3,3
73301,2,2,256345,256346,256348,1,3,0
73302,5,1,256350,256350,256351,0,1,2
73303,6,1,256356,256356,256357,0,1,5
73304,3,2,256359,256359,256361,0,2,2
73305,6,3,256365,256365,256368,0,3,4
73306,4,2,256369,256369,256371,0,2,1
73307,2,1,256371,256371,256372,0,1,0
73308,4,2,256375,256375,256377,0,2,3
73309,3,3,256378,256378,256381,0,3,1
73310,5,1,256383,256383,256384,0,1,2
73311,1,1,256384,256384,256385,0,1,0
73312,3,3,256387,256387,256390,0,3,2
73313,1,2,256388,256390,256392,2,4,0
73314,3,2,256391,256392,256394,1,3,0
73315,1,2,256392,256394,256396,2,4,0
73316,5,3,256397,256397,256400,0,3,1
73317,2,1,256399,256400,256401,1,2,0
73318,1,2,256400,256401,256403,1,3,0
73319,4,2,256404,256404,256406,0,2,1
73320,4,1,256408,256408,256409,0,1,2
73321,2,3,256410,256410,256413,0,3,1
73322,3,1,256413,256413,256414,0,1,0
73323,3,3,256416,256416,256419,0,3,2
73324,2,3,256418,256419,256422,1,4,0
73325,1,1,256419,256422,256423,3,4,0
73326,3,3,256422,256423,256426,1,4,0
73327,4,3,256426,256426,256429,0,3,0
73328,5,3,256431,256431,256434,0,3,2
73329,2,2,256433,256434,256436,1,3,0
73330,4,1,256437,256437,256438,0,1,1
73331,5,2,256442,256442,256444,0,2,4
73332,1,2,256443,256444,256446,1,3,0
73333,2,2,256445,256446,256448,1,3,0
73334,4,2,256449,256449,256451,0,2,1
73335,6,2,256455,256455,256457,0,2,4
73336,4,3,256459,256459,256462,0,3,2
73337,6,1,256465,256465,256466,0,1,3
73338,6,3,256471,256471,256474,0,3,5
73339,3,2,256474,256474,256476,0,2,0
73340,5,1,256479,256479,256480,0,1,3
73341,1,3,256480,256480,256483,0,3,0
73342,6,3,256486,256486,256489,0,3,3
73343,4,1,256490,256490,256491,0,1,1
73344,5,2,256495,256495,256497,0,2,4
73345,4,2,256499,256499,256501,0,2,2
73346,5,3,256504,256504,256507,0,3,3
73347,2,3,256506,256507,256510,1,4,0
73348,5,1,256511,256511,256512,0,1,1
73349,3,2,256514,256514,256516,0,2,2
73350,5,3,256519,256519,256522,0,3,3
73351,3,3,256522,256522,256525,0,3,0
73352,4,1,256526,256526,256527,0,1,1
73353,4,2,256530,256530,256532,0,2,3
73354,4,2,256534,256534,256536,0,2,2
73355,2,2,256536,256536,256538,0,2,0
73356,2,3,256538,256538,256541,0,3,0
73357,1,3,256539,256541,256544,2,5,0
73358,3,2,256542,256544,256546,2,4,0
73359,2,3,256544,256546,256549,2,5,0
73360,4,2,256548,256549,256551,1,3,0
73361,4,2,256552,256552,256554,0,2,1
73362,5,2,256557,256557,256559,0,2,3
73363,5,3,256562,256562,256565,0,3,3
73364,1,1,256563,256565,256566,2,3,0
73365,6,2,256569,256569,256571,0,2,3
73366,3,2,256572,256572,256574,0,2,1
73367,2,3,256574,256574,256577,0,3,0
73368,2,2,256576,256577,256579,1,3,0
73369,2,1,256578,256579,256580,1,2,0
73370,1,3,256579,256580,256583,1,4,0
73371,2,1,256581,256583,256584,2,3,0
73372,5,3,256586,256586,256589,0,3,2
73373,6,2,256592,256592,256594,0,2,3
73374,5,3,256597,256597,256600,0,3,3
73375,6,2,256603,256603,256605,0,2,3
73376,6,2,256609,256609,256611,0,2,4
73377,1,3,256610,256611,256614,1,4,0
73378,4,1,256614,256614,256615,0,1,0
73379,1,3,256615,256615,256618,0,3,0
73380,5,3,256620,256620,256623,0,3,2
73381,3,1,256623,256623,256624,0,1,0
73382,3,2,256626,256626,256628,0,2,2
73383,3,2,256629,256629,256631,0,2,1
73384,3,3,256632,256632,256635,0,3,1
73385,3,2,256635,256635,256637,0,2,0
73386,1,3,256636,256637,256640,1,4,0
73387,2,3,256638,256640,256643,2,5,0
73388,1,2,256639,256643,256645,4,6,0
73389,2,2,256641,256645,256647,4,6,0
73390,3,1,256644,256647,256648,3,4,0
73391,6,2,256650,256650,256652,0,2,2
73392,5,2,256655,256655,256657,0,2,3
73393,4,2,256659,256659,256661,0,2,2
73394,3,3,256662,256662,256665,0,3,1
73395,1,2,256663,256665,256667,2,4,0
73396,2,3,256665,256667,256670,2,5,0
73397,1,2,256666,256670,256672,4,6,0
73398,3,2,256669,256672,256674,3,5,0
73399,6,3,256675,256675,256678,0,3,1
73400,6,2,256681,256681,256683,0,2,3
73401,2,3,256683,256683,256686,0,3,0
73402,4,2,256687,256687,256689,0,2,1
73403,5,3,256692,256692,256695,0,3,3
73404,6,3,256698,256698,256701,0,3,3
73405,1,1,256699,256701,256702,2,3,0
73406,3,1,256702,256702,256703,0,1,0
73407,5,3,256707,256707,256710,0,3,4
73408,6,2,256713,256713,256715,0,2,3
73409,5,2,256718,256718,256720,0,2,3
73410,4,1,256722,256722,256723,0,1,2
73411,4,2,256726,256726,256728,0,2,3
73412,3,2,256729,256729,256731,0,2,1
73413,4,3,256733,256733,256736,0,3,2
73414,3,1,256736,256736,256737,0,1,0
73415,4,3,256740,256740,256743,0,3,3
73416,5,1,256745,256745,256746,0,1,2
73417,5,1,256750,256750,256751,0,1,4
73418,4,3,256754,256754,256757,0,3,3
73419,6,1,256760,256760,256761,0,1,3
73420,2,2,256762,256762,256764,0,2,1
73421,5,2,256767,256767,256769,0,2,3
73422,2,2,256769,256769,256771,0,2,0
73423,2,3,256771,256771,256774,0,3,0
73424,5,1,256776,256776,256777,0,1,2
73425,5,1,256781,256781,256782,0,1,4
73426,2,1,256783,256783,256784,0,1,1
73427,6,2,256789,256789,256791,0,2,5
73428,1,3,256790,256791,256794,1,4,0
73429,2,2,256792,256794,256796,2,4,0
73430,4,1,256796,256796,256797,0,1,0
73431,6,2,256802,256802,256804,0,2,5
73432,1,1,256803,256804,256805,1,2,0
73433,5,1,256808,256808,256809,0,1,3
73434,6,2,256814,256814,256816,0,2,5
73435,6,1,256820,256820,256821,0,1,4
73436,4,3,256824,256824,256827,0,3,3
73437,4,1,256828,256828,256829,0,1,1
73438,6,2,256834,256834,256836,0,2,5
73439,3,3,256837,256837,256840,0,3,1
73440,6,2,256843,256843,256845,0,2,3
73441,2,2,256845,256845,256847,0,2,0
73442,6,1,256851,256851,256852,0,1,4
73443,3,3,256854,256854,256857,0,3,2
73444,1,2,256855,256857,256859,2,4,0
73445,5,1,256860,256860,256861,0,1,1
73446,4,2,256864,256864,256866,0,2,3
73447,2,1,256866,256866,256867,0,1,0
73448,3,1,256869,256869,256870,0,1,2
73449,2,2,256871,256871,256873,0,2,1
73450,3,3,256874,256874,256877,0,3,1
73451,4,3,256878,256878,256881,0,3,1
73452,5,1,256883,256883,256884,0,1,2
73453,6,2,256889,256889,256891,0,2,5
73454,6,1,256895,256895,256896,0,1,4
73455,3,3,256898,256898,256901,0,3,2
73456,2,2,256900,256901,256903,1,3,0
73457,2,3,256902,256903,256906,1,4,0
73458,6,2,256908,256908,256910,0,2,2
73459,6,3,256914,256914,256917,0,3,4
73460,3,1,256917,256917,256918,0,1,0
73461,5,2,256922,256922,256924,0,2,4
73462,4,1,256926,256926,256927,0,1,2
73463,3,2,256929,256929,256931,0,2,2
73464,6,2,256935,256935,256937,0,2,4
73465,6,3,256941,256941,256944,0,3,4
73466,5,3,256946,256946,256949,0,3,2
73467,1,2,256947,256949,256951,2,4,0
73468,1,2,256948,256951,256953,3,5,0
73469,6,1,256954,256954,256955,0,1,1
73470,3,3,256957,256957,256960,0,3,2
73471,2,2,256959,256960,256962,1,3,0
73472,4,1,256963,256963,256964,0,1,1
73473,1,2,256964,256964,256966,0,2,0
73474,3,2,256967,256967,256969,0,2,1
73475,3,2,256970,256970,256972,0,2,1
73476,4,3,256974,256974,256977,0,3,2
73477,3,1,256977,256977,256978,0,1,0
73478,1,1,256978,256978,256979,0,1,0
73479,6,3,256984,256984,256987,0,3,5
73480,1,2,256985,256987,256989,2,4,0
73481,5,2,256990,256990,256992,0,2,1
73482,1,3,256991,256992,256995,1,4,0
73483,6,1,256997,256997,256998,0,1,2
73484,2,3,256999,256999,257002,0,3,1
73485,6,1,257005,257005,257006,0,1,3
73486,1,1,257006,257006,257007,0,1,0
73487,3,3,257009,257009,257012,0,3,2
73488,6,2,257015,257015,257017,0,2,3
73489,1,2,257016,257017,257019,1,3,0
73490,1,1,257017,257019,257020,2,3,0
73491,3,3,257020,257020,257023,0,3,0
73492,5,1,257025,257025,257026,0,1,2
73493,1,3,257026,257026,257029,0,3,0
73494,2,3,257028,257029,257032,1,4,0
73495,4,2,257032,257032,257034,0,2,0
73496,1,1,257033,257034,257035,1,2,0
73497,5,3,257038,257038,257041,0,3,3
73498,4,2,257042,257042,257044,0,2,1
73499,6,3,257048,257048,257051,0,3,4
73500,5,2,257053,257053,257055,0,2,2
73501,4,1,257057,257057,257058,0,1,2
73502,3,2,257060,257060,257062,0,2,2
73503,5,1,257065,257065,257066,0,1,3
73504,5,3,257070,257070,257073,0,3,4
73505,5,2,257075,257075,257077,0,2,2
73506,6,2,257081,257081,257083,0,2,4
73507,1,1,257082,257083,257084,1,2,0
73508,2,2,257084,257084,257086,0,2,0
73509,5,2,257089,257089,257091,0,2,3
73510,4,1,257093,257093,257094,0,1,2
73511,4,1,257097,257097,257098,0,1,3
73512,2,1,257099,257099,257100,0,1,1
73513,1,3,257100,257100,257103,0,3,0
73514,1,1,257101,257103,257104,2,3,0
73515,4,1,257105,257105,257106,0,1,1
73516,5,3,257110,257110,257113,0,3,4
73517,5,3,257115,257115,257118,0,3,2
73518,5,2,257120,257120,257122,0,2,2
73519,5,1,257125,257125,257126,0,1,3
73520,2,1,257127,257127,257128,0,1,1
73521,6,1,257133,257133,257134,0,1,5
73522,1,3,257134,257134,257137,0,3,0
73523,6,3,257140,257140,257143,0,3,3
73524,1,1,257141,257143,257144,2,3,0
73525,6,1,257147,257147,257148,0,1,3
73526,6,2,257153,257153,257155,0,2,5
73527,3,2,257156,257156,257158,0,2,1
73528,2,2,257158,257158,257160,0,2,0
73529,1,3,257159,257160,257163,1,4,0
73530,3,2,257162,257163,257165,1,3,0
73531,5,1,257167,257167,257168,0,1,2
73532,2,3,257169,257169,257172,0,3,1
73533,6,1,257175,257175,257176,0,1,3
73534,2,2,257177,257177,257179,0,2,1
73535,5,3,257182,257182,257185,0,3,3
73536,5,2,257187,257187,257189,0,2,2
73537,6,1,257193,257193,257194,0,1,4
73538,4,1,257197,257197,257198,0,1,3
73539,4,2,257201,257201,257203,0,2,3
73540,5,2,257206,257206,257208,0,2,3
73541,1,3,257207,257208,257211,1,4,0
73542,6,1,257213,257213,257214,0,1,2
73543,5,3,257218,257218,257221,0,3,4
73544,4,3,257222,257222,257225,0,3,1
73545,5,1,257227,257227,257228,0,1,2
73546,5,2,257232,257232,257234,0,2,4
73547,1,3,257233,257234,257237,1,4,0
73548,4,3,257237,257237,257240,0,3,0
73549,6,1,257243,257243,257244,0,1,3
73550,6,3,257249,257249,257252,0,3,5
73551,2,2,257251,257252,257254,1,3,0
73552,6,3,257257,257257,257260,0,3,3
73553,1,3,257258,257260,257263,2,5,0
73554,4,1,257262,257263,257264,1,2,0
73555,2,1,257264,257264,257265,0,1,0
73556,5,3,257269,257269,257272,0,3,4
73557,4,1,257273,257273,257274,0,1,1
73558,2,1,257275,257275,257276,0,1,1
73559,2,2,257277,257277,257279,0,2,1
73560,5,3,257282,257282,257285,0,3,3
73561,1,1,257283,257285,257286,2,3,0
73562,5,3,257288,257288,257291,0,3,2
73563,6,2,257294,257294,257296,0,2,3
73564,3,3,257297,257297,257300,0,3,1
73565,2,3,257299,257300,257303,1,4,0
73566,6,1,257305,257305,257306,0,1,2
73567,1,2,257306,257306,257308,0,2,0
73568,6,1,257312,257312,257313,0,1,4
73569,1,3,257313,257313,257316,0,3,0
73570,2,2,257315,257316,257318,1,3,0
73571,6,1,257321,257321,257322,0,1,3
73572,3,3,257324,257324,257327,0,3,2
73573,3,3,257327,257327,257330,0,3,0
73574,2,3,257329,257330,257333,1,4,0
73575,5,1,257334,257334,257335,0,1,1
73576,6,2,257340,257340,257342,0,2,5
73577,4,3,257344,257344,257347,0,3,2
73578,4,3,257348,257348,257351,0,3,1
73579,5,1,257353,257353,257354,0,1,2
73580,1,1,257354,257354,257355,0,1,0
73581,5,2,257359,257359,257361,0,2,4
73582,6,2,257365,257365,257367,0,2,4
73583,6,3,257371,257371,257374,0,3,4
73584,4,3,257375,257375,257378,0,3,1
73585,4,2,257379,257379,257381,0,2,1
73586,1,1,257380,257381,257382,1,2,0
73587,4,1,257384,257384,257385,0,1,2
73588,5,3,257389,257389,257392,0,3,4
73589,3,1,257392,257392,257393,0,1,0
73590,1,1,257393,257393,257394,0,1,0
73591,4,2,257397,257397,257399,0,2,3
73592,4,3,257401,257401,257404,0,3,2
73593,3,3,257404,257404,257407,0,3,0
73594,3,2,257407,257407,257409,0,2,0
73595,4,2,257411,257411,257413,0,2,2
73596,3,3,257414,257414,257417,0,3,1
73597,2,1,257416,257417,257418,1,2,0
73598,6,3,257422,257422,257425,0,3,4
73599,4,2,257426,257426,257428,0,2,1
73600,2,1,257428,257428,257429,0,1,0
73601,1,2,257429,257429,257431,0,2,0
73602,2,2,257431,257431,257433,0,2,0
73603,5,3,257436,257436,257439,0,3,3
73604,1,2,257437,257439,257441,2,4,0
73605,2,2,257439,257441,257443,2,4,0
73606,5,2,257444,257444,257446,0,2,1
73607,3,3,257447,257447,257450,0,3,1
73608,5,3,257452,257452,257455,0,3,2
73609,5,1,257457,257457,257458,0,1,2
73610,1,3,257458,257458,257461,0,3,0
73611,3,3,257461,257461,257464,0,3,0
73612,3,1,257464,257464,257465,0,1,0
73613,1,1,257465,257465,257466,0,1,0
73614,6,2,257471,257471,257473,0,2,5
73615,2,1,257473,257473,257474,0,1,0
73616,1,2,257474,257474,257476,0,2,0
73617,1,2,257475,257476,257478,1,3,0
73618,6,3,257481,257481,257484,0,3,3
73619,1,2,257482,257484,257486,2,4,0
73620,1,1,257483,257486,257487,3,4,0
73621,1,1,257484,257487,257488,3,4,0
73622,3,3,257487,257488,257491,1,4,0
73623,5,3,257492,257492,257495,0,3,1
73624,4,3,257496,257496,257499,0,3,1
73625,2,2,257498,257499,257501,1,3,0
73626,1,2,257499,257501,257503,2,4,0
73627,5,3,257504,257504,257507,0,3,1
73628,4,2,257508,257508,257510,0,2,1
73629,6,2,257514,257514,257516,0,2,4
73630,3,1,257517,257517,257518,0,1,1
73631,3,3,257520,257520,257523,0,3,2
73632,5,1,257525,257525,257526,0,1,2
73633,5,3,257530,257530,257533,0,3,4
73634,3,2,257533,257533,257535,0,2,0
73635,4,1,257537,257537,257538,0,1,2
73636,5,3,257542,257542,257545,0,3,4
73637,4,3,257546,257546,257549,0,3,1
73638,2,1,257548,257549,257550,1,2,0
73639,2,1,257550,257550,257551,0,1,0
73640,4,1,257554,257554,257555,0,1,3
73641,1,3,257555,257555,257558,0,3,0
73642,6,3,257561,257561,257564,0,3,3
73643,4,2,257565,257565,257567,0,2,1
73644,1,2,257566,257567,257569,1,3,0
73645,6,3,257572,257572,257575,0,3,3
73646,6,2,257578,257578,257580,0,2,3
73647,5,1,257583,257583,257584,0,1,3
73648,6,2,257589,257589,257591,0,2,5
73649,1,3,257590,257591,257594,1,4,0
73650,2,1,257592,257594,257595,2,3,0
73651,4,1,257596,257596,257597,0,1,1
73652,5,3,257601,257601,257604,0,3,4
73653,1,3,257602,257604,257607,2,5,0
73654,4,1,257606,257607,257608,1,2,0
73655,2,2,257608,257608,257610,0,2,0
73656,2,2,257610,257610,257612,0,2,0
73657,3,3,257613,257613,257616,0,3,1
73658,3,1,257616,257616,257617,0,1,0
73659,6,3,257622,257622,257625,0,3,5
73660,6,2,257628,257628,257630,0,2,3
73661,6,3,257634,257634,257637,0,3,4
73662,2,3,257636,257637,257640,1,4,0
73663,1,3,257637,257640,257643,3,6,0
73664,1,3,257638,257643,257646,5,8,0
73665,6,1,257644,257646,257647,2,3,0
73666,2,1,257646,257647,257648,1,2,0
73667,2,2,257648,257648,257650,0,2,0
73668,3,1,257651,257651,257652,0,1,1
73669,5,1,257656,257656,257657,0,1,4
73670,5,1,257661,257661,257662,0,1,4
73671,4,3,257665,257665,257668,0,3,3
73672,3,3,257668,257668,257671,0,3,0
73673,6,2,257674,257674,257676,0,2,3
73674,6,2,257680,257680,257682,0,2,4
73675,6,1,257686,257686,257687,0,1,4
73676,6,3,257692,257692,257695,0,3,5
73677,2,3,257694,257695,257698,1,4,0
73678,3,3,257697,257698,257701,1,4,0
73679,2,3,257699,257701,257704,2,5,0
73680,5,1,257704,257704,257705,0,1,0
73681,1,2,257705,257705,257707,0,2,0
73682,3,1,257708,257708,257709,0,1,1
73683,3,2,257711,257711,257713,0,2,2
73684,1,3,257712,257713,257716,1,4,0
73685,4,2,257716,257716,257718,0,2,0
73686,2,3,257718,257718,257721,0,3,0
73687,6,3,257724,257724,257727,0,3,3
73688,1,2,257725,257727,257729,2,4,0
73689,2,3,257727,257729,257732,2,5,0
73690,6,1,257733,257733,257734,0,1,1
73691,6,2,257739,257739,257741,0,2,5
73692,3,1,257742,257742,257743,0,1,1
73693,1,2,257743,257743,257745,0,2,0
73694,5,1,257748,257748,257749,0,1,3
73695,6,1,257754,257754,257755,0,1,5
73696,3,2,257757,257757,257759,0,2,2
73697,5,1,257762,257762,257763,0,1,3
73698,2,2,257764,257764,257766,0,2,1
73699,6,3,257770,257770,257773,0,3,4
73700,5,3,257775,257775,257778,0,3,2
73701,5,3,257780,257780,257783,0,3,2
73702,3,3,257783,257783,257786,0,3,0
73703,2,2,257785,257786,257788,1,3,0
73704,5,3,257790,257790,257793,0,3,2
73705,4,2,257794,257794,257796,0,2,1
73706,1,3,257795,257796,257799,1,4,0
73707,6,3,257801,257801,257804,0,3,2
73708,3,3,257804,257804,257807,0,3,0
73709,5,2,257809,257809,257811,0,2,2
73710,6,3,257815,257815,257818,0,3,4
73711,3,3,257818,257818,257821,0,3,0
73712,6,3,257824,257824,257827,0,3,3
73713,6,1,257830,257830,257831,0,1,3
73714,3,2,257833,257833,257835,0,2,2
73715,3,2,257836,257836,257838,0,2,1
73716,4,3,257840,257840,257843,0,3,2
73717,6,2,257846,257846,257848,0,2,3
73718,1,2,257847,257848,257850,1,3,0
73719,2,1,257849,257850,257851,1,2,0
73720,2,1,257851,257851,257852,0,1,0
73721,5,3,257856,257856,257859,0,3,4
73722,3,2,257859,257859,257861,0,2,0
73723,5,1,257864,257864,257865,0,1,3
73724,5,2,257869,257869,257871,0,2,4
73725,3,2,257872,257872,257874,0,2,1
73726,2,3,257874,257874,257877,0,3,0
73727,5,3,257879,257879,257882,0,3,2
73728,3,1,257882,257882,257883,0,1,0
73729,3,3,257885,257885,257888,0,3,2
73730,2,3,257887,257888,257891,1,4,0
73731,4,3,257891,257891,257894,0,3,0
73732,6,3,257897,257897,257900,0,3,3
73733,6,1,257903,257903,257904,0,1,3
73734,4,3,257907,257907,257910,0,3,3
73735,2,3,257909,257910,257913,1,4,0
73736,6,2,257915,257915,257917,0,2,2
73737,3,1,257918,257918,257919,0,1,1
73738,4,1,257922,257922,257923,0,1,3
73739,3,2,257925,257925,257927,0,2,2
73740,4,1,257929,257929,257930,0,1,2
73741,1,3,257930,257930,257933,0,3,0
73742,5,1,257935,257935,257936,0,1,2
73743,1,1,257936,257936,257937,0,1,0
73744,2,2,257938,257938,257940,0,2,1
73745,6,1,257944,257944,257945,0,1,4
73746,4,1,257948,257948,257949,0,1,3
73747,2,1,257950,257950,257951,0,1,1
73748,6,3,257956,257956,257959,0,3,5
73749,5,3,257961,257961,257964,0,3,2
73750,3,3,257964,257964,257967,0,3,0
73751,5,2,257969,257969,257971,0,2,2
73752,4,3,257973,257973,257976,0,3,2
73753,4,2,257977,257977,257979,0,2,1
73754,6,2,257983,257983,257985,0,2,4
73755,2,1,257985,257985,257986,0,1,0
73756,1,2,257986,257986,257988,0,2,0
73757,1,2,257987,257988,257990,1,3,0
73758,4,2,257991,257991,257993,0,2,1
73759,3,1,257994,257994,257995,0,1,1
73760,6,2,258000,258000,258002,0,2,5
73761,3,2,258003,258003,258005,0,2,1
73762,6,3,258009,258009,258012,0,3,4
73763,1,1,258010,258012,258013,2,3,0
73764,4,2,258014,258014,258016,0,2,1
73765,4,2,258018,258018,258020,0,2,2
73766,5,2,258023,258023,258025,0,2,3
73767,4,1,258027,258027,258028,0,1,2
73768,2,2,258029,258029,258031,0,2,1
73769,6,1,258035,258035,258036,0,1,4
73770,1,2,258036,258036,258038,0,2,0
73771,1,2,258037,258038,258040,1,3,0
73772,1,1,258038,258040,258041,2,3,0
73773,1,2,258039,258041,258043,2,4,0
73774,6,2,258045,258045,258047,0,2,2
73775,4,3,258049,258049,258052,0,3,2
73776,2,3,258051,258052,258055,1,4,0
73777,1,3,258052,258055,258058,3,6,0
73778,6,3,258058,258058,258061,0,3,0
73779,6,1,258064,258064,258065,0,1,3
73780,6,3,258070,258070,258073,0,3,5
73781,6,2,258076,258076,258078,0,2,3
73782,4,1,258080,258080,258081,0,1,2
73783,5,3,258085,258085,258088,0,3,4
73784,2,3,258087,258088,258091,1,4,0
73785,4,3,258091,258091,258094,0,3,0
73786,4,1,258095,258095,258096,0,1,1
73787,4,2,258099,258099,258101,0,2,3
73788,3,3,258102,258102,258105,0,3,1
73789,3,3,258105,258105,258108,0,3,0
73790,1,2,258106,258108,258110,2,4,0
73791,3,1,258109,258110,258111,1,2,0
73792,1,2,258110,258111,258113,1,3,0
73793,3,2,258113,258113,258115,0,2,0
73794,2,2,258115,258115,258117,0,2,0
73795,5,2,258120,258120,258122,0,2,3
73796,6,2,258126,258126,258128,0,2,4
73797,1,1,258127,258128,258129,1,2,0
73798,2,1,258129,258129,258130,0,1,0
73799,6,3,258135,258135,258138,0,3,5
73800,4,1,258139,258139,258140,0,1,1
73801,6,2,258145,258145,258147,0,2,5
73802,4,2,258149,258149,258151,0,2,2
73803,1,2,258150,258151,258153,1,3,0
73804,3,1,258153,258153,258154,0,1,0
73805,4,2,258157,258157,258159,0,2,3
73806,6,3,258163,258163,258166,0,3,4
73807,3,1,258166,258166,258167,0,1,0
73808,4,1,258170,258170,258171,0,1,3
73809,2,3,258172,258172,258175,0,3,1
73810,5,2,258177,258177,258179,0,2,2
73811,4,2,258181,258181,258183,0,2,2
73812,2,1,258183,258183,258184,0,1,0
73813,4,3,258187,258187,258190,0,3,3
73814,1,3,258188,258190,258193,2,5,0
73815,4,3,258192,258193,258196,1,4,0
73816,2,3,258194,258196,258199,2,5,0
73817,1,3,258195,258199,258202,4,7,0
73818,1,3,258196,258202,258205,6,9,0
73819,3,1,258199,258205,258206,6,7,0
73820,5,1,258204,258206,258207,2,3,0
73821,2,3,258206,258207,258210,1,4,0
73822,5,1,258211,258211,258212,0,1,1
73823,4,1,258215,258215,258216,0,1,3
73824,5,3,258220,258220,258223,0,3,4
73825,4,3,258224,258224,258227,0,3,1
73826,1,1,258225,258227,258228,2,3,0
73827,5,2,258230,258230,258232,0,2,2
73828,1,1,258231,258232,258233,1,2,0
73829,4,3,258235,258235,258238,0,3,2
73830,6,3,258241,258241,258244,0,3,3
73831,6,2,258247,258247,258249,0,2,3
73832,1,1,258248,258249,258250,1,2,0
73833,5,3,258253,258253,258256,0,3,3
73834,2,1,258255,258256,258257,1,2,0
73835,2,3,258257,258257,258260,0,3,0
73836,6,3,258263,258263,258266,0,3,3
73837,1,1,258264,258266,258267,2,3,0
73838,2,1,258266,258267,258268,1,2,0
73839,1,3,258267,258268,258271,1,4,0
73840,2,2,258269,258271,258273,2,4,0
73841,3,3,258272,258273,258276,1,4,0
73842,1,1,258273,258276,258277,3,4,0
73843,4,3,258277,258277,258280,0,3,0
73844,2,3,258279,258280,258283,1,4,0
73845,3,3,258282,258283,258286,1,4,0
73846,2,3,258284,258286,258289,2,5,0
73847,6,3,258290,258290,258293,0,3,1
73848,3,1,258293,258293,258294,0,1,0
73849,2,2,258295,258295,258297,0,2,1
73850,1,1,258296,258297,258298,1,2,0
73851,1,1,258297,258298,258299,1,2,0
73852,6,3,258303,258303,258306,0,3,4
73853,2,2,258305,258306,258308,1,3,0
73854,1,2,258306,258308,258310,2,4,0
73855,6,3,258312,258312,258315,0,3,2
73856,6,1,258318,258318,258319,0,1,3
73857,4,1,258322,258322,258323,0,1,3
73858,6,1,258328,258328,258329,0,1,5
73859,1,1,258329,258329,258330,0,1,0
73860,6,3,258335,258335,258338,0,3,5
73861,6,1,258341,258341,258342,0,1,3
73862,5,2,258346,258346,258348,0,2,4
73863,1,2,258347,258348,258350,1,3,0
73864,3,1,258350,258350,258351,0,1,0
73865,1,3,258351,258351,258354,0,3,0
73866,1,1,258352,258354,258355,2,3,0
73867,5,2,258357,258357,258359,0,2,2
73868,6,3,258363,258363,258366,0,3,4
73869,5,1,258368,258368,258369,0,1,2
73870,3,1,258371,258371,258372,0,1,2
73871,1,3,258372,258372,258375,0,3,0
73872,5,3,258377,258377,258380,0,3,2
73873,6,1,258383,258383,258384,0,1,3
73874,3,3,258386,258386,258389,0,3,2
73875,5,1,258391,258391,258392,0,1,2
73876,6,2,258397,258397,258399,0,2,5
73877,3,1,258400,258400,258401,0,1,1
73878,5,1,258405,258405,258406,0,1,4
73879,6,3,258411,258411,258414,0,3,5
73880,6,3,258417,258417,258420,0,3,3
73881,5,1,258422,258422,258423,0,1,2
73882,4,2,258426,258426,258428,0,2,3
73883,5,3,258431,258431,258434,0,3,3
73884,1,1,258432,258434,258435,2,3,0
73885,1,3,258433,258435,258438,2,5,0
73886,6,3,258439,258439,258442,0,3,1
73887,5,1,258444,258444,258445,0,1,2
73888,4,3,258448,258448,258451,0,3,3
73889,2,1,258450,258451,258452,1,2,0
73890,5,3,258455,258455,258458,0,3,3
73891,1,2,258456,258458,258460,2,4,0
73892,1,3,258457,258460,258463,3,6,0
73893,2,2,258459,258463,258465,4,6,0
73894,4,1,258463,258465,258466,2,3,0
73895,6,1,258469,258469,258470,0,1,3
73896,4,1,258473,258473,258474,0,1,3
73897,6,2,258479,258479,258481,0,2,5
73898,3,2,258482,258482,258484,0,2,1
73899,5,1,258487,258487,258488,0,1,3
73900,3,1,258490,258490,258491,0,1,2
73901,5,2,258495,258495,258497,0,2,4
73902,1,2,258496,258497,258499,1,3,0
73903,2,1,258498,258499,258500,1,2,0
73904,4,3,258502,258502,258505,0,3,2
73905,2,3,258504,258505,258508,1,4,0
73906,5,2,258509,258509,258511,0,2,1
73907,1,2,258510,258511,258513,1,3,0
73908,4,3,258514,258514,258517,0,3,1
73909,2,3,258516,258517,258520,1,4,0
73910,1,2,258517,258520,258522,3,5,0
73911,1,3,258518,258522,258525,4,7,0
73912,5,3,258523,258525,258528,2,5,0
73913,5,1,258528,258528,258529,0,1,0
73914,4,2,258532,258532,258534,0,2,3
73915,2,2,258534,258534,258536,0,2,0
73916,2,2,258536,258536,258538,0,2,0
73917,4,3,258540,258540,258543,0,3,2
73918,3,3,258543,258543,258546,0,3,0
73919,5,1,258548,258548,258549,0,1,2
73920,3,2,258551,258551,258553,0,2,2
73921,6,3,258557,258557,258560,0,3,4
73922,2,1,258559,258560,258561,1,2,0
73923,4,1,258563,258563,258564,0,1,2
73924,3,3,258566,258566,258569,0,3,2
73925,5,2,258571,258571,258573,0,2,2
73926,2,2,258573,258573,258575,0,2,0
73927,3,2,258576,258576,258578,0,2,1
73928,4,2,258580,258580,258582,0,2,2
73929,3,3,258583,258583,258586,0,3,1
73930,1,1,258584,258586,258587,2,3,0
73931,3,1,258587,258587,258588,0,1,0
73932,2,3,258589,258589,258592,0,3,1
73933,5,3,258594,258594,258597,0,3,2
73934,6,1,258600,258600,258601,0,1,3
73935,6,1,258606,258606,258607,0,1,5
73936,4,1,258610,258610,258611,0,1,3
73937,3,2,258613,258613,258615,0,2,2
73938,1,2,258614,258615,258617,1,3,0
73939,4,1,258618,258618,258619,0,1,1
73940,4,1,258622,258622,258623,0,1,3
73941,6,2,258628,258628,258630,0,2,5
73942,1,3,258629,258630,258633,1,4,0
73943,3,1,258632,258633,258634,1,2,0
73944,3,3,258635,258635,258638,0,3,1
73945,4,3,258639,258639,258642,0,3,1
73946,1,2,258640,258642,258644,2,4,0
73947,2,2,258642,258644,258646,2,4,0
73948,3,3,258645,258646,258649,1,4,0
73949,1,3,258646,258649,258652,3,6,0
73950,2,1,258648,258652,258653,4,5,0
73951,2,1,258650,258653,258654,3,4,0
73952,5,1,258655,258655,258656,0,1,1
73953,6,2,258661,258661,258663,0,2,5
73954,1,2,258662,258663,258665,1,3,0
73955,3,2,258665,258665,258667,0,2,0
73956,4,2,258669,258669,258671,0,2,2
73957,3,2,258672,258672,258674,0,2,1
73958,6,2,258678,258678,258680,0,2,4
73959,1,1,258679,258680,258681,1,2,0
73960,6,1,258685,258685,258686,0,1,4
73961,6,1,258691,258691,258692,0,1,5
73962,5,2,258696,258696,258698,0,2,4
73963,2,2,258698,258698,258700,0,2,0
73964,2,3,258700,258700,258703,0,3,0
73965,2,2,258702,258703,258705,1,3,0
73966,6,3,258708,258708,258711,0,3,3
73967,6,3,258714,258714,258717,0,3,3
73968,1,3,258715,258717,258720,2,5,0
73969,2,3,258717,258720,258723,3,6,0
73970,1,3,258718,258723,258726,5,8,0
73971,5,1,258723,258726,258727,3,4,0
73972,1,1,258724,258727,258728,3,4,0
73973,2,3,258726,258728,258731,2,5,0
73974,4,2,258730,258731,258733,1,3,0
73975,6,1,258736,258736,258737,0,1,3
73976,1,3,258737,258737,258740,0,3,0
73977,5,1,258742,258742,258743,0,1,2
73978,6,1,258748,258748,258749,0,1,5
73979,1,3,258749,258749,258752,0,3,0
73980,5,1,258754,258754,258755,0,1,2
73981,1,1,258755,258755,258756,0,1,0
73982,4,1,258759,258759,258760,0,1,3
73983,2,2,258761,258761,258763,0,2,1
73984,2,2,258763,258763,258765,0,2,0
73985,2,3,258765,258765,258768,0,3,0
73986,2,2,258767,258768,258770,1,3,0
73987,3,1,258770,258770,258771,0,1,0
73988,2,3,258772,258772,258775,0,3,1
73989,4,1,258776,258776,258777,0,1,1
73990,4,2,258780,258780,258782,0,2,3
73991,1,3,258781,258782,258785,1,4,0
73992,2,1,258783,258785,258786,2,3,0
73993,2,3,258785,258786,258789,1,4,0
73994,1,2,258786,258789,258791,3,5,0
73995,4,3,258790,258791,258794,1,4,0
73996,2,1,258792,258794,258795,2,3,0
73997,1,3,258793,258795,258798,2,5,0
73998,4,1,258797,258798,258799,1,2,0
73999,6,2,258803,258803,258805,0,2,4
74000,1,2,258804,258805,258807,1,3,0
74001,4,1,258808,258808,258809,0,1,1
74002,1,3,258809,258809,258812,0,3,0
74003,5,2,258814,258814,258816,0,2,2
74004,2,2,258816,258816,258818,0,2,0
74005,6,1,258822,258822,258823,0,1,4
74006,3,3,258825,258825,258828,0,3,2
74007,4,3,258829,258829,258832,0,3,1
74008,3,1,258832,258832,258833,0,1,0
74009,2,1,258834,258834,258835,0,1,1
74010,1,3,258835,258835,258838,0,3,0
74011,5,1,258840,258840,258841,0,1,2
74012,3,3,258843,258843,258846,0,3,2
74013,5,3,258848,258848,258851,0,3,2
74014,4,3,258852,258852,258855,0,3,1
74015,5,2,258857,258857,258859,0,2,2
74016,3,3,258860,258860,258863,0,3,1
74017,5,1,258865,258865,258866,0,1,2
74018,6,1,258871,258871,258872,0,1,5
74019,5,3,258876,258876,258879,0,3,4
74020,1,1,258877,258879,258880,2,3,0
74021,5,3,258882,258882,258885,0,3,2
74022,4,2,258886,258886,258888,0,2,1
74023,4,3,258890,258890,258893,0,3,2
74024,2,2,258892,258893,258895,1,3,0
74025,5,3,258897,258897,258900,0,3,2
74026,5,2,258902,258902,258904,0,2,2
74027,2,1,258904,258904,258905,0,1,0
74028,1,1,258905,258905,258906,0,1,0
74029,1,2,258906,258906,258908,0,2,0
74030,2,3,258908,258908,258911,0,3,0
74031,6,3,258914,258914,258917,0,3,3
74032,4,1,258918,258918,258919,0,1,1
74033,6,3,258924,258924,258927,0,3,5
74034,3,2,258927,258927,258929,0,2,0
74035,1,3,258928,258929,258932,1,4,0
74036,2,3,258930,258932,258935,2,5,0
74037,5,2,258935,258935,258937,0,2,0
74038,3,1,258938,258938,258939,0,1,1
74039,6,2,258944,258944,258946,0,2,5
74040,3,3,258947,258947,258950,0,3,1
74041,1,2,258948,258950,258952,2,4,0
74042,1,2,258949,258952,258954,3,5,0
74043,1,2,258950,258954,258956,4,6,0
74044,1,2,258951,258956,258958,5,7,0
74045,1,2,258952,258958,258960,6,8,0
74046,2,3,258954,258960,258963,6,9,0
74047,4,1,258958,258963,258964,5,6,0
74048,5,3,258963,258964,258967,1,4,0
74049,1,2,258964,258967,258969,3,5,0
74050,1,3,258965,258969,258972,4,7,0
74051,5,3,258970,258972,258975,2,5,0
74052,3,3,258973,258975,258978,2,5,0
74053,4,3,258977,258978,258981,1,4,0
74054,3,2,258980,258981,258983,1,3,0
74055,1,3,258981,258983,258986,2,5,0
74056,5,3,258986,258986,258989,0,3,0
74057,4,1,258990,258990,258991,0,1,1
74058,3,2,258993,258993,258995,0,2,2
74059,4,1,258997,258997,258998,0,1,2
74060,5,3,259002,259002,259005,0,3,4
74061,3,3,259005,259005,259008,0,3,0
74062,3,1,259008,259008,259009,0,1,0
74063,5,3,259013,259013,259016,0,3,4
74064,5,1,259018,259018,259019,0,1,2
74065,3,1,259021,259021,259022,0,1,2
74066,6,1,259027,259027,259028,0,1,5
74067,1,1,259028,259028,259029,0,1,0
74068,3,2,259031,259031,259033,0,2,2
74069,6,3,259037,259037,259040,0,3,4
74070,3,2,259040,259040,259042,0,2,0
74071,4,3,259044,259044,259047,0,3,2
74072,6,3,259050,259050,259053,0,3,3
74073,4,1,259054,259054,259055,0,1,1
74074,4,1,259058,259058,259059,0,1,3
74075,3,3,259061,259061,259064,0,3,2
74076,1,1,259062,259064,259065,2,3,0
74077,2,1,259064,259065,259066,1,2,0
74078,4,2,259068,259068,259070,0,2,2
74079,6,1,259074,259074,259075,0,1,4
74080,5,3,259079,259079,259082,0,3,4
74081,6,2,259085,259085,259087,0,2,3
74082,4,1,259089,259089,259090,0,1,2
74083,1,1,259090,259090,259091,0,1,0
74084,4,3,259094,259094,259097,0,3,3
74085,5,1,259099,259099,259100,0,1,2
74086,6,1,259105,259105,259106,0,1,5
74087,4,1,259109,259109,259110,0,1,3
74088,2,1,259111,259111,259112,0,1,1
74089,1,1,259112,259112,259113,0,1,0
74090,2,1,259114,259114,259115,0,1,1
74091,1,1,259115,259115,259116,0,1,0
74092,6,1,259121,259121,259122,0,1,5
74093,2,1,259123,259123,259124,0,1,1
74094,4,2,259127,259127,259129,0,2,3
74095,5,1,259132,259132,259133,0,1,3
74096,4,3,259136,259136,259139,0,3,3
74097,5,3,259141,259141,259144,0,3,2
74098,4,2,259145,259145,259147,0,2,1
74099,3,3,259148,259148,259151,0,3,1
74100,1,3,259149,259151,259154,2,5,0
74101,2,2,259151,259154,259156,3,5,0
74102,6,2,259157,259157,259159,0,2,1
74103,5,3,259162,259162,259165,0,3,3
74104,5,1,259167,259167,259168,0,1,2
74105,5,2,259172,259172,259174,0,2,4
74106,6,1,259178,259178,259179,0,1,4
74107,3,3,259181,259181,259184,0,3,2
74108,3,1,259184,259184,259185,0,1,0
74109,2,2,259186,259186,259188,0,2,1
74110,3,1,259189,259189,259190,0,1,1
74111,6,1,259195,259195,259196,0,1,5
74112,1,1,259196,259196,259197,0,1,0
74113,3,3,259199,259199,259202,0,3,2
74114,3,1,259202,259202,259203,0,1,0
74115,1,3,259203,259203,259206,0,3,0
74116,3,2,259206,259206,259208,0,2,0
74117,5,2,259211,259211,259213,0,2,3
74118,2,3,259213,259213,259216,0,3,0
74119,4,2,259217,259217,259219,0,2,1
74120,6,3,259223,259223,259226,0,3,4
74121,4,3,259227,259227,259230,0,3,1
74122,4,3,259231,259231,259234,0,3,1
74123,6,2,259237,259237,259239,0,2,3
74124,1,3,259238,259239,259242,1,4,0
74125,6,2,259244,259244,259246,0,2,2
74126,2,1,259246,259246,259247,0,1,0
74127,2,1,259248,259248,259249,0,1,1
74128,3,1,259251,259251,259252,0,1,2
74129,2,1,259253,259253,259254,0,1,1
74130,5,2,259258,259258,259260,0,2,4
74131,2,3,259260,259260,259263,0,3,0
74132,5,1,259265,259265,259266,0,1,2
74133,6,2,259271,259271,259273,0,2,5
74134,3,2,259274,259274,259276,0,2,1
74135,2,2,259276,259276,259278,0,2,0
74136,6,3,259282,259282,259285,0,3,4
74137,5,1,259287,259287,259288,0,1,2
74138,5,2,259292,259292,259294,0,2,4
74139,1,1,259293,259294,259295,1,2,0
74140,5,3,259298,259298,259301,0,3,3
74141,1,2,259299,259301,259303,2,4,0
74142,6,3,259305,259305,259308,0,3,2
74143,1,2,259306,259308,259310,2,4,0
74144,1,1,259307,259310,259311,3,4,0
74145,6,1,259313,259313,259314,0,1,2
74146,1,1,259314,259314,259315,0,1,0
74147,5,2,259319,259319,259321,0,2,4
74148,6,2,259325,259325,259327,0,2,4
74149,1,1,259326,259327,259328,1,2,0
74150,3,2,259329,259329,259331,0,2,1
74151,4,3,259333,259333,259336,0,3,2
74152,4,1,259337,259337,259338,0,1,1
74153,5,1,259342,259342,259343,0,1,4
74154,3,2,259345,259345,259347,0,2,2
74155,4,1,259349,259349,259350,0,1,2
74156,4,1,259353,259353,259354,0,1,3
74157,6,2,259359,259359,259361,0,2,5
74158,6,2,259365,259365,259367,0,2,4
74159,3,2,259368,259368,259370,0,2,1
74160,2,1,259370,259370,259371,0,1,0
74161,3,3,259373,259373,259376,0,3,2
74162,2,2,259375,259376,259378,1,3,0
74163,5,2,259380,259380,259382,0,2,2
74164,3,3,259383,259383,259386,0,3,1
74165,1,2,259384,259386,259388,2,4,0
74166,3,2,259387,259388,259390,1,3,0
74167,5,3,259392,259392,259395,0,3,2
74168,2,3,259394,259395,259398,1,4,0
74169,5,3,259399,259399,259402,0,3,1
74170,4,2,259403,259403,259405,0,2,1
74171,6,1,259409,259409,259410,0,1,4
74172,6,1,259415,259415,259416,0,1,5
74173,6,3,259421,259421,259424,0,3,5
74174,1,3,259422,259424,259427,2,5,0
74175,6,1,259428,259428,259429,0,1,1
74176,1,2,259429,259429,259431,0,2,0
74177,5,3,259434,259434,259437,0,3,3
74178,6,1,259440,259440,259441,0,1,3
74179,5,1,259445,259445,259446,0,1,4
74180,6,3,259451,259451,259454,0,3,5
74181,4,1,259455,259455,259456,0,1,1
74182,3,1,259458,259458,259459,0,1,2
74183,5,3,259463,259463,259466,0,3,4
74184,2,1,259465,259466,259467,1,2,0
74185,5,2,259470,259470,259472,0,2,3
74186,3,2,259473,259473,259475,0,2,1
74187,6,3,259479,259479,259482,0,3,4
74188,6,2,259485,259485,259487,0,2,3
74189,2,3,259487,259487,259490,0,3,0
74190,6,1,259493,259493,259494,0,1,3
74191,1,2,259494,259494,259496,0,2,0
74192,4,3,259498,259498,259501,0,3,2
74193,4,3,259502,259502,259505,0,3,1
74194,5,1,259507,259507,259508,0,1,2
74195,1,2,259508,259508,259510,0,2,0
74196,4,1,259512,259512,259513,0,1,2
74197,5,1,259517,259517,259518,0,1,4
74198,3,2,259520,259520,259522,0,2,2
74199,5,2,259525,259525,259527,0,2,3
74200,5,3,259530,259530,259533,0,3,3
74201,2,2,259532,259533,259535,1,3,0
74202,4,3,259536,259536,259539,0,3,1
74203,6,2,259542,259542,259544,0,2,3
74204,2,1,259544,259544,259545,0,1,0
74205,4,2,259548,259548,259550,0,2,3
74206,2,3,259550,259550,259553,0,3,0
74207,3,3,259553,259553,259556,0,3,0
74208,3,1,259556,259556,259557,0,1,0
74209,6,3,259562,259562,259565,0,3,5
74210,4,2,259566,259566,259568,0,2,1
74211,2,1,259568,259568,259569,0,1,0
74212,2,2,259570,259570,259572,0,2,1
74213,4,1,259574,259574,259575,0,1,2
74214,3,1,259577,259577,259578,0,1,2
74215,3,3,259580,259580,259583,0,3,2
74216,1,2,259581,259583,259585,2,4,0
74217,2,1,259583,259585,259586,2,3,0
74218,6,3,259589,259589,259592,0,3,3
74219,6,2,259595,259595,259597,0,2,3
74220,4,3,259599,259599,259602,0,3,2
74221,3,2,259602,259602,259604,0,2,0
74222,4,2,259606,259606,259608,0,2,2
74223,2,3,259608,259608,259611,0,3,0
74224,3,3,259611,259611,259614,0,3,0
74225,5,1,259616,259616,259617,0,1,2
74226,4,3,259620,259620,259623,0,3,3
74227,3,3,259623,259623,259626,0,3,0
74228,4,2,259627,259627,259629,0,2,1
74229,5,1,259632,259632,259633,0,1,3
74230,3,3,259635,259635,259638,0,3,2
74231,4,2,259639,259639,259641,0,2,1
74232,2,2,259641,259641,259643,0,2,0
74233,5,1,259646,259646,259647,0,1,3
74234,1,1,259647,259647,259648,0,1,0
74235,5,1,259652,259652,259653,0,1,4
74236,5,1,259657,259657,259658,0,1,4
74237,4,1,259661,259661,259662,0,1,3
74238,5,3,259666,259666,259669,0,3,4
74239,3,2,259669,259669,259671,0,2,0
74240,3,1,259672,259672,259673,0,1,1
74241,4,1,259676,259676,259677,0,1,3
74242,4,1,259680,259680,259681,0,1,3
74243,2,3,259682,259682,259685,0,3,1
74244,3,3,259685,259685,259688,0,3,0
74245,5,1,259690,259690,259691,0,1,2
74246,1,2,259691,259691,259693,0,2,0
74247,5,1,259696,259696,259697,0,1,3
74248,4,1,259700,259700,259701,0,1,3
74249,6,2,259706,259706,259708,0,2,5
74250,6,3,259712,259712,259715,0,3,4
74251,5,1,259717,259717,259718,0,1,2
74252,2,2,259719,259719,259721,0,2,1
74253,4,3,259723,259723,259726,0,3,2
74254,2,1,259725,259726,259727,1,2,0
74255,6,2,259731,259731,259733,0,2,4
74256,3,3,259734,259734,259737,0,3,1
74257,5,1,259739,259739,259740,0,1,2
74258,4,3,259743,259743,259746,0,3,3
74259,2,2,259745,259746,259748,1,3,0
74260,1,1,259746,259748,259749,2,3,0
74261,2,1,259748,259749,259750,1,2,0
74262,5,2,259753,259753,259755,0,2,3
74263,2,2,259755,259755,259757,0,2,0
74264,2,3,259757,259757,259760,0,3,0
74265,2,3,259759,259760,259763,1,4,0
74266,6,2,259765,259765,259767,0,2,2
74267,4,2,259769,259769,259771,0,2,2
74268,2,2,259771,259771,259773,0,2,0
74269,1,3,259772,259773,259776,1,4,0
74270,5,2,259777,259777,259779,0,2,1
74271,6,3,259783,259783,259786,0,3,4
74272,6,1,259789,259789,259790,0,1,3
74273,6,1,259795,259795,259796,0,1,5
74274,6,3,259801,259801,259804,0,3,5
74275,4,3,259805,259805,259808,0,3,1
74276,5,3,259810,259810,259813,0,3,2
74277,6,3,259816,259816,259819,0,3,3
74278,4,2,259820,259820,259822,0,2,1
74279,4,1,259824,259824,259825,0,1,2
74280,6,1,259830,259830,259831,0,1,5
74281,2,1,259832,259832,259833,0,1,1
74282,4,3,259836,259836,259839,0,3,3
74283,3,1,259839,259839,259840,0,1,0
74284,4,1,259843,259843,259844,0,1,3
74285,2,2,259845,259845,259847,0,2,1
74286,3,2,259848,259848,259850,0,2,1
74287,5,2,259853,259853,259855,0,2,3
74288,4,2,259857,259857,259859,0,2,2
74289,6,3,259863,259863,259866,0,3,4
74290,2,1,259865,259866,259867,1,2,0
74291,3,1,259868,259868,259869,0,1,1
74292,3,1,259871,259871,259872,0,1,2
74293,5,2,259876,259876,259878,0,2,4
74294,3,1,259879,259879,259880,0,1,1
74295,5,3,259884,259884,259887,0,3,4
74296,6,2,259890,259890,259892,0,2,3
74297,2,1,259892,259892,259893,0,1,0
74298,3,1,259895,259895,259896,0,1,2
74299,1,1,259896,259896,259897,0,1,0
74300,1,1,259897,259897,259898,0,1,0
74301,6,2,259903,259903,259905,0,2,5
74302,2,1,259905,259905,259906,0,1,0
74303,6,2,259911,259911,259913,0,2,5
74304,3,2,259914,259914,259916,0,2,1
74305,3,1,259917,259917,259918,0,1,1
74306,3,2,259920,259920,259922,0,2,2
74307,1,3,259921,259922,259925,1,4,0
74308,6,2,259927,259927,259929,0,2,2
74309,4,3,259931,259931,259934,0,3,2
74310,3,1,259934,259934,259935,0,1,0
74311,6,3,259940,259940,259943,0,3,5
74312,4,1,259944,259944,259945,0,1,1
74313,2,1,259946,259946,259947,0,1,1
74314,6,1,259952,259952,259953,0,1,5
74315,5,1,259957,259957,259958,0,1,4
74316,3,3,259960,259960,259963,0,3,2
74317,3,1,259963,259963,259964,0,1,0
74318,3,2,259966,259966,259968,0,2,2
74319,3,1,259969,259969,259970,0,1,1
74320,2,1,259971,259971,259972,0,1,1
74321,5,2,259976,259976,259978,0,2,4
74322,4,2,259980,259980,259982,0,2,2
74323,3,3,259983,259983,259986,0,3,1
74324,6,3,259989,259989,259992,0,3,3
74325,1,2,259990,259992,259994,2,4,0
74326,1,3,259991,259994,259997,3,6,0
74327,3,2,259994,259997,259999,3,5,0
74328,6,2,260000,260000,260002,0,2,1
74329,2,1,260002,260002,260003,0,1,0
74330,5,1,260007,260007,260008,0,1,4
74331,2,2,260009,260009,260011,0,2,1
74332,5,1,260014,260014,260015,0,1,3
74333,3,3,260017,260017,260020,0,3,2
74334,6,1,260023,260023,260024,0,1,3
74335,6,1,260029,260029,260030,0,1,5
74336,2,3,260031,260031,260034,0,3,1
74337,5,1,260036,260036,260037,0,1,2
74338,6,3,260042,260042,260045,0,3,5
74339,4,1,260046,260046,260047,0,1,1
74340,6,1,260052,260052,260053,0,1,5
74341,2,1,260054,260054,260055,0,1,1
74342,2,1,260056,260056,260057,0,1,1
74343,6,1,260062,260062,260063,0,1,5
74344,4,1,260066,260066,260067,0,1,3
74345,3,1,260069,260069,260070,0,1,2
74346,1,1,260070,260070,260071,0,1,0
74347,6,1,260076,260076,260077,0,1,5
74348,1,2,260077,260077,260079,0,2,0
74349,3,3,260080,260080,260083,0,3,1
74350,5,1,260085,260085,260086,0,1,2
74351,5,2,260090,260090,260092,0,2,4
74352,6,3,260096,260096,260099,0,3,4
74353,2,2,260098,260099,260101,1,3,0
74354,1,2,260099,260101,260103,2,4,0
74355,5,1,260104,260104,260105,0,1,1
74356,6,2,260110,260110,260112,0,2,5
74357,5,1,260115,260115,260116,0,1,3
74358,3,2,260118,260118,260120,0,2,2
74359,3,2,260121,260121,260123,0,2,1
74360,3,2,260124,260124,260126,0,2,1
74361,4,2,260128,260128,260130,0,2,2
74362,2,2,260130,260130,260132,0,2,0
74363,2,2,260132,260132,260134,0,2,0
74364,2,1,260134,260134,260135,0,1,0
74365,2,2,260136,260136,260138,0,2,1
74366,4,3,260140,260140,260143,0,3,2
74367,4,1,260144,260144,260145,0,1,1
74368,1,2,260145,260145,260147,0,2,0
74369,6,1,260151,260151,260152,0,1,4
74370,6,1,260157,260157,260158,0,1,5
74371,6,1,260163,260163,260164,0,1,5
74372,6,3,260169,260169,260172,0,3,5
74373,3,3,260172,260172,260175,0,3,0
74374,6,2,260178,260178,260180,0,2,3
74375,2,3,260180,260180,260183,0,3,0
74376,5,3,260185,260185,260188,0,3,2
74377,4,3,260189,260189,260192,0,3,1
74378,5,2,260194,260194,260196,0,2,2
74379,2,2,260196,260196,260198,0,2,0
74380,2,2,260198,260198,260200,0,2,0
74381,4,2,260202,260202,260204,0,2,2
74382,3,2,260205,260205,260207,0,2,1
74383,2,3,260207,260207,260210,0,3,0
74384,2,3,260209,260210,260213,1,4,0
74385,4,2,260213,260213,260215,0,2,0
74386,3,3,260216,260216,260219,0,3,1
74387,1,1,260217,260219,260220,2,3,0
74388,4,3,260221,260221,260224,0,3,1
74389,4,3,260225,260225,260228,0,3,1
74390,4,1,260229,260229,260230,0,1,1
74391,5,3,260234,260234,260237,0,3,4
74392,5,2,260239,260239,260241,0,2,2
74393,6,1,260245,260245,260246,0,1,4
74394,4,3,260249,260249,260252,0,3,3
74395,2,3,260251,260252,260255,1,4,0
74396,1,1,260252,260255,260256,3,4,0
74397,2,2,260254,260256,260258,2,4,0
74398,6,1,260260,260260,260261,0,1,2
74399,5,2,260265,260265,260267,0,2,4
74400,2,1,260267,260267,260268,0,1,0
74401,4,2,260271,260271,260273,0,2,3
74402,6,2,260277,260277,260279,0,2,4
74403,3,1,260280,260280,260281,0,1,1
74404,5,1,260285,260285,260286,0,1,4
74405,1,1,260286,260286,260287,0,1,0
74406,2,3,260288,260288,260291,0,3,1
74407,3,1,260291,260291,260292,0,1,0
74408,4,2,260295,260295,260297,0,2,3
74409,2,3,260297,260297,260300,0,3,0
74410,3,1,260300,260300,260301,0,1,0
74411,6,3,260306,260306,260309,0,3,5
74412,3,3,260309,260309,260312,0,3,0
74413,3,2,260312,260312,260314,0,2,0
74414,6,1,260318,260318,260319,0,1,4
74415,4,2,260322,260322,260324,0,2,3
74416,5,1,260327,260327,260328,0,1,3
74417,1,2,260328,260328,260330,0,2,0
74418,2,3,260330,260330,260333,0,3,0
74419,4,2,260334,260334,260336,0,2,1
74420,2,1,260336,260336,260337,0,1,0
74421,3,1,260339,260339,260340,0,1,2
74422,4,2,260343,260343,260345,0,2,3
74423,3,1,260346,260346,260347,0,1,1
74424,3,1,260349,260349,260350,0,1,2
74425,1,2,260350,260350,260352,0,2,0
74426,2,3,260352,260352,260355,0,3,0
74427,3,2,260355,260355,260357,0,2,0
74428,4,2,260359,260359,260361,0,2,2
74429,3,2,260362,260362,260364,0,2,1
74430,2,3,260364,260364,260367,0,3,0
74431,6,1,260370,260370,260371,0,1,3
74432,2,3,260372,260372,260375,0,3,1
74433,6,3,260378,260378,260381,0,3,3
74434,1,1,260379,260381,260382,2,3,0
74435,5,2,260384,260384,260386,0,2,2
74436,6,2,260390,260390,260392,0,2,4
74437,5,1,260395,260395,260396,0,1,3
74438,4,1,260399,260399,260400,0,1,3
74439,2,1,260401,260401,260402,0,1,1
74440,1,1,260402,260402,260403,0,1,0
74441,6,1,260408,260408,260409,0,1,5
74442,6,1,260414,260414,260415,0,1,5
74443,5,3,260419,260419,260422,0,3,4
74444,5,3,260424,260424,260427,0,3,2
74445,1,2,260425,260427,260429,2,4,0
74446,2,1,260427,260429,260430,2,3,0
74447,6,3,260433,260433,260436,0,3,3
74448,4,3,260437,260437,260440,0,3,1
74449,1,2,260438,260440,260442,2,4,0
74450,2,2,260440,260442,260444,2,4,0
74451,5,1,260445,260445,260446,0,1,1
74452,6,3,260451,260451,260454,0,3,5
74453,5,1,260456,260456,260457,0,1,2
74454,3,3,260459,260459,260462,0,3,2
74455,2,1,260461,260462,260463,1,2,0
74456,2,3,260463,260463,260466,0,3,0
74457,5,2,260468,260468,260470,0,2,2
74458,1,1,260469,260470,260471,1,2,0
74459,4,1,260473,260473,260474,0,1,2
74460,4,2,260477,260477,260479,0,2,3
74461,4,3,260481,260481,260484,0,3,2
74462,2,3,260483,260484,260487,1,4,0
74463,1,3,260484,260487,260490,3,6,0
74464,6,3,260490,260490,260493,0,3,0
74465,3,1,260493,260493,260494,0,1,0
74466,4,3,260497,260497,260500,0,3,3
74467,2,2,260499,260500,260502,1,3,0
74468,5,3,260504,260504,260507,0,3,2
74469,3,1,260507,260507,260508,0,1,0
74470,2,2,260509,260509,260511,0,2,1
74471,6,3,260515,260515,260518,0,3,4
74472,2,2,260517,260518,260520,1,3,0
74473,6,1,260523,260523,260524,0,1,3
74474,2,3,260525,260525,260528,0,3,1
74475,1,1,260526,260528,260529,2,3,0
74476,6,1,260532,260532,260533,0,1,3
74477,4,1,260536,260536,260537,0,1,3
74478,4,3,260540,260540,260543,0,3,3
74479,6,2,260546,260546,260548,0,2,3
74480,1,3,260547,260548,260551,1,4,0
74481,3,1,260550,260551,260552,1,2,0
74482,2,1,260552,260552,260553,0,1,0
74483,4,1,260556,260556,260557,0,1,3
74484,4,2,260560,260560,260562,0,2,3
74485,2,3,260562,260562,260565,0,3,0
74486,3,1,260565,260565,260566,0,1,0
74487,5,2,260570,260570,260572,0,2,4
74488,1,2,260571,260572,260574,1,3,0
74489,5,2,260576,260576,260578,0,2,2
74490,3,2,260579,260579,260581,0,2,1
74491,5,1,260584,260584,260585,0,1,3
74492,4,3,260588,260588,260591,0,3,3
74493,6,3,260594,260594,260597,0,3,3
74494,2,3,260596,260597,260600,1,4,0
74495,3,3,260599,260600,260603,1,4,0
74496,4,2,260603,260603,260605,0,2,0
74497,2,3,260605,260605,260608,0,3,0
74498,6,2,260611,260611,260613,0,2,3
74499,5,2,260616,260616,260618,0,2,3
74500,1,1,260617,260618,260619,1,2,0
74501,3,2,260620,260620,260622,0,2,1
74502,3,2,260623,260623,260625,0,2,1
74503,3,2,260626,260626,260628,0,2,1
74504,5,3,260631,260631,260634,0,3,3
74505,2,3,260633,260634,260637,1,4,0
74506,6,2,260639,260639,260641,0,2,2
74507,5,3,260644,260644,260647,0,3,3
74508,2,3,260646,260647,260650,1,4,0
74509,3,1,260649,260650,260651,1,2,0
74510,6,2,260655,260655,260657,0,2,4
74511,5,1,260660,260660,260661,0,1,3
74512,4,3,260664,260664,260667,0,3,3
74513,3,2,260667,260667,260669,0,2,0
74514,2,3,260669,260669,260672,0,3,0
74515,1,1,260670,260672,260673,2,3,0
74516,3,2,260673,260673,260675,0,2,0
74517,1,2,260674,260675,260677,1,3,0
74518,5,3,260679,260679,260682,0,3,2
74519,2,1,260681,260682,260683,1,2,0
74520,4,2,260685,260685,260687,0,2,2
74521,4,2,260689,260689,260691,0,2,2
74522,3,2,260692,260692,260694,0,2,1
74523,5,3,260697,260697,260700,0,3,3
74524,5,3,260702,260702,260705,0,3,2
74525,3,2,260705,260705,260707,0,2,0
74526,2,2,260707,260707,260709,0,2,0
74527,6,1,260713,260713,260714,0,1,4
74528,6,2,260719,260719,260721,0,2,5
74529,1,2,260720,260721,260723,1,3,0
74530,3,1,260723,260723,260724,0,1,0
74531,5,1,260728,260728,260729,0,1,4
74532,5,1,260733,260733,260734,0,1,4
74533,5,3,260738,260738,260741,0,3,4
74534,4,1,260742,260742,260743,0,1,1
74535,3,2,260745,260745,260747,0,2,2
74536,6,3,260751,260751,260754,0,3,4
74537,1,1,260752,260754,260755,2,3,0
74538,4,1,260756,260756,260757,0,1,1
74539,4,3,260760,260760,260763,0,3,3
74540,5,1,260765,260765,260766,0,1,2
74541,3,1,260768,260768,260769,0,1,2
74542,4,3,260772,260772,260775,0,3,3
74543,2,2,260774,260775,260777,1,3,0
74544,4,1,260778,260778,260779,0,1,1
74545,2,3,260780,260780,260783,0,3,1
74546,6,1,260786,260786,260787,0,1,3
74547,2,1,260788,260788,260789,0,1,1
74548,4,1,260792,260792,260793,0,1,3
74549,4,2,260796,260796,260798,0,2,3
74550,2,3,260798,260798,260801,0,3,0
74551,4,3,260802,260802,260805,0,3,1
74552,3,2,260805,260805,260807,0,2,0
74553,1,3,260806,260807,260810,1,4,0
74554,6,3,260812,260812,260815,0,3,2
74555,5,3,260817,260817,260820,0,3,2
74556,5,3,260822,260822,260825,0,3,2
74557,1,1,260823,260825,260826,2,3,0
74558,2,1,260825,260826,260827,1,2,0
74559,2,3,260827,260827,260830,0,3,0
74560,5,1,260832,260832,260833,0,1,2
74561,3,3,260835,260835,260838,0,3,2
74562,2,3,260837,260838,260841,1,4,0
74563,6,3,260843,260843,260846,0,3,2
74564,2,2,260845,260846,260848,1,3,0
74565,5,2,260850,260850,260852,0,2,2
74566,4,1,260854,260854,260855,0,1,2
74567,2,1,260856,260856,260857,0,1,1
74568,6,1,260862,260862,260863,0,1,5
74569,6,2,260868,260868,260870,0,2,5
74570,1,2,260869,260870,260872,1,3,0
74571,2,2,260871,260872,260874,1,3,0
74572,5,2,260876,260876,260878,0,2,2
74573,5,2,260881,260881,260883,0,2,3
74574,6,1,260887,260887,260888,0,1,4
74575,3,2,260890,260890,260892,0,2,2
74576,1,1,260891,260892,260893,1,2,0
74577,4,3,260895,260895,260898,0,3,2
74578,4,2,260899,260899,260901,0,2,1
74579,4,2,260903,260903,260905,0,2,2
74580,6,1,260909,260909,260910,0,1,4
74581,3,1,260912,260912,260913,0,1,2
74582,4,1,260916,260916,260917,0,1,3
74583,5,1,260921,260921,260922,0,1,4
74584,3,3,260924,260924,260927,0,3,2
74585,2,3,260926,260927,260930,1,4,0
74586,4,3,260930,260930,260933,0,3,0
74587,3,1,260933,260933,260934,0,1,0
74588,6,1,260939,260939,260940,0,1,5
74589,3,1,260942,260942,260943,0,1,2
74590,3,2,260945,260945,260947,0,2,2
74591,4,2,260949,260949,260951,0,2,2
74592,5,3,260954,260954,260957,0,3,3
74593,2,2,260956,260957,260959,1,3,0
74594,1,1,260957,260959,260960,2,3,0
74595,5,2,260962,260962,260964,0,2,2
74596,2,3,260964,260964,260967,0,3,0
74597,3,1,260967,260967,260968,0,1,0
74598,1,2,260968,260968,260970,0,2,0
74599,5,1,260973,260973,260974,0,1,3
74600,4,3,260977,260977,260980,0,3,3
74601,1,2,260978,260980,260982,2,4,0
74602,6,3,260984,260984,260987,0,3,2
74603,6,3,260990,260990,260993,0,3,3
74604,3,3,260993,260993,260996,0,3,0
74605,2,2,260995,260996,260998,1,3,0
74606,2,2,260997,260998,261000,1,3,0
74607,1,3,260998,261000,261003,2,5,0
74608,1,1,260999,261003,261004,4,5,0
74609,1,1,261000,261004,261005,4,5,0
74610,6,1,261006,261006,261007,0,1,1
74611,5,2,261011,261011,261013,0,2,4
74612,4,1,261015,261015,261016,0,1,2
74613,1,2,261016,261016,261018,0,2,0
74614,6,1,261022,261022,261023,0,1,4
74615,3,3,261025,261025,261028,0,3,2
74616,1,2,261026,261028,261030,2,4,0
74617,3,2,261029,261030,261032,1,3,0
74618,6,3,261035,261035,261038,0,3,3
74619,2,3,261037,261038,261041,1,4,0
74620,2,1,261039,261041,261042,2,3,0
74621,1,1,261040,261042,261043,2,3,0
74622,3,2,261043,261043,261045,0,2,0
74623,4,2,261047,261047,261049,0,2,2
74624,3,1,261050,261050,261051,0,1,1
74625,1,2,261051,261051,261053,0,2,0
74626,1,3,261052,261053,261056,1,4,0
74627,4,1,261056,261056,261057,0,1,0
74628,2,1,261058,261058,261059,0,1,1
74629,5,2,261063,261063,261065,0,2,4
74630,5,1,261068,261068,261069,0,1,3
74631,1,1,261069,261069,261070,0,1,0
74632,6,3,261075,261075,261078,0,3,5
74633,4,3,261079,261079,261082,0,3,1
74634,2,2,261081,261082,261084,1,3,0
74635,3,2,261084,261084,261086,0,2,0
74636,3,1,261087,261087,261088,0,1,1
74637,4,2,261091,261091,261093,0,2,3
74638,1,3,261092,261093,261096,1,4,0
74639,1,3,261093,261096,261099,3,6,0
74640,3,1,261096,261099,261100,3,4,0
74641,5,1,261101,261101,261102,0,1,1
74642,6,2,261107,261107,261109,0,2,5
74643,6,3,261113,261113,261116,0,3,4
74644,6,1,261119,261119,261120,0,1,3
74645,4,3,261123,261123,261126,0,3,3
74646,4,3,261127,261127,261130,0,3,1
74647,4,1,261131,261131,261132,0,1,1
74648,4,3,261135,261135,261138,0,3,3
74649,3,1,261138,261138,261139,0,1,0
74650,5,3,261143,261143,261146,0,3,4
74651,6,1,261149,261149,261150,0,1,3
74652,4,1,261153,261153,261154,0,1,3
74653,2,3,261155,261155,261158,0,3,1
74654,2,3,261157,261158,261161,1,4,0
74655,1,1,261158,261161,261162,3,4,0
74656,5,2,261163,261163,261165,0,2,1
74657,5,1,261168,261168,261169,0,1,3
74658,6,2,261174,261174,261176,0,2,5
74659,5,2,261179,261179,261181,0,2,3
74660,4,2,261183,261183,261185,0,2,2
74661,5,3,261188,261188,261191,0,3,3
74662,3,3,261191,261191,261194,0,3,0
74663,4,3,261195,261195,261198,0,3,1
74664,2,3,261197,261198,261201,1,4,0
74665,3,2,261200,261201,261203,1,3,0
74666,2,3,261202,261203,261206,1,4,0
74667,5,3,261207,261207,261210,0,3,1
74668,4,3,261211,261211,261214,0,3,1
74669,4,1,261215,261215,261216,0,1,1
74670,6,3,261221,261221,261224,0,3,5
74671,2,2,261223,261224,261226,1,3,0
74672,6,1,261229,261229,261230,0,1,3
74673,5,3,261234,261234,261237,0,3,4
74674,6,1,261240,261240,261241,0,1,3
74675,4,1,261244,261244,261245,0,1,3
74676,3,2,261247,261247,261249,0,2,2
74677,5,1,261252,261252,261253,0,1,3
74678,3,2,261255,261255,261257,0,2,2
74679,3,1,261258,261258,261259,0,1,1
74680,6,3,261264,261264,261267,0,3,5
74681,4,3,261268,261268,261271,0,3,1
74682,1,2,261269,261271,261273,2,4,0
74683,3,3,261272,261273,261276,1,4,0
74684,4,3,261276,261276,261279,0,3,0
74685,3,2,261279,261279,261281,0,2,0
74686,5,1,261284,261284,261285,0,1,3
74687,4,2,261288,261288,261290,0,2,3
74688,5,2,261293,261293,261295,0,2,3
74689,3,2,261296,261296,261298,0,2,1
74690,5,3,261301,261301,261304,0,3,3
74691,3,3,261304,261304,261307,0,3,0
74692,4,2,261308,261308,261310,0,2,1
74693,5,3,261313,261313,261316,0,3,3
74694,1,1,261314,261316,261317,2,3,0
74695,3,1,261317,261317,261318,0,1,0
74696,4,1,261321,261321,261322,0,1,3
74697,1,2,261322,261322,261324,0,2,0
74698,4,3,261326,261326,261329,0,3,2
74699,3,3,261329,261329,261332,0,3,0
74700,2,1,261331,261332,261333,1,2,0
74701,2,1,261333,261333,261334,0,1,0
74702,2,1,261335,261335,261336,0,1,1
74703,3,3,261338,261338,261341,0,3,2
74704,6,1,261344,261344,261345,0,1,3
74705,5,1,261349,261349,261350,0,1,4
74706,1,2,261350,261350,261352,0,2,0
74707,5,1,261355,261355,261356,0,1,3
74708,5,3,261360,261360,261363,0,3,4
74709,3,3,261363,261363,261366,0,3,0
74710,1,1,261364,261366,261367,2,3,0
74711,3,1,261367,261367,261368,0,1,0
74712,4,2,261371,261371,261373,0,2,3
74713,1,2,261372,261373,261375,1,3,0
74714,4,1,261376,261376,261377,0,1,1
74715,5,1,261381,261381,261382,0,1,4
74716,5,2,261386,261386,261388,0,2,4
74717,2,2,261388,261388,261390,0,2,0
74718,6,1,261394,261394,261395,0,1,4
74719,6,2,261400,261400,261402,0,2,5
74720,1,3,261401,261402,261405,1,4,0
74721,1,2,261402,261405,261407,3,5,0
74722,1,1,261403,261407,261408,4,5,0
74723,4,1,261407,261408,261409,1,2,0
74724,5,2,261412,261412,261414,0,2,3
74725,5,1,261417,261417,261418,0,1,3
74726,6,3,261423,261423,261426,0,3,5
74727,2,1,261425,261426,261427,1,2,0
74728,1,1,261426,261427,261428,1,2,0
74729,5,3,261431,261431,261434,0,3,3
74730,6,2,261437,261437,261439,0,2,3
74731,2,3,261439,261439,261442,0,3,0
74732,4,1,261443,261443,261444,0,1,1
74733,6,1,261449,261449,261450,0,1,5
74734,1,3,261450,261450,261453,0,3,0
74735,4,2,261454,261454,261456,0,2,1
74736,2,1,261456,261456,261457,0,1,0
74737,4,2,261460,261460,261462,0,2,3
74738,1,2,261461,261462,261464,1,3,0
74739,1,3,261462,261464,261467,2,5,0
74740,5,3,261467,261467,261470,0,3,0
74741,1,1,261468,261470,261471,2,3,0
74742,3,3,261471,261471,261474,0,3,0
74743,3,1,261474,261474,261475,0,1,0
74744,4,2,261478,261478,261480,0,2,3
74745,4,1,261482,261482,261483,0,1,2
74746,2,2,261484,261484,261486,0,2,1
74747,4,2,261488,261488,261490,0,2,2
74748,4,1,261492,261492,261493,0,1,2
74749,6,1,261498,261498,261499,0,1,5
74750,6,1,261504,261504,261505,0,1,5
74751,5,2,261509,261509,261511,0,2,4
74752,6,2,261515,261515,261517,0,2,4
74753,4,1,261519,261519,261520,0,1,2
74754,2,2,261521,261521,261523,0,2,1
74755,3,1,261524,261524,261525,0,1,1
74756,1,3,261525,261525,261528,0,3,0
74757,6,3,261531,261531,261534,0,3,3
74758,1,3,261532,261534,261537,2,5,0
74759,4,3,261536,261537,261540,1,4,0
74760,2,2,261538,261540,261542,2,4,0
74761,5,2,261543,261543,261545,0,2,1
74762,1,2,261544,261545,261547,1,3,0
74763,1,3,261545,261547,261550,2,5,0
74764,5,3,261550,261550,261553,0,3,0
74765,4,3,261554,261554,261557,0,3,1
74766,1,3,261555,261557,261560,2,5,0
74767,2,2,261557,261560,261562,3,5,0
74768,1,1,261558,261562,261563,4,5,0
74769,6,2,261564,261564,261566,0,2,1
74770,4,2,261568,261568,261570,0,2,2
74771,6,2,261574,261574,261576,0,2,4
74772,3,1,261577,261577,261578,0,1,1
74773,6,1,261583,261583,261584,0,1,5
74774,2,2,261585,261585,261587,0,2,1
74775,1,2,261586,261587,261589,1,3,0
74776,5,2,261591,261591,261593,0,2,2
74777,2,3,261593,261593,261596,0,3,0
74778,6,3,261599,261599,261602,0,3,3
74779,6,1,261605,261605,261606,0,1,3
74780,6,2,261611,261611,261613,0,2,5
74781,5,1,261616,261616,261617,0,1,3
74782,3,3,261619,261619,261622,0,3,2
74783,6,3,261625,261625,261628,0,3,3
74784,3,3,261628,261628,261631,0,3,0
74785,5,3,261633,261633,261636,0,3,2
74786,4,2,261637,261637,261639,0,2,1
74787,4,3,261641,261641,261644,0,3,2
74788,4,1,261645,261645,261646,0,1,1
74789,2,3,261647,261647,261650,0,3,1
74790,4,1,261651,261651,261652,0,1,1
74791,4,3,261655,261655,261658,0,3,3
74792,5,1,261660,261660,261661,0,1,2
74793,6,3,261666,261666,261669,0,3,5
74794,5,1,261671,261671,261672,0,1,2
74795,6,2,261677,261677,261679,0,2,5
74796,4,1,261681,261681,261682,0,1,2
74797,4,2,261685,261685,261687,0,2,3
74798,1,2,261686,261687,261689,1,3,0
74799,3,2,261689,261689,261691,0,2,0
74800,5,3,261694,261694,261697,0,3,3
74801,4,3,261698,261698,261701,0,3,1
74802,1,3,261699,261701,261704,2,5,0
74803,4,1,261703,261704,261705,1,2,0
74804,5,1,261708,261708,261709,0,1,3
74805,6,1,261714,261714,261715,0,1,5
74806,4,1,261718,261718,261719,0,1,3
74807,1,3,261719,261719,261722,0,3,0
74808,1,3,261720,261722,261725,2,5,0
74809,4,3,261724,261725,261728,1,4,0
74810,6,2,261730,261730,261732,0,2,2
74811,1,2,261731,261732,261734,1,3,0
74812,6,2,261737,261737,261739,0,2,3
74813,3,2,261740,261740,261742,0,2,1
74814,4,3,261744,261744,261747,0,3,2
74815,1,3,261745,261747,261750,2,5,0
74816,1,1,261746,261750,261751,4,5,0
74817,5,2,261751,261751,261753,0,2,0
74818,1,3,261752,261753,261756,1,4,0
74819,1,3,261753,261756,261759,3,6,0
74820,5,2,261758,261759,261761,1,3,0
74821,5,1,261763,261763,261764,0,1,2
74822,6,2,261769,261769,261771,0,2,5
74823,1,1,261770,261771,261772,1,2,0
74824,4,3,261774,261774,261777,0,3,2
74825,3,3,261777,261777,261780,0,3,0
74826,3,1,261780,261780,261781,0,1,0
74827,2,2,261782,261782,261784,0,2,1
74828,3,1,261785,261785,261786,0,1,1
74829,2,3,261787,261787,261790,0,3,1
74830,4,2,261791,261791,261793,0,2,1
74831,1,1,261792,261793,261794,1,2,0
74832,4,1,261796,261796,261797,0,1,2
74833,3,1,261799,261799,261800,0,1,2
74834,3,2,261802,261802,261804,0,2,2
74835,2,1,261804,261804,261805,0,1,0
74836,3,3,261807,261807,261810,0,3,2
74837,1,2,261808,261810,261812,2,4,0
74838,1,3,261809,261812,261815,3,6,0
74839,6,2,261815,261815,261817,0,2,0
74840,1,2,261816,261817,261819,1,3,0
74841,4,1,261820,261820,261821,0,1,1
74842,6,3,261826,261826,261829,0,3,5
74843,6,3,261832,261832,261835,0,3,3
74844,5,1,261837,261837,261838,0,1,2
74845,5,1,261842,261842,261843,0,1,4
74846,4,2,261846,261846,261848,0,2,3
74847,1,1,261847,261848,261849,1,2,0
74848,6,1,261853,261853,261854,0,1,4
74849,6,3,261859,261859,261862,0,3,5
74850,3,1,261862,261862,261863,0,1,0
74851,4,1,261866,261866,261867,0,1,3
74852,1,1,261867,261867,261868,0,1,0
74853,4,3,261871,261871,261874,0,3,3
74854,3,2,261874,261874,261876,0,2,0
74855,5,3,261879,261879,261882,0,3,3
74856,2,1,261881,261882,261883,1,2,0
74857,2,3,261883,261883,261886,0,3,0
74858,5,3,261888,261888,261891,0,3,2
74859,4,1,261892,261892,261893,0,1,1
74860,6,1,261898,261898,261899,0,1,5
74861,2,1,261900,261900,261901,0,1,1
74862,4,1,261904,261904,261905,0,1,3
74863,6,1,261910,261910,261911,0,1,5
74864,6,2,261916,261916,261918,0,2,5
74865,2,1,261918,261918,261919,0,1,0
74866,2,3,261920,261920,261923,0,3,1
74867,5,2,261925,261925,261927,0,2,2
74868,4,1,261929,261929,261930,0,1,2
74869,6,1,261935,261935,261936,0,1,5
74870,1,2,261936,261936,261938,0,2,0
74871,3,1,261939,261939,261940,0,1,1
74872,2,2,261941,261941,261943,0,2,1
74873,6,2,261947,261947,261949,0,2,4
74874,3,1,261950,261950,261951,0,1,1
74875,5,2,261955,261955,261957,0,2,4
74876,5,2,261960,261960,261962,0,2,3
74877,1,2,261961,261962,261964,1,3,0
74878,3,3,261964,261964,261967,0,3,0
74879,4,2,261968,261968,261970,0,2,1
74880,6,3,261974,261974,261977,0,3,4
74881,3,3,261977,261977,261980,0,3,0
74882,5,2,261982,261982,261984,0,2,2
74883,1,1,261983,261984,261985,1,2,0
74884,5,1,261988,261988,261989,0,1,3
74885,2,1,261990,261990,261991,0,1,1
74886,3,3,261993,261993,261996,0,3,2
74887,1,3,261994,261996,261999,2,5,0
74888,3,1,261997,261999,262000,2,3,0
74889,5,3,262002,262002,262005,0,3,2
74890,1,2,262003,262005,262007,2,4,0
74891,4,2,262007,262007,262009,0,2,0
74892,3,2,262010,262010,262012,0,2,1
74893,4,2,262014,262014,262016,0,2,2
74894,3,3,262017,262017,262020,0,3,1
74895,4,2,262021,262021,262023,0,2,1
74896,3,2,262024,262024,262026,0,2,1
74897,2,2,262026,262026,262028,0,2,0
74898,6,2,262032,262032,262034,0,2,4
74899,2,1,262034,262034,262035,0,1,0
74900,2,1,262036,262036,262037,0,1,1
74901,1,2,262037,262037,262039,0,2,0
74902,5,2,262042,262042,262044,0,2,3
74903,5,1,262047,262047,262048,0,1,3
74904,2,1,262049,262049,262050,0,1,1
74905,5,3,262054,262054,262057,0,3,4
74906,4,2,262058,262058,262060,0,2,1
74907,1,1,262059,262060,262061,1,2,0
74908,3,1,262062,262062,262063,0,1,1
74909,6,2,262068,262068,262070,0,2,5
74910,4,2,262072,262072,262074,0,2,2
74911,4,2,262076,262076,262078,0,2,2
74912,1,3,262077,262078,262081,1,4,0
74913,1,1,262078,262081,262082,3,4,0
74914,5,1,262083,262083,262084,0,1,1
74915,2,1,262085,262085,262086,0,1,1
74916,4,1,262089,262089,262090,0,1,3
74917,1,3,262090,262090,262093,0,3,0
74918,1,1,262091,262093,262094,2,3,0
74919,4,1,262095,262095,262096,0,1,1
74920,6,2,262101,262101,262103,0,2,5
74921,1,2,262102,262103,262105,1,3,0
74922,5,2,262107,262107,262109,0,2,2
74923,2,3,262109,262109,262112,0,3,0
74924,1,1,262110,262112,262113,2,3,0
74925,3,3,262113,262113,262116,0,3,0
74926,5,3,262118,262118,262121,0,3,2
74927,6,1,262124,262124,262125,0,1,3
74928,6,2,262130,262130,262132,0,2,5
74929,1,1,262131,262132,262133,1,2,0
74930,5,2,262136,262136,262138,0,2,3
74931,2,2,262138,262138,262140,0,2,0
74932,4,3,262142,262142,262145,0,3,2
74933,3,1,262145,262145,262146,0,1,0
74934,6,2,262151,262151,262153,0,2,5
74935,5,1,262156,262156,262157,0,1,3
74936,4,2,262160,262160,262162,0,2,3
74937,6,1,262166,262166,262167,0,1,4
74938,4,1,262170,262170,262171,0,1,3
74939,5,1,262175,262175,262176,0,1,4
74940,1,2,262176,262176,262178,0,2,0
74941,5,3,262181,262181,262184,0,3,3
74942,2,3,262183,262184,262187,1,4,0
74943,6,1,262189,262189,262190,0,1,2
74944,6,1,262195,262195,262196,0,1,5
74945,5,3,262200,262200,262203,0,3,4
74946,1,1,262201,262203,262204,2,3,0
74947,2,3,262203,262204,262207,1,4,0
74948,1,2,262204,262207,262209,3,5,0
74949,3,3,262207,262209,262212,2,5,0
74950,4,3,262211,262212,262215,1,4,0
74951,4,2,262215,262215,262217,0,2,0
74952,4,1,262219,262219,262220,0,1,2
74953,3,2,262222,262222,262224,0,2,2
74954,6,1,262228,262228,262229,0,1,4
74955,3,1,262231,262231,262232,0,1,2
74956,4,2,262235,262235,262237,0,2,3
74957,6,3,262241,262241,262244,0,3,4
74958,6,1,262247,262247,262248,0,1,3
74959,3,3,262250,262250,262253,0,3,2
74960,6,3,262256,262256,262259,0,3,3
74961,6,1,262262,262262,262263,0,1,3
74962,2,2,262264,262264,262266,0,2,1
74963,5,1,262269,262269,262270,0,1,3
74964,2,1,262271,262271,262272,0,1,1
74965,3,3,262274,262274,262277,0,3,2
74966,5,1,262279,262279,262280,0,1,2
74967,6,2,262285,262285,262287,0,2,5
74968,6,3,262291,262291,262294,0,3,4
74969,2,2,262293,262294,262296,1,3,0
74970,4,3,262297,262297,262300,0,3,1
74971,4,2,262301,262301,262303,0,2,1
74972,6,3,262307,262307,262310,0,3,4
74973,4,2,262311,262311,262313,0,2,1
74974,4,3,262315,262315,262318,0,3,2
74975,3,2,262318,262318,262320,0,2,0
74976,6,2,262324,262324,262326,0,2,4
74977,2,1,262326,262326,262327,0,1,0
74978,6,2,262332,262332,262334,0,2,5
74979,2,2,262334,262334,262336,0,2,0
74980,1,3,262335,262336,262339,1,4,0
74981,5,2,262340,262340,262342,0,2,1
74982,1,1,262341,262342,262343,1,2,0
74983,1,3,262342,262343,262346,1,4,0
74984,5,1,262347,262347,262348,0,1,1
74985,5,2,262352,262352,262354,0,2,4
74986,3,3,262355,262355,262358,0,3,1
74987,1,3,262356,262358,262361,2,5,0
74988,4,1,262360,262361,262362,1,2,0
74989,1,1,262361,262362,262363,1,2,0
74990,6,2,262367,262367,262369,0,2,4
74991,2,3,262369,262369,262372,0,3,0
74992,4,3,262373,262373,262376,0,3,1
74993,5,1,262378,262378,262379,0,1,2
74994,2,1,262380,262380,262381,0,1,1
74995,6,1,262386,262386,262387,0,1,5
74996,3,2,262389,262389,262391,0,2,2
74997,1,2,262390,262391,262393,1,3,0
74998,5,2,262395,262395,262397,0,2,2
74999,3,3,262398,262398,262401,0,3,1
75000,5,3,262403,262403,262406,0,3,2
75001,6,1,262409,262409,262410,0,1,3
75002,4,2,262413,262413,262415,0,2,3
75003,2,1,262415,262415,262416,0,1,0
75004,4,1,262419,262419,262420,0,1,3
75005,2,1,262421,262421,262422,0,1,1
75006,3,2,262424,262424,262426,0,2,2
75007,1,2,262425,262426,262428,1,3,0
75008,6,2,262431,262431,262433,0,2,3
75009,1,3,262432,262433,262436,1,4,0
75010,6,3,262438,262438,262441,0,3,2
75011,4,1,262442,262442,262443,0,1,1
75012,3,3,262445,262445,262448,0,3,2
75013,4,2,262449,262449,262451,0,2,1
75014,4,2,262453,262453,262455,0,2,2
75015,4,3,262457,262457,262460,0,3,2
75016,1,3,262458,262460,262463,2,5,0
75017,4,2,262462,262463,262465,1,3,0
75018,6,1,262468,262468,262469,0,1,3
75019,6,2,262474,262474,262476,0,2,5
75020,2,1,262476,262476,262477,0,1,0
75021,6,2,262482,262482,262484,0,2,5
75022,2,1,262484,262484,262485,0,1,0
75023,6,2,262490,262490,262492,0,2,5
75024,6,2,262496,262496,262498,0,2,4
75025,1,1,262497,262498,262499,1,2,0
75026,3,2,262500,262500,262502,0,2,1
75027,5,1,262505,262505,262506,0,1,3
75028,1,1,262506,262506,262507,0,1,0
75029,1,3,262507,262507,262510,0,3,0
75030,1,3,262508,262510,262513,2,5,0
75031,1,2,262509,262513,262515,4,6,0
75032,6,2,262515,262515,262517,0,2,0
75033,1,3,262516,262517,262520,1,4,0
75034,1,3,262517,262520,262523,3,6,0
75035,3,3,262520,262523,262526,3,6,0
75036,5,1,262525,262526,262527,1,2,0
75037,3,1,262528,262528,262529,0,1,1
75038,2,2,262530,262530,262532,0,2,1
75039,3,3,262533,262533,262536,0,3,1
75040,6,1,262539,262539,262540,0,1,3
75041,1,2,262540,262540,262542,0,2,0
75042,5,3,262545,262545,262548,0,3,3
75043,6,1,262551,262551,262552,0,1,3
75044,5,1,262556,262556,262557,0,1,4
75045,4,3,262560,262560,262563,0,3,3
75046,5,3,262565,262565,262568,0,3,2
75047,3,3,262568,262568,262571,0,3,0
75048,3,1,262571,262571,262572,0,1,0
75049,5,1,262576,262576,262577,0,1,4
75050,4,2,262580,262580,262582,0,2,3
75051,4,3,262584,262584,262587,0,3,2
75052,1,1,262585,262587,262588,2,3,0
75053,4,3,262589,262589,262592,0,3,1
75054,4,1,262593,262593,262594,0,1,1
75055,3,3,262596,262596,262599,0,3,2
75056,6,3,262602,262602,262605,0,3,3
75057,1,1,262603,262605,262606,2,3,0
75058,1,1,262604,262606,262607,2,3,0
75059,6,2,262610,262610,262612,0,2,3
75060,5,2,262615,262615,262617,0,2,3
75061,6,2,262621,262621,262623,0,2,4
75062,4,2,262625,262625,262627,0,2,2
75063,4,2,262629,262629,262631,0,2,2
75064,1,1,262630,262631,262632,1,2,0
75065,6,1,262636,262636,262637,0,1,4
75066,5,2,262641,262641,262643,0,2,4
75067,2,3,262643,262643,262646,0,3,0
75068,3,2,262646,262646,262648,0,2,0
75069,6,1,262652,262652,262653,0,1,4
75070,6,3,262658,262658,262661,0,3,5
75071,1,2,262659,262661,262663,2,4,0
75072,5,2,262664,262664,262666,0,2,1
75073,4,2,262668,262668,262670,0,2,2
75074,3,3,262671,262671,262674,0,3,1
75075,1,2,262672,262674,262676,2,4,0
75076,4,1,262676,262676,262677,0,1,0
75077,5,2,262681,262681,262683,0,2,4
75078,4,1,262685,262685,262686,0,1,2
75079,3,3,262688,262688,262691,0,3,2
75080,6,2,262694,262694,262696,0,2,3
75081,4,1,262698,262698,262699,0,1,2
75082,3,2,262701,262701,262703,0,2,2
75083,5,2,262706,262706,262708,0,2,3
75084,2,1,262708,262708,262709,0,1,0
75085,5,1,262713,262713,262714,0,1,4
75086,4,1,262717,262717,262718,0,1,3
75087,2,3,262719,262719,262722,0,3,1
75088,6,3,262725,262725,262728,0,3,3
75089,1,2,262726,262728,262730,2,4,0
75090,4,1,262730,262730,262731,0,1,0
75091,1,2,262731,262731,262733,0,2,0
75092,2,3,262733,262733,262736,0,3,0
75093,3,3,262736,262736,262739,0,3,0
75094,2,2,262738,262739,262741,1,3,0
75095,3,2,262741,262741,262743,0,2,0
75096,6,1,262747,262747,262748,0,1,4
75097,4,3,262751,262751,262754,0,3,3
75098,1,2,262752,262754,262756,2,4,0
75099,2,3,262754,262756,262759,2,5,0
75100,3,3,262757,262759,262762,2,5,0
75101,1,2,262758,262762,262764,4,6,0
75102,4,1,262762,262764,262765,2,3,0
75103,1,2,262763,262765,262767,2,4,0
75104,2,3,262765,262767,262770,2,5,0
75105,6,1,262771,262771,262772,0,1,1
75106,5,2,262776,262776,262778,0,2,4
75107,5,3,262781,262781,262784,0,3,3
75108,4,2,262785,262785,262787,0,2,1
75109,2,3,262787,262787,262790,0,3,0
75110,6,3,262793,262793,262796,0,3,3
75111,6,3,262799,262799,262802,0,3,3
75112,4,2,262803,262803,262805,0,2,1
75113,5,2,262808,262808,262810,0,2,3
75114,3,2,262811,262811,262813,0,2,1
75115,5,3,262816,262816,262819,0,3,3
75116,1,2,262817,262819,262821,2,4,0
75117,4,1,262821,262821,262822,0,1,0
75118,5,3,262826,262826,262829,0,3,4
75119,3,1,262829,262829,262830,0,1,0
75120,4,2,262833,262833,262835,0,2,3
75121,2,2,262835,262835,262837,0,2,0
75122,5,3,262840,262840,262843,0,3,3
75123,6,2,262846,262846,262848,0,2,3
75124,5,2,262851,262851,262853,0,2,3
75125,3,2,262854,262854,262856,0,2,1
75126,6,2,262860,262860,262862,0,2,4
75127,3,1,262863,262863,262864,0,1,1
75128,5,2,262868,262868,262870,0,2,4
75129,1,1,262869,262870,262871,1,2,0
75130,2,2,262871,262871,262873,0,2,0
75131,2,1,262873,262873,262874,0,1,0
75132,6,2,262879,262879,262881,0,2,5
75133,6,2,262885,262885,262887,0,2,4
75134,3,1,262888,262888,262889,0,1,1
75135,2,1,262890,262890,262891,0,1,1
75136,5,2,262895,262895,262897,0,2,4
75137,2,3,262897,262897,262900,0,3,0
75138,6,2,262903,262903,262905,0,2,3
75139,4,3,262907,262907,262910,0,3,2
75140,6,2,262913,262913,262915,0,2,3
75141,4,3,262917,262917,262920,0,3,2
75142,4,2,262921,262921,262923,0,2,1
75143,4,2,262925,262925,262927,0,2,2
75144,4,1,262929,262929,262930,0,1,2
75145,2,3,262931,262931,262934,0,3,1
75146,6,1,262937,262937,262938,0,1,3
75147,4,3,262941,262941,262944,0,3,3
75148,3,2,262944,262944,262946,0,2,0
75149,2,2,262946,262946,262948,0,2,0
75150,6,3,262952,262952,262955,0,3,4
75151,4,3,262956,262956,262959,0,3,1
75152,4,3,262960,262960,262963,0,3,1
75153,4,2,262964,262964,262966,0,2,1
75154,3,2,262967,262967,262969,0,2,1
75155,5,2,262972,262972,262974,0,2,3
75156,2,2,262974,262974,262976,0,2,0
75157,6,2,262980,262980,262982,0,2,4
75158,3,3,262983,262983,262986,0,3,1
75159,3,1,262986,262986,262987,0,1,0
75160,2,3,262988,262988,262991,0,3,1
75161,2,3,262990,262991,262994,1,4,0
75162,5,1,262995,262995,262996,0,1,1
75163,3,2,262998,262998,263000,0,2,2
75164,6,2,263004,263004,263006,0,2,4
75165,3,2,263007,263007,263009,0,2,1
75166,1,2,263008,263009,263011,1,3,0
75167,2,1,263010,263011,263012,1,2,0
75168,4,1,263014,263014,263015,0,1,2
75169,5,1,263019,263019,263020,0,1,4
75170,6,3,263025,263025,263028,0,3,5
75171,6,1,263031,263031,263032,0,1,3
75172,3,3,263034,263034,263037,0,3,2
75173,4,1,263038,263038,263039,0,1,1
75174,2,3,263040,263040,263043,0,3,1
75175,5,3,263045,263045,263048,0,3,2
75176,6,2,263051,263051,263053,0,2,3
75177,6,3,263057,263057,263060,0,3,4
75178,5,1,263062,263062,263063,0,1,2
75179,3,2,263065,263065,263067,0,2,2
75180,1,3,263066,263067,263070,1,4,0
75181,3,1,263069,263070,263071,1,2,0
75182,4,1,263073,263073,263074,0,1,2
75183,6,1,263079,263079,263080,0,1,5
75184,1,2,263080,263080,263082,0,2,0
75185,4,2,263084,263084,263086,0,2,2
75186,5,1,263089,263089,263090,0,1,3
75187,6,2,263095,263095,263097,0,2,5
75188,5,3,263100,263100,263103,0,3,3
75189,4,2,263104,263104,263106,0,2,1
75190,1,3,263105,263106,263109,1,4,0
75191,3,2,263108,263109,263111,1,3,0
75192,6,3,263114,263114,263117,0,3,3
75193,2,1,263116,263117,263118,1,2,0
75194,4,3,263120,263120,263123,0,3,2
75195,6,3,263126,263126,263129,0,3,3
75196,3,1,263129,263129,263130,0,1,0
75197,6,2,263135,263135,263137,0,2,5
75198,2,2,263137,263137,263139,0,2,0
75199,3,3,263140,263140,263143,0,3,1
75200,5,1,263145,263145,263146,0,1,2
75201,5,1,263150,263150,263151,0,1,4
75202,3,2,263153,263153,263155,0,2,2
75203,6,1,263159,263159,263160,0,1,4
75204,2,3,263161,263161,263164,0,3,1
75205,6,1,263167,263167,263168,0,1,3
75206,2,3,263169,263169,263172,0,3,1
75207,2,3,263171,263172,263175,1,4,0
75208,1,3,263172,263175,263178,3,6,0
75209,4,3,263176,263178,263181,2,5,0
75210,2,1,263178,263181,263182,3,4,0
75211,1,3,263179,263182,263185,3,6,0
75212,6,3,263185,263185,263188,0,3,0
75213,6,1,263191,263191,263192,0,1,3
75214,1,2,263192,263192,263194,0,2,0
75215,1,3,263193,263194,263197,1,4,0
75216,1,1,263194,263197,263198,3,4,0
75217,4,3,263198,263198,263201,0,3,0
75218,5,3,263203,263203,263206,0,3,2
75219,6,2,263209,263209,263211,0,2,3
75220,3,2,263212,263212,263214,0,2,1
75221,5,1,263217,263217,263218,0,1,3
75222,1,3,263218,263218,263221,0,3,0
75223,2,1,263220,263221,263222,1,2,0
75224,5,3,263225,263225,263228,0,3,3
75225,1,1,263226,263228,263229,2,3,0
75226,3,1,263229,263229,263230,0,1,0
75227,1,3,263230,263230,263233,0,3,0
75228,4,2,263234,263234,263236,0,2,1
75229,5,1,263239,263239,263240,0,1,3
75230,2,3,263241,263241,263244,0,3,1
75231,2,1,263243,263244,263245,1,2,0
75232,2,1,263245,263245,263246,0,1,0
75233,5,2,263250,263250,263252,0,2,4
75234,2,3,263252,263252,263255,0,3,0
75235,2,1,263254,263255,263256,1,2,0
75236,4,3,263258,263258,263261,0,3,2
75237,2,1,263260,263261,263262,1,2,0
75238,1,2,263261,263262,263264,1,3,0
75239,2,2,263263,263264,263266,1,3,0
75240,3,3,263266,263266,263269,0,3,0
75241,5,1,263271,263271,263272,0,1,2
75242,6,3,263277,263277,263280,0,3,5
75243,2,1,263279,263280,263281,1,2,0
75244,3,3,263282,263282,263285,0,3,1
75245,4,2,263286,263286,263288,0,2,1
75246,6,2,263292,263292,263294,0,2,4
75247,1,2,263293,263294,263296,1,3,0
75248,3,2,263296,263296,263298,0,2,0
75249,4,2,263300,263300,263302,0,2,2
75250,3,1,263303,263303,263304,0,1,1
75251,5,1,263308,263308,263309,0,1,4
75252,4,1,263312,263312,263313,0,1,3
75253,6,3,263318,263318,263321,0,3,5
75254,4,1,263322,263322,263323,0,1,1
75255,1,2,263323,263323,263325,0,2,0
75256,5,2,263328,263328,263330,0,2,3
75257,3,1,263331,263331,263332,0,1,1
75258,2,3,263333,263333,263336,0,3,1
75259,4,3,263337,263337,263340,0,3,1
75260,3,3,263340,263340,263343,0,3,0
75261,4,3,263344,263344,263347,0,3,1
75262,1,2,263345,263347,263349,2,4,0
75263,3,3,263348,263349,263352,1,4,0
75264,2,3,263350,263352,263355,2,5,0
75265,5,2,263355,263355,263357,0,2,0
75266,4,1,263359,263359,263360,0,1,2
75267,2,3,263361,263361,263364,0,3,1
75268,2,1,263363,263364,263365,1,2,0
75269,5,1,263368,263368,263369,0,1,3
75270,5,2,263373,263373,263375,0,2,4
75271,4,2,263377,263377,263379,0,2,2
75272,4,1,263381,263381,263382,0,1,2
75273,4,3,263385,263385,263388,0,3,3
75274,2,2,263387,263388,263390,1,3,0
75275,2,3,263389,263390,263393,1,4,0
75276,3,3,263392,263393,263396,1,4,0
75277,3,1,263395,263396,263397,1,2,0
75278,6,1,263401,263401,263402,0,1,4
75279,1,3,263402,263402,263405,0,3,0
75280,1,3,263403,263405,263408,2,5,0
75281,2,1,263405,263408,263409,3,4,0
75282,3,3,263408,263409,263412,1,4,0
75283,6,3,263414,263414,263417,0,3,2
75284,2,2,263416,263417,263419,1,3,0
75285,2,1,263418,263419,263420,1,2,0
75286,1,2,263419,263420,263422,1,3,0
75287,1,3,263420,263422,263425,2,5,0
75288,6,3,263426,263426,263429,0,3,1
75289,4,3,263430,263430,263433,0,3,1
75290,2,1,263432,263433,263434,1,2,0
75291,6,3,263438,263438,263441,0,3,4
75292,4,3,263442,263442,263445,0,3,1
75293,1,1,263443,263445,263446,2,3,0
75294,3,2,263446,263446,263448,0,2,0
75295,1,3,263447,263448,263451,1,4,0
75296,1,2,263448,263451,263453,3,5,0
75297,5,3,263453,263453,263456,0,3,0
75298,6,2,263459,263459,263461,0,2,3
75299,4,1,263463,263463,263464,0,1,2
75300,1,3,263464,263464,263467,0,3,0
75301,3,1,263467,263467,263468,0,1,0
75302,2,2,263469,263469,263471,0,2,1
75303,1,2,263470,263471,263473,1,3,0
75304,1,2,263471,263473,263475,2,4,0
75305,1,1,263472,263475,263476,3,4,0
75306,6,3,263478,263478,263481,0,3,2
75307,1,3,263479,263481,263484,2,5,0
75308,5,3,263484,263484,263487,0,3,0
75309,6,3,263490,263490,263493,0,3,3
75310,4,2,263494,263494,263496,0,2,1
75311,4,3,263498,263498,263501,0,3,2
75312,2,2,263500,263501,263503,1,3,0
75313,5,2,263505,263505,263507,0,2,2
75314,2,3,263507,263507,263510,0,3,0
75315,3,2,263510,263510,263512,0,2,0
75316,3,1,263513,263513,263514,0,1,1
75317,5,3,263518,263518,263521,0,3,4
75318,5,3,263523,263523,263526,0,3,2
75319,5,3,263528,263528,263531,0,3,2
75320,2,1,263530,263531,263532,1,2,0
75321,1,3,263531,263532,263535,1,4,0
75322,2,1,263533,263535,263536,2,3,0
75323,4,2,263537,263537,263539,0,2,1
75324,2,1,263539,263539,263540,0,1,0
75325,4,1,263543,263543,263544,0,1,3
75326,4,2,263547,263547,263549,0,2,3
75327,4,2,263551,263551,263553,0,2,2
75328,1,3,263552,263553,263556,1,4,0
75329,2,1,263554,263556,263557,2,3,0
75330,6,2,263560,263560,263562,0,2,3
75331,5,1,263565,263565,263566,0,1,3
75332,5,1,263570,263570,263571,0,1,4
75333,6,3,263576,263576,263579,0,3,5
75334,6,2,263582,263582,263584,0,2,3
75335,1,2,263583,263584,263586,1,3,0
75336,5,2,263588,263588,263590,0,2,2
75337,2,1,263590,263590,263591,0,1,0
75338,4,2,263594,263594,263596,0,2,3
75339,6,2,263600,263600,263602,0,2,4
75340,3,1,263603,263603,263604,0,1,1
75341,4,3,263607,263607,263610,0,3,3
75342,6,1,263613,263613,263614,0,1,3
75343,1,2,263614,263614,263616,0,2,0
75344,2,2,263616,263616,263618,0,2,0
75345,1,2,263617,263618,263620,1,3,0
75346,5,1,263622,263622,263623,0,1,2
75347,5,2,263627,263627,263629,0,2,4
75348,3,3,263630,263630,263633,0,3,1
75349,5,3,263635,263635,263638,0,3,2
75350,3,1,263638,263638,263639,0,1,0
75351,4,3,263642,263642,263645,0,3,3
75352,2,3,263644,263645,263648,1,4,0
75353,6,2,263650,263650,263652,0,2,2
75354,2,3,263652,263652,263655,0,3,0
75355,1,2,263653,263655,263657,2,4,0
75356,3,2,263656,263657,263659,1,3,0
75357,4,3,263660,263660,263663,0,3,1
75358,2,1,263662,263663,263664,1,2,0
75359,4,1,263666,263666,263667,0,1,2
75360,5,1,263671,263671,263672,0,1,4
75361,2,1,263673,263673,263674,0,1,1
75362,3,3,263676,263676,263679,0,3,2
75363,3,1,263679,263679,263680,0,1,0
75364,4,1,263683,263683,263684,0,1,3
75365,6,2,263689,263689,263691,0,2,5
75366,1,3,263690,263691,263694,1,4,0
75367,4,3,263694,263694,263697,0,3,0
75368,1,2,263695,263697,263699,2,4,0
75369,5,3,263700,263700,263703,0,3,1
75370,6,3,263706,263706,263709,0,3,3
75371,3,1,263709,263709,263710,0,1,0
75372,5,2,263714,263714,263716,0,2,4
75373,3,3,263717,263717,263720,0,3,1
75374,4,3,263721,263721,263724,0,3,1
75375,3,2,263724,263724,263726,0,2,0
75376,2,2,263726,263726,263728,0,2,0
75377,5,2,263731,263731,263733,0,2,3
75378,5,3,263736,263736,263739,0,3,3
75379,2,3,263738,263739,263742,1,4,0
75380,6,1,263744,263744,263745,0,1,2
75381,3,1,263747,263747,263748,0,1,2
75382,5,1,263752,263752,263753,0,1,4
75383,5,3,263757,263757,263760,0,3,4
75384,3,1,263760,263760,263761,0,1,0
75385,6,3,263766,263766,263769,0,3,5
75386,6,2,263772,263772,263774,0,2,3
75387,5,2,263777,263777,263779,0,2,3
75388,4,2,263781,263781,263783,0,2,2
75389,2,1,263783,263783,263784,0,1,0
75390,5,1,263788,263788,263789,0,1,4
75391,2,3,263790,263790,263793,0,3,1
75392,3,3,263793,263793,263796,0,3,0
75393,1,2,263794,263796,263798,2,4,0
75394,3,2,263797,263798,263800,1,3,0
75395,2,2,263799,263800,263802,1,3,0
75396,6,1,263805,263805,263806,0,1,3
75397,3,3,263808,263808,263811,0,3,2
75398,2,1,263810,263811,263812,1,2,0
75399,6,3,263816,263816,263819,0,3,4
75400,1,3,263817,263819,263822,2,5,0
75401,4,2,263821,263822,263824,1,3,0
75402,6,3,263827,263827,263830,0,3,3
75403,1,3,263828,263830,263833,2,5,0
75404,5,2,263833,263833,263835,0,2,0
75405,2,1,263835,263835,263836,0,1,0
75406,6,3,263841,263841,263844,0,3,5
75407,5,3,263846,263846,263849,0,3,2
75408,6,3,263852,263852,263855,0,3,3
75409,4,1,263856,263856,263857,0,1,1
75410,1,1,263857,263857,263858,0,1,0
75411,1,1,263858,263858,263859,0,1,0
75412,5,1,263863,263863,263864,0,1,4
75413,4,1,263867,263867,263868,0,1,3
75414,4,1,263871,263871,263872,0,1,3
75415,2,1,263873,263873,263874,0,1,1
75416,3,2,263876,263876,263878,0,2,2
75417,5,3,263881,263881,263884,0,3,3
75418,6,3,263887,263887,263890,0,3,3
75419,4,3,263891,263891,263894,0,3,1
75420,6,1,263897,263897,263898,0,1,3
75421,1,3,263898,263898,263901,0,3,0
75422,6,1,263904,263904,263905,0,1,3
75423,4,2,263908,263908,263910,0,2,3
75424,6,2,263914,263914,263916,0,2,4
75425,3,2,263917,263917,263919,0,2,1
75426,3,1,263920,263920,263921,0,1,1
75427,4,1,263924,263924,263925,0,1,3
75428,4,3,263928,263928,263931,0,3,3
75429,4,2,263932,263932,263934,0,2,1
75430,3,2,263935,263935,263937,0,2,1
75431,2,2,263937,263937,263939,0,2,0
75432,4,1,263941,263941,263942,0,1,2
75433,1,1,263942,263942,263943,0,1,0
75434,3,3,263945,263945,263948,0,3,2
75435,3,1,263948,263948,263949,0,1,0
75436,6,1,263954,263954,263955,0,1,5
75437,6,2,263960,263960,263962,0,2,5
75438,4,1,263964,263964,263965,0,1,2
75439,4,3,263968,263968,263971,0,3,3
75440,5,3,263973,263973,263976,0,3,2
75441,1,1,263974,263976,263977,2,3,0
75442,3,2,263977,263977,263979,0,2,0
75443,6,3,263983,263983,263986,0,3,4
75444,4,2,263987,263987,263989,0,2,1
75445,5,1,263992,263992,263993,0,1,3
75446,2,2,263994,263994,263996,0,2,1
75447,1,1,263995,263996,263997,1,2,0
75448,6,2,264001,264001,264003,0,2,4
75449,1,1,264002,264003,264004,1,2,0
75450,1,2,264003,264004,264006,1,3,0
75451,4,3,264007,264007,264010,0,3,1
75452,1,1,264008,264010,264011,2,3,0
75453,1,1,264009,264011,264012,2,3,0
75454,4,2,264013,264013,264015,0,2,1
75455,2,3,264015,264015,264018,0,3,0
75456,2,2,264017,264018,264020,1,3,0
75457,4,3,264021,264021,264024,0,3,1
75458,1,3,264022,264024,264027,2,5,0
75459,3,1,264025,264027,264028,2,3,0
75460,5,3,264030,264030,264033,0,3,2
75461,6,1,264036,264036,264037,0,1,3
75462,1,2,264037,264037,264039,0,2,0
75463,5,1,264042,264042,264043,0,1,3
75464,2,1,264044,264044,264045,0,1,1
75465,4,3,264048,264048,264051,0,3,3
75466,2,2,264050,264051,264053,1,3,0
75467,5,3,264055,264055,264058,0,3,2
75468,6,3,264061,264061,264064,0,3,3
75469,4,3,264065,264065,264068,0,3,1
75470,5,1,264070,264070,264071,0,1,2
75471,2,1,264072,264072,264073,0,1,1
75472,5,3,264077,264077,264080,0,3,4
75473,5,1,264082,264082,264083,0,1,2
75474,5,3,264087,264087,264090,0,3,4
75475,4,1,264091,264091,264092,0,1,1
75476,6,2,264097,264097,264099,0,2,5
75477,1,3,264098,264099,264102,1,4,0
75478,6,1,264104,264104,264105,0,1,2
75479,1,3,264105,264105,264108,0,3,0
75480,1,1,264106,264108,264109,2,3,0
75481,6,1,264112,264112,264113,0,1,3
75482,3,3,264115,264115,264118,0,3,2
75483,2,3,264117,264118,264121,1,4,0
75484,3,2,264120,264121,264123,1,3,0
75485,1,2,264121,264123,264125,2,4,0
75486,4,2,264125,264125,264127,0,2,0
75487,2,2,264127,264127,264129,0,2,0
75488,4,3,264131,264131,264134,0,3,2
75489,3,2,264134,264134,264136,0,2,0
75490,6,2,264140,264140,264142,0,2,4
75491,3,2,264143,264143,264145,0,2,1
75492,6,2,264149,264149,264151,0,2,4
75493,2,2,264151,264151,264153,0,2,0
75494,5,3,264156,264156,264159,0,3,3
75495,1,2,264157,264159,264161,2,4,0
75496,1,2,264158,264161,264163,3,5,0
75497,2,1,264160,264163,264164,3,4,0
75498,3,1,264163,264164,264165,1,2,0
75499,5,2,264168,264168,264170,0,2,3
75500,2,1,264170,264170,264171,0,1,0
75501,3,1,264173,264173,264174,0,1,2
75502,6,1,264179,264179,264180,0,1,5
75503,5,3,264184,264184,264187,0,3,4
75504,1,2,264185,264187,264189,2,4,0
75505,6,2,264191,264191,264193,0,2,2
75506,6,2,264197,264197,264199,0,2,4
75507,6,3,264203,264203,264206,0,3,4
75508,2,1,264205,264206,264207,1,2,0
75509,4,3,264209,264209,264212,0,3,2
75510,6,3,264215,264215,264218,0,3,3
75511,3,3,264218,264218,264221,0,3,0
75512,2,1,264220,264221,264222,1,2,0
75513,3,1,264223,264223,264224,0,1,1
75514,2,2,264225,264225,264227,0,2,1
75515,3,1,264228,264228,264229,0,1,1
75516,2,3,264230,264230,264233,0,3,1
75517,2,1,264232,264233,264234,1,2,0
75518,4,1,264236,264236,264237,0,1,2
75519,6,2,264242,264242,264244,0,2,5
75520,3,3,264245,264245,264248,0,3,1
75521,3,2,264248,264248,264250,0,2,0
75522,6,1,264254,264254,264255,0,1,4
75523,4,2,264258,264258,264260,0,2,3
75524,6,3,264264,264264,264267,0,3,4
75525,1,2,264265,264267,264269,2,4,0
75526,3,1,264268,264269,264270,1,2,0
75527,3,1,264271,264271,264272,0,1,1
75528,4,1,264275,264275,264276,0,1,3
75529,1,2,264276,264276,264278,0,2,0
75530,5,1,264281,264281,264282,0,1,3
75531,5,1,264286,264286,264287,0,1,4
75532,3,1,264289,264289,264290,0,1,2
75533,2,1,264291,264291,264292,0,1,1
75534,2,1,264293,264293,264294,0,1,1
75535,1,3,264294,264294,264297,0,3,0
75536,2,2,264296,264297,264299,1,3,0
75537,1,3,264297,264299,264302,2,5,0
75538,4,2,264301,264302,264304,1,3,0
75539,5,2,264306,264306,264308,0,2,2
75540,3,1,264309,264309,264310,0,1,1
75541,1,1,264310,264310,264311,0,1,0
75542,3,1,264313,264313,264314,0,1,2
75543,5,3,264318,264318,264321,0,3,4
75544,1,2,264319,264321,264323,2,4,0
75545,5,1,264324,264324,264325,0,1,1
75546,5,3,264329,264329,264332,0,3,4
75547,1,1,264330,264332,264333,2,3,0
75548,4,2,264334,264334,264336,0,2,1
75549,3,3,264337,264337,264340,0,3,1
75550,4,1,264341,264341,264342,0,1,1
75551,3,2,264344,264344,264346,0,2,2
75552,6,3,264350,264350,264353,0,3,4
75553,2,1,264352,264353,264354,1,2,0
75554,5,3,264357,264357,264360,0,3,3
75555,4,1,264361,264361,264362,0,1,1
75556,2,3,264363,264363,264366,0,3,1
75557,1,1,264364,264366,264367,2,3,0
75558,4,1,264368,264368,264369,0,1,1
75559,1,2,264369,264369,264371,0,2,0
75560,3,3,264372,264372,264375,0,3,1
75561,3,3,264375,264375,264378,0,3,0
75562,2,3,264377,264378,264381,1,4,0
75563,3,1,264380,264381,264382,1,2,0
75564,2,2,264382,264382,264384,0,2,0
75565,2,1,264384,264384,264385,0,1,0
75566,5,2,264389,264389,264391,0,2,4
75567,6,1,264395,264395,264396,0,1,4
75568,1,1,264396,264396,264397,0,1,0
75569,3,2,264399,264399,264401,0,2,2
75570,4,1,264403,264403,264404,0,1,2
75571,5,3,264408,264408,264411,0,3,4
75572,3,2,264411,264411,264413,0,2,0
75573,3,1,264414,264414,264415,0,1,1
75574,5,3,264419,264419,264422,0,3,4
75575,3,1,264422,264422,264423,0,1,0
75576,6,3,264428,264428,264431,0,3,5
75577,2,2,264430,264431,264433,1,3,0
75578,1,3,264431,264433,264436,2,5,0
75579,4,2,264435,264436,264438,1,3,0
75580,4,1,264439,264439,264440,0,1,1
75581,5,2,264444,264444,264446,0,2,4
75582,4,2,264448,264448,264450,0,2,2
75583,2,1,264450,264450,264451,0,1,0
75584,5,3,264455,264455,264458,0,3,4
75585,6,2,264461,264461,264463,0,2,3
75586,3,1,264464,264464,264465,0,1,1
75587,5,3,264469,264469,264472,0,3,4
75588,5,3,264474,264474,264477,0,3,2
75589,1,2,264475,264477,264479,2,4,0
75590,6,3,264481,264481,264484,0,3,2
75591,1,2,264482,264484,264486,2,4,0
75592,3,1,264485,264486,264487,1,2,0
75593,4,1,264489,264489,264490,0,1,2
75594,6,1,264495,264495,264496,0,1,5
75595,3,2,264498,264498,264500,0,2,2
75596,3,3,264501,264501,264504,0,3,1
75597,1,1,264502,264504,264505,2,3,0
75598,4,3,264506,264506,264509,0,3,1
75599,4,3,264510,264510,264513,0,3,1
75600,1,3,264511,264513,264516,2,5,0
75601,2,3,264513,264516,264519,3,6,0
75602,3,2,264516,264519,264521,3,5,0
75603,1,1,264517,264521,264522,4,5,0
75604,4,3,264521,264522,264525,1,4,0
75605,5,3,264526,264526,264529,0,3,1
75606,5,3,264531,264531,264534,0,3,2
75607,2,3,264533,264534,264537,1,4,0
75608,6,3,264539,264539,264542,0,3,2
75609,2,3,264541,264542,264545,1,4,0
75610,2,2,264543,264545,264547,2,4,0
75611,5,1,264548,264548,264549,0,1,1
75612,5,3,264553,264553,264556,0,3,4
75613,2,1,264555,264556,264557,1,2,0
75614,4,1,264559,264559,264560,0,1,2
75615,1,3,264560,264560,264563,0,3,0
75616,6,3,264566,264566,264569,0,3,3
75617,3,2,264569,264569,264571,0,2,0
75618,2,3,264571,264571,264574,0,3,0
75619,6,1,264577,264577,264578,0,1,3
75620,2,1,264579,264579,264580,0,1,1
75621,2,3,264581,264581,264584,0,3,1
75622,2,1,264583,264584,264585,1,2,0
75623,6,2,264589,264589,264591,0,2,4
75624,2,1,264591,264591,264592,0,1,0
75625,1,2,264592,264592,264594,0,2,0
75626,6,1,264598,264598,264599,0,1,4
75627,5,1,264603,264603,264604,0,1,4
75628,1,1,264604,264604,264605,0,1,0
75629,3,2,264607,264607,264609,0,2,2
75630,3,2,264610,264610,264612,0,2,1
75631,5,3,264615,264615,264618,0,3,3
75632,5,1,264620,264620,264621,0,1,2
75633,4,3,264624,264624,264627,0,3,3
75634,4,2,264628,264628,264630,0,2,1
75635,6,3,264634,264634,264637,0,3,4
75636,5,3,264639,264639,264642,0,3,2
75637,5,2,264644,264644,264646,0,2,2
75638,1,2,264645,264646,264648,1,3,0
75639,1,2,264646,264648,264650,2,4,0
75640,3,3,264649,264650,264653,1,4,0
75641,2,1,264651,264653,264654,2,3,0
75642,3,3,264654,264654,264657,0,3,0
75643,5,1,264659,264659,264660,0,1,2
75644,5,1,264664,264664,264665,0,1,4
75645,6,2,264670,264670,264672,0,2,5
75646,3,2,264673,264673,264675,0,2,1
75647,2,2,264675,264675,264677,0,2,0
75648,5,3,264680,264680,264683,0,3,3
75649,5,3,264685,264685,264688,0,3,2
75650,5,3,264690,264690,264693,0,3,2
75651,1,1,264691,264693,264694,2,3,0
75652,6,3,264697,264697,264700,0,3,3
75653,6,2,264703,264703,264705,0,2,3
75654,5,2,264708,264708,264710,0,2,3
75655,4,2,264712,264712,264714,0,2,2
75656,5,2,264717,264717,264719,0,2,3
75657,5,3,264722,264722,264725,0,3,3
75658,3,3,264725,264725,264728,0,3,0
75659,1,2,264726,264728,264730,2,4,0
75660,5,3,264731,264731,264734,0,3,1
75661,1,2,264732,264734,264736,2,4,0
75662,2,3,264734,264736,264739,2,5,0
75663,4,2,264738,264739,264741,1,3,0
75664,4,2,264742,264742,264744,0,2,1
75665,6,1,264748,264748,264749,0,1,4
75666,5,1,264753,264753,264754,0,1,4
75667,4,2,264757,264757,264759,0,2,3
75668,3,1,264760,264760,264761,0,1,1
75669,6,3,264766,264766,264769,0,3,5
75670,6,2,264772,264772,264774,0,2,3
75671,1,1,264773,264774,264775,1,2,0
75672,4,2,264777,264777,264779,0,2,2
75673,1,2,264778,264779,264781,1,3,0
75674,3,2,264781,264781,264783,0,2,0
75675,1,2,264782,264783,264785,1,3,0
75676,6,3,264788,264788,264791,0,3,3
75677,2,2,264790,264791,264793,1,3,0
75678,6,3,264796,264796,264799,0,3,3
75679,2,1,264798,264799,264800,1,2,0
75680,4,2,264802,264802,264804,0,2,2
75681,2,2,264804,264804,264806,0,2,0
75682,2,1,264806,264806,264807,0,1,0
75683,4,1,264810,264810,264811,0,1,3
75684,6,2,264816,264816,264818,0,2,5
75685,1,1,264817,264818,264819,1,2,0
75686,5,1,264822,264822,264823,0,1,3
75687,5,3,264827,264827,264830,0,3,4
75688,2,1,264829,264830,264831,1,2,0
75689,1,1,264830,264831,264832,1,2,0
75690,5,2,264835,264835,264837,0,2,3
75691,6,2,264841,264841,264843,0,2,4
75692,5,2,264846,264846,264848,0,2,3
75693,3,2,264849,264849,264851,0,2,1
75694,6,3,264855,264855,264858,0,3,4
75695,1,3,264856,264858,264861,2,5,0
75696,6,1,264862,264862,264863,0,1,1
75697,4,2,264866,264866,264868,0,2,3
75698,4,2,264870,264870,264872,0,2,2
75699,1,3,264871,264872,264875,1,4,0
75700,2,1,264873,264875,264876,2,3,0
75701,5,3,264878,264878,264881,0,3,2
75702,3,1,264881,264881,264882,0,1,0
75703,5,1,264886,264886,264887,0,1,4
75704,2,2,264888,264888,264890,0,2,1
75705,4,1,264892,264892,264893,0,1,2
75706,5,3,264897,264897,264900,0,3,4
75707,4,1,264901,264901,264902,0,1,1
75708,6,3,264907,264907,264910,0,3,5
75709,4,1,264911,264911,264912,0,1,1
75710,4,1,264915,264915,264916,0,1,3
75711,1,2,264916,264916,264918,0,2,0
75712,3,2,264919,264919,264921,0,2,1
75713,5,1,264924,264924,264925,0,1,3
75714,6,3,264930,264930,264933,0,3,5
75715,2,1,264932,264933,264934,1,2,0
75716,3,2,264935,264935,264937,0,2,1
75717,4,1,264939,264939,264940,0,1,2
75718,5,3,264944,264944,264947,0,3,4
75719,1,1,264945,264947,264948,2,3,0
75720,5,3,264950,264950,264953,0,3,2
75721,3,1,264953,264953,264954,0,1,0
75722,6,3,264959,264959,264962,0,3,5
75723,6,3,264965,264965,264968,0,3,3
75724,5,3,264970,264970,264973,0,3,2
75725,5,1,264975,264975,264976,0,1,2
75726,2,2,264977,264977,264979,0,2,1
75727,1,3,264978,264979,264982,1,4,0
75728,4,3,264982,264982,264985,0,3,0
75729,6,3,264988,264988,264991,0,3,3
75730,4,3,264992,264992,264995,0,3,1
75731,1,3,264993,264995,264998,2,5,0
75732,5,3,264998,264998,265001,0,3,0
75733,4,3,265002,265002,265005,0,3,1
75734,3,1,265005,265005,265006,0,1,0
75735,6,1,265011,265011,265012,0,1,5
75736,2,1,265013,265013,265014,0,1,1
75737,4,3,265017,265017,265020,0,3,3
75738,1,1,265018,265020,265021,2,3,0
75739,2,3,265020,265021,265024,1,4,0
75740,2,3,265022,265024,265027,2,5,0
75741,1,2,265023,265027,265029,4,6,0
75742,1,3,265024,265029,265032,5,8,0
75743,2,1,265026,265032,265033,6,7,0
75744,2,2,265028,265033,265035,5,7,0
75745,3,3,265031,265035,265038,4,7,0
75746,6,3,265037,265038,265041,1,4,0
75747,4,2,265041,265041,265043,0,2,0
75748,1,3,265042,265043,265046,1,4,0
75749,3,2,265045,265046,265048,1,3,0
75750,2,2,265047,265048,265050,1,3,0
75751,1,2,265048,265050,265052,2,4,0
75752,1,2,265049,265052,265054,3,5,0
75753,2,3,265051,265054,265057,3,6,0
75754,2,3,265053,265057,265060,4,7,0
75755,1,2,265054,265060,265062,6,8,0
75756,6,3,265060,265062,265065,2,5,0
75757,6,1,265066,265066,265067,0,1,1
75758,1,2,265067,265067,265069,0,2,0
75759,2,1,265069,265069,265070,0,1,0
75760,2,1,265071,265071,265072,0,1,1
75761,5,2,265076,265076,265078,0,2,4
75762,4,2,265080,265080,265082,0,2,2
75763,5,3,265085,265085,265088,0,3,3
75764,5,1,265090,265090,265091,0,1,2
75765,4,2,265094,265094,265096,0,2,3
75766,1,1,265095,265096,265097,1,2,0
75767,5,2,265100,265100,265102,0,2,3
75768,2,1,265102,265102,265103,0,1,0
75769,1,2,265103,265103,265105,0,2,0
75770,5,3,265108,265108,265111,0,3,3
75771,3,2,265111,265111,265113,0,2,0
75772,3,1,265114,265114,265115,0,1,1
75773,6,1,265120,265120,265121,0,1,5
75774,1,2,265121,265121,265123,0,2,0
75775,6,3,265127,265127,265130,0,3,4
75776,4,2,265131,265131,265133,0,2,1
75777,4,1,265135,265135,265136,0,1,2
75778,4,2,265139,265139,265141,0,2,3
75779,6,3,265145,265145,265148,0,3,4
75780,6,1,265151,265151,265152,0,1,3
75781,6,3,265157,265157,265160,0,3,5
75782,3,2,265160,265160,265162,0,2,0
75783,5,1,265165,265165,265166,0,1,3
75784,6,3,265171,265171,265174,0,3,5
75785,5,3,265176,265176,265179,0,3,2
75786,5,2,265181,265181,265183,0,2,2
75787,2,3,265183,265183,265186,0,3,0
75788,5,2,265188,265188,265190,0,2,2
75789,4,2,265192,265192,265194,0,2,2
75790,6,1,265198,265198,265199,0,1,4
75791,5,1,265203,265203,265204,0,1,4
75792,2,1,265205,265205,265206,0,1,1
75793,1,3,265206,265206,265209,0,3,0
75794,4,2,265210,265210,265212,0,2,1
75795,1,2,265211,265212,265214,1,3,0
75796,6,3,265217,265217,265220,0,3,3
75797,6,1,265223,265223,265224,0,1,3
75798,6,1,265229,265229,265230,0,1,5
75799,5,3,265234,265234,265237,0,3,4
75800,1,1,265235,265237,265238,2,3,0
75801,2,3,265237,265238,265241,1,4,0
75802,4,2,265241,265241,265243,0,2,0
75803,1,3,265242,265243,265246,1,4,0
75804,5,2,265247,265247,265249,0,2,1
75805,4,2,265251,265251,265253,0,2,2
75806,2,3,265253,265253,265256,0,3,0
75807,1,2,265254,265256,265258,2,4,0
75808,6,1,265260,265260,265261,0,1,2
75809,6,3,265266,265266,265269,0,3,5
75810,6,3,265272,265272,265275,0,3,3
75811,3,2,265275,265275,265277,0,2,0
75812,2,3,265277,265277,265280,0,3,0
75813,3,1,265280,265280,265281,0,1,0
75814,1,1,265281,265281,265282,0,1,0
75815,1,2,265282,265282,265284,0,2,0
75816,6,3,265288,265288,265291,0,3,4
75817,1,1,265289,265291,265292,2,3,0
75818,3,2,265292,265292,265294,0,2,0
75819,4,2,265296,265296,265298,0,2,2
75820,5,3,265301,265301,265304,0,3,3
75821,6,2,265307,265307,265309,0,2,3
75822,5,1,265312,265312,265313,0,1,3
75823,4,1,265316,265316,265317,0,1,3
75824,3,1,265319,265319,265320,0,1,2
75825,4,2,265323,265323,265325,0,2,3
75826,6,3,265329,265329,265332,0,3,4
75827,3,1,265332,265332,265333,0,1,0
75828,1,2,265333,265333,265335,0,2,0
75829,6,2,265339,265339,265341,0,2,4
75830,5,2,265344,265344,265346,0,2,3
75831,6,3,265350,265350,265353,0,3,4
75832,1,1,265351,265353,265354,2,3,0
75833,6,3,265357,265357,265360,0,3,3
75834,1,3,265358,265360,265363,2,5,0
75835,2,1,265360,265363,265364,3,4,0
75836,4,3,265364,265364,265367,0,3,0
75837,5,3,265369,265369,265372,0,3,2
75838,5,2,265374,265374,265376,0,2,2
75839,5,2,265379,265379,265381,0,2,3
75840,6,3,265385,265385,265388,0,3,4
75841,1,3,265386,265388,265391,2,5,0
75842,2,3,265388,265391,265394,3,6,0
75843,2,1,265390,265394,265395,4,5,0
75844,2,3,265392,265395,265398,3,6,0
75845,2,2,265394,265398,265400,4,6,0
75846,4,2,265398,265400,265402,2,4,0
75847,6,2,265404,265404,265406,0,2,2
75848,2,3,265406,265406,265409,0,3,0
75849,4,2,265410,265410,265412,0,2,1
75850,1,1,265411,265412,265413,1,2,0
75851,5,1,265416,265416,265417,0,1,3
75852,6,1,265422,265422,265423,0,1,5
75853,3,1,265425,265425,265426,0,1,2
75854,1,3,265426,265426,265429,0,3,0
75855,5,1,265431,265431,265432,0,1,2
75856,5,2,265436,265436,265438,0,2,4
75857,6,1,265442,265442,265443,0,1,4
75858,2,3,265444,265444,265447,0,3,1
75859,3,1,265447,265447,265448,0,1,0
75860,1,3,265448,265448,265451,0,3,0
75861,5,1,265453,265453,265454,0,1,2
75862,2,2,265455,265455,265457,0,2,1
75863,1,2,265456,265457,265459,1,3,0
75864,2,3,265458,265459,265462,1,4,0
75865,6,3,265464,265464,265467,0,3,2
75866,1,3,265465,265467,265470,2,5,0
75867,5,3,265470,265470,265473,0,3,0
75868,3,2,265473,265473,265475,0,2,0
75869,6,1,265479,265479,265480,0,1,4
75870,2,3,265481,265481,265484,0,3,1
75871,5,3,265486,265486,265489,0,3,2
75872,6,2,265492,265492,265494,0,2,3
75873,5,2,265497,265497,265499,0,2,3
75874,4,2,265501,265501,265503,0,2,2
75875,1,1,265502,265503,265504,1,2,0
75876,4,3,265506,265506,265509,0,3,2
75877,1,3,265507,265509,265512,2,5,0
75878,6,3,265513,265513,265516,0,3,1
75879,3,1,265516,265516,265517,0,1,0
75880,6,3,265522,265522,265525,0,3,5
75881,4,3,265526,265526,265529,0,3,1
75882,4,2,265530,265530,265532,0,2,1
75883,1,1,265531,265532,265533,1,2,0
75884,3,3,265534,265534,265537,0,3,1
75885,2,1,265536,265537,265538,1,2,0
75886,2,2,265538,265538,265540,0,2,0
75887,4,3,265542,265542,265545,0,3,2
75888,2,3,265544,265545,265548,1,4,0
75889,3,1,265547,265548,265549,1,2,0
75890,6,1,265553,265553,265554,0,1,4
75891,4,3,265557,265557,265560,0,3,3
75892,5,1,265562,265562,265563,0,1,2
75893,5,3,265567,265567,265570,0,3,4
75894,1,2,265568,265570,265572,2,4,0
75895,3,3,265571,265572,265575,1,4,0
75896,2,2,265573,265575,265577,2,4,0
75897,5,2,265578,265578,265580,0,2,1
75898,4,1,265582,265582,265583,0,1,2
75899,2,2,265584,265584,265586,0,2,1
75900,4,2,265588,265588,265590,0,2,2
75901,2,1,265590,265590,265591,0,1,0
75902,3,1,265593,265593,265594,0,1,2
75903,3,1,265596,265596,265597,0,1,2
75904,6,2,265602,265602,265604,0,2,5
75905,4,3,265606,265606,265609,0,3,2
75906,6,2,265612,265612,265614,0,2,3
75907,5,2,265617,265617,265619,0,2,3
75908,5,2,265622,265622,265624,0,2,3
75909,5,1,265627,265627,265628,0,1,3
75910,4,3,265631,265631,265634,0,3,3
75911,3,3,265634,265634,265637,0,3,0
75912,6,3,265640,265640,265643,0,3,3
75913,2,2,265642,265643,265645,1,3,0
75914,2,2,265644,265645,265647,1,3,0
75915,3,2,265647,265647,265649,0,2,0
75916,3,2,265650,265650,265652,0,2,1
75917,2,2,265652,265652,265654,0,2,0
75918,6,2,265658,265658,265660,0,2,4
75919,4,3,265662,265662,265665,0,3,2
75920,1,1,265663,265665,265666,2,3,0
75921,6,3,265669,265669,265672,0,3,3
75922,3,3,265672,265672,265675,0,3,0
75923,2,2,265674,265675,265677,1,3,0
75924,1,2,265675,265677,265679,2,4,0
75925,1,3,265676,265679,265682,3,6,0
75926,5,2,265681,265682,265684,1,3,0
75927,3,2,265684,265684,265686,0,2,0
75928,2,1,265686,265686,265687,0,1,0
75929,6,3,265692,265692,265695,0,3,5
75930,6,3,265698,265698,265701,0,3,3
75931,5,1,265703,265703,265704,0,1,2
75932,5,3,265708,265708,265711,0,3,4
75933,1,3,265709,265711,265714,2,5,0
75934,3,1,265712,265714,265715,2,3,0
75935,6,1,265718,265718,265719,0,1,3
75936,5,1,265723,265723,265724,0,1,4
75937,3,2,265726,265726,265728,0,2,2
75938,4,3,265730,265730,265733,0,3,2
75939,2,1,265732,265733,265734,1,2,0
75940,5,1,265737,265737,265738,0,1,3
75941,3,1,265740,265740,265741,0,1,2
75942,6,2,265746,265746,265748,0,2,5
75943,3,2,265749,265749,265751,0,2,1
75944,6,2,265755,265755,265757,0,2,4
75945,6,1,265761,265761,265762,0,1,4
75946,1,3,265762,265762,265765,0,3,0
75947,3,3,265765,265765,265768,0,3,0
75948,4,2,265769,265769,265771,0,2,1
75949,5,3,265774,265774,265777,0,3,3
75950,2,1,265776,265777,265778,1,2,0
75951,3,3,265779,265779,265782,0,3,1
75952,3,1,265782,265782,265783,0,1,0
75953,1,2,265783,265783,265785,0,2,0
75954,3,3,265786,265786,265789,0,3,1
75955,2,2,265788,265789,265791,1,3,0
75956,4,3,265792,265792,265795,0,3,1
75957,3,2,265795,265795,265797,0,2,0
75958,2,3,265797,265797,265800,0,3,0
75959,4,2,265801,265801,265803,0,2,1
75960,2,3,265803,265803,265806,0,3,0
75961,2,1,265805,265806,265807,1,2,0
75962,1,3,265806,265807,265810,1,4,0
75963,5,1,265811,265811,265812,0,1,1
75964,4,1,265815,265815,265816,0,1,3
75965,4,2,265819,265819,265821,0,2,3
75966,4,2,265823,265823,265825,0,2,2
75967,4,3,265827,265827,265830,0,3,2
75968,4,1,265831,265831,265832,0,1,1
75969,1,1,265832,265832,265833,0,1,0
75970,3,2,265835,265835,265837,0,2,2
75971,6,2,265841,265841,265843,0,2,4
75972,5,3,265846,265846,265849,0,3,3
75973,6,1,265852,265852,265853,0,1,3
75974,5,2,265857,265857,265859,0,2,4
75975,4,3,265861,265861,265864,0,3,2
75976,2,3,265863,265864,265867,1,4,0
75977,6,3,265869,265869,265872,0,3,2
75978,2,2,265871,265872,265874,1,3,0
75979,1,2,265872,265874,265876,2,4,0
75980,6,1,265878,265878,265879,0,1,2
75981,1,3,265879,265879,265882,0,3,0
75982,2,2,265881,265882,265884,1,3,0
75983,1,2,265882,265884,265886,2,4,0
75984,4,2,265886,265886,265888,0,2,0
75985,4,2,265890,265890,265892,0,2,2
75986,2,1,265892,265892,265893,0,1,0
75987,1,3,265893,265893,265896,0,3,0
75988,6,3,265899,265899,265902,0,3,3
75989,5,1,265904,265904,265905,0,1,2
75990,5,3,265909,265909,265912,0,3,4
75991,2,1,265911,265912,265913,1,2,0
75992,2,2,265913,265913,265915,0,2,0
75993,1,1,265914,265915,265916,1,2,0
75994,5,2,265919,265919,265921,0,2,3
75995,6,1,265925,265925,265926,0,1,4
75996,1,3,265926,265926,265929,0,3,0
75997,5,3,265931,265931,265934,0,3,2
75998,3,2,265934,265934,265936,0,2,0
75999,1,2,265935,265936,265938,1,3,0
76000,5,1,265940,265940,265941,0,1,2
76001,3,3,265943,265943,265946,0,3,2
76002,5,3,265948,265948,265951,0,3,2
76003,5,1,265953,265953,265954,0,1,2
76004,1,2,265954,265954,265956,0,2,0
76005,1,2,265955,265956,265958,1,3,0
76006,4,2,265959,265959,265961,0,2,1
76007,5,2,265964,265964,265966,0,2,3
76008,6,2,265970,265970,265972,0,2,4
76009,4,3,265974,265974,265977,0,3,2
76010,6,3,265980,265980,265983,0,3,3
76011,5,1,265985,265985,265986,0,1,2
76012,5,3,265990,265990,265993,0,3,4
76013,1,3,265991,265993,265996,2,5,0
76014,4,3,265995,265996,265999,1,4,0
76015,2,3,265997,265999,266002,2,5,0
76016,6,2,266003,266003,266005,0,2,1
76017,3,1,266006,266006,266007,0,1,1
76018,3,1,266009,266009,266010,0,1,2
76019,1,2,266010,266010,266012,0,2,0
76020,1,2,266011,266012,266014,1,3,0
76021,2,3,266013,266014,266017,1,4,0
76022,1,1,266014,266017,266018,3,4,0
76023,6,1,266020,266020,266021,0,1,2
76024,2,2,266022,266022,266024,0,2,1
76025,4,2,266026,266026,266028,0,2,2
76026,1,3,266027,266028,266031,1,4,0
76027,4,2,266031,266031,266033,0,2,0
76028,3,1,266034,266034,266035,0,1,1
76029,5,2,266039,266039,266041,0,2,4
76030,4,1,266043,266043,266044,0,1,2
76031,6,1,266049,266049,266050,0,1,5
76032,6,3,266055,266055,266058,0,3,5
76033,6,1,266061,266061,266062,0,1,3
76034,3,2,266064,266064,266066,0,2,2
76035,2,3,266066,266066,266069,0,3,0
76036,1,2,266067,266069,266071,2,4,0
76037,4,3,266071,266071,266074,0,3,0
76038,6,2,266077,266077,266079,0,2,3
76039,1,2,266078,266079,266081,1,3,0
76040,5,3,266083,266083,266086,0,3,2
76041,5,1,266088,266088,266089,0,1,2
76042,6,2,266094,266094,266096,0,2,5
76043,6,1,266100,266100,266101,0,1,4
76044,6,2,266106,266106,266108,0,2,5
76045,1,3,266107,266108,266111,1,4,0
76046,5,3,266112,266112,266115,0,3,1
76047,4,1,266116,266116,266117,0,1,1
76048,5,1,266121,266121,266122,0,1,4
76049,5,1,266126,266126,266127,0,1,4
76050,4,2,266130,266130,266132,0,2,3
76051,5,1,266135,266135,266136,0,1,3
76052,6,3,266141,266141,266144,0,3,5
76053,2,1,266143,266144,266145,1,2,0
76054,5,2,266148,266148,266150,0,2,3
76055,2,1,266150,266150,266151,0,1,0
76056,2,1,266152,266152,266153,0,1,1
76057,1,3,266153,266153,266156,0,3,0
76058,5,2,266158,266158,266160,0,2,2
76059,6,2,266164,266164,266166,0,2,4
76060,2,1,266166,266166,266167,0,1,0
76061,5,2,266171,266171,266173,0,2,4
76062,1,3,266172,266173,266176,1,4,0
76063,5,2,266177,266177,266179,0,2,1
76064,2,3,266179,266179,266182,0,3,0
76065,5,2,266184,266184,266186,0,2,2
76066,5,2,266189,266189,266191,0,2,3
76067,3,2,266192,266192,266194,0,2,1
76068,4,3,266196,266196,266199,0,3,2
76069,5,3,266201,266201,266204,0,3,2
76070,5,1,266206,266206,266207,0,1,2
76071,2,2,266208,266208,266210,0,2,1
76072,6,2,266214,266214,266216,0,2,4
76073,3,1,266217,266217,266218,0,1,1
76074,1,3,266218,266218,266221,0,3,0
76075,5,3,266223,266223,266226,0,3,2
76076,2,3,266225,266226,266229,1,4,0
76077,4,3,266229,266229,266232,0,3,0
76078,1,3,266230,266232,266235,2,5,0
76079,4,1,266234,266235,266236,1,2,0
76080,1,1,266235,266236,266237,1,2,0
76081,2,2,266237,266237,266239,0,2,0
76082,5,1,266242,266242,266243,0,1,3
76083,6,3,266248,266248,266251,0,3,5
76084,6,3,266254,266254,266257,0,3,3
76085,4,1,266258,266258,266259,0,1,1
76086,6,2,266264,266264,266266,0,2,5
76087,3,3,266267,266267,266270,0,3,1
76088,5,1,266272,266272,266273,0,1,2
76089,1,1,266273,266273,266274,0,1,0
76090,5,3,266278,266278,266281,0,3,4
76091,1,3,266279,266281,266284,2,5,0
76092,5,1,266284,266284,266285,0,1,0
76093,4,1,266288,266288,266289,0,1,3
76094,1,1,266289,266289,266290,0,1,0
76095,1,3,266290,266290,266293,0,3,0
76096,6,1,266296,266296,266297,0,1,3
76097,5,1,266301,266301,266302,0,1,4
76098,6,1,266307,266307,266308,0,1,5
76099,6,2,266313,266313,266315,0,2,5
76100,1,2,266314,266315,266317,1,3,0
76101,2,2,266316,266317,266319,1,3,0
76102,1,1,266317,266319,266320,2,3,0
76103,5,1,266322,266322,266323,0,1,2
76104,1,2,266323,266323,266325,0,2,0
76105,1,2,266324,266325,266327,1,3,0
76106,5,3,266329,266329,266332,0,3,2
76107,3,1,266332,266332,266333,0,1,0
76108,1,2,266333,266333,266335,0,2,0
76109,4,1,266337,266337,266338,0,1,2
76110,1,1,266338,266338,266339,0,1,0
76111,2,3,266340,266340,266343,0,3,1
76112,4,1,266344,266344,266345,0,1,1
76113,1,3,266345,266345,266348,0,3,0
76114,5,1,266350,266350,266351,0,1,2
76115,1,2,266351,266351,266353,0,2,0
76116,1,1,266352,266353,266354,1,2,0
76117,3,3,266355,266355,266358,0,3,1
76118,4,3,266359,266359,266362,0,3,1
76119,4,3,266363,266363,266366,0,3,1
76120,5,1,266368,266368,266369,0,1,2
76121,5,3,266373,266373,266376,0,3,4
76122,3,2,266376,266376,266378,0,2,0
76123,5,3,266381,266381,266384,0,3,3
76124,4,3,266385,266385,266388,0,3,1
76125,4,1,266389,266389,266390,0,1,1
76126,4,1,266393,266393,266394,0,1,3
76127,3,3,266396,266396,266399,0,3,2
76128,4,3,266400,266400,266403,0,3,1
76129,2,1,266402,266403,266404,1,2,0
76130,5,2,266407,266407,266409,0,2,3
76131,4,3,266411,266411,266414,0,3,2
76132,3,1,266414,266414,266415,0,1,0
76133,3,2,266417,266417,266419,0,2,2
76134,2,3,266419,266419,266422,0,3,0
76135,4,1,266423,266423,266424,0,1,1
76136,2,1,266425,266425,266426,0,1,1
76137,4,1,266429,266429,266430,0,1,3
76138,2,1,266431,266431,266432,0,1,1
76139,3,3,266434,266434,266437,0,3,2
76140,4,1,266438,266438,266439,0,1,1
76141,1,1,266439,266439,266440,0,1,0
76142,2,1,266441,266441,266442,0,1,1
76143,6,3,266447,266447,266450,0,3,5
76144,1,3,266448,266450,266453,2,5,0
76145,4,3,266452,266453,266456,1,4,0
76146,5,2,266457,266457,266459,0,2,1
76147,1,3,266458,266459,266462,1,4,0
76148,6,2,266464,266464,266466,0,2,2
76149,5,1,266469,266469,266470,0,1,3
76150,4,2,266473,266473,266475,0,2,3
76151,2,2,266475,266475,266477,0,2,0
76152,4,2,266479,266479,266481,0,2,2
76153,6,2,266485,266485,266487,0,2,4
76154,3,3,266488,266488,266491,0,3,1
76155,6,2,266494,266494,266496,0,2,3
76156,2,2,266496,266496,266498,0,2,0
76157,2,2,266498,266498,266500,0,2,0
76158,2,2,266500,266500,266502,0,2,0
76159,6,3,266506,266506,266509,0,3,4
76160,2,3,266508,266509,266512,1,4,0
76161,5,1,266513,266513,266514,0,1,1
76162,5,3,266518,266518,266521,0,3,4
76163,6,3,266524,266524,266527,0,3,3
76164,6,3,266530,266530,266533,0,3,3
76165,2,1,266532,266533,266534,1,2,0
76166,5,1,266537,266537,266538,0,1,3
76167,1,3,266538,266538,266541,0,3,0
76168,3,3,266541,266541,266544,0,3,0
76169,5,1,266546,266546,266547,0,1,2
76170,3,2,266549,266549,266551,0,2,2
76171,5,1,266554,266554,266555,0,1,3
76172,5,1,266559,266559,266560,0,1,4
76173,5,2,266564,266564,266566,0,2,4
76174,4,2,266568,266568,266570,0,2,2
76175,6,3,266574,266574,266577,0,3,4
76176,5,1,266579,266579,266580,0,1,2
76177,4,1,266583,266583,266584,0,1,3
76178,4,1,266587,266587,266588,0,1,3
76179,6,2,266593,266593,266595,0,2,5
76180,2,2,266595,266595,266597,0,2,0
76181,1,3,266596,266597,266600,1,4,0
76182,6,2,266602,266602,266604,0,2,2
76183,2,2,266604,266604,266606,0,2,0
76184,6,3,266610,266610,266613,0,3,4
76185,1,1,266611,266613,266614,2,3,0
76186,4,1,266615,266615,266616,0,1,1
76187,6,1,266621,266621,266622,0,1,5
76188,3,1,266624,266624,266625,0,1,2
76189,4,3,266628,266628,266631,0,3,3
76190,2,2,266630,266631,266633,1,3,0
76191,1,1,266631,266633,266634,2,3,0
76192,5,1,266636,266636,266637,0,1,2
76193,6,3,266642,266642,266645,0,3,5
76194,6,3,266648,266648,266651,0,3,3
76195,6,3,266654,266654,266657,0,3,3
76196,2,2,266656,266657,266659,1,3,0
76197,4,2,266660,266660,266662,0,2,1
76198,6,2,266666,266666,266668,0,2,4
76199,2,2,266668,266668,266670,0,2,0
76200,2,1,266670,266670,266671,0,1,0
76201,6,1,266676,266676,266677,0,1,5
76202,6,3,266682,266682,266685,0,3,5
76203,4,1,266686,266686,266687,0,1,1
76204,3,2,266689,266689,266691,0,2,2
76205,3,3,266692,266692,266695,0,3,1
76206,2,1,266694,266695,266696,1,2,0
76207,3,2,266697,266697,266699,0,2,1
76208,5,1,266702,266702,266703,0,1,3
76209,2,2,266704,266704,266706,0,2,1
76210,3,1,266707,266707,266708,0,1,1
76211,5,3,266712,266712,266715,0,3,4
76212,6,2,266718,266718,266720,0,2,3
76213,2,1,266720,266720,266721,0,1,0
76214,3,1,266723,266723,266724,0,1,2
76215,4,2,266727,266727,266729,0,2,3
76216,2,1,266729,266729,266730,0,1,0
76217,6,1,266735,266735,266736,0,1,5
76218,5,1,266740,266740,266741,0,1,4
76219,6,1,266746,266746,266747,0,1,5
76220,6,3,266752,266752,266755,0,3,5
76221,4,1,266756,266756,266757,0,1,1
76222,2,1,266758,266758,266759,0,1,1
76223,5,3,266763,266763,266766,0,3,4
76224,2,1,266765,266766,266767,1,2,0
76225,5,1,266770,266770,266771,0,1,3
76226,2,1,266772,266772,266773,0,1,1
76227,2,1,266774,266774,266775,0,1,1
76228,5,3,266779,266779,266782,0,3,4
76229,3,1,266782,266782,266783,0,1,0
76230,5,3,266787,266787,266790,0,3,4
76231,6,1,266793,266793,266794,0,1,3
76232,2,3,266795,266795,266798,0,3,1
76233,5,3,266800,266800,266803,0,3,2
76234,1,2,266801,266803,266805,2,4,0
76235,5,1,266806,266806,266807,0,1,1
76236,5,3,266811,266811,266814,0,3,4
76237,6,2,266817,266817,266819,0,2,3
76238,1,2,266818,266819,266821,1,3,0
76239,6,2,266824,266824,266826,0,2,3
76240,5,3,266829,266829,266832,0,3,3
76241,3,3,266832,266832,266835,0,3,0
76242,3,1,266835,266835,266836,0,1,0
76243,2,1,266837,266837,266838,0,1,1
76244,5,2,266842,266842,266844,0,2,4
76245,5,3,266847,266847,266850,0,3,3
76246,1,1,266848,266850,266851,2,3,0
76247,4,2,266852,266852,266854,0,2,1
76248,1,3,266853,266854,266857,1,4,0
76249,5,1,266858,266858,266859,0,1,1
76250,2,2,266860,266860,266862,0,2,1
76251,3,1,266863,266863,266864,0,1,1
76252,4,3,266867,266867,266870,0,3,3
76253,2,2,266869,266870,266872,1,3,0
76254,5,3,266874,266874,266877,0,3,2
76255,1,1,266875,266877,266878,2,3,0
76256,1,1,266876,266878,266879,2,3,0
76257,5,2,266881,266881,266883,0,2,2
76258,2,2,266883,266883,266885,0,2,0
76259,6,2,266889,266889,266891,0,2,4
76260,1,2,266890,266891,266893,1,3,0
76261,3,3,266893,266893,266896,0,3,0
76262,1,2,266894,266896,266898,2,4,0
76263,5,2,266899,266899,266901,0,2,1
76264,3,3,266902,266902,266905,0,3,1
76265,6,2,266908,266908,266910,0,2,3
76266,3,1,266911,266911,266912,0,1,1
76267,4,3,266915,266915,266918,0,3,3
76268,6,1,266921,266921,266922,0,1,3
76269,1,2,266922,266922,266924,0,2,0
76270,2,1,266924,266924,266925,0,1,0
76271,5,1,266929,266929,266930,0,1,4
76272,1,1,266930,266930,266931,0,1,0
76273,2,2,266932,266932,266934,0,2,1
76274,5,1,266937,266937,266938,0,1,3
76275,2,1,266939,266939,266940,0,1,1
76276,2,1,266941,266941,266942,0,1,1
76277,3,1,266944,266944,266945,0,1,2
76278,4,3,266948,266948,266951,0,3,3
76279,5,2,266953,266953,266955,0,2,2
76280,3,1,266956,266956,266957,0,1,1
76281,2,2,266958,266958,266960,0,2,1
76282,5,3,266963,266963,266966,0,3,3
76283,3,3,266966,266966,266969,0,3,0
76284,6,1,266972,266972,266973,0,1,3
76285,5,3,266977,266977,266980,0,3,4
76286,3,3,266980,266980,266983,0,3,0
76287,1,3,266981,266983,266986,2,5,0
76288,3,3,266984,266986,266989,2,5,0
76289,5,3,266989,266989,266992,0,3,0
76290,1,1,266990,266992,266993,2,3,0
76291,4,3,266994,266994,266997,0,3,1
76292,6,3,267000,267000,267003,0,3,3
76293,4,1,267004,267004,267005,0,1,1
76294,4,2,267008,267008,267010,0,2,3
76295,4,1,267012,267012,267013,0,1,2
76296,3,3,267015,267015,267018,0,3,2
76297,6,3,267021,267021,267024,0,3,3
76298,6,2,267027,267027,267029,0,2,3
76299,4,3,267031,267031,267034,0,3,2
76300,1,3,267032,267034,267037,2,5,0
76301,1,1,267033,267037,267038,4,5,0
76302,6,2,267039,267039,267041,0,2,1
76303,5,2,267044,267044,267046,0,2,3
76304,4,2,267048,267048,267050,0,2,2
76305,5,1,267053,267053,267054,0,1,3
76306,3,1,267056,267056,267057,0,1,2
76307,5,3,267061,267061,267064,0,3,4
76308,5,2,267066,267066,267068,0,2,2
76309,5,1,267071,267071,267072,0,1,3
76310,6,3,267077,267077,267080,0,3,5
76311,3,1,267080,267080,267081,0,1,0
76312,1,2,267081,267081,267083,0,2,0
76313,2,3,267083,267083,267086,0,3,0
76314,2,3,267085,267086,267089,1,4,0
76315,4,2,267089,267089,267091,0,2,0
76316,6,1,267095,267095,267096,0,1,4
76317,5,2,267100,267100,267102,0,2,4
76318,3,2,267103,267103,267105,0,2,1
76319,1,3,267104,267105,267108,1,4,0
76320,3,2,267107,267108,267110,1,3,0
76321,2,1,267109,267110,267111,1,2,0
76322,6,1,267115,267115,267116,0,1,4
76323,1,2,267116,267116,267118,0,2,0
76324,6,3,267122,267122,267125,0,3,4
76325,6,1,267128,267128,267129,0,1,3
76326,1,1,267129,267129,267130,0,1,0
76327,4,2,267133,267133,267135,0,2,3
76328,6,1,267139,267139,267140,0,1,4
76329,3,2,267142,267142,267144,0,2,2
76330,6,3,267148,267148,267151,0,3,4
76331,5,3,267153,267153,267156,0,3,2
76332,4,1,267157,267157,267158,0,1,1
76333,4,2,267161,267161,267163,0,2,3
76334,5,3,267166,267166,267169,0,3,3
76335,2,3,267168,267169,267172,1,4,0
76336,5,3,267173,267173,267176,0,3,1
76337,1,1,267174,267176,267177,2,3,0
76338,3,1,267177,267177,267178,0,1,0
76339,1,1,267178,267178,267179,0,1,0
76340,4,2,267182,267182,267184,0,2,3
76341,1,1,267183,267184,267185,1,2,0
76342,1,1,267184,267185,267186,1,2,0
76343,2,2,267186,267186,267188,0,2,0
76344,5,1,267191,267191,267192,0,1,3
76345,2,3,267193,267193,267196,0,3,1
76346,6,3,267199,267199,267202,0,3,3
76347,5,1,267204,267204,267205,0,1,2
76348,2,3,267206,267206,267209,0,3,1
76349,5,2,267211,267211,267213,0,2,2
76350,2,1,267213,267213,267214,0,1,0
76351,3,3,267216,267216,267219,0,3,2
76352,1,3,267217,267219,267222,2,5,0
76353,4,2,267221,267222,267224,1,3,0
76354,5,2,267226,267226,267228,0,2,2
76355,6,2,267232,267232,267234,0,2,4
76356,3,1,267235,267235,267236,0,1,1
76357,6,1,267241,267241,267242,0,1,5
76358,6,2,267247,267247,267249,0,2,5
76359,6,3,267253,267253,267256,0,3,4
76360,5,3,267258,267258,267261,0,3,2
76361,4,3,267262,267262,267265,0,3,1
76362,4,3,267266,267266,267269,0,3,1
76363,5,1,267271,267271,267272,0,1,2
76364,2,1,267273,267273,267274,0,1,1
76365,3,3,267276,267276,267279,0,3,2
76366,3,1,267279,267279,267280,0,1,0
76367,3,3,267282,267282,267285,0,3,2
76368,1,3,267283,267285,267288,2,5,0
76369,2,3,267285,267288,267291,3,6,0
76370,4,1,267289,267291,267292,2,3,0
76371,6,2,267295,267295,267297,0,2,3
76372,4,2,267299,267299,267301,0,2,2
76373,2,2,267301,267301,267303,0,2,0
76374,6,3,267307,267307,267310,0,3,4
76375,1,3,267308,267310,267313,2,5,0
76376,4,1,267312,267313,267314,1,2,0
76377,5,2,267317,267317,267319,0,2,3
76378,4,3,267321,267321,267324,0,3,2
76379,5,1,267326,267326,267327,0,1,2
76380,4,2,267330,267330,267332,0,2,3
76381,2,2,267332,267332,267334,0,2,0
76382,3,2,267335,267335,267337,0,2,1
76383,6,2,267341,267341,267343,0,2,4
76384,6,1,267347,267347,267348,0,1,4
76385,6,2,267353,267353,267355,0,2,5
76386,6,2,267359,267359,267361,0,2,4
76387,1,2,267360,267361,267363,1,3,0
76388,5,1,267365,267365,267366,0,1,2
76389,3,1,267368,267368,267369,0,1,2
76390,4,1,267372,267372,267373,0,1,3
76391,1,3,267373,267373,267376,0,3,0
76392,5,3,267378,267378,267381,0,3,2
76393,6,3,267384,267384,267387,0,3,3
76394,3,2,267387,267387,267389,0,2,0
76395,6,2,267393,267393,267395,0,2,4
76396,4,2,267397,267397,267399,0,2,2
76397,3,1,267400,267400,267401,0,1,1
76398,4,3,267404,267404,267407,0,3,3
76399,6,1,267410,267410,267411,0,1,3
76400,6,1,267416,267416,267417,0,1,5
76401,1,2,267417,267417,267419,0,2,0
76402,6,3,267423,267423,267426,0,3,4
76403,1,3,267424,267426,267429,2,5,0
76404,4,3,267428,267429,267432,1,4,0
76405,3,2,267431,267432,267434,1,3,0
76406,1,1,267432,267434,267435,2,3,0
76407,1,2,267433,267435,267437,2,4,0
76408,1,3,267434,267437,267440,3,6,0
76409,2,2,267436,267440,267442,4,6,0
76410,3,2,267439,267442,267444,3,5,0
76411,6,3,267445,267445,267448,0,3,1
76412,3,2,267448,267448,267450,0,2,0
76413,5,3,267453,267453,267456,0,3,3
76414,5,1,267458,267458,267459,0,1,2
76415,4,1,267462,267462,267463,0,1,3
76416,5,3,267467,267467,267470,0,3,4
76417,5,2,267472,267472,267474,0,2,2
76418,5,1,267477,267477,267478,0,1,3
76419,5,1,267482,267482,267483,0,1,4
76420,3,2,267485,267485,267487,0,2,2
76421,3,3,267488,267488,267491,0,3,1
76422,2,1,267490,267491,267492,1,2,0
76423,2,3,267492,267492,267495,0,3,0
76424,4,2,267496,267496,267498,0,2,1
76425,1,2,267497,267498,267500,1,3,0
76426,3,3,267500,267500,267503,0,3,0
76427,3,2,267503,267503,267505,0,2,0
76428,5,3,267508,267508,267511,0,3,3
76429,4,2,267512,267512,267514,0,2,1
76430,4,3,267516,267516,267519,0,3,2
76431,5,3,267521,267521,267524,0,3,2
76432,6,1,267527,267527,267528,0,1,3
76433,3,3,267530,267530,267533,0,3,2
76434,6,2,267536,267536,267538,0,2,3
76435,5,1,267541,267541,267542,0,1,3
76436,3,1,267544,267544,267545,0,1,2
76437,3,2,267547,267547,267549,0,2,2
76438,1,2,267548,267549,267551,1,3,0
76439,6,3,267554,267554,267557,0,3,3
76440,3,3,267557,267557,267560,0,3,0
76441,2,3,267559,267560,267563,1,4,0
76442,3,1,267562,267563,267564,1,2,0
76443,4,3,267566,267566,267569,0,3,2
76444,6,1,267572,267572,267573,0,1,3
76445,3,2,267575,267575,267577,0,2,2
76446,4,1,267579,267579,267580,0,1,2
76447,1,2,267580,267580,267582,0,2,0
76448,1,1,267581,267582,267583,1,2,0
76449,3,2,267584,267584,267586,0,2,1
76450,1,2,267585,267586,267588,1,3,0
76451,3,3,267588,267588,267591,0,3,0
76452,1,2,267589,267591,267593,2,4,0
76453,5,2,267594,267594,267596,0,2,1
76454,4,2,267598,267598,267600,0,2,2
76455,6,1,267604,267604,267605,0,1,4
76456,1,2,267605,267605,267607,0,2,0
76457,4,1,267609,267609,267610,0,1,2
76458,6,2,267615,267615,267617,0,2,5
76459,5,2,267620,267620,267622,0,2,3
76460,2,3,267622,267622,267625,0,3,0
76461,2,1,267624,267625,267626,1,2,0
76462,5,1,267629,267629,267630,0,1,3
76463,1,2,267630,267630,267632,0,2,0
76464,3,3,267633,267633,267636,0,3,1
76465,3,3,267636,267636,267639,0,3,0
76466,2,2,267638,267639,267641,1,3,0
76467,3,3,267641,267641,267644,0,3,0
76468,5,1,267646,267646,267647,0,1,2
76469,4,2,267650,267650,267652,0,2,3
76470,1,2,267651,267652,267654,1,3,0
76471,5,3,267656,267656,267659,0,3,2
76472,1,3,267657,267659,267662,2,5,0
76473,4,2,267661,267662,267664,1,3,0
76474,1,3,267662,267664,267667,2,5,0
76475,3,2,267665,267667,267669,2,4,0
76476,5,2,267670,267670,267672,0,2,1
76477,6,2,267676,267676,267678,0,2,4
76478,6,1,267682,267682,267683,0,1,4
76479,4,2,267686,267686,267688,0,2,3
76480,1,1,267687,267688,267689,1,2,0
76481,4,3,267691,267691,267694,0,3,2
76482,1,3,267692,267694,267697,2,5,0
76483,4,3,267696,267697,267700,1,4,0
76484,1,2,267697,267700,267702,3,5,0
76485,5,2,267702,267702,267704,0,2,0
76486,4,2,267706,267706,267708,0,2,2
76487,6,3,267712,267712,267715,0,3,4
76488,1,3,267713,267715,267718,2,5,0
76489,3,1,267716,267718,267719,2,3,0
76490,4,3,267720,267720,267723,0,3,1
76491,3,3,267723,267723,267726,0,3,0
76492,6,2,267729,267729,267731,0,2,3
76493,2,3,267731,267731,267734,0,3,0
76494,5,3,267736,267736,267739,0,3,2
76495,1,2,267737,267739,267741,2,4,0
76496,4,2,267741,267741,267743,0,2,0
76497,1,1,267742,267743,267744,1,2,0
76498,2,1,267744,267744,267745,0,1,0
76499,5,2,267749,267749,267751,0,2,4
76500,1,2,267750,267751,267753,1,3,0
76501,2,2,267752,267753,267755,1,3,0
76502,2,1,267754,267755,267756,1,2,0
76503,2,2,267756,267756,267758,0,2,0
76504,5,3,267761,267761,267764,0,3,3
76505,5,3,267766,267766,267769,0,3,2
76506,4,3,267770,267770,267773,0,3,1
76507,1,3,267771,267773,267776,2,5,0
76508,2,3,267773,267776,267779,3,6,0
76509,2,2,267775,267779,267781,4,6,0
76510,2,3,267777,267781,267784,4,7,0
76511,5,2,267782,267784,267786,2,4,0
76512,1,3,267783,267786,267789,3,6,0
76513,4,1,267787,267789,267790,2,3,0
76514,1,3,267788,267790,267793,2,5,0
76515,5,1,267793,267793,267794,0,1,0
76516,3,3,267796,267796,267799,0,3,2
76517,2,1,267798,267799,267800,1,2,0
76518,1,2,267799,267800,267802,1,3,0
76519,5,3,267804,267804,267807,0,3,2
76520,1,2,267805,267807,267809,2,4,0
76521,2,2,267807,267809,267811,2,4,0
76522,4,1,267811,267811,267812,0,1,0
76523,3,1,267814,267814,267815,0,1,2
76524,4,3,267818,267818,267821,0,3,3
76525,1,2,267819,267821,267823,2,4,0
76526,6,2,267825,267825,267827,0,2,2
76527,1,3,267826,267827,267830,1,4,0
76528,2,2,267828,267830,267832,2,4,0
76529,3,1,267831,267832,267833,1,2,0
76530,5,3,267836,267836,267839,0,3,3
76531,5,1,267841,267841,267842,0,1,2
76532,4,2,267845,267845,267847,0,2,3
76533,6,2,267851,267851,267853,0,2,4
76534,2,2,267853,267853,267855,0,2,0
76535,1,1,267854,267855,267856,1,2,0
76536,3,2,267857,267857,267859,0,2,1
76537,4,2,267861,267861,267863,0,2,2
76538,3,3,267864,267864,267867,0,3,1
76539,4,3,267868,267868,267871,0,3,1
76540,4,3,267872,267872,267875,0,3,1
76541,2,3,267874,267875,267878,1,4,0
76542,3,3,267877,267878,267881,1,4,0
76543,3,1,267880,267881,267882,1,2,0
76544,6,1,267886,267886,267887,0,1,4
76545,2,1,267888,267888,267889,0,1,1
76546,5,1,267893,267893,267894,0,1,4
76547,5,1,267898,267898,267899,0,1,4
76548,6,3,267904,267904,267907,0,3,5
76549,1,2,267905,267907,267909,2,4,0
76550,4,3,267909,267909,267912,0,3,0
76551,3,2,267912,267912,267914,0,2,0
76552,6,1,267918,267918,267919,0,1,4
76553,2,2,267920,267920,267922,0,2,1
76554,5,3,267925,267925,267928,0,3,3
76555,3,2,267928,267928,267930,0,2,0
76556,6,3,267934,267934,267937,0,3,4
76557,4,1,267938,267938,267939,0,1,1
76558,5,1,267943,267943,267944,0,1,4
76559,4,1,267947,267947,267948,0,1,3
76560,2,3,267949,267949,267952,0,3,1
76561,2,2,267951,267952,267954,1,3,0
76562,3,2,267954,267954,267956,0,2,0
76563,6,2,267960,267960,267962,0,2,4
76564,4,3,267964,267964,267967,0,3,2
76565,1,2,267965,267967,267969,2,4,0
76566,3,2,267968,267969,267971,1,3,0
76567,1,3,267969,267971,267974,2,5,0
76568,4,2,267973,267974,267976,1,3,0
76569,6,1,267979,267979,267980,0,1,3
76570,4,3,267983,267983,267986,0,3,3
76571,1,3,267984,267986,267989,2,5,0
76572,6,1,267990,267990,267991,0,1,1
76573,3,2,267993,267993,267995,0,2,2
76574,3,1,267996,267996,267997,0,1,1
76575,5,2,268001,268001,268003,0,2,4
76576,6,1,268007,268007,268008,0,1,4
76577,1,2,268008,268008,268010,0,2,0
76578,1,2,268009,268010,268012,1,3,0
76579,5,2,268014,268014,268016,0,2,2
76580,1,1,268015,268016,268017,1,2,0
76581,6,3,268021,268021,268024,0,3,4
76582,2,2,268023,268024,268026,1,3,0
76583,2,3,268025,268026,268029,1,4,0
76584,2,3,268027,268029,268032,2,5,0
76585,4,1,268031,268032,268033,1,2,0
76586,3,2,268034,268034,268036,0,2,1
76587,1,3,268035,268036,268039,1,4,0
76588,1,2,268036,268039,268041,3,5,0
76589,2,3,268038,268041,268044,3,6,0
76590,1,1,268039,268044,268045,5,6,0
76591,1,1,268040,268045,268046,5,6,0
76592,4,3,268044,268046,268049,2,5,0
76593,5,1,268049,268049,268050,0,1,0
76594,2,1,268051,268051,268052,0,1,1
76595,1,1,268052,268052,268053,0,1,0
76596,1,2,268053,268053,268055,0,2,0
76597,5,1,268058,268058,268059,0,1,3
76598,1,3,268059,268059,268062,0,3,0
76599,5,2,268064,268064,268066,0,2,2
76600,3,2,268067,268067,268069,0,2,1
76601,1,3,268068,268069,268072,1,4,0
76602,4,1,268072,268072,268073,0,1,0
76603,2,1,268074,268074,268075,0,1,1
76604,6,2,268080,268080,268082,0,2,5
76605,2,3,268082,268082,268085,0,3,0
76606,1,3,268083,268085,268088,2,5,0
76607,4,3,268087,268088,268091,1,4,0
76608,4,1,268091,268091,268092,0,1,0
76609,5,3,268096,268096,268099,0,3,4
76610,1,3,268097,268099,268102,2,5,0
76611,2,2,268099,268102,268104,3,5,0
76612,1,1,268100,268104,268105,4,5,0
76613,5,3,268105,268105,268108,0,3,0
76614,1,1,268106,268108,268109,2,3,0
76615,2,2,268108,268109,268111,1,3,0
76616,3,3,268111,268111,268114,0,3,0
76617,4,2,268115,268115,268117,0,2,1
76618,1,2,268116,268117,268119,1,3,0
76619,4,2,268120,268120,268122,0,2,1
76620,1,2,268121,268122,268124,1,3,0
76621,1,1,268122,268124,268125,2,3,0
76622,5,3,268127,268127,268130,0,3,2
76623,6,2,268133,268133,268135,0,2,3
76624,3,3,268136,268136,268139,0,3,1
76625,2,1,268138,268139,268140,1,2,0
76626,6,2,268144,268144,268146,0,2,4
76627,3,3,268147,268147,268150,0,3,1
76628,1,1,268148,268150,268151,2,3,0
76629,6,1,268154,268154,268155,0,1,3
76630,5,2,268159,268159,268161,0,2,4
76631,4,3,268163,268163,268166,0,3,2
76632,5,3,268168,268168,268171,0,3,2
76633,5,3,268173,268173,268176,0,3,2
76634,2,2,268175,268176,268178,1,3,0
76635,3,1,268178,268178,268179,0,1,0
76636,6,2,268184,268184,268186,0,2,5
76637,2,3,268186,268186,268189,0,3,0
76638,4,2,268190,268190,268192,0,2,1
76639,5,2,268195,268195,268197,0,2,3
76640,3,1,268198,268198,268199,0,1,1
76641,4,3,268202,268202,268205,0,3,3
76642,4,2,268206,268206,268208,0,2,1
76643,1,3,268207,268208,268211,1,4,0
76644,4,3,268211,268211,268214,0,3,0
76645,5,1,268216,268216,268217,0,1,2
76646,5,3,268221,268221,268224,0,3,4
76647,6,3,268227,268227,268230,0,3,3
76648,4,3,268231,268231,268234,0,3,1
76649,6,1,268237,268237,268238,0,1,3
76650,2,1,268239,268239,268240,0,1,1
76651,1,3,268240,268240,268243,0,3,0
76652,5,2,268245,268245,268247,0,2,2
76653,1,1,268246,268247,268248,1,2,0
76654,3,2,268249,268249,268251,0,2,1
76655,6,1,268255,268255,268256,0,1,4
76656,5,3,268260,268260,268263,0,3,4
76657,1,1,268261,268263,268264,2,3,0
76658,3,2,268264,268264,268266,0,2,0
76659,5,3,268269,268269,268272,0,3,3
76660,1,1,268270,268272,268273,2,3,0
76661,2,3,268272,268273,268276,1,4,0
76662,2,3,268274,268276,268279,2,5,0
76663,5,3,268279,268279,268282,0,3,0
76664,3,2,268282,268282,268284,0,2,0
76665,4,1,268286,268286,268287,0,1,2
76666,4,2,268290,268290,268292,0,2,3
76667,6,1,268296,268296,268297,0,1,4
76668,1,2,268297,268297,268299,0,2,0
76669,3,3,268300,268300,268303,0,3,1
76670,1,1,268301,268303,268304,2,3,0
76671,6,1,268307,268307,268308,0,1,3
76672,5,1,268312,268312,268313,0,1,4
76673,1,2,268313,268313,268315,0,2,0
76674,1,1,268314,268315,268316,1,2,0
76675,6,2,268320,268320,268322,0,2,4
76676,5,3,268325,268325,268328,0,3,3
76677,1,3,268326,268328,268331,2,5,0
76678,5,3,268331,268331,268334,0,3,0
76679,5,1,268336,268336,268337,0,1,2
76680,1,2,268337,268337,268339,0,2,0
76681,6,1,268343,268343,268344,0,1,4
76682,2,2,268345,268345,268347,0,2,1
76683,1,3,268346,268347,268350,1,4,0
76684,5,2,268351,268351,268353,0,2,1
76685,6,3,268357,268357,268360,0,3,4
76686,6,1,268363,268363,268364,0,1,3
76687,4,1,268367,268367,268368,0,1,3
76688,1,1,268368,268368,268369,0,1,0
76689,3,3,268371,268371,268374,0,3,2
76690,5,3,268376,268376,268379,0,3,2
76691,4,2,268380,268380,268382,0,2,1
76692,2,2,268382,268382,268384,0,2,0
76693,6,3,268388,268388,268391,0,3,4
76694,1,2,268389,268391,268393,2,4,0
76695,5,3,268394,268394,268397,0,3,1
76696,4,3,268398,268398,268401,0,3,1
76697,6,2,268404,268404,268406,0,2,3
76698,1,2,268405,268406,268408,1,3,0
76699,1,3,268406,268408,268411,2,5,0
76700,3,1,268409,268411,268412,2,3,0
76701,1,1,268410,268412,268413,2,3,0
76702,3,1,268413,268413,268414,0,1,0
76703,1,1,268414,268414,268415,0,1,0
76704,3,3,268417,268417,268420,0,3,2
76705,6,3,268423,268423,268426,0,3,3
76706,3,1,268426,268426,268427,0,1,0
76707,6,3,268432,268432,268435,0,3,5
76708,1,1,268433,268435,268436,2,3,0
76709,6,2,268439,268439,268441,0,2,3
76710,3,2,268442,268442,268444,0,2,1
76711,6,2,268448,268448,268450,0,2,4
76712,1,2,268449,268450,268452,1,3,0
76713,4,3,268453,268453,268456,0,3,1
76714,1,3,268454,268456,268459,2,5,0
76715,6,1,268460,268460,268461,0,1,1
76716,3,3,268463,268463,268466,0,3,2
76717,4,2,268467,268467,268469,0,2,1
76718,6,3,268473,268473,268476,0,3,4
76719,2,3,268475,268476,268479,1,4,0
76720,5,1,268480,268480,268481,0,1,1
76721,1,2,268481,268481,268483,0,2,0
76722,4,3,268485,268485,268488,0,3,2
76723,3,3,268488,268488,268491,0,3,0
76724,5,1,268493,268493,268494,0,1,2
76725,1,2,268494,268494,268496,0,2,0
76726,6,1,268500,268500,268501,0,1,4
76727,6,1,268506,268506,268507,0,1,5
76728,3,1,268509,268509,268510,0,1,2
76729,3,3,268512,268512,268515,0,3,2
76730,1,3,268513,268515,268518,2,5,0
76731,3,3,268516,268518,268521,2,5,0
76732,4,1,268520,268521,268522,1,2,0
76733,5,2,268525,268525,268527,0,2,3
76734,2,2,268527,268527,268529,0,2,0
76735,6,3,268533,268533,268536,0,3,4
76736,4,2,268537,268537,268539,0,2,1
76737,2,1,268539,268539,268540,0,1,0
76738,5,2,268544,268544,268546,0,2,4
76739,6,1,268550,268550,268551,0,1,4
76740,5,3,268555,268555,268558,0,3,4
76741,1,3,268556,268558,268561,2,5,0
76742,6,2,268562,268562,268564,0,2,1
76743,1,2,268563,268564,268566,1,3,0
76744,1,1,268564,268566,268567,2,3,0
76745,5,3,268569,268569,268572,0,3,2
76746,5,1,268574,268574,268575,0,1,2
76747,1,1,268575,268575,268576,0,1,0
76748,2,1,268577,268577,268578,0,1,1
76749,1,2,268578,268578,268580,0,2,0
76750,4,2,268582,268582,268584,0,2,2
76751,6,1,268588,268588,268589,0,1,4
76752,4,3,268592,268592,268595,0,3,3
76753,4,2,268596,268596,268598,0,2,1
76754,1,3,268597,268598,268601,1,4,0
76755,1,2,268598,268601,268603,3,5,0
76756,5,3,268603,268603,268606,0,3,0
76757,5,1,268608,268608,268609,0,1,2
76758,6,2,268614,268614,268616,0,2,5
76759,5,3,268619,268619,268622,0,3,3
76760,3,1,268622,268622,268623,0,1,0
76761,3,2,268625,268625,268627,0,2,2
76762,4,1,268629,268629,268630,0,1,2
76763,3,2,268632,268632,268634,0,2,2
76764,6,3,268638,268638,268641,0,3,4
76765,6,3,268644,268644,268647,0,3,3
76766,6,1,268650,268650,268651,0,1,3
76767,6,2,268656,268656,268658,0,2,5
76768,6,1,268662,268662,268663,0,1,4
76769,4,3,268666,268666,268669,0,3,3
76770,2,1,268668,268669,268670,1,2,0
76771,6,2,268674,268674,268676,0,2,4
76772,4,3,268678,268678,268681,0,3,2
76773,5,1,268683,268683,268684,0,1,2
76774,5,3,268688,268688,268691,0,3,4
76775,1,3,268689,268691,268694,2,5,0
76776,2,1,268691,268694,268695,3,4,0
76777,3,2,268694,268695,268697,1,3,0
76778,3,3,268697,268697,268700,0,3,0
76779,6,2,268703,268703,268705,0,2,3
76780,1,1,268704,268705,268706,1,2,0
76781,5,3,268709,268709,268712,0,3,3
76782,1,2,268710,268712,268714,2,4,0
76783,4,3,268714,268714,268717,0,3,0
76784,5,3,268719,268719,268722,0,3,2
76785,3,2,268722,268722,268724,0,2,0
76786,5,3,268727,268727,268730,0,3,3
76787,3,2,268730,268730,268732,0,2,0
76788,4,2,268734,268734,268736,0,2,2
76789,5,2,268739,268739,268741,0,2,3
76790,4,1,268743,268743,268744,0,1,2
76791,3,3,268746,268746,268749,0,3,2
76792,2,2,268748,268749,268751,1,3,0
76793,1,2,268749,268751,268753,2,4,0
76794,6,2,268755,268755,268757,0,2,2
76795,5,3,268760,268760,268763,0,3,3
76796,3,1,268763,268763,268764,0,1,0
76797,1,2,268764,268764,268766,0,2,0
76798,5,3,268769,268769,268772,0,3,3
76799,3,2,268772,268772,268774,0,2,0
76800,4,1,268776,268776,268777,0,1,2
76801,6,3,268782,268782,268785,0,3,5
76802,4,3,268786,268786,268789,0,3,1
76803,2,2,268788,268789,268791,1,3,0
76804,4,3,268792,268792,268795,0,3,1
76805,2,1,268794,268795,268796,1,2,0
76806,4,3,268798,268798,268801,0,3,2
76807,4,1,268802,268802,268803,0,1,1
76808,3,1,268805,268805,268806,0,1,2
76809,3,2,268808,268808,268810,0,2,2
76810,2,1,268810,268810,268811,0,1,0
76811,4,1,268814,268814,268815,0,1,3
76812,1,2,268815,268815,268817,0,2,0
76813,3,2,268818,268818,268820,0,2,1
76814,6,3,268824,268824,268827,0,3,4
76815,5,3,268829,268829,268832,0,3,2
76816,5,3,268834,268834,268837,0,3,2
76817,6,2,268840,268840,268842,0,2,3
76818,3,3,268843,268843,268846,0,3,1
76819,5,3,268848,268848,268851,0,3,2
76820,5,3,268853,268853,268856,0,3,2
76821,2,3,268855,268856,268859,1,4,0
76822,5,1,268860,268860,268861,0,1,1
76823,2,3,268862,268862,268865,0,3,1
76824,3,1,268865,268865,268866,0,1,0
76825,3,1,268868,268868,268869,0,1,2
76826,1,2,268869,268869,268871,0,2,0
76827,5,2,268874,268874,268876,0,2,3
76828,3,3,268877,268877,268880,0,3,1
76829,3,1,268880,268880,268881,0,1,0
76830,4,3,268884,268884,268887,0,3,3
76831,6,2,268890,268890,268892,0,2,3
76832,6,2,268896,268896,268898,0,2,4
76833,2,1,268898,268898,268899,0,1,0
76834,1,3,268899,268899,268902,0,3,0
76835,2,1,268901,268902,268903,1,2,0
76836,2,2,268903,268903,268905,0,2,0
76837,6,1,268909,268909,268910,0,1,4
76838,1,2,268910,268910,268912,0,2,0
76839,5,1,268915,268915,268916,0,1,3
76840,6,3,268921,268921,268924,0,3,5
76841,4,3,268925,268925,268928,0,3,1
76842,6,2,268931,268931,268933,0,2,3
76843,2,3,268933,268933,268936,0,3,0
76844,4,1,268937,268937,268938,0,1,1
76845,5,3,268942,268942,268945,0,3,4
76846,4,2,268946,268946,268948,0,2,1
76847,2,3,268948,268948,268951,0,3,0
76848,1,2,268949,268951,268953,2,4,0
76849,1,3,268950,268953,268956,3,6,0
76850,2,3,268952,268956,268959,4,7,0
76851,2,1,268954,268959,268960,5,6,0
76852,5,2,268959,268960,268962,1,3,0
76853,6,3,268965,268965,268968,0,3,3
76854,1,2,268966,268968,268970,2,4,0
76855,3,2,268969,268970,268972,1,3,0
76856,3,3,268972,268972,268975,0,3,0
76857,4,3,268976,268976,268979,0,3,1
76858,5,2,268981,268981,268983,0,2,2
76859,3,2,268984,268984,268986,0,2,1
76860,1,3,268985,268986,268989,1,4,0
76861,1,1,268986,268989,268990,3,4,0
76862,5,1,268991,268991,268992,0,1,1
76863,2,3,268993,268993,268996,0,3,1
76864,4,2,268997,268997,268999,0,2,1
76865,5,2,269002,269002,269004,0,2,3
76866,2,3,269004,269004,269007,0,3,0
76867,6,3,269010,269010,269013,0,3,3
76868,5,2,269015,269015,269017,0,2,2
76869,4,1,269019,269019,269020,0,1,2
76870,2,3,269021,269021,269024,0,3,1
76871,2,3,269023,269024,269027,1,4,0
76872,2,3,269025,269027,269030,2,5,0
76873,4,3,269029,269030,269033,1,4,0
76874,6,3,269035,269035,269038,0,3,2
76875,5,3,269040,269040,269043,0,3,2
76876,6,1,269046,269046,269047,0,1,3
76877,5,1,269051,269051,269052,0,1,4
76878,2,3,269053,269053,269056,0,3,1
76879,1,3,269054,269056,269059,2,5,0
76880,4,3,269058,269059,269062,1,4,0
76881,1,3,269059,269062,269065,3,6,0
76882,5,2,269064,269065,269067,1,3,0
76883,3,2,269067,269067,269069,0,2,0
76884,5,3,269072,269072,269075,0,3,3
76885,1,2,269073,269075,269077,2,4,0
76886,1,2,269074,269077,269079,3,5,0
76887,6,1,269080,269080,269081,0,1,1
76888,4,2,269084,269084,269086,0,2,3
76889,6,1,269090,269090,269091,0,1,4
76890,4,1,269094,269094,269095,0,1,3
76891,6,1,269100,269100,269101,0,1,5
76892,4,1,269104,269104,269105,0,1,3
76893,5,3,269109,269109,269112,0,3,4
76894,5,3,269114,269114,269117,0,3,2
76895,2,2,269116,269117,269119,1,3,0
76896,3,2,269119,269119,269121,0,2,0
76897,1,3,269120,269121,269124,1,4,0
76898,2,1,269122,269124,269125,2,3,0
76899,3,1,269125,269125,269126,0,1,0
76900,3,2,269128,269128,269130,0,2,2
76901,3,3,269131,269131,269134,0,3,1
76902,1,3,269132,269134,269137,2,5,0
76903,4,1,269136,269137,269138,1,2,0
76904,6,3,269142,269142,269145,0,3,4
76905,5,1,269147,269147,269148,0,1,2
76906,5,1,269152,269152,269153,0,1,4
76907,4,2,269156,269156,269158,0,2,3
76908,2,1,269158,269158,269159,0,1,0
76909,2,3,269160,269160,269163,0,3,1
76910,2,2,269162,269163,269165,1,3,0
76911,1,3,269163,269165,269168,2,5,0
76912,3,1,269166,269168,269169,2,3,0
76913,6,2,269172,269172,269174,0,2,3
76914,1,2,269173,269174,269176,1,3,0
76915,5,2,269178,269178,269180,0,2,2
76916,4,2,269182,269182,269184,0,2,2
76917,4,3,269186,269186,269189,0,3,2
76918,2,1,269188,269189,269190,1,2,0
76919,6,3,269194,269194,269197,0,3,4
76920,6,2,269200,269200,269202,0,2,3
76921,4,2,269204,269204,269206,0,2,2
76922,4,1,269208,269208,269209,0,1,2
76923,4,2,269212,269212,269214,0,2,3
76924,5,1,269217,269217,269218,0,1,3
76925,4,1,269221,269221,269222,0,1,3
76926,5,1,269226,269226,269227,0,1,4
76927,5,2,269231,269231,269233,0,2,4
76928,6,2,269237,269237,269239,0,2,4
76929,3,3,269240,269240,269243,0,3,1
76930,4,3,269244,269244,269247,0,3,1
76931,1,2,269245,269247,269249,2,4,0
76932,2,2,269247,269249,269251,2,4,0
76933,3,1,269250,269251,269252,1,2,0
76934,2,3,269252,269252,269255,0,3,0
76935,4,1,269256,269256,269257,0,1,1
76936,4,3,269260,269260,269263,0,3,3
76937,2,1,269262,269263,269264,1,2,0
76938,6,3,269268,269268,269271,0,3,4
76939,2,2,269270,269271,269273,1,3,0
76940,1,3,269271,269273,269276,2,5,0
76941,5,1,269276,269276,269277,0,1,0
76942,5,1,269281,269281,269282,0,1,4
76943,5,2,269286,269286,269288,0,2,4
76944,3,3,269289,269289,269292,0,3,1
76945,3,1,269292,269292,269293,0,1,0
76946,3,2,269295,269295,269297,0,2,2
76947,2,1,269297,269297,269298,0,1,0
76948,1,1,269298,269298,269299,0,1,0
76949,2,1,269300,269300,269301,0,1,1
76950,4,3,269304,269304,269307,0,3,3
76951,1,3,269305,269307,269310,2,5,0
76952,2,2,269307,269310,269312,3,5,0
76953,1,2,269308,269312,269314,4,6,0
76954,3,2,269311,269314,269316,3,5,0
76955,6,2,269317,269317,269319,0,2,1
76956,1,1,269318,269319,269320,1,2,0
76957,3,2,269321,269321,269323,0,2,1
76958,6,3,269327,269327,269330,0,3,4
76959,5,2,269332,269332,269334,0,2,2
76960,3,2,269335,269335,269337,0,2,1
76961,5,2,269340,269340,269342,0,2,3
76962,6,2,269346,269346,269348,0,2,4
76963,4,2,269350,269350,269352,0,2,2
76964,4,2,269354,269354,269356,0,2,2
76965,2,3,269356,269356,269359,0,3,0
76966,2,1,269358,269359,269360,1,2,0
76967,2,2,269360,269360,269362,0,2,0
76968,2,1,269362,269362,269363,0,1,0
76969,4,1,269366,269366,269367,0,1,3
76970,6,1,269372,269372,269373,0,1,5
76971,2,1,269374,269374,269375,0,1,1
76972,5,2,269379,269379,269381,0,2,4
76973,4,3,269383,269383,269386,0,3,2
76974,3,3,269386,269386,269389,0,3,0
76975,1,1,269387,269389,269390,2,3,0
76976,5,1,269392,269392,269393,0,1,2
76977,6,1,269398,269398,269399,0,1,5
76978,5,3,269403,269403,269406,0,3,4
76979,1,3,269404,269406,269409,2,5,0
76980,1,3,269405,269409,269412,4,7,0
76981,2,2,269407,269412,269414,5,7,0
76982,2,2,269409,269414,269416,5,7,0
76983,6,1,269415,269416,269417,1,2,0
76984,6,1,269421,269421,269422,0,1,4
76985,1,3,269422,269422,269425,0,3,0
76986,3,2,269425,269425,269427,0,2,0
76987,1,1,269426,269427,269428,1,2,0
76988,4,3,269430,269430,269433,0,3,2
76989,4,2,269434,269434,269436,0,2,1
76990,3,3,269437,269437,269440,0,3,1
76991,1,1,269438,269440,269441,2,3,0
76992,3,2,269441,269441,269443,0,2,0
76993,3,3,269444,269444,269447,0,3,1
76994,5,3,269449,269449,269452,0,3,2
76995,6,3,269455,269455,269458,0,3,3
76996,2,1,269457,269458,269459,1,2,0
76997,3,3,269460,269460,269463,0,3,1
76998,1,3,269461,269463,269466,2,5,0
76999,3,1,269464,269466,269467,2,3,0
77000,2,3,269466,269467,269470,1,4,0
77001,1,2,269467,269470,269472,3,5,0
77002,2,2,269469,269472,269474,3,5,0
77003,3,1,269472,269474,269475,2,3,0
77004,3,1,269475,269475,269476,0,1,0
77005,6,1,269481,269481,269482,0,1,5
77006,1,2,269482,269482,269484,0,2,0
77007,6,2,269488,269488,269490,0,2,4
77008,6,3,269494,269494,269497,0,3,4
77009,3,1,269497,269497,269498,0,1,0
77010,5,2,269502,269502,269504,0,2,4
77011,3,3,269505,269505,269508,0,3,1
77012,3,3,269508,269508,269511,0,3,0
77013,2,1,269510,269511,269512,1,2,0
77014,4,3,269514,269514,269517,0,3,2
77015,4,3,269518,269518,269521,0,3,1
77016,6,3,269524,269524,269527,0,3,3
77017,3,1,269527,269527,269528,0,1,0
77018,4,1,269531,269531,269532,0,1,3
77019,4,2,269535,269535,269537,0,2,3
77020,4,2,269539,269539,269541,0,2,2
77021,4,2,269543,269543,269545,0,2,2
77022,4,3,269547,269547,269550,0,3,2
77023,2,3,269549,269550,269553,1,4,0
77024,3,3,269552,269553,269556,1,4,0
77025,1,2,269553,269556,269558,3,5,0
77026,6,3,269559,269559,269562,0,3,1
77027,2,2,269561,269562,269564,1,3,0
77028,6,2,269567,269567,269569,0,2,3
77029,5,3,269572,269572,269575,0,3,3
77030,1,1,269573,269575,269576,2,3,0
77031,1,3,269574,269576,269579,2,5,0
77032,6,3,269580,269580,269583,0,3,1
77033,3,3,269583,269583,269586,0,3,0
77034,5,2,269588,269588,269590,0,2,2
77035,2,3,269590,269590,269593,0,3,0
77036,6,1,269596,269596,269597,0,1,3
77037,2,1,269598,269598,269599,0,1,1
77038,5,1,269603,269603,269604,0,1,4
77039,4,2,269607,269607,269609,0,2,3
77040,5,3,269612,269612,269615,0,3,3
77041,1,3,269613,269615,269618,2,5,0
77042,3,1,269616,269618,269619,2,3,0
77043,1,3,269617,269619,269622,2,5,0
77044,4,2,269621,269622,269624,1,3,0
77045,6,3,269627,269627,269630,0,3,3
77046,5,1,269632,269632,269633,0,1,2
77047,1,1,269633,269633,269634,0,1,0
77048,5,1,269638,269638,269639,0,1,4
77049,1,2,269639,269639,269641,0,2,0
77050,3,2,269642,269642,269644,0,2,1
77051,1,1,269643,269644,269645,1,2,0
77052,1,2,269644,269645,269647,1,3,0
77053,2,2,269646,269647,269649,1,3,0
77054,4,1,269650,269650,269651,0,1,1
77055,5,1,269655,269655,269656,0,1,4
77056,2,3,269657,269657,269660,0,3,1
77057,6,1,269663,269663,269664,0,1,3
77058,4,2,269667,269667,269669,0,2,3
77059,5,3,269672,269672,269675,0,3,3
77060,3,3,269675,269675,269678,0,3,0
77061,2,2,269677,269678,269680,1,3,0
77062,6,3,269683,269683,269686,0,3,3
77063,1,3,269684,269686,269689,2,5,0
77064,5,1,269689,269689,269690,0,1,0
77065,5,3,269694,269694,269697,0,3,4
77066,5,2,269699,269699,269701,0,2,2
77067,2,2,269701,269701,269703,0,2,0
77068,4,3,269705,269705,269708,0,3,2
77069,3,1,269708,269708,269709,0,1,0
77070,1,2,269709,269709,269711,0,2,0
77071,2,1,269711,269711,269712,0,1,0
77072,5,2,269716,269716,269718,0,2,4
77073,3,2,269719,269719,269721,0,2,1
77074,1,1,269720,269721,269722,1,2,0
77075,3,2,269723,269723,269725,0,2,1
77076,5,2,269728,269728,269730,0,2,3
77077,3,2,269731,269731,269733,0,2,1
77078,4,3,269735,269735,269738,0,3,2
77079,2,1,269737,269738,269739,1,2,0
77080,4,2,269741,269741,269743,0,2,2
77081,3,2,269744,269744,269746,0,2,1
77082,5,1,269749,269749,269750,0,1,3
77083,1,2,269750,269750,269752,0,2,0
77084,6,1,269756,269756,269757,0,1,4
77085,3,3,269759,269759,269762,0,3,2
77086,5,2,269764,269764,269766,0,2,2
77087,2,1,269766,269766,269767,0,1,0
77088,5,1,269771,269771,269772,0,1,4
77089,3,3,269774,269774,269777,0,3,2
77090,6,2,269780,269780,269782,0,2,3
77091,5,2,269785,269785,269787,0,2,3
77092,2,1,269787,269787,269788,0,1,0
77093,4,3,269791,269791,269794,0,3,3
77094,3,1,269794,269794,269795,0,1,0
77095,1,1,269795,269795,269796,0,1,0
77096,2,1,269797,269797,269798,0,1,1
77097,5,1,269802,269802,269803,0,1,4
77098,4,2,269806,269806,269808,0,2,3
77099,6,2,269812,269812,269814,0,2,4
77100,3,2,269815,269815,269817,0,2,1
77101,2,3,269817,269817,269820,0,3,0
77102,2,1,269819,269820,269821,1,2,0
77103,2,2,269821,269821,269823,0,2,0
77104,3,1,269824,269824,269825,0,1,1
77105,6,3,269830,269830,269833,0,3,5
77106,4,2,269834,269834,269836,0,2,1
77107,2,3,269836,269836,269839,0,3,0
77108,6,2,269842,269842,269844,0,2,3
77109,3,2,269845,269845,269847,0,2,1
77110,2,2,269847,269847,269849,0,2,0
77111,3,2,269850,269850,269852,0,2,1
77112,3,3,269853,269853,269856,0,3,1
77113,4,3,269857,269857,269860,0,3,1
77114,5,1,269862,269862,269863,0,1,2
77115,1,3,269863,269863,269866,0,3,0
77116,1,2,269864,269866,269868,2,4,0
77117,2,3,269866,269868,269871,2,5,0
77118,1,3,269867,269871,269874,4,7,0
77119,2,3,269869,269874,269877,5,8,0
77120,3,2,269872,269877,269879,5,7,0
77121,4,1,269876,269879,269880,3,4,0
77122,1,3,269877,269880,269883,3,6,0
77123,2,2,269879,269883,269885,4,6,0
77124,3,3,269882,269885,269888,3,6,0
77125,5,2,269887,269888,269890,1,3,0
77126,4,1,269891,269891,269892,0,1,1
77127,5,1,269896,269896,269897,0,1,4
77128,3,1,269899,269899,269900,0,1,2
77129,2,1,269901,269901,269902,0,1,1
77130,6,1,269907,269907,269908,0,1,5
77131,4,2,269911,269911,269913,0,2,3
77132,2,2,269913,269913,269915,0,2,0
77133,4,2,269917,269917,269919,0,2,2
77134,2,2,269919,269919,269921,0,2,0
77135,1,2,269920,269921,269923,1,3,0
77136,4,1,269924,269924,269925,0,1,1
77137,3,3,269927,269927,269930,0,3,2
77138,6,3,269933,269933,269936,0,3,3
77139,4,2,269937,269937,269939,0,2,1
77140,1,2,269938,269939,269941,1,3,0
77141,5,3,269943,269943,269946,0,3,2
77142,2,2,269945,269946,269948,1,3,0
77143,6,2,269951,269951,269953,0,2,3
77144,1,2,269952,269953,269955,1,3,0
77145,4,2,269956,269956,269958,0,2,1
77146,1,2,269957,269958,269960,1,3,0
77147,6,1,269963,269963,269964,0,1,3
77148,4,2,269967,269967,269969,0,2,3
77149,2,1,269969,269969,269970,0,1,0
77150,3,2,269972,269972,269974,0,2,2
77151,5,1,269977,269977,269978,0,1,3
77152,1,2,269978,269978,269980,0,2,0
77153,5,2,269983,269983,269985,0,2,3
77154,1,2,269984,269985,269987,1,3,0
77155,2,3,269986,269987,269990,1,4,0
77156,3,3,269989,269990,269993,1,4,0
77157,3,1,269992,269993,269994,1,2,0
77158,3,3,269995,269995,269998,0,3,1
77159,3,2,269998,269998,270000,0,2,0
77160,4,1,270002,270002,270003,0,1,2
77161,4,3,270006,270006,270009,0,3,3
77162,6,2,270012,270012,270014,0,2,3
77163,6,3,270018,270018,270021,0,3,4
77164,5,3,270023,270023,270026,0,3,2
77165,2,1,270025,270026,270027,1,2,0
77166,6,3,270031,270031,270034,0,3,4
77167,6,1,270037,270037,270038,0,1,3
77168,1,3,270038,270038,270041,0,3,0
77169,4,1,270042,270042,270043,0,1,1
77170,5,1,270047,270047,270048,0,1,4
77171,2,3,270049,270049,270052,0,3,1
77172,6,3,270055,270055,270058,0,3,3
77173,4,1,270059,270059,270060,0,1,1
77174,2,1,270061,270061,270062,0,1,1
77175,1,3,270062,270062,270065,0,3,0
77176,4,3,270066,270066,270069,0,3,1
77177,5,3,270071,270071,270074,0,3,2
77178,2,2,270073,270074,270076,1,3,0
77179,5,1,270078,270078,270079,0,1,2
77180,2,3,270080,270080,270083,0,3,1
77181,4,3,270084,270084,270087,0,3,1
77182,5,1,270089,270089,270090,0,1,2
77183,4,3,270093,270093,270096,0,3,3
77184,6,1,270099,270099,270100,0,1,3
77185,5,3,270104,270104,270107,0,3,4
77186,5,3,270109,270109,270112,0,3,2
77187,5,3,270114,270114,270117,0,3,2
77188,4,2,270118,270118,270120,0,2,1
77189,6,2,270124,270124,270126,0,2,4
77190,3,3,270127,270127,270130,0,3,1
77191,2,2,270129,270130,270132,1,3,0
77192,2,2,270131,270132,270134,1,3,0
77193,4,2,270135,270135,270137,0,2,1
77194,2,1,270137,270137,270138,0,1,0
77195,1,2,270138,270138,270140,0,2,0
77196,1,2,270139,270140,270142,1,3,0
77197,3,1,270142,270142,270143,0,1,0
77198,4,3,270146,270146,270149,0,3,3
77199,1,2,270147,270149,270151,2,4,0
77200,6,3,270153,270153,270156,0,3,2
77201,3,2,270156,270156,270158,0,2,0
77202,1,2,270157,270158,270160,1,3,0
77203,6,3,270163,270163,270166,0,3,3
77204,5,1,270168,270168,270169,0,1,2
77205,1,2,270169,270169,270171,0,2,0
77206,1,2,270170,270171,270173,1,3,0
77207,4,3,270174,270174,270177,0,3,1
77208,3,1,270177,270177,270178,0,1,0
77209,3,2,270180,270180,270182,0,2,2
77210,1,3,270181,270182,270185,1,4,0
77211,5,2,270186,270186,270188,0,2,1
77212,2,3,270188,270188,270191,0,3,0
77213,6,2,270194,270194,270196,0,2,3
77214,2,3,270196,270196,270199,0,3,0
77215,1,2,270197,270199,270201,2,4,0
77216,5,2,270202,270202,270204,0,2,1
77217,4,3,270206,270206,270209,0,3,2
77218,5,2,270211,270211,270213,0,2,2
77219,1,2,270212,270213,270215,1,3,0
77220,5,1,270217,270217,270218,0,1,2
77221,6,3,270223,270223,270226,0,3,5
77222,5,3,270228,270228,270231,0,3,2
77223,1,3,270229,270231,270234,2,5,0
77224,6,2,270235,270235,270237,0,2,1
77225,2,2,270237,270237,270239,0,2,0
77226,6,2,270243,270243,270245,0,2,4
77227,3,3,270246,270246,270249,0,3,1
77228,4,2,270250,270250,270252,0,2,1
77229,5,1,270255,270255,270256,0,1,3
77230,4,3,270259,270259,270262,0,3,3
77231,3,3,270262,270262,270265,0,3,0
77232,4,2,270266,270266,270268,0,2,1
77233,5,3,270271,270271,270274,0,3,3
77234,4,2,270275,270275,270277,0,2,1
77235,2,3,270277,270277,270280,0,3,0
77236,3,2,270280,270280,270282,0,2,0
77237,2,2,270282,270282,270284,0,2,0
77238,2,1,270284,270284,270285,0,1,0
77239,1,1,270285,270285,270286,0,1,0
77240,5,2,270290,270290,270292,0,2,4
77241,4,1,270294,270294,270295,0,1,2
77242,1,3,270295,270295,270298,0,3,0
77243,4,2,270299,270299,270301,0,2,1
77244,4,2,270303,270303,270305,0,2,2
77245,2,2,270305,270305,270307,0,2,0
77246,3,2,270308,270308,270310,0,2,1
77247,3,3,270311,270311,270314,0,3,1
77248,1,3,270312,270314,270317,2,5,0
77249,6,2,270318,270318,270320,0,2,1
77250,5,2,270323,270323,270325,0,2,3
77251,2,1,270325,270325,270326,0,1,0
77252,2,1,270327,270327,270328,0,1,1
77253,4,1,270331,270331,270332,0,1,3
77254,4,3,270335,270335,270338,0,3,3
77255,4,1,270339,270339,270340,0,1,1
77256,2,2,270341,270341,270343,0,2,1
77257,5,3,270346,270346,270349,0,3,3
77258,4,2,270350,270350,270352,0,2,1
77259,2,2,270352,270352,270354,0,2,0
77260,4,3,270356,270356,270359,0,3,2
77261,6,2,270362,270362,270364,0,2,3
77262,6,1,270368,270368,270369,0,1,4
77263,1,2,270369,270369,270371,0,2,0
77264,1,2,270370,270371,270373,1,3,0
77265,6,1,270376,270376,270377,0,1,3
77266,4,2,270380,270380,270382,0,2,3
77267,3,3,270383,270383,270386,0,3,1
77268,6,1,270389,270389,270390,0,1,3
77269,6,1,270395,270395,270396,0,1,5
77270,1,2,270396,270396,270398,0,2,0
77271,3,1,270399,270399,270400,0,1,1
77272,2,2,270401,270401,270403,0,2,1
77273,3,3,270404,270404,270407,0,3,1
77274,2,2,270406,270407,270409,1,3,0
77275,2,1,270408,270409,270410,1,2,0
77276,3,3,270411,270411,270414,0,3,1
77277,1,2,270412,270414,270416,2,4,0
77278,4,3,270416,270416,270419,0,3,0
77279,2,2,270418,270419,270421,1,3,0
77280,6,2,270424,270424,270426,0,2,3
77281,5,2,270429,270429,270431,0,2,3
77282,4,2,270433,270433,270435,0,2,2
77283,2,3,270435,270435,270438,0,3,0
77284,6,1,270441,270441,270442,0,1,3
77285,1,2,270442,270442,270444,0,2,0
77286,4,3,270446,270446,270449,0,3,2
77287,4,1,270450,270450,270451,0,1,1
77288,3,3,270453,270453,270456,0,3,2
77289,4,1,270457,270457,270458,0,1,1
77290,4,3,270461,270461,270464,0,3,3
77291,3,2,270464,270464,270466,0,2,0
77292,5,1,270469,270469,270470,0,1,3
77293,3,3,270472,270472,270475,0,3,2
77294,4,1,270476,270476,270477,0,1,1
77295,4,1,270480,270480,270481,0,1,3
77296,4,1,270484,270484,270485,0,1,3
77297,6,2,270490,270490,270492,0,2,5
77298,1,3,270491,270492,270495,1,4,0
77299,6,2,270497,270497,270499,0,2,2
77300,2,3,270499,270499,270502,0,3,0
77301,6,2,270505,270505,270507,0,2,3
77302,2,2,270507,270507,270509,0,2,0
77303,5,2,270512,270512,270514,0,2,3
77304,1,1,270513,270514,270515,1,2,0
77305,2,3,270515,270515,270518,0,3,0
77306,3,3,270518,270518,270521,0,3,0
77307,4,1,270522,270522,270523,0,1,1
77308,4,3,270526,270526,270529,0,3,3
77309,4,2,270530,270530,270532,0,2,1
77310,6,2,270536,270536,270538,0,2,4
77311,3,1,270539,270539,270540,0,1,1
77312,5,2,270544,270544,270546,0,2,4
77313,5,2,270549,270549,270551,0,2,3
77314,5,2,270554,270554,270556,0,2,3
77315,4,2,270558,270558,270560,0,2,2
77316,2,3,270560,270560,270563,0,3,0
77317,4,2,270564,270564,270566,0,2,1
77318,2,2,270566,270566,270568,0,2,0
77319,4,2,270570,270570,270572,0,2,2
77320,5,2,270575,270575,270577,0,2,3
77321,3,1,270578,270578,270579,0,1,1
77322,5,1,270583,270583,270584,0,1,4
77323,4,1,270587,270587,270588,0,1,3
77324,6,1,270593,270593,270594,0,1,5
77325,4,1,270597,270597,270598,0,1,3
77326,6,2,270603,270603,270605,0,2,5
77327,5,3,270608,270608,270611,0,3,3
77328,4,3,270612,270612,270615,0,3,1
77329,6,1,270618,270618,270619,0,1,3
77330,1,3,270619,270619,270622,0,3,0
77331,3,2,270622,270622,270624,0,2,0
77332,2,1,270624,270624,270625,0,1,0
77333,2,1,270626,270626,270627,0,1,1
77334,5,2,270631,270631,270633,0,2,4
77335,6,3,270637,270637,270640,0,3,4
77336,6,1,270643,270643,270644,0,1,3
77337,5,1,270648,270648,270649,0,1,4
77338,3,3,270651,270651,270654,0,3,2
77339,1,2,270652,270654,270656,2,4,0
77340,6,3,270658,270658,270661,0,3,2
77341,3,3,270661,270661,270664,0,3,0
77342,2,1,270663,270664,270665,1,2,0
77343,2,3,270665,270665,270668,0,3,0
77344,3,2,270668,270668,270670,0,2,0
77345,3,3,270671,270671,270674,0,3,1
77346,6,1,270677,270677,270678,0,1,3
77347,2,1,270679,270679,270680,0,1,1
77348,1,3,270680,270680,270683,0,3,0
77349,2,1,270682,270683,270684,1,2,0
77350,3,1,270685,270685,270686,0,1,1
77351,6,3,270691,270691,270694,0,3,5
77352,3,3,270694,270694,270697,0,3,0
77353,1,3,270695,270697,270700,2,5,0
77354,3,3,270698,270700,270703,2,5,0
77355,2,3,270700,270703,270706,3,6,0
77356,6,1,270706,270706,270707,0,1,0
77357,4,1,270710,270710,270711,0,1,3
77358,2,3,270712,270712,270715,0,3,1
77359,2,3,270714,270715,270718,1,4,0
77360,2,3,270716,270718,270721,2,5,0
77361,2,3,270718,270721,270724,3,6,0
77362,6,1,270724,270724,270725,0,1,0
77363,6,1,270730,270730,270731,0,1,5
77364,1,3,270731,270731,270734,0,3,0
77365,2,3,270733,270734,270737,1,4,0
77366,6,3,270739,270739,270742,0,3,2
77367,3,2,270742,270742,270744,0,2,0
77368,3,3,270745,270745,270748,0,3,1
77369,6,2,270751,270751,270753,0,2,3
77370,5,2,270756,270756,270758,0,2,3
77371,1,1,270757,270758,270759,1,2,0
77372,4,2,270761,270761,270763,0,2,2
77373,5,1,270766,270766,270767,0,1,3
77374,6,3,270772,270772,270775,0,3,5
77375,1,1,270773,270775,270776,2,3,0
77376,6,3,270779,270779,270782,0,3,3
77377,4,2,270783,270783,270785,0,2,1
77378,6,2,270789,270789,270791,0,2,4
77379,1,3,270790,270791,270794,1,4,0
77380,5,2,270795,270795,270797,0,2,1
77381,6,2,270801,270801,270803,0,2,4
77382,6,3,270807,270807,270810,0,3,4
77383,3,3,270810,270810,270813,0,3,0
77384,5,2,270815,270815,270817,0,2,2
77385,5,3,270820,270820,270823,0,3,3
77386,2,2,270822,270823,270825,1,3,0
77387,3,1,270825,270825,270826,0,1,0
77388,4,1,270829,270829,270830,0,1,3
77389,5,2,270834,270834,270836,0,2,4
77390,6,1,270840,270840,270841,0,1,4
77391,3,1,270843,270843,270844,0,1,2
77392,3,2,270846,270846,270848,0,2,2
77393,5,3,270851,270851,270854,0,3,3
77394,2,2,270853,270854,270856,1,3,0
77395,5,3,270858,270858,270861,0,3,2
77396,5,3,270863,270863,270866,0,3,2
77397,6,3,270869,270869,270872,0,3,3
77398,2,3,270871,270872,270875,1,4,0
77399,1,1,270872,270875,270876,3,4,0
77400,4,2,270876,270876,270878,0,2,0
77401,2,2,270878,270878,270880,0,2,0
77402,5,1,270883,270883,270884,0,1,3
77403,2,3,270885,270885,270888,0,3,1
77404,3,1,270888,270888,270889,0,1,0
77405,3,1,270891,270891,270892,0,1,2
77406,6,3,270897,270897,270900,0,3,5
77407,6,3,270903,270903,270906,0,3,3
77408,3,1,270906,270906,270907,0,1,0
77409,2,2,270908,270908,270910,0,2,1
77410,2,3,270910,270910,270913,0,3,0
77411,3,1,270913,270913,270914,0,1,0
77412,4,2,270917,270917,270919,0,2,3
77413,1,1,270918,270919,270920,1,2,0
77414,1,1,270919,270920,270921,1,2,0
77415,5,3,270924,270924,270927,0,3,3
77416,2,2,270926,270927,270929,1,3,0
77417,6,2,270932,270932,270934,0,2,3
77418,2,1,270934,270934,270935,0,1,0
77419,6,2,270940,270940,270942,0,2,5
77420,5,2,270945,270945,270947,0,2,3
77421,2,3,270947,270947,270950,0,3,0
77422,6,1,270953,270953,270954,0,1,3
77423,3,3,270956,270956,270959,0,3,2
77424,4,3,270960,270960,270963,0,3,1
77425,4,2,270964,270964,270966,0,2,1
77426,3,1,270967,270967,270968,0,1,1
77427,3,1,270970,270970,270971,0,1,2
77428,5,3,270975,270975,270978,0,3,4
77429,3,2,270978,270978,270980,0,2,0
77430,1,2,270979,270980,270982,1,3,0
77431,3,3,270982,270982,270985,0,3,0
77432,4,3,270986,270986,270989,0,3,1
77433,5,3,270991,270991,270994,0,3,2
77434,5,3,270996,270996,270999,0,3,2
77435,3,2,270999,270999,271001,0,2,0
77436,4,2,271003,271003,271005,0,2,2
77437,4,3,271007,271007,271010,0,3,2
77438,5,2,271012,271012,271014,0,2,2
77439,5,1,271017,271017,271018,0,1,3
77440,3,2,271020,271020,271022,0,2,2
77441,3,3,271023,271023,271026,0,3,1
77442,3,2,271026,271026,271028,0,2,0
77443,2,1,271028,271028,271029,0,1,0
77444,4,1,271032,271032,271033,0,1,3
77445,6,2,271038,271038,271040,0,2,5
77446,2,3,271040,271040,271043,0,3,0
77447,6,3,271046,271046,271049,0,3,3
77448,2,2,271048,271049,271051,1,3,0
77449,6,1,271054,271054,271055,0,1,3
77450,5,1,271059,271059,271060,0,1,4
77451,4,1,271063,271063,271064,0,1,3
77452,6,3,271069,271069,271072,0,3,5
77453,2,1,271071,271072,271073,1,2,0
77454,1,1,271072,271073,271074,1,2,0
77455,2,3,271074,271074,271077,0,3,0
77456,1,1,271075,271077,271078,2,3,0
77457,3,3,271078,271078,271081,0,3,0
77458,3,1,271081,271081,271082,0,1,0
77459,6,1,271087,271087,271088,0,1,5
77460,5,1,271092,271092,271093,0,1,4
77461,6,3,271098,271098,271101,0,3,5
77462,4,3,271102,271102,271105,0,3,1
77463,6,1,271108,271108,271109,0,1,3
77464,3,3,271111,271111,271114,0,3,2
77465,6,1,271117,271117,271118,0,1,3
77466,6,3,271123,271123,271126,0,3,5
77467,2,1,271125,271126,271127,1,2,0
77468,6,1,271131,271131,271132,0,1,4
77469,5,2,271136,271136,271138,0,2,4
77470,3,3,271139,271139,271142,0,3,1
77471,2,2,271141,271142,271144,1,3,0
77472,4,2,271145,271145,271147,0,2,1
77473,6,2,271151,271151,271153,0,2,4
77474,2,2,271153,271153,271155,0,2,0
77475,3,1,271156,271156,271157,0,1,1
77476,2,1,271158,271158,271159,0,1,1
77477,3,3,271161,271161,271164,0,3,2
77478,6,3,271167,271167,271170,0,3,3
77479,5,3,271172,271172,271175,0,3,2
77480,6,3,271178,271178,271181,0,3,3
77481,4,3,271182,271182,271185,0,3,1
77482,6,3,271188,271188,271191,0,3,3
77483,1,2,271189,271191,271193,2,4,0
77484,2,3,271191,271193,271196,2,5,0
77485,5,2,271196,271196,271198,0,2,0
77486,6,1,271202,271202,271203,0,1,4
77487,1,2,271203,271203,271205,0,2,0
77488,1,1,271204,271205,271206,1,2,0
77489,6,2,271210,271210,271212,0,2,4
77490,4,1,271214,271214,271215,0,1,2
77491,6,2,271220,271220,271222,0,2,5
77492,1,2,271221,271222,271224,1,3,0
77493,6,3,271227,271227,271230,0,3,3
77494,3,2,271230,271230,271232,0,2,0
77495,3,1,271233,271233,271234,0,1,1
77496,3,2,271236,271236,271238,0,2,2
77497,4,3,271240,271240,271243,0,3,2
77498,5,2,271245,271245,271247,0,2,2
77499,3,3,271248,271248,271251,0,3,1
77500,1,2,271249,271251,271253,2,4,0
77501,4,3,271253,271253,271256,0,3,0
77502,1,2,271254,271256,271258,2,4,0
77503,5,3,271259,271259,271262,0,3,1
77504,4,2,271263,271263,271265,0,2,1
77505,3,3,271266,271266,271269,0,3,1
77506,1,2,271267,271269,271271,2,4,0
77507,5,1,271272,271272,271273,0,1,1
77508,1,1,271273,271273,271274,0,1,0
77509,5,3,271278,271278,271281,0,3,4
77510,3,2,271281,271281,271283,0,2,0
77511,6,3,271287,271287,271290,0,3,4
77512,2,3,271289,271290,271293,1,4,0
77513,6,1,271295,271295,271296,0,1,2
77514,5,1,271300,271300,271301,0,1,4
77515,2,3,271302,271302,271305,0,3,1
77516,5,1,271307,271307,271308,0,1,2
77517,4,1,271311,271311,271312,0,1,3
77518,1,2,271312,271312,271314,0,2,0
77519,5,3,271317,271317,271320,0,3,3
77520,4,1,271321,271321,271322,0,1,1
77521,6,2,271327,271327,271329,0,2,5
77522,4,3,271331,271331,271334,0,3,2
77523,5,2,271336,271336,271338,0,2,2
77524,2,3,271338,271338,271341,0,3,0
77525,5,2,271343,271343,271345,0,2,2
77526,3,3,271346,271346,271349,0,3,1
77527,4,3,271350,271350,271353,0,3,1
77528,1,1,271351,271353,271354,2,3,0
77529,1,1,271352,271354,271355,2,3,0
77530,4,2,271356,271356,271358,0,2,1
77531,5,2,271361,271361,271363,0,2,3
77532,6,2,271367,271367,271369,0,2,4
77533,3,3,271370,271370,271373,0,3,1
77534,2,1,271372,271373,271374,1,2,0
77535,2,2,271374,271374,271376,0,2,0
77536,1,2,271375,271376,271378,1,3,0
77537,2,1,271377,271378,271379,1,2,0
77538,5,3,271382,271382,271385,0,3,3
77539,3,2,271385,271385,271387,0,2,0
77540,4,1,271389,271389,271390,0,1,2
77541,6,3,271395,271395,271398,0,3,5
77542,6,3,271401,271401,271404,0,3,3
77543,4,1,271405,271405,271406,0,1,1
77544,1,3,271406,271406,271409,0,3,0
77545,4,1,271410,271410,271411,0,1,1
77546,6,2,271416,271416,271418,0,2,5
77547,1,3,271417,271418,271421,1,4,0
77548,1,3,271418,271421,271424,3,6,0
77549,2,2,271420,271424,271426,4,6,0
77550,2,1,271422,271426,271427,4,5,0
77551,4,1,271426,271427,271428,1,2,0
77552,1,2,271427,271428,271430,1,3,0
77553,1,3,271428,271430,271433,2,5,0
77554,2,3,271430,271433,271436,3,6,0
77555,6,2,271436,271436,271438,0,2,0
77556,5,2,271441,271441,271443,0,2,3
77557,2,2,271443,271443,271445,0,2,0
77558,6,1,271449,271449,271450,0,1,4
77559,6,2,271455,271455,271457,0,2,5
77560,1,1,271456,271457,271458,1,2,0
77561,6,2,271462,271462,271464,0,2,4
77562,6,2,271468,271468,271470,0,2,4
77563,1,2,271469,271470,271472,1,3,0
77564,6,1,271475,271475,271476,0,1,3
77565,4,3,271479,271479,271482,0,3,3
77566,4,3,271483,271483,271486,0,3,1
77567,1,1,271484,271486,271487,2,3,0
77568,4,3,271488,271488,271491,0,3,1
77569,4,2,271492,271492,271494,0,2,1
77570,2,2,271494,271494,271496,0,2,0
77571,4,1,271498,271498,271499,0,1,2
77572,4,3,271502,271502,271505,0,3,3
77573,3,2,271505,271505,271507,0,2,0
77574,2,2,271507,271507,271509,0,2,0
77575,5,3,271512,271512,271515,0,3,3
77576,6,2,271518,271518,271520,0,2,3
77577,1,2,271519,271520,271522,1,3,0
77578,3,2,271522,271522,271524,0,2,0
77579,5,2,271527,271527,271529,0,2,3
77580,2,1,271529,271529,271530,0,1,0
77581,2,1,271531,271531,271532,0,1,1
77582,1,2,271532,271532,271534,0,2,0
77583,4,3,271536,271536,271539,0,3,2
77584,3,1,271539,271539,271540,0,1,0
77585,3,2,271542,271542,271544,0,2,2
77586,5,3,271547,271547,271550,0,3,3
77587,5,3,271552,271552,271555,0,3,2
77588,5,1,271557,271557,271558,0,1,2
77589,6,3,271563,271563,271566,0,3,5
77590,1,2,271564,271566,271568,2,4,0
77591,4,3,271568,271568,271571,0,3,0
77592,3,3,271571,271571,271574,0,3,0
77593,1,2,271572,271574,271576,2,4,0
77594,2,3,271574,271576,271579,2,5,0
77595,3,1,271577,271579,271580,2,3,0
77596,2,1,271579,271580,271581,1,2,0
77597,3,1,271582,271582,271583,0,1,1
77598,2,2,271584,271584,271586,0,2,1
77599,5,2,271589,271589,271591,0,2,3
77600,4,3,271593,271593,271596,0,3,2
77601,1,1,271594,271596,271597,2,3,0
77602,2,2,271596,271597,271599,1,3,0
77603,3,3,271599,271599,271602,0,3,0
77604,3,3,271602,271602,271605,0,3,0
77605,4,2,271606,271606,271608,0,2,1
77606,5,1,271611,271611,271612,0,1,3
77607,4,2,271615,271615,271617,0,2,3
77608,4,2,271619,271619,271621,0,2,2
77609,1,1,271620,271621,271622,1,2,0
77610,1,2,271621,271622,271624,1,3,0
77611,2,2,271623,271624,271626,1,3,0
77612,1,2,271624,271626,271628,2,4,0
77613,5,1,271629,271629,271630,0,1,1
77614,2,3,271631,271631,271634,0,3,1
77615,6,2,271637,271637,271639,0,2,3
77616,3,3,271640,271640,271643,0,3,1
77617,6,2,271646,271646,271648,0,2,3
77618,4,2,271650,271650,271652,0,2,2
77619,5,2,271655,271655,271657,0,2,3
77620,4,2,271659,271659,271661,0,2,2
77621,6,2,271665,271665,271667,0,2,4
77622,5,3,271670,271670,271673,0,3,3
77623,5,3,271675,271675,271678,0,3,2
77624,4,1,271679,271679,271680,0,1,1
77625,3,2,271682,271682,271684,0,2,2
77626,3,3,271685,271685,271688,0,3,1
77627,3,3,271688,271688,271691,0,3,0
77628,2,1,271690,271691,271692,1,2,0
77629,1,1,271691,271692,271693,1,2,0
77630,5,1,271696,271696,271697,0,1,3
77631,3,2,271699,271699,271701,0,2,2
77632,2,1,271701,271701,271702,0,1,0
77633,5,1,271706,271706,271707,0,1,4
77634,4,1,271710,271710,271711,0,1,3
77635,6,1,271716,271716,271717,0,1,5
77636,1,1,271717,271717,271718,0,1,0
77637,6,2,271723,271723,271725,0,2,5
77638,3,2,271726,271726,271728,0,2,1
77639,2,3,271728,271728,271731,0,3,0
77640,5,1,271733,271733,271734,0,1,2
77641,5,2,271738,271738,271740,0,2,4
77642,4,1,271742,271742,271743,0,1,2
77643,2,1,271744,271744,271745,0,1,1
77644,4,1,271748,271748,271749,0,1,3
77645,3,2,271751,271751,271753,0,2,2
77646,1,3,271752,271753,271756,1,4,0
77647,6,3,271758,271758,271761,0,3,2
77648,2,3,271760,271761,271764,1,4,0
77649,3,3,271763,271764,271767,1,4,0
77650,6,3,271769,271769,271772,0,3,2
77651,4,2,271773,271773,271775,0,2,1
77652,2,1,271775,271775,271776,0,1,0
77653,2,2,271777,271777,271779,0,2,1
77654,3,1,271780,271780,271781,0,1,1
77655,2,1,271782,271782,271783,0,1,1
77656,3,2,271785,271785,271787,0,2,2
77657,3,1,271788,271788,271789,0,1,1
77658,3,3,271791,271791,271794,0,3,2
77659,5,2,271796,271796,271798,0,2,2
77660,6,2,271802,271802,271804,0,2,4
77661,5,2,271807,271807,271809,0,2,3
77662,5,1,271812,271812,271813,0,1,3
77663,6,1,271818,271818,271819,0,1,5
77664,1,1,271819,271819,271820,0,1,0
77665,6,2,271825,271825,271827,0,2,5
77666,3,3,271828,271828,271831,0,3,1
77667,1,1,271829,271831,271832,2,3,0
77668,4,3,271833,271833,271836,0,3,1
77669,6,2,271839,271839,271841,0,2,3
77670,5,3,271844,271844,271847,0,3,3
77671,2,2,271846,271847,271849,1,3,0
77672,3,3,271849,271849,271852,0,3,0
77673,2,3,271851,271852,271855,1,4,0
77674,6,2,271857,271857,271859,0,2,2
77675,3,2,271860,271860,271862,0,2,1
77676,2,1,271862,271862,271863,0,1,0
77677,6,1,271868,271868,271869,0,1,5
77678,3,2,271871,271871,271873,0,2,2
77679,2,2,271873,271873,271875,0,2,0
77680,1,3,271874,271875,271878,1,4,0
77681,1,1,271875,271878,271879,3,4,0
77682,3,3,271878,271879,271882,1,4,0
77683,2,2,271880,271882,271884,2,4,0
77684,5,2,271885,271885,271887,0,2,1
77685,5,2,271890,271890,271892,0,2,3
77686,2,2,271892,271892,271894,0,2,0
77687,2,3,271894,271894,271897,0,3,0
77688,6,3,271900,271900,271903,0,3,3
77689,3,3,271903,271903,271906,0,3,0
77690,4,2,271907,271907,271909,0,2,1
77691,5,1,271912,271912,271913,0,1,3
77692,2,1,271914,271914,271915,0,1,1
77693,5,1,271919,271919,271920,0,1,4
77694,4,3,271923,271923,271926,0,3,3
77695,6,2,271929,271929,271931,0,2,3
77696,4,3,271933,271933,271936,0,3,2
77697,3,2,271936,271936,271938,0,2,0
77698,2,3,271938,271938,271941,0,3,0
77699,1,1,271939,271941,271942,2,3,0
77700,4,2,271943,271943,271945,0,2,1
77701,3,2,271946,271946,271948,0,2,1
77702,1,3,271947,271948,271951,1,4,0
77703,1,2,271948,271951,271953,3,5,0
77704,4,1,271952,271953,271954,1,2,0
77705,3,1,271955,271955,271956,0,1,1
77706,1,2,271956,271956,271958,0,2,0
77707,5,1,271961,271961,271962,0,1,3
77708,6,2,271967,271967,271969,0,2,5
77709,4,1,271971,271971,271972,0,1,2
77710,4,2,271975,271975,271977,0,2,3
77711,2,1,271977,271977,271978,0,1,0
77712,2,3,271979,271979,271982,0,3,1
77713,2,3,271981,271982,271985,1,4,0
77714,2,1,271983,271985,271986,2,3,0
77715,4,3,271987,271987,271990,0,3,1
77716,6,2,271993,271993,271995,0,2,3
77717,5,2,271998,271998,272000,0,2,3
77718,1,1,271999,272000,272001,1,2,0
77719,1,3,272000,272001,272004,1,4,0
77720,1,1,272001,272004,272005,3,4,0
77721,3,2,272004,272005,272007,1,3,0
77722,6,2,272010,272010,272012,0,2,3
77723,4,1,272014,272014,272015,0,1,2
77724,3,2,272017,272017,272019,0,2,2
77725,6,2,272023,272023,272025,0,2,4
77726,4,3,272027,272027,272030,0,3,2
77727,3,2,272030,272030,272032,0,2,0
77728,5,1,272035,272035,272036,0,1,3
77729,5,2,272040,272040,272042,0,2,4
77730,6,2,272046,272046,272048,0,2,4
77731,3,3,272049,272049,272052,0,3,1
77732,3,1,272052,272052,272053,0,1,0
77733,1,2,272053,272053,272055,0,2,0
77734,4,3,272057,272057,272060,0,3,2
77735,5,3,272062,272062,272065,0,3,2
77736,1,1,272063,272065,272066,2,3,0
77737,6,1,272069,272069,272070,0,1,3
77738,4,2,272073,272073,272075,0,2,3
77739,5,1,272078,272078,272079,0,1,3
77740,2,3,272080,272080,272083,0,3,1
77741,2,2,272082,272083,272085,1,3,0
77742,2,3,272084,272085,272088,1,4,0
77743,2,2,272086,272088,272090,2,4,0
77744,3,2,272089,272090,272092,1,3,0
77745,3,3,272092,272092,272095,0,3,0
77746,5,2,272097,272097,272099,0,2,2
77747,3,1,272100,272100,272101,0,1,1
77748,5,1,272105,272105,272106,0,1,4
77749,4,2,272109,272109,272111,0,2,3
77750,3,2,272112,272112,272114,0,2,1
77751,6,1,272118,272118,272119,0,1,4
77752,5,2,272123,272123,272125,0,2,4
77753,3,3,272126,272126,272129,0,3,1
77754,1,2,272127,272129,272131,2,4,0
77755,1,3,272128,272131,272134,3,6,0
77756,1,2,272129,272134,272136,5,7,0
77757,5,3,272134,272136,272139,2,5,0
77758,6,1,272140,272140,272141,0,1,1
77759,1,1,272141,272141,272142,0,1,0
77760,4,3,272145,272145,272148,0,3,3
77761,4,2,272149,272149,272151,0,2,1
77762,4,1,272153,272153,272154,0,1,2
77763,4,1,272157,272157,272158,0,1,3
77764,2,3,272159,272159,272162,0,3,1
77765,4,3,272163,272163,272166,0,3,1
77766,2,3,272165,272166,272169,1,4,0
77767,4,3,272169,272169,272172,0,3,0
77768,5,1,272174,272174,272175,0,1,2
77769,5,1,272179,272179,272180,0,1,4
77770,3,3,272182,272182,272185,0,3,2
77771,1,2,272183,272185,272187,2,4,0
77772,2,1,272185,272187,272188,2,3,0
77773,4,1,272189,272189,272190,0,1,1
77774,3,3,272192,272192,272195,0,3,2
77775,5,1,272197,272197,272198,0,1,2
77776,4,2,272201,272201,272203,0,2,3
77777,6,2,272207,272207,272209,0,2,4
77778,4,3,272211,272211,272214,0,3,2
77779,6,2,272217,272217,272219,0,2,3
77780,6,3,272223,272223,272226,0,3,4
77781,3,1,272226,272226,272227,0,1,0
77782,5,3,272231,272231,272234,0,3,4
77783,5,3,272236,272236,272239,0,3,2
77784,5,1,272241,272241,272242,0,1,2
77785,3,3,272244,272244,272247,0,3,2
77786,1,3,272245,272247,272250,2,5,0
77787,1,2,272246,272250,272252,4,6,0
77788,5,3,272251,272252,272255,1,4,0
77789,1,1,272252,272255,272256,3,4,0
77790,1,3,272253,272256,272259,3,6,0
77791,2,2,272255,272259,272261,4,6,0
77792,1,3,272256,272261,272264,5,8,0
77793,4,1,272260,272264,272265,4,5,0
77794,4,2,272264,272265,272267,1,3,0
77795,2,1,272266,272267,272268,1,2,0
77796,6,2,272272,272272,272274,0,2,4
77797,6,2,272278,272278,272280,0,2,4
77798,4,1,272282,272282,272283,0,1,2
77799,6,3,272288,272288,272291,0,3,5
77800,1,2,272289,272291,272293,2,4,0
77801,5,3,272294,272294,272297,0,3,1
77802,3,2,272297,272297,272299,0,2,0
77803,3,1,272300,272300,272301,0,1,1
77804,2,1,272302,272302,272303,0,1,1
77805,1,3,272303,272303,272306,0,3,0
77806,2,3,272305,272306,272309,1,4,0
77807,5,2,272310,272310,272312,0,2,1
77808,1,3,272311,272312,272315,1,4,0
77809,1,2,272312,272315,272317,3,5,0
77810,5,2,272317,272317,272319,0,2,0
77811,2,2,272319,272319,272321,0,2,0
77812,3,3,272322,272322,272325,0,3,1
77813,1,1,272323,272325,272326,2,3,0
77814,1,1,272324,272326,272327,2,3,0
77815,1,3,272325,272327,272330,2,5,0
77816,1,3,272326,272330,272333,4,7,0
77817,5,1,272331,272333,272334,2,3,0
77818,2,2,272333,272334,272336,1,3,0
77819,2,2,272335,272336,272338,1,3,0
77820,4,2,272339,272339,272341,0,2,1
77821,3,3,272342,272342,272345,0,3,1
77822,6,1,272348,272348,272349,0,1,3
77823,6,3,272354,272354,272357,0,3,5
77824,4,2,272358,272358,272360,0,2,1
77825,3,1,272361,272361,272362,0,1,1
77826,5,2,272366,272366,272368,0,2,4
77827,3,1,272369,272369,272370,0,1,1
77828,5,2,272374,272374,272376,0,2,4
77829,5,1,272379,272379,272380,0,1,3
77830,2,3,272381,272381,272384,0,3,1
77831,6,2,272387,272387,272389,0,2,3
77832,2,3,272389,272389,272392,0,3,0
77833,2,1,272391,272392,272393,1,2,0
77834,1,3,272392,272393,272396,1,4,0
77835,6,2,272398,272398,272400,0,2,2
77836,5,1,272403,272403,272404,0,1,3
77837,1,3,272404,272404,272407,0,3,0
77838,5,1,272409,272409,272410,0,1,2
77839,2,2,272411,272411,272413,0,2,1
77840,5,1,272416,272416,272417,0,1,3
77841,5,1,272421,272421,272422,0,1,4
77842,1,1,272422,272422,272423,0,1,0
77843,3,2,272425,272425,272427,0,2,2
77844,4,1,272429,272429,272430,0,1,2
77845,5,3,272434,272434,272437,0,3,4
77846,4,1,272438,272438,272439,0,1,1
77847,3,1,272441,272441,272442,0,1,2
77848,6,2,272447,272447,272449,0,2,5
77849,3,2,272450,272450,272452,0,2,1
77850,3,2,272453,272453,272455,0,2,1
77851,6,1,272459,272459,272460,0,1,4
77852,1,3,272460,272460,272463,0,3,0
77853,6,3,272466,272466,272469,0,3,3
77854,2,3,272468,272469,272472,1,4,0
77855,2,3,272470,272472,272475,2,5,0
77856,6,2,272476,272476,272478,0,2,1
77857,3,1,272479,272479,272480,0,1,1
77858,4,1,272483,272483,272484,0,1,3
77859,3,3,272486,272486,272489,0,3,2
77860,1,1,272487,272489,272490,2,3,0
77861,1,2,272488,272490,272492,2,4,0
77862,1,2,272489,272492,272494,3,5,0
77863,1,1,272490,272494,272495,4,5,0
77864,5,3,272495,272495,272498,0,3,0
77865,5,2,272500,272500,272502,0,2,2
77866,1,3,272501,272502,272505,1,4,0
77867,1,2,272502,272505,272507,3,5,0
77868,2,1,272504,272507,272508,3,4,0
77869,3,3,272507,272508,272511,1,4,0
77870,3,2,272510,272511,272513,1,3,0
77871,1,2,272511,272513,272515,2,4,0
77872,2,3,272513,272515,272518,2,5,0
77873,1,2,272514,272518,272520,4,6,0
77874,3,3,272517,272520,272523,3,6,0
77875,1,2,272518,272523,272525,5,7,0
77876,1,3,272519,272525,272528,6,9,0
77877,3,1,272522,272528,272529,6,7,0
77878,3,2,272525,272529,272531,4,6,0
77879,5,2,272530,272531,272533,1,3,0
77880,5,2,272535,272535,272537,0,2,2
77881,1,2,272536,272537,272539,1,3,0
77882,2,3,272538,272539,272542,1,4,0
77883,6,3,272544,272544,272547,0,3,2
77884,5,1,272549,272549,272550,0,1,2
77885,3,3,272552,272552,272555,0,3,2
77886,2,2,272554,272555,272557,1,3,0
77887,1,2,272555,272557,272559,2,4,0
77888,4,2,272559,272559,272561,0,2,0
77889,2,2,272561,272561,272563,0,2,0
77890,2,1,272563,272563,272564,0,1,0
77891,3,1,272566,272566,272567,0,1,2
77892,4,2,272570,272570,272572,0,2,3
77893,3,2,272573,272573,272575,0,2,1
77894,1,2,272574,272575,272577,1,3,0
77895,1,1,272575,272577,272578,2,3,0
77896,1,1,272576,272578,272579,2,3,0
77897,1,3,272577,272579,272582,2,5,0
77898,4,1,272581,272582,272583,1,2,0
77899,4,2,272585,272585,272587,0,2,2
77900,1,2,272586,272587,272589,1,3,0
77901,6,1,272592,272592,272593,0,1,3
77902,4,1,272596,272596,272597,0,1,3
77903,4,1,272600,272600,272601,0,1,3
77904,5,1,272605,272605,272606,0,1,4
77905,4,1,272609,272609,272610,0,1,3
77906,1,2,272610,272610,272612,0,2,0
77907,6,3,272616,272616,272619,0,3,4
77908,6,2,272622,272622,272624,0,2,3
77909,6,1,272628,272628,272629,0,1,4
77910,1,3,272629,272629,272632,0,3,0
77911,2,3,272631,272632,272635,1,4,0
77912,1,3,272632,272635,272638,3,6,0
77913,2,2,272634,272638,272640,4,6,0
77914,3,1,272637,272640,272641,3,4,0
77915,4,1,272641,272641,272642,0,1,0
77916,2,2,272643,272643,272645,0,2,1
77917,5,3,272648,272648,272651,0,3,3
77918,4,2,272652,272652,272654,0,2,1
77919,5,2,272657,272657,272659,0,2,3
77920,6,2,272663,272663,272665,0,2,4
77921,2,3,272665,272665,272668,0,3,0
77922,4,3,272669,272669,272672,0,3,1
77923,5,3,272674,272674,272677,0,3,2
77924,6,1,272680,272680,272681,0,1,3
77925,5,3,272685,272685,272688,0,3,4
77926,4,2,272689,272689,272691,0,2,1
77927,4,1,272693,272693,272694,0,1,2
77928,5,1,272698,272698,272699,0,1,4
77929,1,1,272699,272699,272700,0,1,0
77930,1,3,272700,272700,272703,0,3,0
77931,2,3,272702,272703,272706,1,4,0
77932,3,3,272705,272706,272709,1,4,0
77933,4,2,272709,272709,272711,0,2,0
77934,3,2,272712,272712,272714,0,2,1
77935,2,2,272714,272714,272716,0,2,0
77936,6,1,272720,272720,272721,0,1,4
77937,4,1,272724,272724,272725,0,1,3
77938,5,1,272729,272729,272730,0,1,4
77939,1,1,272730,272730,272731,0,1,0
77940,6,1,272736,272736,272737,0,1,5
77941,3,2,272739,272739,272741,0,2,2
77942,4,3,272743,272743,272746,0,3,2
77943,5,2,272748,272748,272750,0,2,2
77944,6,3,272754,272754,272757,0,3,4
77945,2,3,272756,272757,272760,1,4,0
77946,1,2,272757,272760,272762,3,5,0
77947,1,3,272758,272762,272765,4,7,0
77948,4,3,272762,272765,272768,3,6,0
77949,3,3,272765,272768,272771,3,6,0
77950,2,2,272767,272771,272773,4,6,0
77951,4,1,272771,272773,272774,2,3,0
77952,6,2,272777,272777,272779,0,2,3
77953,6,3,272783,272783,272786,0,3,4
77954,1,3,272784,272786,272789,2,5,0
77955,1,2,272785,272789,272791,4,6,0
77956,3,3,272788,272791,272794,3,6,0
77957,2,2,272790,272794,272796,4,6,0
77958,5,3,272795,272796,272799,1,4,0
77959,3,2,272798,272799,272801,1,3,0
77960,4,3,272802,272802,272805,0,3,1
77961,2,2,272804,272805,272807,1,3,0
77962,1,3,272805,272807,272810,2,5,0
77963,2,1,272807,272810,272811,3,4,0
77964,6,1,272813,272813,272814,0,1,2
77965,3,2,272816,272816,272818,0,2,2
77966,1,3,272817,272818,272821,1,4,0
77967,2,2,272819,272821,272823,2,4,0
77968,1,3,272820,272823,272826,3,6,0
77969,4,2,272824,272826,272828,2,4,0
77970,1,1,272825,272828,272829,3,4,0
77971,1,3,272826,272829,272832,3,6,0
77972,6,3,272832,272832,272835,0,3,0
77973,4,2,272836,272836,272838,0,2,1
77974,5,3,272841,272841,272844,0,3,3
77975,2,1,272843,272844,272845,1,2,0
77976,2,2,272845,272845,272847,0,2,0
77977,2,1,272847,272847,272848,0,1,0
77978,2,2,272849,272849,272851,0,2,1
77979,6,2,272855,272855,272857,0,2,4
77980,4,2,272859,272859,272861,0,2,2
77981,3,3,272862,272862,272865,0,3,1
77982,5,2,272867,272867,272869,0,2,2
77983,5,3,272872,272872,272875,0,3,3
77984,2,1,272874,272875,272876,1,2,0
77985,3,3,272877,272877,272880,0,3,1
77986,4,1,272881,272881,272882,0,1,1
77987,6,2,272887,272887,272889,0,2,5
77988,3,1,272890,272890,272891,0,1,1
77989,5,2,272895,272895,272897,0,2,4
77990,6,3,272901,272901,272904,0,3,4
77991,5,2,272906,272906,272908,0,2,2
77992,1,2,272907,272908,272910,1,3,0
77993,2,1,272909,272910,272911,1,2,0
77994,1,3,272910,272911,272914,1,4,0
77995,6,1,272916,272916,272917,0,1,2
77996,4,1,272920,272920,272921,0,1,3
77997,3,2,272923,272923,272925,0,2,2
77998,5,1,272928,272928,272929,0,1,3
77999,4,3,272932,272932,272935,0,3,3
78000,2,3,272934,272935,272938,1,4,0
78001,6,2,272940,272940,272942,0,2,2
78002,1,1,272941,272942,272943,1,2,0
78003,3,2,272944,272944,272946,0,2,1
78004,3,3,272947,272947,272950,0,3,1
78005,6,2,272953,272953,272955,0,2,3
78006,3,1,272956,272956,272957,0,1,1
78007,5,3,272961,272961,272964,0,3,4
78008,6,2,272967,272967,272969,0,2,3
78009,3,2,272970,272970,272972,0,2,1
78010,6,3,272976,272976,272979,0,3,4
78011,6,2,272982,272982,272984,0,2,3
78012,4,1,272986,272986,272987,0,1,2
78013,6,1,272992,272992,272993,0,1,5
78014,6,3,272998,272998,273001,0,3,5
78015,4,3,273002,273002,273005,0,3,1
78016,6,1,273008,273008,273009,0,1,3
78017,1,3,273009,273009,273012,0,3,0
78018,2,3,273011,273012,273015,1,4,0
78019,4,3,273015,273015,273018,0,3,0
78020,2,1,273017,273018,273019,1,2,0
78021,6,1,273023,273023,273024,0,1,4
78022,1,1,273024,273024,273025,0,1,0
78023,2,1,273026,273026,273027,0,1,1
78024,2,2,273028,273028,273030,0,2,1
78025,2,3,273030,273030,273033,0,3,0
78026,6,3,273036,273036,273039,0,3,3
78027,4,2,273040,273040,273042,0,2,1
78028,3,2,273043,273043,273045,0,2,1
78029,6,2,273049,273049,273051,0,2,4
78030,4,2,273053,273053,273055,0,2,2
78031,5,2,273058,273058,273060,0,2,3
78032,1,1,273059,273060,273061,1,2,0
78033,2,2,273061,273061,273063,0,2,0
78034,6,2,273067,273067,273069,0,2,4
78035,6,2,273073,273073,273075,0,2,4
78036,2,3,273075,273075,273078,0,3,0
78037,4,3,273079,273079,273082,0,3,1
78038,4,1,273083,273083,273084,0,1,1
78039,2,3,273085,273085,273088,0,3,1
78040,6,3,273091,273091,273094,0,3,3
78041,3,2,273094,273094,273096,0,2,0
78042,5,3,273099,273099,273102,0,3,3
78043,6,1,273105,273105,273106,0,1,3
78044,4,3,273109,273109,273112,0,3,3
78045,1,3,273110,273112,273115,2,5,0
78046,6,3,273116,273116,273119,0,3,1
78047,2,3,273118,273119,273122,1,4,0
78048,1,3,273119,273122,273125,3,6,0
78049,2,1,273121,273125,273126,4,5,0
78050,1,1,273122,273126,273127,4,5,0
78051,2,2,273124,273127,273129,3,5,0
78052,3,3,273127,273129,273132,2,5,0
78053,1,1,273128,273132,273133,4,5,0
78054,2,1,273130,273133,273134,3,4,0
78055,4,1,273134,273134,273135,0,1,0
78056,2,3,273136,273136,273139,0,3,1
78057,1,3,273137,273139,273142,2,5,0
78058,1,2,273138,273142,273144,4,6,0
78059,3,1,273141,273144,273145,3,4,0
78060,3,1,273144,273145,273146,1,2,0
78061,2,2,273146,273146,273148,0,2,0
78062,3,1,273149,273149,273150,0,1,1
78063,6,3,273155,273155,273158,0,3,5
78064,1,2,273156,273158,273160,2,4,0
78065,2,3,273158,273160,273163,2,5,0
78066,5,1,273163,273163,273164,0,1,0
78067,2,1,273165,273165,273166,0,1,1
78068,5,2,273170,273170,273172,0,2,4
78069,1,3,273171,273172,273175,1,4,0
78070,4,1,273175,273175,273176,0,1,0
78071,6,2,273181,273181,273183,0,2,5
78072,2,1,273183,273183,273184,0,1,0
78073,1,3,273184,273184,273187,0,3,0
78074,3,3,273187,273187,273190,0,3,0
78075,5,3,273192,273192,273195,0,3,2
78076,6,2,273198,273198,273200,0,2,3
78077,2,2,273200,273200,273202,0,2,0
78078,6,3,273206,273206,273209,0,3,4
78079,4,2,273210,273210,273212,0,2,1
78080,1,2,273211,273212,273214,1,3,0
78081,2,2,273213,273214,273216,1,3,0
78082,2,1,273215,273216,273217,1,2,0
78083,3,1,273218,273218,273219,0,1,1
78084,5,1,273223,273223,273224,0,1,4
78085,3,1,273226,273226,273227,0,1,2
78086,4,1,273230,273230,273231,0,1,3
78087,1,2,273231,273231,273233,0,2,0
78088,4,1,273235,273235,273236,0,1,2
78089,4,1,273239,273239,273240,0,1,3
78090,4,3,273243,273243,273246,0,3,3
78091,6,2,273249,273249,273251,0,2,3
78092,6,3,273255,273255,273258,0,3,4
78093,3,1,273258,273258,273259,0,1,0
78094,1,3,273259,273259,273262,0,3,0
78095,1,2,273260,273262,273264,2,4,0
78096,5,2,273265,273265,273267,0,2,1
78097,5,2,273270,273270,273272,0,2,3
78098,6,3,273276,273276,273279,0,3,4
78099,5,3,273281,273281,273284,0,3,2
78100,1,1,273282,273284,273285,2,3,0
78101,5,2,273287,273287,273289,0,2,2
78102,5,3,273292,273292,273295,0,3,3
78103,5,3,273297,273297,273300,0,3,2
78104,5,3,273302,273302,273305,0,3,2
78105,1,1,273303,273305,273306,2,3,0
78106,3,3,273306,273306,273309,0,3,0
78107,6,3,273312,273312,273315,0,3,3
78108,2,3,273314,273315,273318,1,4,0
78109,4,1,273318,273318,273319,0,1,0
78110,5,1,273323,273323,273324,0,1,4
78111,4,2,273327,273327,273329,0,2,3
78112,1,1,273328,273329,273330,1,2,0
78113,4,3,273332,273332,273335,0,3,2
78114,5,2,273337,273337,273339,0,2,2
78115,3,1,273340,273340,273341,0,1,1
78116,6,3,273346,273346,273349,0,3,5
78117,3,2,273349,273349,273351,0,2,0
78118,1,2,273350,273351,273353,1,3,0
78119,2,2,273352,273353,273355,1,3,0
78120,2,3,273354,273355,273358,1,4,0
78121,4,3,273358,273358,273361,0,3,0
78122,6,2,273364,273364,273366,0,2,3
78123,6,1,273370,273370,273371,0,1,4
78124,2,1,273372,273372,273373,0,1,1
78125,1,2,273373,273373,273375,0,2,0
78126,4,1,273377,273377,273378,0,1,2
78127,6,1,273383,273383,273384,0,1,5
78128,2,1,273385,273385,273386,0,1,1
78129,3,2,273388,273388,273390,0,2,2
78130,4,3,273392,273392,273395,0,3,2
78131,6,3,273398,273398,273401,0,3,3
78132,5,1,273403,273403,273404,0,1,2
78133,4,2,273407,273407,273409,0,2,3
78134,2,3,273409,273409,273412,0,3,0
78135,5,3,273414,273414,273417,0,3,2
78136,6,1,273420,273420,273421,0,1,3
78137,5,2,273425,273425,273427,0,2,4
78138,4,1,273429,273429,273430,0,1,2
78139,1,3,273430,273430,273433,0,3,0
78140,6,2,273436,273436,273438,0,2,3
78141,2,1,273438,273438,273439,0,1,0
78142,1,3,273439,273439,273442,0,3,0
78143,5,1,273444,273444,273445,0,1,2
78144,4,3,273448,273448,273451,0,3,3
78145,3,3,273451,273451,273454,0,3,0
78146,1,3,273452,273454,273457,2,5,0
78147,2,1,273454,273457,273458,3,4,0
78148,2,3,273456,273458,273461,2,5,0
78149,5,3,273461,273461,273464,0,3,0
78150,2,3,273463,273464,273467,1,4,0
78151,3,3,273466,273467,273470,1,4,0
78152,6,1,273472,273472,273473,0,1,2
78153,1,1,273473,273473,273474,0,1,0
78154,1,3,273474,273474,273477,0,3,0
78155,3,3,273477,273477,273480,0,3,0
78156,6,3,273483,273483,273486,0,3,3
78157,3,2,273486,273486,273488,0,2,0
78158,4,3,273490,273490,273493,0,3,2
78159,3,1,273493,273493,273494,0,1,0
78160,4,2,273497,273497,273499,0,2,3
78161,1,3,273498,273499,273502,1,4,0
78162,1,2,273499,273502,273504,3,5,0
78163,6,3,273505,273505,273508,0,3,1
78164,1,2,273506,273508,273510,2,4,0
78165,1,2,273507,273510,273512,3,5,0
78166,5,1,273512,273512,273513,0,1,0
78167,5,3,273517,273517,273520,0,3,4
78168,4,2,273521,273521,273523,0,2,1
78169,1,1,273522,273523,273524,1,2,0
78170,3,2,273525,273525,273527,0,2,1
78171,6,3,273531,273531,273534,0,3,4
78172,2,2,273533,273534,273536,1,3,0
78173,2,3,273535,273536,273539,1,4,0
78174,3,1,273538,273539,273540,1,2,0
78175,2,3,273540,273540,273543,0,3,0
78176,4,1,273544,273544,273545,0,1,1
78177,2,1,273546,273546,273547,0,1,1
78178,3,2,273549,273549,273551,0,2,2
78179,3,1,273552,273552,273553,0,1,1
78180,6,3,273558,273558,273561,0,3,5
78181,6,3,273564,273564,273567,0,3,3
78182,1,1,273565,273567,273568,2,3,0
78183,5,1,273570,273570,273571,0,1,2
78184,1,1,273571,273571,273572,0,1,0
78185,2,3,273573,273573,273576,0,3,1
78186,6,3,273579,273579,273582,0,3,3
78187,2,2,273581,273582,273584,1,3,0
78188,1,2,273582,273584,273586,2,4,0
78189,6,1,273588,273588,273589,0,1,2
78190,2,1,273590,273590,273591,0,1,1
78191,2,2,273592,273592,273594,0,2,1
78192,5,3,273597,273597,273600,0,3,3
78193,5,3,273602,273602,273605,0,3,2
78194,3,2,273605,273605,273607,0,2,0
78195,1,1,273606,273607,273608,1,2,0
78196,3,3,273609,273609,273612,0,3,1
78197,1,3,273610,273612,273615,2,5,0
78198,5,2,273615,273615,273617,0,2,0
78199,6,3,273621,273621,273624,0,3,4
78200,4,1,273625,273625,273626,0,1,1
78201,4,3,273629,273629,273632,0,3,3
78202,5,1,273634,273634,273635,0,1,2
78203,3,2,273637,273637,273639,0,2,2
78204,2,2,273639,273639,273641,0,2,0
78205,3,1,273642,273642,273643,0,1,1
78206,6,2,273648,273648,273650,0,2,5
78207,6,2,273654,273654,273656,0,2,4
78208,3,1,273657,273657,273658,0,1,1
78209,1,2,273658,273658,273660,0,2,0
78210,1,2,273659,273660,273662,1,3,0
78211,4,2,273663,273663,273665,0,2,1
78212,5,3,273668,273668,273671,0,3,3
78213,5,1,273673,273673,273674,0,1,2
78214,2,2,273675,273675,273677,0,2,1
78215,5,3,273680,273680,273683,0,3,3
78216,5,1,273685,273685,273686,0,1,2
78217,1,2,273686,273686,273688,0,2,0
78218,2,2,273688,273688,273690,0,2,0
78219,3,2,273691,273691,273693,0,2,1
78220,3,1,273694,273694,273695,0,1,1
78221,5,3,273699,273699,273702,0,3,4
78222,1,3,273700,273702,273705,2,5,0
78223,2,1,273702,273705,273706,3,4,0
78224,1,2,273703,273706,273708,3,5,0
78225,2,2,273705,273708,273710,3,5,0
78226,6,2,273711,273711,273713,0,2,1
78227,3,1,273714,273714,273715,0,1,1
78228,1,1,273715,273715,273716,0,1,0
78229,4,3,273719,273719,273722,0,3,3
78230,1,3,273720,273722,273725,2,5,0
78231,4,3,273724,273725,273728,1,4,0
78232,5,1,273729,273729,273730,0,1,1
78233,6,2,273735,273735,273737,0,2,5
78234,3,3,273738,273738,273741,0,3,1
78235,4,1,273742,273742,273743,0,1,1
78236,5,2,273747,273747,273749,0,2,4
78237,1,2,273748,273749,273751,1,3,0
78238,4,2,273752,273752,273754,0,2,1
78239,5,3,273757,273757,273760,0,3,3
78240,2,2,273759,273760,273762,1,3,0
78241,2,1,273761,273762,273763,1,2,0
78242,6,3,273767,273767,273770,0,3,4
78243,2,2,273769,273770,273772,1,3,0
78244,1,2,273770,273772,273774,2,4,0
78245,2,1,273772,273774,273775,2,3,0
78246,1,2,273773,273775,273777,2,4,0
78247,6,3,273779,273779,273782,0,3,2
78248,6,1,273785,273785,273786,0,1,3
78249,6,3,273791,273791,273794,0,3,5
78250,3,3,273794,273794,273797,0,3,0
78251,4,1,273798,273798,273799,0,1,1
78252,6,3,273804,273804,273807,0,3,5
78253,1,3,273805,273807,273810,2,5,0
78254,2,1,273807,273810,273811,3,4,0
78255,6,2,273813,273813,273815,0,2,2
78256,1,2,273814,273815,273817,1,3,0
78257,5,2,273819,273819,273821,0,2,2
78258,6,2,273825,273825,273827,0,2,4
78259,5,2,273830,273830,273832,0,2,3
78260,1,2,273831,273832,273834,1,3,0
78261,4,3,273835,273835,273838,0,3,1
78262,5,3,273840,273840,273843,0,3,2
78263,4,1,273844,273844,273845,0,1,1
78264,6,1,273850,273850,273851,0,1,5
78265,5,2,273855,273855,273857,0,2,4
78266,4,2,273859,273859,273861,0,2,2
78267,2,3,273861,273861,273864,0,3,0
78268,1,2,273862,273864,273866,2,4,0
78269,4,3,273866,273866,273869,0,3,0
78270,3,2,273869,273869,273871,0,2,0
78271,3,3,273872,273872,273875,0,3,1
78272,4,3,273876,273876,273879,0,3,1
78273,6,2,273882,273882,273884,0,2,3
78274,3,1,273885,273885,273886,0,1,1
78275,5,2,273890,273890,273892,0,2,4
78276,6,1,273896,273896,273897,0,1,4
78277,6,3,273902,273902,273905,0,3,5
78278,5,1,273907,273907,273908,0,1,2
78279,1,1,273908,273908,273909,0,1,0
78280,2,3,273910,273910,273913,0,3,1
78281,3,3,273913,273913,273916,0,3,0
78282,6,3,273919,273919,273922,0,3,3
78283,1,2,273920,273922,273924,2,4,0
78284,4,1,273924,273924,273925,0,1,0
78285,6,3,273930,273930,273933,0,3,5
78286,5,1,273935,273935,273936,0,1,2
78287,4,1,273939,273939,273940,0,1,3
78288,6,3,273945,273945,273948,0,3,5
78289,5,2,273950,273950,273952,0,2,2
78290,4,2,273954,273954,273956,0,2,2
78291,6,1,273960,273960,273961,0,1,4
78292,3,1,273963,273963,273964,0,1,2
78293,3,2,273966,273966,273968,0,2,2
78294,3,3,273969,273969,273972,0,3,1
78295,6,1,273975,273975,273976,0,1,3
78296,4,3,273979,273979,273982,0,3,3
78297,2,1,273981,273982,273983,1,2,0
78298,2,2,273983,273983,273985,0,2,0
78299,1,1,273984,273985,273986,1,2,0
78300,5,2,273989,273989,273991,0,2,3
78301,4,3,273993,273993,273996,0,3,2
78302,6,2,273999,273999,274001,0,2,3
78303,5,1,274004,274004,274005,0,1,3
78304,5,3,274009,274009,274012,0,3,4
78305,1,1,274010,274012,274013,2,3,0
78306,5,2,274015,274015,274017,0,2,2
78307,2,1,274017,274017,274018,0,1,0
78308,5,2,274022,274022,274024,0,2,4
78309,3,2,274025,274025,274027,0,2,1
78310,6,1,274031,274031,274032,0,1,4
78311,2,1,274033,274033,274034,0,1,1
78312,3,3,274036,274036,274039,0,3,2
78313,5,2,274041,274041,274043,0,2,2
78314,1,1,274042,274043,274044,1,2,0
78315,2,3,274044,274044,274047,0,3,0
78316,3,3,274047,274047,274050,0,3,0
78317,2,2,274049,274050,274052,1,3,0
78318,5,3,274054,274054,274057,0,3,2
78319,3,2,274057,274057,274059,0,2,0
78320,6,2,274063,274063,274065,0,2,4
78321,3,3,274066,274066,274069,0,3,1
78322,6,2,274072,274072,274074,0,2,3
78323,6,3,274078,274078,274081,0,3,4
78324,5,3,274083,274083,274086,0,3,2
78325,5,2,274088,274088,274090,0,2,2
78326,3,1,274091,274091,274092,0,1,1
78327,3,3,274094,274094,274097,0,3,2
78328,2,2,274096,274097,274099,1,3,0
78329,1,2,274097,274099,274101,2,4,0
78330,5,1,274102,274102,274103,0,1,1
78331,5,3,274107,274107,274110,0,3,4
78332,2,2,274109,274110,274112,1,3,0
78333,5,3,274114,274114,274117,0,3,2
78334,4,2,274118,274118,274120,0,2,1
78335,6,1,274124,274124,274125,0,1,4
78336,6,2,274130,274130,274132,0,2,5
78337,4,1,274134,274134,274135,0,1,2
78338,5,3,274139,274139,274142,0,3,4
78339,3,1,274142,274142,274143,0,1,0
78340,2,2,274144,274144,274146,0,2,1
78341,2,3,274146,274146,274149,0,3,0
78342,1,2,274147,274149,274151,2,4,0
78343,1,2,274148,274151,274153,3,5,0
78344,1,3,274149,274153,274156,4,7,0
78345,6,1,274155,274156,274157,1,2,0
78346,2,2,274157,274157,274159,0,2,0
78347,1,1,274158,274159,274160,1,2,0
78348,3,3,274161,274161,274164,0,3,1
78349,6,3,274167,274167,274170,0,3,3
78350,4,3,274171,274171,274174,0,3,1
78351,1,2,274172,274174,274176,2,4,0
78352,4,1,274176,274176,274177,0,1,0
78353,4,3,274180,274180,274183,0,3,3
78354,6,2,274186,274186,274188,0,2,3
78355,2,1,274188,274188,274189,0,1,0
78356,2,1,274190,274190,274191,0,1,1
78357,5,3,274195,274195,274198,0,3,4
78358,6,3,274201,274201,274204,0,3,3
78359,3,2,274204,274204,274206,0,2,0
78360,4,1,274208,274208,274209,0,1,2
78361,5,1,274213,274213,274214,0,1,4
78362,4,2,274217,274217,274219,0,2,3
78363,6,1,274223,274223,274224,0,1,4
78364,4,3,274227,274227,274230,0,3,3
78365,3,2,274230,274230,274232,0,2,0
78366,3,3,274233,274233,274236,0,3,1
78367,6,1,274239,274239,274240,0,1,3
78368,4,3,274243,274243,274246,0,3,3
78369,5,3,274248,274248,274251,0,3,2
78370,3,3,274251,274251,274254,0,3,0
78371,4,2,274255,274255,274257,0,2,1
78372,5,3,274260,274260,274263,0,3,3
78373,2,3,274262,274263,274266,1,4,0
78374,2,1,274264,274266,274267,2,3,0
78375,6,2,274270,274270,274272,0,2,3
78376,5,1,274275,274275,274276,0,1,3
78377,5,1,274280,274280,274281,0,1,4
78378,5,2,274285,274285,274287,0,2,4
78379,3,1,274288,274288,274289,0,1,1
78380,3,3,274291,274291,274294,0,3,2
78381,2,2,274293,274294,274296,1,3,0
78382,3,3,274296,274296,274299,0,3,0
78383,6,1,274302,274302,274303,0,1,3
78384,3,1,274305,274305,274306,0,1,2
78385,5,1,274310,274310,274311,0,1,4
78386,6,1,274316,274316,274317,0,1,5
78387,6,3,274322,274322,274325,0,3,5
78388,6,1,274328,274328,274329,0,1,3
78389,2,1,274330,274330,274331,0,1,1
78390,1,3,274331,274331,274334,0,3,0
78391,3,1,274334,274334,274335,0,1,0
78392,6,3,274340,274340,274343,0,3,5
78393,2,1,274342,274343,274344,1,2,0
78394,6,3,274348,274348,274351,0,3,4
78395,6,1,274354,274354,274355,0,1,3
78396,4,2,274358,274358,274360,0,2,3
78397,4,2,274362,274362,274364,0,2,2
78398,3,3,274365,274365,274368,0,3,1
78399,4,3,274369,274369,274372,0,3,1
78400,6,3,274375,274375,274378,0,3,3
78401,6,1,274381,274381,274382,0,1,3
78402,6,1,274387,274387,274388,0,1,5
78403,2,1,274389,274389,274390,0,1,1
78404,3,3,274392,274392,274395,0,3,2
78405,1,2,274393,274395,274397,2,4,0
78406,3,2,274396,274397,274399,1,3,0
78407,2,3,274398,274399,274402,1,4,0
78408,2,2,274400,274402,274404,2,4,0
78409,3,1,274403,274404,274405,1,2,0
78410,6,1,274409,274409,274410,0,1,4
78411,3,3,274412,274412,274415,0,3,2
78412,5,3,274417,274417,274420,0,3,2
78413,4,3,274421,274421,274424,0,3,1
78414,5,3,274426,274426,274429,0,3,2
78415,5,3,274431,274431,274434,0,3,2
78416,1,1,274432,274434,274435,2,3,0
78417,1,3,274433,274435,274438,2,5,0
78418,1,2,274434,274438,274440,4,6,0
78419,6,2,274440,274440,274442,0,2,0
78420,5,3,274445,274445,274448,0,3,3
78421,3,2,274448,274448,274450,0,2,0
78422,5,1,274453,274453,274454,0,1,3
78423,5,1,274458,274458,274459,0,1,4
78424,5,1,274463,274463,274464,0,1,4
78425,1,1,274464,274464,274465,0,1,0
78426,4,2,274468,274468,274470,0,2,3
78427,5,1,274473,274473,274474,0,1,3
78428,5,2,274478,274478,274480,0,2,4
78429,1,3,274479,274480,274483,1,4,0
78430,3,1,274482,274483,274484,1,2,0
78431,3,2,274485,274485,274487,0,2,1
78432,5,3,274490,274490,274493,0,3,3
78433,2,2,274492,274493,274495,1,3,0
78434,1,2,274493,274495,274497,2,4,0
78435,6,2,274499,274499,274501,0,2,2
78436,6,1,274505,274505,274506,0,1,4
78437,4,3,274509,274509,274512,0,3,3
78438,3,1,274512,274512,274513,0,1,0
78439,6,2,274518,274518,274520,0,2,5
78440,6,1,274524,274524,274525,0,1,4
78441,1,2,274525,274525,274527,0,2,0
78442,2,1,274527,274527,274528,0,1,0
78443,1,1,274528,274528,274529,0,1,0
78444,6,2,274534,274534,274536,0,2,5
78445,3,2,274537,274537,274539,0,2,1
78446,6,3,274543,274543,274546,0,3,4
78447,5,1,274548,274548,274549,0,1,2
78448,1,3,274549,274549,274552,0,3,0
78449,5,1,274554,274554,274555,0,1,2
78450,6,2,274560,274560,274562,0,2,5
78451,6,3,274566,274566,274569,0,3,4
78452,1,2,274567,274569,274571,2,4,0
78453,6,3,274573,274573,274576,0,3,2
78454,6,2,274579,274579,274581,0,2,3
78455,2,2,274581,274581,274583,0,2,0
78456,1,2,274582,274583,274585,1,3,0
78457,3,3,274585,274585,274588,0,3,0
78458,4,1,274589,274589,274590,0,1,1
78459,3,1,274592,274592,274593,0,1,2
78460,2,2,274594,274594,274596,0,2,1
78461,3,1,274597,274597,274598,0,1,1
78462,3,1,274600,274600,274601,0,1,2
78463,5,3,274605,274605,274608,0,3,4
78464,4,3,274609,274609,274612,0,3,1
78465,6,3,274615,274615,274618,0,3,3
78466,6,3,274621,274621,274624,0,3,3
78467,2,1,274623,274624,274625,1,2,0
78468,2,2,274625,274625,274627,0,2,0
78469,3,3,274628,274628,274631,0,3,1
78470,2,2,274630,274631,274633,1,3,0
78471,5,1,274635,274635,274636,0,1,2
78472,6,1,274641,274641,274642,0,1,5
78473,5,2,274646,274646,274648,0,2,4
78474,1,1,274647,274648,274649,1,2,0
78475,3,3,274650,274650,274653,0,3,1
78476,4,1,274654,274654,274655,0,1,1
78477,2,2,274656,274656,274658,0,2,1
78478,1,3,274657,274658,274661,1,4,0
78479,4,3,274661,274661,274664,0,3,0
78480,1,1,274662,274664,274665,2,3,0
78481,4,3,274666,274666,274669,0,3,1
78482,6,3,274672,274672,274675,0,3,3
78483,1,2,274673,274675,274677,2,4,0
78484,5,3,274678,274678,274681,0,3,1
78485,2,3,274680,274681,274684,1,4,0
78486,1,1,274681,274684,274685,3,4,0
78487,2,1,274683,274685,274686,2,3,0
78488,6,3,274689,274689,274692,0,3,3
78489,5,1,274694,274694,274695,0,1,2
78490,6,3,274700,274700,274703,0,3,5
78491,5,1,274705,274705,274706,0,1,2
78492,2,3,274707,274707,274710,0,3,1
78493,3,1,274710,274710,274711,0,1,0
78494,5,3,274715,274715,274718,0,3,4
78495,5,2,274720,274720,274722,0,2,2
78496,2,1,274722,274722,274723,0,1,0
78497,2,3,274724,274724,274727,0,3,1
78498,2,3,274726,274727,274730,1,4,0
78499,1,2,274727,274730,274732,3,5,0
78500,3,2,274730,274732,274734,2,4,0
78501,5,3,274735,274735,274738,0,3,1
78502,6,1,274741,274741,274742,0,1,3
78503,6,1,274747,274747,274748,0,1,5
78504,6,3,274753,274753,274756,0,3,5
78505,6,1,274759,274759,274760,0,1,3
78506,3,3,274762,274762,274765,0,3,2
78507,3,1,274765,274765,274766,0,1,0
78508,3,2,274768,274768,274770,0,2,2
78509,6,3,274774,274774,274777,0,3,4
78510,5,1,274779,274779,274780,0,1,2
78511,1,2,274780,274780,274782,0,2,0
78512,6,3,274786,274786,274789,0,3,4
78513,2,3,274788,274789,274792,1,4,0
78514,4,2,274792,274792,274794,0,2,0
78515,5,3,274797,274797,274800,0,3,3
78516,6,1,274803,274803,274804,0,1,3
78517,4,2,274807,274807,274809,0,2,3
78518,6,2,274813,274813,274815,0,2,4
78519,6,3,274819,274819,274822,0,3,4
78520,3,2,274822,274822,274824,0,2,0
78521,4,2,274826,274826,274828,0,2,2
78522,1,3,274827,274828,274831,1,4,0
78523,6,3,274833,274833,274836,0,3,2
78524,4,1,274837,274837,274838,0,1,1
78525,6,1,274843,274843,274844,0,1,5
78526,6,3,274849,274849,274852,0,3,5
78527,5,3,274854,274854,274857,0,3,2
78528,4,3,274858,274858,274861,0,3,1
78529,4,2,274862,274862,274864,0,2,1
78530,5,3,274867,274867,274870,0,3,3
78531,2,3,274869,274870,274873,1,4,0
78532,3,1,274872,274873,274874,1,2,0
78533,4,1,274876,274876,274877,0,1,2
78534,6,2,274882,274882,274884,0,2,5
78535,6,2,274888,274888,274890,0,2,4
78536,3,3,274891,274891,274894,0,3,1
78537,4,1,274895,274895,274896,0,1,1
78538,1,2,274896,274896,274898,0,2,0
78539,3,1,274899,274899,274900,0,1,1
78540,2,3,274901,274901,274904,0,3,1
78541,6,2,274907,274907,274909,0,2,3
78542,6,1,274913,274913,274914,0,1,4
78543,1,1,274914,274914,274915,0,1,0
78544,1,1,274915,274915,274916,0,1,0
78545,5,1,274920,274920,274921,0,1,4
78546,4,1,274924,274924,274925,0,1,3
78547,6,2,274930,274930,274932,0,2,5
78548,4,1,274934,274934,274935,0,1,2
78549,6,3,274940,274940,274943,0,3,5
78550,5,3,274945,274945,274948,0,3,2
78551,1,2,274946,274948,274950,2,4,0
78552,4,1,274950,274950,274951,0,1,0
78553,3,1,274953,274953,274954,0,1,2
78554,5,1,274958,274958,274959,0,1,4
78555,6,1,274964,274964,274965,0,1,5
78556,6,2,274970,274970,274972,0,2,5
78557,3,3,274973,274973,274976,0,3,1
78558,3,2,274976,274976,274978,0,2,0
78559,1,3,274977,274978,274981,1,4,0
78560,2,3,274979,274981,274984,2,5,0
78561,2,1,274981,274984,274985,3,4,0
78562,3,1,274984,274985,274986,1,2,0
78563,6,3,274990,274990,274993,0,3,4
78564,5,1,274995,274995,274996,0,1,2
78565,1,2,274996,274996,274998,0,2,0
78566,6,2,275002,275002,275004,0,2,4
78567,5,1,275007,275007,275008,0,1,3
78568,4,2,275011,275011,275013,0,2,3
78569,1,3,275012,275013,275016,1,4,0
78570,2,3,275014,275016,275019,2,5,0
78571,1,1,275015,275019,275020,4,5,0
78572,6,2,275021,275021,275023,0,2,1
78573,2,1,275023,275023,275024,0,1,0
78574,4,2,275027,275027,275029,0,2,3
78575,1,1,275028,275029,275030,1,2,0
78576,4,1,275032,275032,275033,0,1,2
78577,5,2,275037,275037,275039,0,2,4
78578,6,1,275043,275043,275044,0,1,4
78579,3,2,275046,275046,275048,0,2,2
78580,6,3,275052,275052,275055,0,3,4
78581,3,2,275055,275055,275057,0,2,0
78582,2,2,275057,275057,275059,0,2,0
78583,4,2,275061,275061,275063,0,2,2
78584,5,1,275066,275066,275067,0,1,3
78585,6,1,275072,275072,275073,0,1,5
78586,1,1,275073,275073,275074,0,1,0
78587,4,3,275077,275077,275080,0,3,3
78588,6,2,275083,275083,275085,0,2,3
78589,4,2,275087,275087,275089,0,2,2
78590,4,1,275091,275091,275092,0,1,2
78591,6,2,275097,275097,275099,0,2,5
78592,3,1,275100,275100,275101,0,1,1
78593,2,1,275102,275102,275103,0,1,1
78594,6,1,275108,275108,275109,0,1,5
78595,3,3,275111,275111,275114,0,3,2
78596,3,3,275114,275114,275117,0,3,0
78597,1,1,275115,275117,275118,2,3,0
78598,3,1,275118,275118,275119,0,1,0
78599,2,3,275120,275120,275123,0,3,1
78600,4,1,275124,275124,275125,0,1,1
78601,1,2,275125,275125,275127,0,2,0
78602,3,3,275128,275128,275131,0,3,1
78603,2,2,275130,275131,275133,1,3,0
78604,4,3,275134,275134,275137,0,3,1
78605,5,2,275139,275139,275141,0,2,2
78606,5,1,275144,275144,275145,0,1,3
78607,1,2,275145,275145,275147,0,2,0
78608,4,3,275149,275149,275152,0,3,2
78609,3,3,275152,275152,275155,0,3,0
78610,3,1,275155,275155,275156,0,1,0
78611,3,2,275158,275158,275160,0,2,2
78612,3,2,275161,275161,275163,0,2,1
78613,3,3,275164,275164,275167,0,3,1
78614,1,1,275165,275167,275168,2,3,0
78615,3,2,275168,275168,275170,0,2,0
78616,2,2,275170,275170,275172,0,2,0
78617,2,1,275172,275172,275173,0,1,0
78618,4,2,275176,275176,275178,0,2,3
78619,3,3,275179,275179,275182,0,3,1
78620,3,1,275182,275182,275183,0,1,0
78621,6,2,275188,275188,275190,0,2,5
78622,1,2,275189,275190,275192,1,3,0
78623,6,1,275195,275195,275196,0,1,3
78624,3,1,275198,275198,275199,0,1,2
78625,3,2,275201,275201,275203,0,2,2
78626,2,2,275203,275203,275205,0,2,0
78627,4,1,275207,275207,275208,0,1,2
78628,5,3,275212,275212,275215,0,3,4
78629,6,1,275218,275218,275219,0,1,3
78630,3,1,275221,275221,275222,0,1,2
78631,2,3,275223,275223,275226,0,3,1
78632,6,3,275229,275229,275232,0,3,3
78633,1,2,275230,275232,275234,2,4,0
78634,3,3,275233,275234,275237,1,4,0
78635,1,1,275234,275237,275238,3,4,0
78636,3,2,275237,275238,275240,1,3,0
78637,5,3,275242,275242,275245,0,3,2
78638,5,1,275247,275247,275248,0,1,2
78639,5,1,275252,275252,275253,0,1,4
78640,2,3,275254,275254,275257,0,3,1
78641,6,3,275260,275260,275263,0,3,3
78642,4,3,275264,275264,275267,0,3,1
78643,6,2,275270,275270,275272,0,2,3
78644,2,1,275272,275272,275273,0,1,0
78645,2,3,275274,275274,275277,0,3,1
78646,2,3,275276,275277,275280,1,4,0
78647,2,2,275278,275280,275282,2,4,0
78648,1,3,275279,275282,275285,3,6,0
78649,5,1,275284,275285,275286,1,2,0
78650,4,2,275288,275288,275290,0,2,2
78651,6,1,275294,275294,275295,0,1,4
78652,1,2,275295,275295,275297,0,2,0
78653,3,1,275298,275298,275299,0,1,1
78654,6,2,275304,275304,275306,0,2,5
78655,4,1,275308,275308,275309,0,1,2
78656,1,3,275309,275309,275312,0,3,0
78657,3,3,275312,275312,275315,0,3,0
78658,3,2,275315,275315,275317,0,2,0
78659,3,3,275318,275318,275321,0,3,1
78660,2,2,275320,275321,275323,1,3,0
78661,2,2,275322,275323,275325,1,3,0
78662,1,1,275323,275325,275326,2,3,0
78663,5,2,275328,275328,275330,0,2,2
78664,3,2,275331,275331,275333,0,2,1
78665,6,2,275337,275337,275339,0,2,4
78666,6,1,275343,275343,275344,0,1,4
78667,4,1,275347,275347,275348,0,1,3
78668,1,2,275348,275348,275350,0,2,0
78669,4,3,275352,275352,275355,0,3,2
78670,4,1,275356,275356,275357,0,1,1
78671,2,1,275358,275358,275359,0,1,1
78672,4,1,275362,275362,275363,0,1,3
78673,1,2,275363,275363,275365,0,2,0
78674,4,3,275367,275367,275370,0,3,2
78675,1,1,275368,275370,275371,2,3,0
78676,6,3,275374,275374,275377,0,3,3
78677,2,2,275376,275377,275379,1,3,0
78678,2,2,275378,275379,275381,1,3,0
78679,5,3,275383,275383,275386,0,3,2
78680,1,1,275384,275386,275387,2,3,0
78681,5,3,275389,275389,275392,0,3,2
78682,6,1,275395,275395,275396,0,1,3
78683,1,3,275396,275396,275399,0,3,0
78684,5,1,275401,275401,275402,0,1,2
78685,2,2,275403,275403,275405,0,2,1
78686,5,1,275408,275408,275409,0,1,3
78687,1,3,275409,275409,275412,0,3,0
78688,3,1,275412,275412,275413,0,1,0
78689,3,1,275415,275415,275416,0,1,2
78690,5,3,275420,275420,275423,0,3,4
78691,5,1,275425,275425,275426,0,1,2
78692,2,1,275427,275427,275428,0,1,1
78693,6,3,275433,275433,275436,0,3,5
78694,2,2,275435,275436,275438,1,3,0
78695,2,1,275437,275438,275439,1,2,0
78696,5,3,275442,275442,275445,0,3,3
78697,1,3,275443,275445,275448,2,5,0
78698,6,3,275449,275449,275452,0,3,1
78699,2,3,275451,275452,275455,1,4,0
78700,1,1,275452,275455,275456,3,4,0
78701,6,3,275458,275458,275461,0,3,2
78702,6,1,275464,275464,275465,0,1,3
78703,4,3,275468,275468,275471,0,3,3
78704,4,3,275472,275472,275475,0,3,1
78705,4,1,275476,275476,275477,0,1,1
78706,4,3,275480,275480,275483,0,3,3
78707,6,3,275486,275486,275489,0,3,3
78708,4,3,275490,275490,275493,0,3,1
78709,1,1,275491,275493,275494,2,3,0
78710,3,3,275494,275494,275497,0,3,0
78711,3,3,275497,275497,275500,0,3,0
78712,2,3,275499,275500,275503,1,4,0
78713,3,3,275502,275503,275506,1,4,0
78714,3,2,275505,275506,275508,1,3,0
78715,3,1,275508,275508,275509,0,1,0
78716,5,3,275513,275513,275516,0,3,4
78717,2,3,275515,275516,275519,1,4,0
78718,2,3,275517,275519,275522,2,5,0
78719,4,2,275521,275522,275524,1,3,0
78720,4,2,275525,275525,275527,0,2,1
78721,1,1,275526,275527,275528,1,2,0
78722,2,2,275528,275528,275530,0,2,0
78723,3,1,275531,275531,275532,0,1,1
78724,5,1,275536,275536,275537,0,1,4
78725,6,3,275542,275542,275545,0,3,5
78726,5,1,275547,275547,275548,0,1,2
78727,3,1,275550,275550,275551,0,1,2
78728,5,1,275555,275555,275556,0,1,4
78729,5,1,275560,275560,275561,0,1,4
78730,2,3,275562,275562,275565,0,3,1
78731,2,1,275564,275565,275566,1,2,0
78732,1,1,275565,275566,275567,1,2,0
78733,6,1,275571,275571,275572,0,1,4
78734,3,2,275574,275574,275576,0,2,2
78735,3,2,275577,275577,275579,0,2,1
78736,5,1,275582,275582,275583,0,1,3
78737,1,2,275583,275583,275585,0,2,0
78738,3,1,275586,275586,275587,0,1,1
78739,3,2,275589,275589,275591,0,2,2
78740,1,2,275590,275591,275593,1,3,0
78741,6,3,275596,275596,275599,0,3,3
78742,6,2,275602,275602,275604,0,2,3
78743,6,2,275608,275608,275610,0,2,4
78744,5,1,275613,275613,275614,0,1,3
78745,5,3,275618,275618,275621,0,3,4
78746,6,2,275624,275624,275626,0,2,3
78747,3,3,275627,275627,275630,0,3,1
78748,6,1,275633,275633,275634,0,1,3
78749,5,3,275638,275638,275641,0,3,4
78750,2,1,275640,275641,275642,1,2,0
78751,5,2,275645,275645,275647,0,2,3
78752,1,2,275646,275647,275649,1,3,0
78753,3,1,275649,275649,275650,0,1,0
78754,6,1,275655,275655,275656,0,1,5
78755,1,3,275656,275656,275659,0,3,0
78756,2,3,275658,275659,275662,1,4,0
78757,3,3,275661,275662,275665,1,4,0
78758,3,3,275664,275665,275668,1,4,0
78759,2,2,275666,275668,275670,2,4,0
78760,2,1,275668,275670,275671,2,3,0
78761,3,1,275671,275671,275672,0,1,0
78762,3,1,275674,275674,275675,0,1,2
78763,2,1,275676,275676,275677,0,1,1
78764,1,1,275677,275677,275678,0,1,0
78765,5,1,275682,275682,275683,0,1,4
78766,4,3,275686,275686,275689,0,3,3
78767,1,2,275687,275689,275691,2,4,0
78768,6,3,275693,275693,275696,0,3,2
78769,4,3,275697,275697,275700,0,3,1
78770,1,3,275698,275700,275703,2,5,0
78771,3,3,275701,275703,275706,2,5,0
78772,6,2,275707,275707,275709,0,2,1
78773,1,2,275708,275709,275711,1,3,0
78774,2,1,275710,275711,275712,1,2,0
78775,3,2,275713,275713,275715,0,2,1
78776,6,2,275719,275719,275721,0,2,4
78777,3,3,275722,275722,275725,0,3,1
78778,6,3,275728,275728,275731,0,3,3
78779,3,2,275731,275731,275733,0,2,0
78780,6,1,275737,275737,275738,0,1,4
78781,6,3,275743,275743,275746,0,3,5
78782,3,1,275746,275746,275747,0,1,0
78783,5,2,275751,275751,275753,0,2,4
78784,2,3,275753,275753,275756,0,3,0
78785,5,1,275758,275758,275759,0,1,2
78786,4,2,275762,275762,275764,0,2,3
78787,2,2,275764,275764,275766,0,2,0
78788,6,3,275770,275770,275773,0,3,4
78789,2,3,275772,275773,275776,1,4,0
78790,4,3,275776,275776,275779,0,3,0
78791,6,1,275782,275782,275783,0,1,3
78792,4,3,275786,275786,275789,0,3,3
78793,6,2,275792,275792,275794,0,2,3
78794,3,3,275795,275795,275798,0,3,1
78795,4,1,275799,275799,275800,0,1,1
78796,3,3,275802,275802,275805,0,3,2
78797,3,1,275805,275805,275806,0,1,0
78798,4,1,275809,275809,275810,0,1,3
78799,5,3,275814,275814,275817,0,3,4
78800,1,2,275815,275817,275819,2,4,0
78801,3,1,275818,275819,275820,1,2,0
78802,2,2,275820,275820,275822,0,2,0
78803,6,2,275826,275826,275828,0,2,4
78804,5,3,275831,275831,275834,0,3,3
78805,3,3,275834,275834,275837,0,3,0
78806,4,3,275838,275838,275841,0,3,1
78807,5,2,275843,275843,275845,0,2,2
78808,3,2,275846,275846,275848,0,2,1
78809,6,2,275852,275852,275854,0,2,4
78810,5,1,275857,275857,275858,0,1,3
78811,1,1,275858,275858,275859,0,1,0
78812,6,3,275864,275864,275867,0,3,5
78813,3,1,275867,275867,275868,0,1,0
78814,2,3,275869,275869,275872,0,3,1
78815,3,3,275872,275872,275875,0,3,0
78816,3,2,275875,275875,275877,0,2,0
78817,6,2,275881,275881,275883,0,2,4
78818,1,2,275882,275883,275885,1,3,0
78819,2,3,275884,275885,275888,1,4,0
78820,6,1,275890,275890,275891,0,1,2
78821,3,1,275893,275893,275894,0,1,2
78822,5,3,275898,275898,275901,0,3,4
78823,6,3,275904,275904,275907,0,3,3
78824,2,3,275906,275907,275910,1,4,0
78825,1,2,275907,275910,275912,3,5,0
78826,1,3,275908,275912,275915,4,7,0
78827,5,1,275913,275915,275916,2,3,0
78828,4,2,275917,275917,275919,0,2,1
78829,4,1,275921,275921,275922,0,1,2
78830,3,1,275924,275924,275925,0,1,2
78831,1,3,275925,275925,275928,0,3,0
78832,6,2,275931,275931,275933,0,2,3
78833,2,2,275933,275933,275935,0,2,0
78834,5,3,275938,275938,275941,0,3,3
78835,3,2,275941,275941,275943,0,2,0
78836,2,3,275943,275943,275946,0,3,0
78837,1,1,275944,275946,275947,2,3,0
78838,6,3,275950,275950,275953,0,3,3
78839,4,1,275954,275954,275955,0,1,1
78840,1,2,275955,275955,275957,0,2,0
78841,3,3,275958,275958,275961,0,3,1
78842,6,3,275964,275964,275967,0,3,3
78843,5,3,275969,275969,275972,0,3,2
78844,6,2,275975,275975,275977,0,2,3
78845,6,3,275981,275981,275984,0,3,4
78846,1,3,275982,275984,275987,2,5,0
78847,2,3,275984,275987,275990,3,6,0
78848,4,1,275988,275990,275991,2,3,0
78849,4,1,275992,275992,275993,0,1,1
78850,2,3,275994,275994,275997,0,3,1
78851,2,2,275996,275997,275999,1,3,0
78852,5,3,276001,276001,276004,0,3,2
78853,3,2,276004,276004,276006,0,2,0
78854,4,2,276008,276008,276010,0,2,2
78855,6,1,276014,276014,276015,0,1,4
78856,3,3,276017,276017,276020,0,3,2
78857,3,2,276020,276020,276022,0,2,0
78858,5,2,276025,276025,276027,0,2,3
78859,5,2,276030,276030,276032,0,2,3
78860,1,3,276031,276032,276035,1,4,0
78861,1,1,276032,276035,276036,3,4,0
78862,1,3,276033,276036,276039,3,6,0
78863,1,3,276034,276039,276042,5,8,0
78864,1,1,276035,276042,276043,7,8,0
78865,5,3,276040,276043,276046,3,6,0
78866,4,1,276044,276046,276047,2,3,0
78867,6,2,276050,276050,276052,0,2,3
78868,4,1,276054,276054,276055,0,1,2
78869,3,3,276057,276057,276060,0,3,2
78870,2,1,276059,276060,276061,1,2,0
78871,4,1,276063,276063,276064,0,1,2
78872,3,3,276066,276066,276069,0,3,2
78873,1,3,276067,276069,276072,2,5,0
78874,2,2,276069,276072,276074,3,5,0
78875,5,2,276074,276074,276076,0,2,0
78876,1,3,276075,276076,276079,1,4,0
78877,4,2,276079,276079,276081,0,2,0
78878,3,2,276082,276082,276084,0,2,1
78879,5,3,276087,276087,276090,0,3,3
78880,3,3,276090,276090,276093,0,3,0
78881,1,1,276091,276093,276094,2,3,0
78882,2,2,276093,276094,276096,1,3,0
78883,4,3,276097,276097,276100,0,3,1
78884,6,1,276103,276103,276104,0,1,3
78885,1,3,276104,276104,276107,0,3,0
78886,1,2,276105,276107,276109,2,4,0
78887,4,2,276109,276109,276111,0,2,0
78888,1,2,276110,276111,276113,1,3,0
78889,6,2,276116,276116,276118,0,2,3
78890,5,1,276121,276121,276122,0,1,3
78891,1,3,276122,276122,276125,0,3,0
78892,1,3,276123,276125,276128,2,5,0
78893,5,1,276128,276128,276129,0,1,0
78894,6,3,276134,276134,276137,0,3,5
78895,5,2,276139,276139,276141,0,2,2
78896,4,2,276143,276143,276145,0,2,2
78897,3,1,276146,276146,276147,0,1,1
78898,1,1,276147,276147,276148,0,1,0
78899,3,1,276150,276150,276151,0,1,2
78900,5,2,276155,276155,276157,0,2,4
78901,5,3,276160,276160,276163,0,3,3
78902,4,2,276164,276164,276166,0,2,1
78903,5,3,276169,276169,276172,0,3,3
78904,3,1,276172,276172,276173,0,1,0
78905,6,1,276178,276178,276179,0,1,5
78906,3,1,276181,276181,276182,0,1,2
78907,2,2,276183,276183,276185,0,2,1
78908,6,2,276189,276189,276191,0,2,4
78909,5,3,276194,276194,276197,0,3,3
78910,2,2,276196,276197,276199,1,3,0
78911,1,1,276197,276199,276200,2,3,0
78912,1,1,276198,276200,276201,2,3,0
78913,5,3,276203,276203,276206,0,3,2
78914,5,2,276208,276208,276210,0,2,2
78915,4,2,276212,276212,276214,0,2,2
78916,3,1,276215,276215,276216,0,1,1
78917,1,1,276216,276216,276217,0,1,0
78918,2,2,276218,276218,276220,0,2,1
78919,4,1,276222,276222,276223,0,1,2
78920,5,2,276227,276227,276229,0,2,4
78921,6,1,276233,276233,276234,0,1,4
78922,6,3,276239,276239,276242,0,3,5
78923,6,2,276245,276245,276247,0,2,3
78924,3,2,276248,276248,276250,0,2,1
78925,6,1,276254,276254,276255,0,1,4
78926,3,3,276257,276257,276260,0,3,2
78927,2,1,276259,276260,276261,1,2,0
78928,2,1,276261,276261,276262,0,1,0
78929,1,2,276262,276262,276264,0,2,0
78930,4,3,276266,276266,276269,0,3,2
78931,5,1,276271,276271,276272,0,1,2
78932,1,1,276272,276272,276273,0,1,0
78933,3,3,276275,276275,276278,0,3,2
78934,2,1,276277,276278,276279,1,2,0
78935,6,1,276283,276283,276284,0,1,4
78936,1,1,276284,276284,276285,0,1,0
78937,1,2,276285,276285,276287,0,2,0
78938,4,3,276289,276289,276292,0,3,2
78939,5,1,276294,276294,276295,0,1,2
78940,4,1,276298,276298,276299,0,1,3
78941,5,2,276303,276303,276305,0,2,4
78942,4,3,276307,276307,276310,0,3,2
78943,3,1,276310,276310,276311,0,1,0
78944,3,3,276313,276313,276316,0,3,2
78945,6,2,276319,276319,276321,0,2,3
78946,3,3,276322,276322,276325,0,3,1
78947,6,3,276328,276328,276331,0,3,3
78948,3,3,276331,276331,276334,0,3,0
78949,6,1,276337,276337,276338,0,1,3
78950,5,3,276342,276342,276345,0,3,4
78951,4,1,276346,276346,276347,0,1,1
78952,3,1,276349,276349,276350,0,1,2
78953,6,3,276355,276355,276358,0,3,5
78954,3,3,276358,276358,276361,0,3,0
78955,2,3,276360,276361,276364,1,4,0
78956,6,2,276366,276366,276368,0,2,2
78957,6,1,276372,276372,276373,0,1,4
78958,3,3,276375,276375,276378,0,3,2
78959,6,3,276381,276381,276384,0,3,3
78960,5,3,276386,276386,276389,0,3,2
78961,6,3,276392,276392,276395,0,3,3
78962,6,3,276398,276398,276401,0,3,3
78963,2,2,276400,276401,276403,1,3,0
78964,5,3,276405,276405,276408,0,3,2
78965,5,3,276410,276410,276413,0,3,2
78966,4,2,276414,276414,276416,0,2,1
78967,4,3,276418,276418,276421,0,3,2
78968,5,3,276423,276423,276426,0,3,2
78969,4,1,276427,276427,276428,0,1,1
78970,1,1,276428,276428,276429,0,1,0
78971,1,3,276429,276429,276432,0,3,0
78972,2,3,276431,276432,276435,1,4,0
78973,2,1,276433,276435,276436,2,3,0
78974,2,1,276435,276436,276437,1,2,0
78975,1,1,276436,276437,276438,1,2,0
78976,1,2,276437,276438,276440,1,3,0
78977,6,2,276443,276443,276445,0,2,3
78978,2,2,276445,276445,276447,0,2,0
78979,4,3,276449,276449,276452,0,3,2
78980,1,3,276450,276452,276455,2,5,0
78981,6,1,276456,276456,276457,0,1,1
78982,3,2,276459,276459,276461,0,2,2
78983,5,1,276464,276464,276465,0,1,3
78984,3,2,276467,276467,276469,0,2,2
78985,4,3,276471,276471,276474,0,3,2
78986,6,3,276477,276477,276480,0,3,3
78987,3,3,276480,276480,276483,0,3,0
78988,2,2,276482,276483,276485,1,3,0
78989,1,3,276483,276485,276488,2,5,0
78990,1,2,276484,276488,276490,4,6,0
78991,5,2,276489,276490,276492,1,3,0
78992,3,3,276492,276492,276495,0,3,0
78993,6,3,276498,276498,276501,0,3,3
78994,6,1,276504,276504,276505,0,1,3
78995,6,3,276510,276510,276513,0,3,5
78996,6,2,276516,276516,276518,0,2,3
78997,1,3,276517,276518,276521,1,4,0
78998,2,3,276519,276521,276524,2,5,0
78999,4,2,276523,276524,276526,1,3,0
79000,3,2,276526,276526,276528,0,2,0
79001,6,3,276532,276532,276535,0,3,4
79002,4,3,276536,276536,276539,0,3,1
79003,2,1,276538,276539,276540,1,2,0
79004,2,1,276540,276540,276541,0,1,0
79005,2,1,276542,276542,276543,0,1,1
79006,5,1,276547,276547,276548,0,1,4
79007,5,2,276552,276552,276554,0,2,4
79008,4,2,276556,276556,276558,0,2,2
79009,2,1,276558,276558,276559,0,1,0
79010,4,3,276562,276562,276565,0,3,3
79011,5,2,276567,276567,276569,0,2,2
79012,3,2,276570,276570,276572,0,2,1
79013,4,3,276574,276574,276577,0,3,2
79014,2,3,276576,276577,276580,1,4,0
79015,1,1,276577,276580,276581,3,4,0
79016,6,1,276583,276583,276584,0,1,2
79017,5,1,276588,276588,276589,0,1,4
79018,3,1,276591,276591,276592,0,1,2
79019,3,2,276594,276594,276596,0,2,2
79020,5,3,276599,276599,276602,0,3,3
79021,3,1,276602,276602,276603,0,1,0
79022,3,3,276605,276605,276608,0,3,2
79023,1,1,276606,276608,276609,2,3,0
79024,5,2,276611,276611,276613,0,2,2
79025,1,1,276612,276613,276614,1,2,0
79026,6,3,276618,276618,276621,0,3,4
79027,1,2,276619,276621,276623,2,4,0
79028,1,2,276620,276623,276625,3,5,0
79029,5,3,276625,276625,276628,0,3,0
79030,3,3,276628,276628,276631,0,3,0
79031,3,3,276631,276631,276634,0,3,0
79032,1,3,276632,276634,276637,2,5,0
79033,1,2,276633,276637,276639,4,6,0
79034,5,1,276638,276639,276640,1,2,0
79035,1,2,276639,276640,276642,1,3,0
79036,4,1,276643,276643,276644,0,1,1
79037,1,3,276644,276644,276647,0,3,0
79038,1,3,276645,276647,276650,2,5,0
79039,2,1,276647,276650,276651,3,4,0
79040,3,2,276650,276651,276653,1,3,0
79041,5,1,276655,276655,276656,0,1,2
79042,2,2,276657,276657,276659,0,2,1
79043,2,3,276659,276659,276662,0,3,0
79044,1,3,276660,276662,276665,2,5,0
79045,4,3,276664,276665,276668,1,4,0
79046,2,1,276666,276668,276669,2,3,0
79047,2,2,276668,276669,276671,1,3,0
79048,6,2,276674,276674,276676,0,2,3
79049,2,2,276676,276676,276678,0,2,0
79050,3,2,276679,276679,276681,0,2,1
79051,1,3,276680,276681,276684,1,4,0
79052,3,1,276683,276684,276685,1,2,0
79053,4,3,276687,276687,276690,0,3,2
79054,3,1,276690,276690,276691,0,1,0
79055,2,1,276692,276692,276693,0,1,1
79056,4,1,276696,276696,276697,0,1,3
79057,1,3,276697,276697,276700,0,3,0
79058,6,1,276703,276703,276704,0,1,3
79059,2,1,276705,276705,276706,0,1,1
79060,2,2,276707,276707,276709,0,2,1
79061,5,2,276712,276712,276714,0,2,3
79062,5,2,276717,276717,276719,0,2,3
79063,6,2,276723,276723,276725,0,2,4
79064,4,1,276727,276727,276728,0,1,2
79065,1,3,276728,276728,276731,0,3,0
79066,4,2,276732,276732,276734,0,2,1
79067,6,2,276738,276738,276740,0,2,4
79068,4,2,276742,276742,276744,0,2,2
79069,3,1,276745,276745,276746,0,1,1
79070,4,3,276749,276749,276752,0,3,3
79071,4,2,276753,276753,276755,0,2,1
79072,5,1,276758,276758,276759,0,1,3
79073,5,1,276763,276763,276764,0,1,4
79074,1,3,276764,276764,276767,0,3,0
79075,3,2,276767,276767,276769,0,2,0
79076,4,1,276771,276771,276772,0,1,2
79077,6,1,276777,276777,276778,0,1,5
79078,6,2,276783,276783,276785,0,2,5
79079,4,2,276787,276787,276789,0,2,2
79080,1,2,276788,276789,276791,1,3,0
79081,3,3,276791,276791,276794,0,3,0
79082,6,1,276797,276797,276798,0,1,3
79083,5,1,276802,276802,276803,0,1,4
79084,4,2,276806,276806,276808,0,2,3
79085,6,3,276812,276812,276815,0,3,4
79086,5,1,276817,276817,276818,0,1,2
79087,2,3,276819,276819,276822,0,3,1
79088,2,1,276821,276822,276823,1,2,0
79089,1,1,276822,276823,276824,1,2,0
79090,2,1,276824,276824,276825,0,1,0
79091,1,2,276825,276825,276827,0,2,0
79092,4,1,276829,276829,276830,0,1,2
79093,6,2,276835,276835,276837,0,2,5
79094,3,2,276838,276838,276840,0,2,1
79095,6,1,276844,276844,276845,0,1,4
79096,6,2,276850,276850,276852,0,2,5
79097,1,2,276851,276852,276854,1,3,0
79098,2,1,276853,276854,276855,1,2,0
79099,3,1,276856,276856,276857,0,1,1
79100,1,2,276857,276857,276859,0,2,0
79101,3,1,276860,276860,276861,0,1,1
79102,1,3,276861,276861,276864,0,3,0
79103,6,2,276867,276867,276869,0,2,3
79104,6,1,276873,276873,276874,0,1,4
79105,6,2,276879,276879,276881,0,2,5
79106,4,2,276883,276883,276885,0,2,2
79107,4,3,276887,276887,276890,0,3,2
79108,6,1,276893,276893,276894,0,1,3
79109,1,3,276894,276894,276897,0,3,0
79110,5,1,276899,276899,276900,0,1,2
79111,2,2,276901,276901,276903,0,2,1
79112,3,3,276904,276904,276907,0,3,1
79113,4,2,276908,276908,276910,0,2,1
79114,4,3,276912,276912,276915,0,3,2
79115,4,3,276916,276916,276919,0,3,1
79116,5,2,276921,276921,276923,0,2,2
79117,6,3,276927,276927,276930,0,3,4
79118,5,3,276932,276932,276935,0,3,2
79119,6,2,276938,276938,276940,0,2,3
79120,5,3,276943,276943,276946,0,3,3
79121,2,3,276945,276946,276949,1,4,0
79122,1,1,276946,276949,276950,3,4,0
79123,2,2,276948,276950,276952,2,4,0
79124,5,3,276953,276953,276956,0,3,1
79125,2,3,276955,276956,276959,1,4,0
79126,3,2,276958,276959,276961,1,3,0
79127,2,1,276960,276961,276962,1,2,0
79128,2,3,276962,276962,276965,0,3,0
79129,2,3,276964,276965,276968,1,4,0
79130,4,2,276968,276968,276970,0,2,0
79131,4,2,276972,276972,276974,0,2,2
79132,1,2,276973,276974,276976,1,3,0
79133,4,2,276977,276977,276979,0,2,1
79134,2,1,276979,276979,276980,0,1,0
79135,4,1,276983,276983,276984,0,1,3
79136,6,3,276989,276989,276992,0,3,5
79137,4,1,276993,276993,276994,0,1,1
79138,3,3,276996,276996,276999,0,3,2
79139,5,2,277001,277001,277003,0,2,2
79140,2,2,277003,277003,277005,0,2,0
79141,4,2,277007,277007,277009,0,2,2
79142,6,3,277013,277013,277016,0,3,4
79143,6,1,277019,277019,277020,0,1,3
79144,3,3,277022,277022,277025,0,3,2
79145,2,3,277024,277025,277028,1,4,0
79146,4,2,277028,277028,277030,0,2,0
79147,1,1,277029,277030,277031,1,2,0
79148,6,3,277035,277035,277038,0,3,4
79149,1,2,277036,277038,277040,2,4,0
79150,1,2,277037,277040,277042,3,5,0
79151,4,1,277041,277042,277043,1,2,0
79152,2,2,277043,277043,277045,0,2,0
79153,5,1,277048,277048,277049,0,1,3
79154,3,3,277051,277051,277054,0,3,2
79155,1,3,277052,277054,277057,2,5,0
79156,5,3,277057,277057,277060,0,3,0
79157,1,1,277058,277060,277061,2,3,0
79158,4,2,277062,277062,277064,0,2,1
79159,2,2,277064,277064,277066,0,2,0
79160,3,3,277067,277067,277070,0,3,1
79161,2,3,277069,277070,277073,1,4,0
79162,4,2,277073,277073,277075,0,2,0
79163,4,2,277077,277077,277079,0,2,2
79164,6,3,277083,277083,277086,0,3,4
79165,5,1,277088,277088,277089,0,1,2
79166,4,2,277092,277092,277094,0,2,3
79167,2,1,277094,277094,277095,0,1,0
79168,3,1,277097,277097,277098,0,1,2
79169,2,2,277099,277099,277101,0,2,1
79170,3,1,277102,277102,277103,0,1,1
79171,3,2,277105,277105,277107,0,2,2
79172,4,1,277109,277109,277110,0,1,2
79173,3,3,277112,277112,277115,0,3,2
79174,4,3,277116,277116,277119,0,3,1
79175,2,3,277118,277119,277122,1,4,0
79176,1,1,277119,277122,277123,3,4,0
79177,6,1,277125,277125,277126,0,1,2
79178,2,1,277127,277127,277128,0,1,1
79179,3,1,277130,277130,277131,0,1,2
79180,6,2,277136,277136,277138,0,2,5
79181,3,2,277139,277139,277141,0,2,1
79182,1,2,277140,277141,277143,1,3,0
79183,2,2,277142,277143,277145,1,3,0
79184,2,2,277144,277145,277147,1,3,0
79185,6,3,277150,277150,277153,0,3,3
79186,5,3,277155,277155,277158,0,3,2
79187,2,2,277157,277158,277160,1,3,0
79188,1,3,277158,277160,277163,2,5,0
79189,5,3,277163,277163,277166,0,3,0
79190,3,2,277166,277166,277168,0,2,0
79191,1,2,277167,277168,277170,1,3,0
79192,2,3,277169,277170,277173,1,4,0
79193,5,2,277174,277174,277176,0,2,1
79194,1,1,277175,277176,277177,1,2,0
79195,2,3,277177,277177,277180,0,3,0
79196,1,1,277178,277180,277181,2,3,0
79197,6,1,277184,277184,277185,0,1,3
79198,5,2,277189,277189,277191,0,2,4
79199,4,2,277193,277193,277195,0,2,2
79200,3,1,277196,277196,277197,0,1,1
79201,5,3,277201,277201,277204,0,3,4
79202,1,1,277202,277204,277205,2,3,0
79203,1,2,277203,277205,277207,2,4,0
79204,3,3,277206,277207,277210,1,4,0
79205,5,2,277211,277211,277213,0,2,1
79206,4,2,277215,277215,277217,0,2,2
79207,6,1,277221,277221,277222,0,1,4
79208,3,3,277224,277224,277227,0,3,2
79209,6,3,277230,277230,277233,0,3,3
79210,5,3,277235,277235,277238,0,3,2
79211,6,3,277241,277241,277244,0,3,3
79212,2,1,277243,277244,277245,1,2,0
79213,4,2,277247,277247,277249,0,2,2
79214,6,3,277253,277253,277256,0,3,4
79215,3,2,277256,277256,277258,0,2,0
79216,2,1,277258,277258,277259,0,1,0
79217,5,1,277263,277263,277264,0,1,4
79218,3,3,277266,277266,277269,0,3,2
79219,6,3,277272,277272,277275,0,3,3
79220,2,3,277274,277275,277278,1,4,0
79221,4,1,277278,277278,277279,0,1,0
79222,5,2,277283,277283,277285,0,2,4
79223,2,3,277285,277285,277288,0,3,0
79224,5,3,277290,277290,277293,0,3,2
79225,1,2,277291,277293,277295,2,4,0
79226,1,1,277292,277295,277296,3,4,0
79227,4,2,277296,277296,277298,0,2,0
79228,5,2,277301,277301,277303,0,2,3
79229,3,2,277304,277304,277306,0,2,1
79230,3,2,277307,277307,277309,0,2,1
79231,5,3,277312,277312,277315,0,3,3
79232,5,3,277317,277317,277320,0,3,2
79233,3,3,277320,277320,277323,0,3,0
79234,1,1,277321,277323,277324,2,3,0
79235,2,2,277323,277324,277326,1,3,0
79236,1,1,277324,277326,277327,2,3,0
79237,5,1,277329,277329,277330,0,1,2
79238,3,2,277332,277332,277334,0,2,2
79239,4,2,277336,277336,277338,0,2,2
79240,4,3,277340,277340,277343,0,3,2
79241,1,2,277341,277343,277345,2,4,0
79242,6,3,277347,277347,277350,0,3,2
79243,6,2,277353,277353,277355,0,2,3
79244,1,3,277354,277355,277358,1,4,0
79245,1,2,277355,277358,277360,3,5,0
79246,2,1,277357,277360,277361,3,4,0
79247,3,3,277360,277361,277364,1,4,0
79248,1,1,277361,277364,277365,3,4,0
79249,6,3,277367,277367,277370,0,3,2
79250,2,3,277369,277370,277373,1,4,0
79251,5,2,277374,277374,277376,0,2,1
79252,5,2,277379,277379,277381,0,2,3
79253,5,2,277384,277384,277386,0,2,3
79254,2,3,277386,277386,277389,0,3,0
79255,4,1,277390,277390,277391,0,1,1
79256,1,1,277391,277391,277392,0,1,0
79257,1,2,277392,277392,277394,0,2,0
79258,1,1,277393,277394,277395,1,2,0
79259,5,1,277398,277398,277399,0,1,3
79260,3,2,277401,277401,277403,0,2,2
79261,6,1,277407,277407,277408,0,1,4
79262,5,3,277412,277412,277415,0,3,4
79263,3,3,277415,277415,277418,0,3,0
79264,4,1,277419,277419,277420,0,1,1
79265,3,2,277422,277422,277424,0,2,2
79266,4,2,277426,277426,277428,0,2,2
79267,4,1,277430,277430,277431,0,1,2
79268,5,3,277435,277435,277438,0,3,4
79269,5,3,277440,277440,277443,0,3,2
79270,2,1,277442,277443,277444,1,2,0
79271,2,1,277444,277444,277445,0,1,0
79272,6,3,277450,277450,277453,0,3,5
79273,2,3,277452,277453,277456,1,4,0
79274,1,2,277453,277456,277458,3,5,0
79275,4,3,277457,277458,277461,1,4,0
79276,2,1,277459,277461,277462,2,3,0
79277,2,1,277461,277462,277463,1,2,0
79278,6,3,277467,277467,277470,0,3,4
79279,6,1,277473,277473,277474,0,1,3
79280,4,2,277477,277477,277479,0,2,3
79281,4,1,277481,277481,277482,0,1,2
79282,5,3,277486,277486,277489,0,3,4
79283,6,1,277492,277492,277493,0,1,3
79284,4,2,277496,277496,277498,0,2,3
79285,5,2,277501,277501,277503,0,2,3
79286,4,2,277505,277505,277507,0,2,2
79287,5,3,277510,277510,277513,0,3,3
79288,1,3,277511,277513,277516,2,5,0
79289,3,1,277514,277516,277517,2,3,0
79290,4,2,277518,277518,277520,0,2,1
79291,5,1,277523,277523,277524,0,1,3
79292,2,2,277525,277525,277527,0,2,1
79293,6,1,277531,277531,277532,0,1,4
79294,6,2,277537,277537,277539,0,2,5
79295,4,2,277541,277541,277543,0,2,2
79296,4,2,277545,277545,277547,0,2,2
79297,5,1,277550,277550,277551,0,1,3
79298,1,1,277551,277551,277552,0,1,0
79299,4,3,277555,277555,277558,0,3,3
79300,5,1,277560,277560,277561,0,1,2
79301,1,1,277561,277561,277562,0,1,0
79302,1,3,277562,277562,277565,0,3,0
79303,6,3,277568,277568,277571,0,3,3
79304,5,3,277573,277573,277576,0,3,2
79305,1,3,277574,277576,277579,2,5,0
79306,2,2,277576,277579,277581,3,5,0
79307,1,2,277577,277581,277583,4,6,0
79308,5,1,277582,277583,277584,1,2,0
79309,4,3,277586,277586,277589,0,3,2
79310,5,1,277591,277591,277592,0,1,2
79311,5,3,277596,277596,277599,0,3,4
79312,1,2,277597,277599,277601,2,4,0
79313,2,3,277599,277601,277604,2,5,0
79314,4,2,277603,277604,277606,1,3,0
79315,3,2,277606,277606,277608,0,2,0
79316,5,3,277611,277611,277614,0,3,3
79317,5,1,277616,277616,277617,0,1,2
79318,2,2,277618,277618,277620,0,2,1
79319,6,2,277624,277624,277626,0,2,4
79320,1,3,277625,277626,277629,1,4,0
79321,6,3,277631,277631,277634,0,3,2
79322,3,3,277634,277634,277637,0,3,0
79323,4,1,277638,277638,277639,0,1,1
79324,2,1,277640,277640,277641,0,1,1
79325,4,3,277644,277644,277647,0,3,3
79326,3,2,277647,277647,277649,0,2,0
79327,5,1,277652,277652,277653,0,1,3
79328,3,3,277655,277655,277658,0,3,2
79329,4,1,277659,277659,277660,0,1,1
79330,1,2,277660,277660,277662,0,2,0
79331,6,2,277666,277666,277668,0,2,4
79332,3,3,277669,277669,277672,0,3,1
79333,5,2,277674,277674,277676,0,2,2
79334,3,2,277677,277677,277679,0,2,1
79335,6,2,277683,277683,277685,0,2,4
79336,3,2,277686,277686,277688,0,2,1
79337,5,1,277691,277691,277692,0,1,3
79338,4,3,277695,277695,277698,0,3,3
79339,5,3,277700,277700,277703,0,3,2
79340,1,2,277701,277703,277705,2,4,0
79341,5,3,277706,277706,277709,0,3,1
79342,4,1,277710,277710,277711,0,1,1
79343,3,3,277713,277713,277716,0,3,2
79344,2,3,277715,277716,277719,1,4,0
79345,2,1,277717,277719,277720,2,3,0
79346,1,2,277718,277720,277722,2,4,0
79347,2,3,277720,277722,277725,2,5,0
79348,3,3,277723,277725,277728,2,5,0
79349,3,2,277726,277728,277730,2,4,0
79350,5,3,277731,277731,277734,0,3,1
79351,4,1,277735,277735,277736,0,1,1
79352,2,3,277737,277737,277740,0,3,1
79353,4,1,277741,277741,277742,0,1,1
79354,3,2,277744,277744,277746,0,2,2
79355,4,2,277748,277748,277750,0,2,2
79356,2,2,277750,277750,277752,0,2,0
79357,6,1,277756,277756,277757,0,1,4
79358,1,3,277757,277757,277760,0,3,0
79359,3,2,277760,277760,277762,0,2,0
79360,1,2,277761,277762,277764,1,3,0
79361,3,2,277764,277764,277766,0,2,0
79362,6,3,277770,277770,277773,0,3,4
79363,3,3,277773,277773,277776,0,3,0
79364,6,2,277779,277779,277781,0,2,3
79365,4,3,277783,277783,277786,0,3,2
79366,3,3,277786,277786,277789,0,3,0
79367,6,2,277792,277792,277794,0,2,3
79368,1,3,277793,277794,277797,1,4,0
79369,5,2,277798,277798,277800,0,2,1
79370,5,2,277803,277803,277805,0,2,3
79371,1,2,277804,277805,277807,1,3,0
79372,5,2,277809,277809,277811,0,2,2
79373,6,2,277815,277815,277817,0,2,4
79374,5,3,277820,277820,277823,0,3,3
79375,6,2,277826,277826,277828,0,2,3
79376,5,3,277831,277831,277834,0,3,3
79377,6,3,277837,277837,277840,0,3,3
79378,3,1,277840,277840,277841,0,1,0
79379,4,2,277844,277844,277846,0,2,3
79380,1,2,277845,277846,277848,1,3,0
79381,5,1,277850,277850,277851,0,1,2
79382,4,1,277854,277854,277855,0,1,3
79383,4,3,277858,277858,277861,0,3,3
79384,3,3,277861,277861,277864,0,3,0
79385,4,2,277865,277865,277867,0,2,1
79386,5,1,277870,277870,277871,0,1,3
79387,4,3,277874,277874,277877,0,3,3
79388,5,2,277879,277879,277881,0,2,2
79389,4,3,277883,277883,277886,0,3,2
79390,1,2,277884,277886,277888,2,4,0
79391,6,3,277890,277890,277893,0,3,2
79392,5,2,277895,277895,277897,0,2,2
79393,6,1,277901,277901,277902,0,1,4
79394,4,2,277905,277905,277907,0,2,3
79395,1,3,277906,277907,277910,1,4,0
79396,1,2,277907,277910,277912,3,5,0
79397,5,1,277912,277912,277913,0,1,0
79398,5,3,277917,277917,277920,0,3,4
79399,1,2,277918,277920,277922,2,4,0
79400,3,2,277921,277922,277924,1,3,0
79401,1,1,277922,277924,277925,2,3,0
79402,2,2,277924,277925,277927,1,3,0
79403,6,1,277930,277930,277931,0,1,3
79404,2,3,277932,277932,277935,0,3,1
79405,1,1,277933,277935,277936,2,3,0
79406,3,1,277936,277936,277937,0,1,0
79407,5,2,277941,277941,277943,0,2,4
79408,2,2,277943,277943,277945,0,2,0
79409,1,1,277944,277945,277946,1,2,0
79410,4,2,277948,277948,277950,0,2,2
79411,2,3,277950,277950,277953,0,3,0
79412,2,1,277952,277953,277954,1,2,0
79413,4,1,277956,277956,277957,0,1,2
79414,6,3,277962,277962,277965,0,3,5
79415,1,3,277963,277965,277968,2,5,0
79416,1,1,277964,277968,277969,4,5,0
79417,6,1,277970,277970,277971,0,1,1
79418,1,2,277971,277971,277973,0,2,0
79419,5,3,277976,277976,277979,0,3,3
79420,6,3,277982,277982,277985,0,3,3
79421,3,1,277985,277985,277986,0,1,0
79422,2,2,277987,277987,277989,0,2,1
79423,3,2,277990,277990,277992,0,2,1
79424,5,2,277995,277995,277997,0,2,3
79425,3,1,277998,277998,277999,0,1,1
79426,5,3,278003,278003,278006,0,3,4
79427,4,2,278007,278007,278009,0,2,1
79428,2,3,278009,278009,278012,0,3,0
79429,1,1,278010,278012,278013,2,3,0
79430,2,1,278012,278013,278014,1,2,0
79431,1,3,278013,278014,278017,1,4,0
79432,1,2,278014,278017,278019,3,5,0
79433,4,3,278018,278019,278022,1,4,0
79434,1,3,278019,278022,278025,3,6,0
79435,5,2,278024,278025,278027,1,3,0
79436,3,3,278027,278027,278030,0,3,0
79437,3,3,278030,278030,278033,0,3,0
79438,1,3,278031,278033,278036,2,5,0
79439,1,1,278032,278036,278037,4,5,0
79440,3,1,278035,278037,278038,2,3,0
79441,4,1,278039,278039,278040,0,1,1
79442,1,3,278040,278040,278043,0,3,0
79443,2,2,278042,278043,278045,1,3,0
79444,5,2,278047,278047,278049,0,2,2
79445,2,3,278049,278049,278052,0,3,0
79446,2,1,278051,278052,278053,1,2,0
79447,5,2,278056,278056,278058,0,2,3
79448,4,2,278060,278060,278062,0,2,2
79449,2,1,278062,278062,278063,0,1,0
79450,1,3,278063,278063,278066,0,3,0
79451,3,3,278066,278066,278069,0,3,0
79452,1,1,278067,278069,278070,2,3,0
79453,4,2,278071,278071,278073,0,2,1
79454,6,1,278077,278077,278078,0,1,4
79455,6,2,278083,278083,278085,0,2,5
79456,4,2,278087,278087,278089,0,2,2
79457,3,2,278090,278090,278092,0,2,1
79458,5,1,278095,278095,278096,0,1,3
79459,1,3,278096,278096,278099,0,3,0
79460,5,1,278101,278101,278102,0,1,2
79461,3,2,278104,278104,278106,0,2,2
79462,6,1,278110,278110,278111,0,1,4
79463,3,3,278113,278113,278116,0,3,2
79464,6,1,278119,278119,278120,0,1,3
79465,6,2,278125,278125,278127,0,2,5
79466,3,3,278128,278128,278131,0,3,1
79467,1,1,278129,278131,278132,2,3,0
79468,2,3,278131,278132,278135,1,4,0
79469,3,2,278134,278135,278137,1,3,0
79470,2,1,278136,278137,278138,1,2,0
79471,6,3,278142,278142,278145,0,3,4
79472,1,2,278143,278145,278147,2,4,0
79473,1,2,278144,278147,278149,3,5,0
79474,1,2,278145,278149,278151,4,6,0
79475,4,3,278149,278151,278154,2,5,0
79476,6,1,278155,278155,278156,0,1,1
79477,5,3,278160,278160,278163,0,3,4
79478,5,1,278165,278165,278166,0,1,2
79479,3,3,278168,278168,278171,0,3,2
79480,6,3,278174,278174,278177,0,3,3
79481,1,1,278175,278177,278178,2,3,0
79482,2,3,278177,278178,278181,1,4,0
79483,3,2,278180,278181,278183,1,3,0
79484,6,3,278186,278186,278189,0,3,3
79485,1,2,278187,278189,278191,2,4,0
79486,6,1,278193,278193,278194,0,1,2
79487,5,2,278198,278198,278200,0,2,4
79488,5,1,278203,278203,278204,0,1,3
79489,5,3,278208,278208,278211,0,3,4
79490,3,1,278211,278211,278212,0,1,0
79491,3,3,278214,278214,278217,0,3,2
79492,6,2,278220,278220,278222,0,2,3
79493,5,1,278225,278225,278226,0,1,3
79494,5,2,278230,278230,278232,0,2,4
79495,6,1,278236,278236,278237,0,1,4
79496,4,2,278240,278240,278242,0,2,3
79497,2,1,278242,278242,278243,0,1,0
79498,1,3,278243,278243,278246,0,3,0
79499,5,2,278248,278248,278250,0,2,2
79500,6,2,278254,278254,278256,0,2,4
79501,3,2,278257,278257,278259,0,2,1
79502,5,1,278262,278262,278263,0,1,3
79503,3,1,278265,278265,278266,0,1,2
79504,6,2,278271,278271,278273,0,2,5
79505,6,2,278277,278277,278279,0,2,4
79506,1,3,278278,278279,278282,1,4,0
79507,4,3,278282,278282,278285,0,3,0
79508,2,3,278284,278285,278288,1,4,0
79509,6,2,278290,278290,278292,0,2,2
79510,1,2,278291,278292,278294,1,3,0
79511,1,1,278292,278294,278295,2,3,0
79512,5,3,278297,278297,278300,0,3,2
79513,6,1,278303,278303,278304,0,1,3
79514,4,3,278307,278307,278310,0,3,3
79515,4,2,278311,278311,278313,0,2,1
79516,4,2,278315,278315,278317,0,2,2
79517,3,2,278318,278318,278320,0,2,1
79518,6,1,278324,278324,278325,0,1,4
79519,5,2,278329,278329,278331,0,2,4
79520,4,3,278333,278333,278336,0,3,2
79521,3,2,278336,278336,278338,0,2,0
79522,5,1,278341,278341,278342,0,1,3
79523,4,1,278345,278345,278346,0,1,3
79524,3,2,278348,278348,278350,0,2,2
79525,5,1,278353,278353,278354,0,1,3
79526,5,3,278358,278358,278361,0,3,4
79527,6,1,278364,278364,278365,0,1,3
79528,3,2,278367,278367,278369,0,2,2
79529,2,3,278369,278369,278372,0,3,0
79530,1,2,278370,278372,278374,2,4,0
79531,2,1,278372,278374,278375,2,3,0
79532,5,1,278377,278377,278378,0,1,2
79533,5,2,278382,278382,278384,0,2,4
79534,1,3,278383,278384,278387,1,4,0
79535,4,3,278387,278387,278390,0,3,0
79536,5,1,278392,278392,278393,0,1,2
79537,2,1,278394,278394,278395,0,1,1
79538,5,3,278399,278399,278402,0,3,4
79539,4,2,278403,278403,278405,0,2,1
79540,1,3,278404,278405,278408,1,4,0
79541,3,1,278407,278408,278409,1,2,0
79542,1,1,278408,278409,278410,1,2,0
79543,3,1,278411,278411,278412,0,1,1
79544,3,2,278414,278414,278416,0,2,2
79545,4,3,278418,278418,278421,0,3,2
79546,3,3,278421,278421,278424,0,3,0
79547,1,3,278422,278424,278427,2,5,0
79548,3,1,278425,278427,278428,2,3,0
79549,6,2,278431,278431,278433,0,2,3
79550,1,3,278432,278433,278436,1,4,0
79551,1,1,278433,278436,278437,3,4,0
79552,4,1,278437,278437,278438,0,1,0
79553,1,3,278438,278438,278441,0,3,0
79554,4,1,278442,278442,278443,0,1,1
79555,6,2,278448,278448,278450,0,2,5
79556,2,1,278450,278450,278451,0,1,0
79557,2,2,278452,278452,278454,0,2,1
79558,2,2,278454,278454,278456,0,2,0
79559,4,3,278458,278458,278461,0,3,2
79560,6,2,278464,278464,278466,0,2,3
79561,6,2,278470,278470,278472,0,2,4
79562,2,3,278472,278472,278475,0,3,0
79563,4,1,278476,278476,278477,0,1,1
79564,3,3,278479,278479,278482,0,3,2
79565,6,2,278485,278485,278487,0,2,3
79566,1,3,278486,278487,278490,1,4,0
79567,2,1,278488,278490,278491,2,3,0
79568,5,2,278493,278493,278495,0,2,2
79569,5,3,278498,278498,278501,0,3,3
79570,6,1,278504,278504,278505,0,1,3
79571,3,3,278507,278507,278510,0,3,2
79572,2,2,278509,278510,278512,1,3,0
79573,5,1,278514,278514,278515,0,1,2
79574,3,2,278517,278517,278519,0,2,2
79575,4,2,278521,278521,278523,0,2,2
79576,3,2,278524,278524,278526,0,2,1
79577,1,3,278525,278526,278529,1,4,0
79578,4,3,278529,278529,278532,0,3,0
79579,2,3,278531,278532,278535,1,4,0
79580,3,2,278534,278535,278537,1,3,0
79581,6,3,278540,278540,278543,0,3,3
79582,4,1,278544,278544,278545,0,1,1
79583,6,3,278550,278550,278553,0,3,5
79584,4,3,278554,278554,278557,0,3,1
79585,1,3,278555,278557,278560,2,5,0
79586,2,1,278557,278560,278561,3,4,0
79587,6,1,278563,278563,278564,0,1,2
79588,6,1,278569,278569,278570,0,1,5
79589,5,2,278574,278574,278576,0,2,4
79590,3,3,278577,278577,278580,0,3,1
79591,1,1,278578,278580,278581,2,3,0
79592,6,2,278584,278584,278586,0,2,3
79593,5,3,278589,278589,278592,0,3,3
79594,3,3,278592,278592,278595,0,3,0
79595,3,1,278595,278595,278596,0,1,0
79596,2,3,278597,278597,278600,0,3,1
79597,3,2,278600,278600,278602,0,2,0
79598,1,2,278601,278602,278604,1,3,0
79599,6,3,278607,278607,278610,0,3,3
79600,6,3,278613,278613,278616,0,3,3
79601,6,1,278619,278619,278620,0,1,3
79602,3,3,278622,278622,278625,0,3,2
79603,2,2,278624,278625,278627,1,3,0
79604,2,1,278626,278627,278628,1,2,0
79605,3,3,278629,278629,278632,0,3,1
79606,3,3,278632,278632,278635,0,3,0
79607,2,3,278634,278635,278638,1,4,0
79608,5,3,278639,278639,278642,0,3,1
79609,4,2,278643,278643,278645,0,2,1
79610,5,2,278648,278648,278650,0,2,3
79611,1,2,278649,278650,278652,1,3,0
79612,2,3,278651,278652,278655,1,4,0
79613,4,3,278655,278655,278658,0,3,0
79614,2,3,278657,278658,278661,1,4,0
79615,4,1,278661,278661,278662,0,1,0
79616,3,2,278664,278664,278666,0,2,2
79617,6,3,278670,278670,278673,0,3,4
79618,1,2,278671,278673,278675,2,4,0
79619,1,1,278672,278675,278676,3,4,0
79620,2,2,278674,278676,278678,2,4,0
79621,3,3,278677,278678,278681,1,4,0
79622,1,1,278678,278681,278682,3,4,0
79623,1,2,278679,278682,278684,3,5,0
79624,4,1,278683,278684,278685,1,2,0
79625,1,2,278684,278685,278687,1,3,0
79626,4,1,278688,278688,278689,0,1,1
79627,3,1,278691,278691,278692,0,1,2
79628,2,2,278693,278693,278695,0,2,1
79629,2,3,278695,278695,278698,0,3,0
79630,6,3,278701,278701,278704,0,3,3
79631,1,3,278702,278704,278707,2,5,0
79632,1,3,278703,278707,278710,4,7,0
79633,5,3,278708,278710,278713,2,5,0
79634,3,3,278711,278713,278716,2,5,0
79635,4,1,278715,278716,278717,1,2,0
79636,6,2,278721,278721,278723,0,2,4
79637,1,2,278722,278723,278725,1,3,0
79638,1,3,278723,278725,278728,2,5,0
79639,2,1,278725,278728,278729,3,4,0
79640,5,3,278730,278730,278733,0,3,1
79641,1,3,278731,278733,278736,2,5,0
79642,1,3,278732,278736,278739,4,7,0
79643,6,1,278738,278739,278740,1,2,0
79644,5,1,278743,278743,278744,0,1,3
79645,4,1,278747,278747,278748,0,1,3
79646,3,2,278750,278750,278752,0,2,2
79647,1,2,278751,278752,278754,1,3,0
79648,5,1,278756,278756,278757,0,1,2
79649,5,2,278761,278761,278763,0,2,4
79650,5,2,278766,278766,278768,0,2,3
79651,3,1,278769,278769,278770,0,1,1
79652,6,1,278775,278775,278776,0,1,5
79653,5,1,278780,278780,278781,0,1,4
79654,3,2,278783,278783,278785,0,2,2
79655,1,3,278784,278785,278788,1,4,0
79656,1,1,278785,278788,278789,3,4,0
79657,2,3,278787,278789,278792,2,5,0
79658,4,3,278791,278792,278795,1,4,0
79659,1,1,278792,278795,278796,3,4,0
79660,1,2,278793,278796,278798,3,5,0
79661,5,2,278798,278798,278800,0,2,0
79662,4,1,278802,278802,278803,0,1,2
79663,4,1,278806,278806,278807,0,1,3
79664,5,2,278811,278811,278813,0,2,4
79665,6,2,278817,278817,278819,0,2,4
79666,2,2,278819,278819,278821,0,2,0
79667,5,1,278824,278824,278825,0,1,3
79668,4,2,278828,278828,278830,0,2,3
79669,5,3,278833,278833,278836,0,3,3
79670,1,3,278834,278836,278839,2,5,0
79671,1,3,278835,278839,278842,4,7,0
79672,3,2,278838,278842,278844,4,6,0
79673,1,2,278839,278844,278846,5,7,0
79674,3,2,278842,278846,278848,4,6,0
79675,2,1,278844,278848,278849,4,5,0
79676,4,3,278848,278849,278852,1,4,0
79677,3,1,278851,278852,278853,1,2,0
79678,5,1,278856,278856,278857,0,1,3
79679,6,1,278862,278862,278863,0,1,5
79680,2,1,278864,278864,278865,0,1,1
79681,5,1,278869,278869,278870,0,1,4
79682,2,3,278871,278871,278874,0,3,1
79683,2,3,278873,278874,278877,1,4,0
79684,3,3,278876,278877,278880,1,4,0
79685,6,1,278882,278882,278883,0,1,2
79686,1,2,278883,278883,278885,0,2,0
79687,2,2,278885,278885,278887,0,2,0
79688,1,2,278886,278887,278889,1,3,0
79689,1,3,278887,278889,278892,2,5,0
79690,1,1,278888,278892,278893,4,5,0
79691,2,2,278890,278893,278895,3,5,0
79692,3,1,278893,278895,278896,2,3,0
79693,2,1,278895,278896,278897,1,2,0
79694,6,3,278901,278901,278904,0,3,4
79695,5,2,278906,278906,278908,0,2,2
79696,2,1,278908,278908,278909,0,1,0
79697,1,3,278909,278909,278912,0,3,0
79698,1,2,278910,278912,278914,2,4,0
79699,5,2,278915,278915,278917,0,2,1
79700,1,1,278916,278917,278918,1,2,0
79701,4,3,278920,278920,278923,0,3,2
79702,6,3,278926,278926,278929,0,3,3
79703,5,3,278931,278931,278934,0,3,2
79704,5,1,278936,278936,278937,0,1,2
79705,2,3,278938,278938,278941,0,3,1
79706,3,3,278941,278941,278944,0,3,0
79707,5,2,278946,278946,278948,0,2,2
79708,1,1,278947,278948,278949,1,2,0
79709,6,3,278953,278953,278956,0,3,4
79710,2,2,278955,278956,278958,1,3,0
79711,5,3,278960,278960,278963,0,3,2
79712,4,1,278964,278964,278965,0,1,1
79713,3,2,278967,278967,278969,0,2,2
79714,1,2,278968,278969,278971,1,3,0
79715,6,3,278974,278974,278977,0,3,3
79716,4,2,278978,278978,278980,0,2,1
79717,1,1,278979,278980,278981,1,2,0
79718,6,1,278985,278985,278986,0,1,4
79719,2,2,278987,278987,278989,0,2,1
79720,5,2,278992,278992,278994,0,2,3
79721,1,2,278993,278994,278996,1,3,0
79722,3,3,278996,278996,278999,0,3,0
79723,4,3,279000,279000,279003,0,3,1
79724,3,3,279003,279003,279006,0,3,0
79725,2,2,279005,279006,279008,1,3,0
79726,4,1,279009,279009,279010,0,1,1
79727,4,3,279013,279013,279016,0,3,3
79728,4,1,279017,279017,279018,0,1,1
79729,4,2,279021,279021,279023,0,2,3
79730,2,2,279023,279023,279025,0,2,0
79731,5,3,279028,279028,279031,0,3,3
79732,1,3,279029,279031,279034,2,5,0
79733,6,1,279035,279035,279036,0,1,1
79734,1,3,279036,279036,279039,0,3,0
79735,5,3,279041,279041,279044,0,3,2
79736,6,2,279047,279047,279049,0,2,3
79737,4,3,279051,279051,279054,0,3,2
79738,6,3,279057,279057,279060,0,3,3
79739,5,3,279062,279062,279065,0,3,2
79740,5,2,279067,279067,279069,0,2,2
79741,2,3,279069,279069,279072,0,3,0
79742,5,2,279074,279074,279076,0,2,2
79743,4,2,279078,279078,279080,0,2,2
79744,1,1,279079,279080,279081,1,2,0
79745,3,2,279082,279082,279084,0,2,1
79746,1,1,279083,279084,279085,1,2,0
79747,6,3,279089,279089,279092,0,3,4
79748,2,1,279091,279092,279093,1,2,0
79749,5,1,279096,279096,279097,0,1,3
79750,4,3,279100,279100,279103,0,3,3
79751,2,3,279102,279103,279106,1,4,0
79752,4,1,279106,279106,279107,0,1,0
79753,6,3,279112,279112,279115,0,3,5
79754,2,2,279114,279115,279117,1,3,0
79755,6,1,279120,279120,279121,0,1,3
79756,1,2,279121,279121,279123,0,2,0
79757,3,2,279124,279124,279126,0,2,1
79758,4,1,279128,279128,279129,0,1,2
79759,4,3,279132,279132,279135,0,3,3
79760,6,3,279138,279138,279141,0,3,3
79761,3,1,279141,279141,279142,0,1,0
79762,2,2,279143,279143,279145,0,2,1
79763,1,3,279144,279145,279148,1,4,0
79764,5,3,279149,279149,279152,0,3,1
79765,4,3,279153,279153,279156,0,3,1
79766,6,3,279159,279159,279162,0,3,3
79767,5,3,279164,279164,279167,0,3,2
79768,5,1,279169,279169,279170,0,1,2
79769,2,3,279171,279171,279174,0,3,1
79770,6,3,279177,279177,279180,0,3,3
79771,5,2,279182,279182,279184,0,2,2
79772,2,1,279184,279184,279185,0,1,0
79773,5,3,279189,279189,279192,0,3,4
79774,3,1,279192,279192,279193,0,1,0
79775,3,1,279195,279195,279196,0,1,2
79776,1,2,279196,279196,279198,0,2,0
79777,1,2,279197,279198,279200,1,3,0
79778,4,3,279201,279201,279204,0,3,1
79779,1,1,279202,279204,279205,2,3,0
79780,2,2,279204,279205,279207,1,3,0
79781,2,3,279206,279207,279210,1,4,0
79782,1,2,279207,279210,279212,3,5,0
79783,4,3,279211,279212,279215,1,4,0
79784,4,2,279215,279215,279217,0,2,0
79785,5,1,279220,279220,279221,0,1,3
79786,3,2,279223,279223,279225,0,2,2
79787,4,3,279227,279227,279230,0,3,2
79788,4,1,279231,279231,279232,0,1,1
79789,2,1,279233,279233,279234,0,1,1
79790,4,1,279237,279237,279238,0,1,3
79791,3,2,279240,279240,279242,0,2,2
79792,4,2,279244,279244,279246,0,2,2
79793,5,3,279249,279249,279252,0,3,3
79794,2,1,279251,279252,279253,1,2,0
79795,3,2,279254,279254,279256,0,2,1
79796,4,1,279258,279258,279259,0,1,2
79797,6,2,279264,279264,279266,0,2,5
79798,2,1,279266,279266,279267,0,1,0
79799,1,1,279267,279267,279268,0,1,0
79800,5,3,279272,279272,279275,0,3,4
79801,3,3,279275,279275,279278,0,3,0
79802,2,1,279277,279278,279279,1,2,0
79803,5,3,279282,279282,279285,0,3,3
79804,4,3,279286,279286,279289,0,3,1
79805,1,3,279287,279289,279292,2,5,0
79806,2,1,279289,279292,279293,3,4,0
79807,4,1,279293,279293,279294,0,1,0
79808,6,2,279299,279299,279301,0,2,5
79809,2,3,279301,279301,279304,0,3,0
79810,4,3,279305,279305,279308,0,3,1
79811,4,2,279309,279309,279311,0,2,1
79812,2,2,279311,279311,279313,0,2,0
79813,6,3,279317,279317,279320,0,3,4
79814,3,1,279320,279320,279321,0,1,0
79815,2,3,279322,279322,279325,0,3,1
79816,4,2,279326,279326,279328,0,2,1
79817,1,2,279327,279328,279330,1,3,0
79818,3,3,279330,279330,279333,0,3,0
79819,1,1,279331,279333,279334,2,3,0
79820,6,2,279337,279337,279339,0,2,3
79821,3,1,279340,279340,279341,0,1,1
79822,5,3,279345,279345,279348,0,3,4
79823,5,3,279350,279350,279353,0,3,2
79824,6,2,279356,279356,279358,0,2,3
79825,5,3,279361,279361,279364,0,3,3
79826,4,3,279365,279365,279368,0,3,1
79827,2,1,279367,279368,279369,1,2,0
79828,4,1,279371,279371,279372,0,1,2
79829,1,1,279372,279372,279373,0,1,0
79830,5,3,279377,279377,279380,0,3,4
79831,1,2,279378,279380,279382,2,4,0
79832,6,1,279384,279384,279385,0,1,2
79833,4,1,279388,279388,279389,0,1,3
79834,2,3,279390,279390,279393,0,3,1
79835,1,2,279391,279393,279395,2,4,0
79836,5,1,279396,279396,279397,0,1,1
79837,3,3,279399,279399,279402,0,3,2
79838,4,2,279403,279403,279405,0,2,1
79839,3,2,279406,279406,279408,0,2,1
79840,2,2,279408,279408,279410,0,2,0
79841,2,2,279410,279410,279412,0,2,0
79842,2,3,279412,279412,279415,0,3,0
79843,1,1,279413,279415,279416,2,3,0
79844,2,1,279415,279416,279417,1,2,0
79845,5,1,279420,279420,279421,0,1,3
79846,5,3,279425,279425,279428,0,3,4
79847,1,2,279426,279428,279430,2,4,0
79848,4,2,279430,279430,279432,0,2,0
79849,3,2,279433,279433,279435,0,2,1
79850,4,2,279437,279437,279439,0,2,2
79851,2,1,279439,279439,279440,0,1,0
79852,6,3,279445,279445,279448,0,3,5
79853,2,2,279447,279448,279450,1,3,0
79854,3,2,279450,279450,279452,0,2,0
79855,4,2,279454,279454,279456,0,2,2
79856,2,1,279456,279456,279457,0,1,0
79857,3,1,279459,279459,279460,0,1,2
79858,3,2,279462,279462,279464,0,2,2
79859,2,1,279464,279464,279465,0,1,0
79860,2,2,279466,279466,279468,0,2,1
79861,2,1,279468,279468,279469,0,1,0
79862,3,1,279471,279471,279472,0,1,2
79863,3,1,279474,279474,279475,0,1,2
79864,6,2,279480,279480,279482,0,2,5
79865,1,2,279481,279482,279484,1,3,0
79866,3,1,279484,279484,279485,0,1,0
79867,6,2,279490,279490,279492,0,2,5
79868,3,3,279493,279493,279496,0,3,1
79869,1,1,279494,279496,279497,2,3,0
79870,1,3,279495,279497,279500,2,5,0
79871,6,3,279501,279501,279504,0,3,1
79872,2,3,279503,279504,279507,1,4,0
79873,4,1,279507,279507,279508,0,1,0
79874,1,3,279508,279508,279511,0,3,0
79875,4,1,279512,279512,279513,0,1,1
79876,3,3,279515,279515,279518,0,3,2
79877,4,2,279519,279519,279521,0,2,1
79878,6,1,279525,279525,279526,0,1,4
79879,5,1,279530,279530,279531,0,1,4
79880,3,1,279533,279533,279534,0,1,2
79881,5,2,279538,279538,279540,0,2,4
79882,6,1,279544,279544,279545,0,1,4
79883,2,3,279546,279546,279549,0,3,1
79884,2,2,279548,279549,279551,1,3,0
79885,5,2,279553,279553,279555,0,2,2
79886,2,1,279555,279555,279556,0,1,0
79887,1,3,279556,279556,279559,0,3,0
79888,6,3,279562,279562,279565,0,3,3
79889,3,3,279565,279565,279568,0,3,0
79890,1,3,279566,279568,279571,2,5,0
79891,6,3,279572,279572,279575,0,3,1
79892,1,2,279573,279575,279577,2,4,0
79893,3,2,279576,279577,279579,1,3,0
79894,6,2,279582,279582,279584,0,2,3
79895,4,1,279586,279586,279587,0,1,2
79896,3,3,279589,279589,279592,0,3,2
79897,3,3,279592,279592,279595,0,3,0
79898,4,2,279596,279596,279598,0,2,1
79899,6,3,279602,279602,279605,0,3,4
79900,2,3,279604,279605,279608,1,4,0
79901,4,3,279608,279608,279611,0,3,0
79902,2,3,279610,279611,279614,1,4,0
79903,5,1,279615,279615,279616,0,1,1
79904,6,2,279621,279621,279623,0,2,5
79905,6,1,279627,279627,279628,0,1,4
79906,5,1,279632,279632,279633,0,1,4
79907,3,3,279635,279635,279638,0,3,2
79908,2,3,279637,279638,279641,1,4,0
79909,4,2,279641,279641,279643,0,2,0
79910,5,2,279646,279646,279648,0,2,3
79911,5,2,279651,279651,279653,0,2,3
79912,4,2,279655,279655,279657,0,2,2
79913,6,2,279661,279661,279663,0,2,4
79914,6,1,279667,279667,279668,0,1,4
79915,6,2,279673,279673,279675,0,2,5
79916,6,3,279679,279679,279682,0,3,4
79917,6,3,279685,279685,279688,0,3,3
79918,4,3,279689,279689,279692,0,3,1
79919,3,1,279692,279692,279693,0,1,0
79920,5,1,279697,279697,279698,0,1,4
79921,6,3,279703,279703,279706,0,3,5
79922,4,3,279707,279707,279710,0,3,1
79923,4,3,279711,279711,279714,0,3,1
79924,4,3,279715,279715,279718,0,3,1
79925,3,3,279718,279718,279721,0,3,0
79926,5,3,279723,279723,279726,0,3,2
79927,2,3,279725,279726,279729,1,4,0
79928,6,3,279731,279731,279734,0,3,2
79929,3,2,279734,279734,279736,0,2,0
79930,2,1,279736,279736,279737,0,1,0
79931,5,1,279741,279741,279742,0,1,4
79932,4,2,279745,279745,279747,0,2,3
79933,6,1,279751,279751,279752,0,1,4
79934,3,2,279754,279754,279756,0,2,2
79935,5,2,279759,279759,279761,0,2,3
79936,6,3,279765,279765,279768,0,3,4
79937,4,2,279769,279769,279771,0,2,1
79938,2,3,279771,279771,279774,0,3,0
79939,4,3,279775,279775,279778,0,3,1
79940,4,3,279779,279779,279782,0,3,1
79941,6,2,279785,279785,279787,0,2,3
79942,4,3,279789,279789,279792,0,3,2
79943,6,2,279795,279795,279797,0,2,3
79944,3,2,279798,279798,279800,0,2,1
79945,6,3,279804,279804,279807,0,3,4
79946,2,2,279806,279807,279809,1,3,0
79947,3,2,279809,279809,279811,0,2,0
79948,2,3,279811,279811,279814,0,3,0
79949,5,3,279816,279816,279819,0,3,2
79950,3,3,279819,279819,279822,0,3,0
79951,2,1,279821,279822,279823,1,2,0
79952,1,3,279822,279823,279826,1,4,0
79953,4,3,279826,279826,279829,0,3,0
79954,2,2,279828,279829,279831,1,3,0
79955,5,3,279833,279833,279836,0,3,2
79956,5,2,279838,279838,279840,0,2,2
79957,5,2,279843,279843,279845,0,2,3
79958,4,3,279847,279847,279850,0,3,2
79959,4,2,279851,279851,279853,0,2,1
79960,1,3,279852,279853,279856,1,4,0
79961,1,2,279853,279856,279858,3,5,0
79962,3,1,279856,279858,279859,2,3,0
79963,1,2,279857,279859,279861,2,4,0
79964,2,3,279859,279861,279864,2,5,0
79965,1,1,279860,279864,279865,4,5,0
79966,5,1,279865,279865,279866,0,1,0
79967,2,2,279867,279867,279869,0,2,1
79968,5,1,279872,279872,279873,0,1,3
79969,6,2,279878,279878,279880,0,2,5
79970,3,1,279881,279881,279882,0,1,1
79971,2,2,279883,279883,279885,0,2,1
79972,5,2,279888,279888,279890,0,2,3
79973,2,3,279890,279890,279893,0,3,0
79974,1,1,279891,279893,279894,2,3,0
79975,4,1,279895,279895,279896,0,1,1
79976,3,2,279898,279898,279900,0,2,2
79977,4,1,279902,279902,279903,0,1,2
79978,3,2,279905,279905,279907,0,2,2
79979,2,1,279907,279907,279908,0,1,0
79980,2,1,279909,279909,279910,0,1,1
79981,4,2,279913,279913,279915,0,2,3
79982,5,2,279918,279918,279920,0,2,3
79983,1,2,279919,279920,279922,1,3,0
79984,1,1,279920,279922,279923,2,3,0
79985,4,3,279924,279924,279927,0,3,1
79986,4,1,279928,279928,279929,0,1,1
79987,6,3,279934,279934,279937,0,3,5
79988,1,1,279935,279937,279938,2,3,0
79989,5,2,279940,279940,279942,0,2,2
79990,1,3,279941,279942,279945,1,4,0
79991,6,2,279947,279947,279949,0,2,2
79992,6,1,279953,279953,279954,0,1,4
79993,4,3,279957,279957,279960,0,3,3
79994,2,2,279959,279960,279962,1,3,0
79995,2,3,279961,279962,279965,1,4,0
79996,3,1,279964,279965,279966,1,2,0
79997,1,1,279965,279966,279967,1,2,0
79998,1,2,279966,279967,279969,1,3,0
79999,4,2,279970,279970,279972,0,2,1
80000,5,2,279975,279975,279977,0,2,3
80001,2,1,279977,279977,279978,0,1,0
80002,5,1,279982,279982,279983,0,1,4
80003,3,1,279985,279985,279986,0,1,2
80004,6,1,279991,279991,279992,0,1,5
80005,6,3,279997,279997,280000,0,3,5
80006,3,2,280000,280000,280002,0,2,0
80007,1,2,280001,280002,280004,1,3,0
80008,5,3,280006,280006,280009,0,3,2
80009,4,1,280010,280010,280011,0,1,1
80010,4,3,280014,280014,280017,0,3,3
80011,1,1,280015,280017,280018,2,3,0
80012,4,3,280019,280019,280022,0,3,1
80013,5,1,280024,280024,280025,0,1,2
80014,3,1,280027,280027,280028,0,1,2
80015,1,3,280028,280028,280031,0,3,0
80016,5,2,280033,280033,280035,0,2,2
80017,4,2,280037,280037,280039,0,2,2
80018,2,1,280039,280039,280040,0,1,0
80019,2,3,280041,280041,280044,0,3,1
80020,1,2,280042,280044,280046,2,4,0
80021,2,3,280044,280046,280049,2,5,0
80022,4,3,280048,280049,280052,1,4,0
80023,3,3,280051,280052,280055,1,4,0
80024,4,1,280055,280055,280056,0,1,0
80025,3,3,280058,280058,280061,0,3,2
80026,6,2,280064,280064,280066,0,2,3
80027,2,3,280066,280066,280069,0,3,0
80028,3,3,280069,280069,280072,0,3,0
80029,2,3,280071,280072,280075,1,4,0
80030,5,3,280076,280076,280079,0,3,1
80031,6,1,280082,280082,280083,0,1,3
80032,1,3,280083,280083,280086,0,3,0
80033,5,3,280088,280088,280091,0,3,2
80034,3,3,280091,280091,280094,0,3,0
80035,2,2,280093,280094,280096,1,3,0
80036,3,2,280096,280096,280098,0,2,0
80037,2,2,280098,280098,280100,0,2,0
80038,2,3,280100,280100,280103,0,3,0
80039,4,2,280104,280104,280106,0,2,1
80040,3,3,280107,280107,280110,0,3,1
80041,6,2,280113,280113,280115,0,2,3
80042,5,1,280118,280118,280119,0,1,3
80043,5,1,280123,280123,280124,0,1,4
80044,1,2,280124,280124,280126,0,2,0
80045,5,3,280129,280129,280132,0,3,3
80046,2,2,280131,280132,280134,1,3,0
80047,3,2,280134,280134,280136,0,2,0
80048,3,2,280137,280137,280139,0,2,1
80049,3,2,280140,280140,280142,0,2,1
80050,5,1,280145,280145,280146,0,1,3
80051,6,2,280151,280151,280153,0,2,5
80052,4,3,280155,280155,280158,0,3,2
80053,6,2,280161,280161,280163,0,2,3
80054,6,1,280167,280167,280168,0,1,4
80055,1,3,280168,280168,280171,0,3,0
80056,3,3,280171,280171,280174,0,3,0
80057,3,1,280174,280174,280175,0,1,0
80058,6,1,280180,280180,280181,0,1,5
80059,2,1,280182,280182,280183,0,1,1
80060,5,2,280187,280187,280189,0,2,4
80061,3,3,280190,280190,280193,0,3,1
80062,5,1,280195,280195,280196,0,1,2
80063,5,3,280200,280200,280203,0,3,4
80064,1,2,280201,280203,280205,2,4,0
80065,2,2,280203,280205,280207,2,4,0
80066,5,3,280208,280208,280211,0,3,1
80067,5,3,280213,280213,280216,0,3,2
80068,3,1,280216,280216,280217,0,1,0
80069,6,2,280222,280222,280224,0,2,5
80070,6,3,280228,280228,280231,0,3,4
80071,1,3,280229,280231,280234,2,5,0
80072,1,3,280230,280234,280237,4,7,0
80073,3,3,280233,280237,280240,4,7,0
80074,4,2,280237,280240,280242,3,5,0
80075,4,2,280241,280242,280244,1,3,0
80076,1,2,280242,280244,280246,2,4,0
80077,5,2,280247,280247,280249,0,2,1
80078,5,2,280252,280252,280254,0,2,3
80079,6,1,280258,280258,280259,0,1,4
80080,5,2,280263,280263,280265,0,2,4
80081,6,2,280269,280269,280271,0,2,4
80082,5,3,280274,280274,280277,0,3,3
80083,2,3,280276,280277,280280,1,4,0
80084,4,3,280280,280280,280283,0,3,0
80085,5,2,280285,280285,280287,0,2,2
80086,2,2,280287,280287,280289,0,2,0
80087,1,1,280288,280289,280290,1,2,0
80088,5,1,280293,280293,280294,0,1,3
80089,1,1,280294,280294,280295,0,1,0
80090,3,2,280297,280297,280299,0,2,2
80091,5,2,280302,280302,280304,0,2,3
80092,4,2,280306,280306,280308,0,2,2
80093,4,1,280310,280310,280311,0,1,2
80094,5,1,280315,280315,280316,0,1,4
80095,4,2,280319,280319,280321,0,2,3
80096,3,1,280322,280322,280323,0,1,1
80097,1,1,280323,280323,280324,0,1,0
80098,1,3,280324,280324,280327,0,3,0
80099,5,2,280329,280329,280331,0,2,2
80100,5,1,280334,280334,280335,0,1,3
80101,1,2,280335,280335,280337,0,2,0
80102,6,1,280341,280341,280342,0,1,4
80103,4,1,280345,280345,280346,0,1,3
80104,2,3,280347,280347,280350,0,3,1
80105,4,3,280351,280351,280354,0,3,1
80106,5,1,280356,280356,280357,0,1,2
80107,4,2,280360,280360,280362,0,2,3
80108,5,3,280365,280365,280368,0,3,3
80109,3,2,280368,280368,280370,0,2,0
80110,3,2,280371,280371,280373,0,2,1
80111,1,3,280372,280373,280376,1,4,0
80112,2,2,280374,280376,280378,2,4,0
80113,4,2,280378,280378,280380,0,2,0
80114,5,2,280383,280383,280385,0,2,3
80115,4,3,280387,280387,280390,0,3,2
80116,1,3,280388,280390,280393,2,5,0
80117,6,2,280394,280394,280396,0,2,1
80118,1,2,280395,280396,280398,1,3,0
80119,4,1,280399,280399,280400,0,1,1
80120,6,3,280405,280405,280408,0,3,5
80121,3,1,280408,280408,280409,0,1,0
80122,2,1,280410,280410,280411,0,1,1
80123,5,2,280415,280415,280417,0,2,4
80124,6,1,280421,280421,280422,0,1,4
80125,5,2,280426,280426,280428,0,2,4
80126,4,1,280430,280430,280431,0,1,2
80127,3,2,280433,280433,280435,0,2,2
80128,5,3,280438,280438,280441,0,3,3
80129,1,3,280439,280441,280444,2,5,0
80130,6,2,280445,280445,280447,0,2,1
80131,2,1,280447,280447,280448,0,1,0
80132,1,3,280448,280448,280451,0,3,0
80133,4,2,280452,280452,280454,0,2,1
80134,1,3,280453,280454,280457,1,4,0
80135,2,3,280455,280457,280460,2,5,0
80136,5,3,280460,280460,280463,0,3,0
80137,1,2,280461,280463,280465,2,4,0
80138,2,2,280463,280465,280467,2,4,0
80139,3,2,280466,280467,280469,1,3,0
80140,4,2,280470,280470,280472,0,2,1
80141,1,3,280471,280472,280475,1,4,0
80142,5,2,280476,280476,280478,0,2,1
80143,2,2,280478,280478,280480,0,2,0
80144,4,3,280482,280482,280485,0,3,2
80145,5,3,280487,280487,280490,0,3,2
80146,5,1,280492,280492,280493,0,1,2
80147,2,2,280494,280494,280496,0,2,1
80148,2,1,280496,280496,280497,0,1,0
80149,5,3,280501,280501,280504,0,3,4
80150,5,2,280506,280506,280508,0,2,2
80151,1,1,280507,280508,280509,1,2,0
80152,5,1,280512,280512,280513,0,1,3
80153,2,2,280514,280514,280516,0,2,1
80154,2,3,280516,280516,280519,0,3,0
80155,6,1,280522,280522,280523,0,1,3
80156,4,2,280526,280526,280528,0,2,3
80157,3,2,280529,280529,280531,0,2,1
80158,3,3,280532,280532,280535,0,3,1
80159,5,3,280537,280537,280540,0,3,2
80160,1,2,280538,280540,280542,2,4,0
80161,6,3,280544,280544,280547,0,3,2
80162,6,2,280550,280550,280552,0,2,3
80163,5,2,280555,280555,280557,0,2,3
80164,6,2,280561,280561,280563,0,2,4
80165,3,3,280564,280564,280567,0,3,1
80166,5,2,280569,280569,280571,0,2,2
80167,3,2,280572,280572,280574,0,2,1
80168,6,2,280578,280578,280580,0,2,4
80169,3,1,280581,280581,280582,0,1,1
80170,1,1,280582,280582,280583,0,1,0
80171,6,1,280588,280588,280589,0,1,5
80172,2,1,280590,280590,280591,0,1,1
80173,4,1,280594,280594,280595,0,1,3
80174,2,2,280596,280596,280598,0,2,1
80175,1,1,280597,280598,280599,1,2,0
80176,2,2,280599,280599,280601,0,2,0
80177,4,3,280603,280603,280606,0,3,2
80178,5,3,280608,280608,280611,0,3,2
80179,3,1,280611,280611,280612,0,1,0
80180,2,3,280613,280613,280616,0,3,1
80181,4,1,280617,280617,280618,0,1,1
80182,3,3,280620,280620,280623,0,3,2
80183,5,1,280625,280625,280626,0,1,2
80184,5,2,280630,280630,280632,0,2,4
80185,3,2,280633,280633,280635,0,2,1
80186,5,2,280638,280638,280640,0,2,3
80187,5,3,280643,280643,280646,0,3,3
80188,6,2,280649,280649,280651,0,2,3
80189,5,1,280654,280654,280655,0,1,3
80190,5,3,280659,280659,280662,0,3,4
80191,6,3,280665,280665,280668,0,3,3
80192,4,1,280669,280669,280670,0,1,1
80193,6,3,280675,280675,280678,0,3,5
80194,2,3,280677,280678,280681,1,4,0
80195,5,1,280682,280682,280683,0,1,1
80196,3,1,280685,280685,280686,0,1,2
80197,4,2,280689,280689,280691,0,2,3
80198,1,2,280690,280691,280693,1,3,0
80199,6,3,280696,280696,280699,0,3,3
80200,6,2,280702,280702,280704,0,2,3
80201,3,3,280705,280705,280708,0,3,1
80202,3,1,280708,280708,280709,0,1,0
80203,1,2,280709,280709,280711,0,2,0
80204,3,3,280712,280712,280715,0,3,1
80205,6,3,280718,280718,280721,0,3,3
80206,1,3,280719,280721,280724,2,5,0
80207,2,2,280721,280724,280726,3,5,0
80208,3,3,280724,280726,280729,2,5,0
80209,6,2,280730,280730,280732,0,2,1
80210,4,1,280734,280734,280735,0,1,2
80211,4,2,280738,280738,280740,0,2,3
80212,5,2,280743,280743,280745,0,2,3
80213,4,3,280747,280747,280750,0,3,2
80214,5,3,280752,280752,280755,0,3,2
80215,5,3,280757,280757,280760,0,3,2
80216,1,2,280758,280760,280762,2,4,0
80217,2,2,280760,280762,280764,2,4,0
80218,4,3,280764,280764,280767,0,3,0
80219,6,3,280770,280770,280773,0,3,3
80220,3,3,280773,280773,280776,0,3,0
80221,6,2,280779,280779,280781,0,2,3
80222,4,3,280783,280783,280786,0,3,2
80223,1,2,280784,280786,280788,2,4,0
80224,6,1,280790,280790,280791,0,1,2
80225,2,2,280792,280792,280794,0,2,1
80226,5,2,280797,280797,280799,0,2,3
80227,4,1,280801,280801,280802,0,1,2
80228,6,1,280807,280807,280808,0,1,5
80229,5,2,280812,280812,280814,0,2,4
80230,6,1,280818,280818,280819,0,1,4
80231,2,2,280820,280820,280822,0,2,1
80232,4,2,280824,280824,280826,0,2,2
80233,6,3,280830,280830,280833,0,3,4
80234,1,3,280831,280833,280836,2,5,0
80235,4,2,280835,280836,280838,1,3,0
80236,3,1,280838,280838,280839,0,1,0
80237,6,2,280844,280844,280846,0,2,5
80238,6,1,280850,280850,280851,0,1,4
80239,2,1,280852,280852,280853,0,1,1
80240,5,3,280857,280857,280860,0,3,4
80241,5,3,280862,280862,280865,0,3,2
80242,5,2,280867,280867,280869,0,2,2
80243,5,1,280872,280872,280873,0,1,3
80244,1,1,280873,280873,280874,0,1,0
80245,6,1,280879,280879,280880,0,1,5
80246,5,1,280884,280884,280885,0,1,4
80247,6,2,280890,280890,280892,0,2,5
80248,2,2,280892,280892,280894,0,2,0
80249,2,3,280894,280894,280897,0,3,0
80250,6,1,280900,280900,280901,0,1,3
80251,1,2,280901,280901,280903,0,2,0
80252,1,1,280902,280903,280904,1,2,0
80253,2,3,280904,280904,280907,0,3,0
80254,5,1,280909,280909,280910,0,1,2
80255,6,1,280915,280915,280916,0,1,5
80256,6,1,280921,280921,280922,0,1,5
80257,3,1,280924,280924,280925,0,1,2
80258,3,2,280927,280927,280929,0,2,2
80259,1,3,280928,280929,280932,1,4,0
80260,1,1,280929,280932,280933,3,4,0
80261,1,3,280930,280933,280936,3,6,0
80262,4,2,280934,280936,280938,2,4,0
80263,3,2,280937,280938,280940,1,3,0
80264,2,3,280939,280940,280943,1,4,0
80265,2,3,280941,280943,280946,2,5,0
80266,3,2,280944,280946,280948,2,4,0
80267,2,1,280946,280948,280949,2,3,0
80268,6,2,280952,280952,280954,0,2,3
80269,6,3,280958,280958,280961,0,3,4
80270,5,2,280963,280963,280965,0,2,2
80271,4,2,280967,280967,280969,0,2,2
80272,6,2,280973,280973,280975,0,2,4
80273,6,3,280979,280979,280982,0,3,4
80274,6,1,280985,280985,280986,0,1,3
80275,3,1,280988,280988,280989,0,1,2
80276,4,3,280992,280992,280995,0,3,3
80277,3,3,280995,280995,280998,0,3,0
80278,3,3,280998,280998,281001,0,3,0
80279,4,2,281002,281002,281004,0,2,1
80280,4,1,281006,281006,281007,0,1,2
80281,1,3,281007,281007,281010,0,3,0
80282,1,3,281008,281010,281013,2,5,0
80283,2,3,281010,281013,281016,3,6,0
80284,3,2,281013,281016,281018,3,5,0
80285,4,3,281017,281018,281021,1,4,0
80286,5,3,281022,281022,281025,0,3,1
80287,1,3,281023,281025,281028,2,5,0
80288,1,1,281024,281028,281029,4,5,0
80289,5,3,281029,281029,281032,0,3,0
80290,4,1,281033,281033,281034,0,1,1
80291,6,1,281039,281039,281040,0,1,5
80292,4,2,281043,281043,281045,0,2,3
80293,5,2,281048,281048,281050,0,2,3
80294,2,2,281050,281050,281052,0,2,0
80295,1,3,281051,281052,281055,1,4,0
80296,2,1,281053,281055,281056,2,3,0
80297,1,1,281054,281056,281057,2,3,0
80298,5,2,281059,281059,281061,0,2,2
80299,3,2,281062,281062,281064,0,2,1
80300,4,2,281066,281066,281068,0,2,2
80301,6,1,281072,281072,281073,0,1,4
80302,5,1,281077,281077,281078,0,1,4
80303,2,3,281079,281079,281082,0,3,1
80304,4,3,281083,281083,281086,0,3,1
80305,2,3,281085,281086,281089,1,4,0
80306,1,2,281086,281089,281091,3,5,0
80307,3,2,281089,281091,281093,2,4,0
80308,5,2,281094,281094,281096,0,2,1
80309,3,3,281097,281097,281100,0,3,1
80310,5,3,281102,281102,281105,0,3,2
80311,4,3,281106,281106,281109,0,3,1
80312,6,2,281112,281112,281114,0,2,3
80313,3,1,281115,281115,281116,0,1,1
80314,3,1,281118,281118,281119,0,1,2
80315,1,2,281119,281119,281121,0,2,0
80316,5,1,281124,281124,281125,0,1,3
80317,5,3,281129,281129,281132,0,3,4
80318,2,1,281131,281132,281133,1,2,0
80319,6,1,281137,281137,281138,0,1,4
80320,6,3,281143,281143,281146,0,3,5
80321,6,3,281149,281149,281152,0,3,3
80322,6,2,281155,281155,281157,0,2,3
80323,3,2,281158,281158,281160,0,2,1
80324,5,3,281163,281163,281166,0,3,3
80325,5,3,281168,281168,281171,0,3,2
80326,1,1,281169,281171,281172,2,3,0
80327,5,1,281174,281174,281175,0,1,2
80328,4,3,281178,281178,281181,0,3,3
80329,6,3,281184,281184,281187,0,3,3
80330,6,1,281190,281190,281191,0,1,3
80331,4,2,281194,281194,281196,0,2,3
80332,3,1,281197,281197,281198,0,1,1
80333,6,1,281203,281203,281204,0,1,5
80334,2,2,281205,281205,281207,0,2,1
80335,5,3,281210,281210,281213,0,3,3
80336,3,3,281213,281213,281216,0,3,0
80337,6,2,281219,281219,281221,0,2,3
80338,1,1,281220,281221,281222,1,2,0
80339,4,1,281224,281224,281225,0,1,2
80340,5,1,281229,281229,281230,0,1,4
80341,6,1,281235,281235,281236,0,1,5
80342,4,2,281239,281239,281241,0,2,3
80343,5,3,281244,281244,281247,0,3,3
80344,4,3,281248,281248,281251,0,3,1
80345,4,3,281252,281252,281255,0,3,1
80346,1,3,281253,281255,281258,2,5,0
80347,3,3,281256,281258,281261,2,5,0
80348,5,3,281261,281261,281264,0,3,0
80349,1,1,281262,281264,281265,2,3,0
80350,6,2,281268,281268,281270,0,2,3
80351,2,3,281270,281270,281273,0,3,0
80352,5,1,281275,281275,281276,0,1,2
80353,2,3,281277,281277,281280,0,3,1
80354,5,3,281282,281282,281285,0,3,2
80355,5,3,281287,281287,281290,0,3,2
80356,4,1,281291,281291,281292,0,1,1
80357,3,2,281294,281294,281296,0,2,2
80358,6,2,281300,281300,281302,0,2,4
80359,2,1,281302,281302,281303,0,1,0
80360,2,3,281304,281304,281307,0,3,1
80361,3,3,281307,281307,281310,0,3,0
80362,1,3,281308,281310,281313,2,5,0
80363,5,2,281313,281313,281315,0,2,0
80364,2,3,281315,281315,281318,0,3,0
80365,4,3,281319,281319,281322,0,3,1
80366,6,1,281325,281325,281326,0,1,3
80367,5,2,281330,281330,281332,0,2,4
80368,5,3,281335,281335,281338,0,3,3
80369,4,2,281339,281339,281341,0,2,1
80370,6,2,281345,281345,281347,0,2,4
80371,3,3,281348,281348,281351,0,3,1
80372,3,2,281351,281351,281353,0,2,0
80373,1,2,281352,281353,281355,1,3,0
80374,2,3,281354,281355,281358,1,4,0
80375,6,1,281360,281360,281361,0,1,2
80376,4,2,281364,281364,281366,0,2,3
80377,5,1,281369,281369,281370,0,1,3
80378,2,2,281371,281371,281373,0,2,1
80379,5,2,281376,281376,281378,0,2,3
80380,2,1,281378,281378,281379,0,1,0
80381,1,3,281379,281379,281382,0,3,0
80382,4,2,281383,281383,281385,0,2,1
80383,1,1,281384,281385,281386,1,2,0
80384,4,1,281388,281388,281389,0,1,2
80385,1,2,281389,281389,281391,0,2,0
80386,1,3,281390,281391,281394,1,4,0
80387,4,3,281394,281394,281397,0,3,0
80388,2,2,281396,281397,281399,1,3,0
80389,1,2,281397,281399,281401,2,4,0
80390,4,1,281401,281401,281402,0,1,0
80391,3,1,281404,281404,281405,0,1,2
80392,5,1,281409,281409,281410,0,1,4
80393,4,2,281413,281413,281415,0,2,3
80394,1,3,281414,281415,281418,1,4,0
80395,5,2,281419,281419,281421,0,2,1
80396,3,3,281422,281422,281425,0,3,1
80397,6,2,281428,281428,281430,0,2,3
80398,3,2,281431,281431,281433,0,2,1
80399,6,3,281437,281437,281440,0,3,4
80400,1,3,281438,281440,281443,2,5,0
80401,3,1,281441,281443,281444,2,3,0
80402,5,1,281446,281446,281447,0,1,2
80403,1,3,281447,281447,281450,0,3,0
80404,1,3,281448,281450,281453,2,5,0
80405,3,3,281451,281453,281456,2,5,0
80406,5,2,281456,281456,281458,0,2,0
80407,1,1,281457,281458,281459,1,2,0
80408,5,2,281462,281462,281464,0,2,3
80409,5,1,281467,281467,281468,0,1,3
80410,2,3,281469,281469,281472,0,3,1
80411,6,2,281475,281475,281477,0,2,3
80412,2,3,281477,281477,281480,0,3,0
80413,5,1,281482,281482,281483,0,1,2
80414,6,1,281488,281488,281489,0,1,5
80415,2,3,281490,281490,281493,0,3,1
80416,6,3,281496,281496,281499,0,3,3
80417,1,1,281497,281499,281500,2,3,0
80418,5,3,281502,281502,281505,0,3,2
80419,1,1,281503,281505,281506,2,3,0
80420,5,3,281508,281508,281511,0,3,2
80421,4,1,281512,281512,281513,0,1,1
80422,4,1,281516,281516,281517,0,1,3
80423,1,3,281517,281517,281520,0,3,0
80424,4,2,281521,281521,281523,0,2,1
80425,6,2,281527,281527,281529,0,2,4
80426,1,3,281528,281529,281532,1,4,0
80427,2,3,281530,281532,281535,2,5,0
80428,2,2,281532,281535,281537,3,5,0
80429,6,1,281538,281538,281539,0,1,1
80430,6,1,281544,281544,281545,0,1,5
80431,6,1,281550,281550,281551,0,1,5
80432,5,2,281555,281555,281557,0,2,4
80433,2,2,281557,281557,281559,0,2,0
80434,3,3,281560,281560,281563,0,3,1
80435,3,1,281563,281563,281564,0,1,0
80436,4,2,281567,281567,281569,0,2,3
80437,1,1,281568,281569,281570,1,2,0
80438,1,1,281569,281570,281571,1,2,0
80439,3,3,281572,281572,281575,0,3,1
80440,4,1,281576,281576,281577,0,1,1
80441,4,1,281580,281580,281581,0,1,3
80442,5,2,281585,281585,281587,0,2,4
80443,6,3,281591,281591,281594,0,3,4
80444,1,1,281592,281594,281595,2,3,0
80445,1,3,281593,281595,281598,2,5,0
80446,2,2,281595,281598,281600,3,5,0
80447,2,3,281597,281600,281603,3,6,0
80448,3,1,281600,281603,281604,3,4,0
80449,5,2,281605,281605,281607,0,2,1
80450,5,1,281610,281610,281611,0,1,3
80451,3,3,281613,281613,281616,0,3,2
80452,4,1,281617,281617,281618,0,1,1
80453,2,3,281619,281619,281622,0,3,1
80454,3,2,281622,281622,281624,0,2,0
80455,6,1,281628,281628,281629,0,1,4
80456,6,1,281634,281634,281635,0,1,5
80457,6,3,281640,281640,281643,0,3,5
80458,4,1,281644,281644,281645,0,1,1
80459,1,1,281645,281645,281646,0,1,0
80460,1,2,281646,281646,281648,0,2,0
80461,6,3,281652,281652,281655,0,3,4
80462,2,2,281654,281655,281657,1,3,0
80463,1,1,281655,281657,281658,2,3,0
80464,2,1,281657,281658,281659,1,2,0
80465,6,1,281663,281663,281664,0,1,4
80466,1,1,281664,281664,281665,0,1,0
80467,1,3,281665,281665,281668,0,3,0
80468,6,2,281671,281671,281673,0,2,3
80469,6,1,281677,281677,281678,0,1,4
80470,2,2,281679,281679,281681,0,2,1
80471,6,3,281685,281685,281688,0,3,4
80472,4,1,281689,281689,281690,0,1,1
80473,3,3,281692,281692,281695,0,3,2
80474,5,1,281697,281697,281698,0,1,2
80475,3,1,281700,281700,281701,0,1,2
80476,1,1,281701,281701,281702,0,1,0
80477,5,2,281706,281706,281708,0,2,4
80478,3,1,281709,281709,281710,0,1,1
80479,3,3,281712,281712,281715,0,3,2
80480,3,1,281715,281715,281716,0,1,0
80481,6,1,281721,281721,281722,0,1,5
80482,2,2,281723,281723,281725,0,2,1
80483,3,1,281726,281726,281727,0,1,1
80484,3,2,281729,281729,281731,0,2,2
80485,6,2,281735,281735,281737,0,2,4
80486,1,1,281736,281737,281738,1,2,0
80487,6,2,281742,281742,281744,0,2,4
80488,4,2,281746,281746,281748,0,2,2
80489,6,3,281752,281752,281755,0,3,4
80490,1,2,281753,281755,281757,2,4,0
80491,2,2,281755,281757,281759,2,4,0
80492,2,1,281757,281759,281760,2,3,0
80493,4,2,281761,281761,281763,0,2,1
80494,3,2,281764,281764,281766,0,2,1
80495,2,3,281766,281766,281769,0,3,0
80496,5,3,281771,281771,281774,0,3,2
80497,2,2,281773,281774,281776,1,3,0
80498,2,1,281775,281776,281777,1,2,0
80499,4,2,281779,281779,281781,0,2,2
80500,4,3,281783,281783,281786,0,3,2
80501,5,3,281788,281788,281791,0,3,2
80502,5,1,281793,281793,281794,0,1,2
80503,6,3,281799,281799,281802,0,3,5
80504,1,3,281800,281802,281805,2,5,0
80505,3,3,281803,281805,281808,2,5,0
80506,3,2,281806,281808,281810,2,4,0
80507,1,1,281807,281810,281811,3,4,0
80508,5,3,281812,281812,281815,0,3,1
80509,5,3,281817,281817,281820,0,3,2
80510,1,1,281818,281820,281821,2,3,0
80511,6,1,281824,281824,281825,0,1,3
80512,3,3,281827,281827,281830,0,3,2
80513,6,1,281833,281833,281834,0,1,3
80514,3,1,281836,281836,281837,0,1,2
80515,3,2,281839,281839,281841,0,2,2
80516,1,1,281840,281841,281842,1,2,0
80517,5,2,281845,281845,281847,0,2,3
80518,2,2,281847,281847,281849,0,2,0
80519,3,2,281850,281850,281852,0,2,1
80520,4,1,281854,281854,281855,0,1,2
80521,3,1,281857,281857,281858,0,1,2
80522,4,2,281861,281861,281863,0,2,3
80523,6,1,281867,281867,281868,0,1,4
80524,1,2,281868,281868,281870,0,2,0
80525,6,1,281874,281874,281875,0,1,4
80526,3,3,281877,281877,281880,0,3,2
80527,5,1,281882,281882,281883,0,1,2
80528,4,3,281886,281886,281889,0,3,3
80529,3,1,281889,281889,281890,0,1,0
80530,3,1,281892,281892,281893,0,1,2
80531,3,3,281895,281895,281898,0,3,2
80532,4,1,281899,281899,281900,0,1,1
80533,4,1,281903,281903,281904,0,1,3
80534,1,2,281904,281904,281906,0,2,0
80535,3,3,281907,281907,281910,0,3,1
80536,5,1,281912,281912,281913,0,1,2
80537,3,2,281915,281915,281917,0,2,2
80538,5,1,281920,281920,281921,0,1,3
80539,2,2,281922,281922,281924,0,2,1
80540,3,1,281925,281925,281926,0,1,1
80541,1,1,281926,281926,281927,0,1,0
80542,3,1,281929,281929,281930,0,1,2
80543,4,1,281933,281933,281934,0,1,3
80544,1,2,281934,281934,281936,0,2,0
80545,1,1,281935,281936,281937,1,2,0
80546,6,1,281941,281941,281942,0,1,4
80547,1,2,281942,281942,281944,0,2,0
80548,3,3,281945,281945,281948,0,3,1
80549,2,3,281947,281948,281951,1,4,0
80550,1,2,281948,281951,281953,3,5,0
80551,4,1,281952,281953,281954,1,2,0
80552,1,3,281953,281954,281957,1,4,0
80553,1,2,281954,281957,281959,3,5,0
80554,4,1,281958,281959,281960,1,2,0
80555,4,3,281962,281962,281965,0,3,2
80556,1,3,281963,281965,281968,2,5,0
80557,6,2,281969,281969,281971,0,2,1
80558,3,1,281972,281972,281973,0,1,1
80559,1,3,281973,281973,281976,0,3,0
80560,2,1,281975,281976,281977,1,2,0
80561,1,1,281976,281977,281978,1,2,0
80562,3,1,281979,281979,281980,0,1,1
80563,1,2,281980,281980,281982,0,2,0
80564,4,2,281984,281984,281986,0,2,2
80565,4,1,281988,281988,281989,0,1,2
80566,1,3,281989,281989,281992,0,3,0
80567,6,2,281995,281995,281997,0,2,3
80568,6,3,282001,282001,282004,0,3,4
80569,6,2,282007,282007,282009,0,2,3
80570,4,2,282011,282011,282013,0,2,2
80571,2,2,282013,282013,282015,0,2,0
80572,1,1,282014,282015,282016,1,2,0
80573,2,3,282016,282016,282019,0,3,0
80574,1,2,282017,282019,282021,2,4,0
80575,3,3,282020,282021,282024,1,4,0
80576,6,2,282026,282026,282028,0,2,2
80577,5,1,282031,282031,282032,0,1,3
80578,6,2,282037,282037,282039,0,2,5
80579,1,3,282038,282039,282042,1,4,0
80580,2,1,282040,282042,282043,2,3,0
80581,3,3,282043,282043,282046,0,3,0
80582,4,2,282047,282047,282049,0,2,1
80583,1,3,282048,282049,282052,1,4,0
80584,4,2,282052,282052,282054,0,2,0
80585,6,3,282058,282058,282061,0,3,4
80586,3,1,282061,282061,282062,0,1,0
80587,5,2,282066,282066,282068,0,2,4
80588,4,1,282070,282070,282071,0,1,2
80589,4,1,282074,282074,282075,0,1,3
80590,1,2,282075,282075,282077,0,2,0
80591,6,1,282081,282081,282082,0,1,4
80592,2,2,282083,282083,282085,0,2,1
80593,5,3,282088,282088,282091,0,3,3
80594,1,3,282089,282091,282094,2,5,0
80595,2,2,282091,282094,282096,3,5,0
80596,1,2,282092,282096,282098,4,6,0
80597,5,1,282097,282098,282099,1,2,0
80598,2,2,282099,282099,282101,0,2,0
80599,6,3,282105,282105,282108,0,3,4
80600,4,1,282109,282109,282110,0,1,1
80601,3,3,282112,282112,282115,0,3,2
80602,4,1,282116,282116,282117,0,1,1
80603,4,3,282120,282120,282123,0,3,3
80604,1,2,282121,282123,282125,2,4,0
80605,1,3,282122,282125,282128,3,6,0
80606,3,3,282125,282128,282131,3,6,0
80607,3,2,282128,282131,282133,3,5,0
80608,2,1,282130,282133,282134,3,4,0
80609,2,1,282132,282134,282135,2,3,0
80610,3,2,282135,282135,282137,0,2,0
80611,6,2,282141,282141,282143,0,2,4
80612,4,2,282145,282145,282147,0,2,2
80613,1,1,282146,282147,282148,1,2,0
80614,2,2,282148,282148,282150,0,2,0
80615,6,3,282154,282154,282157,0,3,4
80616,5,3,282159,282159,282162,0,3,2
80617,6,2,282165,282165,282167,0,2,3
80618,1,3,282166,282167,282170,1,4,0
80619,2,1,282168,282170,282171,2,3,0
80620,6,3,282174,282174,282177,0,3,3
80621,6,3,282180,282180,282183,0,3,3
80622,4,2,282184,282184,282186,0,2,1
80623,6,2,282190,282190,282192,0,2,4
80624,4,3,282194,282194,282197,0,3,2
80625,1,3,282195,282197,282200,2,5,0
80626,6,2,282201,282201,282203,0,2,1
80627,6,3,282207,282207,282210,0,3,4
80628,1,1,282208,282210,282211,2,3,0
80629,4,2,282212,282212,282214,0,2,1
80630,2,3,282214,282214,282217,0,3,0
80631,6,2,282220,282220,282222,0,2,3
80632,5,1,282225,282225,282226,0,1,3
80633,5,3,282230,282230,282233,0,3,4
80634,3,1,282233,282233,282234,0,1,0
80635,3,1,282236,282236,282237,0,1,2
80636,1,2,282237,282237,282239,0,2,0
80637,6,3,282243,282243,282246,0,3,4
80638,2,1,282245,282246,282247,1,2,0
80639,2,2,282247,282247,282249,0,2,0
80640,6,2,282253,282253,282255,0,2,4
80641,4,2,282257,282257,282259,0,2,2
80642,2,2,282259,282259,282261,0,2,0
80643,2,1,282261,282261,282262,0,1,0
80644,5,1,282266,282266,282267,0,1,4
80645,1,3,282267,282267,282270,0,3,0
80646,4,1,282271,282271,282272,0,1,1
80647,5,1,282276,282276,282277,0,1,4
80648,6,2,282282,282282,282284,0,2,5
80649,4,2,282286,282286,282288,0,2,2
80650,3,2,282289,282289,282291,0,2,1
80651,6,2,282295,282295,282297,0,2,4
80652,4,2,282299,282299,282301,0,2,2
80653,3,2,282302,282302,282304,0,2,1
80654,1,2,282303,282304,282306,1,3,0
80655,5,1,282308,282308,282309,0,1,2
80656,2,2,282310,282310,282312,0,2,1
80657,4,1,282314,282314,282315,0,1,2
80658,4,1,282318,282318,282319,0,1,3
80659,2,1,282320,282320,282321,0,1,1
80660,4,2,282324,282324,282326,0,2,3
80661,5,2,282329,282329,282331,0,2,3
80662,4,2,282333,282333,282335,0,2,2
80663,2,3,282335,282335,282338,0,3,0
80664,5,1,282340,282340,282341,0,1,2
80665,1,2,282341,282341,282343,0,2,0
80666,3,1,282344,282344,282345,0,1,1
80667,2,2,282346,282346,282348,0,2,1
80668,4,2,282350,282350,282352,0,2,2
80669,2,2,282352,282352,282354,0,2,0
80670,3,2,282355,282355,282357,0,2,1
80671,2,3,282357,282357,282360,0,3,0
80672,5,3,282362,282362,282365,0,3,2
80673,5,1,282367,282367,282368,0,1,2
80674,5,1,282372,282372,282373,0,1,4
80675,5,2,282377,282377,282379,0,2,4
80676,1,2,282378,282379,282381,1,3,0
80677,2,3,282380,282381,282384,1,4,0
80678,5,3,282385,282385,282388,0,3,1
80679,5,3,282390,282390,282393,0,3,2
80680,1,2,282391,282393,282395,2,4,0
80681,6,1,282397,282397,282398,0,1,2
80682,1,2,282398,282398,282400,0,2,0
80683,4,1,282402,282402,282403,0,1,2
80684,2,1,282404,282404,282405,0,1,1
80685,4,1,282408,282408,282409,0,1,3
80686,3,2,282411,282411,282413,0,2,2
80687,6,2,282417,282417,282419,0,2,4
80688,5,2,282422,282422,282424,0,2,3
80689,3,3,282425,282425,282428,0,3,1
80690,5,2,282430,282430,282432,0,2,2
80691,4,3,282434,282434,282437,0,3,2
80692,5,3,282439,282439,282442,0,3,2
80693,4,3,282443,282443,282446,0,3,1
80694,4,1,282447,282447,282448,0,1,1
80695,4,3,282451,282451,282454,0,3,3
80696,1,3,282452,282454,282457,2,5,0
80697,6,2,282458,282458,282460,0,2,1
80698,3,2,282461,282461,282463,0,2,1
80699,3,1,282464,282464,282465,0,1,1
80700,5,3,282469,282469,282472,0,3,4
80701,6,2,282475,282475,282477,0,2,3
80702,5,1,282480,282480,282481,0,1,3
80703,4,3,282484,282484,282487,0,3,3
80704,2,1,282486,282487,282488,1,2,0
80705,3,3,282489,282489,282492,0,3,1
80706,3,2,282492,282492,282494,0,2,0
80707,5,1,282497,282497,282498,0,1,3
80708,1,2,282498,282498,282500,0,2,0
80709,6,3,282504,282504,282507,0,3,4
80710,4,1,282508,282508,282509,0,1,1
80711,2,1,282510,282510,282511,0,1,1
80712,3,2,282513,282513,282515,0,2,2
80713,3,3,282516,282516,282519,0,3,1
80714,1,3,282517,282519,282522,2,5,0
80715,2,3,282519,282522,282525,3,6,0
80716,3,3,282522,282525,282528,3,6,0
80717,2,2,282524,282528,282530,4,6,0
80718,1,1,282525,282530,282531,5,6,0
80719,3,2,282528,282531,282533,3,5,0
80720,3,1,282531,282533,282534,2,3,0
80721,3,2,282534,282534,282536,0,2,0
80722,3,2,282537,282537,282539,0,2,1
80723,3,2,282540,282540,282542,0,2,1
80724,5,3,282545,282545,282548,0,3,3
80725,1,1,282546,282548,282549,2,3,0
80726,6,2,282552,282552,282554,0,2,3
80727,2,3,282554,282554,282557,0,3,0
80728,3,2,282557,282557,282559,0,2,0
80729,3,2,282560,282560,282562,0,2,1
80730,2,2,282562,282562,282564,0,2,0
80731,2,1,282564,282564,282565,0,1,0
80732,2,1,282566,282566,282567,0,1,1
80733,5,1,282571,282571,282572,0,1,4
80734,2,1,282573,282573,282574,0,1,1
80735,6,3,282579,282579,282582,0,3,5
80736,1,3,282580,282582,282585,2,5,0
80737,4,3,282584,282585,282588,1,4,0
80738,6,1,282590,282590,282591,0,1,2
80739,4,1,282594,282594,282595,0,1,3
80740,5,2,282599,282599,282601,0,2,4
80741,5,3,282604,282604,282607,0,3,3
80742,1,2,282605,282607,282609,2,4,0
80743,5,1,282610,282610,282611,0,1,1
80744,4,2,282614,282614,282616,0,2,3
80745,6,1,282620,282620,282621,0,1,4
80746,6,1,282626,282626,282627,0,1,5
80747,4,2,282630,282630,282632,0,2,3
80748,1,2,282631,282632,282634,1,3,0
80749,3,3,282634,282634,282637,0,3,0
80750,2,2,282636,282637,282639,1,3,0
80751,4,2,282640,282640,282642,0,2,1
80752,3,3,282643,282643,282646,0,3,1
80753,6,1,282649,282649,282650,0,1,3
80754,1,1,282650,282650,282651,0,1,0
80755,4,1,282654,282654,282655,0,1,3
80756,4,1,282658,282658,282659,0,1,3
80757,2,1,282660,282660,282661,0,1,1
80758,5,3,282665,282665,282668,0,3,4
80759,3,3,282668,282668,282671,0,3,0
80760,1,3,282669,282671,282674,2,5,0
80761,3,1,282672,282674,282675,2,3,0
80762,2,2,282674,282675,282677,1,3,0
80763,6,1,282680,282680,282681,0,1,3
80764,2,2,282682,282682,282684,0,2,1
80765,5,3,282687,282687,282690,0,3,3
80766,4,2,282691,282691,282693,0,2,1
80767,4,2,282695,282695,282697,0,2,2
80768,1,1,282696,282697,282698,1,2,0
80769,5,1,282701,282701,282702,0,1,3
80770,5,3,282706,282706,282709,0,3,4
80771,1,1,282707,282709,282710,2,3,0
80772,1,1,282708,282710,282711,2,3,0
80773,1,1,282709,282711,282712,2,3,0
80774,2,2,282711,282712,282714,1,3,0
80775,1,1,282712,282714,282715,2,3,0
80776,3,2,282715,282715,282717,0,2,0
80777,3,3,282718,282718,282721,0,3,1
80778,4,1,282722,282722,282723,0,1,1
80779,1,2,282723,282723,282725,0,2,0
80780,4,1,282727,282727,282728,0,1,2
80781,4,2,282731,282731,282733,0,2,3
80782,2,3,282733,282733,282736,0,3,0
80783,2,1,282735,282736,282737,1,2,0
80784,3,1,282738,282738,282739,0,1,1
80785,4,2,282742,282742,282744,0,2,3
80786,4,1,282746,282746,282747,0,1,2
80787,6,2,282752,282752,282754,0,2,5
80788,4,3,282756,282756,282759,0,3,2
80789,5,1,282761,282761,282762,0,1,2
80790,6,2,282767,282767,282769,0,2,5
80791,3,1,282770,282770,282771,0,1,1
80792,3,1,282773,282773,282774,0,1,2
80793,2,1,282775,282775,282776,0,1,1
80794,3,2,282778,282778,282780,0,2,2
80795,4,2,282782,282782,282784,0,2,2
80796,5,3,282787,282787,282790,0,3,3
80797,4,2,282791,282791,282793,0,2,1
80798,5,3,282796,282796,282799,0,3,3
80799,3,2,282799,282799,282801,0,2,0
80800,1,1,282800,282801,282802,1,2,0
80801,1,2,282801,282802,282804,1,3,0
80802,6,1,282807,282807,282808,0,1,3
80803,6,2,282813,282813,282815,0,2,5
80804,1,1,282814,282815,282816,1,2,0
80805,1,3,282815,282816,282819,1,4,0
80806,1,3,282816,282819,282822,3,6,0
80807,2,2,282818,282822,282824,4,6,0
80808,4,3,282822,282824,282827,2,5,0
80809,2,1,282824,282827,282828,3,4,0
80810,5,1,282829,282829,282830,0,1,1
80811,2,3,282831,282831,282834,0,3,1
80812,5,1,282836,282836,282837,0,1,2
80813,3,2,282839,282839,282841,0,2,2
80814,1,2,282840,282841,282843,1,3,0
80815,1,1,282841,282843,282844,2,3,0
80816,6,3,282847,282847,282850,0,3,3
80817,6,3,282853,282853,282856,0,3,3
80818,2,3,282855,282856,282859,1,4,0
80819,2,1,282857,282859,282860,2,3,0
80820,6,2,282863,282863,282865,0,2,3
80821,5,2,282868,282868,282870,0,2,3
80822,2,3,282870,282870,282873,0,3,0
80823,2,1,282872,282873,282874,1,2,0
80824,3,2,282875,282875,282877,0,2,1
80825,2,3,282877,282877,282880,0,3,0
80826,1,1,282878,282880,282881,2,3,0
80827,2,3,282880,282881,282884,1,4,0
80828,5,3,282885,282885,282888,0,3,1
80829,3,3,282888,282888,282891,0,3,0
80830,1,2,282889,282891,282893,2,4,0
80831,5,1,282894,282894,282895,0,1,1
80832,2,2,282896,282896,282898,0,2,1
80833,3,3,282899,282899,282902,0,3,1
80834,1,3,282900,282902,282905,2,5,0
80835,1,1,282901,282905,282906,4,5,0
80836,5,1,282906,282906,282907,0,1,0
80837,6,2,282912,282912,282914,0,2,5
80838,6,3,282918,282918,282921,0,3,4
80839,6,1,282924,282924,282925,0,1,3
80840,2,2,282926,282926,282928,0,2,1
80841,2,3,282928,282928,282931,0,3,0
80842,3,2,282931,282931,282933,0,2,0
80843,2,3,282933,282933,282936,0,3,0
80844,4,1,282937,282937,282938,0,1,1
80845,3,3,282940,282940,282943,0,3,2
80846,3,3,282943,282943,282946,0,3,0
80847,5,2,282948,282948,282950,0,2,2
80848,3,2,282951,282951,282953,0,2,1
80849,6,3,282957,282957,282960,0,3,4
80850,2,2,282959,282960,282962,1,3,0
80851,2,1,282961,282962,282963,1,2,0
80852,2,2,282963,282963,282965,0,2,0
80853,6,1,282969,282969,282970,0,1,4
80854,3,1,282972,282972,282973,0,1,2
80855,4,1,282976,282976,282977,0,1,3
80856,5,2,282981,282981,282983,0,2,4
80857,5,1,282986,282986,282987,0,1,3
80858,4,2,282990,282990,282992,0,2,3
80859,3,2,282993,282993,282995,0,2,1
80860,6,3,282999,282999,283002,0,3,4
80861,2,2,283001,283002,283004,1,3,0
80862,4,1,283005,283005,283006,0,1,1
80863,4,2,283009,283009,283011,0,2,3
80864,6,1,283015,283015,283016,0,1,4
80865,4,3,283019,283019,283022,0,3,3
80866,5,1,283024,283024,283025,0,1,2
80867,6,1,283030,283030,283031,0,1,5
80868,2,3,283032,283032,283035,0,3,1
80869,4,3,283036,283036,283039,0,3,1
80870,4,2,283040,283040,283042,0,2,1
80871,2,1,283042,283042,283043,0,1,0
80872,1,3,283043,283043,283046,0,3,0
80873,1,3,283044,283046,283049,2,5,0
80874,5,3,283049,283049,283052,0,3,0
80875,5,3,283054,283054,283057,0,3,2
80876,4,3,283058,283058,283061,0,3,1
80877,1,2,283059,283061,283063,2,4,0
80878,2,1,283061,283063,283064,2,3,0
80879,1,2,283062,283064,283066,2,4,0
80880,1,3,283063,283066,283069,3,6,0
80881,4,3,283067,283069,283072,2,5,0
80882,6,3,283073,283073,283076,0,3,1
80883,4,2,283077,283077,283079,0,2,1
80884,4,3,283081,283081,283084,0,3,2
80885,1,1,283082,283084,283085,2,3,0
80886,2,3,283084,283085,283088,1,4,0
80887,3,1,283087,283088,283089,1,2,0
80888,3,1,283090,283090,283091,0,1,1
80889,2,3,283092,283092,283095,0,3,1
80890,5,3,283097,283097,283100,0,3,2
80891,6,1,283103,283103,283104,0,1,3
80892,2,2,283105,283105,283107,0,2,1
80893,3,2,283108,283108,283110,0,2,1
80894,2,2,283110,283110,283112,0,2,0
80895,2,1,283112,283112,283113,0,1,0
80896,3,3,283115,283115,283118,0,3,2
80897,2,1,283117,283118,283119,1,2,0
80898,3,2,283120,283120,283122,0,2,1
80899,3,1,283123,283123,283124,0,1,1
80900,5,2,283128,283128,283130,0,2,4
80901,6,3,283134,283134,283137,0,3,4
80902,2,1,283136,283137,283138,1,2,0
80903,5,3,283141,283141,283144,0,3,3
80904,1,2,283142,283144,283146,2,4,0
80905,4,2,283146,283146,283148,0,2,0
80906,1,2,283147,283148,283150,1,3,0
80907,1,1,283148,283150,283151,2,3,0
80908,4,3,283152,283152,283155,0,3,1
80909,6,3,283158,283158,283161,0,3,3
80910,5,2,283163,283163,283165,0,2,2
80911,3,3,283166,283166,283169,0,3,1
80912,3,3,283169,283169,283172,0,3,0
80913,6,2,283175,283175,283177,0,2,3
80914,6,3,283181,283181,283184,0,3,4
80915,4,2,283185,283185,283187,0,2,1
80916,6,2,283191,283191,283193,0,2,4
80917,4,3,283195,283195,283198,0,3,2
80918,6,2,283201,283201,283203,0,2,3
80919,6,2,283207,283207,283209,0,2,4
80920,1,3,283208,283209,283212,1,4,0
80921,6,2,283214,283214,283216,0,2,2
80922,3,1,283217,283217,283218,0,1,1
80923,2,2,283219,283219,283221,0,2,1
80924,6,1,283225,283225,283226,0,1,4
80925,3,3,283228,283228,283231,0,3,2
80926,1,2,283229,283231,283233,2,4,0
80927,5,1,283234,283234,283235,0,1,1
80928,3,3,283237,283237,283240,0,3,2
80929,2,3,283239,283240,283243,1,4,0
80930,6,3,283245,283245,283248,0,3,2
80931,3,1,283248,283248,283249,0,1,0
80932,4,2,283252,283252,283254,0,2,3
80933,5,1,283257,283257,283258,0,1,3
80934,6,2,283263,283263,283265,0,2,5
80935,1,3,283264,283265,283268,1,4,0
80936,3,3,283267,283268,283271,1,4,0
80937,4,1,283271,283271,283272,0,1,0
80938,2,2,283273,283273,283275,0,2,1
80939,4,3,283277,283277,283280,0,3,2
80940,5,3,283282,283282,283285,0,3,2
80941,1,3,283283,283285,283288,2,5,0
80942,5,1,283288,283288,283289,0,1,0
80943,4,2,283292,283292,283294,0,2,3
80944,5,2,283297,283297,283299,0,2,3
80945,2,1,283299,283299,283300,0,1,0
80946,3,3,283302,283302,283305,0,3,2
80947,4,3,283306,283306,283309,0,3,1
80948,1,2,283307,283309,283311,2,4,0
80949,1,3,283308,283311,283314,3,6,0
80950,5,3,283313,283314,283317,1,4,0
80951,1,1,283314,283317,283318,3,4,0
80952,6,3,283320,283320,283323,0,3,2
80953,5,3,283325,283325,283328,0,3,2
80954,2,1,283327,283328,283329,1,2,0
80955,4,1,283331,283331,283332,0,1,2
80956,1,2,283332,283332,283334,0,2,0
80957,2,1,283334,283334,283335,0,1,0
80958,6,2,283340,283340,283342,0,2,5
80959,1,3,283341,283342,283345,1,4,0
80960,2,2,283343,283345,283347,2,4,0
80961,5,2,283348,283348,283350,0,2,1
80962,6,1,283354,283354,283355,0,1,4
80963,4,3,283358,283358,283361,0,3,3
80964,2,3,283360,283361,283364,1,4,0
80965,3,1,283363,283364,283365,1,2,0
80966,4,3,283367,283367,283370,0,3,2
80967,1,2,283368,283370,283372,2,4,0
80968,2,1,283370,283372,283373,2,3,0
80969,2,2,283372,283373,283375,1,3,0
80970,1,3,283373,283375,283378,2,5,0
80971,5,3,283378,283378,283381,0,3,0
80972,4,2,283382,283382,283384,0,2,1
80973,3,3,283385,283385,283388,0,3,1
80974,3,2,283388,283388,283390,0,2,0
80975,6,2,283394,283394,283396,0,2,4
80976,6,3,283400,283400,283403,0,3,4
80977,6,1,283406,283406,283407,0,1,3
80978,5,1,283411,283411,283412,0,1,4
80979,6,1,283417,283417,283418,0,1,5
80980,3,1,283420,283420,283421,0,1,2
80981,2,1,283422,283422,283423,0,1,1
80982,5,3,283427,283427,283430,0,3,4
80983,4,1,283431,283431,283432,0,1,1
80984,6,3,283437,283437,283440,0,3,5
80985,3,1,283440,283440,283441,0,1,0
80986,5,1,283445,283445,283446,0,1,4
80987,6,2,283451,283451,283453,0,2,5
80988,4,3,283455,283455,283458,0,3,2
80989,5,1,283460,283460,283461,0,1,2
80990,2,1,283462,283462,283463,0,1,1
80991,6,2,283468,283468,283470,0,2,5
80992,4,3,283472,283472,283475,0,3,2
80993,6,1,283478,283478,283479,0,1,3
80994,1,3,283479,283479,283482,0,3,0
80995,2,2,283481,283482,283484,1,3,0
80996,1,1,283482,283484,283485,2,3,0
80997,1,2,283483,283485,283487,2,4,0
80998,2,1,283485,283487,283488,2,3,0
80999,5,1,283490,283490,283491,0,1,2
81000,2,1,283492,283492,283493,0,1,1
81001,2,2,283494,283494,283496,0,2,1
81002,3,3,283497,283497,283500,0,3,1
81003,6,3,283503,283503,283506,0,3,3
81004,3,1,283506,283506,283507,0,1,0
81005,6,2,283512,283512,283514,0,2,5
81006,5,2,283517,283517,283519,0,2,3
81007,4,1,283521,283521,283522,0,1,2
81008,2,2,283523,283523,283525,0,2,1
81009,6,1,283529,283529,283530,0,1,4
81010,5,1,283534,283534,283535,0,1,4
81011,5,1,283539,283539,283540,0,1,4
81012,6,3,283545,283545,283548,0,3,5
81013,1,1,283546,283548,283549,2,3,0
81014,6,3,283552,283552,283555,0,3,3
81015,6,3,283558,283558,283561,0,3,3
81016,4,3,283562,283562,283565,0,3,1
81017,4,1,283566,283566,283567,0,1,1
81018,4,3,283570,283570,283573,0,3,3
81019,6,1,283576,283576,283577,0,1,3
81020,5,2,283581,283581,283583,0,2,4
81021,6,3,283587,283587,283590,0,3,4
81022,2,1,283589,283590,283591,1,2,0
81023,4,2,283593,283593,283595,0,2,2
81024,3,3,283596,283596,283599,0,3,1
81025,1,3,283597,283599,283602,2,5,0
81026,6,3,283603,283603,283606,0,3,1
81027,1,3,283604,283606,283609,2,5,0
81028,6,3,283610,283610,283613,0,3,1
81029,4,3,283614,283614,283617,0,3,1
81030,5,3,283619,283619,283622,0,3,2
81031,2,3,283621,283622,283625,1,4,0
81032,4,1,283625,283625,283626,0,1,0
81033,3,1,283628,283628,283629,0,1,2
81034,6,1,283634,283634,283635,0,1,5
81035,6,1,283640,283640,283641,0,1,5
81036,6,3,283646,283646,283649,0,3,5
81037,3,2,283649,283649,283651,0,2,0
81038,6,3,283655,283655,283658,0,3,4
81039,4,2,283659,283659,283661,0,2,1
81040,1,1,283660,283661,283662,1,2,0
81041,6,2,283666,283666,283668,0,2,4
81042,6,1,283672,283672,283673,0,1,4
81043,1,2,283673,283673,283675,0,2,0
81044,6,2,283679,283679,283681,0,2,4
81045,3,1,283682,283682,283683,0,1,1
81046,5,2,283687,283687,283689,0,2,4
81047,6,3,283693,283693,283696,0,3,4
81048,1,3,283694,283696,283699,2,5,0
81049,4,3,283698,283699,283702,1,4,0
81050,6,1,283704,283704,283705,0,1,2
81051,6,1,283710,283710,283711,0,1,5
81052,4,3,283714,283714,283717,0,3,3
81053,1,2,283715,283717,283719,2,4,0
81054,1,1,283716,283719,283720,3,4,0
81055,5,2,283721,283721,283723,0,2,1
81056,6,2,283727,283727,283729,0,2,4
81057,6,3,283733,283733,283736,0,3,4
81058,3,2,283736,283736,283738,0,2,0
81059,6,2,283742,283742,283744,0,2,4
81060,2,1,283744,283744,283745,0,1,0
81061,1,3,283745,283745,283748,0,3,0
81062,5,2,283750,283750,283752,0,2,2
81063,5,2,283755,283755,283757,0,2,3
81064,5,3,283760,283760,283763,0,3,3
81065,3,2,283763,283763,283765,0,2,0
81066,6,2,283769,283769,283771,0,2,4
81067,4,3,283773,283773,283776,0,3,2
81068,5,2,283778,283778,283780,0,2,2
81069,1,2,283779,283780,283782,1,3,0
81070,4,3,283783,283783,283786,0,3,1
81071,1,2,283784,283786,283788,2,4,0
81072,5,2,283789,283789,283791,0,2,1
81073,3,2,283792,283792,283794,0,2,1
81074,1,1,283793,283794,283795,1,2,0
81075,5,2,283798,283798,283800,0,2,3
81076,1,1,283799,283800,283801,1,2,0
81077,1,2,283800,283801,283803,1,3,0
81078,4,1,283804,283804,283805,0,1,1
81079,6,1,283810,283810,283811,0,1,5
81080,6,2,283816,283816,283818,0,2,5
81081,4,2,283820,283820,283822,0,2,2
81082,4,2,283824,283824,283826,0,2,2
81083,4,2,283828,283828,283830,0,2,2
81084,6,3,283834,283834,283837,0,3,4
81085,2,2,283836,283837,283839,1,3,0
81086,1,3,283837,283839,283842,2,5,0
81087,3,2,283840,283842,283844,2,4,0
81088,2,3,283842,283844,283847,2,5,0
81089,4,2,283846,283847,283849,1,3,0
81090,2,3,283848,283849,283852,1,4,0
81091,4,1,283852,283852,283853,0,1,0
81092,6,3,283858,283858,283861,0,3,5
81093,2,2,283860,283861,283863,1,3,0
81094,1,3,283861,283863,283866,2,5,0
81095,1,1,283862,283866,283867,4,5,0
81096,2,2,283864,283867,283869,3,5,0
81097,3,3,283867,283869,283872,2,5,0
81098,3,2,283870,283872,283874,2,4,0
81099,5,2,283875,283875,283877,0,2,1
81100,5,3,283880,283880,283883,0,3,3
81101,5,1,283885,283885,283886,0,1,2
81102,6,1,283891,283891,283892,0,1,5
81103,5,2,283896,283896,283898,0,2,4
81104,6,1,283902,283902,283903,0,1,4
81105,4,1,283906,283906,283907,0,1,3
81106,5,3,283911,283911,283914,0,3,4
81107,5,1,283916,283916,283917,0,1,2
81108,6,1,283922,283922,283923,0,1,5
81109,1,2,283923,283923,283925,0,2,0
81110,4,3,283927,283927,283930,0,3,2
81111,5,3,283932,283932,283935,0,3,2
81112,5,3,283937,283937,283940,0,3,2
81113,6,3,283943,283943,283946,0,3,3
81114,6,2,283949,283949,283951,0,2,3
81115,6,2,283955,283955,283957,0,2,4
81116,6,3,283961,283961,283964,0,3,4
81117,4,3,283965,283965,283968,0,3,1
81118,6,3,283971,283971,283974,0,3,3
81119,1,3,283972,283974,283977,2,5,0
81120,6,1,283978,283978,283979,0,1,1
81121,2,1,283980,283980,283981,0,1,1
81122,5,2,283985,283985,283987,0,2,4
81123,1,1,283986,283987,283988,1,2,0
81124,2,2,283988,283988,283990,0,2,0
81125,6,1,283994,283994,283995,0,1,4
81126,5,2,283999,283999,284001,0,2,4
81127,6,3,284005,284005,284008,0,3,4
81128,6,3,284011,284011,284014,0,3,3
81129,5,2,284016,284016,284018,0,2,2
81130,1,3,284017,284018,284021,1,4,0
81131,3,1,284020,284021,284022,1,2,0
81132,6,3,284026,284026,284029,0,3,4
81133,2,2,284028,284029,284031,1,3,0
81134,2,1,284030,284031,284032,1,2,0
81135,3,3,284033,284033,284036,0,3,1
81136,4,3,284037,284037,284040,0,3,1
81137,6,1,284043,284043,284044,0,1,3
81138,4,1,284047,284047,284048,0,1,3
81139,2,3,284049,284049,284052,0,3,1
81140,3,1,284052,284052,284053,0,1,0
81141,5,2,284057,284057,284059,0,2,4
81142,4,1,284061,284061,284062,0,1,2
81143,4,2,284065,284065,284067,0,2,3
81144,3,3,284068,284068,284071,0,3,1
81145,6,2,284074,284074,284076,0,2,3
81146,5,3,284079,284079,284082,0,3,3
81147,4,3,284083,284083,284086,0,3,1
81148,4,1,284087,284087,284088,0,1,1
81149,1,3,284088,284088,284091,0,3,0
81150,5,1,284093,284093,284094,0,1,2
81151,3,2,284096,284096,284098,0,2,2
81152,1,3,284097,284098,284101,1,4,0
81153,2,2,284099,284101,284103,2,4,0
81154,3,1,284102,284103,284104,1,2,0
81155,3,3,284105,284105,284108,0,3,1
81156,3,1,284108,284108,284109,0,1,0
81157,3,3,284111,284111,284114,0,3,2
81158,4,1,284115,284115,284116,0,1,1
81159,5,2,284120,284120,284122,0,2,4
81160,4,1,284124,284124,284125,0,1,2
81161,3,2,284127,284127,284129,0,2,2
81162,5,3,284132,284132,284135,0,3,3
81163,4,1,284136,284136,284137,0,1,1
81164,6,3,284142,284142,284145,0,3,5
81165,4,1,284146,284146,284147,0,1,1
81166,4,1,284150,284150,284151,0,1,3
81167,3,2,284153,284153,284155,0,2,2
81168,4,2,284157,284157,284159,0,2,2
81169,1,2,284158,284159,284161,1,3,0
81170,6,1,284164,284164,284165,0,1,3
81171,2,3,284166,284166,284169,0,3,1
81172,3,2,284169,284169,284171,0,2,0
81173,1,2,284170,284171,284173,1,3,0
81174,3,2,284173,284173,284175,0,2,0
81175,3,2,284176,284176,284178,0,2,1
81176,3,2,284179,284179,284181,0,2,1
81177,4,1,284183,284183,284184,0,1,2
81178,4,1,284187,284187,284188,0,1,3
81179,5,2,284192,284192,284194,0,2,4
81180,2,1,284194,284194,284195,0,1,0
81181,2,2,284196,284196,284198,0,2,1
81182,4,2,284200,284200,284202,0,2,2
81183,4,1,284204,284204,284205,0,1,2
81184,1,2,284205,284205,284207,0,2,0
81185,2,1,284207,284207,284208,0,1,0
81186,3,1,284210,284210,284211,0,1,2
81187,4,2,284214,284214,284216,0,2,3
81188,6,3,284220,284220,284223,0,3,4
81189,6,2,284226,284226,284228,0,2,3
81190,3,3,284229,284229,284232,0,3,1
81191,1,1,284230,284232,284233,2,3,0
81192,6,1,284236,284236,284237,0,1,3
81193,3,1,284239,284239,284240,0,1,2
81194,2,2,284241,284241,284243,0,2,1
81195,3,2,284244,284244,284246,0,2,1
81196,3,3,284247,284247,284250,0,3,1
81197,2,2,284249,284250,284252,1,3,0
81198,3,2,284252,284252,284254,0,2,0
81199,1,1,284253,284254,284255,1,2,0
81200,4,2,284257,284257,284259,0,2,2
81201,4,1,284261,284261,284262,0,1,2
81202,6,3,284267,284267,284270,0,3,5
81203,4,1,284271,284271,284272,0,1,1
81204,5,1,284276,284276,284277,0,1,4
81205,2,3,284278,284278,284281,0,3,1
81206,3,1,284281,284281,284282,0,1,0
81207,1,1,284282,284282,284283,0,1,0
81208,6,1,284288,284288,284289,0,1,5
81209,2,1,284290,284290,284291,0,1,1
81210,1,3,284291,284291,284294,0,3,0
81211,4,3,284295,284295,284298,0,3,1
81212,6,3,284301,284301,284304,0,3,3
81213,4,3,284305,284305,284308,0,3,1
81214,5,1,284310,284310,284311,0,1,2
81215,6,2,284316,284316,284318,0,2,5
81216,1,1,284317,284318,284319,1,2,0
81217,6,3,284323,284323,284326,0,3,4
81218,2,2,284325,284326,284328,1,3,0
81219,4,2,284329,284329,284331,0,2,1
81220,1,2,284330,284331,284333,1,3,0
81221,1,3,284331,284333,284336,2,5,0
81222,3,3,284334,284336,284339,2,5,0
81223,1,1,284335,284339,284340,4,5,0
81224,5,2,284340,284340,284342,0,2,0
81225,4,2,284344,284344,284346,0,2,2
81226,4,2,284348,284348,284350,0,2,2
81227,6,2,284354,284354,284356,0,2,4
81228,2,1,284356,284356,284357,0,1,0
81229,2,3,284358,284358,284361,0,3,1
81230,2,2,284360,284361,284363,1,3,0
81231,1,2,284361,284363,284365,2,4,0
81232,5,1,284366,284366,284367,0,1,1
81233,6,3,284372,284372,284375,0,3,5
81234,5,3,284377,284377,284380,0,3,2
81235,1,1,284378,284380,284381,2,3,0
81236,1,1,284379,284381,284382,2,3,0
81237,6,3,284385,284385,284388,0,3,3
81238,3,2,284388,284388,284390,0,2,0
81239,5,1,284393,284393,284394,0,1,3
81240,4,3,284397,284397,284400,0,3,3
81241,5,2,284402,284402,284404,0,2,2
81242,5,2,284407,284407,284409,0,2,3
81243,3,3,284410,284410,284413,0,3,1
81244,6,1,284416,284416,284417,0,1,3
81245,1,3,284417,284417,284420,0,3,0
81246,3,3,284420,284420,284423,0,3,0
81247,2,2,284422,284423,284425,1,3,0
81248,1,1,284423,284425,284426,2,3,0
81249,6,2,284429,284429,284431,0,2,3
81250,6,2,284435,284435,284437,0,2,4
81251,5,1,284440,284440,284441,0,1,3
81252,3,3,284443,284443,284446,0,3,2
81253,5,1,284448,284448,284449,0,1,2
81254,5,1,284453,284453,284454,0,1,4
81255,3,1,284456,284456,284457,0,1,2
81256,1,2,284457,284457,284459,0,2,0
81257,1,3,284458,284459,284462,1,4,0
81258,2,3,284460,284462,284465,2,5,0
81259,5,2,284465,284465,284467,0,2,0
81260,4,3,284469,284469,284472,0,3,2
81261,5,3,284474,284474,284477,0,3,2
81262,4,1,284478,284478,284479,0,1,1
81263,5,3,284483,284483,284486,0,3,4
81264,2,1,284485,284486,284487,1,2,0
81265,6,2,284491,284491,284493,0,2,4
81266,2,1,284493,284493,284494,0,1,0
81267,5,1,284498,284498,284499,0,1,4
81268,6,3,284504,284504,284507,0,3,5
81269,1,1,284505,284507,284508,2,3,0
81270,1,3,284506,284508,284511,2,5,0
81271,1,1,284507,284511,284512,4,5,0
81272,6,2,284513,284513,284515,0,2,1
81273,4,3,284517,284517,284520,0,3,2
81274,6,2,284523,284523,284525,0,2,3
81275,3,2,284526,284526,284528,0,2,1
81276,6,2,284532,284532,284534,0,2,4
81277,2,3,284534,284534,284537,0,3,0
81278,5,1,284539,284539,284540,0,1,2
81279,4,3,284543,284543,284546,0,3,3
81280,3,3,284546,284546,284549,0,3,0
81281,4,1,284550,284550,284551,0,1,1
81282,5,1,284555,284555,284556,0,1,4
81283,2,2,284557,284557,284559,0,2,1
81284,4,3,284561,284561,284564,0,3,2
81285,5,1,284566,284566,284567,0,1,2
81286,4,3,284570,284570,284573,0,3,3
81287,1,2,284571,284573,284575,2,4,0
81288,6,2,284577,284577,284579,0,2,2
81289,5,3,284582,284582,284585,0,3,3
81290,6,1,284588,284588,284589,0,1,3
81291,2,1,284590,284590,284591,0,1,1
81292,3,1,284593,284593,284594,0,1,2
81293,1,3,284594,284594,284597,0,3,0
81294,1,2,284595,284597,284599,2,4,0
81295,6,1,284601,284601,284602,0,1,2
81296,6,1,284607,284607,284608,0,1,5
81297,6,1,284613,284613,284614,0,1,5
81298,3,2,284616,284616,284618,0,2,2
81299,2,1,284618,284618,284619,0,1,0
81300,1,2,284619,284619,284621,0,2,0
81301,5,1,284624,284624,284625,0,1,3
81302,1,3,284625,284625,284628,0,3,0
81303,1,3,284626,284628,284631,2,5,0
81304,6,3,284632,284632,284635,0,3,1
81305,3,1,284635,284635,284636,0,1,0
81306,6,3,284641,284641,284644,0,3,5
81307,5,1,284646,284646,284647,0,1,2
81308,4,2,284650,284650,284652,0,2,3
81309,5,3,284655,284655,284658,0,3,3
81310,2,2,284657,284658,284660,1,3,0
81311,1,2,284658,284660,284662,2,4,0
81312,5,1,284663,284663,284664,0,1,1
81313,3,2,284666,284666,284668,0,2,2
81314,4,1,284670,284670,284671,0,1,2
81315,4,3,284674,284674,284677,0,3,3
81316,2,1,284676,284677,284678,1,2,0
81317,5,2,284681,284681,284683,0,2,3
81318,2,3,284683,284683,284686,0,3,0
81319,5,2,284688,284688,284690,0,2,2
81320,3,3,284691,284691,284694,0,3,1
81321,6,3,284697,284697,284700,0,3,3
81322,2,2,284699,284700,284702,1,3,0
81323,5,3,284704,284704,284707,0,3,2
81324,2,3,284706,284707,284710,1,4,0
81325,6,2,284712,284712,284714,0,2,2
81326,4,2,284716,284716,284718,0,2,2
81327,4,1,284720,284720,284721,0,1,2
81328,4,2,284724,284724,284726,0,2,3
81329,4,2,284728,284728,284730,0,2,2
81330,4,3,284732,284732,284735,0,3,2
81331,1,1,284733,284735,284736,2,3,0
81332,3,3,284736,284736,284739,0,3,0
81333,1,1,284737,284739,284740,2,3,0
81334,4,3,284741,284741,284744,0,3,1
81335,1,2,284742,284744,284746,2,4,0
81336,2,3,284744,284746,284749,2,5,0
81337,2,3,284746,284749,284752,3,6,0
81338,3,2,284749,284752,284754,3,5,0
81339,4,1,284753,284754,284755,1,2,0
81340,6,3,284759,284759,284762,0,3,4
81341,2,3,284761,284762,284765,1,4,0
81342,2,2,284763,284765,284767,2,4,0
81343,4,2,284767,284767,284769,0,2,0
81344,5,3,284772,284772,284775,0,3,3
81345,3,3,284775,284775,284778,0,3,0
81346,5,1,284780,284780,284781,0,1,2
81347,4,1,284784,284784,284785,0,1,3
81348,5,1,284789,284789,284790,0,1,4
81349,5,3,284794,284794,284797,0,3,4
81350,1,3,284795,284797,284800,2,5,0
81351,2,2,284797,284800,284802,3,5,0
81352,5,3,284802,284802,284805,0,3,0
81353,5,1,284807,284807,284808,0,1,2
81354,6,2,284813,284813,284815,0,2,5
81355,2,2,284815,284815,284817,0,2,0
81356,5,1,284820,284820,284821,0,1,3
81357,2,3,284822,284822,284825,0,3,1
81358,3,1,284825,284825,284826,0,1,0
81359,2,2,284827,284827,284829,0,2,1
81360,1,1,284828,284829,284830,1,2,0
81361,1,2,284829,284830,284832,1,3,0
81362,3,1,284832,284832,284833,0,1,0
81363,6,1,284838,284838,284839,0,1,5
81364,1,3,284839,284839,284842,0,3,0
81365,3,2,284842,284842,284844,0,2,0
81366,1,1,284843,284844,284845,1,2,0
81367,3,1,284846,284846,284847,0,1,1
81368,6,3,284852,284852,284855,0,3,5
81369,2,2,284854,284855,284857,1,3,0
81370,1,3,284855,284857,284860,2,5,0
81371,2,1,284857,284860,284861,3,4,0
81372,3,2,284860,284861,284863,1,3,0
81373,4,2,284864,284864,284866,0,2,1
81374,4,3,284868,284868,284871,0,3,2
81375,3,3,284871,284871,284874,0,3,0
81376,3,3,284874,284874,284877,0,3,0
81377,6,2,284880,284880,284882,0,2,3
81378,4,1,284884,284884,284885,0,1,2
81379,5,1,284889,284889,284890,0,1,4
81380,2,2,284891,284891,284893,0,2,1
81381,4,3,284895,284895,284898,0,3,2
81382,6,2,284901,284901,284903,0,2,3
81383,4,1,284905,284905,284906,0,1,2
81384,6,1,284911,284911,284912,0,1,5
81385,4,3,284915,284915,284918,0,3,3
81386,5,3,284920,284920,284923,0,3,2
81387,2,3,284922,284923,284926,1,4,0
81388,5,1,284927,284927,284928,0,1,1
81389,4,2,284931,284931,284933,0,2,3
81390,5,1,284936,284936,284937,0,1,3
81391,2,3,284938,284938,284941,0,3,1
81392,1,3,284939,284941,284944,2,5,0
81393,5,3,284944,284944,284947,0,3,0
81394,6,3,284950,284950,284953,0,3,3
81395,5,1,284955,284955,284956,0,1,2
81396,6,1,284961,284961,284962,0,1,5
81397,6,1,284967,284967,284968,0,1,5
81398,2,1,284969,284969,284970,0,1,1
81399,6,3,284975,284975,284978,0,3,5
81400,3,2,284978,284978,284980,0,2,0
81401,4,3,284982,284982,284985,0,3,2
81402,2,3,284984,284985,284988,1,4,0
81403,3,2,284987,284988,284990,1,3,0
81404,2,3,284989,284990,284993,1,4,0
81405,3,2,284992,284993,284995,1,3,0
81406,3,3,284995,284995,284998,0,3,0
81407,1,1,284996,284998,284999,2,3,0
81408,1,3,284997,284999,285002,2,5,0
81409,6,3,285003,285003,285006,0,3,1
81410,5,2,285008,285008,285010,0,2,2
81411,2,3,285010,285010,285013,0,3,0
81412,3,3,285013,285013,285016,0,3,0
81413,4,3,285017,285017,285020,0,3,1
81414,4,1,285021,285021,285022,0,1,1
81415,4,1,285025,285025,285026,0,1,3
81416,4,1,285029,285029,285030,0,1,3
81417,2,3,285031,285031,285034,0,3,1
81418,5,3,285036,285036,285039,0,3,2
81419,4,1,285040,285040,285041,0,1,1
81420,4,3,285044,285044,285047,0,3,3
81421,2,2,285046,285047,285049,1,3,0
81422,2,2,285048,285049,285051,1,3,0
81423,4,2,285052,285052,285054,0,2,1
81424,5,1,285057,285057,285058,0,1,3
81425,1,2,285058,285058,285060,0,2,0
81426,2,3,285060,285060,285063,0,3,0
81427,6,3,285066,285066,285069,0,3,3
81428,3,3,285069,285069,285072,0,3,0
81429,1,1,285070,285072,285073,2,3,0
81430,4,3,285074,285074,285077,0,3,1
81431,1,2,285075,285077,285079,2,4,0
81432,6,3,285081,285081,285084,0,3,2
81433,4,3,285085,285085,285088,0,3,1
81434,4,2,285089,285089,285091,0,2,1
81435,3,1,285092,285092,285093,0,1,1
81436,6,3,285098,285098,285101,0,3,5
81437,2,1,285100,285101,285102,1,2,0
81438,4,3,285104,285104,285107,0,3,2
81439,3,3,285107,285107,285110,0,3,0
81440,6,1,285113,285113,285114,0,1,3
81441,4,1,285117,285117,285118,0,1,3
81442,2,1,285119,285119,285120,0,1,1
81443,3,2,285122,285122,285124,0,2,2
81444,2,1,285124,285124,285125,0,1,0
81445,2,2,285126,285126,285128,0,2,1
81446,2,3,285128,285128,285131,0,3,0
81447,3,2,285131,285131,285133,0,2,0
81448,5,3,285136,285136,285139,0,3,3
81449,5,2,285141,285141,285143,0,2,2
81450,1,2,285142,285143,285145,1,3,0
81451,5,1,285147,285147,285148,0,1,2
81452,3,1,285150,285150,285151,0,1,2
81453,3,3,285153,285153,285156,0,3,2
81454,2,2,285155,285156,285158,1,3,0
81455,4,2,285159,285159,285161,0,2,1
81456,4,3,285163,285163,285166,0,3,2
81457,5,1,285168,285168,285169,0,1,2
81458,5,3,285173,285173,285176,0,3,4
81459,1,2,285174,285176,285178,2,4,0
81460,4,3,285178,285178,285181,0,3,0
81461,3,3,285181,285181,285184,0,3,0
81462,2,2,285183,285184,285186,1,3,0
81463,5,3,285188,285188,285191,0,3,2
81464,3,3,285191,285191,285194,0,3,0
81465,2,2,285193,285194,285196,1,3,0
81466,1,1,285194,285196,285197,2,3,0
81467,2,1,285196,285197,285198,1,2,0
81468,2,2,285198,285198,285200,0,2,0
81469,3,3,285201,285201,285204,0,3,1
81470,4,1,285205,285205,285206,0,1,1
81471,6,1,285211,285211,285212,0,1,5
81472,2,2,285213,285213,285215,0,2,1
81473,5,1,285218,285218,285219,0,1,3
81474,1,1,285219,285219,285220,0,1,0
81475,4,3,285223,285223,285226,0,3,3
81476,6,1,285229,285229,285230,0,1,3
81477,6,2,285235,285235,285237,0,2,5
81478,4,3,285239,285239,285242,0,3,2
81479,5,2,285244,285244,285246,0,2,2
81480,6,1,285250,285250,285251,0,1,4
81481,4,2,285254,285254,285256,0,2,3
81482,2,3,285256,285256,285259,0,3,0
81483,5,3,285261,285261,285264,0,3,2
81484,2,2,285263,285264,285266,1,3,0
81485,1,1,285264,285266,285267,2,3,0
81486,6,1,285270,285270,285271,0,1,3
81487,2,3,285272,285272,285275,0,3,1
81488,5,3,285277,285277,285280,0,3,2
81489,3,1,285280,285280,285281,0,1,0
81490,5,1,285285,285285,285286,0,1,4
81491,3,2,285288,285288,285290,0,2,2
81492,1,3,285289,285290,285293,1,4,0
81493,5,2,285294,285294,285296,0,2,1
81494,1,1,285295,285296,285297,1,2,0
81495,2,2,285297,285297,285299,0,2,0
81496,5,1,285302,285302,285303,0,1,3
81497,3,3,285305,285305,285308,0,3,2
81498,5,1,285310,285310,285311,0,1,2
81499,1,3,285311,285311,285314,0,3,0
81500,2,3,285313,285314,285317,1,4,0
81501,4,1,285317,285317,285318,0,1,0
81502,5,1,285322,285322,285323,0,1,4
81503,6,1,285328,285328,285329,0,1,5
81504,3,3,285331,285331,285334,0,3,2
81505,3,1,285334,285334,285335,0,1,0
81506,5,1,285339,285339,285340,0,1,4
81507,5,3,285344,285344,285347,0,3,4
81508,5,1,285349,285349,285350,0,1,2
81509,3,2,285352,285352,285354,0,2,2
81510,1,3,285353,285354,285357,1,4,0
81511,5,2,285358,285358,285360,0,2,1
81512,1,2,285359,285360,285362,1,3,0
81513,6,2,285365,285365,285367,0,2,3
81514,2,1,285367,285367,285368,0,1,0
81515,4,3,285371,285371,285374,0,3,3
81516,6,1,285377,285377,285378,0,1,3
81517,5,1,285382,285382,285383,0,1,4
81518,2,2,285384,285384,285386,0,2,1
81519,1,2,285385,285386,285388,1,3,0
81520,4,1,285389,285389,285390,0,1,1
81521,1,3,285390,285390,285393,0,3,0
81522,5,3,285395,285395,285398,0,3,2
81523,6,3,285401,285401,285404,0,3,3
81524,5,1,285406,285406,285407,0,1,2
81525,4,2,285410,285410,285412,0,2,3
81526,6,3,285416,285416,285419,0,3,4
81527,2,3,285418,285419,285422,1,4,0
81528,6,2,285424,285424,285426,0,2,2
81529,3,2,285427,285427,285429,0,2,1
81530,5,3,285432,285432,285435,0,3,3
81531,4,2,285436,285436,285438,0,2,1
81532,1,1,285437,285438,285439,1,2,0
81533,3,2,285440,285440,285442,0,2,1
81534,3,2,285443,285443,285445,0,2,1
81535,1,2,285444,285445,285447,1,3,0
81536,4,1,285448,285448,285449,0,1,1
81537,3,1,285451,285451,285452,0,1,2
81538,4,1,285455,285455,285456,0,1,3
81539,4,1,285459,285459,285460,0,1,3
81540,4,2,285463,285463,285465,0,2,3
81541,1,1,285464,285465,285466,1,2,0
81542,3,1,285467,285467,285468,0,1,1
81543,3,3,285470,285470,285473,0,3,2
81544,5,2,285475,285475,285477,0,2,2
81545,5,3,285480,285480,285483,0,3,3
81546,5,2,285485,285485,285487,0,2,2
81547,2,2,285487,285487,285489,0,2,0
81548,5,1,285492,285492,285493,0,1,3
81549,5,1,285497,285497,285498,0,1,4
81550,4,1,285501,285501,285502,0,1,3
81551,1,3,285502,285502,285505,0,3,0
81552,2,2,285504,285505,285507,1,3,0
81553,5,1,285509,285509,285510,0,1,2
81554,1,3,285510,285510,285513,0,3,0
81555,1,2,285511,285513,285515,2,4,0
81556,2,1,285513,285515,285516,2,3,0
81557,6,2,285519,285519,285521,0,2,3
81558,4,3,285523,285523,285526,0,3,2
81559,2,1,285525,285526,285527,1,2,0
81560,6,1,285531,285531,285532,0,1,4
81561,1,2,285532,285532,285534,0,2,0
81562,3,2,285535,285535,285537,0,2,1
81563,6,1,285541,285541,285542,0,1,4
81564,3,2,285544,285544,285546,0,2,2
81565,6,3,285550,285550,285553,0,3,4
81566,5,2,285555,285555,285557,0,2,2
81567,1,1,285556,285557,285558,1,2,0
81568,1,3,285557,285558,285561,1,4,0
81569,1,1,285558,285561,285562,3,4,0
81570,6,2,285564,285564,285566,0,2,2
81571,1,3,285565,285566,285569,1,4,0
81572,5,2,285570,285570,285572,0,2,1
81573,5,2,285575,285575,285577,0,2,3
81574,4,2,285579,285579,285581,0,2,2
81575,3,3,285582,285582,285585,0,3,1
81576,6,2,285588,285588,285590,0,2,3
81577,3,1,285591,285591,285592,0,1,1
81578,1,1,285592,285592,285593,0,1,0
81579,2,2,285594,285594,285596,0,2,1
81580,3,2,285597,285597,285599,0,2,1
81581,1,3,285598,285599,285602,1,4,0
81582,6,3,285604,285604,285607,0,3,2
81583,1,3,285605,285607,285610,2,5,0
81584,3,3,285608,285610,285613,2,5,0
81585,5,2,285613,285613,285615,0,2,0
81586,6,1,285619,285619,285620,0,1,4
81587,4,2,285623,285623,285625,0,2,3
81588,3,1,285626,285626,285627,0,1,1
81589,1,2,285627,285627,285629,0,2,0
81590,5,2,285632,285632,285634,0,2,3
81591,3,2,285635,285635,285637,0,2,1
81592,4,3,285639,285639,285642,0,3,2
81593,3,2,285642,285642,285644,0,2,0
81594,6,1,285648,285648,285649,0,1,4
81595,5,3,285653,285653,285656,0,3,4
81596,4,1,285657,285657,285658,0,1,1
81597,3,2,285660,285660,285662,0,2,2
81598,2,2,285662,285662,285664,0,2,0
81599,5,1,285667,285667,285668,0,1,3
81600,6,3,285673,285673,285676,0,3,5
81601,4,1,285677,285677,285678,0,1,1
81602,3,3,285680,285680,285683,0,3,2
81603,3,1,285683,285683,285684,0,1,0
81604,4,1,285687,285687,285688,0,1,3
81605,3,3,285690,285690,285693,0,3,2
81606,5,2,285695,285695,285697,0,2,2
81607,6,3,285701,285701,285704,0,3,4
81608,6,1,285707,285707,285708,0,1,3
81609,6,1,285713,285713,285714,0,1,5
81610,6,3,285719,285719,285722,0,3,5
81611,6,2,285725,285725,285727,0,2,3
81612,2,1,285727,285727,285728,0,1,0
81613,3,3,285730,285730,285733,0,3,2
81614,3,1,285733,285733,285734,0,1,0
81615,2,2,285735,285735,285737,0,2,1
81616,3,3,285738,285738,285741,0,3,1
81617,6,2,285744,285744,285746,0,2,3
81618,2,2,285746,285746,285748,0,2,0
81619,5,2,285751,285751,285753,0,2,3
81620,5,1,285756,285756,285757,0,1,3
81621,5,2,285761,285761,285763,0,2,4
81622,6,1,285767,285767,285768,0,1,4
81623,5,3,285772,285772,285775,0,3,4
81624,3,1,285775,285775,285776,0,1,0
81625,5,1,285780,285780,285781,0,1,4
81626,5,1,285785,285785,285786,0,1,4
81627,3,1,285788,285788,285789,0,1,2
81628,6,2,285794,285794,285796,0,2,5
81629,1,1,285795,285796,285797,1,2,0
81630,5,2,285800,285800,285802,0,2,3
81631,1,3,285801,285802,285805,1,4,0
81632,6,2,285807,285807,285809,0,2,2
81633,2,1,285809,285809,285810,0,1,0
81634,6,3,285815,285815,285818,0,3,5
81635,5,3,285820,285820,285823,0,3,2
81636,1,1,285821,285823,285824,2,3,0
81637,6,2,285827,285827,285829,0,2,3
81638,1,2,285828,285829,285831,1,3,0
81639,4,1,285832,285832,285833,0,1,1
81640,4,2,285836,285836,285838,0,2,3
81641,1,3,285837,285838,285841,1,4,0
81642,1,3,285838,285841,285844,3,6,0
81643,5,1,285843,285844,285845,1,2,0
81644,5,2,285848,285848,285850,0,2,3
81645,2,2,285850,285850,285852,0,2,0
81646,2,3,285852,285852,285855,0,3,0
81647,6,3,285858,285858,285861,0,3,3
81648,6,3,285864,285864,285867,0,3,3
81649,3,1,285867,285867,285868,0,1,0
81650,2,1,285869,285869,285870,0,1,1
81651,2,3,285871,285871,285874,0,3,1
81652,5,1,285876,285876,285877,0,1,2
81653,4,2,285880,285880,285882,0,2,3
81654,4,3,285884,285884,285887,0,3,2
81655,6,2,285890,285890,285892,0,2,3
81656,6,1,285896,285896,285897,0,1,4
81657,1,2,285897,285897,285899,0,2,0
81658,4,2,285901,285901,285903,0,2,2
81659,5,3,285906,285906,285909,0,3,3
81660,3,1,285909,285909,285910,0,1,0
81661,2,1,285911,285911,285912,0,1,1
81662,2,2,285913,285913,285915,0,2,1
81663,3,3,285916,285916,285919,0,3,1
81664,3,1,285919,285919,285920,0,1,0
81665,3,2,285922,285922,285924,0,2,2
81666,4,2,285926,285926,285928,0,2,2
81667,5,3,285931,285931,285934,0,3,3
81668,4,2,285935,285935,285937,0,2,1
81669,3,1,285938,285938,285939,0,1,1
81670,2,3,285940,285940,285943,0,3,1
81671,6,1,285946,285946,285947,0,1,3
81672,1,3,285947,285947,285950,0,3,0
81673,3,1,285950,285950,285951,0,1,0
81674,6,3,285956,285956,285959,0,3,5
81675,3,3,285959,285959,285962,0,3,0
81676,3,1,285962,285962,285963,0,1,0
81677,4,1,285966,285966,285967,0,1,3
81678,4,1,285970,285970,285971,0,1,3
81679,1,2,285971,285971,285973,0,2,0
81680,3,1,285974,285974,285975,0,1,1
81681,4,2,285978,285978,285980,0,2,3
81682,2,2,285980,285980,285982,0,2,0
81683,1,3,285981,285982,285985,1,4,0
81684,3,2,285984,285985,285987,1,3,0
81685,6,2,285990,285990,285992,0,2,3
81686,4,2,285994,285994,285996,0,2,2
81687,5,3,285999,285999,286002,0,3,3
81688,6,3,286005,286005,286008,0,3,3
81689,2,3,286007,286008,286011,1,4,0
81690,1,1,286008,286011,286012,3,4,0
81691,6,3,286014,286014,286017,0,3,2
81692,2,3,286016,286017,286020,1,4,0
81693,6,2,286022,286022,286024,0,2,2
81694,6,1,286028,286028,286029,0,1,4
81695,1,3,286029,286029,286032,0,3,0
81696,4,1,286033,286033,286034,0,1,1
81697,4,3,286037,286037,286040,0,3,3
81698,2,1,286039,286040,286041,1,2,0
81699,3,3,286042,286042,286045,0,3,1
81700,5,1,286047,286047,286048,0,1,2
81701,4,1,286051,286051,286052,0,1,3
81702,1,1,286052,286052,286053,0,1,0
81703,5,3,286057,286057,286060,0,3,4
81704,3,3,286060,286060,286063,0,3,0
81705,6,3,286066,286066,286069,0,3,3
81706,1,1,286067,286069,286070,2,3,0
81707,3,2,286070,286070,286072,0,2,0
81708,4,1,286074,286074,286075,0,1,2
81709,1,2,286075,286075,286077,0,2,0
81710,3,1,286078,286078,286079,0,1,1
81711,4,1,286082,286082,286083,0,1,3
81712,6,3,286088,286088,286091,0,3,5
81713,5,2,286093,286093,286095,0,2,2
81714,6,2,286099,286099,286101,0,2,4
81715,4,2,286103,286103,286105,0,2,2
81716,6,1,286109,286109,286110,0,1,4
81717,5,2,286114,286114,286116,0,2,4
81718,4,2,286118,286118,286120,0,2,2
81719,6,1,286124,286124,286125,0,1,4
81720,2,1,286126,286126,286127,0,1,1
81721,2,1,286128,286128,286129,0,1,1
81722,2,1,286130,286130,286131,0,1,1
81723,6,2,286136,286136,286138,0,2,5
81724,4,3,286140,286140,286143,0,3,2
81725,5,2,286145,286145,286147,0,2,2
81726,2,2,286147,286147,286149,0,2,0
81727,6,3,286153,286153,286156,0,3,4
81728,6,1,286159,286159,286160,0,1,3
81729,2,3,286161,286161,286164,0,3,1
81730,4,2,286165,286165,286167,0,2,1
81731,3,1,286168,286168,286169,0,1,1
81732,5,1,286173,286173,286174,0,1,4
81733,4,2,286177,286177,286179,0,2,3
81734,2,2,286179,286179,286181,0,2,0
81735,5,2,286184,286184,286186,0,2,3
81736,1,1,286185,286186,286187,1,2,0
81737,4,2,286189,286189,286191,0,2,2
81738,5,3,286194,286194,286197,0,3,3
81739,2,2,286196,286197,286199,1,3,0
81740,5,2,286201,286201,286203,0,2,2
81741,1,1,286202,286203,286204,1,2,0
81742,4,1,286206,286206,286207,0,1,2
81743,3,1,286209,286209,286210,0,1,2
81744,6,2,286215,286215,286217,0,2,5
81745,6,3,286221,286221,286224,0,3,4
81746,3,2,286224,286224,286226,0,2,0
81747,1,3,286225,286226,286229,1,4,0
81748,1,2,286226,286229,286231,3,5,0
81749,4,2,286230,286231,286233,1,3,0
81750,5,2,286235,286235,286237,0,2,2
81751,5,1,286240,286240,286241,0,1,3
81752,2,3,286242,286242,286245,0,3,1
81753,3,2,286245,286245,286247,0,2,0
81754,1,1,286246,286247,286248,1,2,0
81755,1,1,286247,286248,286249,1,2,0
81756,2,2,286249,286249,286251,0,2,0
81757,5,2,286254,286254,286256,0,2,3
81758,1,2,286255,286256,286258,1,3,0
81759,4,2,286259,286259,286261,0,2,1
81760,1,3,286260,286261,286264,1,4,0
81761,6,2,286266,286266,286268,0,2,2
81762,1,1,286267,286268,286269,1,2,0
81763,1,3,286268,286269,286272,1,4,0
81764,5,1,286273,286273,286274,0,1,1
81765,1,3,286274,286274,286277,0,3,0
81766,2,1,286276,286277,286278,1,2,0
81767,4,1,286280,286280,286281,0,1,2
81768,3,3,286283,286283,286286,0,3,2
81769,6,2,286289,286289,286291,0,2,3
81770,2,1,286291,286291,286292,0,1,0
81771,3,3,286294,286294,286297,0,3,2
81772,6,1,286300,286300,286301,0,1,3
81773,2,2,286302,286302,286304,0,2,1
81774,5,1,286307,286307,286308,0,1,3
81775,2,3,286309,286309,286312,0,3,1
81776,2,1,286311,286312,286313,1,2,0
81777,1,2,286312,286313,286315,1,3,0
81778,2,1,286314,286315,286316,1,2,0
81779,5,2,286319,286319,286321,0,2,3
81780,5,2,286324,286324,286326,0,2,3
81781,1,3,286325,286326,286329,1,4,0
81782,5,1,286330,286330,286331,0,1,1
81783,4,2,286334,286334,286336,0,2,3
81784,1,2,286335,286336,286338,1,3,0
81785,2,3,286337,286338,286341,1,4,0
81786,1,2,286338,286341,286343,3,5,0
81787,6,3,286344,286344,286347,0,3,1
81788,4,3,286348,286348,286351,0,3,1
81789,3,2,286351,286351,286353,0,2,0
81790,4,2,286355,286355,286357,0,2,2
81791,5,1,286360,286360,286361,0,1,3
81792,6,1,286366,286366,286367,0,1,5
81793,3,1,286369,286369,286370,0,1,2
81794,6,2,286375,286375,286377,0,2,5
81795,6,3,286381,286381,286384,0,3,4
81796,4,1,286385,286385,286386,0,1,1
81797,3,1,286388,286388,286389,0,1,2
81798,3,1,286391,286391,286392,0,1,2
81799,2,2,286393,286393,286395,0,2,1
81800,2,1,286395,286395,286396,0,1,0
81801,4,3,286399,286399,286402,0,3,3
81802,1,1,286400,286402,286403,2,3,0
81803,4,3,286404,286404,286407,0,3,1
81804,4,2,286408,286408,286410,0,2,1
81805,2,2,286410,286410,286412,0,2,0
81806,3,3,286413,286413,286416,0,3,1
81807,4,2,286417,286417,286419,0,2,1
81808,3,1,286420,286420,286421,0,1,1
81809,3,1,286423,286423,286424,0,1,2
81810,1,3,286424,286424,286427,0,3,0
81811,6,3,286430,286430,286433,0,3,3
81812,6,1,286436,286436,286437,0,1,3
81813,6,2,286442,286442,286444,0,2,5
81814,6,3,286448,286448,286451,0,3,4
81815,4,3,286452,286452,286455,0,3,1
81816,1,1,286453,286455,286456,2,3,0
81817,1,1,286454,286456,286457,2,3,0
81818,5,3,286459,286459,286462,0,3,2
81819,4,3,286463,286463,286466,0,3,1
81820,1,3,286464,286466,286469,2,5,0
81821,5,1,286469,286469,286470,0,1,0
81822,3,3,286472,286472,286475,0,3,2
81823,6,2,286478,286478,286480,0,2,3
81824,3,2,286481,286481,286483,0,2,1
81825,4,2,286485,286485,286487,0,2,2
81826,3,3,286488,286488,286491,0,3,1
81827,6,3,286494,286494,286497,0,3,3
81828,2,3,286496,286497,286500,1,4,0
81829,6,3,286502,286502,286505,0,3,2
81830,2,1,286504,286505,286506,1,2,0
81831,5,2,286509,286509,286511,0,2,3
81832,2,3,286511,286511,286514,0,3,0
81833,2,3,286513,286514,286517,1,4,0
81834,6,2,286519,286519,286521,0,2,2
81835,5,2,286524,286524,286526,0,2,3
81836,4,3,286528,286528,286531,0,3,2
81837,4,3,286532,286532,286535,0,3,1
81838,1,2,286533,286535,286537,2,4,0
81839,6,1,286539,286539,286540,0,1,2
81840,3,2,286542,286542,286544,0,2,2
81841,6,1,286548,286548,286549,0,1,4
81842,2,1,286550,286550,286551,0,1,1
81843,4,2,286554,286554,286556,0,2,3
81844,2,3,286556,286556,286559,0,3,0
81845,6,1,286562,286562,286563,0,1,3
81846,6,1,286568,286568,286569,0,1,5
81847,5,2,286573,286573,286575,0,2,4
81848,1,3,286574,286575,286578,1,4,0
81849,2,2,286576,286578,286580,2,4,0
81850,6,1,286582,286582,286583,0,1,2
81851,2,2,286584,286584,286586,0,2,1
81852,2,3,286586,286586,286589,0,3,0
81853,2,3,286588,286589,286592,1,4,0
81854,2,1,286590,286592,286593,2,3,0
81855,4,3,286594,286594,286597,0,3,1
81856,6,2,286600,286600,286602,0,2,3
81857,6,1,286606,286606,286607,0,1,4
81858,1,2,286607,286607,286609,0,2,0
81859,2,3,286609,286609,286612,0,3,0
81860,2,3,286611,286612,286615,1,4,0
81861,4,2,286615,286615,286617,0,2,0
81862,6,3,286621,286621,286624,0,3,4
81863,1,2,286622,286624,286626,2,4,0
81864,1,1,286623,286626,286627,3,4,0
81865,3,1,286626,286627,286628,1,2,0
81866,1,2,286627,286628,286630,1,3,0
81867,3,2,286630,286630,286632,0,2,0
81868,2,2,286632,286632,286634,0,2,0
81869,1,2,286633,286634,286636,1,3,0
81870,4,1,286637,286637,286638,0,1,1
81871,3,1,286640,286640,286641,0,1,2
81872,4,1,286644,286644,286645,0,1,3
81873,3,2,286647,286647,286649,0,2,2
81874,4,1,286651,286651,286652,0,1,2
81875,4,1,286655,286655,286656,0,1,3
81876,5,2,286660,286660,286662,0,2,4
81877,1,2,286661,286662,286664,1,3,0
81878,2,2,286663,286664,286666,1,3,0
81879,3,1,286666,286666,286667,0,1,0
81880,6,1,286672,286672,286673,0,1,5
81881,4,2,286676,286676,286678,0,2,3
81882,4,2,286680,286680,286682,0,2,2
81883,4,2,286684,286684,286686,0,2,2
81884,3,2,286687,286687,286689,0,2,1
81885,1,3,286688,286689,286692,1,4,0
81886,4,3,286692,286692,286695,0,3,0
81887,4,2,286696,286696,286698,0,2,1
81888,1,2,286697,286698,286700,1,3,0
81889,1,1,286698,286700,286701,2,3,0
81890,2,2,286700,286701,286703,1,3,0
81891,4,2,286704,286704,286706,0,2,1
81892,6,1,286710,286710,286711,0,1,4
81893,6,2,286716,286716,286718,0,2,5
81894,4,2,286720,286720,286722,0,2,2
81895,6,2,286726,286726,286728,0,2,4
81896,5,2,286731,286731,286733,0,2,3
81897,1,2,286732,286733,286735,1,3,0
81898,3,3,286735,286735,286738,0,3,0
81899,2,3,286737,286738,286741,1,4,0
81900,4,3,286741,286741,286744,0,3,0
81901,6,1,286747,286747,286748,0,1,3
81902,3,2,286750,286750,286752,0,2,2
81903,4,3,286754,286754,286757,0,3,2
81904,1,1,286755,286757,286758,2,3,0
81905,4,2,286759,286759,286761,0,2,1
81906,1,1,286760,286761,286762,1,2,0
81907,3,1,286763,286763,286764,0,1,1
81908,6,2,286769,286769,286771,0,2,5
81909,6,1,286775,286775,286776,0,1,4
81910,6,3,286781,286781,286784,0,3,5
81911,6,1,286787,286787,286788,0,1,3
81912,4,3,286791,286791,286794,0,3,3
81913,2,1,286793,286794,286795,1,2,0
81914,5,2,286798,286798,286800,0,2,3
81915,1,1,286799,286800,286801,1,2,0
81916,2,2,286801,286801,286803,0,2,0
81917,4,1,286805,286805,286806,0,1,2
81918,2,3,286807,286807,286810,0,3,1
81919,3,3,286810,286810,286813,0,3,0
81920,1,2,286811,286813,286815,2,4,0
81921,1,3,286812,286815,286818,3,6,0
81922,6,2,286818,286818,286820,0,2,0
81923,4,3,286822,286822,286825,0,3,2
81924,6,3,286828,286828,286831,0,3,3
81925,2,2,286830,286831,286833,1,3,0
81926,1,3,286831,286833,286836,2,5,0
81927,4,3,286835,286836,286839,1,4,0
81928,6,1,286841,286841,286842,0,1,2
81929,5,2,286846,286846,286848,0,2,4
81930,5,2,286851,286851,286853,0,2,3
81931,1,1,286852,286853,286854,1,2,0
81932,5,2,286857,286857,286859,0,2,3
81933,2,1,286859,286859,286860,0,1,0
81934,6,1,286865,286865,286866,0,1,5
81935,3,1,286868,286868,286869,0,1,2
81936,3,1,286871,286871,286872,0,1,2
81937,4,3,286875,286875,286878,0,3,3
81938,6,2,286881,286881,286883,0,2,3
81939,3,1,286884,286884,286885,0,1,1
81940,6,3,286890,286890,286893,0,3,5
81941,4,3,286894,286894,286897,0,3,1
81942,4,3,286898,286898,286901,0,3,1
81943,5,3,286903,286903,286906,0,3,2
81944,2,3,286905,286906,286909,1,4,0
81945,2,2,286907,286909,286911,2,4,0
81946,6,3,286913,286913,286916,0,3,2
81947,4,2,286917,286917,286919,0,2,1
81948,6,2,286923,286923,286925,0,2,4
81949,2,3,286925,286925,286928,0,3,0
81950,5,3,286930,286930,286933,0,3,2
81951,4,3,286934,286934,286937,0,3,1
81952,6,2,286940,286940,286942,0,2,3
81953,3,2,286943,286943,286945,0,2,1
81954,4,2,286947,286947,286949,0,2,2
81955,1,1,286948,286949,286950,1,2,0
81956,2,3,286950,286950,286953,0,3,0
81957,5,1,286955,286955,286956,0,1,2
81958,6,1,286961,286961,286962,0,1,5
81959,4,1,286965,286965,286966,0,1,3
81960,4,2,286969,286969,286971,0,2,3
81961,5,3,286974,286974,286977,0,3,3
81962,4,2,286978,286978,286980,0,2,1
81963,6,1,286984,286984,286985,0,1,4
81964,4,2,286988,286988,286990,0,2,3
81965,3,2,286991,286991,286993,0,2,1
81966,3,3,286994,286994,286997,0,3,1
81967,5,1,286999,286999,287000,0,1,2
81968,6,2,287005,287005,287007,0,2,5
81969,2,2,287007,287007,287009,0,2,0
81970,2,3,287009,287009,287012,0,3,0
81971,1,3,287010,287012,287015,2,5,0
81972,1,2,287011,287015,287017,4,6,0
81973,2,3,287013,287017,287020,4,7,0
81974,1,2,287014,287020,287022,6,8,0
81975,1,2,287015,287022,287024,7,9,0
81976,6,3,287021,287024,287027,3,6,0
81977,2,1,287023,287027,287028,4,5,0
81978,4,1,287027,287028,287029,1,2,0
81979,1,1,287028,287029,287030,1,2,0
81980,3,3,287031,287031,287034,0,3,1
81981,1,2,287032,287034,287036,2,4,0
81982,3,1,287035,287036,287037,1,2,0
81983,4,3,287039,287039,287042,0,3,2
81984,2,1,287041,287042,287043,1,2,0
81985,1,3,287042,287043,287046,1,4,0
81986,6,3,287048,287048,287051,0,3,2
81987,3,2,287051,287051,287053,0,2,0
81988,6,1,287057,287057,287058,0,1,4
81989,4,3,287061,287061,287064,0,3,3
81990,4,2,287065,287065,287067,0,2,1
81991,3,3,287068,287068,287071,0,3,1
81992,6,2,287074,287074,287076,0,2,3
81993,5,3,287079,287079,287082,0,3,3
81994,1,2,287080,287082,287084,2,4,0
81995,3,1,287083,287084,287085,1,2,0
81996,2,1,287085,287085,287086,0,1,0
81997,3,2,287088,287088,287090,0,2,2
81998,3,1,287091,287091,287092,0,1,1
81999,5,1,287096,287096,287097,0,1,4
82000,6,1,287102,287102,287103,0,1,5
82001,1,2,287103,287103,287105,0,2,0
82002,3,3,287106,287106,287109,0,3,1
82003,5,1,287111,287111,287112,0,1,2
82004,3,3,287114,287114,287117,0,3,2
82005,6,2,287120,287120,287122,0,2,3
82006,6,3,287126,287126,287129,0,3,4
82007,1,1,287127,287129,287130,2,3,0
82008,2,3,287129,287130,287133,1,4,0
82009,4,3,287133,287133,287136,0,3,0
82010,6,1,287139,287139,287140,0,1,3
82011,4,1,287143,287143,287144,0,1,3
82012,3,3,287146,287146,287149,0,3,2
82013,1,3,287147,287149,287152,2,5,0
82014,4,1,287151,287152,287153,1,2,0
82015,6,1,287157,287157,287158,0,1,4
82016,2,2,287159,287159,287161,0,2,1
82017,2,3,287161,287161,287164,0,3,0
82018,3,2,287164,287164,287166,0,2,0
82019,2,2,287166,287166,287168,0,2,0
82020,5,3,287171,287171,287174,0,3,3
82021,4,2,287175,287175,287177,0,2,1
82022,5,3,287180,287180,287183,0,3,3
82023,4,3,287184,287184,287187,0,3,1
82024,3,1,287187,287187,287188,0,1,0
82025,4,3,287191,287191,287194,0,3,3
82026,6,3,287197,287197,287200,0,3,3
82027,4,1,287201,287201,287202,0,1,1
82028,3,1,287204,287204,287205,0,1,2
82029,5,1,287209,287209,287210,0,1,4
82030,3,1,287212,287212,287213,0,1,2
82031,1,3,287213,287213,287216,0,3,0
82032,2,1,287215,287216,287217,1,2,0
82033,4,2,287219,287219,287221,0,2,2
82034,2,2,287221,287221,287223,0,2,0
82035,1,3,287222,287223,287226,1,4,0
82036,2,3,287224,287226,287229,2,5,0
82037,6,1,287230,287230,287231,0,1,1
82038,6,3,287236,287236,287239,0,3,5
82039,1,2,287237,287239,287241,2,4,0
82040,4,2,287241,287241,287243,0,2,0
82041,3,1,287244,287244,287245,0,1,1
82042,5,2,287249,287249,287251,0,2,4
82043,4,3,287253,287253,287256,0,3,2
82044,6,1,287259,287259,287260,0,1,3
82045,6,3,287265,287265,287268,0,3,5
82046,4,1,287269,287269,287270,0,1,1
82047,5,1,287274,287274,287275,0,1,4
82048,4,1,287278,287278,287279,0,1,3
82049,4,1,287282,287282,287283,0,1,3
82050,6,2,287288,287288,287290,0,2,5
82051,4,3,287292,287292,287295,0,3,2
82052,1,2,287293,287295,287297,2,4,0
82053,3,1,287296,287297,287298,1,2,0
82054,2,3,287298,287298,287301,0,3,0
82055,5,1,287303,287303,287304,0,1,2
82056,6,3,287309,287309,287312,0,3,5
82057,5,1,287314,287314,287315,0,1,2
82058,4,2,287318,287318,287320,0,2,3
82059,3,1,287321,287321,287322,0,1,1
82060,2,2,287323,287323,287325,0,2,1
82061,1,3,287324,287325,287328,1,4,0
82062,4,2,287328,287328,287330,0,2,0
82063,6,1,287334,287334,287335,0,1,4
82064,2,3,287336,287336,287339,0,3,1
82065,6,2,287342,287342,287344,0,2,3
82066,6,2,287348,287348,287350,0,2,4
82067,6,1,287354,287354,287355,0,1,4
82068,1,1,287355,287355,287356,0,1,0
82069,5,2,287360,287360,287362,0,2,4
82070,2,2,287362,287362,287364,0,2,0
82071,6,1,287368,287368,287369,0,1,4
82072,1,1,287369,287369,287370,0,1,0
82073,2,2,287371,287371,287373,0,2,1
82074,1,2,287372,287373,287375,1,3,0
82075,6,2,287378,287378,287380,0,2,3
82076,5,1,287383,287383,287384,0,1,3
82077,1,1,287384,287384,287385,0,1,0
82078,3,3,287387,287387,287390,0,3,2
82079,3,3,287390,287390,287393,0,3,0
82080,1,2,287391,287393,287395,2,4,0
82081,3,1,287394,287395,287396,1,2,0
82082,2,1,287396,287396,287397,0,1,0
82083,2,3,287398,287398,287401,0,3,1
82084,5,2,287403,287403,287405,0,2,2
82085,1,2,287404,287405,287407,1,3,0
82086,1,3,287405,287407,287410,2,5,0
82087,4,1,287409,287410,287411,1,2,0
82088,2,2,287411,287411,287413,0,2,0
82089,6,2,287417,287417,287419,0,2,4
82090,1,2,287418,287419,287421,1,3,0
82091,1,3,287419,287421,287424,2,5,0
82092,5,1,287424,287424,287425,0,1,0
82093,2,2,287426,287426,287428,0,2,1
82094,4,3,287430,287430,287433,0,3,2
82095,3,3,287433,287433,287436,0,3,0
82096,4,2,287437,287437,287439,0,2,1
82097,5,1,287442,287442,287443,0,1,3
82098,5,1,287447,287447,287448,0,1,4
82099,3,3,287450,287450,287453,0,3,2
82100,5,2,287455,287455,287457,0,2,2
82101,6,2,287461,287461,287463,0,2,4
82102,2,2,287463,287463,287465,0,2,0
82103,3,2,287466,287466,287468,0,2,1
82104,6,3,287472,287472,287475,0,3,4
82105,5,1,287477,287477,287478,0,1,2
82106,2,3,287479,287479,287482,0,3,1
82107,5,2,287484,287484,287486,0,2,2
82108,3,2,287487,287487,287489,0,2,1
82109,6,1,287493,287493,287494,0,1,4
82110,5,3,287498,287498,287501,0,3,4
82111,2,3,287500,287501,287504,1,4,0
82112,1,1,287501,287504,287505,3,4,0
82113,6,2,287507,287507,287509,0,2,2
82114,6,2,287513,287513,287515,0,2,4
82115,4,3,287517,287517,287520,0,3,2
82116,1,1,287518,287520,287521,2,3,0
82117,6,2,287524,287524,287526,0,2,3
82118,1,3,287525,287526,287529,1,4,0
82119,3,1,287528,287529,287530,1,2,0
82120,3,3,287531,287531,287534,0,3,1
82121,5,3,287536,287536,287539,0,3,2
82122,1,1,287537,287539,287540,2,3,0
82123,6,1,287543,287543,287544,0,1,3
82124,2,2,287545,287545,287547,0,2,1
82125,4,2,287549,287549,287551,0,2,2
82126,6,2,287555,287555,287557,0,2,4
82127,4,2,287559,287559,287561,0,2,2
82128,3,1,287562,287562,287563,0,1,1
82129,4,1,287566,287566,287567,0,1,3
82130,1,2,287567,287567,287569,0,2,0
82131,5,3,287572,287572,287575,0,3,3
82132,2,2,287574,287575,287577,1,3,0
82133,6,3,287580,287580,287583,0,3,3
82134,1,2,287581,287583,287585,2,4,0
82135,6,2,287587,287587,287589,0,2,2
82136,2,3,287589,287589,287592,0,3,0
82137,2,2,287591,287592,287594,1,3,0
82138,4,1,287595,287595,287596,0,1,1
82139,5,2,287600,287600,287602,0,2,4
82140,5,2,287605,287605,287607,0,2,3
82141,1,3,287606,287607,287610,1,4,0
82142,1,3,287607,287610,287613,3,6,0
82143,5,2,287612,287613,287615,1,3,0
82144,3,3,287615,287615,287618,0,3,0
82145,3,3,287618,287618,287621,0,3,0
82146,1,2,287619,287621,287623,2,4,0
82147,2,2,287621,287623,287625,2,4,0
82148,6,1,287627,287627,287628,0,1,2
82149,1,2,287628,287628,287630,0,2,0
82150,2,1,287630,287630,287631,0,1,0
82151,6,1,287636,287636,287637,0,1,5
82152,1,2,287637,287637,287639,0,2,0
82153,6,1,287643,287643,287644,0,1,4
82154,5,2,287648,287648,287650,0,2,4
82155,6,2,287654,287654,287656,0,2,4
82156,4,2,287658,287658,287660,0,2,2
82157,4,1,287662,287662,287663,0,1,2
82158,2,1,287664,287664,287665,0,1,1
82159,3,3,287667,287667,287670,0,3,2
82160,5,2,287672,287672,287674,0,2,2
82161,5,2,287677,287677,287679,0,2,3
82162,5,3,287682,287682,287685,0,3,3
82163,6,3,287688,287688,287691,0,3,3
82164,2,2,287690,287691,287693,1,3,0
82165,6,3,287696,287696,287699,0,3,3
82166,1,1,287697,287699,287700,2,3,0
82167,5,1,287702,287702,287703,0,1,2
82168,5,3,287707,287707,287710,0,3,4
82169,4,3,287711,287711,287714,0,3,1
82170,3,1,287714,287714,287715,0,1,0
82171,5,2,287719,287719,287721,0,2,4
82172,4,2,287723,287723,287725,0,2,2
82173,1,1,287724,287725,287726,1,2,0
82174,5,1,287729,287729,287730,0,1,3
82175,5,1,287734,287734,287735,0,1,4
82176,2,2,287736,287736,287738,0,2,1
82177,5,1,287741,287741,287742,0,1,3
82178,3,1,287744,287744,287745,0,1,2
82179,5,2,287749,287749,287751,0,2,4
82180,6,1,287755,287755,287756,0,1,4
82181,2,2,287757,287757,287759,0,2,1
82182,1,3,287758,287759,287762,1,4,0
82183,2,3,287760,287762,287765,2,5,0
82184,6,2,287766,287766,287768,0,2,1
82185,6,3,287772,287772,287775,0,3,4
82186,4,1,287776,287776,287777,0,1,1
82187,4,3,287780,287780,287783,0,3,3
82188,4,1,287784,287784,287785,0,1,1
82189,6,2,287790,287790,287792,0,2,5
82190,6,1,287796,287796,287797,0,1,4
82191,4,2,287800,287800,287802,0,2,3
82192,3,1,287803,287803,287804,0,1,1
82193,1,2,287804,287804,287806,0,2,0
82194,5,1,287809,287809,287810,0,1,3
82195,5,2,287814,287814,287816,0,2,4
82196,3,3,287817,287817,287820,0,3,1
82197,3,3,287820,287820,287823,0,3,0
82198,4,1,287824,287824,287825,0,1,1
82199,5,2,287829,287829,287831,0,2,4
82200,2,1,287831,287831,287832,0,1,0
82201,5,3,287836,287836,287839,0,3,4
82202,1,2,287837,287839,287841,2,4,0
82203,2,2,287839,287841,287843,2,4,0
82204,1,3,287840,287843,287846,3,6,0
82205,5,1,287845,287846,287847,1,2,0
82206,5,3,287850,287850,287853,0,3,3
82207,3,1,287853,287853,287854,0,1,0
82208,4,2,287857,287857,287859,0,2,3
82209,3,3,287860,287860,287863,0,3,1
82210,6,2,287866,287866,287868,0,2,3
82211,5,2,287871,287871,287873,0,2,3
82212,1,2,287872,287873,287875,1,3,0
82213,5,2,287877,287877,287879,0,2,2
82214,6,1,287883,287883,287884,0,1,4
82215,1,1,287884,287884,287885,0,1,0
82216,4,2,287888,287888,287890,0,2,3
82217,2,3,287890,287890,287893,0,3,0
82218,5,3,287895,287895,287898,0,3,2
82219,1,2,287896,287898,287900,2,4,0
82220,4,1,287900,287900,287901,0,1,0
82221,6,3,287906,287906,287909,0,3,5
82222,6,2,287912,287912,287914,0,2,3
82223,1,3,287913,287914,287917,1,4,0
82224,4,3,287917,287917,287920,0,3,0
82225,6,2,287923,287923,287925,0,2,3
82226,2,2,287925,287925,287927,0,2,0
82227,4,1,287929,287929,287930,0,1,2
82228,6,3,287935,287935,287938,0,3,5
82229,4,3,287939,287939,287942,0,3,1
82230,2,3,287941,287942,287945,1,4,0
82231,3,3,287944,287945,287948,1,4,0
82232,2,3,287946,287948,287951,2,5,0
82233,5,1,287951,287951,287952,0,1,0
82234,5,3,287956,287956,287959,0,3,4
82235,3,2,287959,287959,287961,0,2,0
82236,6,3,287965,287965,287968,0,3,4
82237,4,1,287969,287969,287970,0,1,1
82238,5,3,287974,287974,287977,0,3,4
82239,4,2,287978,287978,287980,0,2,1
82240,2,3,287980,287980,287983,0,3,0
82241,5,2,287985,287985,287987,0,2,2
82242,4,3,287989,287989,287992,0,3,2
82243,2,2,287991,287992,287994,1,3,0
82244,5,1,287996,287996,287997,0,1,2
82245,2,2,287998,287998,288000,0,2,1
82246,3,1,288001,288001,288002,0,1,1
82247,3,3,288004,288004,288007,0,3,2
82248,3,2,288007,288007,288009,0,2,0
82249,2,1,288009,288009,288010,0,1,0
82250,4,3,288013,288013,288016,0,3,3
82251,4,2,288017,288017,288019,0,2,1
82252,4,2,288021,288021,288023,0,2,2
82253,5,2,288026,288026,288028,0,2,3
82254,4,3,288030,288030,288033,0,3,2
82255,6,2,288036,288036,288038,0,2,3
82256,3,3,288039,288039,288042,0,3,1
82257,4,1,288043,288043,288044,0,1,1
82258,5,1,288048,288048,288049,0,1,4
82259,3,2,288051,288051,288053,0,2,2
82260,6,1,288057,288057,288058,0,1,4
82261,6,2,288063,288063,288065,0,2,5
82262,4,2,288067,288067,288069,0,2,2
82263,3,3,288070,288070,288073,0,3,1
82264,2,3,288072,288073,288076,1,4,0
82265,2,3,288074,288076,288079,2,5,0
82266,6,2,288080,288080,288082,0,2,1
82267,3,2,288083,288083,288085,0,2,1
82268,5,1,288088,288088,288089,0,1,3
82269,6,1,288094,288094,288095,0,1,5
82270,6,2,288100,288100,288102,0,2,5
82271,1,2,288101,288102,288104,1,3,0
82272,6,2,288107,288107,288109,0,2,3
82273,1,3,288108,288109,288112,1,4,0
82274,2,3,288110,288112,288115,2,5,0
82275,3,1,288113,288115,288116,2,3,0
82276,2,2,288115,288116,288118,1,3,0
82277,6,2,288121,288121,288123,0,2,3
82278,6,1,288127,288127,288128,0,1,4
82279,5,2,288132,288132,288134,0,2,4
82280,4,1,288136,288136,288137,0,1,2
82281,3,3,288139,288139,288142,0,3,2
82282,5,2,288144,288144,288146,0,2,2
82283,2,3,288146,288146,288149,0,3,0
82284,1,1,288147,288149,288150,2,3,0
82285,6,3,288153,288153,288156,0,3,3
82286,1,1,288154,288156,288157,2,3,0
82287,5,1,288159,288159,288160,0,1,2
82288,2,3,288161,288161,288164,0,3,1
82289,6,3,288167,288167,288170,0,3,3
82290,3,1,288170,288170,288171,0,1,0
82291,1,1,288171,288171,288172,0,1,0
82292,6,2,288177,288177,288179,0,2,5
82293,3,1,288180,288180,288181,0,1,1
82294,6,3,288186,288186,288189,0,3,5
82295,3,1,288189,288189,288190,0,1,0
82296,3,2,288192,288192,288194,0,2,2
82297,4,1,288196,288196,288197,0,1,2
82298,5,1,288201,288201,288202,0,1,4
82299,5,3,288206,288206,288209,0,3,4
82300,2,2,288208,288209,288211,1,3,0
82301,4,1,288212,288212,288213,0,1,1
82302,5,2,288217,288217,288219,0,2,4
82303,1,1,288218,288219,288220,1,2,0
82304,4,3,288222,288222,288225,0,3,2
82305,5,2,288227,288227,288229,0,2,2
82306,1,3,288228,288229,288232,1,4,0
82307,4,1,288232,288232,288233,0,1,0
82308,3,3,288235,288235,288238,0,3,2
82309,3,3,288238,288238,288241,0,3,0
82310,4,3,288242,288242,288245,0,3,1
82311,6,1,288248,288248,288249,0,1,3
82312,2,1,288250,288250,288251,0,1,1
82313,1,1,288251,288251,288252,0,1,0
82314,4,2,288255,288255,288257,0,2,3
82315,1,2,288256,288257,288259,1,3,0
82316,5,1,288261,288261,288262,0,1,2
82317,1,1,288262,288262,288263,0,1,0
82318,4,1,288266,288266,288267,0,1,3
82319,3,3,288269,288269,288272,0,3,2
82320,2,2,288271,288272,288274,1,3,0
82321,5,1,288276,288276,288277,0,1,2
82322,2,2,288278,288278,288280,0,2,1
82323,2,1,288280,288280,288281,0,1,0
82324,1,3,288281,288281,288284,0,3,0
82325,1,2,288282,288284,288286,2,4,0
82326,2,3,288284,288286,288289,2,5,0
82327,1,2,288285,288289,288291,4,6,0
82328,5,1,288290,288291,288292,1,2,0
82329,6,3,288296,288296,288299,0,3,4
82330,1,3,288297,288299,288302,2,5,0
82331,3,2,288300,288302,288304,2,4,0
82332,2,3,288302,288304,288307,2,5,0
82333,3,3,288305,288307,288310,2,5,0
82334,3,2,288308,288310,288312,2,4,0
82335,1,3,288309,288312,288315,3,6,0
82336,5,1,288314,288315,288316,1,2,0
82337,1,3,288315,288316,288319,1,4,0
82338,6,2,288321,288321,288323,0,2,2
82339,5,1,288326,288326,288327,0,1,3
82340,1,1,288327,288327,288328,0,1,0
82341,5,3,288332,288332,288335,0,3,4
82342,4,1,288336,288336,288337,0,1,1
82343,6,3,288342,288342,288345,0,3,5
82344,5,2,288347,288347,288349,0,2,2
82345,1,2,288348,288349,288351,1,3,0
82346,5,2,288353,288353,288355,0,2,2
82347,2,2,288355,288355,288357,0,2,0
82348,5,3,288360,288360,288363,0,3,3
82349,3,2,288363,288363,288365,0,2,0
82350,6,1,288369,288369,288370,0,1,4
82351,2,1,288371,288371,288372,0,1,1
82352,5,2,288376,288376,288378,0,2,4
82353,4,1,288380,288380,288381,0,1,2
82354,4,1,288384,288384,288385,0,1,3
82355,4,1,288388,288388,288389,0,1,3
82356,3,2,288391,288391,288393,0,2,2
82357,4,2,288395,288395,288397,0,2,2
82358,6,3,288401,288401,288404,0,3,4
82359,6,2,288407,288407,288409,0,2,3
82360,2,3,288409,288409,288412,0,3,0
82361,5,1,288414,288414,288415,0,1,2
82362,3,2,288417,288417,288419,0,2,2
82363,1,3,288418,288419,288422,1,4,0
82364,6,3,288424,288424,288427,0,3,2
82365,5,1,288429,288429,288430,0,1,2
82366,6,3,288435,288435,288438,0,3,5
82367,2,2,288437,288438,288440,1,3,0
82368,6,2,288443,288443,288445,0,2,3
82369,5,3,288448,288448,288451,0,3,3
82370,2,3,288450,288451,288454,1,4,0
82371,5,3,288455,288455,288458,0,3,1
82372,2,3,288457,288458,288461,1,4,0
82373,6,3,288463,288463,288466,0,3,2
82374,2,1,288465,288466,288467,1,2,0
82375,2,3,288467,288467,288470,0,3,0
82376,4,1,288471,288471,288472,0,1,1
82377,1,3,288472,288472,288475,0,3,0
82378,2,3,288474,288475,288478,1,4,0
82379,6,1,288480,288480,288481,0,1,2
82380,5,2,288485,288485,288487,0,2,4
82381,4,3,288489,288489,288492,0,3,2
82382,3,1,288492,288492,288493,0,1,0
82383,5,1,288497,288497,288498,0,1,4
82384,4,2,288501,288501,288503,0,2,3
82385,1,1,288502,288503,288504,1,2,0
82386,5,1,288507,288507,288508,0,1,3
82387,6,1,288513,288513,288514,0,1,5
82388,1,1,288514,288514,288515,0,1,0
82389,5,2,288519,288519,288521,0,2,4
82390,1,1,288520,288521,288522,1,2,0
82391,2,2,288522,288522,288524,0,2,0
82392,6,3,288528,288528,288531,0,3,4
82393,2,3,288530,288531,288534,1,4,0
82394,3,2,288533,288534,288536,1,3,0
82395,5,2,288538,288538,288540,0,2,2
82396,3,1,288541,288541,288542,0,1,1
82397,4,3,288545,288545,288548,0,3,3
82398,1,1,288546,288548,288549,2,3,0
82399,1,1,288547,288549,288550,2,3,0
82400,3,2,288550,288550,288552,0,2,0
82401,3,2,288553,288553,288555,0,2,1
82402,4,2,288557,288557,288559,0,2,2
82403,4,2,288561,288561,288563,0,2,2
82404,4,2,288565,288565,288567,0,2,2
82405,3,2,288568,288568,288570,0,2,1
82406,1,1,288569,288570,288571,1,2,0
82407,1,2,288570,288571,288573,1,3,0
82408,3,2,288573,288573,288575,0,2,0
82409,5,1,288578,288578,288579,0,1,3
82410,1,2,288579,288579,288581,0,2,0
82411,4,2,288583,288583,288585,0,2,2
82412,5,2,288588,288588,288590,0,2,3
82413,2,1,288590,288590,288591,0,1,0
82414,5,3,288595,288595,288598,0,3,4
82415,2,1,288597,288598,288599,1,2,0
82416,1,3,288598,288599,288602,1,4,0
82417,3,2,288601,288602,288604,1,3,0
82418,5,3,288606,288606,288609,0,3,2
82419,3,3,288609,288609,288612,0,3,0
82420,3,2,288612,288612,288614,0,2,0
82421,6,2,288618,288618,288620,0,2,4
82422,6,2,288624,288624,288626,0,2,4
82423,6,3,288630,288630,288633,0,3,4
82424,6,3,288636,288636,288639,0,3,3
82425,3,1,288639,288639,288640,0,1,0
82426,2,2,288641,288641,288643,0,2,1
82427,5,2,288646,288646,288648,0,2,3
82428,2,3,288648,288648,288651,0,3,0
82429,6,3,288654,288654,288657,0,3,3
82430,5,1,288659,288659,288660,0,1,2
82431,1,1,288660,288660,288661,0,1,0
82432,5,3,288665,288665,288668,0,3,4
82433,6,3,288671,288671,288674,0,3,3
82434,4,1,288675,288675,288676,0,1,1
82435,4,3,288679,288679,288682,0,3,3
82436,3,3,288682,288682,288685,0,3,0
82437,4,2,288686,288686,288688,0,2,1
82438,4,3,288690,288690,288693,0,3,2
82439,1,2,288691,288693,288695,2,4,0
82440,3,2,288694,288695,288697,1,3,0
82441,5,2,288699,288699,288701,0,2,2
82442,5,2,288704,288704,288706,0,2,3
82443,4,3,288708,288708,288711,0,3,2
82444,5,3,288713,288713,288716,0,3,2
82445,1,2,288714,288716,288718,2,4,0
82446,3,3,288717,288718,288721,1,4,0
82447,1,1,288718,288721,288722,3,4,0
82448,4,2,288722,288722,288724,0,2,0
82449,4,1,288726,288726,288727,0,1,2
82450,2,1,288728,288728,288729,0,1,1
82451,1,1,288729,288729,288730,0,1,0
82452,6,2,288735,288735,288737,0,2,5
82453,1,2,288736,288737,288739,1,3,0
82454,5,1,288741,288741,288742,0,1,2
82455,6,3,288747,288747,288750,0,3,5
82456,5,3,288752,288752,288755,0,3,2
82457,5,3,288757,288757,288760,0,3,2
82458,6,2,288763,288763,288765,0,2,3
82459,1,2,288764,288765,288767,1,3,0
82460,1,3,288765,288767,288770,2,5,0
82461,5,2,288770,288770,288772,0,2,0
82462,2,1,288772,288772,288773,0,1,0
82463,5,1,288777,288777,288778,0,1,4
82464,2,3,288779,288779,288782,0,3,1
82465,5,3,288784,288784,288787,0,3,2
82466,2,3,288786,288787,288790,1,4,0
82467,3,3,288789,288790,288793,1,4,0
82468,2,2,288791,288793,288795,2,4,0
82469,6,3,288797,288797,288800,0,3,2
82470,3,3,288800,288800,288803,0,3,0
82471,5,1,288805,288805,288806,0,1,2
82472,1,1,288806,288806,288807,0,1,0
82473,3,3,288809,288809,288812,0,3,2
82474,2,2,288811,288812,288814,1,3,0
82475,1,1,288812,288814,288815,2,3,0
82476,5,1,288817,288817,288818,0,1,2
82477,4,1,288821,288821,288822,0,1,3
82478,3,3,288824,288824,288827,0,3,2
82479,1,2,288825,288827,288829,2,4,0
82480,5,1,288830,288830,288831,0,1,1
82481,2,2,288832,288832,288834,0,2,1
82482,5,2,288837,288837,288839,0,2,3
82483,1,1,288838,288839,288840,1,2,0
82484,3,1,288841,288841,288842,0,1,1
82485,4,1,288845,288845,288846,0,1,3
82486,5,1,288850,288850,288851,0,1,4
82487,5,2,288855,288855,288857,0,2,4
82488,1,1,288856,288857,288858,1,2,0
82489,6,2,288862,288862,288864,0,2,4
82490,5,1,288867,288867,288868,0,1,3
82491,3,2,288870,288870,288872,0,2,2
82492,2,3,288872,288872,288875,0,3,0
82493,5,2,288877,288877,288879,0,2,2
82494,4,2,288881,288881,288883,0,2,2
82495,6,1,288887,288887,288888,0,1,4
82496,6,1,288893,288893,288894,0,1,5
82497,4,2,288897,288897,288899,0,2,3
82498,4,1,288901,288901,288902,0,1,2
82499,6,2,288907,288907,288909,0,2,5
82500,3,3,288910,288910,288913,0,3,1
82501,5,1,288915,288915,288916,0,1,2
82502,4,3,288919,288919,288922,0,3,3
82503,5,3,288924,288924,288927,0,3,2
82504,6,3,288930,288930,288933,0,3,3
82505,1,3,288931,288933,288936,2,5,0
82506,2,2,288933,288936,288938,3,5,0
82507,3,2,288936,288938,288940,2,4,0
82508,2,3,288938,288940,288943,2,5,0
82509,5,2,288943,288943,288945,0,2,0
82510,2,2,288945,288945,288947,0,2,0
82511,5,2,288950,288950,288952,0,2,3
82512,3,2,288953,288953,288955,0,2,1
82513,2,1,288955,288955,288956,0,1,0
82514,4,2,288959,288959,288961,0,2,3
82515,4,2,288963,288963,288965,0,2,2
82516,3,1,288966,288966,288967,0,1,1
82517,1,1,288967,288967,288968,0,1,0
82518,6,1,288973,288973,288974,0,1,5
82519,2,1,288975,288975,288976,0,1,1
82520,2,3,288977,288977,288980,0,3,1
82521,5,3,288982,288982,288985,0,3,2
82522,2,3,288984,288985,288988,1,4,0
82523,6,3,288990,288990,288993,0,3,2
82524,1,1,288991,288993,288994,2,3,0
82525,6,1,288997,288997,288998,0,1,3
82526,3,2,289000,289000,289002,0,2,2
82527,2,2,289002,289002,289004,0,2,0
82528,4,3,289006,289006,289009,0,3,2
82529,1,2,289007,289009,289011,2,4,0
82530,3,3,289010,289011,289014,1,4,0
82531,5,2,289015,289015,289017,0,2,1
82532,5,3,289020,289020,289023,0,3,3
82533,4,2,289024,289024,289026,0,2,1
82534,1,1,289025,289026,289027,1,2,0
82535,1,3,289026,289027,289030,1,4,0
82536,5,3,289031,289031,289034,0,3,1
82537,3,3,289034,289034,289037,0,3,0
82538,4,3,289038,289038,289041,0,3,1
82539,3,3,289041,289041,289044,0,3,0
82540,2,2,289043,289044,289046,1,3,0
82541,2,1,289045,289046,289047,1,2,0
82542,3,1,289048,289048,289049,0,1,1
82543,6,3,289054,289054,289057,0,3,5
82544,4,1,289058,289058,289059,0,1,1
82545,2,3,289060,289060,289063,0,3,1
82546,1,3,289061,289063,289066,2,5,0
82547,2,2,289063,289066,289068,3,5,0
82548,3,3,289066,289068,289071,2,5,0
82549,3,2,289069,289071,289073,2,4,0
82550,4,3,289073,289073,289076,0,3,0
82551,3,1,289076,289076,289077,0,1,0
82552,1,3,289077,289077,289080,0,3,0
82553,3,3,289080,289080,289083,0,3,0
82554,3,3,289083,289083,289086,0,3,0
82555,4,3,289087,289087,289090,0,3,1
82556,3,1,289090,289090,289091,0,1,0
82557,3,2,289093,289093,289095,0,2,2
82558,4,3,289097,289097,289100,0,3,2
82559,6,1,289103,289103,289104,0,1,3
82560,1,1,289104,289104,289105,0,1,0
82561,6,2,289110,289110,289112,0,2,5
82562,1,3,289111,289112,289115,1,4,0
82563,6,3,289117,289117,289120,0,3,2
82564,1,3,289118,289120,289123,2,5,0
82565,6,3,289124,289124,289127,0,3,1
82566,5,1,289129,289129,289130,0,1,2
82567,5,1,289134,289134,289135,0,1,4
82568,5,2,289139,289139,289141,0,2,4
82569,4,2,289143,289143,289145,0,2,2
82570,5,3,289148,289148,289151,0,3,3
82571,2,1,289150,289151,289152,1,2,0
82572,3,2,289153,289153,289155,0,2,1
82573,3,3,289156,289156,289159,0,3,1
82574,2,1,289158,289159,289160,1,2,0
82575,3,3,289161,289161,289164,0,3,1
82576,4,2,289165,289165,289167,0,2,1
82577,2,2,289167,289167,289169,0,2,0
82578,6,1,289173,289173,289174,0,1,4
82579,4,3,289177,289177,289180,0,3,3
82580,4,1,289181,289181,289182,0,1,1
82581,2,2,289183,289183,289185,0,2,1
82582,3,1,289186,289186,289187,0,1,1
82583,4,1,289190,289190,289191,0,1,3
82584,6,1,289196,289196,289197,0,1,5
82585,3,1,289199,289199,289200,0,1,2
82586,3,2,289202,289202,289204,0,2,2
82587,5,2,289207,289207,289209,0,2,3
82588,5,3,289212,289212,289215,0,3,3
82589,2,3,289214,289215,289218,1,4,0
82590,1,1,289215,289218,289219,3,4,0
82591,4,3,289219,289219,289222,0,3,0
82592,1,2,289220,289222,289224,2,4,0
82593,2,2,289222,289224,289226,2,4,0
82594,2,3,289224,289226,289229,2,5,0
82595,3,2,289227,289229,289231,2,4,0
82596,2,2,289229,289231,289233,2,4,0
82597,3,2,289232,289233,289235,1,3,0
82598,2,3,289234,289235,289238,1,4,0
82599,1,1,289235,289238,289239,3,4,0
82600,3,1,289238,289239,289240,1,2,0
82601,5,1,289243,289243,289244,0,1,3
82602,2,2,289245,289245,289247,0,2,1
82603,3,1,289248,289248,289249,0,1,1
82604,5,1,289253,289253,289254,0,1,4
82605,3,1,289256,289256,289257,0,1,2
82606,5,1,289261,289261,289262,0,1,4
82607,4,3,289265,289265,289268,0,3,3
82608,5,2,289270,289270,289272,0,2,2
82609,4,2,289274,289274,289276,0,2,2
82610,6,3,289280,289280,289283,0,3,4
82611,2,3,289282,289283,289286,1,4,0
82612,4,1,289286,289286,289287,0,1,0
82613,6,3,289292,289292,289295,0,3,5
82614,2,3,289294,289295,289298,1,4,0
82615,1,1,289295,289298,289299,3,4,0
82616,6,1,289301,289301,289302,0,1,2
82617,6,2,289307,289307,289309,0,2,5
82618,1,1,289308,289309,289310,1,2,0
82619,4,2,289312,289312,289314,0,2,2
82620,2,1,289314,289314,289315,0,1,0
82621,5,2,289319,289319,289321,0,2,4
82622,2,3,289321,289321,289324,0,3,0
82623,5,1,289326,289326,289327,0,1,2
82624,4,1,289330,289330,289331,0,1,3
82625,3,3,289333,289333,289336,0,3,2
82626,2,2,289335,289336,289338,1,3,0
82627,3,1,289338,289338,289339,0,1,0
82628,1,2,289339,289339,289341,0,2,0
82629,2,3,289341,289341,289344,0,3,0
82630,1,2,289342,289344,289346,2,4,0
82631,5,1,289347,289347,289348,0,1,1
82632,6,1,289353,289353,289354,0,1,5
82633,2,1,289355,289355,289356,0,1,1
82634,5,2,289360,289360,289362,0,2,4
82635,4,1,289364,289364,289365,0,1,2
82636,5,1,289369,289369,289370,0,1,4
82637,2,3,289371,289371,289374,0,3,1
82638,2,2,289373,289374,289376,1,3,0
82639,3,2,289376,289376,289378,0,2,0
82640,1,3,289377,289378,289381,1,4,0
82641,5,3,289382,289382,289385,0,3,1
82642,3,1,289385,289385,289386,0,1,0
82643,3,1,289388,289388,289389,0,1,2
82644,6,3,289394,289394,289397,0,3,5
82645,5,2,289399,289399,289401,0,2,2
82646,4,2,289403,289403,289405,0,2,2
82647,3,2,289406,289406,289408,0,2,1
82648,2,3,289408,289408,289411,0,3,0
82649,3,3,289411,289411,289414,0,3,0
82650,4,3,289415,289415,289418,0,3,1
82651,4,2,289419,289419,289421,0,2,1
82652,4,1,289423,289423,289424,0,1,2
82653,6,3,289429,289429,289432,0,3,5
82654,3,3,289432,289432,289435,0,3,0
82655,5,1,289437,289437,289438,0,1,2
82656,1,1,289438,289438,289439,0,1,0
82657,2,1,289440,289440,289441,0,1,1
82658,5,3,289445,289445,289448,0,3,4
82659,6,3,289451,289451,289454,0,3,3
82660,6,3,289457,289457,289460,0,3,3
82661,1,3,289458,289460,289463,2,5,0
82662,6,1,289464,289464,289465,0,1,1
82663,4,3,289468,289468,289471,0,3,3
82664,1,3,289469,289471,289474,2,5,0
82665,5,3,289474,289474,289477,0,3,0
82666,5,1,289479,289479,289480,0,1,2
82667,1,1,289480,289480,289481,0,1,0
82668,6,2,289486,289486,289488,0,2,5
82669,5,1,289491,289491,289492,0,1,3
82670,3,1,289494,289494,289495,0,1,2
82671,1,3,289495,289495,289498,0,3,0
82672,1,2,289496,289498,289500,2,4,0
82673,3,3,289499,289500,289503,1,4,0
82674,2,2,289501,289503,289505,2,4,0
82675,4,1,289505,289505,289506,0,1,0
82676,1,2,289506,289506,289508,0,2,0
82677,3,3,289509,289509,289512,0,3,1
82678,5,2,289514,289514,289516,0,2,2
82679,4,2,289518,289518,289520,0,2,2
82680,5,1,289523,289523,289524,0,1,3
82681,4,1,289527,289527,289528,0,1,3
82682,2,3,289529,289529,289532,0,3,1
82683,1,3,289530,289532,289535,2,5,0
82684,3,3,289533,289535,289538,2,5,0
82685,5,1,289538,289538,289539,0,1,0
82686,5,1,289543,289543,289544,0,1,4
82687,4,2,289547,289547,289549,0,2,3
82688,6,3,289553,289553,289556,0,3,4
82689,2,1,289555,289556,289557,1,2,0
82690,6,3,289561,289561,289564,0,3,4
82691,5,3,289566,289566,289569,0,3,2
82692,6,2,289572,289572,289574,0,2,3
82693,3,3,289575,289575,289578,0,3,1
82694,3,1,289578,289578,289579,0,1,0
82695,4,2,289582,289582,289584,0,2,3
82696,5,3,289587,289587,289590,0,3,3
82697,6,1,289593,289593,289594,0,1,3
82698,3,2,289596,289596,289598,0,2,2
82699,2,3,289598,289598,289601,0,3,0
82700,6,2,289604,289604,289606,0,2,3
82701,6,2,289610,289610,289612,0,2,4
82702,3,1,289613,289613,289614,0,1,1
82703,5,2,289618,289618,289620,0,2,4
82704,6,2,289624,289624,289626,0,2,4
82705,2,1,289626,289626,289627,0,1,0
82706,4,2,289630,289630,289632,0,2,3
82707,5,2,289635,289635,289637,0,2,3
82708,3,3,289638,289638,289641,0,3,1
82709,4,3,289642,289642,289645,0,3,1
82710,2,3,289644,289645,289648,1,4,0
82711,3,1,289647,289648,289649,1,2,0
82712,3,1,289650,289650,289651,0,1,1
82713,3,2,289653,289653,289655,0,2,2
82714,4,1,289657,289657,289658,0,1,2
82715,2,1,289659,289659,289660,0,1,1
82716,6,3,289665,289665,289668,0,3,5
82717,4,3,289669,289669,289672,0,3,1
82718,4,2,289673,289673,289675,0,2,1
82719,5,2,289678,289678,289680,0,2,3
82720,3,2,289681,289681,289683,0,2,1
82721,2,3,289683,289683,289686,0,3,0
82722,4,1,289687,289687,289688,0,1,1
82723,6,2,289693,289693,289695,0,2,5
82724,3,1,289696,289696,289697,0,1,1
82725,2,1,289698,289698,289699,0,1,1
82726,3,3,289701,289701,289704,0,3,2
82727,2,3,289703,289704,289707,1,4,0
82728,6,1,289709,289709,289710,0,1,2
82729,5,1,289714,289714,289715,0,1,4
82730,6,1,289720,289720,289721,0,1,5
82731,1,3,289721,289721,289724,0,3,0
82732,4,3,289725,289725,289728,0,3,1
82733,2,1,289727,289728,289729,1,2,0
82734,3,2,289730,289730,289732,0,2,1
82735,5,2,289735,289735,289737,0,2,3
82736,6,2,289741,289741,289743,0,2,4
82737,4,1,289745,289745,289746,0,1,2
82738,6,3,289751,289751,289754,0,3,5
82739,3,3,289754,289754,289757,0,3,0
82740,4,1,289758,289758,289759,0,1,1
82741,3,2,289761,289761,289763,0,2,2
82742,5,3,289766,289766,289769,0,3,3
82743,6,1,289772,289772,289773,0,1,3
82744,4,3,289776,289776,289779,0,3,3
82745,3,1,289779,289779,289780,0,1,0
82746,5,2,289784,289784,289786,0,2,4
82747,5,1,289789,289789,289790,0,1,3
82748,3,2,289792,289792,289794,0,2,2
82749,2,2,289794,289794,289796,0,2,0
82750,3,2,289797,289797,289799,0,2,1
82751,4,3,289801,289801,289804,0,3,2
82752,1,3,289802,289804,289807,2,5,0
82753,2,2,289804,289807,289809,3,5,0
82754,5,2,289809,289809,289811,0,2,0
82755,1,1,289810,289811,289812,1,2,0
82756,4,3,289814,289814,289817,0,3,2
82757,5,1,289819,289819,289820,0,1,2
82758,4,1,289823,289823,289824,0,1,3
82759,6,1,289829,289829,289830,0,1,5
82760,3,2,289832,289832,289834,0,2,2
82761,2,1,289834,289834,289835,0,1,0
82762,4,2,289838,289838,289840,0,2,3
82763,2,2,289840,289840,289842,0,2,0
82764,6,3,289846,289846,289849,0,3,4
82765,5,2,289851,289851,289853,0,2,2
82766,6,3,289857,289857,289860,0,3,4
82767,4,2,289861,289861,289863,0,2,1
82768,4,1,289865,289865,289866,0,1,2
82769,5,3,289870,289870,289873,0,3,4
82770,3,2,289873,289873,289875,0,2,0
82771,4,1,289877,289877,289878,0,1,2
82772,4,2,289881,289881,289883,0,2,3
82773,3,3,289884,289884,289887,0,3,1
82774,2,2,289886,289887,289889,1,3,0
82775,5,3,289891,289891,289894,0,3,2
82776,3,3,289894,289894,289897,0,3,0
82777,2,1,289896,289897,289898,1,2,0
82778,5,2,289901,289901,289903,0,2,3
82779,6,1,289907,289907,289908,0,1,4
82780,5,2,289912,289912,289914,0,2,4
82781,3,2,289915,289915,289917,0,2,1
82782,1,1,289916,289917,289918,1,2,0
82783,4,2,289920,289920,289922,0,2,2
82784,5,2,289925,289925,289927,0,2,3
82785,5,2,289930,289930,289932,0,2,3
82786,6,3,289936,289936,289939,0,3,4
82787,5,3,289941,289941,289944,0,3,2
82788,5,2,289946,289946,289948,0,2,2
82789,2,1,289948,289948,289949,0,1,0
82790,4,1,289952,289952,289953,0,1,3
82791,3,3,289955,289955,289958,0,3,2
82792,5,2,289960,289960,289962,0,2,2
82793,2,3,289962,289962,289965,0,3,0
82794,1,1,289963,289965,289966,2,3,0
82795,3,1,289966,289966,289967,0,1,0
82796,5,3,289971,289971,289974,0,3,4
82797,2,2,289973,289974,289976,1,3,0
82798,3,1,289976,289976,289977,0,1,0
82799,3,3,289979,289979,289982,0,3,2
82800,4,1,289983,289983,289984,0,1,1
82801,4,2,289987,289987,289989,0,2,3
82802,1,2,289988,289989,289991,1,3,0
82803,1,1,289989,289991,289992,2,3,0
82804,4,3,289993,289993,289996,0,3,1
82805,5,1,289998,289998,289999,0,1,2
82806,1,3,289999,289999,290002,0,3,0
82807,1,2,290000,290002,290004,2,4,0
82808,2,1,290002,290004,290005,2,3,0
82809,3,3,290005,290005,290008,0,3,0
82810,4,3,290009,290009,290012,0,3,1
82811,2,2,290011,290012,290014,1,3,0
82812,6,3,290017,290017,290020,0,3,3
82813,4,3,290021,290021,290024,0,3,1
82814,2,1,290023,290024,290025,1,2,0
82815,2,1,290025,290025,290026,0,1,0
82816,3,1,290028,290028,290029,0,1,2
82817,6,1,290034,290034,290035,0,1,5
82818,1,2,290035,290035,290037,0,2,0
82819,4,2,290039,290039,290041,0,2,2
82820,5,3,290044,290044,290047,0,3,3
82821,5,2,290049,290049,290051,0,2,2
82822,1,2,290050,290051,290053,1,3,0
82823,6,3,290056,290056,290059,0,3,3
82824,5,3,290061,290061,290064,0,3,2
82825,4,3,290065,290065,290068,0,3,1
82826,1,1,290066,290068,290069,2,3,0
82827,4,3,290070,290070,290073,0,3,1
82828,3,1,290073,290073,290074,0,1,0
82829,2,3,290075,290075,290078,0,3,1
82830,2,2,290077,290078,290080,1,3,0
82831,6,3,290083,290083,290086,0,3,3
82832,2,1,290085,290086,290087,1,2,0
82833,2,1,290087,290087,290088,0,1,0
82834,2,2,290089,290089,290091,0,2,1
82835,4,3,290093,290093,290096,0,3,2
82836,4,3,290097,290097,290100,0,3,1
82837,6,3,290103,290103,290106,0,3,3
82838,2,1,290105,290106,290107,1,2,0
82839,1,1,290106,290107,290108,1,2,0
82840,3,1,290109,290109,290110,0,1,1
82841,1,3,290110,290110,290113,0,3,0
82842,1,1,290111,290113,290114,2,3,0
82843,1,3,290112,290114,290117,2,5,0
82844,6,2,290118,290118,290120,0,2,1
82845,2,3,290120,290120,290123,0,3,0
82846,4,3,290124,290124,290127,0,3,1
82847,4,3,290128,290128,290131,0,3,1
82848,5,1,290133,290133,290134,0,1,2
82849,3,3,290136,290136,290139,0,3,2
82850,6,3,290142,290142,290145,0,3,3
82851,6,2,290148,290148,290150,0,2,3
82852,6,1,290154,290154,290155,0,1,4
82853,3,2,290157,290157,290159,0,2,2
82854,2,2,290159,290159,290161,0,2,0
82855,1,1,290160,290161,290162,1,2,0
82856,6,1,290166,290166,290167,0,1,4
82857,5,1,290171,290171,290172,0,1,4
82858,6,2,290177,290177,290179,0,2,5
82859,3,2,290180,290180,290182,0,2,1
82860,5,3,290185,290185,290188,0,3,3
82861,3,2,290188,290188,290190,0,2,0
82862,4,3,290192,290192,290195,0,3,2
82863,1,1,290193,290195,290196,2,3,0
82864,2,2,290195,290196,290198,1,3,0
82865,1,1,290196,290198,290199,2,3,0
82866,3,2,290199,290199,290201,0,2,0
82867,5,1,290204,290204,290205,0,1,3
82868,1,2,290205,290205,290207,0,2,0
82869,2,2,290207,290207,290209,0,2,0
82870,6,3,290213,290213,290216,0,3,4
82871,2,3,290215,290216,290219,1,4,0
82872,1,3,290216,290219,290222,3,6,0
82873,6,3,290222,290222,290225,0,3,0
82874,1,1,290223,290225,290226,2,3,0
82875,2,2,290225,290226,290228,1,3,0
82876,2,1,290227,290228,290229,1,2,0
82877,5,1,290232,290232,290233,0,1,3
82878,2,3,290234,290234,290237,0,3,1
82879,3,2,290237,290237,290239,0,2,0
82880,4,1,290241,290241,290242,0,1,2
82881,5,3,290246,290246,290249,0,3,4
82882,1,1,290247,290249,290250,2,3,0
82883,5,1,290252,290252,290253,0,1,2
82884,6,2,290258,290258,290260,0,2,5
82885,4,1,290262,290262,290263,0,1,2
82886,3,3,290265,290265,290268,0,3,2
82887,3,2,290268,290268,290270,0,2,0
82888,3,1,290271,290271,290272,0,1,1
82889,3,3,290274,290274,290277,0,3,2
82890,2,1,290276,290277,290278,1,2,0
82891,6,1,290282,290282,290283,0,1,4
82892,6,1,290288,290288,290289,0,1,5
82893,3,1,290291,290291,290292,0,1,2
82894,2,1,290293,290293,290294,0,1,1
82895,1,1,290294,290294,290295,0,1,0
82896,1,2,290295,290295,290297,0,2,0
82897,5,1,290300,290300,290301,0,1,3
82898,1,1,290301,290301,290302,0,1,0
82899,3,2,290304,290304,290306,0,2,2
82900,2,1,290306,290306,290307,0,1,0
82901,5,2,290311,290311,290313,0,2,4
82902,5,3,290316,290316,290319,0,3,3
82903,5,2,290321,290321,290323,0,2,2
82904,5,2,290326,290326,290328,0,2,3
82905,3,2,290329,290329,290331,0,2,1
82906,5,1,290334,290334,290335,0,1,3
82907,6,2,290340,290340,290342,0,2,5
82908,3,3,290343,290343,290346,0,3,1
82909,4,2,290347,290347,290349,0,2,1
82910,3,2,290350,290350,290352,0,2,1
82911,2,3,290352,290352,290355,0,3,0
82912,3,3,290355,290355,290358,0,3,0
82913,3,1,290358,290358,290359,0,1,0
82914,1,2,290359,290359,290361,0,2,0
82915,5,3,290364,290364,290367,0,3,3
82916,3,1,290367,290367,290368,0,1,0
82917,2,2,290369,290369,290371,0,2,1
82918,5,3,290374,290374,290377,0,3,3
82919,2,2,290376,290377,290379,1,3,0
82920,2,1,290378,290379,290380,1,2,0
82921,1,3,290379,290380,290383,1,4,0
82922,4,3,290383,290383,290386,0,3,0
82923,5,3,290388,290388,290391,0,3,2
82924,4,2,290392,290392,290394,0,2,1
82925,5,2,290397,290397,290399,0,2,3
82926,2,3,290399,290399,290402,0,3,0
82927,4,1,290403,290403,290404,0,1,1
82928,2,3,290405,290405,290408,0,3,1
82929,5,2,290410,290410,290412,0,2,2
82930,2,3,290412,290412,290415,0,3,0
82931,5,1,290417,290417,290418,0,1,2
82932,2,1,290419,290419,290420,0,1,1
82933,1,1,290420,290420,290421,0,1,0
82934,3,1,290423,290423,290424,0,1,2
82935,6,3,290429,290429,290432,0,3,5
82936,2,3,290431,290432,290435,1,4,0
82937,2,3,290433,290435,290438,2,5,0
82938,6,2,290439,290439,290441,0,2,1
82939,3,2,290442,290442,290444,0,2,1
82940,6,1,290448,290448,290449,0,1,4
82941,1,1,290449,290449,290450,0,1,0
82942,2,3,290451,290451,290454,0,3,1
82943,5,3,290456,290456,290459,0,3,2
82944,3,1,290459,290459,290460,0,1,0
82945,1,3,290460,290460,290463,0,3,0
82946,6,1,290466,290466,290467,0,1,3
82947,6,1,290472,290472,290473,0,1,5
82948,2,2,290474,290474,290476,0,2,1
82949,1,3,290475,290476,290479,1,4,0
82950,2,1,290477,290479,290480,2,3,0
82951,3,3,290480,290480,290483,0,3,0
82952,4,1,290484,290484,290485,0,1,1
82953,5,3,290489,290489,290492,0,3,4
82954,1,1,290490,290492,290493,2,3,0
82955,5,2,290495,290495,290497,0,2,2
82956,6,1,290501,290501,290502,0,1,4
82957,4,3,290505,290505,290508,0,3,3
82958,1,3,290506,290508,290511,2,5,0
82959,3,1,290509,290511,290512,2,3,0
82960,2,3,290511,290512,290515,1,4,0
82961,4,2,290515,290515,290517,0,2,0
82962,6,2,290521,290521,290523,0,2,4
82963,5,1,290526,290526,290527,0,1,3
82964,1,1,290527,290527,290528,0,1,0
82965,5,1,290532,290532,290533,0,1,4
82966,1,2,290533,290533,290535,0,2,0
82967,6,1,290539,290539,290540,0,1,4
82968,4,1,290543,290543,290544,0,1,3
82969,2,1,290545,290545,290546,0,1,1
82970,6,2,290551,290551,290553,0,2,5
82971,4,1,290555,290555,290556,0,1,2
82972,6,1,290561,290561,290562,0,1,5
82973,5,3,290566,290566,290569,0,3,4
82974,1,3,290567,290569,290572,2,5,0
82975,5,3,290572,290572,290575,0,3,0
82976,4,2,290576,290576,290578,0,2,1
82977,1,3,290577,290578,290581,1,4,0
82978,3,3,290580,290581,290584,1,4,0
82979,6,1,290586,290586,290587,0,1,2
82980,1,1,290587,290587,290588,0,1,0
82981,4,3,290591,290591,290594,0,3,3
82982,4,2,290595,290595,290597,0,2,1
82983,5,3,290600,290600,290603,0,3,3
82984,3,1,290603,290603,290604,0,1,0
82985,3,3,290606,290606,290609,0,3,2
82986,3,1,290609,290609,290610,0,1,0
82987,6,2,290615,290615,290617,0,2,5
82988,1,3,290616,290617,290620,1,4,0
82989,5,3,290621,290621,290624,0,3,1
82990,2,2,290623,290624,290626,1,3,0
82991,1,1,290624,290626,290627,2,3,0
82992,3,3,290627,290627,290630,0,3,0
82993,1,1,290628,290630,290631,2,3,0
82994,1,1,290629,290631,290632,2,3,0
82995,3,2,290632,290632,290634,0,2,0
82996,6,2,290638,290638,290640,0,2,4
82997,4,3,290642,290642,290645,0,3,2
82998,2,2,290644,290645,290647,1,3,0
82999,2,2,290646,290647,290649,1,3,0
83000,2,3,290648,290649,290652,1,4,0
83001,2,3,290650,290652,290655,2,5,0
83002,6,1,290656,290656,290657,0,1,1
83003,1,3,290657,290657,290660,0,3,0
83004,1,2,290658,290660,290662,2,4,0
83005,1,1,290659,290662,290663,3,4,0
83006,1,3,290660,290663,290666,3,6,0
83007,1,3,290661,290666,290669,5,8,0
83008,3,2,290664,290669,290671,5,7,0
83009,4,3,290668,290671,290674,3,6,0
83010,1,3,290669,290674,290677,5,8,0
83011,3,3,290672,290677,290680,5,8,0
83012,4,2,290676,290680,290682,4,6,0
83013,1,2,290677,290682,290684,5,7,0
83014,5,1,290682,290684,290685,2,3,0
83015,3,1,290685,290685,290686,0,1,0
83016,1,2,290686,290686,290688,0,2,0
83017,3,2,290689,290689,290691,0,2,1
83018,4,1,290693,290693,290694,0,1,2
83019,4,2,290697,290697,290699,0,2,3
83020,5,2,290702,290702,290704,0,2,3
83021,3,1,290705,290705,290706,0,1,1
83022,3,3,290708,290708,290711,0,3,2
83023,2,1,290710,290711,290712,1,2,0
83024,4,3,290714,290714,290717,0,3,2
83025,4,1,290718,290718,290719,0,1,1
83026,2,1,290720,290720,290721,0,1,1
83027,4,3,290724,290724,290727,0,3,3
83028,1,2,290725,290727,290729,2,4,0
83029,1,1,290726,290729,290730,3,4,0
83030,3,3,290729,290730,290733,1,4,0
83031,2,2,290731,290733,290735,2,4,0
83032,5,3,290736,290736,290739,0,3,1
83033,2,2,290738,290739,290741,1,3,0
83034,4,1,290742,290742,290743,0,1,1
83035,4,3,290746,290746,290749,0,3,3
83036,3,3,290749,290749,290752,0,3,0
83037,3,3,290752,290752,290755,0,3,0
83038,1,3,290753,290755,290758,2,5,0
83039,2,2,290755,290758,290760,3,5,0
83040,3,2,290758,290760,290762,2,4,0
83041,6,3,290764,290764,290767,0,3,2
83042,4,3,290768,290768,290771,0,3,1
83043,3,3,290771,290771,290774,0,3,0
83044,6,1,290777,290777,290778,0,1,3
83045,4,1,290781,290781,290782,0,1,3
83046,4,3,290785,290785,290788,0,3,3
83047,6,2,290791,290791,290793,0,2,3
83048,4,1,290795,290795,290796,0,1,2
83049,3,2,290798,290798,290800,0,2,2
83050,3,3,290801,290801,290804,0,3,1
83051,3,1,290804,290804,290805,0,1,0
83052,5,3,290809,290809,290812,0,3,4
83053,6,3,290815,290815,290818,0,3,3
83054,4,1,290819,290819,290820,0,1,1
83055,1,1,290820,290820,290821,0,1,0
83056,5,1,290825,290825,290826,0,1,4
83057,1,1,290826,290826,290827,0,1,0
83058,6,2,290832,290832,290834,0,2,5
83059,4,3,290836,290836,290839,0,3,2
83060,1,1,290837,290839,290840,2,3,0
83061,6,2,290843,290843,290845,0,2,3
83062,6,2,290849,290849,290851,0,2,4
83063,4,1,290853,290853,290854,0,1,2
83064,6,2,290859,290859,290861,0,2,5
83065,4,3,290863,290863,290866,0,3,2
83066,1,3,290864,290866,290869,2,5,0
83067,1,2,290865,290869,290871,4,6,0
83068,3,3,290868,290871,290874,3,6,0
83069,3,2,290871,290874,290876,3,5,0
83070,1,1,290872,290876,290877,4,5,0
83071,1,3,290873,290877,290880,4,7,0
83072,6,3,290879,290880,290883,1,4,0
83073,5,1,290884,290884,290885,0,1,1
83074,6,3,290890,290890,290893,0,3,5
83075,5,2,290895,290895,290897,0,2,2
83076,3,1,290898,290898,290899,0,1,1
83077,5,1,290903,290903,290904,0,1,4
83078,1,2,290904,290904,290906,0,2,0
83079,2,3,290906,290906,290909,0,3,0
83080,2,2,290908,290909,290911,1,3,0
83081,6,2,290914,290914,290916,0,2,3
83082,2,1,290916,290916,290917,0,1,0
83083,2,3,290918,290918,290921,0,3,1
83084,3,1,290921,290921,290922,0,1,0
83085,3,1,290924,290924,290925,0,1,2
83086,1,2,290925,290925,290927,0,2,0
83087,3,1,290928,290928,290929,0,1,1
83088,3,1,290931,290931,290932,0,1,2
83089,3,2,290934,290934,290936,0,2,2
83090,3,3,290937,290937,290940,0,3,1
83091,5,3,290942,290942,290945,0,3,2
83092,1,1,290943,290945,290946,2,3,0
83093,2,1,290945,290946,290947,1,2,0
83094,5,2,290950,290950,290952,0,2,3
83095,5,1,290955,290955,290956,0,1,3
83096,6,1,290961,290961,290962,0,1,5
83097,5,3,290966,290966,290969,0,3,4
83098,4,2,290970,290970,290972,0,2,1
83099,2,1,290972,290972,290973,0,1,0
83100,1,3,290973,290973,290976,0,3,0
83101,6,2,290979,290979,290981,0,2,3
83102,5,2,290984,290984,290986,0,2,3
83103,3,2,290987,290987,290989,0,2,1
83104,5,1,290992,290992,290993,0,1,3
83105,4,3,290996,290996,290999,0,3,3
83106,6,3,291002,291002,291005,0,3,3
83107,3,1,291005,291005,291006,0,1,0
83108,4,3,291009,291009,291012,0,3,3
83109,6,1,291015,291015,291016,0,1,3
83110,4,3,291019,291019,291022,0,3,3
83111,3,2,291022,291022,291024,0,2,0
83112,1,2,291023,291024,291026,1,3,0
83113,6,1,291029,291029,291030,0,1,3
83114,6,3,291035,291035,291038,0,3,5
83115,2,3,291037,291038,291041,1,4,0
83116,3,1,291040,291041,291042,1,2,0
83117,1,2,291041,291042,291044,1,3,0
83118,6,3,291047,291047,291050,0,3,3
83119,6,3,291053,291053,291056,0,3,3
83120,6,1,291059,291059,291060,0,1,3
83121,4,3,291063,291063,291066,0,3,3
83122,3,2,291066,291066,291068,0,2,0
83123,6,3,291072,291072,291075,0,3,4
83124,4,1,291076,291076,291077,0,1,1
83125,5,3,291081,291081,291084,0,3,4
83126,2,3,291083,291084,291087,1,4,0
83127,3,1,291086,291087,291088,1,2,0
83128,6,2,291092,291092,291094,0,2,4
83129,4,3,291096,291096,291099,0,3,2
83130,5,3,291101,291101,291104,0,3,2
83131,2,3,291103,291104,291107,1,4,0
83132,6,2,291109,291109,291111,0,2,2
83133,4,3,291113,291113,291116,0,3,2
83134,4,3,291117,291117,291120,0,3,1
83135,2,2,291119,291120,291122,1,3,0
83136,6,3,291125,291125,291128,0,3,3
83137,5,3,291130,291130,291133,0,3,2
83138,3,3,291133,291133,291136,0,3,0
83139,2,3,291135,291136,291139,1,4,0
83140,3,2,291138,291139,291141,1,3,0
83141,6,3,291144,291144,291147,0,3,3
83142,6,3,291150,291150,291153,0,3,3
83143,2,2,291152,291153,291155,1,3,0
83144,2,1,291154,291155,291156,1,2,0
83145,1,2,291155,291156,291158,1,3,0
83146,5,1,291160,291160,291161,0,1,2
83147,4,1,291164,291164,291165,0,1,3
83148,3,3,291167,291167,291170,0,3,2
83149,2,1,291169,291170,291171,1,2,0
83150,4,1,291173,291173,291174,0,1,2
83151,3,2,291176,291176,291178,0,2,2
83152,1,3,291177,291178,291181,1,4,0
83153,1,2,291178,291181,291183,3,5,0
83154,1,3,291179,291183,291186,4,7,0
83155,3,1,291182,291186,291187,4,5,0
83156,6,2,291188,291188,291190,0,2,1
83157,3,3,291191,291191,291194,0,3,1
83158,4,1,291195,291195,291196,0,1,1
83159,4,3,291199,291199,291202,0,3,3
83160,6,3,291205,291205,291208,0,3,3
83161,5,1,291210,291210,291211,0,1,2
83162,5,2,291215,291215,291217,0,2,4
83163,6,3,291221,291221,291224,0,3,4
83164,2,2,291223,291224,291226,1,3,0
83165,1,1,291224,291226,291227,2,3,0
83166,1,2,291225,291227,291229,2,4,0
83167,1,3,291226,291229,291232,3,6,0
83168,6,3,291232,291232,291235,0,3,0
83169,4,1,291236,291236,291237,0,1,1
83170,6,3,291242,291242,291245,0,3,5
83171,1,3,291243,291245,291248,2,5,0
83172,3,2,291246,291248,291250,2,4,0
83173,5,2,291251,291251,291253,0,2,1
83174,2,2,291253,291253,291255,0,2,0
83175,4,2,291257,291257,291259,0,2,2
83176,3,3,291260,291260,291263,0,3,1
83177,6,2,291266,291266,291268,0,2,3
83178,2,2,291268,291268,291270,0,2,0
83179,3,2,291271,291271,291273,0,2,1
83180,6,1,291277,291277,291278,0,1,4
83181,2,3,291279,291279,291282,0,3,1
83182,4,1,291283,291283,291284,0,1,1
83183,6,1,291289,291289,291290,0,1,5
83184,2,2,291291,291291,291293,0,2,1
83185,5,1,291296,291296,291297,0,1,3
83186,4,2,291300,291300,291302,0,2,3
83187,4,1,291304,291304,291305,0,1,2
83188,1,3,291305,291305,291308,0,3,0
83189,4,1,291309,291309,291310,0,1,1
83190,6,3,291315,291315,291318,0,3,5
83191,3,1,291318,291318,291319,0,1,0
83192,2,2,291320,291320,291322,0,2,1
83193,4,2,291324,291324,291326,0,2,2
83194,3,3,291327,291327,291330,0,3,1
83195,4,3,291331,291331,291334,0,3,1
83196,1,2,291332,291334,291336,2,4,0
83197,4,2,291336,291336,291338,0,2,0
83198,2,2,291338,291338,291340,0,2,0
83199,2,3,291340,291340,291343,0,3,0
83200,1,3,291341,291343,291346,2,5,0
83201,3,2,291344,291346,291348,2,4,0
83202,3,2,291347,291348,291350,1,3,0
83203,5,2,291352,291352,291354,0,2,2
83204,5,1,291357,291357,291358,0,1,3
83205,6,1,291363,291363,291364,0,1,5
83206,4,2,291367,291367,291369,0,2,3
83207,4,2,291371,291371,291373,0,2,2
83208,2,3,291373,291373,291376,0,3,0
83209,2,1,291375,291376,291377,1,2,0
83210,1,1,291376,291377,291378,1,2,0
83211,2,3,291378,291378,291381,0,3,0
83212,6,2,291384,291384,291386,0,2,3
83213,2,2,291386,291386,291388,0,2,0
83214,4,3,291390,291390,291393,0,3,2
83215,4,1,291394,291394,291395,0,1,1
83216,6,3,291400,291400,291403,0,3,5
83217,6,2,291406,291406,291408,0,2,3
83218,3,1,291409,291409,291410,0,1,1
83219,2,2,291411,291411,291413,0,2,1
83220,4,2,291415,291415,291417,0,2,2
83221,4,1,291419,291419,291420,0,1,2
83222,2,2,291421,291421,291423,0,2,1
83223,5,2,291426,291426,291428,0,2,3
83224,5,2,291431,291431,291433,0,2,3
83225,1,3,291432,291433,291436,1,4,0
83226,3,2,291435,291436,291438,1,3,0
83227,1,3,291436,291438,291441,2,5,0
83228,2,2,291438,291441,291443,3,5,0
83229,1,1,291439,291443,291444,4,5,0
83230,6,1,291445,291445,291446,0,1,1
83231,4,3,291449,291449,291452,0,3,3
83232,3,3,291452,291452,291455,0,3,0
83233,4,2,291456,291456,291458,0,2,1
83234,5,3,291461,291461,291464,0,3,3
83235,5,3,291466,291466,291469,0,3,2
83236,4,1,291470,291470,291471,0,1,1
83237,6,1,291476,291476,291477,0,1,5
83238,6,3,291482,291482,291485,0,3,5
83239,1,2,291483,291485,291487,2,4,0
83240,4,1,291487,291487,291488,0,1,0
83241,5,3,291492,291492,291495,0,3,4
83242,5,2,291497,291497,291499,0,2,2
83243,6,2,291503,291503,291505,0,2,4
83244,6,3,291509,291509,291512,0,3,4
83245,4,2,291513,291513,291515,0,2,1
83246,2,3,291515,291515,291518,0,3,0
83247,1,3,291516,291518,291521,2,5,0
83248,2,2,291518,291521,291523,3,5,0
83249,2,2,291520,291523,291525,3,5,0
83250,1,2,291521,291525,291527,4,6,0
83251,5,1,291526,291527,291528,1,2,0
83252,4,3,291530,291530,291533,0,3,2
83253,4,3,291534,291534,291537,0,3,1
83254,1,1,291535,291537,291538,2,3,0
83255,2,1,291537,291538,291539,1,2,0
83256,1,1,291538,291539,291540,1,2,0
83257,3,1,291541,291541,291542,0,1,1
83258,1,2,291542,291542,291544,0,2,0
83259,5,1,291547,291547,291548,0,1,3
83260,3,1,291550,291550,291551,0,1,2
83261,5,3,291555,291555,291558,0,3,4
83262,1,2,291556,291558,291560,2,4,0
83263,5,3,291561,291561,291564,0,3,1
83264,3,3,291564,291564,291567,0,3,0
83265,6,2,291570,291570,291572,0,2,3
83266,1,2,291571,291572,291574,1,3,0
83267,5,3,291576,291576,291579,0,3,2
83268,4,2,291580,291580,291582,0,2,1
83269,3,1,291583,291583,291584,0,1,1
83270,4,2,291587,291587,291589,0,2,3
83271,2,2,291589,291589,291591,0,2,0
83272,3,2,291592,291592,291594,0,2,1
83273,2,1,291594,291594,291595,0,1,0
83274,1,2,291595,291595,291597,0,2,0
83275,4,1,291599,291599,291600,0,1,2
83276,5,1,291604,291604,291605,0,1,4
83277,6,1,291610,291610,291611,0,1,5
83278,6,3,291616,291616,291619,0,3,5
83279,3,2,291619,291619,291621,0,2,0
83280,3,3,291622,291622,291625,0,3,1
83281,4,1,291626,291626,291627,0,1,1
83282,3,3,291629,291629,291632,0,3,2
83283,3,3,291632,291632,291635,0,3,0
83284,6,2,291638,291638,291640,0,2,3
83285,3,1,291641,291641,291642,0,1,1
83286,2,3,291643,291643,291646,0,3,1
83287,1,3,291644,291646,291649,2,5,0
83288,3,1,291647,291649,291650,2,3,0
83289,4,1,291651,291651,291652,0,1,1
83290,2,1,291653,291653,291654,0,1,1
83291,4,2,291657,291657,291659,0,2,3
83292,1,3,291658,291659,291662,1,4,0
83293,5,2,291663,291663,291665,0,2,1
83294,5,1,291668,291668,291669,0,1,3
83295,1,2,291669,291669,291671,0,2,0
83296,6,2,291675,291675,291677,0,2,4
83297,3,2,291678,291678,291680,0,2,1
83298,6,1,291684,291684,291685,0,1,4
83299,1,1,291685,291685,291686,0,1,0
83300,6,3,291691,291691,291694,0,3,5
83301,5,1,291696,291696,291697,0,1,2
83302,2,2,291698,291698,291700,0,2,1
83303,3,3,291701,291701,291704,0,3,1
83304,1,2,291702,291704,291706,2,4,0
83305,1,1,291703,291706,291707,3,4,0
83306,1,2,291704,291707,291709,3,5,0
83307,3,2,291707,291709,291711,2,4,0
83308,5,2,291712,291712,291714,0,2,1
83309,6,1,291718,291718,291719,0,1,4
83310,1,2,291719,291719,291721,0,2,0
83311,2,1,291721,291721,291722,0,1,0
83312,1,2,291722,291722,291724,0,2,0
83313,2,2,291724,291724,291726,0,2,0
83314,6,3,291730,291730,291733,0,3,4
83315,3,2,291733,291733,291735,0,2,0
83316,4,2,291737,291737,291739,0,2,2
83317,2,1,291739,291739,291740,0,1,0
83318,1,3,291740,291740,291743,0,3,0
83319,4,3,291744,291744,291747,0,3,1
83320,6,3,291750,291750,291753,0,3,3
83321,4,1,291754,291754,291755,0,1,1
83322,1,2,291755,291755,291757,0,2,0
83323,6,1,291761,291761,291762,0,1,4
83324,6,1,291767,291767,291768,0,1,5
83325,2,2,291769,291769,291771,0,2,1
83326,4,3,291773,291773,291776,0,3,2
83327,1,3,291774,291776,291779,2,5,0
83328,5,2,291779,291779,291781,0,2,0
83329,1,2,291780,291781,291783,1,3,0
83330,5,1,291785,291785,291786,0,1,2
83331,4,2,291789,291789,291791,0,2,3
83332,2,2,291791,291791,291793,0,2,0
83333,6,3,291797,291797,291800,0,3,4
83334,3,2,291800,291800,291802,0,2,0
83335,5,1,291805,291805,291806,0,1,3
83336,5,2,291810,291810,291812,0,2,4
83337,1,3,291811,291812,291815,1,4,0
83338,2,2,291813,291815,291817,2,4,0
83339,1,3,291814,291817,291820,3,6,0
83340,1,2,291815,291820,291822,5,7,0
83341,2,3,291817,291822,291825,5,8,0
83342,5,2,291822,291825,291827,3,5,0
83343,1,1,291823,291827,291828,4,5,0
83344,5,1,291828,291828,291829,0,1,0
83345,2,1,291830,291830,291831,0,1,1
83346,5,2,291835,291835,291837,0,2,4
83347,5,1,291840,291840,291841,0,1,3
83348,6,1,291846,291846,291847,0,1,5
83349,3,1,291849,291849,291850,0,1,2
83350,2,1,291851,291851,291852,0,1,1
83351,6,1,291857,291857,291858,0,1,5
83352,6,3,291863,291863,291866,0,3,5
83353,3,3,291866,291866,291869,0,3,0
83354,3,1,291869,291869,291870,0,1,0
83355,3,2,291872,291872,291874,0,2,2
83356,3,3,291875,291875,291878,0,3,1
83357,5,3,291880,291880,291883,0,3,2
83358,6,3,291886,291886,291889,0,3,3
83359,4,3,291890,291890,291893,0,3,1
83360,4,3,291894,291894,291897,0,3,1
83361,6,3,291900,291900,291903,0,3,3
83362,4,1,291904,291904,291905,0,1,1
83363,4,3,291908,291908,291911,0,3,3
83364,5,3,291913,291913,291916,0,3,2
83365,6,3,291919,291919,291922,0,3,3
83366,2,2,291921,291922,291924,1,3,0
83367,2,1,291923,291924,291925,1,2,0
83368,3,2,291926,291926,291928,0,2,1
83369,4,3,291930,291930,291933,0,3,2
83370,1,1,291931,291933,291934,2,3,0
83371,2,1,291933,291934,291935,1,2,0
83372,6,2,291939,291939,291941,0,2,4
83373,4,1,291943,291943,291944,0,1,2
83374,3,2,291946,291946,291948,0,2,2
83375,2,3,291948,291948,291951,0,3,0
83376,1,1,291949,291951,291952,2,3,0
83377,2,3,291951,291952,291955,1,4,0
83378,1,2,291952,291955,291957,3,5,0
83379,6,3,291958,291958,291961,0,3,1
83380,5,2,291963,291963,291965,0,2,2
83381,6,1,291969,291969,291970,0,1,4
83382,4,3,291973,291973,291976,0,3,3
83383,6,2,291979,291979,291981,0,2,3
83384,5,1,291984,291984,291985,0,1,3
83385,2,3,291986,291986,291989,0,3,1
83386,5,3,291991,291991,291994,0,3,2
83387,3,2,291994,291994,291996,0,2,0
83388,4,3,291998,291998,292001,0,3,2
83389,2,1,292000,292001,292002,1,2,0
83390,5,2,292005,292005,292007,0,2,3
83391,5,2,292010,292010,292012,0,2,3
83392,6,3,292016,292016,292019,0,3,4
83393,6,2,292022,292022,292024,0,2,3
83394,3,1,292025,292025,292026,0,1,1
83395,4,1,292029,292029,292030,0,1,3
83396,6,3,292035,292035,292038,0,3,5
83397,6,1,292041,292041,292042,0,1,3
83398,5,2,292046,292046,292048,0,2,4
83399,6,3,292052,292052,292055,0,3,4
83400,3,2,292055,292055,292057,0,2,0
83401,6,1,292061,292061,292062,0,1,4
83402,1,1,292062,292062,292063,0,1,0
83403,4,2,292066,292066,292068,0,2,3
83404,1,2,292067,292068,292070,1,3,0
83405,5,1,292072,292072,292073,0,1,2
83406,6,3,292078,292078,292081,0,3,5
83407,1,2,292079,292081,292083,2,4,0
83408,5,3,292084,292084,292087,0,3,1
83409,5,3,292089,292089,292092,0,3,2
83410,3,1,292092,292092,292093,0,1,0
83411,1,3,292093,292093,292096,0,3,0
83412,4,1,292097,292097,292098,0,1,1
83413,3,1,292100,292100,292101,0,1,2
83414,6,2,292106,292106,292108,0,2,5
83415,1,2,292107,292108,292110,1,3,0
83416,3,1,292110,292110,292111,0,1,0
83417,2,1,292112,292112,292113,0,1,1
83418,1,2,292113,292113,292115,0,2,0
83419,4,1,292117,292117,292118,0,1,2
83420,3,2,292120,292120,292122,0,2,2
83421,6,3,292126,292126,292129,0,3,4
83422,4,2,292130,292130,292132,0,2,1
83423,1,2,292131,292132,292134,1,3,0
83424,3,2,292134,292134,292136,0,2,0
83425,6,2,292140,292140,292142,0,2,4
83426,4,2,292144,292144,292146,0,2,2
83427,6,1,292150,292150,292151,0,1,4
83428,6,1,292156,292156,292157,0,1,5
83429,4,1,292160,292160,292161,0,1,3
83430,1,1,292161,292161,292162,0,1,0
83431,5,3,292166,292166,292169,0,3,4
83432,4,3,292170,292170,292173,0,3,1
83433,3,3,292173,292173,292176,0,3,0
83434,5,2,292178,292178,292180,0,2,2
83435,6,1,292184,292184,292185,0,1,4
83436,5,2,292189,292189,292191,0,2,4
83437,3,2,292192,292192,292194,0,2,1
83438,5,1,292197,292197,292198,0,1,3
83439,1,3,292198,292198,292201,0,3,0
83440,6,3,292204,292204,292207,0,3,3
83441,5,1,292209,292209,292210,0,1,2
83442,1,1,292210,292210,292211,0,1,0
83443,5,1,292215,292215,292216,0,1,4
83444,3,2,292218,292218,292220,0,2,2
83445,1,1,292219,292220,292221,1,2,0
83446,2,2,292221,292221,292223,0,2,0
83447,1,3,292222,292223,292226,1,4,0
83448,5,2,292227,292227,292229,0,2,1
83449,5,2,292232,292232,292234,0,2,3
83450,2,2,292234,292234,292236,0,2,0
83451,2,1,292236,292236,292237,0,1,0
83452,3,2,292239,292239,292241,0,2,2
83453,4,2,292243,292243,292245,0,2,2
83454,2,2,292245,292245,292247,0,2,0
83455,6,2,292251,292251,292253,0,2,4
83456,5,1,292256,292256,292257,0,1,3
83457,1,2,292257,292257,292259,0,2,0
83458,5,1,292262,292262,292263,0,1,3
83459,4,3,292266,292266,292269,0,3,3
83460,6,2,292272,292272,292274,0,2,3
83461,5,1,292277,292277,292278,0,1,3
83462,4,1,292281,292281,292282,0,1,3
83463,6,2,292287,292287,292289,0,2,5
83464,5,1,292292,292292,292293,0,1,3
83465,5,3,292297,292297,292300,0,3,4
83466,2,2,292299,292300,292302,1,3,0
83467,6,2,292305,292305,292307,0,2,3
83468,2,3,292307,292307,292310,0,3,0
83469,6,1,292313,292313,292314,0,1,3
83470,3,3,292316,292316,292319,0,3,2
83471,5,1,292321,292321,292322,0,1,2
83472,5,3,292326,292326,292329,0,3,4
83473,5,3,292331,292331,292334,0,3,2
83474,2,1,292333,292334,292335,1,2,0
83475,4,2,292337,292337,292339,0,2,2
83476,2,1,292339,292339,292340,0,1,0
83477,2,3,292341,292341,292344,0,3,1
83478,5,1,292346,292346,292347,0,1,2
83479,4,3,292350,292350,292353,0,3,3
83480,4,1,292354,292354,292355,0,1,1
83481,5,2,292359,292359,292361,0,2,4
83482,5,3,292364,292364,292367,0,3,3
83483,5,3,292369,292369,292372,0,3,2
83484,1,1,292370,292372,292373,2,3,0
83485,6,2,292376,292376,292378,0,2,3
83486,2,2,292378,292378,292380,0,2,0
83487,5,1,292383,292383,292384,0,1,3
83488,2,1,292385,292385,292386,0,1,1
83489,3,2,292388,292388,292390,0,2,2
83490,5,1,292393,292393,292394,0,1,3
83491,3,3,292396,292396,292399,0,3,2
83492,4,2,292400,292400,292402,0,2,1
83493,3,2,292403,292403,292405,0,2,1
83494,3,1,292406,292406,292407,0,1,1
83495,1,2,292407,292407,292409,0,2,0
83496,2,2,292409,292409,292411,0,2,0
83497,5,2,292414,292414,292416,0,2,3
83498,4,2,292418,292418,292420,0,2,2
83499,5,2,292423,292423,292425,0,2,3
83500,6,1,292429,292429,292430,0,1,4
83501,4,2,292433,292433,292435,0,2,3
83502,1,1,292434,292435,292436,1,2,0
83503,5,2,292439,292439,292441,0,2,3
83504,2,1,292441,292441,292442,0,1,0
83505,6,2,292447,292447,292449,0,2,5
83506,4,1,292451,292451,292452,0,1,2
83507,1,3,292452,292452,292455,0,3,0
83508,6,3,292458,292458,292461,0,3,3
83509,1,3,292459,292461,292464,2,5,0
83510,2,3,292461,292464,292467,3,6,0
83511,1,3,292462,292467,292470,5,8,0
83512,2,2,292464,292470,292472,6,8,0
83513,6,3,292470,292472,292475,2,5,0
83514,1,1,292471,292475,292476,4,5,0
83515,6,1,292477,292477,292478,0,1,1
83516,2,3,292479,292479,292482,0,3,1
83517,6,2,292485,292485,292487,0,2,3
83518,2,1,292487,292487,292488,0,1,0
83519,4,2,292491,292491,292493,0,2,3
83520,2,3,292493,292493,292496,0,3,0
83521,2,1,292495,292496,292497,1,2,0
83522,6,2,292501,292501,292503,0,2,4
83523,5,1,292506,292506,292507,0,1,3
83524,6,2,292512,292512,292514,0,2,5
83525,2,2,292514,292514,292516,0,2,0
83526,1,2,292515,292516,292518,1,3,0
83527,3,2,292518,292518,292520,0,2,0
83528,3,3,292521,292521,292524,0,3,1
83529,5,2,292526,292526,292528,0,2,2
83530,3,2,292529,292529,292531,0,2,1
83531,1,1,292530,292531,292532,1,2,0
83532,6,3,292536,292536,292539,0,3,4
83533,6,3,292542,292542,292545,0,3,3
83534,1,1,292543,292545,292546,2,3,0
83535,5,2,292548,292548,292550,0,2,2
83536,3,3,292551,292551,292554,0,3,1
83537,2,1,292553,292554,292555,1,2,0
83538,1,1,292554,292555,292556,1,2,0
83539,1,3,292555,292556,292559,1,4,0
83540,5,3,292560,292560,292563,0,3,1
83541,4,3,292564,292564,292567,0,3,1
83542,5,2,292569,292569,292571,0,2,2
83543,6,3,292575,292575,292578,0,3,4
83544,6,3,292581,292581,292584,0,3,3
83545,6,2,292587,292587,292589,0,2,3
83546,3,2,292590,292590,292592,0,2,1
83547,4,2,292594,292594,292596,0,2,2
83548,2,2,292596,292596,292598,0,2,0
83549,6,3,292602,292602,292605,0,3,4
83550,5,2,292607,292607,292609,0,2,2
83551,2,3,292609,292609,292612,0,3,0
83552,3,2,292612,292612,292614,0,2,0
83553,5,3,292617,292617,292620,0,3,3
83554,6,3,292623,292623,292626,0,3,3
83555,4,3,292627,292627,292630,0,3,1
83556,2,3,292629,292630,292633,1,4,0
83557,3,3,292632,292633,292636,1,4,0
83558,3,3,292635,292636,292639,1,4,0
83559,1,2,292636,292639,292641,3,5,0
83560,4,1,292640,292641,292642,1,2,0
83561,4,3,292644,292644,292647,0,3,2
83562,4,3,292648,292648,292651,0,3,1
83563,3,1,292651,292651,292652,0,1,0
83564,3,2,292654,292654,292656,0,2,2
83565,5,2,292659,292659,292661,0,2,3
83566,4,1,292663,292663,292664,0,1,2
83567,2,1,292665,292665,292666,0,1,1
83568,6,2,292671,292671,292673,0,2,5
83569,2,1,292673,292673,292674,0,1,0
83570,5,2,292678,292678,292680,0,2,4
83571,2,2,292680,292680,292682,0,2,0
83572,4,1,292684,292684,292685,0,1,2
83573,6,3,292690,292690,292693,0,3,5
83574,4,3,292694,292694,292697,0,3,1
83575,3,1,292697,292697,292698,0,1,0
83576,4,3,292701,292701,292704,0,3,3
83577,2,2,292703,292704,292706,1,3,0
83578,1,1,292704,292706,292707,2,3,0
83579,6,1,292710,292710,292711,0,1,3
83580,4,2,292714,292714,292716,0,2,3
83581,3,3,292717,292717,292720,0,3,1
83582,3,3,292720,292720,292723,0,3,0
83583,6,1,292726,292726,292727,0,1,3
83584,2,3,292728,292728,292731,0,3,1
83585,5,1,292733,292733,292734,0,1,2
83586,1,3,292734,292734,292737,0,3,0
83587,2,1,292736,292737,292738,1,2,0
83588,2,2,292738,292738,292740,0,2,0
83589,1,1,292739,292740,292741,1,2,0
83590,5,3,292744,292744,292747,0,3,3
83591,5,3,292749,292749,292752,0,3,2
83592,1,3,292750,292752,292755,2,5,0
83593,1,1,292751,292755,292756,4,5,0
83594,2,2,292753,292756,292758,3,5,0
83595,4,2,292757,292758,292760,1,3,0
83596,4,3,292761,292761,292764,0,3,1
83597,3,2,292764,292764,292766,0,2,0
83598,6,1,292770,292770,292771,0,1,4
83599,5,2,292775,292775,292777,0,2,4
83600,2,2,292777,292777,292779,0,2,0
83601,2,2,292779,292779,292781,0,2,0
83602,2,1,292781,292781,292782,0,1,0
83603,2,1,292783,292783,292784,0,1,1
83604,3,3,292786,292786,292789,0,3,2
83605,3,2,292789,292789,292791,0,2,0
83606,3,1,292792,292792,292793,0,1,1
83607,2,3,292794,292794,292797,0,3,1
83608,3,2,292797,292797,292799,0,2,0
83609,5,2,292802,292802,292804,0,2,3
83610,2,1,292804,292804,292805,0,1,0
83611,1,2,292805,292805,292807,0,2,0
83612,5,3,292810,292810,292813,0,3,3
83613,3,2,292813,292813,292815,0,2,0
83614,1,2,292814,292815,292817,1,3,0
83615,2,3,292816,292817,292820,1,4,0
83616,3,1,292819,292820,292821,1,2,0
83617,4,1,292823,292823,292824,0,1,2
83618,4,2,292827,292827,292829,0,2,3
83619,3,3,292830,292830,292833,0,3,1
83620,1,2,292831,292833,292835,2,4,0
83621,1,1,292832,292835,292836,3,4,0
83622,6,1,292838,292838,292839,0,1,2
83623,3,1,292841,292841,292842,0,1,2
83624,6,2,292847,292847,292849,0,2,5
83625,1,1,292848,292849,292850,1,2,0
83626,1,2,292849,292850,292852,1,3,0
83627,4,1,292853,292853,292854,0,1,1
83628,4,3,292857,292857,292860,0,3,3
83629,3,2,292860,292860,292862,0,2,0
83630,5,2,292865,292865,292867,0,2,3
83631,1,3,292866,292867,292870,1,4,0
83632,6,2,292872,292872,292874,0,2,2
83633,5,2,292877,292877,292879,0,2,3
83634,2,3,292879,292879,292882,0,3,0
83635,4,3,292883,292883,292886,0,3,1
83636,6,1,292889,292889,292890,0,1,3
83637,3,3,292892,292892,292895,0,3,2
83638,2,1,292894,292895,292896,1,2,0
83639,6,1,292900,292900,292901,0,1,4
83640,5,2,292905,292905,292907,0,2,4
83641,3,1,292908,292908,292909,0,1,1
83642,5,3,292913,292913,292916,0,3,4
83643,5,2,292918,292918,292920,0,2,2
83644,4,2,292922,292922,292924,0,2,2
83645,1,2,292923,292924,292926,1,3,0
83646,5,3,292928,292928,292931,0,3,2
83647,3,1,292931,292931,292932,0,1,0
83648,6,2,292937,292937,292939,0,2,5
83649,5,2,292942,292942,292944,0,2,3
83650,4,3,292946,292946,292949,0,3,2
83651,1,1,292947,292949,292950,2,3,0
83652,5,3,292952,292952,292955,0,3,2
83653,3,3,292955,292955,292958,0,3,0
83654,1,1,292956,292958,292959,2,3,0
83655,5,2,292961,292961,292963,0,2,2
83656,5,2,292966,292966,292968,0,2,3
83657,3,3,292969,292969,292972,0,3,1
83658,5,1,292974,292974,292975,0,1,2
83659,2,2,292976,292976,292978,0,2,1
83660,6,1,292982,292982,292983,0,1,4
83661,2,3,292984,292984,292987,0,3,1
83662,2,2,292986,292987,292989,1,3,0
83663,5,2,292991,292991,292993,0,2,2
83664,1,2,292992,292993,292995,1,3,0
83665,6,1,292998,292998,292999,0,1,3
83666,3,2,293001,293001,293003,0,2,2
83667,3,2,293004,293004,293006,0,2,1
83668,3,2,293007,293007,293009,0,2,1
83669,6,1,293013,293013,293014,0,1,4
83670,3,3,293016,293016,293019,0,3,2
83671,5,2,293021,293021,293023,0,2,2
83672,5,3,293026,293026,293029,0,3,3
83673,4,3,293030,293030,293033,0,3,1
83674,3,3,293033,293033,293036,0,3,0
83675,1,3,293034,293036,293039,2,5,0
83676,3,3,293037,293039,293042,2,5,0
83677,2,1,293039,293042,293043,3,4,0
83678,3,2,293042,293043,293045,1,3,0
83679,6,2,293048,293048,293050,0,2,3
83680,6,1,293054,293054,293055,0,1,4
83681,1,3,293055,293055,293058,0,3,0
83682,2,1,293057,293058,293059,1,2,0
83683,5,3,293062,293062,293065,0,3,3
83684,2,1,293064,293065,293066,1,2,0
83685,5,2,293069,293069,293071,0,2,3
83686,5,2,293074,293074,293076,0,2,3
83687,2,3,293076,293076,293079,0,3,0
83688,5,1,293081,293081,293082,0,1,2
83689,6,3,293087,293087,293090,0,3,5
83690,4,3,293091,293091,293094,0,3,1
83691,3,1,293094,293094,293095,0,1,0
83692,6,2,293100,293100,293102,0,2,5
83693,2,3,293102,293102,293105,0,3,0
83694,1,2,293103,293105,293107,2,4,0
83695,5,3,293108,293108,293111,0,3,1
83696,4,3,293112,293112,293115,0,3,1
83697,2,2,293114,293115,293117,1,3,0
83698,5,3,293119,293119,293122,0,3,2
83699,6,2,293125,293125,293127,0,2,3
83700,5,3,293130,293130,293133,0,3,3
83701,1,3,293131,293133,293136,2,5,0
83702,3,2,293134,293136,293138,2,4,0
83703,3,3,293137,293138,293141,1,4,0
83704,5,3,293142,293142,293145,0,3,1
83705,6,3,293148,293148,293151,0,3,3
83706,5,3,293153,293153,293156,0,3,2
83707,3,2,293156,293156,293158,0,2,0
83708,6,1,293162,293162,293163,0,1,4
83709,2,1,293164,293164,293165,0,1,1
83710,4,3,293168,293168,293171,0,3,3
83711,1,1,293169,293171,293172,2,3,0
83712,5,2,293174,293174,293176,0,2,2
83713,5,2,293179,293179,293181,0,2,3
83714,2,1,293181,293181,293182,0,1,0
83715,4,2,293185,293185,293187,0,2,3
83716,2,2,293187,293187,293189,0,2,0
83717,6,1,293193,293193,293194,0,1,4
83718,3,3,293196,293196,293199,0,3,2
83719,2,1,293198,293199,293200,1,2,0
83720,5,2,293203,293203,293205,0,2,3
83721,2,2,293205,293205,293207,0,2,0
83722,1,3,293206,293207,293210,1,4,0
83723,5,2,293211,293211,293213,0,2,1
83724,4,3,293215,293215,293218,0,3,2
83725,1,1,293216,293218,293219,2,3,0
83726,2,1,293218,293219,293220,1,2,0
83727,2,3,293220,293220,293223,0,3,0
83728,5,1,293225,293225,293226,0,1,2
83729,2,2,293227,293227,293229,0,2,1
83730,5,3,293232,293232,293235,0,3,3
83731,4,1,293236,293236,293237,0,1,1
83732,4,3,293240,293240,293243,0,3,3
83733,3,3,293243,293243,293246,0,3,0
83734,5,2,293248,293248,293250,0,2,2
83735,3,1,293251,293251,293252,0,1,1
83736,4,1,293255,293255,293256,0,1,3
83737,6,2,293261,293261,293263,0,2,5
83738,4,3,293265,293265,293268,0,3,2
83739,1,1,293266,293268,293269,2,3,0
83740,5,1,293271,293271,293272,0,1,2
83741,2,1,293273,293273,293274,0,1,1
83742,1,1,293274,293274,293275,0,1,0
83743,5,1,293279,293279,293280,0,1,4
83744,1,3,293280,293280,293283,0,3,0
83745,1,3,293281,293283,293286,2,5,0
83746,4,2,293285,293286,293288,1,3,0
83747,6,2,293291,293291,293293,0,2,3
83748,2,1,293293,293293,293294,0,1,0
83749,4,3,293297,293297,293300,0,3,3
83750,1,1,293298,293300,293301,2,3,0
83751,4,2,293302,293302,293304,0,2,1
83752,1,2,293303,293304,293306,1,3,0
83753,3,3,293306,293306,293309,0,3,0
83754,2,2,293308,293309,293311,1,3,0
83755,2,1,293310,293311,293312,1,2,0
83756,3,2,293313,293313,293315,0,2,1
83757,5,3,293318,293318,293321,0,3,3
83758,1,2,293319,293321,293323,2,4,0
83759,6,1,293325,293325,293326,0,1,2
83760,4,2,293329,293329,293331,0,2,3
83761,5,3,293334,293334,293337,0,3,3
83762,3,1,293337,293337,293338,0,1,0
83763,2,1,293339,293339,293340,0,1,1
83764,5,3,293344,293344,293347,0,3,4
83765,4,2,293348,293348,293350,0,2,1
83766,6,2,293354,293354,293356,0,2,4
83767,3,2,293357,293357,293359,0,2,1
83768,2,3,293359,293359,293362,0,3,0
83769,4,3,293363,293363,293366,0,3,1
83770,5,2,293368,293368,293370,0,2,2
83771,2,2,293370,293370,293372,0,2,0
83772,3,2,293373,293373,293375,0,2,1
83773,5,2,293378,293378,293380,0,2,3
83774,5,1,293383,293383,293384,0,1,3
83775,6,3,293389,293389,293392,0,3,5
83776,3,1,293392,293392,293393,0,1,0
83777,4,1,293396,293396,293397,0,1,3
83778,4,1,293400,293400,293401,0,1,3
83779,1,1,293401,293401,293402,0,1,0
83780,2,1,293403,293403,293404,0,1,1
83781,1,2,293404,293404,293406,0,2,0
83782,2,2,293406,293406,293408,0,2,0
83783,5,3,293411,293411,293414,0,3,3
83784,1,3,293412,293414,293417,2,5,0
83785,6,2,293418,293418,293420,0,2,1
83786,6,1,293424,293424,293425,0,1,4
83787,5,2,293429,293429,293431,0,2,4
83788,4,3,293433,293433,293436,0,3,2
83789,2,1,293435,293436,293437,1,2,0
83790,4,3,293439,293439,293442,0,3,2
83791,3,3,293442,293442,293445,0,3,0
83792,1,3,293443,293445,293448,2,5,0
83793,5,3,293448,293448,293451,0,3,0
83794,6,3,293454,293454,293457,0,3,3
83795,2,3,293456,293457,293460,1,4,0
83796,6,2,293462,293462,293464,0,2,2
83797,5,1,293467,293467,293468,0,1,3
83798,4,2,293471,293471,293473,0,2,3
83799,4,3,293475,293475,293478,0,3,2
83800,3,2,293478,293478,293480,0,2,0
83801,5,3,293483,293483,293486,0,3,3
83802,4,2,293487,293487,293489,0,2,1
83803,3,2,293490,293490,293492,0,2,1
83804,5,1,293495,293495,293496,0,1,3
83805,6,1,293501,293501,293502,0,1,5
83806,4,2,293505,293505,293507,0,2,3
83807,3,3,293508,293508,293511,0,3,1
83808,3,1,293511,293511,293512,0,1,0
83809,4,1,293515,293515,293516,0,1,3
83810,5,2,293520,293520,293522,0,2,4
83811,1,1,293521,293522,293523,1,2,0
83812,5,2,293526,293526,293528,0,2,3
83813,1,1,293527,293528,293529,1,2,0
83814,2,2,293529,293529,293531,0,2,0
83815,3,3,293532,293532,293535,0,3,1
83816,1,1,293533,293535,293536,2,3,0
83817,1,1,293534,293536,293537,2,3,0
83818,5,2,293539,293539,293541,0,2,2
83819,3,1,293542,293542,293543,0,1,1
83820,6,3,293548,293548,293551,0,3,5
83821,1,1,293549,293551,293552,2,3,0
83822,3,1,293552,293552,293553,0,1,0
83823,6,2,293558,293558,293560,0,2,5
83824,5,3,293563,293563,293566,0,3,3
83825,3,2,293566,293566,293568,0,2,0
83826,1,2,293567,293568,293570,1,3,0
83827,6,3,293573,293573,293576,0,3,3
83828,2,3,293575,293576,293579,1,4,0
83829,1,3,293576,293579,293582,3,6,0
83830,3,3,293579,293582,293585,3,6,0
83831,6,3,293585,293585,293588,0,3,0
83832,1,2,293586,293588,293590,2,4,0
83833,2,3,293588,293590,293593,2,5,0
83834,2,2,293590,293593,293595,3,5,0
83835,2,2,293592,293595,293597,3,5,0
83836,3,3,293595,293597,293600,2,5,0
83837,5,3,293600,293600,293603,0,3,0
83838,3,3,293603,293603,293606,0,3,0
83839,6,2,293609,293609,293611,0,2,3
83840,2,2,293611,293611,293613,0,2,0
83841,6,3,293617,293617,293620,0,3,4
83842,5,2,293622,293622,293624,0,2,2
83843,2,3,293624,293624,293627,0,3,0
83844,2,3,293626,293627,293630,1,4,0
83845,6,1,293632,293632,293633,0,1,2
83846,3,2,293635,293635,293637,0,2,2
83847,3,3,293638,293638,293641,0,3,1
83848,5,1,293643,293643,293644,0,1,2
83849,2,3,293645,293645,293648,0,3,1
83850,4,2,293649,293649,293651,0,2,1
83851,4,1,293653,293653,293654,0,1,2
83852,4,2,293657,293657,293659,0,2,3
83853,5,3,293662,293662,293665,0,3,3
83854,5,1,293667,293667,293668,0,1,2
83855,5,3,293672,293672,293675,0,3,4
83856,4,3,293676,293676,293679,0,3,1
83857,3,3,293679,293679,293682,0,3,0
83858,1,2,293680,293682,293684,2,4,0
83859,6,3,293686,293686,293689,0,3,2
83860,1,1,293687,293689,293690,2,3,0
83861,2,1,293689,293690,293691,1,2,0
83862,5,3,293694,293694,293697,0,3,3
83863,4,3,293698,293698,293701,0,3,1
83864,6,1,293704,293704,293705,0,1,3
83865,6,3,293710,293710,293713,0,3,5
83866,2,2,293712,293713,293715,1,3,0
83867,6,3,293718,293718,293721,0,3,3
83868,2,1,293720,293721,293722,1,2,0
83869,1,3,293721,293722,293725,1,4,0
83870,4,2,293725,293725,293727,0,2,0
83871,4,3,293729,293729,293732,0,3,2
83872,5,2,293734,293734,293736,0,2,2
83873,2,2,293736,293736,293738,0,2,0
83874,4,2,293740,293740,293742,0,2,2
83875,2,2,293742,293742,293744,0,2,0
83876,5,3,293747,293747,293750,0,3,3
83877,1,2,293748,293750,293752,2,4,0
83878,2,2,293750,293752,293754,2,4,0
83879,2,3,293752,293754,293757,2,5,0
83880,2,3,293754,293757,293760,3,6,0
83881,3,2,293757,293760,293762,3,5,0
83882,2,1,293759,293762,293763,3,4,0
83883,3,3,293762,293763,293766,1,4,0
83884,6,2,293768,293768,293770,0,2,2
83885,2,3,293770,293770,293773,0,3,0
83886,6,3,293776,293776,293779,0,3,3
83887,3,1,293779,293779,293780,0,1,0
83888,2,3,293781,293781,293784,0,3,1
83889,3,1,293784,293784,293785,0,1,0
83890,1,2,293785,293785,293787,0,2,0
83891,5,3,293790,293790,293793,0,3,3
83892,4,3,293794,293794,293797,0,3,1
83893,6,1,293800,293800,293801,0,1,3
83894,5,3,293805,293805,293808,0,3,4
83895,5,1,293810,293810,293811,0,1,2
83896,5,2,293815,293815,293817,0,2,4
83897,3,3,293818,293818,293821,0,3,1
83898,2,2,293820,293821,293823,1,3,0
83899,2,3,293822,293823,293826,1,4,0
83900,5,1,293827,293827,293828,0,1,1
83901,3,1,293830,293830,293831,0,1,2
83902,1,3,293831,293831,293834,0,3,0
83903,2,2,293833,293834,293836,1,3,0
83904,2,1,293835,293836,293837,1,2,0
83905,4,1,293839,293839,293840,0,1,2
83906,3,3,293842,293842,293845,0,3,2
83907,1,2,293843,293845,293847,2,4,0
83908,5,2,293848,293848,293850,0,2,1
83909,3,1,293851,293851,293852,0,1,1
83910,1,2,293852,293852,293854,0,2,0
83911,1,1,293853,293854,293855,1,2,0
83912,5,1,293858,293858,293859,0,1,3
83913,4,3,293862,293862,293865,0,3,3
83914,3,3,293865,293865,293868,0,3,0
83915,6,1,293871,293871,293872,0,1,3
83916,6,2,293877,293877,293879,0,2,5
83917,2,2,293879,293879,293881,0,2,0
83918,1,3,293880,293881,293884,1,4,0
83919,2,1,293882,293884,293885,2,3,0
83920,4,3,293886,293886,293889,0,3,1
83921,6,3,293892,293892,293895,0,3,3
83922,6,1,293898,293898,293899,0,1,3
83923,2,3,293900,293900,293903,0,3,1
83924,1,1,293901,293903,293904,2,3,0
83925,6,1,293907,293907,293908,0,1,3
83926,3,1,293910,293910,293911,0,1,2
83927,2,2,293912,293912,293914,0,2,1
83928,2,1,293914,293914,293915,0,1,0
83929,5,1,293919,293919,293920,0,1,4
83930,2,3,293921,293921,293924,0,3,1
83931,1,3,293922,293924,293927,2,5,0
83932,2,3,293924,293927,293930,3,6,0
83933,2,2,293926,293930,293932,4,6,0
83934,4,3,293930,293932,293935,2,5,0
83935,3,3,293933,293935,293938,2,5,0
83936,4,3,293937,293938,293941,1,4,0
83937,4,1,293941,293941,293942,0,1,0
83938,2,2,293943,293943,293945,0,2,1
83939,5,2,293948,293948,293950,0,2,3
83940,6,1,293954,293954,293955,0,1,4
83941,6,2,293960,293960,293962,0,2,5
83942,1,3,293961,293962,293965,1,4,0
83943,6,1,293967,293967,293968,0,1,2
83944,2,3,293969,293969,293972,0,3,1
83945,5,1,293974,293974,293975,0,1,2
83946,3,3,293977,293977,293980,0,3,2
83947,6,1,293983,293983,293984,0,1,3
83948,2,1,293985,293985,293986,0,1,1
83949,1,3,293986,293986,293989,0,3,0
83950,3,3,293989,293989,293992,0,3,0
83951,6,1,293995,293995,293996,0,1,3
83952,1,2,293996,293996,293998,0,2,0
83953,6,1,294002,294002,294003,0,1,4
83954,1,1,294003,294003,294004,0,1,0
83955,1,3,294004,294004,294007,0,3,0
83956,5,1,294009,294009,294010,0,1,2
83957,2,3,294011,294011,294014,0,3,1
83958,5,3,294016,294016,294019,0,3,2
83959,6,1,294022,294022,294023,0,1,3
83960,3,2,294025,294025,294027,0,2,2
83961,1,3,294026,294027,294030,1,4,0
83962,4,3,294030,294030,294033,0,3,0
83963,6,2,294036,294036,294038,0,2,3
83964,1,2,294037,294038,294040,1,3,0
83965,3,2,294040,294040,294042,0,2,0
83966,2,1,294042,294042,294043,0,1,0
83967,1,2,294043,294043,294045,0,2,0
83968,2,1,294045,294045,294046,0,1,0
83969,2,3,294047,294047,294050,0,3,1
83970,6,3,294053,294053,294056,0,3,3
83971,2,1,294055,294056,294057,1,2,0
83972,5,2,294060,294060,294062,0,2,3
83973,5,3,294065,294065,294068,0,3,3
83974,5,1,294070,294070,294071,0,1,2
83975,1,3,294071,294071,294074,0,3,0
83976,1,3,294072,294074,294077,2,5,0
83977,5,1,294077,294077,294078,0,1,0
83978,6,2,294083,294083,294085,0,2,5
83979,4,2,294087,294087,294089,0,2,2
83980,2,2,294089,294089,294091,0,2,0
83981,2,1,294091,294091,294092,0,1,0
83982,6,1,294097,294097,294098,0,1,5
83983,6,2,294103,294103,294105,0,2,5
83984,1,2,294104,294105,294107,1,3,0
83985,1,2,294105,294107,294109,2,4,0
83986,3,3,294108,294109,294112,1,4,0
83987,6,3,294114,294114,294117,0,3,2
83988,1,2,294115,294117,294119,2,4,0
83989,2,2,294117,294119,294121,2,4,0
83990,5,3,294122,294122,294125,0,3,1
83991,6,1,294128,294128,294129,0,1,3
83992,3,3,294131,294131,294134,0,3,2
83993,4,1,294135,294135,294136,0,1,1
83994,6,1,294141,294141,294142,0,1,5
83995,3,3,294144,294144,294147,0,3,2
83996,4,3,294148,294148,294151,0,3,1
83997,6,2,294154,294154,294156,0,2,3
83998,2,3,294156,294156,294159,0,3,0
83999,3,1,294159,294159,294160,0,1,0
84000,2,3,294161,294161,294164,0,3,1
84001,5,2,294166,294166,294168,0,2,2
84002,1,2,294167,294168,294170,1,3,0
84003,3,3,294170,294170,294173,0,3,0
84004,5,3,294175,294175,294178,0,3,2
84005,3,1,294178,294178,294179,0,1,0
84006,4,2,294182,294182,294184,0,2,3
84007,1,1,294183,294184,294185,1,2,0
84008,6,1,294189,294189,294190,0,1,4
84009,1,1,294190,294190,294191,0,1,0
84010,2,1,294192,294192,294193,0,1,1
84011,1,2,294193,294193,294195,0,2,0
84012,5,3,294198,294198,294201,0,3,3
84013,2,1,294200,294201,294202,1,2,0
84014,3,2,294203,294203,294205,0,2,1
84015,3,2,294206,294206,294208,0,2,1
84016,3,2,294209,294209,294211,0,2,1
84017,4,3,294213,294213,294216,0,3,2
84018,4,1,294217,294217,294218,0,1,1
84019,2,2,294219,294219,294221,0,2,1
84020,3,3,294222,294222,294225,0,3,1
84021,1,3,294223,294225,294228,2,5,0
84022,2,2,294225,294228,294230,3,5,0
84023,4,1,294229,294230,294231,1,2,0
84024,1,2,294230,294231,294233,1,3,0
84025,5,2,294235,294235,294237,0,2,2
84026,6,3,294241,294241,294244,0,3,4
84027,6,1,294247,294247,294248,0,1,3
84028,5,2,294252,294252,294254,0,2,4
84029,5,1,294257,294257,294258,0,1,3
84030,6,2,294263,294263,294265,0,2,5
84031,5,1,294268,294268,294269,0,1,3
84032,6,2,294274,294274,294276,0,2,5
84033,4,1,294278,294278,294279,0,1,2
84034,4,2,294282,294282,294284,0,2,3
84035,1,2,294283,294284,294286,1,3,0
84036,6,2,294289,294289,294291,0,2,3
84037,5,2,294294,294294,294296,0,2,3
84038,2,3,294296,294296,294299,0,3,0
84039,1,3,294297,294299,294302,2,5,0
84040,6,1,294303,294303,294304,0,1,1
84041,6,3,294309,294309,294312,0,3,5
84042,6,1,294315,294315,294316,0,1,3
84043,1,3,294316,294316,294319,0,3,0
84044,6,3,294322,294322,294325,0,3,3
84045,3,2,294325,294325,294327,0,2,0
84046,3,2,294328,294328,294330,0,2,1
84047,2,3,294330,294330,294333,0,3,0
84048,2,3,294332,294333,294336,1,4,0
84049,6,2,294338,294338,294340,0,2,2
84050,3,2,294341,294341,294343,0,2,1
84051,1,2,294342,294343,294345,1,3,0
84052,1,2,294343,294345,294347,2,4,0
84053,4,2,294347,294347,294349,0,2,0
84054,6,3,294353,294353,294356,0,3,4
84055,1,2,294354,294356,294358,2,4,0
84056,2,2,294356,294358,294360,2,4,0
84057,4,3,294360,294360,294363,0,3,0
84058,4,3,294364,294364,294367,0,3,1
84059,6,1,294370,294370,294371,0,1,3
84060,4,1,294374,294374,294375,0,1,3
84061,2,2,294376,294376,294378,0,2,1
84062,6,3,294382,294382,294385,0,3,4
84063,4,1,294386,294386,294387,0,1,1
84064,1,1,294387,294387,294388,0,1,0
84065,3,1,294390,294390,294391,0,1,2
84066,4,3,294394,294394,294397,0,3,3
84067,5,2,294399,294399,294401,0,2,2
84068,6,2,294405,294405,294407,0,2,4
84069,5,3,294410,294410,294413,0,3,3
84070,3,3,294413,294413,294416,0,3,0
84071,6,1,294419,294419,294420,0,1,3
84072,6,2,294425,294425,294427,0,2,5
84073,6,1,294431,294431,294432,0,1,4
84074,1,3,294432,294432,294435,0,3,0
84075,6,2,294438,294438,294440,0,2,3
84076,1,2,294439,294440,294442,1,3,0
84077,4,1,294443,294443,294444,0,1,1
84078,6,1,294449,294449,294450,0,1,5
84079,3,2,294452,294452,294454,0,2,2
84080,5,3,294457,294457,294460,0,3,3
84081,4,2,294461,294461,294463,0,2,1
84082,5,1,294466,294466,294467,0,1,3
84083,4,3,294470,294470,294473,0,3,3
84084,3,1,294473,294473,294474,0,1,0
84085,1,1,294474,294474,294475,0,1,0
84086,2,2,294476,294476,294478,0,2,1
84087,4,1,294480,294480,294481,0,1,2
84088,5,1,294485,294485,294486,0,1,4
84089,5,3,294490,294490,294493,0,3,4
84090,3,1,294493,294493,294494,0,1,0
84091,2,2,294495,294495,294497,0,2,1
84092,5,3,294500,294500,294503,0,3,3
84093,5,3,294505,294505,294508,0,3,2
84094,2,1,294507,294508,294509,1,2,0
84095,4,1,294511,294511,294512,0,1,2
84096,4,2,294515,294515,294517,0,2,3
84097,5,1,294520,294520,294521,0,1,3
84098,6,2,294526,294526,294528,0,2,5
84099,5,2,294531,294531,294533,0,2,3
84100,2,1,294533,294533,294534,0,1,0
84101,2,2,294535,294535,294537,0,2,1
84102,3,2,294538,294538,294540,0,2,1
84103,6,3,294544,294544,294547,0,3,4
84104,1,1,294545,294547,294548,2,3,0
84105,4,3,294549,294549,294552,0,3,1
84106,6,3,294555,294555,294558,0,3,3
84107,4,1,294559,294559,294560,0,1,1
84108,5,3,294564,294564,294567,0,3,4
84109,4,2,294568,294568,294570,0,2,1
84110,3,1,294571,294571,294572,0,1,1
84111,4,3,294575,294575,294578,0,3,3
84112,4,2,294579,294579,294581,0,2,1
84113,2,3,294581,294581,294584,0,3,0
84114,2,1,294583,294584,294585,1,2,0
84115,1,3,294584,294585,294588,1,4,0
84116,6,1,294590,294590,294591,0,1,2
84117,4,1,294594,294594,294595,0,1,3
84118,4,2,294598,294598,294600,0,2,3
84119,1,2,294599,294600,294602,1,3,0
84120,6,1,294605,294605,294606,0,1,3
84121,6,2,294611,294611,294613,0,2,5
84122,6,1,294617,294617,294618,0,1,4
84123,3,2,294620,294620,294622,0,2,2
84124,1,3,294621,294622,294625,1,4,0
84125,5,3,294626,294626,294629,0,3,1
84126,6,2,294632,294632,294634,0,2,3
84127,4,2,294636,294636,294638,0,2,2
84128,5,3,294641,294641,294644,0,3,3
84129,6,1,294647,294647,294648,0,1,3
84130,6,2,294653,294653,294655,0,2,5
84131,2,1,294655,294655,294656,0,1,0
84132,4,3,294659,294659,294662,0,3,3
84133,5,1,294664,294664,294665,0,1,2
84134,3,2,294667,294667,294669,0,2,2
84135,2,1,294669,294669,294670,0,1,0
84136,3,1,294672,294672,294673,0,1,2
84137,4,1,294676,294676,294677,0,1,3
84138,3,1,294679,294679,294680,0,1,2
84139,5,3,294684,294684,294687,0,3,4
84140,4,2,294688,294688,294690,0,2,1
84141,2,1,294690,294690,294691,0,1,0
84142,5,3,294695,294695,294698,0,3,4
84143,5,3,294700,294700,294703,0,3,2
84144,3,3,294703,294703,294706,0,3,0
84145,3,2,294706,294706,294708,0,2,0
84146,3,1,294709,294709,294710,0,1,1
84147,3,1,294712,294712,294713,0,1,2
84148,3,3,294715,294715,294718,0,3,2
84149,3,1,294718,294718,294719,0,1,0
84150,1,1,294719,294719,294720,0,1,0
84151,3,3,294722,294722,294725,0,3,2
84152,1,3,294723,294725,294728,2,5,0
84153,3,1,294726,294728,294729,2,3,0
84154,3,3,294729,294729,294732,0,3,0
84155,1,1,294730,294732,294733,2,3,0
84156,2,3,294732,294733,294736,1,4,0
84157,6,3,294738,294738,294741,0,3,2
84158,6,2,294744,294744,294746,0,2,3
84159,6,2,294750,294750,294752,0,2,4
84160,4,3,294754,294754,294757,0,3,2
84161,6,3,294760,294760,294763,0,3,3
84162,5,3,294765,294765,294768,0,3,2
84163,4,3,294769,294769,294772,0,3,1
84164,4,1,294773,294773,294774,0,1,1
84165,4,3,294777,294777,294780,0,3,3
84166,2,1,294779,294780,294781,1,2,0
84167,3,3,294782,294782,294785,0,3,1
84168,1,1,294783,294785,294786,2,3,0
84169,2,2,294785,294786,294788,1,3,0
84170,1,3,294786,294788,294791,2,5,0
84171,6,2,294792,294792,294794,0,2,1
84172,2,3,294794,294794,294797,0,3,0
84173,6,3,294800,294800,294803,0,3,3
84174,4,1,294804,294804,294805,0,1,1
84175,4,1,294808,294808,294809,0,1,3
84176,6,2,294814,294814,294816,0,2,5
84177,3,3,294817,294817,294820,0,3,1
84178,5,2,294822,294822,294824,0,2,2
84179,6,3,294828,294828,294831,0,3,4
84180,5,2,294833,294833,294835,0,2,2
84181,4,2,294837,294837,294839,0,2,2
84182,1,1,294838,294839,294840,1,2,0
84183,1,2,294839,294840,294842,1,3,0
84184,2,1,294841,294842,294843,1,2,0
84185,1,2,294842,294843,294845,1,3,0
84186,3,2,294845,294845,294847,0,2,0
84187,4,2,294849,294849,294851,0,2,2
84188,3,2,294852,294852,294854,0,2,1
84189,4,2,294856,294856,294858,0,2,2
84190,5,3,294861,294861,294864,0,3,3
84191,2,3,294863,294864,294867,1,4,0
84192,3,2,294866,294867,294869,1,3,0
84193,5,2,294871,294871,294873,0,2,2
84194,3,1,294874,294874,294875,0,1,1
84195,1,1,294875,294875,294876,0,1,0
84196,2,3,294877,294877,294880,0,3,1
84197,5,3,294882,294882,294885,0,3,2
84198,4,3,294886,294886,294889,0,3,1
84199,3,1,294889,294889,294890,0,1,0
84200,4,1,294893,294893,294894,0,1,3
84201,6,2,294899,294899,294901,0,2,5
84202,2,2,294901,294901,294903,0,2,0
84203,2,2,294903,294903,294905,0,2,0
84204,3,1,294906,294906,294907,0,1,1
84205,2,1,294908,294908,294909,0,1,1
84206,3,3,294911,294911,294914,0,3,2
84207,5,2,294916,294916,294918,0,2,2
84208,6,3,294922,294922,294925,0,3,4
84209,2,1,294924,294925,294926,1,2,0
84210,6,3,294930,294930,294933,0,3,4
84211,2,2,294932,294933,294935,1,3,0
84212,1,2,294933,294935,294937,2,4,0
84213,3,1,294936,294937,294938,1,2,0
84214,5,3,294941,294941,294944,0,3,3
84215,1,3,294942,294944,294947,2,5,0
84216,4,1,294946,294947,294948,1,2,0
84217,6,3,294952,294952,294955,0,3,4
84218,5,3,294957,294957,294960,0,3,2
84219,1,2,294958,294960,294962,2,4,0
84220,2,3,294960,294962,294965,2,5,0
84221,2,3,294962,294965,294968,3,6,0
84222,4,1,294966,294968,294969,2,3,0
84223,3,1,294969,294969,294970,0,1,0
84224,3,2,294972,294972,294974,0,2,2
84225,2,2,294974,294974,294976,0,2,0
84226,3,3,294977,294977,294980,0,3,1
84227,5,2,294982,294982,294984,0,2,2
84228,5,3,294987,294987,294990,0,3,3
84229,1,1,294988,294990,294991,2,3,0
84230,1,1,294989,294991,294992,2,3,0
84231,4,2,294993,294993,294995,0,2,1
84232,4,3,294997,294997,295000,0,3,2
84233,6,2,295003,295003,295005,0,2,3
84234,1,3,295004,295005,295008,1,4,0
84235,5,3,295009,295009,295012,0,3,1
84236,2,3,295011,295012,295015,1,4,0
84237,1,3,295012,295015,295018,3,6,0
84238,3,3,295015,295018,295021,3,6,0
84239,6,2,295021,295021,295023,0,2,0
84240,6,1,295027,295027,295028,0,1,4
84241,6,1,295033,295033,295034,0,1,5
84242,1,3,295034,295034,295037,0,3,0
84243,6,2,295040,295040,295042,0,2,3
84244,6,3,295046,295046,295049,0,3,4
84245,1,3,295047,295049,295052,2,5,0
84246,1,2,295048,295052,295054,4,6,0
84247,2,1,295050,295054,295055,4,5,0
84248,4,2,295054,295055,295057,1,3,0
84249,4,1,295058,295058,295059,0,1,1
84250,5,2,295063,295063,295065,0,2,4
84251,6,3,295069,295069,295072,0,3,4
84252,3,1,295072,295072,295073,0,1,0
84253,6,3,295078,295078,295081,0,3,5
84254,5,1,295083,295083,295084,0,1,2
84255,4,3,295087,295087,295090,0,3,3
84256,3,3,295090,295090,295093,0,3,0
84257,2,1,295092,295093,295094,1,2,0
84258,4,2,295096,295096,295098,0,2,2
84259,5,1,295101,295101,295102,0,1,3
84260,2,2,295103,295103,295105,0,2,1
84261,4,3,295107,295107,295110,0,3,2
84262,4,1,295111,295111,295112,0,1,1
84263,3,2,295114,295114,295116,0,2,2
84264,3,2,295117,295117,295119,0,2,1
84265,3,1,295120,295120,295121,0,1,1
84266,6,1,295126,295126,295127,0,1,5
84267,5,3,295131,295131,295134,0,3,4
84268,5,2,295136,295136,295138,0,2,2
84269,3,1,295139,295139,295140,0,1,1
84270,6,1,295145,295145,295146,0,1,5
84271,5,3,295150,295150,295153,0,3,4
84272,5,1,295155,295155,295156,0,1,2
84273,1,1,295156,295156,295157,0,1,0
84274,2,1,295158,295158,295159,0,1,1
84275,1,3,295159,295159,295162,0,3,0
84276,2,3,295161,295162,295165,1,4,0
84277,5,2,295166,295166,295168,0,2,1
84278,6,3,295172,295172,295175,0,3,4
84279,3,2,295175,295175,295177,0,2,0
84280,4,3,295179,295179,295182,0,3,2
84281,1,2,295180,295182,295184,2,4,0
84282,4,2,295184,295184,295186,0,2,0
84283,6,2,295190,295190,295192,0,2,4
84284,2,3,295192,295192,295195,0,3,0
84285,4,2,295196,295196,295198,0,2,1
84286,5,1,295201,295201,295202,0,1,3
84287,3,1,295204,295204,295205,0,1,2
84288,5,3,295209,295209,295212,0,3,4
84289,5,1,295214,295214,295215,0,1,2
84290,3,1,295217,295217,295218,0,1,2
84291,3,3,295220,295220,295223,0,3,2
84292,2,1,295222,295223,295224,1,2,0
84293,1,3,295223,295224,295227,1,4,0
84294,3,1,295226,295227,295228,1,2,0
84295,3,3,295229,295229,295232,0,3,1
84296,6,1,295235,295235,295236,0,1,3
84297,3,2,295238,295238,295240,0,2,2
84298,1,3,295239,295240,295243,1,4,0
84299,5,3,295244,295244,295247,0,3,1
84300,1,1,295245,295247,295248,2,3,0
84301,3,1,295248,295248,295249,0,1,0
84302,5,2,295253,295253,295255,0,2,4
84303,5,2,295258,295258,295260,0,2,3
84304,2,2,295260,295260,295262,0,2,0
84305,3,1,295263,295263,295264,0,1,1
84306,5,3,295268,295268,295271,0,3,4
84307,2,2,295270,295271,295273,1,3,0
84308,5,1,295275,295275,295276,0,1,2
84309,3,3,295278,295278,295281,0,3,2
84310,4,2,295282,295282,295284,0,2,1
84311,3,1,295285,295285,295286,0,1,1
84312,4,1,295289,295289,295290,0,1,3
84313,6,1,295295,295295,295296,0,1,5
84314,5,1,295300,295300,295301,0,1,4
84315,5,3,295305,295305,295308,0,3,4
84316,3,1,295308,295308,295309,0,1,0
84317,6,3,295314,295314,295317,0,3,5
84318,6,2,295320,295320,295322,0,2,3
84319,6,1,295326,295326,295327,0,1,4
84320,5,2,295331,295331,295333,0,2,4
84321,1,3,295332,295333,295336,1,4,0
84322,2,3,295334,295336,295339,2,5,0
84323,2,2,295336,295339,295341,3,5,0
84324,2,3,295338,295341,295344,3,6,0
84325,4,3,295342,295344,295347,2,5,0
84326,6,1,295348,295348,295349,0,1,1
84327,1,2,295349,295349,295351,0,2,0
84328,1,2,295350,295351,295353,1,3,0
84329,2,3,295352,295353,295356,1,4,0
84330,3,1,295355,295356,295357,1,2,0
84331,2,3,295357,295357,295360,0,3,0
84332,1,3,295358,295360,295363,2,5,0
84333,5,3,295363,295363,295366,0,3,0
84334,6,1,295369,295369,295370,0,1,3
84335,3,1,295372,295372,295373,0,1,2
84336,3,2,295375,295375,295377,0,2,2
84337,5,1,295380,295380,295381,0,1,3
84338,4,3,295384,295384,295387,0,3,3
84339,3,3,295387,295387,295390,0,3,0
84340,2,1,295389,295390,295391,1,2,0
84341,4,2,295393,295393,295395,0,2,2
84342,5,3,295398,295398,295401,0,3,3
84343,1,2,295399,295401,295403,2,4,0
84344,3,2,295402,295403,295405,1,3,0
84345,1,2,295403,295405,295407,2,4,0
84346,5,3,295408,295408,295411,0,3,1
84347,5,2,295413,295413,295415,0,2,2
84348,5,1,295418,295418,295419,0,1,3
84349,1,1,295419,295419,295420,0,1,0
84350,6,3,295425,295425,295428,0,3,5
84351,4,3,295429,295429,295432,0,3,1
84352,3,3,295432,295432,295435,0,3,0
84353,4,3,295436,295436,295439,0,3,1
84354,5,2,295441,295441,295443,0,2,2
84355,4,3,295445,295445,295448,0,3,2
84356,3,3,295448,295448,295451,0,3,0
84357,6,3,295454,295454,295457,0,3,3
84358,2,1,295456,295457,295458,1,2,0
84359,2,3,295458,295458,295461,0,3,0
84360,4,2,295462,295462,295464,0,2,1
84361,6,1,295468,295468,295469,0,1,4
84362,6,3,295474,295474,295477,0,3,5
84363,1,1,295475,295477,295478,2,3,0
84364,3,1,295478,295478,295479,0,1,0
84365,4,3,295482,295482,295485,0,3,3
84366,6,2,295488,295488,295490,0,2,3
84367,2,3,295490,295490,295493,0,3,0
84368,3,2,295493,295493,295495,0,2,0
84369,1,1,295494,295495,295496,1,2,0
84370,5,3,295499,295499,295502,0,3,3
84371,5,3,295504,295504,295507,0,3,2
84372,1,1,295505,295507,295508,2,3,0
84373,2,3,295507,295508,295511,1,4,0
84374,4,1,295511,295511,295512,0,1,0
84375,6,2,295517,295517,295519,0,2,5
84376,4,2,295521,295521,295523,0,2,2
84377,4,2,295525,295525,295527,0,2,2
84378,1,3,295526,295527,295530,1,4,0
84379,2,2,295528,295530,295532,2,4,0
84380,5,2,295533,295533,295535,0,2,1
84381,6,2,295539,295539,295541,0,2,4
84382,4,2,295543,295543,295545,0,2,2
84383,2,3,295545,295545,295548,0,3,0
84384,5,1,295550,295550,295551,0,1,2
84385,3,1,295553,295553,295554,0,1,2
84386,6,1,295559,295559,295560,0,1,5
84387,1,2,295560,295560,295562,0,2,0
84388,4,3,295564,295564,295567,0,3,2
84389,4,1,295568,295568,295569,0,1,1
84390,2,3,295570,295570,295573,0,3,1
84391,3,3,295573,295573,295576,0,3,0
84392,1,1,295574,295576,295577,2,3,0
84393,6,3,295580,295580,295583,0,3,3
84394,3,3,295583,295583,295586,0,3,0
84395,5,1,295588,295588,295589,0,1,2
84396,4,3,295592,295592,295595,0,3,3
84397,3,3,295595,295595,295598,0,3,0
84398,2,2,295597,295598,295600,1,3,0
84399,5,3,295602,295602,295605,0,3,2
84400,4,1,295606,295606,295607,0,1,1
84401,6,3,295612,295612,295615,0,3,5
84402,4,2,295616,295616,295618,0,2,1
84403,6,3,295622,295622,295625,0,3,4
84404,6,3,295628,295628,295631,0,3,3
84405,2,2,295630,295631,295633,1,3,0
84406,1,2,295631,295633,295635,2,4,0
84407,3,2,295634,295635,295637,1,3,0
84408,5,3,295639,295639,295642,0,3,2
84409,2,1,295641,295642,295643,1,2,0
84410,2,1,295643,295643,295644,0,1,0
84411,2,3,295645,295645,295648,0,3,1
84412,4,1,295649,295649,295650,0,1,1
84413,4,3,295653,295653,295656,0,3,3
84414,6,3,295659,295659,295662,0,3,3
84415,5,2,295664,295664,295666,0,2,2
84416,3,2,295667,295667,295669,0,2,1
84417,3,3,295670,295670,295673,0,3,1
84418,3,1,295673,295673,295674,0,1,0
84419,2,2,295675,295675,295677,0,2,1
84420,1,3,295676,295677,295680,1,4,0
84421,3,1,295679,295680,295681,1,2,0
84422,5,3,295684,295684,295687,0,3,3
84423,2,3,295686,295687,295690,1,4,0
84424,3,2,295689,295690,295692,1,3,0
84425,1,2,295690,295692,295694,2,4,0
84426,4,1,295694,295694,295695,0,1,0
84427,4,1,295698,295698,295699,0,1,3
84428,1,1,295699,295699,295700,0,1,0
84429,6,2,295705,295705,295707,0,2,5
84430,1,3,295706,295707,295710,1,4,0
84431,3,3,295709,295710,295713,1,4,0
84432,4,3,295713,295713,295716,0,3,0
84433,3,2,295716,295716,295718,0,2,0
84434,3,1,295719,295719,295720,0,1,1
84435,1,3,295720,295720,295723,0,3,0
84436,4,3,295724,295724,295727,0,3,1
84437,3,1,295727,295727,295728,0,1,0
84438,5,2,295732,295732,295734,0,2,4
84439,5,1,295737,295737,295738,0,1,3
84440,1,2,295738,295738,295740,0,2,0
84441,4,1,295742,295742,295743,0,1,2
84442,1,1,295743,295743,295744,0,1,0
84443,4,2,295747,295747,295749,0,2,3
84444,1,2,295748,295749,295751,1,3,0
84445,3,1,295751,295751,295752,0,1,0
84446,6,1,295757,295757,295758,0,1,5
84447,5,1,295762,295762,295763,0,1,4
84448,3,2,295765,295765,295767,0,2,2
84449,1,3,295766,295767,295770,1,4,0
84450,4,3,295770,295770,295773,0,3,0
84451,4,1,295774,295774,295775,0,1,1
84452,1,1,295775,295775,295776,0,1,0
84453,3,2,295778,295778,295780,0,2,2
84454,6,3,295784,295784,295787,0,3,4
84455,6,1,295790,295790,295791,0,1,3
84456,2,1,295792,295792,295793,0,1,1
84457,6,2,295798,295798,295800,0,2,5
84458,4,1,295802,295802,295803,0,1,2
84459,2,3,295804,295804,295807,0,3,1
84460,2,1,295806,295807,295808,1,2,0
84461,2,2,295808,295808,295810,0,2,0
84462,3,3,295811,295811,295814,0,3,1
84463,5,3,295816,295816,295819,0,3,2
84464,1,2,295817,295819,295821,2,4,0
84465,4,3,295821,295821,295824,0,3,0
84466,5,1,295826,295826,295827,0,1,2
84467,3,2,295829,295829,295831,0,2,2
84468,3,3,295832,295832,295835,0,3,1
84469,5,3,295837,295837,295840,0,3,2
84470,4,1,295841,295841,295842,0,1,1
84471,1,1,295842,295842,295843,0,1,0
84472,2,2,295844,295844,295846,0,2,1
84473,6,2,295850,295850,295852,0,2,4
84474,1,1,295851,295852,295853,1,2,0
84475,1,2,295852,295853,295855,1,3,0
84476,4,2,295856,295856,295858,0,2,1
84477,3,1,295859,295859,295860,0,1,1
84478,1,3,295860,295860,295863,0,3,0
84479,2,2,295862,295863,295865,1,3,0
84480,5,1,295867,295867,295868,0,1,2
84481,3,2,295870,295870,295872,0,2,2
84482,5,1,295875,295875,295876,0,1,3
84483,3,3,295878,295878,295881,0,3,2
84484,3,3,295881,295881,295884,0,3,0
84485,4,3,295885,295885,295888,0,3,1
84486,6,3,295891,295891,295894,0,3,3
84487,6,3,295897,295897,295900,0,3,3
84488,6,1,295903,295903,295904,0,1,3
84489,2,3,295905,295905,295908,0,3,1
84490,3,1,295908,295908,295909,0,1,0
84491,4,3,295912,295912,295915,0,3,3
84492,3,1,295915,295915,295916,0,1,0
84493,6,3,295921,295921,295924,0,3,5
84494,4,1,295925,295925,295926,0,1,1
84495,1,3,295926,295926,295929,0,3,0
84496,5,2,295931,295931,295933,0,2,2
84497,3,1,295934,295934,295935,0,1,1
84498,6,1,295940,295940,295941,0,1,5
84499,3,1,295943,295943,295944,0,1,2
84500,4,2,295947,295947,295949,0,2,3
84501,1,1,295948,295949,295950,1,2,0
84502,6,1,295954,295954,295955,0,1,4
84503,2,2,295956,295956,295958,0,2,1
84504,1,3,295957,295958,295961,1,4,0
84505,1,2,295958,295961,295963,3,5,0
84506,6,3,295964,295964,295967,0,3,1
84507,5,3,295969,295969,295972,0,3,2
84508,5,3,295974,295974,295977,0,3,2
84509,6,1,295980,295980,295981,0,1,3
84510,1,2,295981,295981,295983,0,2,0
84511,2,1,295983,295983,295984,0,1,0
84512,4,2,295987,295987,295989,0,2,3
84513,3,3,295990,295990,295993,0,3,1
84514,5,2,295995,295995,295997,0,2,2
84515,1,2,295996,295997,295999,1,3,0
84516,3,1,295999,295999,296000,0,1,0
84517,3,1,296002,296002,296003,0,1,2
84518,2,3,296004,296004,296007,0,3,1
84519,4,2,296008,296008,296010,0,2,1
84520,4,1,296012,296012,296013,0,1,2
84521,4,3,296016,296016,296019,0,3,3
84522,2,2,296018,296019,296021,1,3,0
84523,1,2,296019,296021,296023,2,4,0
84524,4,1,296023,296023,296024,0,1,0
84525,5,2,296028,296028,296030,0,2,4
84526,2,1,296030,296030,296031,0,1,0
84527,2,2,296032,296032,296034,0,2,1
84528,3,2,296035,296035,296037,0,2,1
84529,3,1,296038,296038,296039,0,1,1
84530,2,1,296040,296040,296041,0,1,1
84531,1,2,296041,296041,296043,0,2,0
84532,1,3,296042,296043,296046,1,4,0
84533,6,3,296048,296048,296051,0,3,2
84534,1,1,296049,296051,296052,2,3,0
84535,6,1,296055,296055,296056,0,1,3
84536,3,2,296058,296058,296060,0,2,2
84537,3,3,296061,296061,296064,0,3,1
84538,5,1,296066,296066,296067,0,1,2
84539,1,3,296067,296067,296070,0,3,0
84540,1,3,296068,296070,296073,2,5,0
84541,4,2,296072,296073,296075,1,3,0
84542,3,2,296075,296075,296077,0,2,0
84543,4,1,296079,296079,296080,0,1,2
84544,6,2,296085,296085,296087,0,2,5
84545,5,2,296090,296090,296092,0,2,3
84546,4,3,296094,296094,296097,0,3,2
84547,2,1,296096,296097,296098,1,2,0
84548,3,2,296099,296099,296101,0,2,1
84549,2,1,296101,296101,296102,0,1,0
84550,5,2,296106,296106,296108,0,2,4
84551,4,3,296110,296110,296113,0,3,2
84552,6,2,296116,296116,296118,0,2,3
84553,2,3,296118,296118,296121,0,3,0
84554,4,2,296122,296122,296124,0,2,1
84555,3,1,296125,296125,296126,0,1,1
84556,5,1,296130,296130,296131,0,1,4
84557,6,1,296136,296136,296137,0,1,5
84558,1,3,296137,296137,296140,0,3,0
84559,3,1,296140,296140,296141,0,1,0
84560,1,3,296141,296141,296144,0,3,0
84561,6,1,296147,296147,296148,0,1,3
84562,2,1,296149,296149,296150,0,1,1
84563,1,1,296150,296150,296151,0,1,0
84564,4,3,296154,296154,296157,0,3,3
84565,3,3,296157,296157,296160,0,3,0
84566,2,2,296159,296160,296162,1,3,0
84567,5,1,296164,296164,296165,0,1,2
84568,1,3,296165,296165,296168,0,3,0
84569,1,1,296166,296168,296169,2,3,0
84570,3,1,296169,296169,296170,0,1,0
84571,4,1,296173,296173,296174,0,1,3
84572,4,3,296177,296177,296180,0,3,3
84573,4,1,296181,296181,296182,0,1,1
84574,1,3,296182,296182,296185,0,3,0
84575,3,2,296185,296185,296187,0,2,0
84576,6,1,296191,296191,296192,0,1,4
84577,2,1,296193,296193,296194,0,1,1
84578,6,2,296199,296199,296201,0,2,5
84579,5,2,296204,296204,296206,0,2,3
84580,5,1,296209,296209,296210,0,1,3
84581,3,3,296212,296212,296215,0,3,2
84582,3,3,296215,296215,296218,0,3,0
84583,5,2,296220,296220,296222,0,2,2
84584,1,3,296221,296222,296225,1,4,0
84585,5,1,296226,296226,296227,0,1,1
84586,1,3,296227,296227,296230,0,3,0
84587,2,3,296229,296230,296233,1,4,0
84588,2,3,296231,296233,296236,2,5,0
84589,4,2,296235,296236,296238,1,3,0
84590,5,1,296240,296240,296241,0,1,2
84591,2,1,296242,296242,296243,0,1,1
84592,5,3,296247,296247,296250,0,3,4
84593,3,2,296250,296250,296252,0,2,0
84594,6,2,296256,296256,296258,0,2,4
84595,6,3,296262,296262,296265,0,3,4
84596,2,1,296264,296265,296266,1,2,0
84597,6,1,296270,296270,296271,0,1,4
84598,3,3,296273,296273,296276,0,3,2
84599,3,1,296276,296276,296277,0,1,0
84600,3,3,296279,296279,296282,0,3,2
84601,1,3,296280,296282,296285,2,5,0
84602,1,1,296281,296285,296286,4,5,0
84603,1,2,296282,296286,296288,4,6,0
84604,5,2,296287,296288,296290,1,3,0
84605,1,1,296288,296290,296291,2,3,0
84606,1,1,296289,296291,296292,2,3,0
84607,4,2,296293,296293,296295,0,2,1
84608,3,3,296296,296296,296299,0,3,1
84609,3,3,296299,296299,296302,0,3,0
84610,3,1,296302,296302,296303,0,1,0
84611,2,3,296304,296304,296307,0,3,1
84612,2,1,296306,296307,296308,1,2,0
84613,3,3,296309,296309,296312,0,3,1
84614,6,1,296315,296315,296316,0,1,3
84615,2,3,296317,296317,296320,0,3,1
84616,2,3,296319,296320,296323,1,4,0
84617,2,1,296321,296323,296324,2,3,0
84618,6,3,296327,296327,296330,0,3,3
84619,1,3,296328,296330,296333,2,5,0
84620,5,2,296333,296333,296335,0,2,0
84621,5,3,296338,296338,296341,0,3,3
84622,1,3,296339,296341,296344,2,5,0
84623,5,3,296344,296344,296347,0,3,0
84624,4,3,296348,296348,296351,0,3,1
84625,4,3,296352,296352,296355,0,3,1
84626,4,1,296356,296356,296357,0,1,1
84627,1,2,296357,296357,296359,0,2,0
84628,2,3,296359,296359,296362,0,3,0
84629,2,1,296361,296362,296363,1,2,0
84630,5,1,296366,296366,296367,0,1,3
84631,5,2,296371,296371,296373,0,2,4
84632,4,3,296375,296375,296378,0,3,2
84633,6,2,296381,296381,296383,0,2,3
84634,2,2,296383,296383,296385,0,2,0
84635,6,2,296389,296389,296391,0,2,4
84636,2,2,296391,296391,296393,0,2,0
84637,1,3,296392,296393,296396,1,4,0
84638,4,2,296396,296396,296398,0,2,0
84639,2,2,296398,296398,296400,0,2,0
84640,2,1,296400,296400,296401,0,1,0
84641,4,2,296404,296404,296406,0,2,3
84642,6,3,296410,296410,296413,0,3,4
84643,4,2,296414,296414,296416,0,2,1
84644,3,1,296417,296417,296418,0,1,1
84645,2,1,296419,296419,296420,0,1,1
84646,3,2,296422,296422,296424,0,2,2
84647,1,1,296423,296424,296425,1,2,0
84648,1,2,296424,296425,296427,1,3,0
84649,5,2,296429,296429,296431,0,2,2
84650,6,3,296435,296435,296438,0,3,4
84651,2,1,296437,296438,296439,1,2,0
84652,4,1,296441,296441,296442,0,1,2
84653,4,1,296445,296445,296446,0,1,3
84654,1,1,296446,296446,296447,0,1,0
84655,3,1,296449,296449,296450,0,1,2
84656,5,2,296454,296454,296456,0,2,4
84657,3,1,296457,296457,296458,0,1,1
84658,1,3,296458,296458,296461,0,3,0
84659,6,1,296464,296464,296465,0,1,3
84660,3,2,296467,296467,296469,0,2,2
84661,4,1,296471,296471,296472,0,1,2
84662,1,1,296472,296472,296473,0,1,0
84663,3,1,296475,296475,296476,0,1,2
84664,5,1,296480,296480,296481,0,1,4
84665,1,3,296481,296481,296484,0,3,0
84666,1,2,296482,296484,296486,2,4,0
84667,1,3,296483,296486,296489,3,6,0
84668,2,3,296485,296489,296492,4,7,0
84669,1,1,296486,296492,296493,6,7,0
84670,2,1,296488,296493,296494,5,6,0
84671,1,1,296489,296494,296495,5,6,0
84672,2,2,296491,296495,296497,4,6,0
84673,1,1,296492,296497,296498,5,6,0
84674,5,2,296497,296498,296500,1,3,0
84675,6,2,296503,296503,296505,0,2,3
84676,6,3,296509,296509,296512,0,3,4
84677,4,3,296513,296513,296516,0,3,1
84678,5,3,296518,296518,296521,0,3,2
84679,1,2,296519,296521,296523,2,4,0
84680,3,2,296522,296523,296525,1,3,0
84681,2,3,296524,296525,296528,1,4,0
84682,5,2,296529,296529,296531,0,2,1
84683,2,3,296531,296531,296534,0,3,0
84684,6,1,296537,296537,296538,0,1,3
84685,2,1,296539,296539,296540,0,1,1
84686,6,2,296545,296545,296547,0,2,5
84687,2,2,296547,296547,296549,0,2,0
84688,5,3,296552,296552,296555,0,3,3
84689,3,1,296555,296555,296556,0,1,0
84690,6,2,296561,296561,296563,0,2,5
84691,2,3,296563,296563,296566,0,3,0
84692,1,3,296564,296566,296569,2,5,0
84693,6,3,296570,296570,296573,0,3,1
84694,4,3,296574,296574,296577,0,3,1
84695,5,3,296579,296579,296582,0,3,2
84696,2,1,296581,296582,296583,1,2,0
84697,4,3,296585,296585,296588,0,3,2
84698,5,2,296590,296590,296592,0,2,2
84699,4,3,296594,296594,296597,0,3,2
84700,4,2,296598,296598,296600,0,2,1
84701,1,3,296599,296600,296603,1,4,0
84702,1,2,296600,296603,296605,3,5,0
84703,5,1,296605,296605,296606,0,1,0
84704,4,1,296609,296609,296610,0,1,3
84705,4,1,296613,296613,296614,0,1,3
84706,6,3,296619,296619,296622,0,3,5
84707,2,3,296621,296622,296625,1,4,0
84708,5,3,296626,296626,296629,0,3,1
84709,4,3,296630,296630,296633,0,3,1
84710,1,3,296631,296633,296636,2,5,0
84711,1,1,296632,296636,296637,4,5,0
84712,3,3,296635,296637,296640,2,5,0
84713,2,1,296637,296640,296641,3,4,0
84714,2,1,296639,296641,296642,2,3,0
84715,2,3,296641,296642,296645,1,4,0
84716,6,2,296647,296647,296649,0,2,2
84717,3,3,296650,296650,296653,0,3,1
84718,3,1,296653,296653,296654,0,1,0
84719,5,1,296658,296658,296659,0,1,4
84720,5,1,296663,296663,296664,0,1,4
84721,1,2,296664,296664,296666,0,2,0
84722,4,2,296668,296668,296670,0,2,2
84723,3,2,296671,296671,296673,0,2,1
84724,6,1,296677,296677,296678,0,1,4
84725,3,1,296680,296680,296681,0,1,2
84726,5,3,296685,296685,296688,0,3,4
84727,4,2,296689,296689,296691,0,2,1
84728,3,1,296692,296692,296693,0,1,1
84729,1,3,296693,296693,296696,0,3,0
84730,4,3,296697,296697,296700,0,3,1
84731,1,3,296698,296700,296703,2,5,0
84732,1,1,296699,296703,296704,4,5,0
84733,5,3,296704,296704,296707,0,3,0
84734,1,3,296705,296707,296710,2,5,0
84735,3,2,296708,296710,296712,2,4,0
84736,6,1,296714,296714,296715,0,1,2
84737,1,2,296715,296715,296717,0,2,0
84738,2,2,296717,296717,296719,0,2,0
84739,2,2,296719,296719,296721,0,2,0
84740,4,3,296723,296723,296726,0,3,2
84741,5,1,296728,296728,296729,0,1,2
84742,2,1,296730,296730,296731,0,1,1
84743,6,2,296736,296736,296738,0,2,5
84744,1,1,296737,296738,296739,1,2,0
84745,1,3,296738,296739,296742,1,4,0
84746,2,2,296740,296742,296744,2,4,0
84747,5,2,296745,296745,296747,0,2,1
84748,1,2,296746,296747,296749,1,3,0
84749,2,1,296748,296749,296750,1,2,0
84750,5,3,296753,296753,296756,0,3,3
84751,6,1,296759,296759,296760,0,1,3
84752,1,2,296760,296760,296762,0,2,0
84753,2,3,296762,296762,296765,0,3,0
84754,2,2,296764,296765,296767,1,3,0
84755,1,1,296765,296767,296768,2,3,0
84756,5,2,296770,296770,296772,0,2,2
84757,1,3,296771,296772,296775,1,4,0
84758,5,1,296776,296776,296777,0,1,1
84759,2,1,296778,296778,296779,0,1,1
84760,6,3,296784,296784,296787,0,3,5
84761,3,2,296787,296787,296789,0,2,0
84762,1,2,296788,296789,296791,1,3,0
84763,4,2,296792,296792,296794,0,2,1
84764,1,1,296793,296794,296795,1,2,0
84765,6,1,296799,296799,296800,0,1,4
84766,3,1,296802,296802,296803,0,1,2
84767,3,2,296805,296805,296807,0,2,2
84768,5,1,296810,296810,296811,0,1,3
84769,4,2,296814,296814,296816,0,2,3
84770,2,1,296816,296816,296817,0,1,0
84771,6,3,296822,296822,296825,0,3,5
84772,2,1,296824,296825,296826,1,2,0
84773,3,1,296827,296827,296828,0,1,1
84774,5,1,296832,296832,296833,0,1,4
84775,5,3,296837,296837,296840,0,3,4
84776,2,1,296839,296840,296841,1,2,0
84777,5,3,296844,296844,296847,0,3,3
84778,6,2,296850,296850,296852,0,2,3
84779,1,1,296851,296852,296853,1,2,0
84780,2,2,296853,296853,296855,0,2,0
84781,2,3,296855,296855,296858,0,3,0
84782,3,2,296858,296858,296860,0,2,0
84783,6,2,296864,296864,296866,0,2,4
84784,2,3,296866,296866,296869,0,3,0
84785,4,1,296870,296870,296871,0,1,1
84786,1,3,296871,296871,296874,0,3,0
84787,2,1,296873,296874,296875,1,2,0
84788,1,3,296874,296875,296878,1,4,0
84789,4,2,296878,296878,296880,0,2,0
84790,4,3,296882,296882,296885,0,3,2
84791,6,3,296888,296888,296891,0,3,3
84792,6,3,296894,296894,296897,0,3,3
84793,4,3,296898,296898,296901,0,3,1
84794,1,2,296899,296901,296903,2,4,0
84795,2,1,296901,296903,296904,2,3,0
84796,1,3,296902,296904,296907,2,5,0
84797,5,2,296907,296907,296909,0,2,0
84798,5,3,296912,296912,296915,0,3,3
84799,6,2,296918,296918,296920,0,2,3
84800,3,2,296921,296921,296923,0,2,1
84801,4,2,296925,296925,296927,0,2,2
84802,3,2,296928,296928,296930,0,2,1
84803,4,3,296932,296932,296935,0,3,2
84804,4,2,296936,296936,296938,0,2,1
84805,2,1,296938,296938,296939,0,1,0
84806,1,1,296939,296939,296940,0,1,0
84807,5,2,296944,296944,296946,0,2,4
84808,6,2,296950,296950,296952,0,2,4
84809,3,2,296953,296953,296955,0,2,1
84810,6,2,296959,296959,296961,0,2,4
84811,6,2,296965,296965,296967,0,2,4
84812,3,1,296968,296968,296969,0,1,1
84813,2,2,296970,296970,296972,0,2,1
84814,5,2,296975,296975,296977,0,2,3
84815,3,2,296978,296978,296980,0,2,1
84816,3,3,296981,296981,296984,0,3,1
84817,2,1,296983,296984,296985,1,2,0
84818,3,2,296986,296986,296988,0,2,1
84819,2,2,296988,296988,296990,0,2,0
84820,4,2,296992,296992,296994,0,2,2
84821,1,2,296993,296994,296996,1,3,0
84822,6,1,296999,296999,297000,0,1,3
84823,6,3,297005,297005,297008,0,3,5
84824,5,1,297010,297010,297011,0,1,2
84825,2,2,297012,297012,297014,0,2,1
84826,3,2,297015,297015,297017,0,2,1
84827,2,2,297017,297017,297019,0,2,0
84828,1,1,297018,297019,297020,1,2,0
84829,3,1,297021,297021,297022,0,1,1
84830,5,3,297026,297026,297029,0,3,4
84831,5,3,297031,297031,297034,0,3,2
84832,1,1,297032,297034,297035,2,3,0
84833,4,1,297036,297036,297037,0,1,1
84834,4,1,297040,297040,297041,0,1,3
84835,6,2,297046,297046,297048,0,2,5
84836,5,2,297051,297051,297053,0,2,3
84837,5,2,297056,297056,297058,0,2,3
84838,6,2,297062,297062,297064,0,2,4
84839,1,3,297063,297064,297067,1,4,0
84840,2,1,297065,297067,297068,2,3,0
84841,5,1,297070,297070,297071,0,1,2
84842,5,3,297075,297075,297078,0,3,4
84843,6,1,297081,297081,297082,0,1,3
84844,2,1,297083,297083,297084,0,1,1
84845,5,1,297088,297088,297089,0,1,4
84846,1,2,297089,297089,297091,0,2,0
84847,1,1,297090,297091,297092,1,2,0
84848,6,2,297096,297096,297098,0,2,4
84849,3,3,297099,297099,297102,0,3,1
84850,2,1,297101,297102,297103,1,2,0
84851,2,2,297103,297103,297105,0,2,0
84852,5,2,297108,297108,297110,0,2,3
84853,6,2,297114,297114,297116,0,2,4
84854,6,3,297120,297120,297123,0,3,4
84855,4,2,297124,297124,297126,0,2,1
84856,3,1,297127,297127,297128,0,1,1
84857,5,2,297132,297132,297134,0,2,4
84858,1,1,297133,297134,297135,1,2,0
84859,6,2,297139,297139,297141,0,2,4
84860,4,3,297143,297143,297146,0,3,2
84861,4,3,297147,297147,297150,0,3,1
84862,1,3,297148,297150,297153,2,5,0
84863,6,3,297154,297154,297157,0,3,1
84864,4,1,297158,297158,297159,0,1,1
84865,3,2,297161,297161,297163,0,2,2
84866,1,1,297162,297163,297164,1,2,0
84867,4,2,297166,297166,297168,0,2,2
84868,4,3,297170,297170,297173,0,3,2
84869,5,1,297175,297175,297176,0,1,2
84870,6,2,297181,297181,297183,0,2,5
84871,2,2,297183,297183,297185,0,2,0
84872,4,3,297187,297187,297190,0,3,2
84873,2,3,297189,297190,297193,1,4,0
84874,2,2,297191,297193,297195,2,4,0
84875,4,2,297195,297195,297197,0,2,0
84876,2,3,297197,297197,297200,0,3,0
84877,4,1,297201,297201,297202,0,1,1
84878,5,3,297206,297206,297209,0,3,4
84879,4,1,297210,297210,297211,0,1,1
84880,5,1,297215,297215,297216,0,1,4
84881,6,3,297221,297221,297224,0,3,5
84882,2,1,297223,297224,297225,1,2,0
84883,1,2,297224,297225,297227,1,3,0
84884,3,1,297227,297227,297228,0,1,0
84885,3,2,297230,297230,297232,0,2,2
84886,1,2,297231,297232,297234,1,3,0
84887,1,1,297232,297234,297235,2,3,0
84888,2,2,297234,297235,297237,1,3,0
84889,6,2,297240,297240,297242,0,2,3
84890,5,3,297245,297245,297248,0,3,3
84891,4,3,297249,297249,297252,0,3,1
84892,6,2,297255,297255,297257,0,2,3
84893,1,1,297256,297257,297258,1,2,0
84894,5,1,297261,297261,297262,0,1,3
84895,4,2,297265,297265,297267,0,2,3
84896,6,2,297271,297271,297273,0,2,4
84897,6,3,297277,297277,297280,0,3,4
84898,2,2,297279,297280,297282,1,3,0
84899,4,1,297283,297283,297284,0,1,1
84900,4,1,297287,297287,297288,0,1,3
84901,5,3,297292,297292,297295,0,3,4
84902,2,3,297294,297295,297298,1,4,0
84903,6,3,297300,297300,297303,0,3,2
84904,6,1,297306,297306,297307,0,1,3
84905,1,2,297307,297307,297309,0,2,0
84906,5,2,297312,297312,297314,0,2,3
84907,4,1,297316,297316,297317,0,1,2
84908,1,1,297317,297317,297318,0,1,0
84909,4,1,297321,297321,297322,0,1,3
84910,1,3,297322,297322,297325,0,3,0
84911,6,3,297328,297328,297331,0,3,3
84912,2,1,297330,297331,297332,1,2,0
84913,2,2,297332,297332,297334,0,2,0
84914,6,2,297338,297338,297340,0,2,4
84915,3,1,297341,297341,297342,0,1,1
84916,3,1,297344,297344,297345,0,1,2
84917,3,1,297347,297347,297348,0,1,2
84918,1,1,297348,297348,297349,0,1,0
84919,1,2,297349,297349,297351,0,2,0
84920,5,2,297354,297354,297356,0,2,3
84921,1,3,297355,297356,297359,1,4,0
84922,6,3,297361,297361,297364,0,3,2
84923,1,2,297362,297364,297366,2,4,0
84924,1,1,297363,297366,297367,3,4,0
84925,3,3,297366,297367,297370,1,4,0
84926,2,3,297368,297370,297373,2,5,0
84927,2,2,297370,297373,297375,3,5,0
84928,5,2,297375,297375,297377,0,2,0
84929,2,3,297377,297377,297380,0,3,0
84930,6,3,297383,297383,297386,0,3,3
84931,5,2,297388,297388,297390,0,2,2
84932,5,3,297393,297393,297396,0,3,3
84933,6,3,297399,297399,297402,0,3,3
84934,5,2,297404,297404,297406,0,2,2
84935,2,2,297406,297406,297408,0,2,0
84936,3,2,297409,297409,297411,0,2,1
84937,6,2,297415,297415,297417,0,2,4
84938,4,3,297419,297419,297422,0,3,2
84939,2,3,297421,297422,297425,1,4,0
84940,2,1,297423,297425,297426,2,3,0
84941,1,3,297424,297426,297429,2,5,0
84942,5,1,297429,297429,297430,0,1,0
84943,3,2,297432,297432,297434,0,2,2
84944,6,3,297438,297438,297441,0,3,4
84945,3,1,297441,297441,297442,0,1,0
84946,2,2,297443,297443,297445,0,2,1
84947,3,2,297446,297446,297448,0,2,1
84948,3,2,297449,297449,297451,0,2,1
84949,6,3,297455,297455,297458,0,3,4
84950,2,3,297457,297458,297461,1,4,0
84951,3,2,297460,297461,297463,1,3,0
84952,3,1,297463,297463,297464,0,1,0
84953,4,2,297467,297467,297469,0,2,3
84954,5,3,297472,297472,297475,0,3,3
84955,6,2,297478,297478,297480,0,2,3
84956,1,1,297479,297480,297481,1,2,0
84957,1,3,297480,297481,297484,1,4,0
84958,4,1,297484,297484,297485,0,1,0
84959,3,3,297487,297487,297490,0,3,2
84960,5,2,297492,297492,297494,0,2,2
84961,6,2,297498,297498,297500,0,2,4
84962,6,3,297504,297504,297507,0,3,4
84963,1,3,297505,297507,297510,2,5,0
84964,6,2,297511,297511,297513,0,2,1
84965,1,3,297512,297513,297516,1,4,0
84966,2,2,297514,297516,297518,2,4,0
84967,2,3,297516,297518,297521,2,5,0
84968,4,2,297520,297521,297523,1,3,0
84969,5,1,297525,297525,297526,0,1,2
84970,4,2,297529,297529,297531,0,2,3
84971,1,2,297530,297531,297533,1,3,0
84972,3,1,297533,297533,297534,0,1,0
84973,5,1,297538,297538,297539,0,1,4
84974,5,2,297543,297543,297545,0,2,4
84975,3,1,297546,297546,297547,0,1,1
84976,4,3,297550,297550,297553,0,3,3
84977,3,2,297553,297553,297555,0,2,0
84978,4,1,297557,297557,297558,0,1,2
84979,3,2,297560,297560,297562,0,2,2
84980,1,1,297561,297562,297563,1,2,0
84981,3,3,297564,297564,297567,0,3,1
84982,1,3,297565,297567,297570,2,5,0
84983,5,1,297570,297570,297571,0,1,0
84984,5,3,297575,297575,297578,0,3,4
84985,6,1,297581,297581,297582,0,1,3
84986,2,3,297583,297583,297586,0,3,1
84987,4,1,297587,297587,297588,0,1,1
84988,3,2,297590,297590,297592,0,2,2
84989,3,2,297593,297593,297595,0,2,1
84990,2,1,297595,297595,297596,0,1,0
84991,1,3,297596,297596,297599,0,3,0
84992,2,3,297598,297599,297602,1,4,0
84993,6,2,297604,297604,297606,0,2,2
84994,3,1,297607,297607,297608,0,1,1
84995,4,1,297611,297611,297612,0,1,3
84996,2,2,297613,297613,297615,0,2,1
84997,6,3,297619,297619,297622,0,3,4
84998,1,2,297620,297622,297624,2,4,0
84999,4,2,297624,297624,297626,0,2,0
85000,2,1,297626,297626,297627,0,1,0
85001,1,3,297627,297627,297630,0,3,0
85002,5,1,297632,297632,297633,0,1,2
85003,3,1,297635,297635,297636,0,1,2
85004,1,3,297636,297636,297639,0,3,0
85005,6,3,297642,297642,297645,0,3,3
85006,6,3,297648,297648,297651,0,3,3
85007,2,2,297650,297651,297653,1,3,0
85008,4,1,297654,297654,297655,0,1,1
85009,6,3,297660,297660,297663,0,3,5
85010,2,2,297662,297663,297665,1,3,0
85011,6,3,297668,297668,297671,0,3,3
85012,4,2,297672,297672,297674,0,2,1
85013,4,3,297676,297676,297679,0,3,2
85014,4,3,297680,297680,297683,0,3,1
85015,6,3,297686,297686,297689,0,3,3
85016,5,1,297691,297691,297692,0,1,2
85017,6,3,297697,297697,297700,0,3,5
85018,4,3,297701,297701,297704,0,3,1
85019,4,3,297705,297705,297708,0,3,1
85020,6,3,297711,297711,297714,0,3,3
85021,3,1,297714,297714,297715,0,1,0
85022,6,1,297720,297720,297721,0,1,5
85023,2,3,297722,297722,297725,0,3,1
85024,3,1,297725,297725,297726,0,1,0
85025,2,1,297727,297727,297728,0,1,1
85026,3,2,297730,297730,297732,0,2,2
85027,1,3,297731,297732,297735,1,4,0
85028,3,3,297734,297735,297738,1,4,0
85029,4,2,297738,297738,297740,0,2,0
85030,3,2,297741,297741,297743,0,2,1
85031,4,3,297745,297745,297748,0,3,2
85032,1,3,297746,297748,297751,2,5,0
85033,3,2,297749,297751,297753,2,4,0
85034,2,2,297751,297753,297755,2,4,0
85035,6,2,297757,297757,297759,0,2,2
85036,1,3,297758,297759,297762,1,4,0
85037,4,2,297762,297762,297764,0,2,0
85038,5,2,297767,297767,297769,0,2,3
85039,5,3,297772,297772,297775,0,3,3
85040,2,1,297774,297775,297776,1,2,0
85041,5,2,297779,297779,297781,0,2,3
85042,6,2,297785,297785,297787,0,2,4
85043,6,3,297791,297791,297794,0,3,4
85044,3,3,297794,297794,297797,0,3,0
85045,6,3,297800,297800,297803,0,3,3
85046,5,2,297805,297805,297807,0,2,2
85047,1,1,297806,297807,297808,1,2,0
85048,2,1,297808,297808,297809,0,1,0
85049,2,3,297810,297810,297813,0,3,1
85050,5,2,297815,297815,297817,0,2,2
85051,6,2,297821,297821,297823,0,2,4
85052,2,2,297823,297823,297825,0,2,0
85053,3,2,297826,297826,297828,0,2,1
85054,1,1,297827,297828,297829,1,2,0
85055,3,3,297830,297830,297833,0,3,1
85056,5,2,297835,297835,297837,0,2,2
85057,3,2,297838,297838,297840,0,2,1
85058,1,3,297839,297840,297843,1,4,0
85059,2,2,297841,297843,297845,2,4,0
85060,3,3,297844,297845,297848,1,4,0
85061,5,3,297849,297849,297852,0,3,1
85062,5,3,297854,297854,297857,0,3,2
85063,3,2,297857,297857,297859,0,2,0
85064,3,2,297860,297860,297862,0,2,1
85065,3,2,297863,297863,297865,0,2,1
85066,5,2,297868,297868,297870,0,2,3
85067,6,2,297874,297874,297876,0,2,4
85068,5,2,297879,297879,297881,0,2,3
85069,1,1,297880,297881,297882,1,2,0
85070,5,2,297885,297885,297887,0,2,3
85071,3,2,297888,297888,297890,0,2,1
85072,5,3,297893,297893,297896,0,3,3
85073,5,1,297898,297898,297899,0,1,2
85074,1,1,297899,297899,297900,0,1,0
85075,2,1,297901,297901,297902,0,1,1
85076,1,1,297902,297902,297903,0,1,0
85077,6,3,297908,297908,297911,0,3,5
85078,5,1,297913,297913,297914,0,1,2
85079,6,2,297919,297919,297921,0,2,5
85080,6,2,297925,297925,297927,0,2,4
85081,1,3,297926,297927,297930,1,4,0
85082,6,3,297932,297932,297935,0,3,2
85083,6,3,297938,297938,297941,0,3,3
85084,4,2,297942,297942,297944,0,2,1
85085,1,3,297943,297944,297947,1,4,0
85086,5,3,297948,297948,297951,0,3,1
85087,2,3,297950,297951,297954,1,4,0
85088,5,1,297955,297955,297956,0,1,1
85089,2,1,297957,297957,297958,0,1,1
85090,2,1,297959,297959,297960,0,1,1
85091,5,1,297964,297964,297965,0,1,4
85092,4,3,297968,297968,297971,0,3,3
85093,2,1,297970,297971,297972,1,2,0
85094,2,2,297972,297972,297974,0,2,0
85095,3,2,297975,297975,297977,0,2,1
85096,3,1,297978,297978,297979,0,1,1
85097,2,3,297980,297980,297983,0,3,1
85098,3,1,297983,297983,297984,0,1,0
85099,5,1,297988,297988,297989,0,1,4
85100,4,2,297992,297992,297994,0,2,3
85101,1,3,297993,297994,297997,1,4,0
85102,3,1,297996,297997,297998,1,2,0
85103,1,1,297997,297998,297999,1,2,0
85104,1,3,297998,297999,298002,1,4,0
85105,1,1,297999,298002,298003,3,4,0
85106,4,2,298003,298003,298005,0,2,0
85107,4,1,298007,298007,298008,0,1,2
85108,4,3,298011,298011,298014,0,3,3
85109,1,2,298012,298014,298016,2,4,0
85110,3,2,298015,298016,298018,1,3,0
85111,3,2,298018,298018,298020,0,2,0
85112,1,1,298019,298020,298021,1,2,0
85113,6,3,298025,298025,298028,0,3,4
85114,4,2,298029,298029,298031,0,2,1
85115,2,2,298031,298031,298033,0,2,0
85116,2,3,298033,298033,298036,0,3,0
85117,5,3,298038,298038,298041,0,3,2
85118,4,2,298042,298042,298044,0,2,1
85119,6,1,298048,298048,298049,0,1,4
85120,3,1,298051,298051,298052,0,1,2
85121,1,1,298052,298052,298053,0,1,0
85122,5,3,298057,298057,298060,0,3,4
85123,2,3,298059,298060,298063,1,4,0
85124,4,1,298063,298063,298064,0,1,0
85125,4,3,298067,298067,298070,0,3,3
85126,4,1,298071,298071,298072,0,1,1
85127,2,1,298073,298073,298074,0,1,1
85128,1,2,298074,298074,298076,0,2,0
85129,2,1,298076,298076,298077,0,1,0
85130,6,3,298082,298082,298085,0,3,5
85131,3,1,298085,298085,298086,0,1,0
85132,6,1,298091,298091,298092,0,1,5
85133,2,1,298093,298093,298094,0,1,1
85134,4,3,298097,298097,298100,0,3,3
85135,2,3,298099,298100,298103,1,4,0
85136,2,2,298101,298103,298105,2,4,0
85137,3,2,298104,298105,298107,1,3,0
85138,5,1,298109,298109,298110,0,1,2
85139,5,2,298114,298114,298116,0,2,4
85140,1,2,298115,298116,298118,1,3,0
85141,1,3,298116,298118,298121,2,5,0
85142,2,3,298118,298121,298124,3,6,0
85143,3,2,298121,298124,298126,3,5,0
85144,2,2,298123,298126,298128,3,5,0
85145,6,2,298129,298129,298131,0,2,1
85146,1,3,298130,298131,298134,1,4,0
85147,6,2,298136,298136,298138,0,2,2
85148,3,3,298139,298139,298142,0,3,1
85149,5,3,298144,298144,298147,0,3,2
85150,1,2,298145,298147,298149,2,4,0
85151,2,1,298147,298149,298150,2,3,0
85152,1,1,298148,298150,298151,2,3,0
85153,6,1,298154,298154,298155,0,1,3
85154,4,2,298158,298158,298160,0,2,3
85155,6,1,298164,298164,298165,0,1,4
85156,4,2,298168,298168,298170,0,2,3
85157,1,3,298169,298170,298173,1,4,0
85158,1,1,298170,298173,298174,3,4,0
85159,4,1,298174,298174,298175,0,1,0
85160,2,3,298176,298176,298179,0,3,1
85161,3,3,298179,298179,298182,0,3,0
85162,6,2,298185,298185,298187,0,2,3
85163,1,2,298186,298187,298189,1,3,0
85164,2,2,298188,298189,298191,1,3,0
85165,6,2,298194,298194,298196,0,2,3
85166,5,3,298199,298199,298202,0,3,3
85167,1,1,298200,298202,298203,2,3,0
85168,4,1,298204,298204,298205,0,1,1
85169,4,2,298208,298208,298210,0,2,3
85170,5,2,298213,298213,298215,0,2,3
85171,3,1,298216,298216,298217,0,1,1
85172,5,1,298221,298221,298222,0,1,4
85173,4,3,298225,298225,298228,0,3,3
85174,3,1,298228,298228,298229,0,1,0
85175,2,1,298230,298230,298231,0,1,1
85176,6,1,298236,298236,298237,0,1,5
85177,5,3,298241,298241,298244,0,3,4
85178,3,1,298244,298244,298245,0,1,0
85179,2,3,298246,298246,298249,0,3,1
85180,1,1,298247,298249,298250,2,3,0
85181,5,2,298252,298252,298254,0,2,2
85182,1,1,298253,298254,298255,1,2,0
85183,3,1,298256,298256,298257,0,1,1
85184,6,1,298262,298262,298263,0,1,5
85185,1,3,298263,298263,298266,0,3,0
85186,4,2,298267,298267,298269,0,2,1
85187,3,3,298270,298270,298273,0,3,1
85188,1,1,298271,298273,298274,2,3,0
85189,3,2,298274,298274,298276,0,2,0
85190,4,2,298278,298278,298280,0,2,2
85191,2,2,298280,298280,298282,0,2,0
85192,5,1,298285,298285,298286,0,1,3
85193,6,3,298291,298291,298294,0,3,5
85194,1,3,298292,298294,298297,2,5,0
85195,5,2,298297,298297,298299,0,2,0
85196,3,3,298300,298300,298303,0,3,1
85197,2,2,298302,298303,298305,1,3,0
85198,2,1,298304,298305,298306,1,2,0
85199,4,1,298308,298308,298309,0,1,2
85200,1,1,298309,298309,298310,0,1,0
85201,3,3,298312,298312,298315,0,3,2
85202,5,3,298317,298317,298320,0,3,2
85203,3,2,298320,298320,298322,0,2,0
85204,4,3,298324,298324,298327,0,3,2
85205,4,3,298328,298328,298331,0,3,1
85206,1,2,298329,298331,298333,2,4,0
85207,1,1,298330,298333,298334,3,4,0
85208,4,1,298334,298334,298335,0,1,0
85209,3,2,298337,298337,298339,0,2,2
85210,4,3,298341,298341,298344,0,3,2
85211,2,1,298343,298344,298345,1,2,0
85212,2,2,298345,298345,298347,0,2,0
85213,5,2,298350,298350,298352,0,2,3
85214,5,2,298355,298355,298357,0,2,3
85215,6,2,298361,298361,298363,0,2,4
85216,1,2,298362,298363,298365,1,3,0
85217,6,2,298368,298368,298370,0,2,3
85218,2,3,298370,298370,298373,0,3,0
85219,1,1,298371,298373,298374,2,3,0
85220,1,3,298372,298374,298377,2,5,0
85221,5,1,298377,298377,298378,0,1,0
85222,1,3,298378,298378,298381,0,3,0
85223,1,3,298379,298381,298384,2,5,0
85224,1,2,298380,298384,298386,4,6,0
85225,2,1,298382,298386,298387,4,5,0
85226,1,1,298383,298387,298388,4,5,0
85227,6,1,298389,298389,298390,0,1,1
85228,5,1,298394,298394,298395,0,1,4
85229,5,3,298399,298399,298402,0,3,4
85230,4,2,298403,298403,298405,0,2,1
85231,5,2,298408,298408,298410,0,2,3
85232,1,3,298409,298410,298413,1,4,0
85233,4,2,298413,298413,298415,0,2,0
85234,1,3,298414,298415,298418,1,4,0
85235,6,3,298420,298420,298423,0,3,2
85236,5,1,298425,298425,298426,0,1,2
85237,5,1,298430,298430,298431,0,1,4
85238,6,2,298436,298436,298438,0,2,5
85239,1,3,298437,298438,298441,1,4,0
85240,2,1,298439,298441,298442,2,3,0
85241,5,1,298444,298444,298445,0,1,2
85242,1,2,298445,298445,298447,0,2,0
85243,6,2,298451,298451,298453,0,2,4
85244,4,3,298455,298455,298458,0,3,2
85245,5,3,298460,298460,298463,0,3,2
85246,1,3,298461,298463,298466,2,5,0
85247,4,2,298465,298466,298468,1,3,0
85248,6,1,298471,298471,298472,0,1,3
85249,4,1,298475,298475,298476,0,1,3
85250,5,3,298480,298480,298483,0,3,4
85251,5,3,298485,298485,298488,0,3,2
85252,1,1,298486,298488,298489,2,3,0
85253,6,3,298492,298492,298495,0,3,3
85254,3,1,298495,298495,298496,0,1,0
85255,4,1,298499,298499,298500,0,1,3
85256,4,3,298503,298503,298506,0,3,3
85257,2,1,298505,298506,298507,1,2,0
85258,6,1,298511,298511,298512,0,1,4
85259,3,3,298514,298514,298517,0,3,2
85260,2,1,298516,298517,298518,1,2,0
85261,5,1,298521,298521,298522,0,1,3
85262,3,1,298524,298524,298525,0,1,2
85263,3,1,298527,298527,298528,0,1,2
85264,1,3,298528,298528,298531,0,3,0
85265,6,1,298534,298534,298535,0,1,3
85266,4,3,298538,298538,298541,0,3,3
85267,1,1,298539,298541,298542,2,3,0
85268,2,2,298541,298542,298544,1,3,0
85269,2,3,298543,298544,298547,1,4,0
85270,2,2,298545,298547,298549,2,4,0
85271,5,1,298550,298550,298551,0,1,1
85272,3,2,298553,298553,298555,0,2,2
85273,1,3,298554,298555,298558,1,4,0
85274,6,2,298560,298560,298562,0,2,2
85275,6,3,298566,298566,298569,0,3,4
85276,2,1,298568,298569,298570,1,2,0
85277,4,1,298572,298572,298573,0,1,2
85278,4,3,298576,298576,298579,0,3,3
85279,5,2,298581,298581,298583,0,2,2
85280,4,2,298585,298585,298587,0,2,2
85281,6,1,298591,298591,298592,0,1,4
85282,6,3,298597,298597,298600,0,3,5
85283,1,1,298598,298600,298601,2,3,0
85284,5,2,298603,298603,298605,0,2,2
85285,5,1,298608,298608,298609,0,1,3
85286,1,3,298609,298609,298612,0,3,0
85287,5,3,298614,298614,298617,0,3,2
85288,5,1,298619,298619,298620,0,1,2
85289,6,2,298625,298625,298627,0,2,5
85290,1,2,298626,298627,298629,1,3,0
85291,1,3,298627,298629,298632,2,5,0
85292,3,3,298630,298632,298635,2,5,0
85293,5,3,298635,298635,298638,0,3,0
85294,2,2,298637,298638,298640,1,3,0
85295,3,3,298640,298640,298643,0,3,0
85296,6,2,298646,298646,298648,0,2,3
85297,5,1,298651,298651,298652,0,1,3
85298,5,3,298656,298656,298659,0,3,4
85299,3,1,298659,298659,298660,0,1,0
85300,6,1,298665,298665,298666,0,1,5
85301,4,1,298669,298669,298670,0,1,3
85302,4,3,298673,298673,298676,0,3,3
85303,2,3,298675,298676,298679,1,4,0
85304,6,2,298681,298681,298683,0,2,2
85305,3,1,298684,298684,298685,0,1,1
85306,4,3,298688,298688,298691,0,3,3
85307,3,3,298691,298691,298694,0,3,0
85308,2,1,298693,298694,298695,1,2,0
85309,6,3,298699,298699,298702,0,3,4
85310,2,3,298701,298702,298705,1,4,0
85311,6,3,298707,298707,298710,0,3,2
85312,1,1,298708,298710,298711,2,3,0
85313,5,3,298713,298713,298716,0,3,2
85314,3,1,298716,298716,298717,0,1,0
85315,2,2,298718,298718,298720,0,2,1
85316,6,2,298724,298724,298726,0,2,4
85317,6,2,298730,298730,298732,0,2,4
85318,6,3,298736,298736,298739,0,3,4
85319,3,1,298739,298739,298740,0,1,0
85320,5,1,298744,298744,298745,0,1,4
85321,2,2,298746,298746,298748,0,2,1
85322,2,1,298748,298748,298749,0,1,0
85323,1,3,298749,298749,298752,0,3,0
85324,2,3,298751,298752,298755,1,4,0
85325,1,3,298752,298755,298758,3,6,0
85326,6,2,298758,298758,298760,0,2,0
85327,1,3,298759,298760,298763,1,4,0
85328,1,2,298760,298763,298765,3,5,0
85329,3,3,298763,298765,298768,2,5,0
85330,1,1,298764,298768,298769,4,5,0
85331,5,3,298769,298769,298772,0,3,0
85332,6,2,298775,298775,298777,0,2,3
85333,5,2,298780,298780,298782,0,2,3
85334,6,3,298786,298786,298789,0,3,4
85335,6,1,298792,298792,298793,0,1,3
85336,4,3,298796,298796,298799,0,3,3
85337,3,2,298799,298799,298801,0,2,0
85338,1,1,298800,298801,298802,1,2,0
85339,2,2,298802,298802,298804,0,2,0
85340,6,2,298808,298808,298810,0,2,4
85341,4,3,298812,298812,298815,0,3,2
85342,4,2,298816,298816,298818,0,2,1
85343,2,2,298818,298818,298820,0,2,0
85344,2,3,298820,298820,298823,0,3,0
85345,3,3,298823,298823,298826,0,3,0
85346,6,3,298829,298829,298832,0,3,3
85347,5,2,298834,298834,298836,0,2,2
85348,1,3,298835,298836,298839,1,4,0
85349,2,1,298837,298839,298840,2,3,0
85350,2,1,298839,298840,298841,1,2,0
85351,2,1,298841,298841,298842,0,1,0
85352,1,1,298842,298842,298843,0,1,0
85353,2,1,298844,298844,298845,0,1,1
85354,3,1,298847,298847,298848,0,1,2
85355,4,2,298851,298851,298853,0,2,3
85356,1,3,298852,298853,298856,1,4,0
85357,1,2,298853,298856,298858,3,5,0
85358,4,2,298857,298858,298860,1,3,0
85359,1,3,298858,298860,298863,2,5,0
85360,2,3,298860,298863,298866,3,6,0
85361,1,3,298861,298866,298869,5,8,0
85362,5,1,298866,298869,298870,3,4,0
85363,4,2,298870,298870,298872,0,2,0
85364,3,1,298873,298873,298874,0,1,1
85365,4,2,298877,298877,298879,0,2,3
85366,2,3,298879,298879,298882,0,3,0
85367,6,2,298885,298885,298887,0,2,3
85368,6,2,298891,298891,298893,0,2,4
85369,2,1,298893,298893,298894,0,1,0
85370,2,2,298895,298895,298897,0,2,1
85371,4,2,298899,298899,298901,0,2,2
85372,4,3,298903,298903,298906,0,3,2
85373,4,3,298907,298907,298910,0,3,1
85374,6,1,298913,298913,298914,0,1,3
85375,1,1,298914,298914,298915,0,1,0
85376,5,3,298919,298919,298922,0,3,4
85377,2,3,298921,298922,298925,1,4,0
85378,5,1,298926,298926,298927,0,1,1
85379,6,3,298932,298932,298935,0,3,5
85380,6,3,298938,298938,298941,0,3,3
85381,6,1,298944,298944,298945,0,1,3
85382,1,2,298945,298945,298947,0,2,0
85383,2,2,298947,298947,298949,0,2,0
85384,1,3,298948,298949,298952,1,4,0
85385,5,2,298953,298953,298955,0,2,1
85386,5,2,298958,298958,298960,0,2,3
85387,2,2,298960,298960,298962,0,2,0
85388,1,1,298961,298962,298963,1,2,0
85389,4,1,298965,298965,298966,0,1,2
85390,2,1,298967,298967,298968,0,1,1
85391,4,2,298971,298971,298973,0,2,3
85392,2,2,298973,298973,298975,0,2,0
85393,2,2,298975,298975,298977,0,2,0
85394,4,3,298979,298979,298982,0,3,2
85395,6,3,298985,298985,298988,0,3,3
85396,4,2,298989,298989,298991,0,2,1
85397,6,3,298995,298995,298998,0,3,4
85398,4,1,298999,298999,299000,0,1,1
85399,4,2,299003,299003,299005,0,2,3
85400,4,3,299007,299007,299010,0,3,2
85401,4,2,299011,299011,299013,0,2,1
85402,1,1,299012,299013,299014,1,2,0
85403,4,2,299016,299016,299018,0,2,2
85404,1,3,299017,299018,299021,1,4,0
85405,1,2,299018,299021,299023,3,5,0
85406,3,1,299021,299023,299024,2,3,0
85407,1,3,299022,299024,299027,2,5,0
85408,1,1,299023,299027,299028,4,5,0
85409,2,1,299025,299028,299029,3,4,0
85410,6,2,299031,299031,299033,0,2,2
85411,5,1,299036,299036,299037,0,1,3
85412,2,3,299038,299038,299041,0,3,1
85413,2,2,299040,299041,299043,1,3,0
85414,3,3,299043,299043,299046,0,3,0
85415,2,2,299045,299046,299048,1,3,0
85416,3,2,299048,299048,299050,0,2,0
85417,6,3,299054,299054,299057,0,3,4
85418,4,2,299058,299058,299060,0,2,1
85419,1,3,299059,299060,299063,1,4,0
85420,6,1,299065,299065,299066,0,1,2
85421,2,2,299067,299067,299069,0,2,1
85422,6,3,299073,299073,299076,0,3,4
85423,1,3,299074,299076,299079,2,5,0
85424,3,1,299077,299079,299080,2,3,0
85425,6,1,299083,299083,299084,0,1,3
85426,6,2,299089,299089,299091,0,2,5
85427,3,3,299092,299092,299095,0,3,1
85428,6,2,299098,299098,299100,0,2,3
85429,2,2,299100,299100,299102,0,2,0
85430,3,3,299103,299103,299106,0,3,1
85431,5,1,299108,299108,299109,0,1,2
85432,2,1,299110,299110,299111,0,1,1
85433,5,1,299115,299115,299116,0,1,4
85434,6,3,299121,299121,299124,0,3,5
85435,5,2,299126,299126,299128,0,2,2
85436,5,3,299131,299131,299134,0,3,3
85437,6,2,299137,299137,299139,0,2,3
85438,3,2,299140,299140,299142,0,2,1
85439,4,2,299144,299144,299146,0,2,2
85440,2,1,299146,299146,299147,0,1,0
85441,3,1,299149,299149,299150,0,1,2
85442,3,2,299152,299152,299154,0,2,2
85443,3,3,299155,299155,299158,0,3,1
85444,5,2,299160,299160,299162,0,2,2
85445,5,2,299165,299165,299167,0,2,3
85446,6,1,299171,299171,299172,0,1,4
85447,1,3,299172,299172,299175,0,3,0
85448,6,1,299178,299178,299179,0,1,3
85449,1,1,299179,299179,299180,0,1,0
85450,1,1,299180,299180,299181,0,1,0
85451,1,3,299181,299181,299184,0,3,0
85452,4,1,299185,299185,299186,0,1,1
85453,1,2,299186,299186,299188,0,2,0
85454,4,1,299190,299190,299191,0,1,2
85455,5,1,299195,299195,299196,0,1,4
85456,5,3,299200,299200,299203,0,3,4
85457,4,1,299204,299204,299205,0,1,1
85458,5,2,299209,299209,299211,0,2,4
85459,4,3,299213,299213,299216,0,3,2
85460,4,2,299217,299217,299219,0,2,1
85461,6,2,299223,299223,299225,0,2,4
85462,4,3,299227,299227,299230,0,3,2
85463,5,1,299232,299232,299233,0,1,2
85464,5,1,299237,299237,299238,0,1,4
85465,4,1,299241,299241,299242,0,1,3
85466,2,3,299243,299243,299246,0,3,1
85467,4,2,299247,299247,299249,0,2,1
85468,6,2,299253,299253,299255,0,2,4
85469,3,1,299256,299256,299257,0,1,1
85470,6,3,299262,299262,299265,0,3,5
85471,5,2,299267,299267,299269,0,2,2
85472,4,3,299271,299271,299274,0,3,2
85473,6,1,299277,299277,299278,0,1,3
85474,6,1,299283,299283,299284,0,1,5
85475,2,3,299285,299285,299288,0,3,1
85476,3,3,299288,299288,299291,0,3,0
85477,1,3,299289,299291,299294,2,5,0
85478,2,1,299291,299294,299295,3,4,0
85479,6,2,299297,299297,299299,0,2,2
85480,2,3,299299,299299,299302,0,3,0
85481,5,3,299304,299304,299307,0,3,2
85482,6,1,299310,299310,299311,0,1,3
85483,3,2,299313,299313,299315,0,2,2
85484,5,3,299318,299318,299321,0,3,3
85485,4,2,299322,299322,299324,0,2,1
85486,2,3,299324,299324,299327,0,3,0
85487,5,1,299329,299329,299330,0,1,2
85488,3,3,299332,299332,299335,0,3,2
85489,3,2,299335,299335,299337,0,2,0
85490,2,2,299337,299337,299339,0,2,0
85491,2,1,299339,299339,299340,0,1,0
85492,1,3,299340,299340,299343,0,3,0
85493,1,1,299341,299343,299344,2,3,0
85494,2,2,299343,299344,299346,1,3,0
85495,2,1,299345,299346,299347,1,2,0
85496,3,3,299348,299348,299351,0,3,1
85497,2,3,299350,299351,299354,1,4,0
85498,1,3,299351,299354,299357,3,6,0
85499,2,2,299353,299357,299359,4,6,0
85500,1,3,299354,299359,299362,5,8,0
85501,5,2,299359,299362,299364,3,5,0
85502,2,1,299361,299364,299365,3,4,0
85503,2,1,299363,299365,299366,2,3,0
85504,3,2,299366,299366,299368,0,2,0
85505,4,1,299370,299370,299371,0,1,2
85506,4,1,299374,299374,299375,0,1,3
85507,3,3,299377,299377,299380,0,3,2
85508,1,3,299378,299380,299383,2,5,0
85509,2,2,299380,299383,299385,3,5,0
85510,2,3,299382,299385,299388,3,6,0
85511,6,1,299388,299388,299389,0,1,0
85512,3,1,299391,299391,299392,0,1,2
85513,1,2,299392,299392,299394,0,2,0
85514,5,3,299397,299397,299400,0,3,3
85515,4,1,299401,299401,299402,0,1,1
85516,2,1,299403,299403,299404,0,1,1
85517,2,1,299405,299405,299406,0,1,1
85518,2,3,299407,299407,299410,0,3,1
85519,1,2,299408,299410,299412,2,4,0
85520,5,3,299413,299413,299416,0,3,1
85521,5,2,299418,299418,299420,0,2,2
85522,1,2,299419,299420,299422,1,3,0
85523,5,2,299424,299424,299426,0,2,2
85524,3,1,299427,299427,299428,0,1,1
85525,3,2,299430,299430,299432,0,2,2
85526,6,2,299436,299436,299438,0,2,4
85527,6,2,299442,299442,299444,0,2,4
85528,5,1,299447,299447,299448,0,1,3
85529,2,1,299449,299449,299450,0,1,1
85530,4,2,299453,299453,299455,0,2,3
85531,1,3,299454,299455,299458,1,4,0
85532,6,3,299460,299460,299463,0,3,2
85533,5,2,299465,299465,299467,0,2,2
85534,6,2,299471,299471,299473,0,2,4
85535,4,2,299475,299475,299477,0,2,2
85536,6,1,299481,299481,299482,0,1,4
85537,5,3,299486,299486,299489,0,3,4
85538,4,2,299490,299490,299492,0,2,1
85539,1,2,299491,299492,299494,1,3,0
85540,5,1,299496,299496,299497,0,1,2
85541,3,3,299499,299499,299502,0,3,2
85542,1,1,299500,299502,299503,2,3,0
85543,5,3,299505,299505,299508,0,3,2
85544,5,2,299510,299510,299512,0,2,2
85545,1,3,299511,299512,299515,1,4,0
85546,6,2,299517,299517,299519,0,2,2
85547,6,3,299523,299523,299526,0,3,4
85548,6,2,299529,299529,299531,0,2,3
85549,6,2,299535,299535,299537,0,2,4
85550,4,3,299539,299539,299542,0,3,2
85551,1,1,299540,299542,299543,2,3,0
85552,3,2,299543,299543,299545,0,2,0
85553,3,3,299546,299546,299549,0,3,1
85554,1,1,299547,299549,299550,2,3,0
85555,1,3,299548,299550,299553,2,5,0
85556,2,1,299550,299553,299554,3,4,0
85557,4,2,299554,299554,299556,0,2,0
85558,2,1,299556,299556,299557,0,1,0
85559,5,1,299561,299561,299562,0,1,4
85560,3,2,299564,299564,299566,0,2,2
85561,4,2,299568,299568,299570,0,2,2
85562,2,3,299570,299570,299573,0,3,0
85563,1,2,299571,299573,299575,2,4,0
85564,6,3,299577,299577,299580,0,3,2
85565,5,2,299582,299582,299584,0,2,2
85566,3,2,299585,299585,299587,0,2,1
85567,3,1,299588,299588,299589,0,1,1
85568,1,3,299589,299589,299592,0,3,0
85569,1,3,299590,299592,299595,2,5,0
85570,2,3,299592,299595,299598,3,6,0
85571,6,1,299598,299598,299599,0,1,0
85572,3,1,299601,299601,299602,0,1,2
85573,3,1,299604,299604,299605,0,1,2
85574,5,1,299609,299609,299610,0,1,4
85575,2,3,299611,299611,299614,0,3,1
85576,5,1,299616,299616,299617,0,1,2
85577,2,3,299618,299618,299621,0,3,1
85578,4,2,299622,299622,299624,0,2,1
85579,5,2,299627,299627,299629,0,2,3
85580,3,1,299630,299630,299631,0,1,1
85581,1,3,299631,299631,299634,0,3,0
85582,3,2,299634,299634,299636,0,2,0
85583,6,3,299640,299640,299643,0,3,4
85584,2,2,299642,299643,299645,1,3,0
85585,2,1,299644,299645,299646,1,2,0
85586,2,1,299646,299646,299647,0,1,0
85587,3,2,299649,299649,299651,0,2,2
85588,2,3,299651,299651,299654,0,3,0
85589,2,3,299653,299654,299657,1,4,0
85590,3,2,299656,299657,299659,1,3,0
85591,5,3,299661,299661,299664,0,3,2
85592,6,1,299667,299667,299668,0,1,3
85593,2,1,299669,299669,299670,0,1,1
85594,1,1,299670,299670,299671,0,1,0
85595,1,1,299671,299671,299672,0,1,0
85596,6,3,299677,299677,299680,0,3,5
85597,1,3,299678,299680,299683,2,5,0
85598,5,3,299683,299683,299686,0,3,0
85599,4,2,299687,299687,299689,0,2,1
85600,4,1,299691,299691,299692,0,1,2
85601,4,1,299695,299695,299696,0,1,3
85602,4,3,299699,299699,299702,0,3,3
85603,5,3,299704,299704,299707,0,3,2
85604,2,2,299706,299707,299709,1,3,0
85605,4,3,299710,299710,299713,0,3,1
85606,6,2,299716,299716,299718,0,2,3
85607,5,1,299721,299721,299722,0,1,3
85608,3,3,299724,299724,299727,0,3,2
85609,3,2,299727,299727,299729,0,2,0
85610,5,2,299732,299732,299734,0,2,3
85611,2,2,299734,299734,299736,0,2,0
85612,3,3,299737,299737,299740,0,3,1
85613,4,2,299741,299741,299743,0,2,1
85614,4,3,299745,299745,299748,0,3,2
85615,3,3,299748,299748,299751,0,3,0
85616,4,2,299752,299752,299754,0,2,1
85617,1,3,299753,299754,299757,1,4,0
85618,4,2,299757,299757,299759,0,2,0
85619,5,1,299762,299762,299763,0,1,3
85620,5,3,299767,299767,299770,0,3,4
85621,4,2,299771,299771,299773,0,2,1
85622,2,3,299773,299773,299776,0,3,0
85623,4,3,299777,299777,299780,0,3,1
85624,5,2,299782,299782,299784,0,2,2
85625,1,3,299783,299784,299787,1,4,0
85626,1,3,299784,299787,299790,3,6,0
85627,5,1,299789,299790,299791,1,2,0
85628,4,3,299793,299793,299796,0,3,2
85629,4,3,299797,299797,299800,0,3,1
85630,2,1,299799,299800,299801,1,2,0
85631,5,2,299804,299804,299806,0,2,3
85632,4,1,299808,299808,299809,0,1,2
85633,6,3,299814,299814,299817,0,3,5
85634,5,1,299819,299819,299820,0,1,2
85635,5,3,299824,299824,299827,0,3,4
85636,5,2,299829,299829,299831,0,2,2
85637,6,1,299835,299835,299836,0,1,4
85638,4,1,299839,299839,299840,0,1,3
85639,3,1,299842,299842,299843,0,1,2
85640,4,3,299846,299846,299849,0,3,3
85641,6,2,299852,299852,299854,0,2,3
85642,3,1,299855,299855,299856,0,1,1
85643,4,1,299859,299859,299860,0,1,3
85644,2,3,299861,299861,299864,0,3,1
85645,5,2,299866,299866,299868,0,2,2
85646,4,2,299870,299870,299872,0,2,2
85647,4,3,299874,299874,299877,0,3,2
85648,1,1,299875,299877,299878,2,3,0
85649,2,3,299877,299878,299881,1,4,0
85650,6,3,299883,299883,299886,0,3,2
85651,6,1,299889,299889,299890,0,1,3
85652,5,1,299894,299894,299895,0,1,4
85653,6,1,299900,299900,299901,0,1,5
85654,6,2,299906,299906,299908,0,2,5
85655,4,2,299910,299910,299912,0,2,2
85656,2,3,299912,299912,299915,0,3,0
85657,5,2,299917,299917,299919,0,2,2
85658,1,2,299918,299919,299921,1,3,0
85659,5,1,299923,299923,299924,0,1,2
85660,3,3,299926,299926,299929,0,3,2
85661,3,2,299929,299929,299931,0,2,0
85662,1,2,299930,299931,299933,1,3,0
85663,2,2,299932,299933,299935,1,3,0
85664,3,1,299935,299935,299936,0,1,0
85665,2,3,299937,299937,299940,0,3,1
85666,5,1,299942,299942,299943,0,1,2
85667,6,1,299948,299948,299949,0,1,5
85668,1,3,299949,299949,299952,0,3,0
85669,1,2,299950,299952,299954,2,4,0
85670,4,2,299954,299954,299956,0,2,0
85671,1,1,299955,299956,299957,1,2,0
85672,5,3,299960,299960,299963,0,3,3
85673,6,1,299966,299966,299967,0,1,3
85674,1,2,299967,299967,299969,0,2,0
85675,2,3,299969,299969,299972,0,3,0
85676,4,2,299973,299973,299975,0,2,1
85677,4,2,299977,299977,299979,0,2,2
85678,5,1,299982,299982,299983,0,1,3
85679,1,2,299983,299983,299985,0,2,0
85680,4,2,299987,299987,299989,0,2,2
85681,3,3,299990,299990,299993,0,3,1
85682,3,2,299993,299993,299995,0,2,0
85683,6,1,299999,299999,300000,0,1,4
85684,6,3,300005,300005,300008,0,3,5
85685,4,1,300009,300009,300010,0,1,1
85686,1,3,300010,300010,300013,0,3,0
85687,6,3,300016,300016,300019,0,3,3
85688,2,3,300018,300019,300022,1,4,0
85689,2,2,300020,300022,300024,2,4,0
85690,3,1,300023,300024,300025,1,2,0
85691,3,2,300026,300026,300028,0,2,1
85692,6,1,300032,300032,300033,0,1,4
85693,6,1,300038,300038,300039,0,1,5
85694,3,2,300041,300041,300043,0,2,2
85695,2,1,300043,300043,300044,0,1,0
85696,5,3,300048,300048,300051,0,3,4
85697,1,1,300049,300051,300052,2,3,0
85698,3,1,300052,300052,300053,0,1,0
85699,4,2,300056,300056,300058,0,2,3
85700,3,3,300059,300059,300062,0,3,1
85701,4,3,300063,300063,300066,0,3,1
85702,1,2,300064,300066,300068,2,4,0
85703,1,3,300065,300068,300071,3,6,0
85704,5,1,300070,300071,300072,1,2,0
85705,6,3,300076,300076,300079,0,3,4
85706,1,2,300077,300079,300081,2,4,0
85707,5,2,300082,300082,300084,0,2,1
85708,4,1,300086,300086,300087,0,1,2
85709,5,2,300091,300091,300093,0,2,4
85710,2,3,300093,300093,300096,0,3,0
85711,3,2,300096,300096,300098,0,2,0
85712,4,2,300100,300100,300102,0,2,2
85713,5,2,300105,300105,300107,0,2,3
85714,1,2,300106,300107,300109,1,3,0
85715,5,2,300111,300111,300113,0,2,2
85716,6,1,300117,300117,300118,0,1,4
85717,5,2,300122,300122,300124,0,2,4
85718,2,1,300124,300124,300125,0,1,0
85719,3,1,300127,300127,300128,0,1,2
85720,4,3,300131,300131,300134,0,3,3
85721,2,1,300133,300134,300135,1,2,0
85722,2,1,300135,300135,300136,0,1,0
85723,3,2,300138,300138,300140,0,2,2
85724,2,3,300140,300140,300143,0,3,0
85725,5,3,300145,300145,300148,0,3,2
85726,5,2,300150,300150,300152,0,2,2
85727,4,2,300154,300154,300156,0,2,2
85728,6,1,300160,300160,300161,0,1,4
85729,3,2,300163,300163,300165,0,2,2
85730,4,2,300167,300167,300169,0,2,2
85731,3,3,300170,300170,300173,0,3,1
85732,6,1,300176,300176,300177,0,1,3
85733,2,3,300178,300178,300181,0,3,1
85734,3,1,300181,300181,300182,0,1,0
85735,4,1,300185,300185,300186,0,1,3
85736,6,1,300191,300191,300192,0,1,5
85737,2,3,300193,300193,300196,0,3,1
85738,2,2,300195,300196,300198,1,3,0
85739,2,2,300197,300198,300200,1,3,0
85740,3,3,300200,300200,300203,0,3,0
85741,3,3,300203,300203,300206,0,3,0
85742,1,2,300204,300206,300208,2,4,0
85743,5,3,300209,300209,300212,0,3,1
85744,2,2,300211,300212,300214,1,3,0
85745,1,3,300212,300214,300217,2,5,0
85746,4,2,300216,300217,300219,1,3,0
85747,3,2,300219,300219,300221,0,2,0
85748,4,1,300223,300223,300224,0,1,2
85749,4,1,300227,300227,300228,0,1,3
85750,4,3,300231,300231,300234,0,3,3
85751,1,3,300232,300234,300237,2,5,0
85752,2,1,300234,300237,300238,3,4,0
85753,1,2,300235,300238,300240,3,5,0
85754,3,1,300238,300240,300241,2,3,0
85755,1,2,300239,300241,300243,2,4,0
85756,3,2,300242,300243,300245,1,3,0
85757,2,3,300244,300245,300248,1,4,0
85758,4,3,300248,300248,300251,0,3,0
85759,5,2,300253,300253,300255,0,2,2
85760,4,2,300257,300257,300259,0,2,2
85761,2,3,300259,300259,300262,0,3,0
85762,6,1,300265,300265,300266,0,1,3
85763,5,1,300270,300270,300271,0,1,4
85764,3,2,300273,300273,300275,0,2,2
85765,4,2,300277,300277,300279,0,2,2
85766,2,1,300279,300279,300280,0,1,0
85767,1,1,300280,300280,300281,0,1,0
85768,6,2,300286,300286,300288,0,2,5
85769,3,3,300289,300289,300292,0,3,1
85770,6,3,300295,300295,300298,0,3,3
85771,6,2,300301,300301,300303,0,2,3
85772,5,1,300306,300306,300307,0,1,3
85773,6,2,300312,300312,300314,0,2,5
85774,6,1,300318,300318,300319,0,1,4
85775,3,1,300321,300321,300322,0,1,2
85776,5,3,300326,300326,300329,0,3,4
85777,3,3,300329,300329,300332,0,3,0
85778,4,1,300333,300333,300334,0,1,1
85779,5,1,300338,300338,300339,0,1,4
85780,2,3,300340,300340,300343,0,3,1
85781,6,1,300346,300346,300347,0,1,3
85782,1,2,300347,300347,300349,0,2,0
85783,3,1,300350,300350,300351,0,1,1
85784,6,3,300356,300356,300359,0,3,5
85785,4,1,300360,300360,300361,0,1,1
85786,2,1,300362,300362,300363,0,1,1
85787,6,2,300368,300368,300370,0,2,5
85788,2,1,300370,300370,300371,0,1,0
85789,6,1,300376,300376,300377,0,1,5
85790,4,2,300380,300380,300382,0,2,3
85791,4,3,300384,300384,300387,0,3,2
85792,6,1,300390,300390,300391,0,1,3
85793,6,1,300396,300396,300397,0,1,5
85794,4,3,300400,300400,300403,0,3,3
85795,3,3,300403,300403,300406,0,3,0
85796,3,2,300406,300406,300408,0,2,0
85797,3,2,300409,300409,300411,0,2,1
85798,3,3,300412,300412,300415,0,3,1
85799,1,3,300413,300415,300418,2,5,0
85800,5,2,300418,300418,300420,0,2,0
85801,3,3,300421,300421,300424,0,3,1
85802,5,3,300426,300426,300429,0,3,2
85803,5,2,300431,300431,300433,0,2,2
85804,2,3,300433,300433,300436,0,3,0
85805,1,2,300434,300436,300438,2,4,0
85806,6,3,300440,300440,300443,0,3,2
85807,5,3,300445,300445,300448,0,3,2
85808,6,2,300451,300451,300453,0,2,3
85809,1,2,300452,300453,300455,1,3,0
85810,2,2,300454,300455,300457,1,3,0
85811,4,3,300458,300458,300461,0,3,1
85812,6,3,300464,300464,300467,0,3,3
85813,3,1,300467,300467,300468,0,1,0
85814,2,3,300469,300469,300472,0,3,1
85815,3,2,300472,300472,300474,0,2,0
85816,6,1,300478,300478,300479,0,1,4
85817,1,1,300479,300479,300480,0,1,0
85818,1,2,300480,300480,300482,0,2,0
85819,3,1,300483,300483,300484,0,1,1
85820,5,2,300488,300488,300490,0,2,4
85821,2,3,300490,300490,300493,0,3,0
85822,1,3,300491,300493,300496,2,5,0
85823,6,1,300497,300497,300498,0,1,1
85824,4,3,300501,300501,300504,0,3,3
85825,3,1,300504,300504,300505,0,1,0
85826,1,2,300505,300505,300507,0,2,0
85827,5,1,300510,300510,300511,0,1,3
85828,3,1,300513,300513,300514,0,1,2
85829,3,2,300516,300516,300518,0,2,2
85830,6,2,300522,300522,300524,0,2,4
85831,1,3,300523,300524,300527,1,4,0
85832,5,1,300528,300528,300529,0,1,1
85833,6,1,300534,300534,300535,0,1,5
85834,2,3,300536,300536,300539,0,3,1
85835,2,2,300538,300539,300541,1,3,0
85836,3,1,300541,300541,300542,0,1,0
85837,5,1,300546,300546,300547,0,1,4
85838,4,2,300550,300550,300552,0,2,3
85839,5,1,300555,300555,300556,0,1,3
85840,3,3,300558,300558,300561,0,3,2
85841,6,1,300564,300564,300565,0,1,3
85842,5,1,300569,300569,300570,0,1,4
85843,4,1,300573,300573,300574,0,1,3
85844,1,3,300574,300574,300577,0,3,0
85845,3,2,300577,300577,300579,0,2,0
85846,2,2,300579,300579,300581,0,2,0
85847,3,3,300582,300582,300585,0,3,1
85848,6,2,300588,300588,300590,0,2,3
85849,3,3,300591,300591,300594,0,3,1
85850,3,2,300594,300594,300596,0,2,0
85851,1,1,300595,300596,300597,1,2,0
85852,1,3,300596,300597,300600,1,4,0
85853,1,1,300597,300600,300601,3,4,0
85854,1,3,300598,300601,300604,3,6,0
85855,4,1,300602,300604,300605,2,3,0
85856,6,1,300608,300608,300609,0,1,3
85857,4,1,300612,300612,300613,0,1,3
85858,2,3,300614,300614,300617,0,3,1
85859,2,2,300616,300617,300619,1,3,0
85860,6,2,300622,300622,300624,0,2,3
85861,3,3,300625,300625,300628,0,3,1
85862,3,3,300628,300628,300631,0,3,0
85863,5,3,300633,300633,300636,0,3,2
85864,4,2,300637,300637,300639,0,2,1
85865,6,3,300643,300643,300646,0,3,4
85866,5,3,300648,300648,300651,0,3,2
85867,1,2,300649,300651,300653,2,4,0
85868,3,3,300652,300653,300656,1,4,0
85869,4,1,300656,300656,300657,0,1,0
85870,1,2,300657,300657,300659,0,2,0
85871,2,2,300659,300659,300661,0,2,0
85872,6,1,300665,300665,300666,0,1,4
85873,6,3,300671,300671,300674,0,3,5
85874,3,2,300674,300674,300676,0,2,0
85875,5,1,300679,300679,300680,0,1,3
85876,2,3,300681,300681,300684,0,3,1
85877,6,2,300687,300687,300689,0,2,3
85878,3,2,300690,300690,300692,0,2,1
85879,4,2,300694,300694,300696,0,2,2
85880,2,2,300696,300696,300698,0,2,0
85881,4,3,300700,300700,300703,0,3,2
85882,5,2,300705,300705,300707,0,2,2
85883,2,2,300707,300707,300709,0,2,0
85884,3,1,300710,300710,300711,0,1,1
85885,1,1,300711,300711,300712,0,1,0
85886,4,2,300715,300715,300717,0,2,3
85887,3,3,300718,300718,300721,0,3,1
85888,4,2,300722,300722,300724,0,2,1
85889,6,2,300728,300728,300730,0,2,4
85890,2,3,300730,300730,300733,0,3,0
85891,3,1,300733,300733,300734,0,1,0
85892,1,1,300734,300734,300735,0,1,0
85893,4,3,300738,300738,300741,0,3,3
85894,2,3,300740,300741,300744,1,4,0
85895,5,2,300745,300745,300747,0,2,1
85896,3,2,300748,300748,300750,0,2,1
85897,6,3,300754,300754,300757,0,3,4
85898,5,1,300759,300759,300760,0,1,2
85899,2,3,300761,300761,300764,0,3,1
85900,2,2,300763,300764,300766,1,3,0
85901,3,1,300766,300766,300767,0,1,0
85902,1,3,300767,300767,300770,0,3,0
85903,3,1,300770,300770,300771,0,1,0
85904,6,3,300776,300776,300779,0,3,5
85905,3,3,300779,300779,300782,0,3,0
85906,2,3,300781,300782,300785,1,4,0
85907,2,3,300783,300785,300788,2,5,0
85908,2,2,300785,300788,300790,3,5,0
85909,4,2,300789,300790,300792,1,3,0
85910,2,2,300791,300792,300794,1,3,0
85911,5,1,300796,300796,300797,0,1,2
85912,2,3,300798,300798,300801,0,3,1
85913,5,2,300803,300803,300805,0,2,2
85914,4,2,300807,300807,300809,0,2,2
85915,6,1,300813,300813,300814,0,1,4
85916,2,2,300815,300815,300817,0,2,1
85917,2,1,300817,300817,300818,0,1,0
85918,6,1,300823,300823,300824,0,1,5
85919,6,1,300829,300829,300830,0,1,5
85920,6,2,300835,300835,300837,0,2,5
85921,5,2,300840,300840,300842,0,2,3
85922,5,1,300845,300845,300846,0,1,3
85923,5,3,300850,300850,300853,0,3,4
85924,5,2,300855,300855,300857,0,2,2
85925,6,1,300861,300861,300862,0,1,4
85926,1,3,300862,300862,300865,0,3,0
85927,5,3,300867,300867,300870,0,3,2
85928,6,3,300873,300873,300876,0,3,3
85929,6,2,300879,300879,300881,0,2,3
85930,1,1,300880,300881,300882,1,2,0
85931,2,3,300882,300882,300885,0,3,0
85932,1,3,300883,300885,300888,2,5,0
85933,4,1,300887,300888,300889,1,2,0
85934,3,1,300890,300890,300891,0,1,1
85935,5,3,300895,300895,300898,0,3,4
85936,3,3,300898,300898,300901,0,3,0
85937,6,2,300904,300904,300906,0,2,3
85938,6,2,300910,300910,300912,0,2,4
85939,1,3,300911,300912,300915,1,4,0
85940,2,3,300913,300915,300918,2,5,0
85941,2,2,300915,300918,300920,3,5,0
85942,1,1,300916,300920,300921,4,5,0
85943,3,1,300919,300921,300922,2,3,0
85944,3,2,300922,300922,300924,0,2,0
85945,5,3,300927,300927,300930,0,3,3
85946,4,1,300931,300931,300932,0,1,1
85947,4,2,300935,300935,300937,0,2,3
85948,1,1,300936,300937,300938,1,2,0
85949,3,1,300939,300939,300940,0,1,1
85950,4,3,300943,300943,300946,0,3,3
85951,2,1,300945,300946,300947,1,2,0
85952,3,3,300948,300948,300951,0,3,1
85953,5,3,300953,300953,300956,0,3,2
85954,6,1,300959,300959,300960,0,1,3
85955,6,2,300965,300965,300967,0,2,5
85956,3,3,300968,300968,300971,0,3,1
85957,3,3,300971,300971,300974,0,3,0
85958,1,3,300972,300974,300977,2,5,0
85959,4,1,300976,300977,300978,1,2,0
85960,1,2,300977,300978,300980,1,3,0
85961,1,3,300978,300980,300983,2,5,0
85962,2,3,300980,300983,300986,3,6,0
85963,1,2,300981,300986,300988,5,7,0
85964,4,1,300985,300988,300989,3,4,0
85965,1,3,300986,300989,300992,3,6,0
85966,6,2,300992,300992,300994,0,2,0
85967,6,1,300998,300998,300999,0,1,4
85968,5,1,301003,301003,301004,0,1,4
85969,3,1,301006,301006,301007,0,1,2
85970,3,3,301009,301009,301012,0,3,2
85971,4,2,301013,301013,301015,0,2,1
85972,1,1,301014,301015,301016,1,2,0
85973,3,1,301017,301017,301018,0,1,1
85974,6,3,301023,301023,301026,0,3,5
85975,5,3,301028,301028,301031,0,3,2
85976,2,1,301030,301031,301032,1,2,0
85977,1,1,301031,301032,301033,1,2,0
85978,1,1,301032,301033,301034,1,2,0
85979,4,3,301036,301036,301039,0,3,2
85980,4,3,301040,301040,301043,0,3,1
85981,4,1,301044,301044,301045,0,1,1
85982,2,1,301046,301046,301047,0,1,1
85983,5,1,301051,301051,301052,0,1,4
85984,4,2,301055,301055,301057,0,2,3
85985,5,1,301060,301060,301061,0,1,3
85986,3,3,301063,301063,301066,0,3,2
85987,6,3,301069,301069,301072,0,3,3
85988,1,2,301070,301072,301074,2,4,0
85989,3,1,301073,301074,301075,1,2,0
85990,2,2,301075,301075,301077,0,2,0
85991,2,1,301077,301077,301078,0,1,0
85992,3,3,301080,301080,301083,0,3,2
85993,4,2,301084,301084,301086,0,2,1
85994,1,1,301085,301086,301087,1,2,0
85995,4,1,301089,301089,301090,0,1,2
85996,2,1,301091,301091,301092,0,1,1
85997,3,2,301094,301094,301096,0,2,2
85998,6,3,301100,301100,301103,0,3,4
85999,4,2,301104,301104,301106,0,2,1
86000,2,2,301106,301106,301108,0,2,0
86001,1,3,301107,301108,301111,1,4,0
86002,5,2,301112,301112,301114,0,2,1
86003,4,3,301116,301116,301119,0,3,2
86004,3,2,301119,301119,301121,0,2,0
86005,6,2,301125,301125,301127,0,2,4
86006,2,3,301127,301127,301130,0,3,0
86007,5,1,301132,301132,301133,0,1,2
86008,5,3,301137,301137,301140,0,3,4
86009,1,1,301138,301140,301141,2,3,0
86010,6,3,301144,301144,301147,0,3,3
86011,6,1,301150,301150,301151,0,1,3
86012,3,1,301153,301153,301154,0,1,2
86013,3,1,301156,301156,301157,0,1,2
86014,3,1,301159,301159,301160,0,1,2
86015,3,1,301162,301162,301163,0,1,2
86016,4,3,301166,301166,301169,0,3,3
86017,4,3,301170,301170,301173,0,3,1
86018,4,2,301174,301174,301176,0,2,1
86019,2,3,301176,301176,301179,0,3,0
86020,3,2,301179,301179,301181,0,2,0
86021,6,3,301185,301185,301188,0,3,4
86022,2,1,301187,301188,301189,1,2,0
86023,6,2,301193,301193,301195,0,2,4
86024,2,1,301195,301195,301196,0,1,0
86025,2,3,301197,301197,301200,0,3,1
86026,1,3,301198,301200,301203,2,5,0
86027,1,2,301199,301203,301205,4,6,0
86028,1,3,301200,301205,301208,5,8,0
86029,5,3,301205,301208,301211,3,6,0
86030,6,2,301211,301211,301213,0,2,0
86031,2,1,301213,301213,301214,0,1,0
86032,2,2,301215,301215,301217,0,2,1
86033,4,2,301219,301219,301221,0,2,2
86034,5,3,301224,301224,301227,0,3,3
86035,3,1,301227,301227,301228,0,1,0
86036,6,3,301233,301233,301236,0,3,5
86037,1,3,301234,301236,301239,2,5,0
86038,5,2,301239,301239,301241,0,2,0
86039,6,1,301245,301245,301246,0,1,4
86040,4,1,301249,301249,301250,0,1,3
86041,5,3,301254,301254,301257,0,3,4
86042,2,2,301256,301257,301259,1,3,0
86043,6,3,301262,301262,301265,0,3,3
86044,6,3,301268,301268,301271,0,3,3
86045,2,1,301270,301271,301272,1,2,0
86046,4,2,301274,301274,301276,0,2,2
86047,6,2,301280,301280,301282,0,2,4
86048,1,2,301281,301282,301284,1,3,0
86049,6,1,301287,301287,301288,0,1,3
86050,3,3,301290,301290,301293,0,3,2
86051,2,3,301292,301293,301296,1,4,0
86052,5,1,301297,301297,301298,0,1,1
86053,1,3,301298,301298,301301,0,3,0
86054,1,2,301299,301301,301303,2,4,0
86055,6,1,301305,301305,301306,0,1,2
86056,5,2,301310,301310,301312,0,2,4
86057,6,2,301316,301316,301318,0,2,4
86058,4,1,301320,301320,301321,0,1,2
86059,5,1,301325,301325,301326,0,1,4
86060,1,2,301326,301326,301328,0,2,0
86061,1,3,301327,301328,301331,1,4,0
86062,4,2,301331,301331,301333,0,2,0
86063,6,1,301337,301337,301338,0,1,4
86064,1,3,301338,301338,301341,0,3,0
86065,3,2,301341,301341,301343,0,2,0
86066,1,1,301342,301343,301344,1,2,0
86067,2,1,301344,301344,301345,0,1,0
86068,3,1,301347,301347,301348,0,1,2
86069,2,1,301349,301349,301350,0,1,1
86070,4,2,301353,301353,301355,0,2,3
86071,3,2,301356,301356,301358,0,2,1
86072,5,1,301361,301361,301362,0,1,3
86073,6,1,301367,301367,301368,0,1,5
86074,4,2,301371,301371,301373,0,2,3
86075,6,2,301377,301377,301379,0,2,4
86076,6,3,301383,301383,301386,0,3,4
86077,2,1,301385,301386,301387,1,2,0
86078,3,3,301388,301388,301391,0,3,1
86079,5,3,301393,301393,301396,0,3,2
86080,4,1,301397,301397,301398,0,1,1
86081,2,2,301399,301399,301401,0,2,1
86082,2,3,301401,301401,301404,0,3,0
86083,1,2,301402,301404,301406,2,4,0
86084,2,2,301404,301406,301408,2,4,0
86085,4,2,301408,301408,301410,0,2,0
86086,5,1,301413,301413,301414,0,1,3
86087,3,2,301416,301416,301418,0,2,2
86088,1,1,301417,301418,301419,1,2,0
86089,3,3,301420,301420,301423,0,3,1
86090,2,1,301422,301423,301424,1,2,0
86091,3,2,301425,301425,301427,0,2,1
86092,2,3,301427,301427,301430,0,3,0
86093,3,2,301430,301430,301432,0,2,0
86094,5,1,301435,301435,301436,0,1,3
86095,4,3,301439,301439,301442,0,3,3
86096,2,2,301441,301442,301444,1,3,0
86097,2,3,301443,301444,301447,1,4,0
86098,4,3,301447,301447,301450,0,3,0
86099,4,3,301451,301451,301454,0,3,1
86100,2,3,301453,301454,301457,1,4,0
86101,2,1,301455,301457,301458,2,3,0
86102,6,2,301461,301461,301463,0,2,3
86103,2,3,301463,301463,301466,0,3,0
86104,1,2,301464,301466,301468,2,4,0
86105,6,2,301470,301470,301472,0,2,2
86106,6,1,301476,301476,301477,0,1,4
86107,5,3,301481,301481,301484,0,3,4
86108,6,2,301487,301487,301489,0,2,3
86109,4,3,301491,301491,301494,0,3,2
86110,5,3,301496,301496,301499,0,3,2
86111,4,1,301500,301500,301501,0,1,1
86112,3,1,301503,301503,301504,0,1,2
86113,3,3,301506,301506,301509,0,3,2
86114,1,2,301507,301509,301511,2,4,0
86115,2,1,301509,301511,301512,2,3,0
86116,3,3,301512,301512,301515,0,3,0
86117,4,3,301516,301516,301519,0,3,1
86118,2,1,301518,301519,301520,1,2,0
86119,5,1,301523,301523,301524,0,1,3
86120,4,2,301527,301527,301529,0,2,3
86121,5,1,301532,301532,301533,0,1,3
86122,2,2,301534,301534,301536,0,2,1
86123,4,1,301538,301538,301539,0,1,2
86124,1,3,301539,301539,301542,0,3,0
86125,2,1,301541,301542,301543,1,2,0
86126,6,1,301547,301547,301548,0,1,4
86127,1,1,301548,301548,301549,0,1,0
86128,3,3,301551,301551,301554,0,3,2
86129,1,2,301552,301554,301556,2,4,0
86130,4,1,301556,301556,301557,0,1,0
86131,3,3,301559,301559,301562,0,3,2
86132,2,2,301561,301562,301564,1,3,0
86133,2,3,301563,301564,301567,1,4,0
86134,5,3,301568,301568,301571,0,3,1
86135,1,2,301569,301571,301573,2,4,0
86136,5,2,301574,301574,301576,0,2,1
86137,5,1,301579,301579,301580,0,1,3
86138,2,1,301581,301581,301582,0,1,1
86139,2,1,301583,301583,301584,0,1,1
86140,4,2,301587,301587,301589,0,2,3
86141,5,2,301592,301592,301594,0,2,3
86142,4,2,301596,301596,301598,0,2,2
86143,3,1,301599,301599,301600,0,1,1
86144,2,1,301601,301601,301602,0,1,1
86145,6,3,301607,301607,301610,0,3,5
86146,3,3,301610,301610,301613,0,3,0
86147,4,1,301614,301614,301615,0,1,1
86148,2,3,301616,301616,301619,0,3,1
86149,5,1,301621,301621,301622,0,1,2
86150,3,2,301624,301624,301626,0,2,2
86151,6,2,301630,301630,301632,0,2,4
86152,4,3,301634,301634,301637,0,3,2
86153,6,1,301640,301640,301641,0,1,3
86154,4,2,301644,301644,301646,0,2,3
86155,3,1,301647,301647,301648,0,1,1
86156,3,1,301650,301650,301651,0,1,2
86157,2,3,301652,301652,301655,0,3,1
86158,6,1,301658,301658,301659,0,1,3
86159,2,1,301660,301660,301661,0,1,1
86160,5,2,301665,301665,301667,0,2,4
86161,4,3,301669,301669,301672,0,3,2
86162,6,3,301675,301675,301678,0,3,3
86163,5,1,301680,301680,301681,0,1,2
86164,4,2,301684,301684,301686,0,2,3
86165,3,3,301687,301687,301690,0,3,1
86166,6,2,301693,301693,301695,0,2,3
86167,5,1,301698,301698,301699,0,1,3
86168,2,1,301700,301700,301701,0,1,1
86169,4,2,301704,301704,301706,0,2,3
86170,1,3,301705,301706,301709,1,4,0
86171,3,1,301708,301709,301710,1,2,0
86172,4,1,301712,301712,301713,0,1,2
86173,2,2,301714,301714,301716,0,2,1
86174,4,2,301718,301718,301720,0,2,2
86175,5,3,301723,301723,301726,0,3,3
86176,6,1,301729,301729,301730,0,1,3
86177,4,3,301733,301733,301736,0,3,3
86178,6,2,301739,301739,301741,0,2,3
86179,4,1,301743,301743,301744,0,1,2
86180,5,1,301748,301748,301749,0,1,4
86181,2,2,301750,301750,301752,0,2,1
86182,4,1,301754,301754,301755,0,1,2
86183,3,3,301757,301757,301760,0,3,2
86184,4,1,301761,301761,301762,0,1,1
86185,2,3,301763,301763,301766,0,3,1
86186,3,2,301766,301766,301768,0,2,0
86187,4,1,301770,301770,301771,0,1,2
86188,1,3,301771,301771,301774,0,3,0
86189,5,1,301776,301776,301777,0,1,2
86190,5,3,301781,301781,301784,0,3,4
86191,5,3,301786,301786,301789,0,3,2
86192,4,3,301790,301790,301793,0,3,1
86193,3,1,301793,301793,301794,0,1,0
86194,4,1,301797,301797,301798,0,1,3
86195,4,2,301801,301801,301803,0,2,3
86196,3,1,301804,301804,301805,0,1,1
86197,5,1,301809,301809,301810,0,1,4
86198,3,1,301812,301812,301813,0,1,2
86199,2,1,301814,301814,301815,0,1,1
86200,3,2,301817,301817,301819,0,2,2
86201,1,1,301818,301819,301820,1,2,0
86202,5,3,301823,301823,301826,0,3,3
86203,6,1,301829,301829,301830,0,1,3
86204,6,2,301835,301835,301837,0,2,5
86205,2,2,301837,301837,301839,0,2,0
86206,5,3,301842,301842,301845,0,3,3
86207,5,2,301847,301847,301849,0,2,2
86208,3,3,301850,301850,301853,0,3,1
86209,2,2,301852,301853,301855,1,3,0
86210,6,3,301858,301858,301861,0,3,3
86211,4,1,301862,301862,301863,0,1,1
86212,5,1,301867,301867,301868,0,1,4
86213,3,1,301870,301870,301871,0,1,2
86214,3,3,301873,301873,301876,0,3,2
86215,5,1,301878,301878,301879,0,1,2
86216,4,1,301882,301882,301883,0,1,3
86217,5,3,301887,301887,301890,0,3,4
86218,4,1,301891,301891,301892,0,1,1
86219,4,2,301895,301895,301897,0,2,3
86220,4,2,301899,301899,301901,0,2,2
86221,2,2,301901,301901,301903,0,2,0
86222,3,1,301904,301904,301905,0,1,1
86223,1,3,301905,301905,301908,0,3,0
86224,5,3,301910,301910,301913,0,3,2
86225,1,3,301911,301913,301916,2,5,0
86226,5,1,301916,301916,301917,0,1,0
86227,2,3,301918,301918,301921,0,3,1
86228,5,1,301923,301923,301924,0,1,2
86229,5,1,301928,301928,301929,0,1,4
86230,2,1,301930,301930,301931,0,1,1
86231,2,1,301932,301932,301933,0,1,1
86232,3,3,301935,301935,301938,0,3,2
86233,5,2,301940,301940,301942,0,2,2
86234,4,2,301944,301944,301946,0,2,2
86235,1,3,301945,301946,301949,1,4,0
86236,4,2,301949,301949,301951,0,2,0
86237,6,3,301955,301955,301958,0,3,4
86238,5,3,301960,301960,301963,0,3,2
86239,4,3,301964,301964,301967,0,3,1
86240,2,2,301966,301967,301969,1,3,0
86241,2,2,301968,301969,301971,1,3,0
86242,5,3,301973,301973,301976,0,3,2
86243,1,2,301974,301976,301978,2,4,0
86244,2,3,301976,301978,301981,2,5,0
86245,1,1,301977,301981,301982,4,5,0
86246,1,1,301978,301982,301983,4,5,0
86247,5,3,301983,301983,301986,0,3,0
86248,6,1,301989,301989,301990,0,1,3
86249,2,2,301991,301991,301993,0,2,1
86250,3,1,301994,301994,301995,0,1,1
86251,5,3,301999,301999,302002,0,3,4
86252,4,1,302003,302003,302004,0,1,1
86253,3,2,302006,302006,302008,0,2,2
86254,3,2,302009,302009,302011,0,2,1
86255,3,3,302012,302012,302015,0,3,1
86256,2,3,302014,302015,302018,1,4,0
86257,2,3,302016,302018,302021,2,5,0
86258,2,3,302018,302021,302024,3,6,0
86259,3,1,302021,302024,302025,3,4,0
86260,1,2,302022,302025,302027,3,5,0
86261,1,3,302023,302027,302030,4,7,0
86262,4,3,302027,302030,302033,3,6,0
86263,1,1,302028,302033,302034,5,6,0
86264,6,3,302034,302034,302037,0,3,0
86265,4,2,302038,302038,302040,0,2,1
86266,4,3,302042,302042,302045,0,3,2
86267,3,1,302045,302045,302046,0,1,0
86268,4,1,302049,302049,302050,0,1,3
86269,6,1,302055,302055,302056,0,1,5
86270,4,3,302059,302059,302062,0,3,3
86271,6,1,302065,302065,302066,0,1,3
86272,1,1,302066,302066,302067,0,1,0
86273,1,3,302067,302067,302070,0,3,0
86274,2,2,302069,302070,302072,1,3,0
86275,6,2,302075,302075,302077,0,2,3
86276,1,3,302076,302077,302080,1,4,0
86277,1,1,302077,302080,302081,3,4,0
86278,5,2,302082,302082,302084,0,2,1
86279,2,2,302084,302084,302086,0,2,0
86280,2,2,302086,302086,302088,0,2,0
86281,2,3,302088,302088,302091,0,3,0
86282,2,1,302090,302091,302092,1,2,0
86283,5,1,302095,302095,302096,0,1,3
86284,6,2,302101,302101,302103,0,2,5
86285,6,2,302107,302107,302109,0,2,4
86286,5,3,302112,302112,302115,0,3,3
86287,2,1,302114,302115,302116,1,2,0
86288,3,3,302117,302117,302120,0,3,1
86289,2,2,302119,302120,302122,1,3,0
86290,6,3,302125,302125,302128,0,3,3
86291,3,1,302128,302128,302129,0,1,0
86292,3,2,302131,302131,302133,0,2,2
86293,1,1,302132,302133,302134,1,2,0
86294,2,1,302134,302134,302135,0,1,0
86295,3,3,302137,302137,302140,0,3,2
86296,6,3,302143,302143,302146,0,3,3
86297,5,1,302148,302148,302149,0,1,2
86298,1,2,302149,302149,302151,0,2,0
86299,1,3,302150,302151,302154,1,4,0
86300,3,1,302153,302154,302155,1,2,0
86301,5,1,302158,302158,302159,0,1,3
86302,3,2,302161,302161,302163,0,2,2
86303,3,2,302164,302164,302166,0,2,1
86304,6,2,302170,302170,302172,0,2,4
86305,5,3,302175,302175,302178,0,3,3
86306,5,1,302180,302180,302181,0,1,2
86307,6,3,302186,302186,302189,0,3,5
86308,3,3,302189,302189,302192,0,3,0
86309,2,2,302191,302192,302194,1,3,0
86310,2,3,302193,302194,302197,1,4,0
86311,1,2,302194,302197,302199,3,5,0
86312,2,1,302196,302199,302200,3,4,0
86313,3,3,302199,302200,302203,1,4,0
86314,4,1,302203,302203,302204,0,1,0
86315,6,3,302209,302209,302212,0,3,5
86316,4,3,302213,302213,302216,0,3,1
86317,3,3,302216,302216,302219,0,3,0
86318,6,1,302222,302222,302223,0,1,3
86319,2,3,302224,302224,302227,0,3,1
86320,3,1,302227,302227,302228,0,1,0
86321,4,2,302231,302231,302233,0,2,3
86322,5,3,302236,302236,302239,0,3,3
86323,5,1,302241,302241,302242,0,1,2
86324,6,2,302247,302247,302249,0,2,5
86325,3,1,302250,302250,302251,0,1,1
86326,5,2,302255,302255,302257,0,2,4
86327,4,3,302259,302259,302262,0,3,2
86328,6,3,302265,302265,302268,0,3,3
86329,3,2,302268,302268,302270,0,2,0
86330,6,2,302274,302274,302276,0,2,4
86331,5,2,302279,302279,302281,0,2,3
86332,2,1,302281,302281,302282,0,1,0
86333,5,3,302286,302286,302289,0,3,4
86334,1,1,302287,302289,302290,2,3,0
86335,5,1,302292,302292,302293,0,1,2
86336,4,2,302296,302296,302298,0,2,3
86337,5,3,302301,302301,302304,0,3,3
86338,2,1,302303,302304,302305,1,2,0
86339,6,1,302309,302309,302310,0,1,4
86340,3,2,302312,302312,302314,0,2,2
86341,4,2,302316,302316,302318,0,2,2
86342,4,2,302320,302320,302322,0,2,2
86343,2,1,302322,302322,302323,0,1,0
86344,3,1,302325,302325,302326,0,1,2
86345,5,2,302330,302330,302332,0,2,4
86346,4,1,302334,302334,302335,0,1,2
86347,1,1,302335,302335,302336,0,1,0
86348,5,1,302340,302340,302341,0,1,4
86349,5,1,302345,302345,302346,0,1,4
86350,5,1,302350,302350,302351,0,1,4
86351,4,3,302354,302354,302357,0,3,3
86352,1,2,302355,302357,302359,2,4,0
86353,4,1,302359,302359,302360,0,1,0
86354,3,3,302362,302362,302365,0,3,2
86355,2,3,302364,302365,302368,1,4,0
86356,2,3,302366,302368,302371,2,5,0
86357,4,1,302370,302371,302372,1,2,0
86358,5,2,302375,302375,302377,0,2,3
86359,4,2,302379,302379,302381,0,2,2
86360,3,3,302382,302382,302385,0,3,1
86361,5,3,302387,302387,302390,0,3,2
86362,4,2,302391,302391,302393,0,2,1
86363,3,3,302394,302394,302397,0,3,1
86364,1,3,302395,302397,302400,2,5,0
86365,2,2,302397,302400,302402,3,5,0
86366,2,1,302399,302402,302403,3,4,0
86367,5,3,302404,302404,302407,0,3,1
86368,2,3,302406,302407,302410,1,4,0
86369,6,3,302412,302412,302415,0,3,2
86370,6,1,302418,302418,302419,0,1,3
86371,3,1,302421,302421,302422,0,1,2
86372,5,3,302426,302426,302429,0,3,4
86373,4,2,302430,302430,302432,0,2,1
86374,4,1,302434,302434,302435,0,1,2
86375,6,1,302440,302440,302441,0,1,5
86376,3,2,302443,302443,302445,0,2,2
86377,4,1,302447,302447,302448,0,1,2
86378,1,3,302448,302448,302451,0,3,0
86379,2,2,302450,302451,302453,1,3,0
86380,3,2,302453,302453,302455,0,2,0
86381,1,1,302454,302455,302456,1,2,0
86382,4,2,302458,302458,302460,0,2,2
86383,1,3,302459,302460,302463,1,4,0
86384,6,3,302465,302465,302468,0,3,2
86385,3,2,302468,302468,302470,0,2,0
86386,3,1,302471,302471,302472,0,1,1
86387,3,2,302474,302474,302476,0,2,2
86388,6,3,302480,302480,302483,0,3,4
86389,6,3,302486,302486,302489,0,3,3
86390,4,2,302490,302490,302492,0,2,1
86391,6,2,302496,302496,302498,0,2,4
86392,6,2,302502,302502,302504,0,2,4
86393,1,3,302503,302504,302507,1,4,0
86394,1,2,302504,302507,302509,3,5,0
86395,6,1,302510,302510,302511,0,1,1
86396,4,2,302514,302514,302516,0,2,3
86397,3,2,302517,302517,302519,0,2,1
86398,1,1,302518,302519,302520,1,2,0
86399,5,1,302523,302523,302524,0,1,3
86400,1,3,302524,302524,302527,0,3,0
86401,1,3,302525,302527,302530,2,5,0
86402,5,2,302530,302530,302532,0,2,0
86403,4,2,302534,302534,302536,0,2,2
86404,3,3,302537,302537,302540,0,3,1
86405,4,2,302541,302541,302543,0,2,1
86406,4,2,302545,302545,302547,0,2,2
86407,2,3,302547,302547,302550,0,3,0
86408,6,3,302553,302553,302556,0,3,3
86409,5,1,302558,302558,302559,0,1,2
86410,3,1,302561,302561,302562,0,1,2
86411,2,2,302563,302563,302565,0,2,1
86412,4,1,302567,302567,302568,0,1,2
86413,4,1,302571,302571,302572,0,1,3
86414,4,3,302575,302575,302578,0,3,3
86415,2,3,302577,302578,302581,1,4,0
86416,3,1,302580,302581,302582,1,2,0
86417,1,3,302581,302582,302585,1,4,0
86418,1,3,302582,302585,302588,3,6,0
86419,5,1,302587,302588,302589,1,2,0
86420,1,1,302588,302589,302590,1,2,0
86421,3,1,302591,302591,302592,0,1,1
86422,5,2,302596,302596,302598,0,2,4
86423,5,1,302601,302601,302602,0,1,3
86424,1,3,302602,302602,302605,0,3,0
86425,3,3,302605,302605,302608,0,3,0
86426,5,3,302610,302610,302613,0,3,2
86427,6,1,302616,302616,302617,0,1,3
86428,6,2,302622,302622,302624,0,2,5
86429,3,2,302625,302625,302627,0,2,1
86430,3,1,302628,302628,302629,0,1,1
86431,3,2,302631,302631,302633,0,2,2
86432,4,1,302635,302635,302636,0,1,2
86433,5,2,302640,302640,302642,0,2,4
86434,4,2,302644,302644,302646,0,2,2
86435,2,1,302646,302646,302647,0,1,0
86436,1,2,302647,302647,302649,0,2,0
86437,5,3,302652,302652,302655,0,3,3
86438,5,3,302657,302657,302660,0,3,2
86439,3,2,302660,302660,302662,0,2,0
86440,6,1,302666,302666,302667,0,1,4
86441,4,1,302670,302670,302671,0,1,3
86442,6,3,302676,302676,302679,0,3,5
86443,2,3,302678,302679,302682,1,4,0
86444,5,1,302683,302683,302684,0,1,1
86445,6,1,302689,302689,302690,0,1,5
86446,2,3,302691,302691,302694,0,3,1
86447,4,1,302695,302695,302696,0,1,1
86448,1,1,302696,302696,302697,0,1,0
86449,3,2,302699,302699,302701,0,2,2
86450,3,3,302702,302702,302705,0,3,1
86451,3,3,302705,302705,302708,0,3,0
86452,5,1,302710,302710,302711,0,1,2
86453,2,2,302712,302712,302714,0,2,1
86454,1,3,302713,302714,302717,1,4,0
86455,3,1,302716,302717,302718,1,2,0
86456,4,2,302720,302720,302722,0,2,2
86457,5,1,302725,302725,302726,0,1,3
86458,3,1,302728,302728,302729,0,1,2
86459,3,2,302731,302731,302733,0,2,2
86460,1,2,302732,302733,302735,1,3,0
86461,1,3,302733,302735,302738,2,5,0
86462,4,2,302737,302738,302740,1,3,0
86463,4,1,302741,302741,302742,0,1,1
86464,1,2,302742,302742,302744,0,2,0
86465,1,3,302743,302744,302747,1,4,0
86466,2,3,302745,302747,302750,2,5,0
86467,1,3,302746,302750,302753,4,7,0
86468,6,1,302752,302753,302754,1,2,0
86469,6,1,302758,302758,302759,0,1,4
86470,3,2,302761,302761,302763,0,2,2
86471,2,2,302763,302763,302765,0,2,0
86472,4,3,302767,302767,302770,0,3,2
86473,5,1,302772,302772,302773,0,1,2
86474,6,3,302778,302778,302781,0,3,5
86475,1,3,302779,302781,302784,2,5,0
86476,4,1,302783,302784,302785,1,2,0
86477,1,3,302784,302785,302788,1,4,0
86478,1,3,302785,302788,302791,3,6,0
86479,5,3,302790,302791,302794,1,4,0
86480,6,3,302796,302796,302799,0,3,2
86481,6,3,302802,302802,302805,0,3,3
86482,5,3,302807,302807,302810,0,3,2
86483,3,2,302810,302810,302812,0,2,0
86484,6,3,302816,302816,302819,0,3,4
86485,4,3,302820,302820,302823,0,3,1
86486,5,2,302825,302825,302827,0,2,2
86487,1,1,302826,302827,302828,1,2,0
86488,3,1,302829,302829,302830,0,1,1
86489,2,3,302831,302831,302834,0,3,1
86490,2,2,302833,302834,302836,1,3,0
86491,2,2,302835,302836,302838,1,3,0
86492,2,3,302837,302838,302841,1,4,0
86493,5,1,302842,302842,302843,0,1,1
86494,2,1,302844,302844,302845,0,1,1
86495,5,3,302849,302849,302852,0,3,4
86496,3,3,302852,302852,302855,0,3,0
86497,1,3,302853,302855,302858,2,5,0
86498,3,3,302856,302858,302861,2,5,0
86499,6,3,302862,302862,302865,0,3,1
86500,6,2,302868,302868,302870,0,2,3
86501,3,3,302871,302871,302874,0,3,1
86502,4,2,302875,302875,302877,0,2,1
86503,3,1,302878,302878,302879,0,1,1
86504,4,1,302882,302882,302883,0,1,3
86505,3,3,302885,302885,302888,0,3,2
86506,2,3,302887,302888,302891,1,4,0
86507,3,3,302890,302891,302894,1,4,0
86508,4,1,302894,302894,302895,0,1,0
86509,6,3,302900,302900,302903,0,3,5
86510,3,3,302903,302903,302906,0,3,0
86511,5,1,302908,302908,302909,0,1,2
86512,3,2,302911,302911,302913,0,2,2
86513,5,1,302916,302916,302917,0,1,3
86514,3,2,302919,302919,302921,0,2,2
86515,3,3,302922,302922,302925,0,3,1
86516,3,2,302925,302925,302927,0,2,0
86517,1,1,302926,302927,302928,1,2,0
86518,5,2,302931,302931,302933,0,2,3
86519,3,2,302934,302934,302936,0,2,1
86520,4,2,302938,302938,302940,0,2,2
86521,1,1,302939,302940,302941,1,2,0
86522,3,2,302942,302942,302944,0,2,1
86523,6,3,302948,302948,302951,0,3,4
86524,2,2,302950,302951,302953,1,3,0
86525,4,3,302954,302954,302957,0,3,1
86526,6,3,302960,302960,302963,0,3,3
86527,3,2,302963,302963,302965,0,2,0
86528,2,2,302965,302965,302967,0,2,0
86529,3,2,302968,302968,302970,0,2,1
86530,5,1,302973,302973,302974,0,1,3
86531,4,3,302977,302977,302980,0,3,3
86532,2,3,302979,302980,302983,1,4,0
86533,1,1,302980,302983,302984,3,4,0
86534,5,3,302985,302985,302988,0,3,1
86535,3,1,302988,302988,302989,0,1,0
86536,1,3,302989,302989,302992,0,3,0
86537,3,1,302992,302992,302993,0,1,0
86538,4,2,302996,302996,302998,0,2,3
86539,6,1,303002,303002,303003,0,1,4
86540,5,1,303007,303007,303008,0,1,4
86541,3,3,303010,303010,303013,0,3,2
86542,6,1,303016,303016,303017,0,1,3
86543,3,1,303019,303019,303020,0,1,2
86544,2,2,303021,303021,303023,0,2,1
86545,5,1,303026,303026,303027,0,1,3
86546,1,2,303027,303027,303029,0,2,0
86547,2,2,303029,303029,303031,0,2,0
86548,4,1,303033,303033,303034,0,1,2
86549,1,3,303034,303034,303037,0,3,0
86550,3,1,303037,303037,303038,0,1,0
86551,3,3,303040,303040,303043,0,3,2
86552,1,3,303041,303043,303046,2,5,0
86553,5,3,303046,303046,303049,0,3,0
86554,4,2,303050,303050,303052,0,2,1
86555,1,1,303051,303052,303053,1,2,0
86556,4,1,303055,303055,303056,0,1,2
86557,1,1,303056,303056,303057,0,1,0
86558,5,2,303061,303061,303063,0,2,4
86559,3,2,303064,303064,303066,0,2,1
86560,4,2,303068,303068,303070,0,2,2
86561,3,3,303071,303071,303074,0,3,1
86562,1,3,303072,303074,303077,2,5,0
86563,3,1,303075,303077,303078,2,3,0
86564,5,1,303080,303080,303081,0,1,2
86565,1,3,303081,303081,303084,0,3,0
86566,1,1,303082,303084,303085,2,3,0
86567,4,1,303086,303086,303087,0,1,1
86568,5,1,303091,303091,303092,0,1,4
86569,2,3,303093,303093,303096,0,3,1
86570,3,3,303096,303096,303099,0,3,0
86571,6,3,303102,303102,303105,0,3,3
86572,5,2,303107,303107,303109,0,2,2
86573,3,1,303110,303110,303111,0,1,1
86574,3,1,303113,303113,303114,0,1,2
86575,4,1,303117,303117,303118,0,1,3
86576,6,2,303123,303123,303125,0,2,5
86577,3,1,303126,303126,303127,0,1,1
86578,6,2,303132,303132,303134,0,2,5
86579,2,2,303134,303134,303136,0,2,0
86580,4,1,303138,303138,303139,0,1,2
86581,5,2,303143,303143,303145,0,2,4
86582,4,2,303147,303147,303149,0,2,2
86583,4,3,303151,303151,303154,0,3,2
86584,2,2,303153,303154,303156,1,3,0
86585,4,3,303157,303157,303160,0,3,1
86586,4,3,303161,303161,303164,0,3,1
86587,4,1,303165,303165,303166,0,1,1
86588,1,1,303166,303166,303167,0,1,0
86589,2,1,303168,303168,303169,0,1,1
86590,4,1,303172,303172,303173,0,1,3
86591,6,1,303178,303178,303179,0,1,5
86592,2,1,303180,303180,303181,0,1,1
86593,6,2,303186,303186,303188,0,2,5
86594,2,3,303188,303188,303191,0,3,0
86595,6,3,303194,303194,303197,0,3,3
86596,5,1,303199,303199,303200,0,1,2
86597,3,1,303202,303202,303203,0,1,2
86598,5,1,303207,303207,303208,0,1,4
86599,6,3,303213,303213,303216,0,3,5
86600,2,3,303215,303216,303219,1,4,0
86601,5,2,303220,303220,303222,0,2,1
86602,2,2,303222,303222,303224,0,2,0
86603,5,3,303227,303227,303230,0,3,3
86604,5,2,303232,303232,303234,0,2,2
86605,6,1,303238,303238,303239,0,1,4
86606,2,2,303240,303240,303242,0,2,1
86607,4,1,303244,303244,303245,0,1,2
86608,5,3,303249,303249,303252,0,3,4
86609,2,3,303251,303252,303255,1,4,0
86610,4,3,303255,303255,303258,0,3,0
86611,4,1,303259,303259,303260,0,1,1
86612,2,3,303261,303261,303264,0,3,1
86613,6,2,303267,303267,303269,0,2,3
86614,6,2,303273,303273,303275,0,2,4
86615,6,3,303279,303279,303282,0,3,4
86616,1,2,303280,303282,303284,2,4,0
86617,5,1,303285,303285,303286,0,1,1
86618,3,3,303288,303288,303291,0,3,2
86619,4,3,303292,303292,303295,0,3,1
86620,6,3,303298,303298,303301,0,3,3
86621,5,1,303303,303303,303304,0,1,2
86622,3,2,303306,303306,303308,0,2,2
86623,1,1,303307,303308,303309,1,2,0
86624,3,1,303310,303310,303311,0,1,1
86625,2,2,303312,303312,303314,0,2,1
86626,1,3,303313,303314,303317,1,4,0
86627,3,1,303316,303317,303318,1,2,0
86628,2,2,303318,303318,303320,0,2,0
86629,6,1,303324,303324,303325,0,1,4
86630,3,3,303327,303327,303330,0,3,2
86631,4,3,303331,303331,303334,0,3,1
86632,2,1,303333,303334,303335,1,2,0
86633,1,2,303334,303335,303337,1,3,0
86634,3,1,303337,303337,303338,0,1,0
86635,3,1,303340,303340,303341,0,1,2
86636,1,3,303341,303341,303344,0,3,0
86637,4,1,303345,303345,303346,0,1,1
86638,1,1,303346,303346,303347,0,1,0
86639,1,3,303347,303347,303350,0,3,0
86640,4,2,303351,303351,303353,0,2,1
86641,1,1,303352,303353,303354,1,2,0
86642,4,2,303356,303356,303358,0,2,2
86643,5,1,303361,303361,303362,0,1,3
86644,1,1,303362,303362,303363,0,1,0
86645,5,1,303367,303367,303368,0,1,4
86646,3,1,303370,303370,303371,0,1,2
86647,5,1,303375,303375,303376,0,1,4
86648,2,2,303377,303377,303379,0,2,1
86649,2,2,303379,303379,303381,0,2,0
86650,5,3,303384,303384,303387,0,3,3
86651,3,2,303387,303387,303389,0,2,0
86652,6,3,303393,303393,303396,0,3,4
86653,2,2,303395,303396,303398,1,3,0
86654,2,2,303397,303398,303400,1,3,0
86655,2,1,303399,303400,303401,1,2,0
86656,5,3,303404,303404,303407,0,3,3
86657,6,2,303410,303410,303412,0,2,3
86658,2,3,303412,303412,303415,0,3,0
86659,5,3,303417,303417,303420,0,3,2
86660,2,2,303419,303420,303422,1,3,0
86661,1,1,303420,303422,303423,2,3,0
86662,3,1,303423,303423,303424,0,1,0
86663,3,1,303426,303426,303427,0,1,2
86664,1,2,303427,303427,303429,0,2,0
86665,6,1,303433,303433,303434,0,1,4
86666,2,3,303435,303435,303438,0,3,1
86667,6,1,303441,303441,303442,0,1,3
86668,5,3,303446,303446,303449,0,3,4
86669,1,2,303447,303449,303451,2,4,0
86670,1,3,303448,303451,303454,3,6,0
86671,2,3,303450,303454,303457,4,7,0
86672,6,1,303456,303457,303458,1,2,0
86673,3,3,303459,303459,303462,0,3,1
86674,4,1,303463,303463,303464,0,1,1
86675,3,2,303466,303466,303468,0,2,2
86676,4,3,303470,303470,303473,0,3,2
86677,2,2,303472,303473,303475,1,3,0
86678,3,2,303475,303475,303477,0,2,0
86679,5,3,303480,303480,303483,0,3,3
86680,1,2,303481,303483,303485,2,4,0
86681,3,1,303484,303485,303486,1,2,0
86682,6,1,303490,303490,303491,0,1,4
86683,5,2,303495,303495,303497,0,2,4
86684,6,1,303501,303501,303502,0,1,4
86685,1,1,303502,303502,303503,0,1,0
86686,1,3,303503,303503,303506,0,3,0
86687,4,2,303507,303507,303509,0,2,1
86688,6,1,303513,303513,303514,0,1,4
86689,5,3,303518,303518,303521,0,3,4
86690,1,2,303519,303521,303523,2,4,0
86691,6,1,303525,303525,303526,0,1,2
86692,4,1,303529,303529,303530,0,1,3
86693,4,1,303533,303533,303534,0,1,3
86694,6,3,303539,303539,303542,0,3,5
86695,6,2,303545,303545,303547,0,2,3
86696,2,3,303547,303547,303550,0,3,0
86697,2,3,303549,303550,303553,1,4,0
86698,4,1,303553,303553,303554,0,1,0
86699,3,1,303556,303556,303557,0,1,2
86700,6,3,303562,303562,303565,0,3,5
86701,6,2,303568,303568,303570,0,2,3
86702,5,3,303573,303573,303576,0,3,3
86703,3,2,303576,303576,303578,0,2,0
86704,3,2,303579,303579,303581,0,2,1
86705,3,2,303582,303582,303584,0,2,1
86706,2,2,303584,303584,303586,0,2,0
86707,3,1,303587,303587,303588,0,1,1
86708,6,3,303593,303593,303596,0,3,5
86709,2,2,303595,303596,303598,1,3,0
86710,6,1,303601,303601,303602,0,1,3
86711,4,1,303605,303605,303606,0,1,3
86712,1,1,303606,303606,303607,0,1,0
86713,3,3,303609,303609,303612,0,3,2
86714,3,1,303612,303612,303613,0,1,0
86715,2,3,303614,303614,303617,0,3,1
86716,4,2,303618,303618,303620,0,2,1
86717,4,2,303622,303622,303624,0,2,2
86718,6,1,303628,303628,303629,0,1,4
86719,1,3,303629,303629,303632,0,3,0
86720,1,3,303630,303632,303635,2,5,0
86721,5,3,303635,303635,303638,0,3,0
86722,5,3,303640,303640,303643,0,3,2
86723,5,3,303645,303645,303648,0,3,2
86724,4,1,303649,303649,303650,0,1,1
86725,5,2,303654,303654,303656,0,2,4
86726,4,2,303658,303658,303660,0,2,2
86727,4,1,303662,303662,303663,0,1,2
86728,1,1,303663,303663,303664,0,1,0
86729,2,1,303665,303665,303666,0,1,1
86730,6,1,303671,303671,303672,0,1,5
86731,4,1,303675,303675,303676,0,1,3
86732,3,2,303678,303678,303680,0,2,2
86733,5,2,303683,303683,303685,0,2,3
86734,1,2,303684,303685,303687,1,3,0
86735,3,3,303687,303687,303690,0,3,0
86736,1,1,303688,303690,303691,2,3,0
86737,2,1,303690,303691,303692,1,2,0
86738,4,2,303694,303694,303696,0,2,2
86739,1,2,303695,303696,303698,1,3,0
86740,6,2,303701,303701,303703,0,2,3
86741,4,2,303705,303705,303707,0,2,2
86742,3,3,303708,303708,303711,0,3,1
86743,4,3,303712,303712,303715,0,3,1
86744,5,2,303717,303717,303719,0,2,2
86745,6,1,303723,303723,303724,0,1,4
86746,3,2,303726,303726,303728,0,2,2
86747,3,1,303729,303729,303730,0,1,1
86748,1,1,303730,303730,303731,0,1,0
86749,2,1,303732,303732,303733,0,1,1
86750,1,2,303733,303733,303735,0,2,0
86751,3,2,303736,303736,303738,0,2,1
86752,4,1,303740,303740,303741,0,1,2
86753,6,2,303746,303746,303748,0,2,5
86754,3,1,303749,303749,303750,0,1,1
86755,1,1,303750,303750,303751,0,1,0
86756,5,1,303755,303755,303756,0,1,4
86757,5,1,303760,303760,303761,0,1,4
86758,3,2,303763,303763,303765,0,2,2
86759,2,3,303765,303765,303768,0,3,0
86760,5,1,303770,303770,303771,0,1,2
86761,2,3,303772,303772,303775,0,3,1
86762,4,2,303776,303776,303778,0,2,1
86763,1,3,303777,303778,303781,1,4,0
86764,3,3,303780,303781,303784,1,4,0
86765,5,3,303785,303785,303788,0,3,1
86766,3,1,303788,303788,303789,0,1,0
86767,6,2,303794,303794,303796,0,2,5
86768,2,3,303796,303796,303799,0,3,0
86769,6,3,303802,303802,303805,0,3,3
86770,5,3,303807,303807,303810,0,3,2
86771,6,3,303813,303813,303816,0,3,3
86772,3,3,303816,303816,303819,0,3,0
86773,3,3,303819,303819,303822,0,3,0
86774,2,3,303821,303822,303825,1,4,0
86775,3,3,303824,303825,303828,1,4,0
86776,4,3,303828,303828,303831,0,3,0
86777,6,3,303834,303834,303837,0,3,3
86778,1,3,303835,303837,303840,2,5,0
86779,3,2,303838,303840,303842,2,4,0
86780,5,1,303843,303843,303844,0,1,1
86781,1,3,303844,303844,303847,0,3,0
86782,1,3,303845,303847,303850,2,5,0
86783,6,1,303851,303851,303852,0,1,1
86784,1,3,303852,303852,303855,0,3,0
86785,2,3,303854,303855,303858,1,4,0
86786,5,3,303859,303859,303862,0,3,1
86787,6,1,303865,303865,303866,0,1,3
86788,1,1,303866,303866,303867,0,1,0
86789,6,1,303872,303872,303873,0,1,5
86790,5,3,303877,303877,303880,0,3,4
86791,6,3,303883,303883,303886,0,3,3
86792,6,3,303889,303889,303892,0,3,3
86793,3,1,303892,303892,303893,0,1,0
86794,4,1,303896,303896,303897,0,1,3
86795,6,2,303902,303902,303904,0,2,5
86796,1,3,303903,303904,303907,1,4,0
86797,2,2,303905,303907,303909,2,4,0
86798,5,2,303910,303910,303912,0,2,1
86799,1,2,303911,303912,303914,1,3,0
86800,2,2,303913,303914,303916,1,3,0
86801,1,2,303914,303916,303918,2,4,0
86802,4,3,303918,303918,303921,0,3,0
86803,3,2,303921,303921,303923,0,2,0
86804,2,1,303923,303923,303924,0,1,0
86805,1,1,303924,303924,303925,0,1,0
86806,4,2,303928,303928,303930,0,2,3
86807,6,1,303934,303934,303935,0,1,4
86808,6,1,303940,303940,303941,0,1,5
86809,4,3,303944,303944,303947,0,3,3
86810,6,2,303950,303950,303952,0,2,3
86811,1,3,303951,303952,303955,1,4,0
86812,5,2,303956,303956,303958,0,2,1
86813,5,1,303961,303961,303962,0,1,3
86814,6,3,303967,303967,303970,0,3,5
86815,6,2,303973,303973,303975,0,2,3
86816,3,2,303976,303976,303978,0,2,1
86817,1,3,303977,303978,303981,1,4,0
86818,2,2,303979,303981,303983,2,4,0
86819,1,1,303980,303983,303984,3,4,0
86820,4,1,303984,303984,303985,0,1,0
86821,6,3,303990,303990,303993,0,3,5
86822,6,2,303996,303996,303998,0,2,3
86823,1,1,303997,303998,303999,1,2,0
86824,5,2,304002,304002,304004,0,2,3
86825,6,3,304008,304008,304011,0,3,4
86826,2,1,304010,304011,304012,1,2,0
86827,2,3,304012,304012,304015,0,3,0
86828,4,1,304016,304016,304017,0,1,1
86829,1,2,304017,304017,304019,0,2,0
86830,1,3,304018,304019,304022,1,4,0
86831,3,1,304021,304022,304023,1,2,0
86832,6,3,304027,304027,304030,0,3,4
86833,3,3,304030,304030,304033,0,3,0
86834,6,1,304036,304036,304037,0,1,3
86835,3,3,304039,304039,304042,0,3,2
86836,5,1,304044,304044,304045,0,1,2
86837,4,3,304048,304048,304051,0,3,3
86838,3,3,304051,304051,304054,0,3,0
86839,5,3,304056,304056,304059,0,3,2
86840,1,2,304057,304059,304061,2,4,0
86841,3,1,304060,304061,304062,1,2,0
86842,2,2,304062,304062,304064,0,2,0
86843,5,1,304067,304067,304068,0,1,3
86844,5,3,304072,304072,304075,0,3,4
86845,4,2,304076,304076,304078,0,2,1
86846,6,2,304082,304082,304084,0,2,4
86847,3,2,304085,304085,304087,0,2,1
86848,6,2,304091,304091,304093,0,2,4
86849,2,3,304093,304093,304096,0,3,0
86850,3,1,304096,304096,304097,0,1,0
86851,1,2,304097,304097,304099,0,2,0
86852,2,2,304099,304099,304101,0,2,0
86853,4,2,304103,304103,304105,0,2,2
86854,3,2,304106,304106,304108,0,2,1
86855,3,1,304109,304109,304110,0,1,1
86856,5,1,304114,304114,304115,0,1,4
86857,2,1,304116,304116,304117,0,1,1
86858,1,1,304117,304117,304118,0,1,0
86859,5,3,304122,304122,304125,0,3,4
86860,6,3,304128,304128,304131,0,3,3
86861,2,2,304130,304131,304133,1,3,0
86862,4,1,304134,304134,304135,0,1,1
86863,6,1,304140,304140,304141,0,1,5
86864,4,3,304144,304144,304147,0,3,3
86865,1,3,304145,304147,304150,2,5,0
86866,4,1,304149,304150,304151,1,2,0
86867,1,1,304150,304151,304152,1,2,0
86868,1,3,304151,304152,304155,1,4,0
86869,3,1,304154,304155,304156,1,2,0
86870,5,1,304159,304159,304160,0,1,3
86871,4,1,304163,304163,304164,0,1,3
86872,6,1,304169,304169,304170,0,1,5
86873,1,1,304170,304170,304171,0,1,0
86874,2,1,304172,304172,304173,0,1,1
86875,2,1,304174,304174,304175,0,1,1
86876,3,2,304177,304177,304179,0,2,2
86877,4,3,304181,304181,304184,0,3,2
86878,2,2,304183,304184,304186,1,3,0
86879,4,2,304187,304187,304189,0,2,1
86880,1,3,304188,304189,304192,1,4,0
86881,1,3,304189,304192,304195,3,6,0
86882,4,3,304193,304195,304198,2,5,0
86883,4,1,304197,304198,304199,1,2,0
86884,4,1,304201,304201,304202,0,1,2
86885,1,2,304202,304202,304204,0,2,0
86886,4,2,304206,304206,304208,0,2,2
86887,5,3,304211,304211,304214,0,3,3
86888,1,1,304212,304214,304215,2,3,0
86889,4,2,304216,304216,304218,0,2,1
86890,2,3,304218,304218,304221,0,3,0
86891,4,3,304222,304222,304225,0,3,1
86892,5,3,304227,304227,304230,0,3,2
86893,1,1,304228,304230,304231,2,3,0
86894,4,3,304232,304232,304235,0,3,1
86895,3,3,304235,304235,304238,0,3,0
86896,6,3,304241,304241,304244,0,3,3
86897,4,2,304245,304245,304247,0,2,1
86898,2,1,304247,304247,304248,0,1,0
86899,6,1,304253,304253,304254,0,1,5
86900,6,2,304259,304259,304261,0,2,5
86901,3,1,304262,304262,304263,0,1,1
86902,1,3,304263,304263,304266,0,3,0
86903,1,3,304264,304266,304269,2,5,0
86904,3,3,304267,304269,304272,2,5,0
86905,6,1,304273,304273,304274,0,1,1
86906,3,3,304276,304276,304279,0,3,2
86907,4,3,304280,304280,304283,0,3,1
86908,6,3,304286,304286,304289,0,3,3
86909,3,2,304289,304289,304291,0,2,0
86910,2,2,304291,304291,304293,0,2,0
86911,1,2,304292,304293,304295,1,3,0
86912,1,2,304293,304295,304297,2,4,0
86913,6,1,304299,304299,304300,0,1,2
86914,3,3,304302,304302,304305,0,3,2
86915,3,3,304305,304305,304308,0,3,0
86916,4,2,304309,304309,304311,0,2,1
86917,1,1,304310,304311,304312,1,2,0
86918,4,3,304314,304314,304317,0,3,2
86919,4,1,304318,304318,304319,0,1,1
86920,1,3,304319,304319,304322,0,3,0
86921,4,2,304323,304323,304325,0,2,1
86922,5,3,304328,304328,304331,0,3,3
86923,5,3,304333,304333,304336,0,3,2
86924,2,3,304335,304336,304339,1,4,0
86925,1,2,304336,304339,304341,3,5,0
86926,3,2,304339,304341,304343,2,4,0
86927,4,3,304343,304343,304346,0,3,0
86928,3,3,304346,304346,304349,0,3,0
86929,2,3,304348,304349,304352,1,4,0
86930,5,1,304353,304353,304354,0,1,1
86931,6,3,304359,304359,304362,0,3,5
86932,6,1,304365,304365,304366,0,1,3
86933,5,3,304370,304370,304373,0,3,4
86934,3,1,304373,304373,304374,0,1,0
86935,5,2,304378,304378,304380,0,2,4
86936,3,3,304381,304381,304384,0,3,1
86937,3,3,304384,304384,304387,0,3,0
86938,1,2,304385,304387,304389,2,4,0
86939,4,3,304389,304389,304392,0,3,0
86940,3,1,304392,304392,304393,0,1,0
86941,5,1,304397,304397,304398,0,1,4
86942,6,3,304403,304403,304406,0,3,5
86943,6,3,304409,304409,304412,0,3,3
86944,1,2,304410,304412,304414,2,4,0
86945,4,2,304414,304414,304416,0,2,0
86946,6,3,304420,304420,304423,0,3,4
86947,6,3,304426,304426,304429,0,3,3
86948,3,2,304429,304429,304431,0,2,0
86949,5,2,304434,304434,304436,0,2,3
86950,6,1,304440,304440,304441,0,1,4
86951,3,1,304443,304443,304444,0,1,2
86952,3,1,304446,304446,304447,0,1,2
86953,3,2,304449,304449,304451,0,2,2
86954,4,3,304453,304453,304456,0,3,2
86955,2,3,304455,304456,304459,1,4,0
86956,6,1,304461,304461,304462,0,1,2
86957,3,1,304464,304464,304465,0,1,2
86958,1,3,304465,304465,304468,0,3,0
86959,4,2,304469,304469,304471,0,2,1
86960,6,3,304475,304475,304478,0,3,4
86961,5,1,304480,304480,304481,0,1,2
86962,1,2,304481,304481,304483,0,2,0
86963,2,3,304483,304483,304486,0,3,0
86964,2,2,304485,304486,304488,1,3,0
86965,5,2,304490,304490,304492,0,2,2
86966,6,2,304496,304496,304498,0,2,4
86967,1,3,304497,304498,304501,1,4,0
86968,1,3,304498,304501,304504,3,6,0
86969,2,2,304500,304504,304506,4,6,0
86970,5,3,304505,304506,304509,1,4,0
86971,3,1,304508,304509,304510,1,2,0
86972,2,3,304510,304510,304513,0,3,0
86973,1,2,304511,304513,304515,2,4,0
86974,3,3,304514,304515,304518,1,4,0
86975,4,3,304518,304518,304521,0,3,0
86976,1,1,304519,304521,304522,2,3,0
86977,4,1,304523,304523,304524,0,1,1
86978,3,1,304526,304526,304527,0,1,2
86979,5,3,304531,304531,304534,0,3,4
86980,3,3,304534,304534,304537,0,3,0
86981,2,1,304536,304537,304538,1,2,0
86982,3,2,304539,304539,304541,0,2,1
86983,3,2,304542,304542,304544,0,2,1
86984,4,1,304546,304546,304547,0,1,2
86985,2,1,304548,304548,304549,0,1,1
86986,3,3,304551,304551,304554,0,3,2
86987,6,2,304557,304557,304559,0,2,3
86988,2,3,304559,304559,304562,0,3,0
86989,3,1,304562,304562,304563,0,1,0
86990,2,2,304564,304564,304566,0,2,1
86991,3,1,304567,304567,304568,0,1,1
86992,5,1,304572,304572,304573,0,1,4
86993,2,2,304574,304574,304576,0,2,1
86994,3,1,304577,304577,304578,0,1,1
86995,4,2,304581,304581,304583,0,2,3
86996,5,1,304586,304586,304587,0,1,3
86997,5,3,304591,304591,304594,0,3,4
86998,1,1,304592,304594,304595,2,3,0
86999,4,3,304596,304596,304599,0,3,1
87000,5,3,304601,304601,304604,0,3,2
87001,4,3,304605,304605,304608,0,3,1
87002,4,3,304609,304609,304612,0,3,1
87003,4,1,304613,304613,304614,0,1,1
87004,3,3,304616,304616,304619,0,3,2
87005,2,1,304618,304619,304620,1,2,0
87006,6,1,304624,304624,304625,0,1,4
87007,3,2,304627,304627,304629,0,2,2
87008,6,1,304633,304633,304634,0,1,4
87009,3,3,304636,304636,304639,0,3,2
87010,1,3,304637,304639,304642,2,5,0
87011,1,3,304638,304642,304645,4,7,0
87012,2,1,304640,304645,304646,5,6,0
87013,4,3,304644,304646,304649,2,5,0
87014,2,2,304646,304649,304651,3,5,0
87015,6,3,304652,304652,304655,0,3,1
87016,6,1,304658,304658,304659,0,1,3
87017,1,1,304659,304659,304660,0,1,0
87018,2,2,304661,304661,304663,0,2,1
87019,6,3,304667,304667,304670,0,3,4
87020,4,2,304671,304671,304673,0,2,1
87021,4,1,304675,304675,304676,0,1,2
87022,6,2,304681,304681,304683,0,2,5
87023,3,2,304684,304684,304686,0,2,1
87024,5,3,304689,304689,304692,0,3,3
87025,5,2,304694,304694,304696,0,2,2
87026,1,2,304695,304696,304698,1,3,0
87027,3,3,304698,304698,304701,0,3,0
87028,4,3,304702,304702,304705,0,3,1
87029,1,3,304703,304705,304708,2,5,0
87030,5,2,304708,304708,304710,0,2,0
87031,5,3,304713,304713,304716,0,3,3
87032,2,1,304715,304716,304717,1,2,0
87033,1,3,304716,304717,304720,1,4,0
87034,1,2,304717,304720,304722,3,5,0
87035,4,3,304721,304722,304725,1,4,0
87036,5,2,304726,304726,304728,0,2,1
87037,3,1,304729,304729,304730,0,1,1
87038,3,1,304732,304732,304733,0,1,2
87039,4,1,304736,304736,304737,0,1,3
87040,2,3,304738,304738,304741,0,3,1
87041,4,2,304742,304742,304744,0,2,1
87042,1,1,304743,304744,304745,1,2,0
87043,2,2,304745,304745,304747,0,2,0
87044,6,1,304751,304751,304752,0,1,4
87045,5,2,304756,304756,304758,0,2,4
87046,2,1,304758,304758,304759,0,1,0
87047,1,3,304759,304759,304762,0,3,0
87048,5,3,304764,304764,304767,0,3,2
87049,3,3,304767,304767,304770,0,3,0
87050,2,2,304769,304770,304772,1,3,0
87051,2,3,304771,304772,304775,1,4,0
87052,4,1,304775,304775,304776,0,1,0
87053,2,3,304777,304777,304780,0,3,1
87054,2,1,304779,304780,304781,1,2,0
87055,3,3,304782,304782,304785,0,3,1
87056,6,2,304788,304788,304790,0,2,3
87057,6,2,304794,304794,304796,0,2,4
87058,3,2,304797,304797,304799,0,2,1
87059,4,2,304801,304801,304803,0,2,2
87060,4,2,304805,304805,304807,0,2,2
87061,6,1,304811,304811,304812,0,1,4
87062,4,2,304815,304815,304817,0,2,3
87063,3,3,304818,304818,304821,0,3,1
87064,2,3,304820,304821,304824,1,4,0
87065,5,1,304825,304825,304826,0,1,1
87066,1,2,304826,304826,304828,0,2,0
87067,5,2,304831,304831,304833,0,2,3
87068,6,2,304837,304837,304839,0,2,4
87069,4,3,304841,304841,304844,0,3,2
87070,4,1,304845,304845,304846,0,1,1
87071,3,1,304848,304848,304849,0,1,2
87072,1,2,304849,304849,304851,0,2,0
87073,4,3,304853,304853,304856,0,3,2
87074,2,3,304855,304856,304859,1,4,0
87075,6,2,304861,304861,304863,0,2,2
87076,6,3,304867,304867,304870,0,3,4
87077,1,2,304868,304870,304872,2,4,0
87078,3,1,304871,304872,304873,1,2,0
87079,1,2,304872,304873,304875,1,3,0
87080,1,3,304873,304875,304878,2,5,0
87081,5,1,304878,304878,304879,0,1,0
87082,3,3,304881,304881,304884,0,3,2
87083,1,2,304882,304884,304886,2,4,0
87084,2,3,304884,304886,304889,2,5,0
87085,6,2,304890,304890,304892,0,2,1
87086,2,1,304892,304892,304893,0,1,0
87087,3,2,304895,304895,304897,0,2,2
87088,2,2,304897,304897,304899,0,2,0
87089,5,1,304902,304902,304903,0,1,3
87090,2,2,304904,304904,304906,0,2,1
87091,5,2,304909,304909,304911,0,2,3
87092,1,2,304910,304911,304913,1,3,0
87093,4,1,304914,304914,304915,0,1,1
87094,6,2,304920,304920,304922,0,2,5
87095,4,2,304924,304924,304926,0,2,2
87096,5,3,304929,304929,304932,0,3,3
87097,6,3,304935,304935,304938,0,3,3
87098,5,1,304940,304940,304941,0,1,2
87099,3,2,304943,304943,304945,0,2,2
87100,1,1,304944,304945,304946,1,2,0
87101,5,2,304949,304949,304951,0,2,3
87102,2,2,304951,304951,304953,0,2,0
87103,1,2,304952,304953,304955,1,3,0
87104,1,1,304953,304955,304956,2,3,0
87105,6,1,304959,304959,304960,0,1,3
87106,2,1,304961,304961,304962,0,1,1
87107,1,2,304962,304962,304964,0,2,0
87108,3,3,304965,304965,304968,0,3,1
87109,1,1,304966,304968,304969,2,3,0
87110,2,1,304968,304969,304970,1,2,0
87111,3,1,304971,304971,304972,0,1,1
87112,6,2,304977,304977,304979,0,2,5
87113,2,1,304979,304979,304980,0,1,0
87114,5,2,304984,304984,304986,0,2,4
87115,2,1,304986,304986,304987,0,1,0
87116,6,2,304992,304992,304994,0,2,5
87117,6,1,304998,304998,304999,0,1,4
87118,2,2,305000,305000,305002,0,2,1
87119,1,2,305001,305002,305004,1,3,0
87120,5,1,305006,305006,305007,0,1,2
87121,6,1,305012,305012,305013,0,1,5
87122,6,3,305018,305018,305021,0,3,5
87123,4,2,305022,305022,305024,0,2,1
87124,3,2,305025,305025,305027,0,2,1
87125,3,3,305028,305028,305031,0,3,1
87126,6,3,305034,305034,305037,0,3,3
87127,4,3,305038,305038,305041,0,3,1
87128,3,3,305041,305041,305044,0,3,0
87129,4,1,305045,305045,305046,0,1,1
87130,5,3,305050,305050,305053,0,3,4
87131,4,2,305054,305054,305056,0,2,1
87132,3,3,305057,305057,305060,0,3,1
87133,3,1,305060,305060,305061,0,1,0
87134,4,2,305064,305064,305066,0,2,3
87135,2,1,305066,305066,305067,0,1,0
87136,6,2,305072,305072,305074,0,2,5
87137,3,3,305075,305075,305078,0,3,1
87138,3,3,305078,305078,305081,0,3,0
87139,1,1,305079,305081,305082,2,3,0
87140,6,2,305085,305085,305087,0,2,3
87141,6,1,305091,305091,305092,0,1,4
87142,2,3,305093,305093,305096,0,3,1
87143,4,2,305097,305097,305099,0,2,1
87144,6,1,305103,305103,305104,0,1,4
87145,5,3,305108,305108,305111,0,3,4
87146,6,3,305114,305114,305117,0,3,3
87147,6,3,305120,305120,305123,0,3,3
87148,3,2,305123,305123,305125,0,2,0
87149,4,1,305127,305127,305128,0,1,2
87150,3,3,305130,305130,305133,0,3,2
87151,4,3,305134,305134,305137,0,3,1
87152,5,3,305139,305139,305142,0,3,2
87153,5,2,305144,305144,305146,0,2,2
87154,1,3,305145,305146,305149,1,4,0
87155,2,1,305147,305149,305150,2,3,0
87156,1,2,305148,305150,305152,2,4,0
87157,3,1,305151,305152,305153,1,2,0
87158,1,1,305152,305153,305154,1,2,0
87159,4,3,305156,305156,305159,0,3,2
87160,2,2,305158,305159,305161,1,3,0
87161,2,3,305160,305161,305164,1,4,0
87162,3,2,305163,305164,305166,1,3,0
87163,4,2,305167,305167,305169,0,2,1
87164,2,3,305169,305169,305172,0,3,0
87165,3,1,305172,305172,305173,0,1,0
87166,2,3,305174,305174,305177,0,3,1
87167,4,3,305178,305178,305181,0,3,1
87168,1,1,305179,305181,305182,2,3,0
87169,1,2,305180,305182,305184,2,4,0
87170,3,1,305183,305184,305185,1,2,0
87171,3,3,305186,305186,305189,0,3,1
87172,5,2,305191,305191,305193,0,2,2
87173,6,2,305197,305197,305199,0,2,4
87174,6,2,305203,305203,305205,0,2,4
87175,3,1,305206,305206,305207,0,1,1
87176,1,1,305207,305207,305208,0,1,0
87177,4,2,305211,305211,305213,0,2,3
87178,6,2,305217,305217,305219,0,2,4
87179,3,1,305220,305220,305221,0,1,1
87180,4,1,305224,305224,305225,0,1,3
87181,1,3,305225,305225,305228,0,3,0
87182,6,3,305231,305231,305234,0,3,3
87183,1,1,305232,305234,305235,2,3,0
87184,6,2,305238,305238,305240,0,2,3
87185,5,2,305243,305243,305245,0,2,3
87186,6,2,305249,305249,305251,0,2,4
87187,4,1,305253,305253,305254,0,1,2
87188,6,3,305259,305259,305262,0,3,5
87189,6,1,305265,305265,305266,0,1,3
87190,5,2,305270,305270,305272,0,2,4
87191,1,3,305271,305272,305275,1,4,0
87192,3,3,305274,305275,305278,1,4,0
87193,3,2,305277,305278,305280,1,3,0
87194,1,1,305278,305280,305281,2,3,0
87195,5,2,305283,305283,305285,0,2,2
87196,4,3,305287,305287,305290,0,3,2
87197,3,2,305290,305290,305292,0,2,0
87198,4,3,305294,305294,305297,0,3,2
87199,5,2,305299,305299,305301,0,2,2
87200,2,3,305301,305301,305304,0,3,0
87201,2,1,305303,305304,305305,1,2,0
87202,4,1,305307,305307,305308,0,1,2
87203,2,3,305309,305309,305312,0,3,1
87204,1,3,305310,305312,305315,2,5,0
87205,5,1,305315,305315,305316,0,1,0
87206,1,2,305316,305316,305318,0,2,0
87207,2,2,305318,305318,305320,0,2,0
87208,4,3,305322,305322,305325,0,3,2
87209,4,2,305326,305326,305328,0,2,1
87210,2,3,305328,305328,305331,0,3,0
87211,6,3,305334,305334,305337,0,3,3
87212,5,2,305339,305339,305341,0,2,2
87213,2,2,305341,305341,305343,0,2,0
87214,2,2,305343,305343,305345,0,2,0
87215,5,3,305348,305348,305351,0,3,3
87216,3,3,305351,305351,305354,0,3,0
87217,6,1,305357,305357,305358,0,1,3
87218,6,3,305363,305363,305366,0,3,5
87219,5,2,305368,305368,305370,0,2,2
87220,2,3,305370,305370,305373,0,3,0
87221,4,2,305374,305374,305376,0,2,1
87222,2,3,305376,305376,305379,0,3,0
87223,2,1,305378,305379,305380,1,2,0
87224,4,2,305382,305382,305384,0,2,2
87225,1,1,305383,305384,305385,1,2,0
87226,4,2,305387,305387,305389,0,2,2
87227,4,3,305391,305391,305394,0,3,2
87228,1,3,305392,305394,305397,2,5,0
87229,6,1,305398,305398,305399,0,1,1
87230,5,2,305403,305403,305405,0,2,4
87231,3,3,305406,305406,305409,0,3,1
87232,3,3,305409,305409,305412,0,3,0
87233,3,2,305412,305412,305414,0,2,0
87234,4,3,305416,305416,305419,0,3,2
87235,6,1,305422,305422,305423,0,1,3
87236,3,3,305425,305425,305428,0,3,2
87237,3,2,305428,305428,305430,0,2,0
87238,6,1,305434,305434,305435,0,1,4
87239,5,1,305439,305439,305440,0,1,4
87240,1,2,305440,305440,305442,0,2,0
87241,3,3,305443,305443,305446,0,3,1
87242,4,1,305447,305447,305448,0,1,1
87243,4,1,305451,305451,305452,0,1,3
87244,1,1,305452,305452,305453,0,1,0
87245,3,1,305455,305455,305456,0,1,2
87246,3,1,305458,305458,305459,0,1,2
87247,2,2,305460,305460,305462,0,2,1
87248,4,2,305464,305464,305466,0,2,2
87249,6,1,305470,305470,305471,0,1,4
87250,6,3,305476,305476,305479,0,3,5
87251,2,3,305478,305479,305482,1,4,0
87252,6,2,305484,305484,305486,0,2,2
87253,6,1,305490,305490,305491,0,1,4
87254,4,3,305494,305494,305497,0,3,3
87255,6,2,305500,305500,305502,0,2,3
87256,2,1,305502,305502,305503,0,1,0
87257,5,3,305507,305507,305510,0,3,4
87258,2,1,305509,305510,305511,1,2,0
87259,5,3,305514,305514,305517,0,3,3
87260,4,3,305518,305518,305521,0,3,1
87261,1,3,305519,305521,305524,2,5,0
87262,4,3,305523,305524,305527,1,4,0
87263,2,1,305525,305527,305528,2,3,0
87264,2,2,305527,305528,305530,1,3,0
87265,6,1,305533,305533,305534,0,1,3
87266,2,3,305535,305535,305538,0,3,1
87267,4,3,305539,305539,305542,0,3,1
87268,1,2,305540,305542,305544,2,4,0
87269,4,1,305544,305544,305545,0,1,0
87270,3,2,305547,305547,305549,0,2,2
87271,4,3,305551,305551,305554,0,3,2
87272,2,1,305553,305554,305555,1,2,0
87273,6,1,305559,305559,305560,0,1,4
87274,4,2,305563,305563,305565,0,2,3
87275,6,2,305569,305569,305571,0,2,4
87276,2,2,305571,305571,305573,0,2,0
87277,2,2,305573,305573,305575,0,2,0
87278,1,1,305574,305575,305576,1,2,0
87279,6,2,305580,305580,305582,0,2,4
87280,5,1,305585,305585,305586,0,1,3
87281,4,3,305589,305589,305592,0,3,3
87282,6,1,305595,305595,305596,0,1,3
87283,1,3,305596,305596,305599,0,3,0
87284,3,1,305599,305599,305600,0,1,0
87285,5,3,305604,305604,305607,0,3,4
87286,4,3,305608,305608,305611,0,3,1
87287,3,1,305611,305611,305612,0,1,0
87288,4,2,305615,305615,305617,0,2,3
87289,2,3,305617,305617,305620,0,3,0
87290,2,1,305619,305620,305621,1,2,0
87291,1,2,305620,305621,305623,1,3,0
87292,5,3,305625,305625,305628,0,3,2
87293,5,2,305630,305630,305632,0,2,2
87294,3,1,305633,305633,305634,0,1,1
87295,1,1,305634,305634,305635,0,1,0
87296,4,2,305638,305638,305640,0,2,3
87297,5,1,305643,305643,305644,0,1,3
87298,6,1,305649,305649,305650,0,1,5
87299,6,3,305655,305655,305658,0,3,5
87300,2,1,305657,305658,305659,1,2,0
87301,4,3,305661,305661,305664,0,3,2
87302,6,3,305667,305667,305670,0,3,3
87303,1,2,305668,305670,305672,2,4,0
87304,6,1,305674,305674,305675,0,1,2
87305,4,2,305678,305678,305680,0,2,3
87306,5,3,305683,305683,305686,0,3,3
87307,3,2,305686,305686,305688,0,2,0
87308,5,1,305691,305691,305692,0,1,3
87309,3,1,305694,305694,305695,0,1,2
87310,2,3,305696,305696,305699,0,3,1
87311,1,1,305697,305699,305700,2,3,0
87312,3,2,305700,305700,305702,0,2,0
87313,5,1,305705,305705,305706,0,1,3
87314,4,1,305709,305709,305710,0,1,3
87315,2,3,305711,305711,305714,0,3,1
87316,4,3,305715,305715,305718,0,3,1
87317,6,2,305721,305721,305723,0,2,3
87318,5,3,305726,305726,305729,0,3,3
87319,1,1,305727,305729,305730,2,3,0
87320,5,3,305732,305732,305735,0,3,2
87321,3,3,305735,305735,305738,0,3,0
87322,5,3,305740,305740,305743,0,3,2
87323,1,3,305741,305743,305746,2,5,0
87324,1,3,305742,305746,305749,4,7,0
87325,3,2,305745,305749,305751,4,6,0
87326,6,1,305751,305751,305752,0,1,0
87327,5,2,305756,305756,305758,0,2,4
87328,6,3,305762,305762,305765,0,3,4
87329,5,1,305767,305767,305768,0,1,2
87330,5,2,305772,305772,305774,0,2,4
87331,1,3,305773,305774,305777,1,4,0
87332,2,2,305775,305777,305779,2,4,0
87333,2,2,305777,305779,305781,2,4,0
87334,6,1,305783,305783,305784,0,1,2
87335,3,1,305786,305786,305787,0,1,2
87336,4,1,305790,305790,305791,0,1,3
87337,2,3,305792,305792,305795,0,3,1
87338,4,2,305796,305796,305798,0,2,1
87339,2,2,305798,305798,305800,0,2,0
87340,4,3,305802,305802,305805,0,3,2
87341,4,2,305806,305806,305808,0,2,1
87342,4,3,305810,305810,305813,0,3,2
87343,5,1,305815,305815,305816,0,1,2
87344,5,3,305820,305820,305823,0,3,4
87345,6,2,305826,305826,305828,0,2,3
87346,3,3,305829,305829,305832,0,3,1
87347,6,3,305835,305835,305838,0,3,3
87348,3,3,305838,305838,305841,0,3,0
87349,4,2,305842,305842,305844,0,2,1
87350,2,1,305844,305844,305845,0,1,0
87351,2,2,305846,305846,305848,0,2,1
87352,6,1,305852,305852,305853,0,1,4
87353,4,3,305856,305856,305859,0,3,3
87354,6,3,305862,305862,305865,0,3,3
87355,1,1,305863,305865,305866,2,3,0
87356,1,1,305864,305866,305867,2,3,0
87357,1,1,305865,305867,305868,2,3,0
87358,3,2,305868,305868,305870,0,2,0
87359,4,2,305872,305872,305874,0,2,2
87360,6,3,305878,305878,305881,0,3,4
87361,2,3,305880,305881,305884,1,4,0
87362,6,3,305886,305886,305889,0,3,2
87363,5,1,305891,305891,305892,0,1,2
87364,6,2,305897,305897,305899,0,2,5
87365,1,3,305898,305899,305902,1,4,0
87366,2,1,305900,305902,305903,2,3,0
87367,1,2,305901,305903,305905,2,4,0
87368,1,2,305902,305905,305907,3,5,0
87369,1,3,305903,305907,305910,4,7,0
87370,3,2,305906,305910,305912,4,6,0
87371,4,3,305910,305912,305915,2,5,0
87372,1,2,305911,305915,305917,4,6,0
87373,1,2,305912,305917,305919,5,7,0
87374,5,3,305917,305919,305922,2,5,0
87375,3,1,305920,305922,305923,2,3,0
87376,1,2,305921,305923,305925,2,4,0
87377,6,2,305927,305927,305929,0,2,2
87378,1,3,305928,305929,305932,1,4,0
87379,6,3,305934,305934,305937,0,3,2
87380,1,2,305935,305937,305939,2,4,0
87381,5,3,305940,305940,305943,0,3,1
87382,4,1,305944,305944,305945,0,1,1
87383,1,1,305945,305945,305946,0,1,0
87384,6,3,305951,305951,305954,0,3,5
87385,3,3,305954,305954,305957,0,3,0
87386,2,1,305956,305957,305958,1,2,0
87387,3,3,305959,305959,305962,0,3,1
87388,3,3,305962,305962,305965,0,3,0
87389,3,3,305965,305965,305968,0,3,0
87390,2,3,305967,305968,305971,1,4,0
87391,5,3,305972,305972,305975,0,3,1
87392,2,1,305974,305975,305976,1,2,0
87393,3,1,305977,305977,305978,0,1,1
87394,1,2,305978,305978,305980,0,2,0
87395,5,1,305983,305983,305984,0,1,3
87396,5,3,305988,305988,305991,0,3,4
87397,4,1,305992,305992,305993,0,1,1
87398,5,1,305997,305997,305998,0,1,4
87399,4,2,306001,306001,306003,0,2,3
87400,5,3,306006,306006,306009,0,3,3
87401,1,3,306007,306009,306012,2,5,0
87402,1,2,306008,306012,306014,4,6,0
87403,5,1,306013,306014,306015,1,2,0
87404,5,1,306018,306018,306019,0,1,3
87405,3,2,306021,306021,306023,0,2,2
87406,3,3,306024,306024,306027,0,3,1
87407,6,2,306030,306030,306032,0,2,3
87408,2,3,306032,306032,306035,0,3,0
87409,2,1,306034,306035,306036,1,2,0
87410,4,1,306038,306038,306039,0,1,2
87411,4,2,306042,306042,306044,0,2,3
87412,1,2,306043,306044,306046,1,3,0
87413,1,3,306044,306046,306049,2,5,0
87414,4,2,306048,306049,306051,1,3,0
87415,6,1,306054,306054,306055,0,1,3
87416,3,3,306057,306057,306060,0,3,2
87417,1,1,306058,306060,306061,2,3,0
87418,5,2,306063,306063,306065,0,2,2
87419,6,2,306069,306069,306071,0,2,4
87420,3,3,306072,306072,306075,0,3,1
87421,3,1,306075,306075,306076,0,1,0
87422,4,3,306079,306079,306082,0,3,3
87423,2,3,306081,306082,306085,1,4,0
87424,1,1,306082,306085,306086,3,4,0
87425,2,1,306084,306086,306087,2,3,0
87426,1,1,306085,306087,306088,2,3,0
87427,1,1,306086,306088,306089,2,3,0
87428,6,1,306092,306092,306093,0,1,3
87429,4,1,306096,306096,306097,0,1,3
87430,3,2,306099,306099,306101,0,2,2
87431,3,3,306102,306102,306105,0,3,1
87432,1,2,306103,306105,306107,2,4,0
87433,2,1,306105,306107,306108,2,3,0
87434,4,2,306109,306109,306111,0,2,1
87435,5,2,306114,306114,306116,0,2,3
87436,6,3,306120,306120,306123,0,3,4
87437,4,2,306124,306124,306126,0,2,1
87438,3,2,306127,306127,306129,0,2,1
87439,4,2,306131,306131,306133,0,2,2
87440,2,3,306133,306133,306136,0,3,0
87441,3,1,306136,306136,306137,0,1,0
87442,3,2,306139,306139,306141,0,2,2
87443,1,1,306140,306141,306142,1,2,0
87444,5,3,306145,306145,306148,0,3,3
87445,6,2,306151,306151,306153,0,2,3
87446,5,1,306156,306156,306157,0,1,3
87447,2,3,306158,306158,306161,0,3,1
87448,4,1,306162,306162,306163,0,1,1
87449,4,3,306166,306166,306169,0,3,3
87450,4,2,306170,306170,306172,0,2,1
87451,2,3,306172,306172,306175,0,3,0
87452,2,1,306174,306175,306176,1,2,0
87453,2,1,306176,306176,306177,0,1,0
87454,5,2,306181,306181,306183,0,2,4
87455,2,3,306183,306183,306186,0,3,0
87456,6,3,306189,306189,306192,0,3,3
87457,4,2,306193,306193,306195,0,2,1
87458,2,2,306195,306195,306197,0,2,0
87459,4,1,306199,306199,306200,0,1,2
87460,1,3,306200,306200,306203,0,3,0
87461,3,3,306203,306203,306206,0,3,0
87462,5,1,306208,306208,306209,0,1,2
87463,3,1,306211,306211,306212,0,1,2
87464,6,2,306217,306217,306219,0,2,5
87465,2,1,306219,306219,306220,0,1,0
87466,2,1,306221,306221,306222,0,1,1
87467,2,2,306223,306223,306225,0,2,1
87468,5,3,306228,306228,306231,0,3,3
87469,6,3,306234,306234,306237,0,3,3
87470,5,3,306239,306239,306242,0,3,2
87471,2,3,306241,306242,306245,1,4,0
87472,5,1,306246,306246,306247,0,1,1
87473,5,3,306251,306251,306254,0,3,4
87474,1,3,306252,306254,306257,2,5,0
87475,2,2,306254,306257,306259,3,5,0
87476,3,1,306257,306259,306260,2,3,0
87477,3,3,306260,306260,306263,0,3,0
87478,6,2,306266,306266,306268,0,2,3
87479,5,3,306271,306271,306274,0,3,3
87480,6,1,306277,306277,306278,0,1,3
87481,5,2,306282,306282,306284,0,2,4
87482,4,1,306286,306286,306287,0,1,2
87483,1,3,306287,306287,306290,0,3,0
87484,4,1,306291,306291,306292,0,1,1
87485,2,3,306293,306293,306296,0,3,1
87486,6,3,306299,306299,306302,0,3,3
87487,1,2,306300,306302,306304,2,4,0
87488,2,1,306302,306304,306305,2,3,0
87489,6,2,306308,306308,306310,0,2,3
87490,1,2,306309,306310,306312,1,3,0
87491,6,2,306315,306315,306317,0,2,3
87492,2,2,306317,306317,306319,0,2,0
87493,3,1,306320,306320,306321,0,1,1
87494,2,1,306322,306322,306323,0,1,1
87495,2,2,306324,306324,306326,0,2,1
87496,2,1,306326,306326,306327,0,1,0
87497,4,2,306330,306330,306332,0,2,3
87498,2,1,306332,306332,306333,0,1,0
87499,3,1,306335,306335,306336,0,1,2
87500,2,3,306337,306337,306340,0,3,1
87501,2,1,306339,306340,306341,1,2,0
87502,1,3,306340,306341,306344,1,4,0
87503,3,3,306343,306344,306347,1,4,0
87504,1,3,306344,306347,306350,3,6,0
87505,3,3,306347,306350,306353,3,6,0
87506,1,2,306348,306353,306355,5,7,0
87507,6,3,306354,306355,306358,1,4,0
87508,6,3,306360,306360,306363,0,3,2
87509,3,2,306363,306363,306365,0,2,0
87510,2,3,306365,306365,306368,0,3,0
87511,5,2,306370,306370,306372,0,2,2
87512,1,3,306371,306372,306375,1,4,0
87513,5,2,306376,306376,306378,0,2,1
87514,3,1,306379,306379,306380,0,1,1
87515,1,2,306380,306380,306382,0,2,0
87516,2,1,306382,306382,306383,0,1,0
87517,4,1,306386,306386,306387,0,1,3
87518,6,1,306392,306392,306393,0,1,5
87519,5,2,306397,306397,306399,0,2,4
87520,4,2,306401,306401,306403,0,2,2
87521,4,2,306405,306405,306407,0,2,2
87522,4,2,306409,306409,306411,0,2,2
87523,1,3,306410,306411,306414,1,4,0
87524,1,3,306411,306414,306417,3,6,0
87525,2,3,306413,306417,306420,4,7,0
87526,1,2,306414,306420,306422,6,8,0
87527,4,1,306418,306422,306423,4,5,0
87528,4,2,306422,306423,306425,1,3,0
87529,1,1,306423,306425,306426,2,3,0
87530,6,3,306429,306429,306432,0,3,3
87531,4,3,306433,306433,306436,0,3,1
87532,2,1,306435,306436,306437,1,2,0
87533,1,1,306436,306437,306438,1,2,0
87534,3,1,306439,306439,306440,0,1,1
87535,6,2,306445,306445,306447,0,2,5
87536,3,3,306448,306448,306451,0,3,1
87537,3,2,306451,306451,306453,0,2,0
87538,5,3,306456,306456,306459,0,3,3
87539,6,3,306462,306462,306465,0,3,3
87540,6,3,306468,306468,306471,0,3,3
87541,2,3,306470,306471,306474,1,4,0
87542,2,3,306472,306474,306477,2,5,0
87543,3,3,306475,306477,306480,2,5,0
87544,4,3,306479,306480,306483,1,4,0
87545,5,2,306484,306484,306486,0,2,1
87546,4,1,306488,306488,306489,0,1,2
87547,1,2,306489,306489,306491,0,2,0
87548,2,3,306491,306491,306494,0,3,0
87549,6,1,306497,306497,306498,0,1,3
87550,4,1,306501,306501,306502,0,1,3
87551,1,2,306502,306502,306504,0,2,0
87552,3,1,306505,306505,306506,0,1,1
87553,5,1,306510,306510,306511,0,1,4
87554,3,1,306513,306513,306514,0,1,2
87555,2,2,306515,306515,306517,0,2,1
87556,5,2,306520,306520,306522,0,2,3
87557,4,3,306524,306524,306527,0,3,2
87558,3,3,306527,306527,306530,0,3,0
87559,1,2,306528,306530,306532,2,4,0
87560,4,1,306532,306532,306533,0,1,0
87561,1,2,306533,306533,306535,0,2,0
87562,4,1,306537,306537,306538,0,1,2
87563,2,2,306539,306539,306541,0,2,1
87564,1,1,306540,306541,306542,1,2,0
87565,4,1,306544,306544,306545,0,1,2
87566,4,3,306548,306548,306551,0,3,3
87567,6,3,306554,306554,306557,0,3,3
87568,5,3,306559,306559,306562,0,3,2
87569,2,1,306561,306562,306563,1,2,0
87570,3,1,306564,306564,306565,0,1,1
87571,1,3,306565,306565,306568,0,3,0
87572,2,1,306567,306568,306569,1,2,0
87573,3,1,306570,306570,306571,0,1,1
87574,3,3,306573,306573,306576,0,3,2
87575,1,1,306574,306576,306577,2,3,0
87576,4,2,306578,306578,306580,0,2,1
87577,5,2,306583,306583,306585,0,2,3
87578,6,1,306589,306589,306590,0,1,4
87579,2,1,306591,306591,306592,0,1,1
87580,6,2,306597,306597,306599,0,2,5
87581,5,1,306602,306602,306603,0,1,3
87582,3,3,306605,306605,306608,0,3,2
87583,4,3,306609,306609,306612,0,3,1
87584,2,1,306611,306612,306613,1,2,0
87585,1,1,306612,306613,306614,1,2,0
87586,4,2,306616,306616,306618,0,2,2
87587,5,2,306621,306621,306623,0,2,3
87588,5,3,306626,306626,306629,0,3,3
87589,2,2,306628,306629,306631,1,3,0
87590,6,2,306634,306634,306636,0,2,3
87591,1,1,306635,306636,306637,1,2,0
87592,4,1,306639,306639,306640,0,1,2
87593,4,3,306643,306643,306646,0,3,3
87594,1,3,306644,306646,306649,2,5,0
87595,1,2,306645,306649,306651,4,6,0
87596,2,3,306647,306651,306654,4,7,0
87597,4,1,306651,306654,306655,3,4,0
87598,6,3,306657,306657,306660,0,3,2
87599,3,1,306660,306660,306661,0,1,0
87600,5,2,306665,306665,306667,0,2,4
87601,4,1,306669,306669,306670,0,1,2
87602,2,3,306671,306671,306674,0,3,1
87603,3,1,306674,306674,306675,0,1,0
87604,3,3,306677,306677,306680,0,3,2
87605,5,2,306682,306682,306684,0,2,2
87606,2,3,306684,306684,306687,0,3,0
87607,4,2,306688,306688,306690,0,2,1
87608,2,2,306690,306690,306692,0,2,0
87609,5,1,306695,306695,306696,0,1,3
87610,4,3,306699,306699,306702,0,3,3
87611,4,1,306703,306703,306704,0,1,1
87612,1,2,306704,306704,306706,0,2,0
87613,3,1,306707,306707,306708,0,1,1
87614,2,2,306709,306709,306711,0,2,1
87615,4,2,306713,306713,306715,0,2,2
87616,1,1,306714,306715,306716,1,2,0
87617,2,1,306716,306716,306717,0,1,0
87618,4,1,306720,306720,306721,0,1,3
87619,5,3,306725,306725,306728,0,3,4
87620,1,3,306726,306728,306731,2,5,0
87621,5,3,306731,306731,306734,0,3,0
87622,5,1,306736,306736,306737,0,1,2
87623,4,2,306740,306740,306742,0,2,3
87624,3,3,306743,306743,306746,0,3,1
87625,2,3,306745,306746,306749,1,4,0
87626,3,2,306748,306749,306751,1,3,0
87627,6,2,306754,306754,306756,0,2,3
87628,6,2,306760,306760,306762,0,2,4
87629,1,3,306761,306762,306765,1,4,0
87630,5,2,306766,306766,306768,0,2,1
87631,4,2,306770,306770,306772,0,2,2
87632,1,1,306771,306772,306773,1,2,0
87633,4,3,306775,306775,306778,0,3,2
87634,3,3,306778,306778,306781,0,3,0
87635,5,2,306783,306783,306785,0,2,2
87636,6,3,306789,306789,306792,0,3,4
87637,6,2,306795,306795,306797,0,2,3
87638,1,2,306796,306797,306799,1,3,0
87639,3,1,306799,306799,306800,0,1,0
87640,1,3,306800,306800,306803,0,3,0
87641,5,1,306805,306805,306806,0,1,2
87642,2,3,306807,306807,306810,0,3,1
87643,3,3,306810,306810,306813,0,3,0
87644,5,2,306815,306815,306817,0,2,2
87645,1,1,306816,306817,306818,1,2,0
87646,6,1,306822,306822,306823,0,1,4
87647,1,2,306823,306823,306825,0,2,0
87648,3,3,306826,306826,306829,0,3,1
87649,4,1,306830,306830,306831,0,1,1
87650,1,2,306831,306831,306833,0,2,0
87651,2,3,306833,306833,306836,0,3,0
87652,1,1,306834,306836,306837,2,3,0
87653,5,3,306839,306839,306842,0,3,2
87654,6,3,306845,306845,306848,0,3,3
87655,2,1,306847,306848,306849,1,2,0
87656,1,3,306848,306849,306852,1,4,0
87657,6,2,306854,306854,306856,0,2,2
87658,2,3,306856,306856,306859,0,3,0
87659,5,1,306861,306861,306862,0,1,2
87660,4,2,306865,306865,306867,0,2,3
87661,3,3,306868,306868,306871,0,3,1
87662,6,1,306874,306874,306875,0,1,3
87663,4,1,306878,306878,306879,0,1,3
87664,3,2,306881,306881,306883,0,2,2
87665,6,3,306887,306887,306890,0,3,4
87666,3,1,306890,306890,306891,0,1,0
87667,3,1,306893,306893,306894,0,1,2
87668,6,2,306899,306899,306901,0,2,5
87669,3,1,306902,306902,306903,0,1,1
87670,4,1,306906,306906,306907,0,1,3
87671,1,2,306907,306907,306909,0,2,0
87672,2,3,306909,306909,306912,0,3,0
87673,3,3,306912,306912,306915,0,3,0
87674,2,3,306914,306915,306918,1,4,0
87675,4,2,306918,306918,306920,0,2,0
87676,1,2,306919,306920,306922,1,3,0
87677,2,3,306921,306922,306925,1,4,0
87678,1,1,306922,306925,306926,3,4,0
87679,3,2,306925,306926,306928,1,3,0
87680,5,1,306930,306930,306931,0,1,2
87681,4,2,306934,306934,306936,0,2,3
87682,5,1,306939,306939,306940,0,1,3
87683,5,1,306944,306944,306945,0,1,4
87684,1,3,306945,306945,306948,0,3,0
87685,1,1,306946,306948,306949,2,3,0
87686,3,3,306949,306949,306952,0,3,0
87687,1,2,306950,306952,306954,2,4,0
87688,2,3,306952,306954,306957,2,5,0
87689,6,3,306958,306958,306961,0,3,1
87690,4,2,306962,306962,306964,0,2,1
87691,3,2,306965,306965,306967,0,2,1
87692,2,2,306967,306967,306969,0,2,0
87693,6,2,306973,306973,306975,0,2,4
87694,6,2,306979,306979,306981,0,2,4
87695,5,3,306984,306984,306987,0,3,3
87696,1,3,306985,306987,306990,2,5,0
87697,3,2,306988,306990,306992,2,4,0
87698,6,1,306994,306994,306995,0,1,2
87699,1,3,306995,306995,306998,0,3,0
87700,6,2,307001,307001,307003,0,2,3
87701,5,1,307006,307006,307007,0,1,3
87702,1,3,307007,307007,307010,0,3,0
87703,5,3,307012,307012,307015,0,3,2
87704,4,2,307016,307016,307018,0,2,1
87705,3,1,307019,307019,307020,0,1,1
87706,5,3,307024,307024,307027,0,3,4
87707,5,2,307029,307029,307031,0,2,2
87708,4,1,307033,307033,307034,0,1,2
87709,6,1,307039,307039,307040,0,1,5
87710,1,2,307040,307040,307042,0,2,0
87711,3,2,307043,307043,307045,0,2,1
87712,3,1,307046,307046,307047,0,1,1
87713,3,3,307049,307049,307052,0,3,2
87714,4,1,307053,307053,307054,0,1,1
87715,4,1,307057,307057,307058,0,1,3
87716,2,1,307059,307059,307060,0,1,1
87717,3,2,307062,307062,307064,0,2,2
87718,1,1,307063,307064,307065,1,2,0
87719,1,2,307064,307065,307067,1,3,0
87720,5,3,307069,307069,307072,0,3,2
87721,2,1,307071,307072,307073,1,2,0
87722,6,3,307077,307077,307080,0,3,4
87723,5,1,307082,307082,307083,0,1,2
87724,5,2,307087,307087,307089,0,2,4
87725,2,1,307089,307089,307090,0,1,0
87726,3,3,307092,307092,307095,0,3,2
87727,2,3,307094,307095,307098,1,4,0
87728,1,2,307095,307098,307100,3,5,0
87729,4,2,307099,307100,307102,1,3,0
87730,6,2,307105,307105,307107,0,2,3
87731,4,3,307109,307109,307112,0,3,2
87732,5,3,307114,307114,307117,0,3,2
87733,5,3,307119,307119,307122,0,3,2
87734,4,2,307123,307123,307125,0,2,1
87735,4,3,307127,307127,307130,0,3,2
87736,1,1,307128,307130,307131,2,3,0
87737,3,1,307131,307131,307132,0,1,0
87738,1,1,307132,307132,307133,0,1,0
87739,6,1,307138,307138,307139,0,1,5
87740,3,1,307141,307141,307142,0,1,2
87741,6,3,307147,307147,307150,0,3,5
87742,1,2,307148,307150,307152,2,4,0
87743,4,3,307152,307152,307155,0,3,0
87744,4,1,307156,307156,307157,0,1,1
87745,3,1,307159,307159,307160,0,1,2
87746,5,3,307164,307164,307167,0,3,4
87747,4,1,307168,307168,307169,0,1,1
87748,4,3,307172,307172,307175,0,3,3
87749,5,3,307177,307177,307180,0,3,2
87750,4,1,307181,307181,307182,0,1,1
87751,4,3,307185,307185,307188,0,3,3
87752,2,3,307187,307188,307191,1,4,0
87753,4,1,307191,307191,307192,0,1,0
87754,2,3,307193,307193,307196,0,3,1
87755,4,3,307197,307197,307200,0,3,1
87756,3,2,307200,307200,307202,0,2,0
87757,6,3,307206,307206,307209,0,3,4
87758,5,1,307211,307211,307212,0,1,2
87759,6,3,307217,307217,307220,0,3,5
87760,1,1,307218,307220,307221,2,3,0
87761,4,3,307222,307222,307225,0,3,1
87762,5,1,307227,307227,307228,0,1,2
87763,6,3,307233,307233,307236,0,3,5
87764,1,2,307234,307236,307238,2,4,0
87765,6,3,307240,307240,307243,0,3,2
87766,3,1,307243,307243,307244,0,1,0
87767,1,3,307244,307244,307247,0,3,0
87768,2,1,307246,307247,307248,1,2,0
87769,6,1,307252,307252,307253,0,1,4
87770,6,2,307258,307258,307260,0,2,5
87771,5,2,307263,307263,307265,0,2,3
87772,4,1,307267,307267,307268,0,1,2
87773,1,2,307268,307268,307270,0,2,0
87774,4,1,307272,307272,307273,0,1,2
87775,5,1,307277,307277,307278,0,1,4
87776,1,2,307278,307278,307280,0,2,0
87777,4,1,307282,307282,307283,0,1,2
87778,6,1,307288,307288,307289,0,1,5
87779,6,3,307294,307294,307297,0,3,5
87780,3,3,307297,307297,307300,0,3,0
87781,3,1,307300,307300,307301,0,1,0
87782,1,3,307301,307301,307304,0,3,0
87783,2,3,307303,307304,307307,1,4,0
87784,4,3,307307,307307,307310,0,3,0
87785,6,1,307313,307313,307314,0,1,3
87786,6,3,307319,307319,307322,0,3,5
87787,5,3,307324,307324,307327,0,3,2
87788,5,1,307329,307329,307330,0,1,2
87789,5,1,307334,307334,307335,0,1,4
87790,2,1,307336,307336,307337,0,1,1
87791,2,3,307338,307338,307341,0,3,1
87792,6,2,307344,307344,307346,0,2,3
87793,4,1,307348,307348,307349,0,1,2
87794,3,3,307351,307351,307354,0,3,2
87795,1,3,307352,307354,307357,2,5,0
87796,6,2,307358,307358,307360,0,2,1
87797,3,2,307361,307361,307363,0,2,1
87798,1,1,307362,307363,307364,1,2,0
87799,2,2,307364,307364,307366,0,2,0
87800,2,2,307366,307366,307368,0,2,0
87801,5,1,307371,307371,307372,0,1,3
87802,5,1,307376,307376,307377,0,1,4
87803,1,3,307377,307377,307380,0,3,0
87804,3,2,307380,307380,307382,0,2,0
87805,4,1,307384,307384,307385,0,1,2
87806,6,2,307390,307390,307392,0,2,5
87807,1,1,307391,307392,307393,1,2,0
87808,5,3,307396,307396,307399,0,3,3
87809,6,1,307402,307402,307403,0,1,3
87810,3,1,307405,307405,307406,0,1,2
87811,4,3,307409,307409,307412,0,3,3
87812,1,3,307410,307412,307415,2,5,0
87813,3,1,307413,307415,307416,2,3,0
87814,6,2,307419,307419,307421,0,2,3
87815,1,3,307420,307421,307424,1,4,0
87816,5,1,307425,307425,307426,0,1,1
87817,6,2,307431,307431,307433,0,2,5
87818,6,1,307437,307437,307438,0,1,4
87819,5,2,307442,307442,307444,0,2,4
87820,5,1,307447,307447,307448,0,1,3
87821,5,2,307452,307452,307454,0,2,4
87822,3,3,307455,307455,307458,0,3,1
87823,1,2,307456,307458,307460,2,4,0
87824,4,1,307460,307460,307461,0,1,0
87825,2,1,307462,307462,307463,0,1,1
87826,4,2,307466,307466,307468,0,2,3
87827,2,2,307468,307468,307470,0,2,0
87828,4,3,307472,307472,307475,0,3,2
87829,6,3,307478,307478,307481,0,3,3
87830,2,1,307480,307481,307482,1,2,0
87831,2,3,307482,307482,307485,0,3,0
87832,1,3,307483,307485,307488,2,5,0
87833,3,1,307486,307488,307489,2,3,0
87834,2,1,307488,307489,307490,1,2,0
87835,2,2,307490,307490,307492,0,2,0
87836,5,1,307495,307495,307496,0,1,3
87837,5,2,307500,307500,307502,0,2,4
87838,4,2,307504,307504,307506,0,2,2
87839,1,3,307505,307506,307509,1,4,0
87840,3,2,307508,307509,307511,1,3,0
87841,2,3,307510,307511,307514,1,4,0
87842,6,2,307516,307516,307518,0,2,2
87843,5,1,307521,307521,307522,0,1,3
87844,2,2,307523,307523,307525,0,2,1
87845,5,2,307528,307528,307530,0,2,3
87846,2,1,307530,307530,307531,0,1,0
87847,2,2,307532,307532,307534,0,2,1
87848,1,2,307533,307534,307536,1,3,0
87849,5,2,307538,307538,307540,0,2,2
87850,6,2,307544,307544,307546,0,2,4
87851,3,2,307547,307547,307549,0,2,1
87852,6,3,307553,307553,307556,0,3,4
87853,3,2,307556,307556,307558,0,2,0
87854,5,1,307561,307561,307562,0,1,3
87855,3,2,307564,307564,307566,0,2,2
87856,3,2,307567,307567,307569,0,2,1
87857,4,1,307571,307571,307572,0,1,2
87858,5,3,307576,307576,307579,0,3,4
87859,5,1,307581,307581,307582,0,1,2
87860,1,1,307582,307582,307583,0,1,0
87861,2,1,307584,307584,307585,0,1,1
87862,2,2,307586,307586,307588,0,2,1
87863,6,3,307592,307592,307595,0,3,4
87864,5,1,307597,307597,307598,0,1,2
87865,4,1,307601,307601,307602,0,1,3
87866,3,1,307604,307604,307605,0,1,2
87867,1,2,307605,307605,307607,0,2,0
87868,2,3,307607,307607,307610,0,3,0
87869,3,1,307610,307610,307611,0,1,0
87870,5,1,307615,307615,307616,0,1,4
87871,3,3,307618,307618,307621,0,3,2
87872,5,1,307623,307623,307624,0,1,2
87873,1,2,307624,307624,307626,0,2,0
87874,5,2,307629,307629,307631,0,2,3
87875,5,1,307634,307634,307635,0,1,3
87876,6,2,307640,307640,307642,0,2,5
87877,2,2,307642,307642,307644,0,2,0
87878,4,2,307646,307646,307648,0,2,2
87879,5,3,307651,307651,307654,0,3,3
87880,2,3,307653,307654,307657,1,4,0
87881,5,3,307658,307658,307661,0,3,1
87882,3,2,307661,307661,307663,0,2,0
87883,2,1,307663,307663,307664,0,1,0
87884,2,3,307665,307665,307668,0,3,1
87885,4,3,307669,307669,307672,0,3,1
87886,6,1,307675,307675,307676,0,1,3
87887,2,2,307677,307677,307679,0,2,1
87888,5,3,307682,307682,307685,0,3,3
87889,4,1,307686,307686,307687,0,1,1
87890,4,1,307690,307690,307691,0,1,3
87891,6,2,307696,307696,307698,0,2,5
87892,3,1,307699,307699,307700,0,1,1
87893,3,2,307702,307702,307704,0,2,2
87894,3,2,307705,307705,307707,0,2,1
87895,1,2,307706,307707,307709,1,3,0
87896,4,3,307710,307710,307713,0,3,1
87897,6,1,307716,307716,307717,0,1,3
87898,2,2,307718,307718,307720,0,2,1
87899,1,2,307719,307720,307722,1,3,0
87900,3,1,307722,307722,307723,0,1,0
87901,1,1,307723,307723,307724,0,1,0
87902,4,3,307727,307727,307730,0,3,3
87903,1,3,307728,307730,307733,2,5,0
87904,4,3,307732,307733,307736,1,4,0
87905,2,2,307734,307736,307738,2,4,0
87906,2,1,307736,307738,307739,2,3,0
87907,3,1,307739,307739,307740,0,1,0
87908,1,1,307740,307740,307741,0,1,0
87909,4,3,307744,307744,307747,0,3,3
87910,6,1,307750,307750,307751,0,1,3
87911,4,2,307754,307754,307756,0,2,3
87912,2,2,307756,307756,307758,0,2,0
87913,4,2,307760,307760,307762,0,2,2
87914,5,1,307765,307765,307766,0,1,3
87915,5,1,307770,307770,307771,0,1,4
87916,1,2,307771,307771,307773,0,2,0
87917,3,2,307774,307774,307776,0,2,1
87918,3,3,307777,307777,307780,0,3,1
87919,2,1,307779,307780,307781,1,2,0
87920,1,3,307780,307781,307784,1,4,0
87921,4,2,307784,307784,307786,0,2,0
87922,2,1,307786,307786,307787,0,1,0
87923,3,1,307789,307789,307790,0,1,2
87924,6,2,307795,307795,307797,0,2,5
87925,1,1,307796,307797,307798,1,2,0
87926,1,2,307797,307798,307800,1,3,0
87927,6,2,307803,307803,307805,0,2,3
87928,3,3,307806,307806,307809,0,3,1
87929,5,3,307811,307811,307814,0,3,2
87930,5,3,307816,307816,307819,0,3,2
87931,1,3,307817,307819,307822,2,5,0
87932,2,3,307819,307822,307825,3,6,0
87933,5,2,307824,307825,307827,1,3,0
87934,4,1,307828,307828,307829,0,1,1
87935,5,3,307833,307833,307836,0,3,4
87936,2,3,307835,307836,307839,1,4,0
87937,5,2,307840,307840,307842,0,2,1
87938,6,3,307846,307846,307849,0,3,4
87939,3,1,307849,307849,307850,0,1,0
87940,5,3,307854,307854,307857,0,3,4
87941,5,2,307859,307859,307861,0,2,2
87942,1,3,307860,307861,307864,1,4,0
87943,3,2,307863,307864,307866,1,3,0
87944,5,2,307868,307868,307870,0,2,2
87945,2,3,307870,307870,307873,0,3,0
87946,1,2,307871,307873,307875,2,4,0
87947,5,1,307876,307876,307877,0,1,1
87948,6,2,307882,307882,307884,0,2,5
87949,1,2,307883,307884,307886,1,3,0
87950,2,3,307885,307886,307889,1,4,0
87951,4,2,307889,307889,307891,0,2,0
87952,1,1,307890,307891,307892,1,2,0
87953,3,2,307893,307893,307895,0,2,1
87954,5,2,307898,307898,307900,0,2,3
87955,4,1,307902,307902,307903,0,1,2
87956,1,3,307903,307903,307906,0,3,0
87957,2,3,307905,307906,307909,1,4,0
87958,4,2,307909,307909,307911,0,2,0
87959,6,2,307915,307915,307917,0,2,4
87960,2,3,307917,307917,307920,0,3,0
87961,4,3,307921,307921,307924,0,3,1
87962,2,1,307923,307924,307925,1,2,0
87963,5,3,307928,307928,307931,0,3,3
87964,1,1,307929,307931,307932,2,3,0
87965,5,3,307934,307934,307937,0,3,2
87966,1,2,307935,307937,307939,2,4,0
87967,4,3,307939,307939,307942,0,3,0
87968,5,2,307944,307944,307946,0,2,2
87969,4,1,307948,307948,307949,0,1,2
87970,6,2,307954,307954,307956,0,2,5
87971,6,3,307960,307960,307963,0,3,4
87972,3,3,307963,307963,307966,0,3,0
87973,4,1,307967,307967,307968,0,1,1
87974,4,1,307971,307971,307972,0,1,3
87975,4,2,307975,307975,307977,0,2,3
87976,4,2,307979,307979,307981,0,2,2
87977,5,3,307984,307984,307987,0,3,3
87978,1,3,307985,307987,307990,2,5,0
87979,4,1,307989,307990,307991,1,2,0
87980,4,1,307993,307993,307994,0,1,2
87981,4,2,307997,307997,307999,0,2,3
87982,3,2,308000,308000,308002,0,2,1
87983,3,2,308003,308003,308005,0,2,1
87984,1,2,308004,308005,308007,1,3,0
87985,1,1,308005,308007,308008,2,3,0
87986,2,1,308007,308008,308009,1,2,0
87987,2,3,308009,308009,308012,0,3,0
87988,1,3,308010,308012,308015,2,5,0
87989,1,3,308011,308015,308018,4,7,0
87990,4,3,308015,308018,308021,3,6,0
87991,6,3,308021,308021,308024,0,3,0
87992,5,3,308026,308026,308029,0,3,2
87993,6,1,308032,308032,308033,0,1,3
87994,2,2,308034,308034,308036,0,2,1
87995,3,2,308037,308037,308039,0,2,1
87996,5,1,308042,308042,308043,0,1,3
87997,3,2,308045,308045,308047,0,2,2
87998,3,2,308048,308048,308050,0,2,1
87999,2,2,308050,308050,308052,0,2,0
88000,6,1,308056,308056,308057,0,1,4
88001,5,1,308061,308061,308062,0,1,4
88002,5,1,308066,308066,308067,0,1,4
88003,5,2,308071,308071,308073,0,2,4
88004,1,2,308072,308073,308075,1,3,0
88005,2,1,308074,308075,308076,1,2,0
88006,1,2,308075,308076,308078,1,3,0
88007,4,1,308079,308079,308080,0,1,1
88008,5,3,308084,308084,308087,0,3,4
88009,1,1,308085,308087,308088,2,3,0
88010,4,1,308089,308089,308090,0,1,1
88011,3,2,308092,308092,308094,0,2,2
88012,6,2,308098,308098,308100,0,2,4
88013,5,2,308103,308103,308105,0,2,3
88014,6,2,308109,308109,308111,0,2,4
88015,5,3,308114,308114,308117,0,3,3
88016,1,3,308115,308117,308120,2,5,0
88017,3,3,308118,308120,308123,2,5,0
88018,1,2,308119,308123,308125,4,6,0
88019,6,1,308125,308125,308126,0,1,0
88020,6,2,308131,308131,308133,0,2,5
88021,3,1,308134,308134,308135,0,1,1
88022,3,1,308137,308137,308138,0,1,2
88023,1,3,308138,308138,308141,0,3,0
88024,2,3,308140,308141,308144,1,4,0
88025,4,3,308144,308144,308147,0,3,0
88026,3,2,308147,308147,308149,0,2,0
88027,2,1,308149,308149,308150,0,1,0
88028,4,2,308153,308153,308155,0,2,3
88029,2,3,308155,308155,308158,0,3,0
88030,2,1,308157,308158,308159,1,2,0
88031,6,1,308163,308163,308164,0,1,4
88032,4,1,308167,308167,308168,0,1,3
88033,5,3,308172,308172,308175,0,3,4
88034,6,2,308178,308178,308180,0,2,3
88035,5,3,308183,308183,308186,0,3,3
88036,2,1,308185,308186,308187,1,2,0
88037,6,1,308191,308191,308192,0,1,4
88038,6,2,308197,308197,308199,0,2,5
88039,2,2,308199,308199,308201,0,2,0
88040,3,3,308202,308202,308205,0,3,1
88041,1,2,308203,308205,308207,2,4,0
88042,5,3,308208,308208,308211,0,3,1
88043,2,2,308210,308211,308213,1,3,0
88044,4,3,308214,308214,308217,0,3,1
88045,2,2,308216,308217,308219,1,3,0
88046,1,3,308217,308219,308222,2,5,0
88047,3,1,308220,308222,308223,2,3,0
88048,3,3,308223,308223,308226,0,3,0
88049,6,1,308229,308229,308230,0,1,3
88050,6,1,308235,308235,308236,0,1,5
88051,3,1,308238,308238,308239,0,1,2
88052,3,3,308241,308241,308244,0,3,2
88053,4,1,308245,308245,308246,0,1,1
88054,6,1,308251,308251,308252,0,1,5
88055,4,2,308255,308255,308257,0,2,3
88056,4,3,308259,308259,308262,0,3,2
88057,4,2,308263,308263,308265,0,2,1
88058,2,1,308265,308265,308266,0,1,0
88059,2,2,308267,308267,308269,0,2,1
88060,2,2,308269,308269,308271,0,2,0
88061,1,2,308270,308271,308273,1,3,0
88062,1,2,308271,308273,308275,2,4,0
88063,4,3,308275,308275,308278,0,3,0
88064,4,3,308279,308279,308282,0,3,1
88065,3,2,308282,308282,308284,0,2,0
88066,2,1,308284,308284,308285,0,1,0
88067,2,3,308286,308286,308289,0,3,1
88068,5,2,308291,308291,308293,0,2,2
88069,5,2,308296,308296,308298,0,2,3
88070,4,3,308300,308300,308303,0,3,2
88071,6,2,308306,308306,308308,0,2,3
88072,1,3,308307,308308,308311,1,4,0
88073,5,3,308312,308312,308315,0,3,1
88074,5,3,308317,308317,308320,0,3,2
88075,6,3,308323,308323,308326,0,3,3
88076,3,2,308326,308326,308328,0,2,0
88077,4,3,308330,308330,308333,0,3,2
88078,6,1,308336,308336,308337,0,1,3
88079,3,3,308339,308339,308342,0,3,2
88080,2,3,308341,308342,308345,1,4,0
88081,5,1,308346,308346,308347,0,1,1
88082,2,3,308348,308348,308351,0,3,1
88083,6,3,308354,308354,308357,0,3,3
88084,1,3,308355,308357,308360,2,5,0
88085,3,2,308358,308360,308362,2,4,0
88086,2,1,308360,308362,308363,2,3,0
88087,5,2,308365,308365,308367,0,2,2
88088,2,2,308367,308367,308369,0,2,0
88089,6,1,308373,308373,308374,0,1,4
88090,4,1,308377,308377,308378,0,1,3
88091,4,3,308381,308381,308384,0,3,3
88092,3,2,308384,308384,308386,0,2,0
88093,5,1,308389,308389,308390,0,1,3
88094,5,1,308394,308394,308395,0,1,4
88095,4,1,308398,308398,308399,0,1,3
88096,6,1,308404,308404,308405,0,1,5
88097,4,3,308408,308408,308411,0,3,3
88098,5,1,308413,308413,308414,0,1,2
88099,6,3,308419,308419,308422,0,3,5
88100,4,3,308423,308423,308426,0,3,1
88101,4,2,308427,308427,308429,0,2,1
88102,5,3,308432,308432,308435,0,3,3
88103,5,2,308437,308437,308439,0,2,2
88104,2,2,308439,308439,308441,0,2,0
88105,2,3,308441,308441,308444,0,3,0
88106,4,1,308445,308445,308446,0,1,1
88107,2,2,308447,308447,308449,0,2,1
88108,1,1,308448,308449,308450,1,2,0
88109,6,3,308454,308454,308457,0,3,4
88110,2,2,308456,308457,308459,1,3,0
88111,6,1,308462,308462,308463,0,1,3
88112,5,1,308467,308467,308468,0,1,4
88113,5,1,308472,308472,308473,0,1,4
88114,3,3,308475,308475,308478,0,3,2
88115,4,3,308479,308479,308482,0,3,1
88116,6,2,308485,308485,308487,0,2,3
88117,6,2,308491,308491,308493,0,2,4
88118,1,1,308492,308493,308494,1,2,0
88119,5,2,308497,308497,308499,0,2,3
88120,6,3,308503,308503,308506,0,3,4
88121,5,2,308508,308508,308510,0,2,2
88122,3,2,308511,308511,308513,0,2,1
88123,1,2,308512,308513,308515,1,3,0
88124,3,3,308515,308515,308518,0,3,0
88125,4,3,308519,308519,308522,0,3,1
88126,4,2,308523,308523,308525,0,2,1
88127,4,2,308527,308527,308529,0,2,2
88128,4,2,308531,308531,308533,0,2,2
88129,3,2,308534,308534,308536,0,2,1
88130,4,3,308538,308538,308541,0,3,2
88131,3,3,308541,308541,308544,0,3,0
88132,5,3,308546,308546,308549,0,3,2
88133,4,3,308550,308550,308553,0,3,1
88134,1,2,308551,308553,308555,2,4,0
88135,1,2,308552,308555,308557,3,5,0
88136,3,1,308555,308557,308558,2,3,0
88137,6,1,308561,308561,308562,0,1,3
88138,2,2,308563,308563,308565,0,2,1
88139,2,1,308565,308565,308566,0,1,0
88140,1,2,308566,308566,308568,0,2,0
88141,4,2,308570,308570,308572,0,2,2
88142,4,2,308574,308574,308576,0,2,2
88143,3,1,308577,308577,308578,0,1,1
88144,3,3,308580,308580,308583,0,3,2
88145,4,2,308584,308584,308586,0,2,1
88146,4,2,308588,308588,308590,0,2,2
88147,2,3,308590,308590,308593,0,3,0
88148,5,2,308595,308595,308597,0,2,2
88149,1,3,308596,308597,308600,1,4,0
88150,4,1,308600,308600,308601,0,1,0
88151,4,3,308604,308604,308607,0,3,3
88152,5,1,308609,308609,308610,0,1,2
88153,1,1,308610,308610,308611,0,1,0
88154,6,1,308616,308616,308617,0,1,5
88155,6,1,308622,308622,308623,0,1,5
88156,6,1,308628,308628,308629,0,1,5
88157,6,1,308634,308634,308635,0,1,5
88158,6,1,308640,308640,308641,0,1,5
88159,6,2,308646,308646,308648,0,2,5
88160,6,3,308652,308652,308655,0,3,4
88161,3,3,308655,308655,308658,0,3,0
88162,6,1,308661,308661,308662,0,1,3
88163,1,1,308662,308662,308663,0,1,0
88164,3,2,308665,308665,308667,0,2,2
88165,1,2,308666,308667,308669,1,3,0
88166,1,2,308667,308669,308671,2,4,0
88167,6,3,308673,308673,308676,0,3,2
88168,4,3,308677,308677,308680,0,3,1
88169,6,2,308683,308683,308685,0,2,3
88170,1,1,308684,308685,308686,1,2,0
88171,6,2,308690,308690,308692,0,2,4
88172,3,1,308693,308693,308694,0,1,1
88173,3,1,308696,308696,308697,0,1,2
88174,4,3,308700,308700,308703,0,3,3
88175,5,3,308705,308705,308708,0,3,2
88176,4,2,308709,308709,308711,0,2,1
88177,1,3,308710,308711,308714,1,4,0
88178,6,2,308716,308716,308718,0,2,2
88179,6,2,308722,308722,308724,0,2,4
88180,5,2,308727,308727,308729,0,2,3
88181,3,1,308730,308730,308731,0,1,1
88182,3,3,308733,308733,308736,0,3,2
88183,2,1,308735,308736,308737,1,2,0
88184,2,1,308737,308737,308738,0,1,0
88185,6,3,308743,308743,308746,0,3,5
88186,1,1,308744,308746,308747,2,3,0
88187,4,1,308748,308748,308749,0,1,1
88188,4,3,308752,308752,308755,0,3,3
88189,6,2,308758,308758,308760,0,2,3
88190,1,1,308759,308760,308761,1,2,0
88191,3,2,308762,308762,308764,0,2,1
88192,3,1,308765,308765,308766,0,1,1
88193,6,2,308771,308771,308773,0,2,5
88194,2,1,308773,308773,308774,0,1,0
88195,6,3,308779,308779,308782,0,3,5
88196,1,2,308780,308782,308784,2,4,0
88197,2,2,308782,308784,308786,2,4,0
88198,6,1,308788,308788,308789,0,1,2
88199,5,3,308793,308793,308796,0,3,4
88200,5,1,308798,308798,308799,0,1,2
88201,2,1,308800,308800,308801,0,1,1
88202,5,1,308805,308805,308806,0,1,4
88203,6,1,308811,308811,308812,0,1,5
88204,6,3,308817,308817,308820,0,3,5
88205,4,3,308821,308821,308824,0,3,1
88206,1,3,308822,308824,308827,2,5,0
88207,6,2,308828,308828,308830,0,2,1
88208,1,1,308829,308830,308831,1,2,0
88209,3,1,308832,308832,308833,0,1,1
88210,4,2,308836,308836,308838,0,2,3
88211,2,3,308838,308838,308841,0,3,0
88212,4,2,308842,308842,308844,0,2,1
88213,1,2,308843,308844,308846,1,3,0
88214,5,1,308848,308848,308849,0,1,2
88215,5,1,308853,308853,308854,0,1,4
88216,5,3,308858,308858,308861,0,3,4
88217,5,2,308863,308863,308865,0,2,2
88218,2,3,308865,308865,308868,0,3,0
88219,2,3,308867,308868,308871,1,4,0
88220,4,1,308871,308871,308872,0,1,0
88221,2,2,308873,308873,308875,0,2,1
88222,4,1,308877,308877,308878,0,1,2
88223,1,3,308878,308878,308881,0,3,0
88224,4,2,308882,308882,308884,0,2,1
88225,6,3,308888,308888,308891,0,3,4
88226,1,1,308889,308891,308892,2,3,0
88227,1,2,308890,308892,308894,2,4,0
88228,2,1,308892,308894,308895,2,3,0
88229,4,2,308896,308896,308898,0,2,1
88230,2,1,308898,308898,308899,0,1,0
88231,3,3,308901,308901,308904,0,3,2
88232,3,1,308904,308904,308905,0,1,0
88233,5,2,308909,308909,308911,0,2,4
88234,5,2,308914,308914,308916,0,2,3
88235,3,2,308917,308917,308919,0,2,1
88236,5,1,308922,308922,308923,0,1,3
88237,1,2,308923,308923,308925,0,2,0
88238,2,1,308925,308925,308926,0,1,0
88239,4,2,308929,308929,308931,0,2,3
88240,3,3,308932,308932,308935,0,3,1
88241,4,2,308936,308936,308938,0,2,1
88242,4,2,308940,308940,308942,0,2,2
88243,3,2,308943,308943,308945,0,2,1
88244,3,3,308946,308946,308949,0,3,1
88245,2,2,308948,308949,308951,1,3,0
88246,1,1,308949,308951,308952,2,3,0
88247,5,3,308954,308954,308957,0,3,2
88248,2,2,308956,308957,308959,1,3,0
88249,4,1,308960,308960,308961,0,1,1
88250,1,3,308961,308961,308964,0,3,0
88251,5,3,308966,308966,308969,0,3,2
88252,5,1,308971,308971,308972,0,1,2
88253,5,1,308976,308976,308977,0,1,4
88254,5,2,308981,308981,308983,0,2,4
88255,3,2,308984,308984,308986,0,2,1
88256,4,2,308988,308988,308990,0,2,2
88257,5,2,308993,308993,308995,0,2,3
88258,6,1,308999,308999,309000,0,1,4
88259,4,1,309003,309003,309004,0,1,3
88260,6,3,309009,309009,309012,0,3,5
88261,5,2,309014,309014,309016,0,2,2
88262,6,1,309020,309020,309021,0,1,4
88263,4,2,309024,309024,309026,0,2,3
88264,4,1,309028,309028,309029,0,1,2
88265,2,2,309030,309030,309032,0,2,1
88266,5,3,309035,309035,309038,0,3,3
88267,3,1,309038,309038,309039,0,1,0
88268,6,1,309044,309044,309045,0,1,5
88269,3,3,309047,309047,309050,0,3,2
88270,1,1,309048,309050,309051,2,3,0
88271,6,2,309054,309054,309056,0,2,3
88272,2,1,309056,309056,309057,0,1,0
88273,3,1,309059,309059,309060,0,1,2
88274,4,2,309063,309063,309065,0,2,3
88275,3,2,309066,309066,309068,0,2,1
88276,4,2,309070,309070,309072,0,2,2
88277,4,1,309074,309074,309075,0,1,2
88278,4,1,309078,309078,309079,0,1,3
88279,6,1,309084,309084,309085,0,1,5
88280,3,1,309087,309087,309088,0,1,2
88281,4,2,309091,309091,309093,0,2,3
88282,4,1,309095,309095,309096,0,1,2
88283,5,1,309100,309100,309101,0,1,4
88284,5,1,309105,309105,309106,0,1,4
88285,6,2,309111,309111,309113,0,2,5
88286,3,1,309114,309114,309115,0,1,1
88287,4,3,309118,309118,309121,0,3,3
88288,1,2,309119,309121,309123,2,4,0
88289,1,1,309120,309123,309124,3,4,0
88290,2,2,309122,309124,309126,2,4,0
88291,5,1,309127,309127,309128,0,1,1
88292,4,2,309131,309131,309133,0,2,3
88293,5,1,309136,309136,309137,0,1,3
88294,1,3,309137,309137,309140,0,3,0
88295,4,3,309141,309141,309144,0,3,1
88296,5,3,309146,309146,309149,0,3,2
88297,3,2,309149,309149,309151,0,2,0
88298,5,1,309154,309154,309155,0,1,3
88299,6,1,309160,309160,309161,0,1,5
88300,6,1,309166,309166,309167,0,1,5
88301,5,3,309171,309171,309174,0,3,4
88302,4,2,309175,309175,309177,0,2,1
88303,5,3,309180,309180,309183,0,3,3
88304,5,3,309185,309185,309188,0,3,2
88305,1,1,309186,309188,309189,2,3,0
88306,6,2,309192,309192,309194,0,2,3
88307,3,3,309195,309195,309198,0,3,1
88308,5,2,309200,309200,309202,0,2,2
88309,4,1,309204,309204,309205,0,1,2
88310,5,3,309209,309209,309212,0,3,4
88311,2,1,309211,309212,309213,1,2,0
88312,3,3,309214,309214,309217,0,3,1
88313,5,1,309219,309219,309220,0,1,2
88314,1,2,309220,309220,309222,0,2,0
88315,2,3,309222,309222,309225,0,3,0
88316,5,3,309227,309227,309230,0,3,2
88317,1,2,309228,309230,309232,2,4,0
88318,2,2,309230,309232,309234,2,4,0
88319,4,1,309234,309234,309235,0,1,0
88320,4,3,309238,309238,309241,0,3,3
88321,2,3,309240,309241,309244,1,4,0
88322,4,3,309244,309244,309247,0,3,0
88323,2,3,309246,309247,309250,1,4,0
88324,4,3,309250,309250,309253,0,3,0
88325,4,2,309254,309254,309256,0,2,1
88326,6,1,309260,309260,309261,0,1,4
88327,2,3,309262,309262,309265,0,3,1
88328,5,1,309267,309267,309268,0,1,2
88329,4,1,309271,309271,309272,0,1,3
88330,3,3,309274,309274,309277,0,3,2
88331,2,1,309276,309277,309278,1,2,0
88332,1,2,309277,309278,309280,1,3,0
88333,1,1,309278,309280,309281,2,3,0
88334,6,3,309284,309284,309287,0,3,3
88335,6,2,309290,309290,309292,0,2,3
88336,1,1,309291,309292,309293,1,2,0
88337,1,2,309292,309293,309295,1,3,0
88338,1,2,309293,309295,309297,2,4,0
88339,2,2,309295,309297,309299,2,4,0
88340,5,3,309300,309300,309303,0,3,1
88341,1,1,309301,309303,309304,2,3,0
88342,6,3,309307,309307,309310,0,3,3
88343,6,3,309313,309313,309316,0,3,3
88344,6,3,309319,309319,309322,0,3,3
88345,1,2,309320,309322,309324,2,4,0
88346,5,2,309325,309325,309327,0,2,1
88347,5,3,309330,309330,309333,0,3,3
88348,5,3,309335,309335,309338,0,3,2
88349,5,2,309340,309340,309342,0,2,2
88350,1,3,309341,309342,309345,1,4,0
88351,6,3,309347,309347,309350,0,3,2
88352,2,2,309349,309350,309352,1,3,0
88353,5,1,309354,309354,309355,0,1,2
88354,1,3,309355,309355,309358,0,3,0
88355,4,3,309359,309359,309362,0,3,1
88356,4,2,309363,309363,309365,0,2,1
88357,4,3,309367,309367,309370,0,3,2
88358,2,1,309369,309370,309371,1,2,0
88359,4,2,309373,309373,309375,0,2,2
88360,2,2,309375,309375,309377,0,2,0
88361,2,1,309377,309377,309378,0,1,0
88362,3,2,309380,309380,309382,0,2,2
88363,6,1,309386,309386,309387,0,1,4
88364,3,3,309389,309389,309392,0,3,2
88365,5,1,309394,309394,309395,0,1,2
88366,2,3,309396,309396,309399,0,3,1
88367,5,3,309401,309401,309404,0,3,2
88368,5,3,309406,309406,309409,0,3,2
88369,1,2,309407,309409,309411,2,4,0
88370,5,2,309412,309412,309414,0,2,1
88371,2,2,309414,309414,309416,0,2,0
88372,1,1,309415,309416,309417,1,2,0
88373,1,2,309416,309417,309419,1,3,0
88374,2,3,309418,309419,309422,1,4,0
88375,5,3,309423,309423,309426,0,3,1
88376,3,3,309426,309426,309429,0,3,0
88377,3,3,309429,309429,309432,0,3,0
88378,3,3,309432,309432,309435,0,3,0
88379,2,3,309434,309435,309438,1,4,0
88380,4,3,309438,309438,309441,0,3,0
88381,4,3,309442,309442,309445,0,3,1
88382,3,1,309445,309445,309446,0,1,0
88383,6,1,309451,309451,309452,0,1,5
88384,3,1,309454,309454,309455,0,1,2
88385,5,3,309459,309459,309462,0,3,4
88386,4,2,309463,309463,309465,0,2,1
88387,1,1,309464,309465,309466,1,2,0
88388,3,2,309467,309467,309469,0,2,1
88389,1,3,309468,309469,309472,1,4,0
88390,6,2,309474,309474,309476,0,2,2
88391,2,3,309476,309476,309479,0,3,0
88392,5,3,309481,309481,309484,0,3,2
88393,4,2,309485,309485,309487,0,2,1
88394,4,2,309489,309489,309491,0,2,2
88395,3,2,309492,309492,309494,0,2,1
88396,3,1,309495,309495,309496,0,1,1
88397,3,1,309498,309498,309499,0,1,2
88398,1,1,309499,309499,309500,0,1,0
88399,3,2,309502,309502,309504,0,2,2
88400,4,1,309506,309506,309507,0,1,2
88401,5,3,309511,309511,309514,0,3,4
88402,1,1,309512,309514,309515,2,3,0
88403,5,3,309517,309517,309520,0,3,2
88404,2,1,309519,309520,309521,1,2,0
88405,4,3,309523,309523,309526,0,3,2
88406,2,2,309525,309526,309528,1,3,0
88407,1,2,309526,309528,309530,2,4,0
88408,5,3,309531,309531,309534,0,3,1
88409,2,1,309533,309534,309535,1,2,0
88410,2,2,309535,309535,309537,0,2,0
88411,6,1,309541,309541,309542,0,1,4
88412,2,3,309543,309543,309546,0,3,1
88413,1,1,309544,309546,309547,2,3,0
88414,4,1,309548,309548,309549,0,1,1
88415,3,2,309551,309551,309553,0,2,2
88416,2,2,309553,309553,309555,0,2,0
88417,5,2,309558,309558,309560,0,2,3
88418,2,2,309560,309560,309562,0,2,0
88419,4,2,309564,309564,309566,0,2,2
88420,2,2,309566,309566,309568,0,2,0
88421,1,1,309567,309568,309569,1,2,0
88422,4,2,309571,309571,309573,0,2,2
88423,4,3,309575,309575,309578,0,3,2
88424,3,1,309578,309578,309579,0,1,0
88425,3,2,309581,309581,309583,0,2,2
88426,3,3,309584,309584,309587,0,3,1
88427,4,1,309588,309588,309589,0,1,1
88428,1,3,309589,309589,309592,0,3,0
88429,4,3,309593,309593,309596,0,3,1
88430,2,3,309595,309596,309599,1,4,0
88431,5,2,309600,309600,309602,0,2,1
88432,5,1,309605,309605,309606,0,1,3
88433,3,3,309608,309608,309611,0,3,2
88434,3,2,309611,309611,309613,0,2,0
88435,2,1,309613,309613,309614,0,1,0
88436,2,2,309615,309615,309617,0,2,1
88437,1,3,309616,309617,309620,1,4,0
88438,2,2,309618,309620,309622,2,4,0
88439,2,2,309620,309622,309624,2,4,0
88440,5,2,309625,309625,309627,0,2,1
88441,6,3,309631,309631,309634,0,3,4
88442,3,3,309634,309634,309637,0,3,0
88443,3,2,309637,309637,309639,0,2,0
88444,1,1,309638,309639,309640,1,2,0
88445,1,2,309639,309640,309642,1,3,0
88446,2,2,309641,309642,309644,1,3,0
88447,6,3,309647,309647,309650,0,3,3
88448,5,3,309652,309652,309655,0,3,2
88449,3,3,309655,309655,309658,0,3,0
88450,2,3,309657,309658,309661,1,4,0
88451,3,2,309660,309661,309663,1,3,0
88452,3,2,309663,309663,309665,0,2,0
88453,6,2,309669,309669,309671,0,2,4
88454,4,2,309673,309673,309675,0,2,2
88455,1,3,309674,309675,309678,1,4,0
88456,1,3,309675,309678,309681,3,6,0
88457,1,1,309676,309681,309682,5,6,0
88458,3,1,309679,309682,309683,3,4,0
88459,6,2,309685,309685,309687,0,2,2
88460,5,1,309690,309690,309691,0,1,3
88461,3,3,309693,309693,309696,0,3,2
88462,1,1,309694,309696,309697,2,3,0
88463,2,2,309696,309697,309699,1,3,0
88464,3,2,309699,309699,309701,0,2,0
88465,3,2,309702,309702,309704,0,2,1
88466,4,1,309706,309706,309707,0,1,2
88467,2,1,309708,309708,309709,0,1,1
88468,2,1,309710,309710,309711,0,1,1
88469,2,3,309712,309712,309715,0,3,1
88470,4,3,309716,309716,309719,0,3,1
88471,3,1,309719,309719,309720,0,1,0
88472,4,1,309723,309723,309724,0,1,3
88473,4,2,309727,309727,309729,0,2,3
88474,2,2,309729,309729,309731,0,2,0
88475,1,1,309730,309731,309732,1,2,0
88476,3,1,309733,309733,309734,0,1,1
88477,2,3,309735,309735,309738,0,3,1
88478,5,2,309740,309740,309742,0,2,2
88479,2,1,309742,309742,309743,0,1,0
88480,5,3,309747,309747,309750,0,3,4
88481,1,2,309748,309750,309752,2,4,0
88482,1,3,309749,309752,309755,3,6,0
88483,5,1,309754,309755,309756,1,2,0
88484,2,1,309756,309756,309757,0,1,0
88485,1,3,309757,309757,309760,0,3,0
88486,2,1,309759,309760,309761,1,2,0
88487,4,2,309763,309763,309765,0,2,2
88488,1,3,309764,309765,309768,1,4,0
88489,4,2,309768,309768,309770,0,2,0
88490,4,1,309772,309772,309773,0,1,2
88491,2,3,309774,309774,309777,0,3,1
88492,6,3,309780,309780,309783,0,3,3
88493,4,3,309784,309784,309787,0,3,1
88494,2,3,309786,309787,309790,1,4,0
88495,5,2,309791,309791,309793,0,2,1
88496,5,2,309796,309796,309798,0,2,3
88497,3,2,309799,309799,309801,0,2,1
88498,4,1,309803,309803,309804,0,1,2
88499,4,2,309807,309807,309809,0,2,3
88500,3,3,309810,309810,309813,0,3,1
88501,3,2,309813,309813,309815,0,2,0
88502,3,3,309816,309816,309819,0,3,1
88503,5,2,309821,309821,309823,0,2,2
88504,4,2,309825,309825,309827,0,2,2
88505,5,2,309830,309830,309832,0,2,3
88506,3,3,309833,309833,309836,0,3,1
88507,3,1,309836,309836,309837,0,1,0
88508,4,3,309840,309840,309843,0,3,3
88509,2,2,309842,309843,309845,1,3,0
88510,3,3,309845,309845,309848,0,3,0
88511,4,2,309849,309849,309851,0,2,1
88512,5,3,309854,309854,309857,0,3,3
88513,6,1,309860,309860,309861,0,1,3
88514,5,3,309865,309865,309868,0,3,4
88515,3,1,309868,309868,309869,0,1,0
88516,6,2,309874,309874,309876,0,2,5
88517,5,2,309879,309879,309881,0,2,3
88518,4,3,309883,309883,309886,0,3,2
88519,2,3,309885,309886,309889,1,4,0
88520,5,1,309890,309890,309891,0,1,1
88521,4,1,309894,309894,309895,0,1,3
88522,3,3,309897,309897,309900,0,3,2
88523,2,1,309899,309900,309901,1,2,0
88524,4,1,309903,309903,309904,0,1,2
88525,6,1,309909,309909,309910,0,1,5
88526,6,2,309915,309915,309917,0,2,5
88527,1,2,309916,309917,309919,1,3,0
88528,4,2,309920,309920,309922,0,2,1
88529,4,3,309924,309924,309927,0,3,2
88530,4,3,309928,309928,309931,0,3,1
88531,2,3,309930,309931,309934,1,4,0
88532,5,2,309935,309935,309937,0,2,1
88533,1,2,309936,309937,309939,1,3,0
88534,6,1,309942,309942,309943,0,1,3
88535,6,3,309948,309948,309951,0,3,5
88536,4,2,309952,309952,309954,0,2,1
88537,5,3,309957,309957,309960,0,3,3
88538,6,1,309963,309963,309964,0,1,3
88539,1,1,309964,309964,309965,0,1,0
88540,3,3,309967,309967,309970,0,3,2
88541,2,1,309969,309970,309971,1,2,0
88542,6,2,309975,309975,309977,0,2,4
88543,5,3,309980,309980,309983,0,3,3
88544,1,3,309981,309983,309986,2,5,0
88545,5,3,309986,309986,309989,0,3,0
88546,6,3,309992,309992,309995,0,3,3
88547,6,1,309998,309998,309999,0,1,3
88548,6,3,310004,310004,310007,0,3,5
88549,2,1,310006,310007,310008,1,2,0
88550,4,2,310010,310010,310012,0,2,2
88551,1,1,310011,310012,310013,1,2,0
88552,3,3,310014,310014,310017,0,3,1
88553,3,1,310017,310017,310018,0,1,0
88554,5,3,310022,310022,310025,0,3,4
88555,1,1,310023,310025,310026,2,3,0
88556,6,2,310029,310029,310031,0,2,3
88557,3,2,310032,310032,310034,0,2,1
88558,1,1,310033,310034,310035,1,2,0
88559,3,3,310036,310036,310039,0,3,1
88560,2,3,310038,310039,310042,1,4,0
88561,2,2,310040,310042,310044,2,4,0
88562,4,3,310044,310044,310047,0,3,0
88563,4,1,310048,310048,310049,0,1,1
88564,5,1,310053,310053,310054,0,1,4
88565,6,1,310059,310059,310060,0,1,5
88566,1,1,310060,310060,310061,0,1,0
88567,3,1,310063,310063,310064,0,1,2
88568,1,2,310064,310064,310066,0,2,0
88569,4,1,310068,310068,310069,0,1,2
88570,6,1,310074,310074,310075,0,1,5
88571,6,1,310080,310080,310081,0,1,5
88572,5,2,310085,310085,310087,0,2,4
88573,5,2,310090,310090,310092,0,2,3
88574,3,3,310093,310093,310096,0,3,1
88575,3,3,310096,310096,310099,0,3,0
88576,6,2,310102,310102,310104,0,2,3
88577,5,1,310107,310107,310108,0,1,3
88578,6,3,310113,310113,310116,0,3,5
88579,2,2,310115,310116,310118,1,3,0
88580,4,1,310119,310119,310120,0,1,1
88581,2,3,310121,310121,310124,0,3,1
88582,4,3,310125,310125,310128,0,3,1
88583,3,3,310128,310128,310131,0,3,0
88584,2,2,310130,310131,310133,1,3,0
88585,3,2,310133,310133,310135,0,2,0
88586,1,1,310134,310135,310136,1,2,0
88587,3,1,310137,310137,310138,0,1,1
88588,3,2,310140,310140,310142,0,2,2
88589,1,2,310141,310142,310144,1,3,0
88590,3,3,310144,310144,310147,0,3,0
88591,4,2,310148,310148,310150,0,2,1
88592,6,1,310154,310154,310155,0,1,4
88593,1,2,310155,310155,310157,0,2,0
88594,3,1,310158,310158,310159,0,1,1
88595,2,1,310160,310160,310161,0,1,1
88596,2,2,310162,310162,310164,0,2,1
88597,4,2,310166,310166,310168,0,2,2
88598,2,1,310168,310168,310169,0,1,0
88599,6,2,310174,310174,310176,0,2,5
88600,2,2,310176,310176,310178,0,2,0
88601,4,2,310180,310180,310182,0,2,2
88602,1,2,310181,310182,310184,1,3,0
88603,1,1,310182,310184,310185,2,3,0
88604,3,3,310185,310185,310188,0,3,0
88605,1,1,310186,310188,310189,2,3,0
88606,2,2,310188,310189,310191,1,3,0
88607,5,2,310193,310193,310195,0,2,2
88608,1,1,310194,310195,310196,1,2,0
88609,3,1,310197,310197,310198,0,1,1
88610,3,3,310200,310200,310203,0,3,2
88611,4,3,310204,310204,310207,0,3,1
88612,1,1,310205,310207,310208,2,3,0
88613,4,2,310209,310209,310211,0,2,1
88614,1,1,310210,310211,310212,1,2,0
88615,1,1,310211,310212,310213,1,2,0
88616,3,3,310214,310214,310217,0,3,1
88617,4,2,310218,310218,310220,0,2,1
88618,2,3,310220,310220,310223,0,3,0
88619,5,3,310225,310225,310228,0,3,2
88620,6,1,310231,310231,310232,0,1,3
88621,6,1,310237,310237,310238,0,1,5
88622,2,3,310239,310239,310242,0,3,1
88623,5,2,310244,310244,310246,0,2,2
88624,1,2,310245,310246,310248,1,3,0
88625,1,2,310246,310248,310250,2,4,0
88626,3,2,310249,310250,310252,1,3,0
88627,1,3,310250,310252,310255,2,5,0
88628,2,3,310252,310255,310258,3,6,0
88629,4,2,310256,310258,310260,2,4,0
88630,2,2,310258,310260,310262,2,4,0
88631,4,1,310262,310262,310263,0,1,0
88632,2,2,310264,310264,310266,0,2,1
88633,1,2,310265,310266,310268,1,3,0
88634,5,2,310270,310270,310272,0,2,2
88635,3,2,310273,310273,310275,0,2,1
88636,3,2,310276,310276,310278,0,2,1
88637,2,3,310278,310278,310281,0,3,0
88638,5,1,310283,310283,310284,0,1,2
88639,3,3,310286,310286,310289,0,3,2
88640,1,3,310287,310289,310292,2,5,0
88641,5,3,310292,310292,310295,0,3,0
88642,5,3,310297,310297,310300,0,3,2
88643,2,3,310299,310300,310303,1,4,0
88644,4,3,310303,310303,310306,0,3,0
88645,5,3,310308,310308,310311,0,3,2
88646,1,3,310309,310311,310314,2,5,0
88647,5,2,310314,310314,310316,0,2,0
88648,2,1,310316,310316,310317,0,1,0
88649,3,1,310319,310319,310320,0,1,2
88650,4,1,310323,310323,310324,0,1,3
88651,2,3,310325,310325,310328,0,3,1
88652,1,3,310326,310328,310331,2,5,0
88653,1,2,310327,310331,310333,4,6,0
88654,4,3,310331,310333,310336,2,5,0
88655,5,1,310336,310336,310337,0,1,0
88656,6,3,310342,310342,310345,0,3,5
88657,5,1,310347,310347,310348,0,1,2
88658,5,1,310352,310352,310353,0,1,4
88659,3,3,310355,310355,310358,0,3,2
88660,1,3,310356,310358,310361,2,5,0
88661,3,3,310359,310361,310364,2,5,0
88662,1,3,310360,310364,310367,4,7,0
88663,5,2,310365,310367,310369,2,4,0
88664,5,3,310370,310370,310373,0,3,1
88665,4,1,310374,310374,310375,0,1,1
88666,5,3,310379,310379,310382,0,3,4
88667,3,1,310382,310382,310383,0,1,0
88668,3,2,310385,310385,310387,0,2,2
88669,5,2,310390,310390,310392,0,2,3
88670,3,1,310393,310393,310394,0,1,1
88671,3,1,310396,310396,310397,0,1,2
88672,5,2,310401,310401,310403,0,2,4
88673,2,1,310403,310403,310404,0,1,0
88674,6,3,310409,310409,310412,0,3,5
88675,4,1,310413,310413,310414,0,1,1
88676,6,2,310419,310419,310421,0,2,5
88677,3,1,310422,310422,310423,0,1,1
88678,2,2,310424,310424,310426,0,2,1
88679,1,3,310425,310426,310429,1,4,0
88680,2,1,310427,310429,310430,2,3,0
88681,5,1,310432,310432,310433,0,1,2
88682,3,3,310435,310435,310438,0,3,2
88683,1,3,310436,310438,310441,2,5,0
88684,2,3,310438,310441,310444,3,6,0
88685,2,2,310440,310444,310446,4,6,0
88686,4,1,310444,310446,310447,2,3,0
88687,5,3,310449,310449,310452,0,3,2
88688,5,3,310454,310454,310457,0,3,2
88689,4,2,310458,310458,310460,0,2,1
88690,1,2,310459,310460,310462,1,3,0
88691,4,3,310463,310463,310466,0,3,1
88692,4,1,310467,310467,310468,0,1,1
88693,3,1,310470,310470,310471,0,1,2
88694,5,1,310475,310475,310476,0,1,4
88695,2,3,310477,310477,310480,0,3,1
88696,3,2,310480,310480,310482,0,2,0
88697,4,3,310484,310484,310487,0,3,2
88698,3,2,310487,310487,310489,0,2,0
88699,5,1,310492,310492,310493,0,1,3
88700,1,2,310493,310493,310495,0,2,0
88701,6,3,310499,310499,310502,0,3,4
88702,5,1,310504,310504,310505,0,1,2
88703,3,1,310507,310507,310508,0,1,2
88704,3,1,310510,310510,310511,0,1,2
88705,6,2,310516,310516,310518,0,2,5
88706,1,3,310517,310518,310521,1,4,0
88707,4,3,310521,310521,310524,0,3,0
88708,4,1,310525,310525,310526,0,1,1
88709,3,2,310528,310528,310530,0,2,2
88710,6,2,310534,310534,310536,0,2,4
88711,3,2,310537,310537,310539,0,2,1
88712,4,3,310541,310541,310544,0,3,2
88713,2,1,310543,310544,310545,1,2,0
88714,2,1,310545,310545,310546,0,1,0
88715,4,3,310549,310549,310552,0,3,3
88716,5,3,310554,310554,310557,0,3,2
88717,4,2,310558,310558,310560,0,2,1
88718,4,3,310562,310562,310565,0,3,2
88719,2,3,310564,310565,310568,1,4,0
88720,4,3,310568,310568,310571,0,3,0
88721,4,2,310572,310572,310574,0,2,1
88722,4,1,310576,310576,310577,0,1,2
88723,5,1,310581,310581,310582,0,1,4
88724,3,1,310584,310584,310585,0,1,2
88725,3,2,310587,310587,310589,0,2,2
88726,2,3,310589,310589,310592,0,3,0
88727,4,2,310593,310593,310595,0,2,1
88728,2,2,310595,310595,310597,0,2,0
88729,3,2,310598,310598,310600,0,2,1
88730,2,1,310600,310600,310601,0,1,0
88731,5,1,310605,310605,310606,0,1,4
88732,5,1,310610,310610,310611,0,1,4
88733,3,2,310613,310613,310615,0,2,2
88734,6,2,310619,310619,310621,0,2,4
88735,5,2,310624,310624,310626,0,2,3
88736,2,3,310626,310626,310629,0,3,0
88737,2,3,310628,310629,310632,1,4,0
88738,2,2,310630,310632,310634,2,4,0
88739,3,2,310633,310634,310636,1,3,0
88740,1,1,310634,310636,310637,2,3,0
88741,1,2,310635,310637,310639,2,4,0
88742,2,1,310637,310639,310640,2,3,0
88743,5,3,310642,310642,310645,0,3,2
88744,4,1,310646,310646,310647,0,1,1
88745,3,3,310649,310649,310652,0,3,2
88746,5,2,310654,310654,310656,0,2,2
88747,4,3,310658,310658,310661,0,3,2
88748,3,1,310661,310661,310662,0,1,0
88749,6,3,310667,310667,310670,0,3,5
88750,5,3,310672,310672,310675,0,3,2
88751,3,3,310675,310675,310678,0,3,0
88752,4,1,310679,310679,310680,0,1,1
88753,3,3,310682,310682,310685,0,3,2
88754,6,3,310688,310688,310691,0,3,3
88755,6,3,310694,310694,310697,0,3,3
88756,4,3,310698,310698,310701,0,3,1
88757,4,3,310702,310702,310705,0,3,1
88758,5,1,310707,310707,310708,0,1,2
88759,2,1,310709,310709,310710,0,1,1
88760,1,1,310710,310710,310711,0,1,0
88761,3,2,310713,310713,310715,0,2,2
88762,3,2,310716,310716,310718,0,2,1
88763,6,2,310722,310722,310724,0,2,4
88764,2,3,310724,310724,310727,0,3,0
88765,6,3,310730,310730,310733,0,3,3
88766,5,1,310735,310735,310736,0,1,2
88767,5,3,310740,310740,310743,0,3,4
88768,4,3,310744,310744,310747,0,3,1
88769,5,1,310749,310749,310750,0,1,2
88770,1,3,310750,310750,310753,0,3,0
88771,4,3,310754,310754,310757,0,3,1
88772,4,3,310758,310758,310761,0,3,1
88773,2,1,310760,310761,310762,1,2,0
88774,1,3,310761,310762,310765,1,4,0
88775,4,1,310765,310765,310766,0,1,0
88776,4,3,310769,310769,310772,0,3,3
88777,2,2,310771,310772,310774,1,3,0
88778,4,3,310775,310775,310778,0,3,1
88779,1,1,310776,310778,310779,2,3,0
88780,4,1,310780,310780,310781,0,1,1
88781,1,3,310781,310781,310784,0,3,0
88782,3,3,310784,310784,310787,0,3,0
88783,6,2,310790,310790,310792,0,2,3
88784,4,2,310794,310794,310796,0,2,2
88785,3,3,310797,310797,310800,0,3,1
88786,5,2,310802,310802,310804,0,2,2
88787,4,3,310806,310806,310809,0,3,2
88788,2,1,310808,310809,310810,1,2,0
88789,1,1,310809,310810,310811,1,2,0
88790,4,1,310813,310813,310814,0,1,2
88791,4,2,310817,310817,310819,0,2,3
88792,2,3,310819,310819,310822,0,3,0
88793,5,2,310824,310824,310826,0,2,2
88794,5,2,310829,310829,310831,0,2,3
88795,5,2,310834,310834,310836,0,2,3
88796,3,2,310837,310837,310839,0,2,1
88797,5,3,310842,310842,310845,0,3,3
88798,1,1,310843,310845,310846,2,3,0
88799,5,2,310848,310848,310850,0,2,2
88800,2,1,310850,310850,310851,0,1,0
88801,5,1,310855,310855,310856,0,1,4
88802,5,1,310860,310860,310861,0,1,4
88803,1,3,310861,310861,310864,0,3,0
88804,3,2,310864,310864,310866,0,2,0
88805,3,1,310867,310867,310868,0,1,1
88806,6,1,310873,310873,310874,0,1,5
88807,2,1,310875,310875,310876,0,1,1
88808,4,1,310879,310879,310880,0,1,3
88809,3,1,310882,310882,310883,0,1,2
88810,6,1,310888,310888,310889,0,1,5
88811,6,1,310894,310894,310895,0,1,5
88812,2,2,310896,310896,310898,0,2,1
88813,4,1,310900,310900,310901,0,1,2
88814,5,3,310905,310905,310908,0,3,4
88815,4,1,310909,310909,310910,0,1,1
88816,4,2,310913,310913,310915,0,2,3
88817,6,3,310919,310919,310922,0,3,4
88818,1,1,310920,310922,310923,2,3,0
88819,5,2,310925,310925,310927,0,2,2
88820,6,2,310931,310931,310933,0,2,4
88821,3,2,310934,310934,310936,0,2,1
88822,5,1,310939,310939,310940,0,1,3
88823,4,1,310943,310943,310944,0,1,3
88824,4,3,310947,310947,310950,0,3,3
88825,3,3,310950,310950,310953,0,3,0
88826,3,1,310953,310953,310954,0,1,0
88827,3,2,310956,310956,310958,0,2,2
88828,5,3,310961,310961,310964,0,3,3
88829,4,1,310965,310965,310966,0,1,1
88830,2,2,310967,310967,310969,0,2,1
88831,2,3,310969,310969,310972,0,3,0
88832,5,2,310974,310974,310976,0,2,2
88833,4,1,310978,310978,310979,0,1,2
88834,6,3,310984,310984,310987,0,3,5
88835,6,3,310990,310990,310993,0,3,3
88836,5,1,310995,310995,310996,0,1,2
88837,6,2,311001,311001,311003,0,2,5
88838,4,3,311005,311005,311008,0,3,2
88839,5,1,311010,311010,311011,0,1,2
88840,1,2,311011,311011,311013,0,2,0
88841,5,1,311016,311016,311017,0,1,3
88842,5,3,311021,311021,311024,0,3,4
88843,1,3,311022,311024,311027,2,5,0
88844,1,3,311023,311027,311030,4,7,0
88845,2,3,311025,311030,311033,5,8,0
88846,1,3,311026,311033,311036,7,10,0
88847,5,2,311031,311036,311038,5,7,0
88848,1,2,311032,311038,311040,6,8,0
88849,6,3,311038,311040,311043,2,5,0
88850,2,2,311040,311043,311045,3,5,0
88851,4,1,311044,311045,311046,1,2,0
88852,4,1,311048,311048,311049,0,1,2
88853,3,3,311051,311051,311054,0,3,2
88854,5,2,311056,311056,311058,0,2,2
88855,3,1,311059,311059,311060,0,1,1
88856,4,2,311063,311063,311065,0,2,3
88857,1,3,311064,311065,311068,1,4,0
88858,5,1,311069,311069,311070,0,1,1
88859,3,3,311072,311072,311075,0,3,2
88860,4,3,311076,311076,311079,0,3,1
88861,4,3,311080,311080,311083,0,3,1
88862,3,1,311083,311083,311084,0,1,0
88863,6,2,311089,311089,311091,0,2,5
88864,5,1,311094,311094,311095,0,1,3
88865,6,3,311100,311100,311103,0,3,5
88866,2,3,311102,311103,311106,1,4,0
88867,5,1,311107,311107,311108,0,1,1
88868,2,3,311109,311109,311112,0,3,1
88869,2,3,311111,311112,311115,1,4,0
88870,4,3,311115,311115,311118,0,3,0
88871,1,3,311116,311118,311121,2,5,0
88872,2,3,311118,311121,311124,3,6,0
88873,6,2,311124,311124,311126,0,2,0
88874,4,2,311128,311128,311130,0,2,2
88875,2,2,311130,311130,311132,0,2,0
88876,5,3,311135,311135,311138,0,3,3
88877,6,2,311141,311141,311143,0,2,3
88878,2,1,311143,311143,311144,0,1,0
88879,5,2,311148,311148,311150,0,2,4
88880,5,3,311153,311153,311156,0,3,3
88881,4,1,311157,311157,311158,0,1,1
88882,6,2,311163,311163,311165,0,2,5
88883,1,2,311164,311165,311167,1,3,0
88884,5,1,311169,311169,311170,0,1,2
88885,1,3,311170,311170,311173,0,3,0
88886,4,2,311174,311174,311176,0,2,1
88887,6,3,311180,311180,311183,0,3,4
88888,6,3,311186,311186,311189,0,3,3
88889,2,3,311188,311189,311192,1,4,0
88890,5,3,311193,311193,311196,0,3,1
88891,1,2,311194,311196,311198,2,4,0
88892,4,2,311198,311198,311200,0,2,0
88893,2,3,311200,311200,311203,0,3,0
88894,3,2,311203,311203,311205,0,2,0
88895,5,1,311208,311208,311209,0,1,3
88896,5,2,311213,311213,311215,0,2,4
88897,3,3,311216,311216,311219,0,3,1
88898,2,1,311218,311219,311220,1,2,0
88899,1,3,311219,311220,311223,1,4,0
88900,1,3,311220,311223,311226,3,6,0
88901,5,3,311225,311226,311229,1,4,0
88902,6,2,311231,311231,311233,0,2,2
88903,6,3,311237,311237,311240,0,3,4
88904,4,3,311241,311241,311244,0,3,1
88905,3,3,311244,311244,311247,0,3,0
88906,3,2,311247,311247,311249,0,2,0
88907,2,1,311249,311249,311250,0,1,0
88908,5,3,311254,311254,311257,0,3,4
88909,1,2,311255,311257,311259,2,4,0
88910,2,3,311257,311259,311262,2,5,0
88911,1,2,311258,311262,311264,4,6,0
88912,1,2,311259,311264,311266,5,7,0
88913,3,2,311262,311266,311268,4,6,0
88914,6,2,311268,311268,311270,0,2,0
88915,5,2,311273,311273,311275,0,2,3
88916,6,3,311279,311279,311282,0,3,4
88917,2,3,311281,311282,311285,1,4,0
88918,5,1,311286,311286,311287,0,1,1
88919,6,2,311292,311292,311294,0,2,5
88920,3,2,311295,311295,311297,0,2,1
88921,2,2,311297,311297,311299,0,2,0
88922,1,1,311298,311299,311300,1,2,0
88923,5,3,311303,311303,311306,0,3,3
88924,4,3,311307,311307,311310,0,3,1
88925,6,2,311313,311313,311315,0,2,3
88926,2,2,311315,311315,311317,0,2,0
88927,5,2,311320,311320,311322,0,2,3
88928,2,1,311322,311322,311323,0,1,0
88929,4,2,311326,311326,311328,0,2,3
88930,2,3,311328,311328,311331,0,3,0
88931,6,1,311334,311334,311335,0,1,3
88932,2,2,311336,311336,311338,0,2,1
88933,5,1,311341,311341,311342,0,1,3
88934,6,2,311347,311347,311349,0,2,5
88935,3,2,311350,311350,311352,0,2,1
88936,2,3,311352,311352,311355,0,3,0
88937,5,3,311357,311357,311360,0,3,2
88938,1,1,311358,311360,311361,2,3,0
88939,4,1,311362,311362,311363,0,1,1
88940,3,3,311365,311365,311368,0,3,2
88941,6,1,311371,311371,311372,0,1,3
88942,1,3,311372,311372,311375,0,3,0
88943,3,3,311375,311375,311378,0,3,0
88944,3,1,311378,311378,311379,0,1,0
88945,5,1,311383,311383,311384,0,1,4
88946,6,2,311389,311389,311391,0,2,5
88947,3,2,311392,311392,311394,0,2,1
88948,6,1,311398,311398,311399,0,1,4
88949,1,3,311399,311399,311402,0,3,0
88950,4,3,311403,311403,311406,0,3,1
88951,1,3,311404,311406,311409,2,5,0
88952,1,1,311405,311409,311410,4,5,0
88953,5,2,311410,311410,311412,0,2,0
88954,6,2,311416,311416,311418,0,2,4
88955,5,1,311421,311421,311422,0,1,3
88956,4,2,311425,311425,311427,0,2,3
88957,1,3,311426,311427,311430,1,4,0
88958,4,2,311430,311430,311432,0,2,0
88959,6,2,311436,311436,311438,0,2,4
88960,4,1,311440,311440,311441,0,1,2
88961,1,1,311441,311441,311442,0,1,0
88962,6,3,311447,311447,311450,0,3,5
88963,2,3,311449,311450,311453,1,4,0
88964,2,1,311451,311453,311454,2,3,0
88965,3,1,311454,311454,311455,0,1,0
88966,3,3,311457,311457,311460,0,3,2
88967,1,2,311458,311460,311462,2,4,0
88968,5,1,311463,311463,311464,0,1,1
88969,1,3,311464,311464,311467,0,3,0
88970,4,2,311468,311468,311470,0,2,1
88971,2,2,311470,311470,311472,0,2,0
88972,6,2,311476,311476,311478,0,2,4
88973,6,2,311482,311482,311484,0,2,4
88974,6,1,311488,311488,311489,0,1,4
88975,3,2,311491,311491,311493,0,2,2
88976,4,2,311495,311495,311497,0,2,2
88977,5,3,311500,311500,311503,0,3,3
88978,3,2,311503,311503,311505,0,2,0
88979,2,2,311505,311505,311507,0,2,0
88980,6,2,311511,311511,311513,0,2,4
88981,5,2,311516,311516,311518,0,2,3
88982,3,1,311519,311519,311520,0,1,1
88983,5,3,311524,311524,311527,0,3,4
88984,4,2,311528,311528,311530,0,2,1
88985,4,3,311532,311532,311535,0,3,2
88986,1,1,311533,311535,311536,2,3,0
88987,6,1,311539,311539,311540,0,1,3
88988,6,1,311545,311545,311546,0,1,5
88989,4,1,311549,311549,311550,0,1,3
88990,3,3,311552,311552,311555,0,3,2
88991,5,2,311557,311557,311559,0,2,2
88992,4,2,311561,311561,311563,0,2,2
88993,4,1,311565,311565,311566,0,1,2
88994,2,3,311567,311567,311570,0,3,1
88995,6,3,311573,311573,311576,0,3,3
88996,4,1,311577,311577,311578,0,1,1
88997,5,2,311582,311582,311584,0,2,4
88998,5,1,311587,311587,311588,0,1,3
88999,5,2,311592,311592,311594,0,2,4
89000,3,1,311595,311595,311596,0,1,1
89001,3,3,311598,311598,311601,0,3,2
89002,4,2,311602,311602,311604,0,2,1
89003,1,1,311603,311604,311605,1,2,0
89004,5,2,311608,311608,311610,0,2,3
89005,6,1,311614,311614,311615,0,1,4
89006,2,1,311616,311616,311617,0,1,1
89007,3,1,311619,311619,311620,0,1,2
89008,4,1,311623,311623,311624,0,1,3
89009,6,3,311629,311629,311632,0,3,5
89010,3,3,311632,311632,311635,0,3,0
89011,3,2,311635,311635,311637,0,2,0
89012,1,1,311636,311637,311638,1,2,0
89013,3,3,311639,311639,311642,0,3,1
89014,5,1,311644,311644,311645,0,1,2
89015,2,1,311646,311646,311647,0,1,1
89016,2,1,311648,311648,311649,0,1,1
89017,3,1,311651,311651,311652,0,1,2
89018,2,2,311653,311653,311655,0,2,1
89019,5,1,311658,311658,311659,0,1,3
89020,2,1,311660,311660,311661,0,1,1
89021,2,3,311662,311662,311665,0,3,1
89022,6,3,311668,311668,311671,0,3,3
89023,3,3,311671,311671,311674,0,3,0
89024,6,1,311677,311677,311678,0,1,3
89025,4,3,311681,311681,311684,0,3,3
89026,5,3,311686,311686,311689,0,3,2
89027,4,1,311690,311690,311691,0,1,1
89028,6,1,311696,311696,311697,0,1,5
89029,6,1,311702,311702,311703,0,1,5
89030,4,2,311706,311706,311708,0,2,3
89031,3,2,311709,311709,311711,0,2,1
89032,5,1,311714,311714,311715,0,1,3
89033,2,3,311716,311716,311719,0,3,1
89034,6,1,311722,311722,311723,0,1,3
89035,1,1,311723,311723,311724,0,1,0
89036,3,2,311726,311726,311728,0,2,2
89037,5,2,311731,311731,311733,0,2,3
89038,3,3,311734,311734,311737,0,3,1
89039,2,2,311736,311737,311739,1,3,0
89040,2,1,311738,311739,311740,1,2,0
89041,4,2,311742,311742,311744,0,2,2
89042,5,1,311747,311747,311748,0,1,3
89043,6,2,311753,311753,311755,0,2,5
89044,3,1,311756,311756,311757,0,1,1
89045,3,2,311759,311759,311761,0,2,2
89046,1,1,311760,311761,311762,1,2,0
89047,4,2,311764,311764,311766,0,2,2
89048,2,2,311766,311766,311768,0,2,0
89049,1,1,311767,311768,311769,1,2,0
89050,2,2,311769,311769,311771,0,2,0
89051,4,2,311773,311773,311775,0,2,2
89052,2,3,311775,311775,311778,0,3,0
89053,5,2,311780,311780,311782,0,2,2
89054,3,2,311783,311783,311785,0,2,1
89055,2,2,311785,311785,311787,0,2,0
89056,2,1,311787,311787,311788,0,1,0
89057,2,3,311789,311789,311792,0,3,1
89058,4,2,311793,311793,311795,0,2,1
89059,3,3,311796,311796,311799,0,3,1
89060,5,3,311801,311801,311804,0,3,2
89061,3,2,311804,311804,311806,0,2,0
89062,4,3,311808,311808,311811,0,3,2
89063,2,1,311810,311811,311812,1,2,0
89064,5,3,311815,311815,311818,0,3,3
89065,5,3,311820,311820,311823,0,3,2
89066,5,1,311825,311825,311826,0,1,2
89067,5,3,311830,311830,311833,0,3,4
89068,4,2,311834,311834,311836,0,2,1
89069,1,3,311835,311836,311839,1,4,0
89070,5,3,311840,311840,311843,0,3,1
89071,1,3,311841,311843,311846,2,5,0
89072,5,3,311846,311846,311849,0,3,0
89073,6,2,311852,311852,311854,0,2,3
89074,6,2,311858,311858,311860,0,2,4
89075,2,2,311860,311860,311862,0,2,0
89076,5,3,311865,311865,311868,0,3,3
89077,5,1,311870,311870,311871,0,1,2
89078,2,1,311872,311872,311873,0,1,1
89079,3,1,311875,311875,311876,0,1,2
89080,2,2,311877,311877,311879,0,2,1
89081,6,2,311883,311883,311885,0,2,4
89082,4,1,311887,311887,311888,0,1,2
89083,4,3,311891,311891,311894,0,3,3
89084,1,2,311892,311894,311896,2,4,0
89085,2,2,311894,311896,311898,2,4,0
89086,6,2,311900,311900,311902,0,2,2
89087,3,3,311903,311903,311906,0,3,1
89088,2,1,311905,311906,311907,1,2,0
89089,1,1,311906,311907,311908,1,2,0
89090,4,2,311910,311910,311912,0,2,2
89091,2,1,311912,311912,311913,0,1,0
89092,4,2,311916,311916,311918,0,2,3
89093,3,1,311919,311919,311920,0,1,1
89094,6,1,311925,311925,311926,0,1,5
89095,5,3,311930,311930,311933,0,3,4
89096,2,1,311932,311933,311934,1,2,0
89097,2,1,311934,311934,311935,0,1,0
89098,5,1,311939,311939,311940,0,1,4
89099,1,2,311940,311940,311942,0,2,0
89100,1,2,311941,311942,311944,1,3,0
89101,2,3,311943,311944,311947,1,4,0
89102,6,3,311949,311949,311952,0,3,2
89103,6,1,311955,311955,311956,0,1,3
89104,3,1,311958,311958,311959,0,1,2
89105,1,1,311959,311959,311960,0,1,0
89106,4,3,311963,311963,311966,0,3,3
89107,1,2,311964,311966,311968,2,4,0
89108,2,3,311966,311968,311971,2,5,0
89109,4,1,311970,311971,311972,1,2,0
89110,5,2,311975,311975,311977,0,2,3
89111,5,1,311980,311980,311981,0,1,3
89112,1,2,311981,311981,311983,0,2,0
89113,5,2,311986,311986,311988,0,2,3
89114,6,1,311992,311992,311993,0,1,4
89115,1,3,311993,311993,311996,0,3,0
89116,5,1,311998,311998,311999,0,1,2
89117,5,3,312003,312003,312006,0,3,4
89118,3,2,312006,312006,312008,0,2,0
89119,1,3,312007,312008,312011,1,4,0
89120,5,1,312012,312012,312013,0,1,1
89121,1,2,312013,312013,312015,0,2,0
89122,3,1,312016,312016,312017,0,1,1
89123,6,3,312022,312022,312025,0,3,5
89124,3,2,312025,312025,312027,0,2,0
89125,3,2,312028,312028,312030,0,2,1
89126,4,3,312032,312032,312035,0,3,2
89127,5,1,312037,312037,312038,0,1,2
89128,5,3,312042,312042,312045,0,3,4
89129,4,3,312046,312046,312049,0,3,1
89130,3,3,312049,312049,312052,0,3,0
89131,6,3,312055,312055,312058,0,3,3
89132,6,3,312061,312061,312064,0,3,3
89133,2,3,312063,312064,312067,1,4,0
89134,1,1,312064,312067,312068,3,4,0
89135,1,1,312065,312068,312069,3,4,0
89136,1,2,312066,312069,312071,3,5,0
89137,3,3,312069,312071,312074,2,5,0
89138,2,1,312071,312074,312075,3,4,0
89139,2,2,312073,312075,312077,2,4,0
89140,2,1,312075,312077,312078,2,3,0
89141,1,2,312076,312078,312080,2,4,0
89142,2,2,312078,312080,312082,2,4,0
89143,4,3,312082,312082,312085,0,3,0
89144,5,1,312087,312087,312088,0,1,2
89145,5,1,312092,312092,312093,0,1,4
89146,3,3,312095,312095,312098,0,3,2
89147,1,1,312096,312098,312099,2,3,0
89148,2,1,312098,312099,312100,1,2,0
89149,5,2,312103,312103,312105,0,2,3
89150,1,3,312104,312105,312108,1,4,0
89151,1,2,312105,312108,312110,3,5,0
89152,3,3,312108,312110,312113,2,5,0
89153,6,1,312114,312114,312115,0,1,1
89154,1,1,312115,312115,312116,0,1,0
89155,2,2,312117,312117,312119,0,2,1
89156,6,3,312123,312123,312126,0,3,4
89157,3,1,312126,312126,312127,0,1,0
89158,3,3,312129,312129,312132,0,3,2
89159,3,3,312132,312132,312135,0,3,0
89160,2,3,312134,312135,312138,1,4,0
89161,5,2,312139,312139,312141,0,2,1
89162,1,1,312140,312141,312142,1,2,0
89163,2,1,312142,312142,312143,0,1,0
89164,4,1,312146,312146,312147,0,1,3
89165,6,2,312152,312152,312154,0,2,5
89166,6,3,312158,312158,312161,0,3,4
89167,5,2,312163,312163,312165,0,2,2
89168,1,3,312164,312165,312168,1,4,0
89169,6,2,312170,312170,312172,0,2,2
89170,2,3,312172,312172,312175,0,3,0
89171,1,1,312173,312175,312176,2,3,0
89172,5,2,312178,312178,312180,0,2,2
89173,4,3,312182,312182,312185,0,3,2
89174,2,2,312184,312185,312187,1,3,0
89175,6,3,312190,312190,312193,0,3,3
89176,1,1,312191,312193,312194,2,3,0
89177,3,2,312194,312194,312196,0,2,0
89178,5,2,312199,312199,312201,0,2,3
89179,6,2,312205,312205,312207,0,2,4
89180,4,2,312209,312209,312211,0,2,2
89181,5,1,312214,312214,312215,0,1,3
89182,1,3,312215,312215,312218,0,3,0
89183,4,1,312219,312219,312220,0,1,1
89184,3,1,312222,312222,312223,0,1,2
89185,6,3,312228,312228,312231,0,3,5
89186,2,3,312230,312231,312234,1,4,0
89187,5,1,312235,312235,312236,0,1,1
89188,4,2,312239,312239,312241,0,2,3
89189,3,3,312242,312242,312245,0,3,1
89190,6,2,312248,312248,312250,0,2,3
89191,6,2,312254,312254,312256,0,2,4
89192,3,1,312257,312257,312258,0,1,1
89193,2,1,312259,312259,312260,0,1,1
89194,2,2,312261,312261,312263,0,2,1
89195,4,2,312265,312265,312267,0,2,2
89196,6,2,312271,312271,312273,0,2,4
89197,6,1,312277,312277,312278,0,1,4
89198,4,2,312281,312281,312283,0,2,3
89199,1,1,312282,312283,312284,1,2,0
89200,4,2,312286,312286,312288,0,2,2
89201,6,2,312292,312292,312294,0,2,4
89202,6,1,312298,312298,312299,0,1,4
89203,1,3,312299,312299,312302,0,3,0
89204,1,1,312300,312302,312303,2,3,0
89205,6,1,312306,312306,312307,0,1,3
89206,3,2,312309,312309,312311,0,2,2
89207,6,3,312315,312315,312318,0,3,4
89208,5,3,312320,312320,312323,0,3,2
89209,5,2,312325,312325,312327,0,2,2
89210,5,3,312330,312330,312333,0,3,3
89211,6,2,312336,312336,312338,0,2,3
89212,6,3,312342,312342,312345,0,3,4
89213,1,1,312343,312345,312346,2,3,0
89214,5,1,312348,312348,312349,0,1,2
89215,6,3,312354,312354,312357,0,3,5
89216,5,1,312359,312359,312360,0,1,2
89217,5,2,312364,312364,312366,0,2,4
89218,4,2,312368,312368,312370,0,2,2
89219,5,3,312373,312373,312376,0,3,3
89220,6,2,312379,312379,312381,0,2,3
89221,5,1,312384,312384,312385,0,1,3
89222,2,3,312386,312386,312389,0,3,1
89223,6,2,312392,312392,312394,0,2,3
89224,2,2,312394,312394,312396,0,2,0
89225,4,1,312398,312398,312399,0,1,2
89226,4,2,312402,312402,312404,0,2,3
89227,6,3,312408,312408,312411,0,3,4
89228,4,1,312412,312412,312413,0,1,1
89229,5,1,312417,312417,312418,0,1,4
89230,4,2,312421,312421,312423,0,2,3
89231,6,2,312427,312427,312429,0,2,4
89232,2,3,312429,312429,312432,0,3,0
89233,6,2,312435,312435,312437,0,2,3
89234,4,1,312439,312439,312440,0,1,2
89235,1,3,312440,312440,312443,0,3,0
89236,4,1,312444,312444,312445,0,1,1
89237,2,2,312446,312446,312448,0,2,1
89238,2,2,312448,312448,312450,0,2,0
89239,6,2,312454,312454,312456,0,2,4
89240,6,3,312460,312460,312463,0,3,4
89241,5,2,312465,312465,312467,0,2,2
89242,1,3,312466,312467,312470,1,4,0
89243,4,3,312470,312470,312473,0,3,0
89244,1,1,312471,312473,312474,2,3,0
89245,4,1,312475,312475,312476,0,1,1
89246,5,2,312480,312480,312482,0,2,4
89247,3,2,312483,312483,312485,0,2,1
89248,3,3,312486,312486,312489,0,3,1
89249,4,1,312490,312490,312491,0,1,1
89250,4,1,312494,312494,312495,0,1,3
89251,2,3,312496,312496,312499,0,3,1
89252,1,3,312497,312499,312502,2,5,0
89253,3,2,312500,312502,312504,2,4,0
89254,5,3,312505,312505,312508,0,3,1
89255,3,1,312508,312508,312509,0,1,0
89256,6,1,312514,312514,312515,0,1,5
89257,6,3,312520,312520,312523,0,3,5
89258,1,2,312521,312523,312525,2,4,0
89259,3,1,312524,312525,312526,1,2,0
89260,5,2,312529,312529,312531,0,2,3
89261,3,1,312532,312532,312533,0,1,1
89262,5,1,312537,312537,312538,0,1,4
89263,5,1,312542,312542,312543,0,1,4
89264,1,1,312543,312543,312544,0,1,0
89265,4,1,312547,312547,312548,0,1,3
89266,4,1,312551,312551,312552,0,1,3
89267,5,1,312556,312556,312557,0,1,4
89268,6,3,312562,312562,312565,0,3,5
89269,6,1,312568,312568,312569,0,1,3
89270,1,1,312569,312569,312570,0,1,0
89271,5,3,312574,312574,312577,0,3,4
89272,1,3,312575,312577,312580,2,5,0
89273,4,3,312579,312580,312583,1,4,0
89274,3,2,312582,312583,312585,1,3,0
89275,1,3,312583,312585,312588,2,5,0
89276,1,1,312584,312588,312589,4,5,0
89277,5,1,312589,312589,312590,0,1,0
89278,6,3,312595,312595,312598,0,3,5
89279,6,1,312601,312601,312602,0,1,3
89280,2,1,312603,312603,312604,0,1,1
89281,1,2,312604,312604,312606,0,2,0
89282,2,1,312606,312606,312607,0,1,0
89283,5,1,312611,312611,312612,0,1,4
89284,2,2,312613,312613,312615,0,2,1
89285,3,1,312616,312616,312617,0,1,1
89286,6,1,312622,312622,312623,0,1,5
89287,1,2,312623,312623,312625,0,2,0
89288,4,3,312627,312627,312630,0,3,2
89289,6,3,312633,312633,312636,0,3,3
89290,3,3,312636,312636,312639,0,3,0
89291,4,2,312640,312640,312642,0,2,1
89292,1,2,312641,312642,312644,1,3,0
89293,2,2,312643,312644,312646,1,3,0
89294,6,1,312649,312649,312650,0,1,3
89295,3,2,312652,312652,312654,0,2,2
89296,5,1,312657,312657,312658,0,1,3
89297,2,3,312659,312659,312662,0,3,1
89298,1,3,312660,312662,312665,2,5,0
89299,3,3,312663,312665,312668,2,5,0
89300,1,3,312664,312668,312671,4,7,0
89301,6,2,312670,312671,312673,1,3,0
89302,3,1,312673,312673,312674,0,1,0
89303,6,2,312679,312679,312681,0,2,5
89304,4,2,312683,312683,312685,0,2,2
89305,4,2,312687,312687,312689,0,2,2
89306,4,3,312691,312691,312694,0,3,2
89307,3,3,312694,312694,312697,0,3,0
89308,3,2,312697,312697,312699,0,2,0
89309,1,3,312698,312699,312702,1,4,0
89310,6,1,312704,312704,312705,0,1,2
89311,3,1,312707,312707,312708,0,1,2
89312,4,1,312711,312711,312712,0,1,3
89313,5,2,312716,312716,312718,0,2,4
89314,3,2,312719,312719,312721,0,2,1
89315,6,1,312725,312725,312726,0,1,4
89316,4,2,312729,312729,312731,0,2,3
89317,1,1,312730,312731,312732,1,2,0
89318,2,3,312732,312732,312735,0,3,0
89319,4,2,312736,312736,312738,0,2,1
89320,6,1,312742,312742,312743,0,1,4
89321,3,2,312745,312745,312747,0,2,2
89322,3,3,312748,312748,312751,0,3,1
89323,1,3,312749,312751,312754,2,5,0
89324,6,3,312755,312755,312758,0,3,1
89325,3,3,312758,312758,312761,0,3,0
89326,1,3,312759,312761,312764,2,5,0
89327,6,2,312765,312765,312767,0,2,1
89328,4,3,312769,312769,312772,0,3,2
89329,4,3,312773,312773,312776,0,3,1
89330,2,2,312775,312776,312778,1,3,0
89331,3,1,312778,312778,312779,0,1,0
89332,2,3,312780,312780,312783,0,3,1
89333,4,1,312784,312784,312785,0,1,1
89334,3,1,312787,312787,312788,0,1,2
89335,1,3,312788,312788,312791,0,3,0
89336,3,2,312791,312791,312793,0,2,0
89337,2,2,312793,312793,312795,0,2,0
89338,4,2,312797,312797,312799,0,2,2
89339,1,3,312798,312799,312802,1,4,0
89340,1,2,312799,312802,312804,3,5,0
89341,4,3,312803,312804,312807,1,4,0
89342,4,2,312807,312807,312809,0,2,0
89343,5,2,312812,312812,312814,0,2,3
89344,6,1,312818,312818,312819,0,1,4
89345,6,2,312824,312824,312826,0,2,5
89346,2,1,312826,312826,312827,0,1,0
89347,6,2,312832,312832,312834,0,2,5
89348,2,1,312834,312834,312835,0,1,0
89349,3,1,312837,312837,312838,0,1,2
89350,1,3,312838,312838,312841,0,3,0
89351,6,2,312844,312844,312846,0,2,3
89352,6,2,312850,312850,312852,0,2,4
89353,2,2,312852,312852,312854,0,2,0
89354,2,3,312854,312854,312857,0,3,0
89355,2,2,312856,312857,312859,1,3,0
89356,4,2,312860,312860,312862,0,2,1
89357,1,2,312861,312862,312864,1,3,0
89358,5,3,312866,312866,312869,0,3,2
89359,1,2,312867,312869,312871,2,4,0
89360,2,2,312869,312871,312873,2,4,0
89361,2,3,312871,312873,312876,2,5,0
89362,1,1,312872,312876,312877,4,5,0
89363,5,3,312877,312877,312880,0,3,0
89364,2,2,312879,312880,312882,1,3,0
89365,6,3,312885,312885,312888,0,3,3
89366,1,2,312886,312888,312890,2,4,0
89367,1,3,312887,312890,312893,3,6,0
89368,2,2,312889,312893,312895,4,6,0
89369,2,1,312891,312895,312896,4,5,0
89370,3,2,312894,312896,312898,2,4,0
89371,6,3,312900,312900,312903,0,3,2
89372,6,2,312906,312906,312908,0,2,3
89373,3,1,312909,312909,312910,0,1,1
89374,4,1,312913,312913,312914,0,1,3
89375,5,2,312918,312918,312920,0,2,4
89376,5,3,312923,312923,312926,0,3,3
89377,6,3,312929,312929,312932,0,3,3
89378,1,2,312930,312932,312934,2,4,0
89379,1,1,312931,312934,312935,3,4,0
89380,6,2,312937,312937,312939,0,2,2
89381,6,2,312943,312943,312945,0,2,4
89382,4,1,312947,312947,312948,0,1,2
89383,1,3,312948,312948,312951,0,3,0
89384,5,2,312953,312953,312955,0,2,2
89385,6,1,312959,312959,312960,0,1,4
89386,2,1,312961,312961,312962,0,1,1
89387,6,1,312967,312967,312968,0,1,5
89388,2,3,312969,312969,312972,0,3,1
89389,6,3,312975,312975,312978,0,3,3
89390,5,1,312980,312980,312981,0,1,2
89391,2,1,312982,312982,312983,0,1,1
89392,4,1,312986,312986,312987,0,1,3
89393,6,3,312992,312992,312995,0,3,5
89394,5,3,312997,312997,313000,0,3,2
89395,3,3,313000,313000,313003,0,3,0
89396,4,1,313004,313004,313005,0,1,1
89397,6,3,313010,313010,313013,0,3,5
89398,5,3,313015,313015,313018,0,3,2
89399,3,1,313018,313018,313019,0,1,0
89400,4,2,313022,313022,313024,0,2,3
89401,2,1,313024,313024,313025,0,1,0
89402,2,2,313026,313026,313028,0,2,1
89403,1,1,313027,313028,313029,1,2,0
89404,6,1,313033,313033,313034,0,1,4
89405,3,3,313036,313036,313039,0,3,2
89406,1,3,313037,313039,313042,2,5,0
89407,5,3,313042,313042,313045,0,3,0
89408,1,1,313043,313045,313046,2,3,0
89409,2,3,313045,313046,313049,1,4,0
89410,3,1,313048,313049,313050,1,2,0
89411,6,2,313054,313054,313056,0,2,4
89412,2,3,313056,313056,313059,0,3,0
89413,5,2,313061,313061,313063,0,2,2
89414,4,1,313065,313065,313066,0,1,2
89415,3,1,313068,313068,313069,0,1,2
89416,4,2,313072,313072,313074,0,2,3
89417,5,1,313077,313077,313078,0,1,3
89418,3,3,313080,313080,313083,0,3,2
89419,6,2,313086,313086,313088,0,2,3
89420,2,3,313088,313088,313091,0,3,0
89421,1,2,313089,313091,313093,2,4,0
89422,6,3,313095,313095,313098,0,3,2
89423,3,2,313098,313098,313100,0,2,0
89424,4,3,313102,313102,313105,0,3,2
89425,3,2,313105,313105,313107,0,2,0
89426,4,1,313109,313109,313110,0,1,2
89427,5,2,313114,313114,313116,0,2,4
89428,3,2,313117,313117,313119,0,2,1
89429,3,3,313120,313120,313123,0,3,1
89430,6,1,313126,313126,313127,0,1,3
89431,1,3,313127,313127,313130,0,3,0
89432,5,1,313132,313132,313133,0,1,2
89433,5,3,313137,313137,313140,0,3,4
89434,1,1,313138,313140,313141,2,3,0
89435,1,2,313139,313141,313143,2,4,0
89436,6,1,313145,313145,313146,0,1,2
89437,4,2,313149,313149,313151,0,2,3
89438,6,2,313155,313155,313157,0,2,4
89439,6,1,313161,313161,313162,0,1,4
89440,3,1,313164,313164,313165,0,1,2
89441,5,1,313169,313169,313170,0,1,4
89442,3,2,313172,313172,313174,0,2,2
89443,3,3,313175,313175,313178,0,3,1
89444,5,3,313180,313180,313183,0,3,2
89445,5,3,313185,313185,313188,0,3,2
89446,2,3,313187,313188,313191,1,4,0
89447,5,3,313192,313192,313195,0,3,1
89448,5,3,313197,313197,313200,0,3,2
89449,5,2,313202,313202,313204,0,2,2
89450,3,2,313205,313205,313207,0,2,1
89451,1,1,313206,313207,313208,1,2,0
89452,1,1,313207,313208,313209,1,2,0
89453,1,1,313208,313209,313210,1,2,0
89454,4,2,313212,313212,313214,0,2,2
89455,6,2,313218,313218,313220,0,2,4
89456,6,1,313224,313224,313225,0,1,4
89457,4,2,313228,313228,313230,0,2,3
89458,4,3,313232,313232,313235,0,3,2
89459,1,1,313233,313235,313236,2,3,0
89460,6,2,313239,313239,313241,0,2,3
89461,4,3,313243,313243,313246,0,3,2
89462,2,3,313245,313246,313249,1,4,0
89463,1,3,313246,313249,313252,3,6,0
89464,5,3,313251,313252,313255,1,4,0
89465,2,2,313253,313255,313257,2,4,0
89466,5,3,313258,313258,313261,0,3,1
89467,5,2,313263,313263,313265,0,2,2
89468,6,1,313269,313269,313270,0,1,4
89469,4,2,313273,313273,313275,0,2,3
89470,5,2,313278,313278,313280,0,2,3
89471,6,1,313284,313284,313285,0,1,4
89472,1,2,313285,313285,313287,0,2,0
89473,5,2,313290,313290,313292,0,2,3
89474,5,1,313295,313295,313296,0,1,3
89475,1,2,313296,313296,313298,0,2,0
89476,3,1,313299,313299,313300,0,1,1
89477,6,3,313305,313305,313308,0,3,5
89478,4,2,313309,313309,313311,0,2,1
89479,5,3,313314,313314,313317,0,3,3
89480,5,1,313319,313319,313320,0,1,2
89481,3,1,313322,313322,313323,0,1,2
89482,2,2,313324,313324,313326,0,2,1
89483,6,2,313330,313330,313332,0,2,4
89484,3,2,313333,313333,313335,0,2,1
89485,2,1,313335,313335,313336,0,1,0
89486,1,1,313336,313336,313337,0,1,0
89487,3,1,313339,313339,313340,0,1,2
89488,3,1,313342,313342,313343,0,1,2
89489,2,1,313344,313344,313345,0,1,1
89490,4,2,313348,313348,313350,0,2,3
89491,5,1,313353,313353,313354,0,1,3
89492,1,2,313354,313354,313356,0,2,0
89493,5,3,313359,313359,313362,0,3,3
89494,4,2,313363,313363,313365,0,2,1
89495,1,1,313364,313365,313366,1,2,0
89496,4,1,313368,313368,313369,0,1,2
89497,1,1,313369,313369,313370,0,1,0
89498,2,2,313371,313371,313373,0,2,1
89499,5,3,313376,313376,313379,0,3,3
89500,3,3,313379,313379,313382,0,3,0
89501,3,2,313382,313382,313384,0,2,0
89502,4,2,313386,313386,313388,0,2,2
89503,3,3,313389,313389,313392,0,3,1
89504,5,3,313394,313394,313397,0,3,2
89505,4,1,313398,313398,313399,0,1,1
89506,5,3,313403,313403,313406,0,3,4
89507,6,1,313409,313409,313410,0,1,3
89508,4,2,313413,313413,313415,0,2,3
89509,4,3,313417,313417,313420,0,3,2
89510,3,2,313420,313420,313422,0,2,0
89511,2,2,313422,313422,313424,0,2,0
89512,2,1,313424,313424,313425,0,1,0
89513,4,2,313428,313428,313430,0,2,3
89514,1,2,313429,313430,313432,1,3,0
89515,3,3,313432,313432,313435,0,3,0
89516,6,2,313438,313438,313440,0,2,3
89517,3,3,313441,313441,313444,0,3,1
89518,5,3,313446,313446,313449,0,3,2
89519,4,3,313450,313450,313453,0,3,1
89520,2,3,313452,313453,313456,1,4,0
89521,4,3,313456,313456,313459,0,3,0
89522,5,3,313461,313461,313464,0,3,2
89523,1,3,313462,313464,313467,2,5,0
89524,6,2,313468,313468,313470,0,2,1
89525,2,3,313470,313470,313473,0,3,0
89526,4,3,313474,313474,313477,0,3,1
89527,2,1,313476,313477,313478,1,2,0
89528,5,3,313481,313481,313484,0,3,3
89529,2,1,313483,313484,313485,1,2,0
89530,5,1,313488,313488,313489,0,1,3
89531,6,3,313494,313494,313497,0,3,5
89532,6,1,313500,313500,313501,0,1,3
89533,6,2,313506,313506,313508,0,2,5
89534,4,1,313510,313510,313511,0,1,2
89535,6,1,313516,313516,313517,0,1,5
89536,2,1,313518,313518,313519,0,1,1
89537,6,1,313524,313524,313525,0,1,5
89538,6,2,313530,313530,313532,0,2,5
89539,5,2,313535,313535,313537,0,2,3
89540,6,2,313541,313541,313543,0,2,4
89541,2,3,313543,313543,313546,0,3,0
89542,4,2,313547,313547,313549,0,2,1
89543,3,3,313550,313550,313553,0,3,1
89544,4,1,313554,313554,313555,0,1,1
89545,4,1,313558,313558,313559,0,1,3
89546,2,1,313560,313560,313561,0,1,1
89547,2,3,313562,313562,313565,0,3,1
89548,6,3,313568,313568,313571,0,3,3
89549,6,1,313574,313574,313575,0,1,3
89550,5,1,313579,313579,313580,0,1,4
89551,5,2,313584,313584,313586,0,2,4
89552,6,1,313590,313590,313591,0,1,4
89553,6,2,313596,313596,313598,0,2,5
89554,3,1,313599,313599,313600,0,1,1
89555,4,3,313603,313603,313606,0,3,3
89556,1,3,313604,313606,313609,2,5,0
89557,1,2,313605,313609,313611,4,6,0
89558,2,2,313607,313611,313613,4,6,0
89559,6,2,313613,313613,313615,0,2,0
89560,4,3,313617,313617,313620,0,3,2
89561,2,3,313619,313620,313623,1,4,0
89562,6,2,313625,313625,313627,0,2,2
89563,3,3,313628,313628,313631,0,3,1
89564,1,1,313629,313631,313632,2,3,0
89565,2,1,313631,313632,313633,1,2,0
89566,6,3,313637,313637,313640,0,3,4
89567,6,1,313643,313643,313644,0,1,3
89568,3,3,313646,313646,313649,0,3,2
89569,4,1,313650,313650,313651,0,1,1
89570,6,3,313656,313656,313659,0,3,5
89571,6,2,313662,313662,313664,0,2,3
89572,3,3,313665,313665,313668,0,3,1
89573,1,1,313666,313668,313669,2,3,0
89574,6,3,313672,313672,313675,0,3,3
89575,3,1,313675,313675,313676,0,1,0
89576,3,2,313678,313678,313680,0,2,2
89577,5,3,313683,313683,313686,0,3,3
89578,2,1,313685,313686,313687,1,2,0
89579,3,1,313688,313688,313689,0,1,1
89580,6,3,313694,313694,313697,0,3,5
89581,5,3,313699,313699,313702,0,3,2
89582,4,3,313703,313703,313706,0,3,1
89583,3,1,313706,313706,313707,0,1,0
89584,3,1,313709,313709,313710,0,1,2
89585,2,3,313711,313711,313714,0,3,1
89586,4,1,313715,313715,313716,0,1,1
89587,4,3,313719,313719,313722,0,3,3
89588,5,2,313724,313724,313726,0,2,2
89589,1,1,313725,313726,313727,1,2,0
89590,5,2,313730,313730,313732,0,2,3
89591,5,2,313735,313735,313737,0,2,3
89592,6,1,313741,313741,313742,0,1,4
89593,3,3,313744,313744,313747,0,3,2
89594,6,2,313750,313750,313752,0,2,3
89595,6,2,313756,313756,313758,0,2,4
89596,4,2,313760,313760,313762,0,2,2
89597,5,2,313765,313765,313767,0,2,3
89598,6,3,313771,313771,313774,0,3,4
89599,5,1,313776,313776,313777,0,1,2
89600,4,3,313780,313780,313783,0,3,3
89601,6,3,313786,313786,313789,0,3,3
89602,4,2,313790,313790,313792,0,2,1
89603,5,3,313795,313795,313798,0,3,3
89604,1,3,313796,313798,313801,2,5,0
89605,3,1,313799,313801,313802,2,3,0
89606,3,2,313802,313802,313804,0,2,0
89607,6,3,313808,313808,313811,0,3,4
89608,1,1,313809,313811,313812,2,3,0
89609,3,1,313812,313812,313813,0,1,0
89610,3,3,313815,313815,313818,0,3,2
89611,1,2,313816,313818,313820,2,4,0
89612,1,2,313817,313820,313822,3,5,0
89613,2,2,313819,313822,313824,3,5,0
89614,3,1,313822,313824,313825,2,3,0
89615,2,1,313824,313825,313826,1,2,0
89616,4,3,313828,313828,313831,0,3,2
89617,2,1,313830,313831,313832,1,2,0
89618,3,2,313833,313833,313835,0,2,1
89619,2,2,313835,313835,313837,0,2,0
89620,5,2,313840,313840,313842,0,2,3
89621,2,2,313842,313842,313844,0,2,0
89622,6,1,313848,313848,313849,0,1,4
89623,5,2,313853,313853,313855,0,2,4
89624,1,3,313854,313855,313858,1,4,0
89625,1,1,313855,313858,313859,3,4,0
89626,2,1,313857,313859,313860,2,3,0
89627,6,1,313863,313863,313864,0,1,3
89628,3,2,313866,313866,313868,0,2,2
89629,1,3,313867,313868,313871,1,4,0
89630,3,2,313870,313871,313873,1,3,0
89631,4,1,313874,313874,313875,0,1,1
89632,1,1,313875,313875,313876,0,1,0
89633,1,2,313876,313876,313878,0,2,0
89634,4,2,313880,313880,313882,0,2,2
89635,4,1,313884,313884,313885,0,1,2
89636,6,1,313890,313890,313891,0,1,5
89637,1,1,313891,313891,313892,0,1,0
89638,3,3,313894,313894,313897,0,3,2
89639,2,3,313896,313897,313900,1,4,0
89640,4,1,313900,313900,313901,0,1,0
89641,2,1,313902,313902,313903,0,1,1
89642,3,3,313905,313905,313908,0,3,2
89643,4,3,313909,313909,313912,0,3,1
89644,3,3,313912,313912,313915,0,3,0
89645,4,3,313916,313916,313919,0,3,1
89646,6,1,313922,313922,313923,0,1,3
89647,3,3,313925,313925,313928,0,3,2
89648,4,1,313929,313929,313930,0,1,1
89649,1,1,313930,313930,313931,0,1,0
89650,5,3,313935,313935,313938,0,3,4
89651,5,1,313940,313940,313941,0,1,2
89652,6,2,313946,313946,313948,0,2,5
89653,1,1,313947,313948,313949,1,2,0
89654,6,3,313953,313953,313956,0,3,4
89655,4,3,313957,313957,313960,0,3,1
89656,5,2,313962,313962,313964,0,2,2
89657,2,3,313964,313964,313967,0,3,0
89658,5,2,313969,313969,313971,0,2,2
89659,3,3,313972,313972,313975,0,3,1
89660,3,2,313975,313975,313977,0,2,0
89661,5,2,313980,313980,313982,0,2,3
89662,2,3,313982,313982,313985,0,3,0
89663,4,2,313986,313986,313988,0,2,1
89664,6,1,313992,313992,313993,0,1,4
89665,1,3,313993,313993,313996,0,3,0
89666,2,3,313995,313996,313999,1,4,0
89667,4,1,313999,313999,314000,0,1,0
89668,4,2,314003,314003,314005,0,2,3
89669,6,2,314009,314009,314011,0,2,4
89670,2,3,314011,314011,314014,0,3,0
89671,2,2,314013,314014,314016,1,3,0
89672,2,3,314015,314016,314019,1,4,0
89673,2,1,314017,314019,314020,2,3,0
89674,4,2,314021,314021,314023,0,2,1
89675,1,1,314022,314023,314024,1,2,0
89676,2,2,314024,314024,314026,0,2,0
89677,2,3,314026,314026,314029,0,3,0
89678,6,3,314032,314032,314035,0,3,3
89679,2,1,314034,314035,314036,1,2,0
89680,6,2,314040,314040,314042,0,2,4
89681,5,1,314045,314045,314046,0,1,3
89682,5,3,314050,314050,314053,0,3,4
89683,6,3,314056,314056,314059,0,3,3
89684,4,2,314060,314060,314062,0,2,1
89685,6,1,314066,314066,314067,0,1,4
89686,5,2,314071,314071,314073,0,2,4
89687,3,1,314074,314074,314075,0,1,1
89688,6,2,314080,314080,314082,0,2,5
89689,3,2,314083,314083,314085,0,2,1
89690,5,3,314088,314088,314091,0,3,3
89691,4,3,314092,314092,314095,0,3,1
89692,2,1,314094,314095,314096,1,2,0
89693,3,1,314097,314097,314098,0,1,1
89694,4,2,314101,314101,314103,0,2,3
89695,5,2,314106,314106,314108,0,2,3
89696,6,2,314112,314112,314114,0,2,4
89697,4,1,314116,314116,314117,0,1,2
89698,6,3,314122,314122,314125,0,3,5
89699,1,2,314123,314125,314127,2,4,0
89700,2,1,314125,314127,314128,2,3,0
89701,6,3,314131,314131,314134,0,3,3
89702,1,2,314132,314134,314136,2,4,0
89703,1,1,314133,314136,314137,3,4,0
89704,3,1,314136,314137,314138,1,2,0
89705,3,1,314139,314139,314140,0,1,1
89706,1,3,314140,314140,314143,0,3,0
89707,6,3,314146,314146,314149,0,3,3
89708,4,2,314150,314150,314152,0,2,1
89709,4,1,314154,314154,314155,0,1,2
89710,5,1,314159,314159,314160,0,1,4
89711,3,1,314162,314162,314163,0,1,2
89712,2,3,314164,314164,314167,0,3,1
89713,4,2,314168,314168,314170,0,2,1
89714,5,3,314173,314173,314176,0,3,3
89715,6,1,314179,314179,314180,0,1,3
89716,6,2,314185,314185,314187,0,2,5
89717,2,1,314187,314187,314188,0,1,0
89718,3,3,314190,314190,314193,0,3,2
89719,2,1,314192,314193,314194,1,2,0
89720,2,1,314194,314194,314195,0,1,0
89721,5,3,314199,314199,314202,0,3,4
89722,5,3,314204,314204,314207,0,3,2
89723,3,2,314207,314207,314209,0,2,0
89724,4,2,314211,314211,314213,0,2,2
89725,3,1,314214,314214,314215,0,1,1
89726,4,2,314218,314218,314220,0,2,3
89727,2,2,314220,314220,314222,0,2,0
89728,5,2,314225,314225,314227,0,2,3
89729,3,1,314228,314228,314229,0,1,1
89730,4,3,314232,314232,314235,0,3,3
89731,5,3,314237,314237,314240,0,3,2
89732,1,1,314238,314240,314241,2,3,0
89733,3,1,314241,314241,314242,0,1,0
89734,2,3,314243,314243,314246,0,3,1
89735,6,1,314249,314249,314250,0,1,3
89736,6,3,314255,314255,314258,0,3,5
89737,4,3,314259,314259,314262,0,3,1
89738,2,2,314261,314262,314264,1,3,0
89739,1,2,314262,314264,314266,2,4,0
89740,4,3,314266,314266,314269,0,3,0
89741,4,3,314270,314270,314273,0,3,1
89742,4,3,314274,314274,314277,0,3,1
89743,5,2,314279,314279,314281,0,2,2
89744,4,3,314283,314283,314286,0,3,2
89745,5,2,314288,314288,314290,0,2,2
89746,3,2,314291,314291,314293,0,2,1
89747,6,2,314297,314297,314299,0,2,4
89748,3,2,314300,314300,314302,0,2,1
89749,1,1,314301,314302,314303,1,2,0
89750,6,3,314307,314307,314310,0,3,4
89751,6,1,314313,314313,314314,0,1,3
89752,5,1,314318,314318,314319,0,1,4
89753,2,1,314320,314320,314321,0,1,1
89754,3,2,314323,314323,314325,0,2,2
89755,3,2,314326,314326,314328,0,2,1
89756,4,1,314330,314330,314331,0,1,2
89757,2,2,314332,314332,314334,0,2,1
89758,3,1,314335,314335,314336,0,1,1
89759,4,3,314339,314339,314342,0,3,3
89760,4,2,314343,314343,314345,0,2,1
89761,3,1,314346,314346,314347,0,1,1
89762,1,3,314347,314347,314350,0,3,0
89763,2,2,314349,314350,314352,1,3,0
89764,1,2,314350,314352,314354,2,4,0
89765,6,3,314356,314356,314359,0,3,2
89766,5,3,314361,314361,314364,0,3,2
89767,2,2,314363,314364,314366,1,3,0
89768,2,3,314365,314366,314369,1,4,0
89769,2,1,314367,314369,314370,2,3,0
89770,5,1,314372,314372,314373,0,1,2
89771,4,1,314376,314376,314377,0,1,3
89772,4,1,314380,314380,314381,0,1,3
89773,6,2,314386,314386,314388,0,2,5
89774,2,1,314388,314388,314389,0,1,0
89775,2,3,314390,314390,314393,0,3,1
89776,5,2,314395,314395,314397,0,2,2
89777,5,1,314400,314400,314401,0,1,3
89778,3,3,314403,314403,314406,0,3,2
89779,4,1,314407,314407,314408,0,1,1
89780,4,1,314411,314411,314412,0,1,3
89781,1,1,314412,314412,314413,0,1,0
89782,1,3,314413,314413,314416,0,3,0
89783,5,2,314418,314418,314420,0,2,2
89784,2,2,314420,314420,314422,0,2,0
89785,4,1,314424,314424,314425,0,1,2
89786,2,1,314426,314426,314427,0,1,1
89787,5,3,314431,314431,314434,0,3,4
89788,6,3,314437,314437,314440,0,3,3
89789,3,3,314440,314440,314443,0,3,0
89790,6,1,314446,314446,314447,0,1,3
89791,5,2,314451,314451,314453,0,2,4
89792,5,2,314456,314456,314458,0,2,3
89793,2,2,314458,314458,314460,0,2,0
89794,3,1,314461,314461,314462,0,1,1
89795,5,2,314466,314466,314468,0,2,4
89796,3,1,314469,314469,314470,0,1,1
89797,1,2,314470,314470,314472,0,2,0
89798,3,2,314473,314473,314475,0,2,1
89799,6,2,314479,314479,314481,0,2,4
89800,4,2,314483,314483,314485,0,2,2
89801,6,2,314489,314489,314491,0,2,4
89802,5,1,314494,314494,314495,0,1,3
89803,3,2,314497,314497,314499,0,2,2
89804,4,3,314501,314501,314504,0,3,2
89805,2,1,314503,314504,314505,1,2,0
89806,1,2,314504,314505,314507,1,3,0
89807,3,3,314507,314507,314510,0,3,0
89808,6,3,314513,314513,314516,0,3,3
89809,4,1,314517,314517,314518,0,1,1
89810,1,3,314518,314518,314521,0,3,0
89811,3,1,314521,314521,314522,0,1,0
89812,3,3,314524,314524,314527,0,3,2
89813,4,2,314528,314528,314530,0,2,1
89814,1,3,314529,314530,314533,1,4,0
89815,5,2,314534,314534,314536,0,2,1
89816,5,3,314539,314539,314542,0,3,3
89817,1,2,314540,314542,314544,2,4,0
89818,1,2,314541,314544,314546,3,5,0
89819,5,3,314546,314546,314549,0,3,0
89820,4,2,314550,314550,314552,0,2,1
89821,4,1,314554,314554,314555,0,1,2
89822,3,3,314557,314557,314560,0,3,2
89823,2,2,314559,314560,314562,1,3,0
89824,4,3,314563,314563,314566,0,3,1
89825,4,3,314567,314567,314570,0,3,1
89826,3,1,314570,314570,314571,0,1,0
89827,4,3,314574,314574,314577,0,3,3
89828,4,2,314578,314578,314580,0,2,1
89829,6,3,314584,314584,314587,0,3,4
89830,3,1,314587,314587,314588,0,1,0
89831,3,3,314590,314590,314593,0,3,2
89832,1,3,314591,314593,314596,2,5,0
89833,1,3,314592,314596,314599,4,7,0
89834,3,1,314595,314599,314600,4,5,0
89835,2,3,314597,314600,314603,3,6,0
89836,1,3,314598,314603,314606,5,8,0
89837,6,1,314604,314606,314607,2,3,0
89838,6,3,314610,314610,314613,0,3,3
89839,3,3,314613,314613,314616,0,3,0
89840,3,3,314616,314616,314619,0,3,0
89841,2,3,314618,314619,314622,1,4,0
89842,4,1,314622,314622,314623,0,1,0
89843,6,1,314628,314628,314629,0,1,5
89844,4,1,314632,314632,314633,0,1,3
89845,6,2,314638,314638,314640,0,2,5
89846,3,1,314641,314641,314642,0,1,1
89847,4,2,314645,314645,314647,0,2,3
89848,6,1,314651,314651,314652,0,1,4
89849,4,1,314655,314655,314656,0,1,3
89850,3,1,314658,314658,314659,0,1,2
89851,5,2,314663,314663,314665,0,2,4
89852,3,2,314666,314666,314668,0,2,1
89853,2,3,314668,314668,314671,0,3,0
89854,6,1,314674,314674,314675,0,1,3
89855,5,1,314679,314679,314680,0,1,4
89856,5,2,314684,314684,314686,0,2,4
89857,3,3,314687,314687,314690,0,3,1
89858,1,2,314688,314690,314692,2,4,0
89859,1,2,314689,314692,314694,3,5,0
89860,6,2,314695,314695,314697,0,2,1
89861,1,1,314696,314697,314698,1,2,0
89862,4,1,314700,314700,314701,0,1,2
89863,6,2,314706,314706,314708,0,2,5
89864,3,1,314709,314709,314710,0,1,1
89865,1,1,314710,314710,314711,0,1,0
89866,1,2,314711,314711,314713,0,2,0
89867,5,1,314716,314716,314717,0,1,3
89868,2,3,314718,314718,314721,0,3,1
89869,6,1,314724,314724,314725,0,1,3
89870,6,3,314730,314730,314733,0,3,5
89871,3,2,314733,314733,314735,0,2,0
89872,3,2,314736,314736,314738,0,2,1
89873,6,1,314742,314742,314743,0,1,4
89874,6,2,314748,314748,314750,0,2,5
89875,1,1,314749,314750,314751,1,2,0
89876,2,3,314751,314751,314754,0,3,0
89877,5,3,314756,314756,314759,0,3,2
89878,2,2,314758,314759,314761,1,3,0
89879,5,3,314763,314763,314766,0,3,2
89880,3,1,314766,314766,314767,0,1,0
89881,2,2,314768,314768,314770,0,2,1
89882,3,1,314771,314771,314772,0,1,1
89883,2,1,314773,314773,314774,0,1,1
89884,3,1,314776,314776,314777,0,1,2
89885,6,1,314782,314782,314783,0,1,5
89886,4,2,314786,314786,314788,0,2,3
89887,1,2,314787,314788,314790,1,3,0
89888,5,1,314792,314792,314793,0,1,2
89889,4,3,314796,314796,314799,0,3,3
89890,4,2,314800,314800,314802,0,2,1
89891,3,1,314803,314803,314804,0,1,1
89892,1,2,314804,314804,314806,0,2,0
89893,5,3,314809,314809,314812,0,3,3
89894,6,2,314815,314815,314817,0,2,3
89895,5,1,314820,314820,314821,0,1,3
89896,6,2,314826,314826,314828,0,2,5
89897,4,2,314830,314830,314832,0,2,2
89898,3,2,314833,314833,314835,0,2,1
89899,6,3,314839,314839,314842,0,3,4
89900,4,2,314843,314843,314845,0,2,1
89901,2,3,314845,314845,314848,0,3,0
89902,1,2,314846,314848,314850,2,4,0
89903,4,1,314850,314850,314851,0,1,0
89904,1,3,314851,314851,314854,0,3,0
89905,1,2,314852,314854,314856,2,4,0
89906,1,3,314853,314856,314859,3,6,0
89907,3,2,314856,314859,314861,3,5,0
89908,4,2,314860,314861,314863,1,3,0
89909,3,1,314863,314863,314864,0,1,0
89910,4,2,314867,314867,314869,0,2,3
89911,1,3,314868,314869,314872,1,4,0
89912,3,2,314871,314872,314874,1,3,0
89913,5,1,314876,314876,314877,0,1,2
89914,3,1,314879,314879,314880,0,1,2
89915,3,2,314882,314882,314884,0,2,2
89916,3,3,314885,314885,314888,0,3,1
89917,5,3,314890,314890,314893,0,3,2
89918,3,3,314893,314893,314896,0,3,0
89919,1,2,314894,314896,314898,2,4,0
89920,1,1,314895,314898,314899,3,4,0
89921,4,3,314899,314899,314902,0,3,0
89922,5,2,314904,314904,314906,0,2,2
89923,3,3,314907,314907,314910,0,3,1
89924,4,1,314911,314911,314912,0,1,1
89925,5,2,314916,314916,314918,0,2,4
89926,6,2,314922,314922,314924,0,2,4
89927,2,2,314924,314924,314926,0,2,0
89928,5,1,314929,314929,314930,0,1,3
89929,3,3,314932,314932,314935,0,3,2
89930,6,1,314938,314938,314939,0,1,3
89931,2,1,314940,314940,314941,0,1,1
89932,4,1,314944,314944,314945,0,1,3
89933,4,3,314948,314948,314951,0,3,3
89934,5,1,314953,314953,314954,0,1,2
89935,3,3,314956,314956,314959,0,3,2
89936,2,3,314958,314959,314962,1,4,0
89937,1,3,314959,314962,314965,3,6,0
89938,6,2,314965,314965,314967,0,2,0
89939,1,1,314966,314967,314968,1,2,0
89940,4,3,314970,314970,314973,0,3,2
89941,5,1,314975,314975,314976,0,1,2
89942,1,1,314976,314976,314977,0,1,0
89943,4,3,314980,314980,314983,0,3,3
89944,6,1,314986,314986,314987,0,1,3
89945,5,2,314991,314991,314993,0,2,4
89946,4,3,314995,314995,314998,0,3,2
89947,2,1,314997,314998,314999,1,2,0
89948,2,2,314999,314999,315001,0,2,0
89949,3,3,315002,315002,315005,0,3,1
89950,4,2,315006,315006,315008,0,2,1
89951,2,1,315008,315008,315009,0,1,0
89952,6,1,315014,315014,315015,0,1,5
89953,6,1,315020,315020,315021,0,1,5
89954,2,2,315022,315022,315024,0,2,1
89955,1,1,315023,315024,315025,1,2,0
89956,6,3,315029,315029,315032,0,3,4
89957,5,2,315034,315034,315036,0,2,2
89958,6,3,315040,315040,315043,0,3,4
89959,1,3,315041,315043,315046,2,5,0
89960,1,2,315042,315046,315048,4,6,0
89961,4,1,315046,315048,315049,2,3,0
89962,6,1,315052,315052,315053,0,1,3
89963,4,1,315056,315056,315057,0,1,3
89964,1,1,315057,315057,315058,0,1,0
89965,3,1,315060,315060,315061,0,1,2
89966,3,2,315063,315063,315065,0,2,2
89967,4,1,315067,315067,315068,0,1,2
89968,5,3,315072,315072,315075,0,3,4
89969,5,3,315077,315077,315080,0,3,2
89970,6,2,315083,315083,315085,0,2,3
89971,2,3,315085,315085,315088,0,3,0
89972,5,3,315090,315090,315093,0,3,2
89973,1,3,315091,315093,315096,2,5,0
89974,5,3,315096,315096,315099,0,3,0
89975,1,3,315097,315099,315102,2,5,0
89976,6,1,315103,315103,315104,0,1,1
89977,2,2,315105,315105,315107,0,2,1
89978,5,3,315110,315110,315113,0,3,3
89979,4,1,315114,315114,315115,0,1,1
89980,2,1,315116,315116,315117,0,1,1
89981,2,3,315118,315118,315121,0,3,1
89982,5,2,315123,315123,315125,0,2,2
89983,1,3,315124,315125,315128,1,4,0
89984,3,1,315127,315128,315129,1,2,0
89985,6,3,315133,315133,315136,0,3,4
89986,5,3,315138,315138,315141,0,3,2
89987,3,2,315141,315141,315143,0,2,0
89988,3,2,315144,315144,315146,0,2,1
89989,5,2,315149,315149,315151,0,2,3
89990,6,1,315155,315155,315156,0,1,4
89991,6,1,315161,315161,315162,0,1,5
89992,1,1,315162,315162,315163,0,1,0
89993,2,2,315164,315164,315166,0,2,1
89994,2,2,315166,315166,315168,0,2,0
89995,2,1,315168,315168,315169,0,1,0
89996,1,1,315169,315169,315170,0,1,0
89997,3,1,315172,315172,315173,0,1,2
89998,4,2,315176,315176,315178,0,2,3
89999,2,2,315178,315178,315180,0,2,0
90000,6,1,315184,315184,315185,0,1,4
90001,1,2,315185,315185,315187,0,2,0
90002,2,2,315187,315187,315189,0,2,0
90003,4,1,315191,315191,315192,0,1,2
90004,1,2,315192,315192,315194,0,2,0
90005,6,1,315198,315198,315199,0,1,4
90006,2,3,315200,315200,315203,0,3,1
90007,6,3,315206,315206,315209,0,3,3
90008,5,3,315211,315211,315214,0,3,2
90009,5,2,315216,315216,315218,0,2,2
90010,6,2,315222,315222,315224,0,2,4
90011,1,2,315223,315224,315226,1,3,0
90012,4,2,315227,315227,315229,0,2,1
90013,4,3,315231,315231,315234,0,3,2
90014,2,1,315233,315234,315235,1,2,0
90015,1,1,315234,315235,315236,1,2,0
90016,3,3,315237,315237,315240,0,3,1
90017,2,3,315239,315240,315243,1,4,0
90018,2,2,315241,315243,315245,2,4,0
90019,6,1,315247,315247,315248,0,1,2
90020,5,1,315252,315252,315253,0,1,4
90021,2,3,315254,315254,315257,0,3,1
90022,3,1,315257,315257,315258,0,1,0
90023,1,1,315258,315258,315259,0,1,0
90024,1,2,315259,315259,315261,0,2,0
90025,4,1,315263,315263,315264,0,1,2
90026,4,3,315267,315267,315270,0,3,3
90027,6,1,315273,315273,315274,0,1,3
90028,1,3,315274,315274,315277,0,3,0
90029,1,3,315275,315277,315280,2,5,0
90030,4,1,315279,315280,315281,1,2,0
90031,6,3,315285,315285,315288,0,3,4
90032,1,1,315286,315288,315289,2,3,0
90033,5,3,315291,315291,315294,0,3,2
90034,5,2,315296,315296,315298,0,2,2
90035,6,1,315302,315302,315303,0,1,4
90036,2,3,315304,315304,315307,0,3,1
90037,3,1,315307,315307,315308,0,1,0
90038,3,1,315310,315310,315311,0,1,2
90039,2,1,315312,315312,315313,0,1,1
90040,6,2,315318,315318,315320,0,2,5
90041,5,1,315323,315323,315324,0,1,3
90042,6,2,315329,315329,315331,0,2,5
90043,2,3,315331,315331,315334,0,3,0
90044,3,1,315334,315334,315335,0,1,0
90045,2,3,315336,315336,315339,0,3,1
90046,4,1,315340,315340,315341,0,1,1
90047,4,1,315344,315344,315345,0,1,3
90048,2,2,315346,315346,315348,0,2,1
90049,4,3,315350,315350,315353,0,3,2
90050,3,1,315353,315353,315354,0,1,0
90051,6,3,315359,315359,315362,0,3,5
90052,4,2,315363,315363,315365,0,2,1
90053,6,2,315369,315369,315371,0,2,4
90054,5,2,315374,315374,315376,0,2,3
90055,6,3,315380,315380,315383,0,3,4
90056,6,3,315386,315386,315389,0,3,3
90057,4,3,315390,315390,315393,0,3,1
90058,5,2,315395,315395,315397,0,2,2
90059,5,1,315400,315400,315401,0,1,3
90060,4,2,315404,315404,315406,0,2,3
90061,1,2,315405,315406,315408,1,3,0
90062,5,3,315410,315410,315413,0,3,2
90063,2,2,315412,315413,315415,1,3,0
90064,3,2,315415,315415,315417,0,2,0
90065,2,2,315417,315417,315419,0,2,0
90066,6,3,315423,315423,315426,0,3,4
90067,5,3,315428,315428,315431,0,3,2
90068,4,1,315432,315432,315433,0,1,1
90069,6,2,315438,315438,315440,0,2,5
90070,1,1,315439,315440,315441,1,2,0
90071,1,3,315440,315441,315444,1,4,0
90072,2,2,315442,315444,315446,2,4,0
90073,6,2,315448,315448,315450,0,2,2
90074,3,3,315451,315451,315454,0,3,1
90075,2,2,315453,315454,315456,1,3,0
90076,2,2,315455,315456,315458,1,3,0
90077,3,2,315458,315458,315460,0,2,0
90078,2,3,315460,315460,315463,0,3,0
90079,2,1,315462,315463,315464,1,2,0
90080,2,2,315464,315464,315466,0,2,0
90081,4,1,315468,315468,315469,0,1,2
90082,4,2,315472,315472,315474,0,2,3
90083,6,1,315478,315478,315479,0,1,4
90084,3,2,315481,315481,315483,0,2,2
90085,2,2,315483,315483,315485,0,2,0
90086,6,3,315489,315489,315492,0,3,4
90087,1,1,315490,315492,315493,2,3,0
90088,6,1,315496,315496,315497,0,1,3
90089,6,3,315502,315502,315505,0,3,5
90090,4,2,315506,315506,315508,0,2,1
90091,5,2,315511,315511,315513,0,2,3
90092,4,1,315515,315515,315516,0,1,2
90093,3,1,315518,315518,315519,0,1,2
90094,1,2,315519,315519,315521,0,2,0
90095,3,2,315522,315522,315524,0,2,1
90096,2,3,315524,315524,315527,0,3,0
90097,1,2,315525,315527,315529,2,4,0
90098,1,1,315526,315529,315530,3,4,0
90099,3,2,315529,315530,315532,1,3,0
90100,3,2,315532,315532,315534,0,2,0
90101,3,2,315535,315535,315537,0,2,1
90102,4,2,315539,315539,315541,0,2,2
90103,4,1,315543,315543,315544,0,1,2
90104,1,3,315544,315544,315547,0,3,0
90105,2,2,315546,315547,315549,1,3,0
90106,6,1,315552,315552,315553,0,1,3
90107,3,2,315555,315555,315557,0,2,2
90108,3,1,315558,315558,315559,0,1,1
90109,5,3,315563,315563,315566,0,3,4
90110,5,1,315568,315568,315569,0,1,2
90111,4,2,315572,315572,315574,0,2,3
90112,5,1,315577,315577,315578,0,1,3
90113,3,1,315580,315580,315581,0,1,2
90114,3,1,315583,315583,315584,0,1,2
90115,3,1,315586,315586,315587,0,1,2
90116,4,2,315590,315590,315592,0,2,3
90117,3,3,315593,315593,315596,0,3,1
90118,2,1,315595,315596,315597,1,2,0
90119,1,1,315596,315597,315598,1,2,0
90120,4,2,315600,315600,315602,0,2,2
90121,2,3,315602,315602,315605,0,3,0
90122,6,3,315608,315608,315611,0,3,3
90123,6,3,315614,315614,315617,0,3,3
90124,1,2,315615,315617,315619,2,4,0
90125,6,3,315621,315621,315624,0,3,2
90126,1,3,315622,315624,315627,2,5,0
90127,1,1,315623,315627,315628,4,5,0
90128,1,1,315624,315628,315629,4,5,0
90129,6,1,315630,315630,315631,0,1,1
90130,6,3,315636,315636,315639,0,3,5
90131,1,3,315637,315639,315642,2,5,0
90132,1,2,315638,315642,315644,4,6,0
90133,2,2,315640,315644,315646,4,6,0
90134,2,2,315642,315646,315648,4,6,0
90135,1,2,315643,315648,315650,5,7,0
90136,2,1,315645,315650,315651,5,6,0
90137,6,3,315651,315651,315654,0,3,0
90138,6,2,315657,315657,315659,0,2,3
90139,5,2,315662,315662,315664,0,2,3
90140,6,1,315668,315668,315669,0,1,4
90141,4,1,315672,315672,315673,0,1,3
90142,1,2,315673,315673,315675,0,2,0
90143,4,2,315677,315677,315679,0,2,2
90144,6,1,315683,315683,315684,0,1,4
90145,5,2,315688,315688,315690,0,2,4
90146,1,1,315689,315690,315691,1,2,0
90147,1,1,315690,315691,315692,1,2,0
90148,4,2,315694,315694,315696,0,2,2
90149,4,1,315698,315698,315699,0,1,2
90150,1,1,315699,315699,315700,0,1,0
90151,1,2,315700,315700,315702,0,2,0
90152,2,2,315702,315702,315704,0,2,0
90153,6,3,315708,315708,315711,0,3,4
90154,6,3,315714,315714,315717,0,3,3
90155,5,1,315719,315719,315720,0,1,2
90156,2,1,315721,315721,315722,0,1,1
90157,6,2,315727,315727,315729,0,2,5
90158,4,1,315731,315731,315732,0,1,2
90159,2,2,315733,315733,315735,0,2,1
90160,1,1,315734,315735,315736,1,2,0
90161,3,3,315737,315737,315740,0,3,1
90162,3,2,315740,315740,315742,0,2,0
90163,5,1,315745,315745,315746,0,1,3
90164,3,1,315748,315748,315749,0,1,2
90165,5,3,315753,315753,315756,0,3,4
90166,3,2,315756,315756,315758,0,2,0
90167,2,2,315758,315758,315760,0,2,0
90168,4,3,315762,315762,315765,0,3,2
90169,3,2,315765,315765,315767,0,2,0
90170,1,1,315766,315767,315768,1,2,0
90171,3,3,315769,315769,315772,0,3,1
90172,3,2,315772,315772,315774,0,2,0
90173,4,1,315776,315776,315777,0,1,2
90174,4,2,315780,315780,315782,0,2,3
90175,3,3,315783,315783,315786,0,3,1
90176,4,2,315787,315787,315789,0,2,1
90177,5,1,315792,315792,315793,0,1,3
90178,3,3,315795,315795,315798,0,3,2
90179,4,1,315799,315799,315800,0,1,1
90180,5,3,315804,315804,315807,0,3,4
90181,2,1,315806,315807,315808,1,2,0
90182,6,3,315812,315812,315815,0,3,4
90183,4,2,315816,315816,315818,0,2,1
90184,3,2,315819,315819,315821,0,2,1
90185,3,1,315822,315822,315823,0,1,1
90186,1,3,315823,315823,315826,0,3,0
90187,5,1,315828,315828,315829,0,1,2
90188,3,2,315831,315831,315833,0,2,2
90189,3,2,315834,315834,315836,0,2,1
90190,5,2,315839,315839,315841,0,2,3
90191,6,3,315845,315845,315848,0,3,4
90192,5,1,315850,315850,315851,0,1,2
90193,6,2,315856,315856,315858,0,2,5
90194,3,1,315859,315859,315860,0,1,1
90195,3,1,315862,315862,315863,0,1,2
90196,1,1,315863,315863,315864,0,1,0
90197,4,3,315867,315867,315870,0,3,3
90198,6,3,315873,315873,315876,0,3,3
90199,3,2,315876,315876,315878,0,2,0
90200,4,3,315880,315880,315883,0,3,2
90201,2,3,315882,315883,315886,1,4,0
90202,4,1,315886,315886,315887,0,1,0
90203,6,3,315892,315892,315895,0,3,5
90204,4,2,315896,315896,315898,0,2,1
90205,4,2,315900,315900,315902,0,2,2
90206,4,3,315904,315904,315907,0,3,2
90207,2,1,315906,315907,315908,1,2,0
90208,2,2,315908,315908,315910,0,2,0
90209,6,2,315914,315914,315916,0,2,4
90210,5,1,315919,315919,315920,0,1,3
90211,2,3,315921,315921,315924,0,3,1
90212,3,3,315924,315924,315927,0,3,0
90213,6,1,315930,315930,315931,0,1,3
90214,1,2,315931,315931,315933,0,2,0
90215,5,2,315936,315936,315938,0,2,3
90216,5,2,315941,315941,315943,0,2,3
90217,5,3,315946,315946,315949,0,3,3
90218,1,2,315947,315949,315951,2,4,0
90219,2,3,315949,315951,315954,2,5,0
90220,5,1,315954,315954,315955,0,1,0
90221,3,3,315957,315957,315960,0,3,2
90222,3,2,315960,315960,315962,0,2,0
90223,1,1,315961,315962,315963,1,2,0
90224,1,1,315962,315963,315964,1,2,0
90225,5,1,315967,315967,315968,0,1,3
90226,3,1,315970,315970,315971,0,1,2
90227,4,1,315974,315974,315975,0,1,3
90228,5,1,315979,315979,315980,0,1,4
90229,3,3,315982,315982,315985,0,3,2
90230,5,3,315987,315987,315990,0,3,2
90231,4,1,315991,315991,315992,0,1,1
90232,5,2,315996,315996,315998,0,2,4
90233,2,3,315998,315998,316001,0,3,0
90234,4,1,316002,316002,316003,0,1,1
90235,3,3,316005,316005,316008,0,3,2
90236,3,3,316008,316008,316011,0,3,0
90237,3,3,316011,316011,316014,0,3,0
90238,5,1,316016,316016,316017,0,1,2
90239,4,2,316020,316020,316022,0,2,3
90240,6,1,316026,316026,316027,0,1,4
90241,3,2,316029,316029,316031,0,2,2
90242,2,2,316031,316031,316033,0,2,0
90243,5,2,316036,316036,316038,0,2,3
90244,4,1,316040,316040,316041,0,1,2
90245,4,1,316044,316044,316045,0,1,3
90246,2,2,316046,316046,316048,0,2,1
90247,2,2,316048,316048,316050,0,2,0
90248,2,1,316050,316050,316051,0,1,0
90249,1,1,316051,316051,316052,0,1,0
90250,3,1,316054,316054,316055,0,1,2
90251,4,2,316058,316058,316060,0,2,3
90252,3,1,316061,316061,316062,0,1,1
90253,4,1,316065,316065,316066,0,1,3
90254,5,3,316070,316070,316073,0,3,4
90255,2,2,316072,316073,316075,1,3,0
90256,6,3,316078,316078,316081,0,3,3
90257,3,1,316081,316081,316082,0,1,0
90258,2,3,316083,316083,316086,0,3,1
90259,5,3,316088,316088,316091,0,3,2
90260,3,1,316091,316091,316092,0,1,0
90261,4,3,316095,316095,316098,0,3,3
90262,2,3,316097,316098,316101,1,4,0
90263,4,3,316101,316101,316104,0,3,0
90264,2,1,316103,316104,316105,1,2,0
90265,5,3,316108,316108,316111,0,3,3
90266,4,3,316112,316112,316115,0,3,1
90267,4,3,316116,316116,316119,0,3,1
90268,1,1,316117,316119,316120,2,3,0
90269,6,2,316123,316123,316125,0,2,3
90270,6,2,316129,316129,316131,0,2,4
90271,3,3,316132,316132,316135,0,3,1
90272,2,1,316134,316135,316136,1,2,0
90273,5,3,316139,316139,316142,0,3,3
90274,4,1,316143,316143,316144,0,1,1
90275,2,3,316145,316145,316148,0,3,1
90276,6,1,316151,316151,316152,0,1,3
90277,4,1,316155,316155,316156,0,1,3
90278,4,1,316159,316159,316160,0,1,3
90279,6,1,316165,316165,316166,0,1,5
90280,5,1,316170,316170,316171,0,1,4
90281,1,3,316171,316171,316174,0,3,0
90282,6,1,316177,316177,316178,0,1,3
90283,2,2,316179,316179,316181,0,2,1
90284,6,1,316185,316185,316186,0,1,4
90285,1,1,316186,316186,316187,0,1,0
90286,5,2,316191,316191,316193,0,2,4
90287,4,3,316195,316195,316198,0,3,2
90288,1,3,316196,316198,316201,2,5,0
90289,5,2,316201,316201,316203,0,2,0
90290,1,2,316202,316203,316205,1,3,0
90291,2,3,316204,316205,316208,1,4,0
90292,4,3,316208,316208,316211,0,3,0
90293,2,3,316210,316211,316214,1,4,0
90294,5,2,316215,316215,316217,0,2,1
90295,1,2,316216,316217,316219,1,3,0
90296,6,2,316222,316222,316224,0,2,3
90297,6,2,316228,316228,316230,0,2,4
90298,1,3,316229,316230,316233,1,4,0
90299,4,2,316233,316233,316235,0,2,0
90300,2,1,316235,316235,316236,0,1,0
90301,5,1,316240,316240,316241,0,1,4
90302,1,1,316241,316241,316242,0,1,0
90303,2,1,316243,316243,316244,0,1,1
90304,2,2,316245,316245,316247,0,2,1
90305,1,3,316246,316247,316250,1,4,0
90306,6,1,316252,316252,316253,0,1,2
90307,5,2,316257,316257,316259,0,2,4
90308,1,2,316258,316259,316261,1,3,0
90309,4,3,316262,316262,316265,0,3,1
90310,2,3,316264,316265,316268,1,4,0
90311,3,3,316267,316268,316271,1,4,0
90312,6,2,316273,316273,316275,0,2,2
90313,2,3,316275,316275,316278,0,3,0
90314,1,1,316276,316278,316279,2,3,0
90315,2,1,316278,316279,316280,1,2,0
90316,1,2,316279,316280,316282,1,3,0
90317,5,3,316284,316284,316287,0,3,2
90318,2,1,316286,316287,316288,1,2,0
90319,6,2,316292,316292,316294,0,2,4
90320,2,2,316294,316294,316296,0,2,0
90321,4,3,316298,316298,316301,0,3,2
90322,3,2,316301,316301,316303,0,2,0
90323,5,2,316306,316306,316308,0,2,3
90324,6,1,316312,316312,316313,0,1,4
90325,2,2,316314,316314,316316,0,2,1
90326,1,2,316315,316316,316318,1,3,0
90327,3,3,316318,316318,316321,0,3,0
90328,4,2,316322,316322,316324,0,2,1
90329,1,3,316323,316324,316327,1,4,0
90330,1,1,316324,316327,316328,3,4,0
90331,3,1,316327,316328,316329,1,2,0
90332,6,3,316333,316333,316336,0,3,4
90333,5,3,316338,316338,316341,0,3,2
90334,1,3,316339,316341,316344,2,5,0
90335,4,1,316343,316344,316345,1,2,0
90336,6,2,316349,316349,316351,0,2,4
90337,1,2,316350,316351,316353,1,3,0
90338,1,2,316351,316353,316355,2,4,0
90339,2,1,316353,316355,316356,2,3,0
90340,6,3,316359,316359,316362,0,3,3
90341,1,1,316360,316362,316363,2,3,0
90342,2,3,316362,316363,316366,1,4,0
90343,2,2,316364,316366,316368,2,4,0
90344,2,1,316366,316368,316369,2,3,0
90345,4,1,316370,316370,316371,0,1,1
90346,3,1,316373,316373,316374,0,1,2
90347,1,1,316374,316374,316375,0,1,0
90348,4,2,316378,316378,316380,0,2,3
90349,6,3,316384,316384,316387,0,3,4
90350,2,2,316386,316387,316389,1,3,0
90351,6,3,316392,316392,316395,0,3,3
90352,5,1,316397,316397,316398,0,1,2
90353,2,2,316399,316399,316401,0,2,1
90354,4,1,316403,316403,316404,0,1,2
90355,6,1,316409,316409,316410,0,1,5
90356,4,3,316413,316413,316416,0,3,3
90357,2,3,316415,316416,316419,1,4,0
90358,1,1,316416,316419,316420,3,4,0
90359,6,3,316422,316422,316425,0,3,2
90360,6,2,316428,316428,316430,0,2,3
90361,1,3,316429,316430,316433,1,4,0
90362,3,1,316432,316433,316434,1,2,0
90363,5,3,316437,316437,316440,0,3,3
90364,2,2,316439,316440,316442,1,3,0
90365,1,1,316440,316442,316443,2,3,0
90366,2,3,316442,316443,316446,1,4,0
90367,3,1,316445,316446,316447,1,2,0
90368,3,2,316448,316448,316450,0,2,1
90369,3,2,316451,316451,316453,0,2,1
90370,3,2,316454,316454,316456,0,2,1
90371,6,3,316460,316460,316463,0,3,4
90372,2,3,316462,316463,316466,1,4,0
90373,3,1,316465,316466,316467,1,2,0
90374,1,2,316466,316467,316469,1,3,0
90375,2,1,316468,316469,316470,1,2,0
90376,4,3,316472,316472,316475,0,3,2
90377,5,2,316477,316477,316479,0,2,2
90378,2,2,316479,316479,316481,0,2,0
90379,2,3,316481,316481,316484,0,3,0
90380,6,3,316487,316487,316490,0,3,3
90381,6,1,316493,316493,316494,0,1,3
90382,4,3,316497,316497,316500,0,3,3
90383,5,2,316502,316502,316504,0,2,2
90384,1,3,316503,316504,316507,1,4,0
90385,3,3,316506,316507,316510,1,4,0
90386,6,2,316512,316512,316514,0,2,2
90387,5,3,316517,316517,316520,0,3,3
90388,6,2,316523,316523,316525,0,2,3
90389,4,1,316527,316527,316528,0,1,2
90390,1,2,316528,316528,316530,0,2,0
90391,1,1,316529,316530,316531,1,2,0
90392,3,2,316532,316532,316534,0,2,1
90393,4,2,316536,316536,316538,0,2,2
90394,5,2,316541,316541,316543,0,2,3
90395,3,1,316544,316544,316545,0,1,1
90396,2,1,316546,316546,316547,0,1,1
90397,4,2,316550,316550,316552,0,2,3
90398,6,1,316556,316556,316557,0,1,4
90399,2,3,316558,316558,316561,0,3,1
90400,2,1,316560,316561,316562,1,2,0
90401,3,3,316563,316563,316566,0,3,1
90402,5,3,316568,316568,316571,0,3,2
90403,5,3,316573,316573,316576,0,3,2
90404,1,3,316574,316576,316579,2,5,0
90405,5,2,316579,316579,316581,0,2,0
90406,5,1,316584,316584,316585,0,1,3
90407,3,3,316587,316587,316590,0,3,2
90408,3,1,316590,316590,316591,0,1,0
90409,5,3,316595,316595,316598,0,3,4
90410,1,2,316596,316598,316600,2,4,0
90411,6,1,316602,316602,316603,0,1,2
90412,3,2,316605,316605,316607,0,2,2
90413,6,3,316611,316611,316614,0,3,4
90414,5,3,316616,316616,316619,0,3,2
90415,6,2,316622,316622,316624,0,2,3
90416,3,3,316625,316625,316628,0,3,1
90417,4,2,316629,316629,316631,0,2,1
90418,4,1,316633,316633,316634,0,1,2
90419,3,2,316636,316636,316638,0,2,2
90420,3,3,316639,316639,316642,0,3,1
90421,5,2,316644,316644,316646,0,2,2
90422,2,1,316646,316646,316647,0,1,0
90423,3,3,316649,316649,316652,0,3,2
90424,3,2,316652,316652,316654,0,2,0
90425,2,1,316654,316654,316655,0,1,0
90426,2,3,316656,316656,316659,0,3,1
90427,6,3,316662,316662,316665,0,3,3
90428,6,1,316668,316668,316669,0,1,3
90429,2,1,316670,316670,316671,0,1,1
90430,6,1,316676,316676,316677,0,1,5
90431,6,3,316682,316682,316685,0,3,5
90432,4,1,316686,316686,316687,0,1,1
90433,3,1,316689,316689,316690,0,1,2
90434,5,3,316694,316694,316697,0,3,4
90435,5,3,316699,316699,316702,0,3,2
90436,2,3,316701,316702,316705,1,4,0
90437,6,3,316707,316707,316710,0,3,2
90438,4,2,316711,316711,316713,0,2,1
90439,5,3,316716,316716,316719,0,3,3
90440,6,3,316722,316722,316725,0,3,3
90441,1,1,316723,316725,316726,2,3,0
90442,1,1,316724,316726,316727,2,3,0
90443,1,1,316725,316727,316728,2,3,0
90444,3,2,316728,316728,316730,0,2,0
90445,2,3,316730,316730,316733,0,3,0
90446,2,2,316732,316733,316735,1,3,0
90447,6,1,316738,316738,316739,0,1,3
90448,1,2,316739,316739,316741,0,2,0
90449,2,1,316741,316741,316742,0,1,0
90450,2,1,316743,316743,316744,0,1,1
90451,2,3,316745,316745,316748,0,3,1
90452,1,2,316746,316748,316750,2,4,0
90453,1,1,316747,316750,316751,3,4,0
90454,6,2,316753,316753,316755,0,2,2
90455,3,1,316756,316756,316757,0,1,1
90456,3,2,316759,316759,316761,0,2,2
90457,2,1,316761,316761,316762,0,1,0
90458,4,2,316765,316765,316767,0,2,3
90459,6,1,316771,316771,316772,0,1,4
90460,3,3,316774,316774,316777,0,3,2
90461,4,1,316778,316778,316779,0,1,1
90462,6,3,316784,316784,316787,0,3,5
90463,3,1,316787,316787,316788,0,1,0
90464,5,3,316792,316792,316795,0,3,4
90465,2,2,316794,316795,316797,1,3,0
90466,2,1,316796,316797,316798,1,2,0
90467,3,3,316799,316799,316802,0,3,1
90468,2,2,316801,316802,316804,1,3,0
90469,3,1,316804,316804,316805,0,1,0
90470,6,2,316810,316810,316812,0,2,5
90471,2,1,316812,316812,316813,0,1,0
90472,4,2,316816,316816,316818,0,2,3
90473,1,1,316817,316818,316819,1,2,0
90474,2,2,316819,316819,316821,0,2,0
90475,4,3,316823,316823,316826,0,3,2
90476,3,1,316826,316826,316827,0,1,0
90477,1,2,316827,316827,316829,0,2,0
90478,1,3,316828,316829,316832,1,4,0
90479,5,2,316833,316833,316835,0,2,1
90480,2,2,316835,316835,316837,0,2,0
90481,3,3,316838,316838,316841,0,3,1
90482,3,2,316841,316841,316843,0,2,0
90483,3,1,316844,316844,316845,0,1,1
90484,2,2,316846,316846,316848,0,2,1
90485,6,2,316852,316852,316854,0,2,4
90486,4,3,316856,316856,316859,0,3,2
90487,2,2,316858,316859,316861,1,3,0
90488,3,2,316861,316861,316863,0,2,0
90489,5,1,316866,316866,316867,0,1,3
90490,6,2,316872,316872,316874,0,2,5
90491,4,3,316876,316876,316879,0,3,2
90492,3,3,316879,316879,316882,0,3,0
90493,4,3,316883,316883,316886,0,3,1
90494,4,2,316887,316887,316889,0,2,1
90495,5,2,316892,316892,316894,0,2,3
90496,2,1,316894,316894,316895,0,1,0
90497,2,3,316896,316896,316899,0,3,1
90498,6,2,316902,316902,316904,0,2,3
90499,2,1,316904,316904,316905,0,1,0
90500,5,2,316909,316909,316911,0,2,4
90501,5,3,316914,316914,316917,0,3,3
90502,3,1,316917,316917,316918,0,1,0
90503,4,3,316921,316921,316924,0,3,3
90504,5,3,316926,316926,316929,0,3,2
90505,4,2,316930,316930,316932,0,2,1
90506,2,3,316932,316932,316935,0,3,0
90507,4,3,316936,316936,316939,0,3,1
90508,6,3,316942,316942,316945,0,3,3
90509,5,1,316947,316947,316948,0,1,2
90510,1,1,316948,316948,316949,0,1,0
90511,2,1,316950,316950,316951,0,1,1
90512,6,2,316956,316956,316958,0,2,5
90513,4,1,316960,316960,316961,0,1,2
90514,2,3,316962,316962,316965,0,3,1
90515,2,1,316964,316965,316966,1,2,0
90516,2,3,316966,316966,316969,0,3,0
90517,2,3,316968,316969,316972,1,4,0
90518,5,2,316973,316973,316975,0,2,1
90519,4,3,316977,316977,316980,0,3,2
90520,2,2,316979,316980,316982,1,3,0
90521,5,1,316984,316984,316985,0,1,2
90522,3,2,316987,316987,316989,0,2,2
90523,5,2,316992,316992,316994,0,2,3
90524,5,2,316997,316997,316999,0,2,3
90525,6,1,317003,317003,317004,0,1,4
90526,4,1,317007,317007,317008,0,1,3
90527,2,1,317009,317009,317010,0,1,1
90528,5,1,317014,317014,317015,0,1,4
90529,3,2,317017,317017,317019,0,2,2
90530,1,3,317018,317019,317022,1,4,0
90531,5,2,317023,317023,317025,0,2,1
90532,4,3,317027,317027,317030,0,3,2
90533,3,1,317030,317030,317031,0,1,0
90534,2,3,317032,317032,317035,0,3,1
90535,5,3,317037,317037,317040,0,3,2
90536,5,3,317042,317042,317045,0,3,2
90537,5,1,317047,317047,317048,0,1,2
90538,1,1,317048,317048,317049,0,1,0
90539,2,3,317050,317050,317053,0,3,1
90540,2,1,317052,317053,317054,1,2,0
90541,6,3,317058,317058,317061,0,3,4
90542,4,1,317062,317062,317063,0,1,1
90543,1,1,317063,317063,317064,0,1,0
90544,1,2,317064,317064,317066,0,2,0
90545,1,3,317065,317066,317069,1,4,0
90546,2,2,317067,317069,317071,2,4,0
90547,1,2,317068,317071,317073,3,5,0
90548,3,2,317071,317073,317075,2,4,0
90549,3,3,317074,317075,317078,1,4,0
90550,2,1,317076,317078,317079,2,3,0
90551,2,2,317078,317079,317081,1,3,0
90552,5,2,317083,317083,317085,0,2,2
90553,6,3,317089,317089,317092,0,3,4
90554,1,1,317090,317092,317093,2,3,0
90555,1,3,317091,317093,317096,2,5,0
90556,1,1,317092,317096,317097,4,5,0
90557,1,2,317093,317097,317099,4,6,0
90558,6,1,317099,317099,317100,0,1,0
90559,5,1,317104,317104,317105,0,1,4
90560,1,3,317105,317105,317108,0,3,0
90561,2,3,317107,317108,317111,1,4,0
90562,6,3,317113,317113,317116,0,3,2
90563,5,1,317118,317118,317119,0,1,2
90564,1,1,317119,317119,317120,0,1,0
90565,2,2,317121,317121,317123,0,2,1
90566,5,2,317126,317126,317128,0,2,3
90567,5,1,317131,317131,317132,0,1,3
90568,6,3,317137,317137,317140,0,3,5
90569,4,2,317141,317141,317143,0,2,1
90570,4,1,317145,317145,317146,0,1,2
90571,4,2,317149,317149,317151,0,2,3
90572,5,3,317154,317154,317157,0,3,3
90573,4,2,317158,317158,317160,0,2,1
90574,3,3,317161,317161,317164,0,3,1
90575,2,1,317163,317164,317165,1,2,0
90576,6,2,317169,317169,317171,0,2,4
90577,2,3,317171,317171,317174,0,3,0
90578,6,1,317177,317177,317178,0,1,3
90579,1,1,317178,317178,317179,0,1,0
90580,5,2,317183,317183,317185,0,2,4
90581,1,1,317184,317185,317186,1,2,0
90582,6,3,317190,317190,317193,0,3,4
90583,1,2,317191,317193,317195,2,4,0
90584,4,2,317195,317195,317197,0,2,0
90585,4,1,317199,317199,317200,0,1,2
90586,4,1,317203,317203,317204,0,1,3
90587,2,2,317205,317205,317207,0,2,1
90588,6,2,317211,317211,317213,0,2,4
90589,2,2,317213,317213,317215,0,2,0
90590,6,1,317219,317219,317220,0,1,4
90591,3,1,317222,317222,317223,0,1,2
90592,5,2,317227,317227,317229,0,2,4
90593,5,2,317232,317232,317234,0,2,3
90594,5,3,317237,317237,317240,0,3,3
90595,3,2,317240,317240,317242,0,2,0
90596,5,2,317245,317245,317247,0,2,3
90597,4,3,317249,317249,317252,0,3,2
90598,2,2,317251,317252,317254,1,3,0
90599,6,1,317257,317257,317258,0,1,3
90600,4,2,317261,317261,317263,0,2,3
90601,2,2,317263,317263,317265,0,2,0
90602,5,2,317268,317268,317270,0,2,3
90603,3,2,317271,317271,317273,0,2,1
90604,2,2,317273,317273,317275,0,2,0
90605,4,2,317277,317277,317279,0,2,2
90606,5,3,317282,317282,317285,0,3,3
90607,5,2,317287,317287,317289,0,2,2
90608,6,3,317293,317293,317296,0,3,4
90609,5,2,317298,317298,317300,0,2,2
90610,3,3,317301,317301,317304,0,3,1
90611,4,3,317305,317305,317308,0,3,1
90612,6,1,317311,317311,317312,0,1,3
90613,3,3,317314,317314,317317,0,3,2
90614,4,3,317318,317318,317321,0,3,1
90615,3,1,317321,317321,317322,0,1,0
90616,4,1,317325,317325,317326,0,1,3
90617,2,2,317327,317327,317329,0,2,1
90618,1,2,317328,317329,317331,1,3,0
90619,4,1,317332,317332,317333,0,1,1
90620,6,2,317338,317338,317340,0,2,5
90621,2,1,317340,317340,317341,0,1,0
90622,3,1,317343,317343,317344,0,1,2
90623,6,2,317349,317349,317351,0,2,5
90624,1,2,317350,317351,317353,1,3,0
90625,2,1,317352,317353,317354,1,2,0
90626,6,3,317358,317358,317361,0,3,4
90627,5,2,317363,317363,317365,0,2,2
90628,3,1,317366,317366,317367,0,1,1
90629,3,2,317369,317369,317371,0,2,2
90630,6,1,317375,317375,317376,0,1,4
90631,2,2,317377,317377,317379,0,2,1
90632,1,1,317378,317379,317380,1,2,0
90633,2,2,317380,317380,317382,0,2,0
90634,3,3,317383,317383,317386,0,3,1
90635,5,1,317388,317388,317389,0,1,2
90636,5,1,317393,317393,317394,0,1,4
90637,4,3,317397,317397,317400,0,3,3
90638,6,3,317403,317403,317406,0,3,3
90639,4,2,317407,317407,317409,0,2,1
90640,1,2,317408,317409,317411,1,3,0
90641,4,1,317412,317412,317413,0,1,1
90642,2,2,317414,317414,317416,0,2,1
90643,5,1,317419,317419,317420,0,1,3
90644,5,1,317424,317424,317425,0,1,4
90645,1,3,317425,317425,317428,0,3,0
90646,2,3,317427,317428,317431,1,4,0
90647,2,1,317429,317431,317432,2,3,0
90648,4,1,317433,317433,317434,0,1,1
90649,4,2,317437,317437,317439,0,2,3
90650,5,3,317442,317442,317445,0,3,3
90651,6,3,317448,317448,317451,0,3,3
90652,3,3,317451,317451,317454,0,3,0
90653,1,1,317452,317454,317455,2,3,0
90654,2,3,317454,317455,317458,1,4,0
90655,3,3,317457,317458,317461,1,4,0
90656,2,3,317459,317461,317464,2,5,0
90657,4,3,317463,317464,317467,1,4,0
90658,3,2,317466,317467,317469,1,3,0
90659,4,1,317470,317470,317471,0,1,1
90660,1,3,317471,317471,317474,0,3,0
90661,3,2,317474,317474,317476,0,2,0
90662,1,2,317475,317476,317478,1,3,0
90663,1,1,317476,317478,317479,2,3,0
90664,3,2,317479,317479,317481,0,2,0
90665,5,1,317484,317484,317485,0,1,3
90666,6,1,317490,317490,317491,0,1,5
90667,6,2,317496,317496,317498,0,2,5
90668,5,2,317501,317501,317503,0,2,3
90669,3,1,317504,317504,317505,0,1,1
90670,3,3,317507,317507,317510,0,3,2
90671,3,3,317510,317510,317513,0,3,0
90672,4,1,317514,317514,317515,0,1,1
90673,1,1,317515,317515,317516,0,1,0
90674,2,1,317517,317517,317518,0,1,1
90675,4,1,317521,317521,317522,0,1,3
90676,4,3,317525,317525,317528,0,3,3
90677,1,3,317526,317528,317531,2,5,0
90678,6,2,317532,317532,317534,0,2,1
90679,1,1,317533,317534,317535,1,2,0
90680,5,1,317538,317538,317539,0,1,3
90681,1,2,317539,317539,317541,0,2,0
90682,1,2,317540,317541,317543,1,3,0
90683,4,2,317544,317544,317546,0,2,1
90684,3,3,317547,317547,317550,0,3,1
90685,2,3,317549,317550,317553,1,4,0
90686,3,1,317552,317553,317554,1,2,0
90687,6,1,317558,317558,317559,0,1,4
90688,4,1,317562,317562,317563,0,1,3
90689,5,2,317567,317567,317569,0,2,4
90690,4,2,317571,317571,317573,0,2,2
90691,1,3,317572,317573,317576,1,4,0
90692,2,1,317574,317576,317577,2,3,0
90693,2,3,317576,317577,317580,1,4,0
90694,3,1,317579,317580,317581,1,2,0
90695,4,1,317583,317583,317584,0,1,2
90696,1,1,317584,317584,317585,0,1,0
90697,5,3,317589,317589,317592,0,3,4
90698,4,1,317593,317593,317594,0,1,1
90699,2,2,317595,317595,317597,0,2,1
90700,6,3,317601,317601,317604,0,3,4
90701,5,3,317606,317606,317609,0,3,2
90702,6,2,317612,317612,317614,0,2,3
90703,1,1,317613,317614,317615,1,2,0
90704,2,1,317615,317615,317616,0,1,0
90705,2,3,317617,317617,317620,0,3,1
90706,5,1,317622,317622,317623,0,1,2
90707,2,1,317624,317624,317625,0,1,1
90708,4,3,317628,317628,317631,0,3,3
90709,6,3,317634,317634,317637,0,3,3
90710,6,2,317640,317640,317642,0,2,3
90711,3,1,317643,317643,317644,0,1,1
90712,2,3,317645,317645,317648,0,3,1
90713,5,1,317650,317650,317651,0,1,2
90714,1,2,317651,317651,317653,0,2,0
90715,5,1,317656,317656,317657,0,1,3
90716,4,1,317660,317660,317661,0,1,3
90717,6,2,317666,317666,317668,0,2,5
90718,2,2,317668,317668,317670,0,2,0
90719,1,3,317669,317670,317673,1,4,0
90720,2,2,317671,317673,317675,2,4,0
90721,3,3,317674,317675,317678,1,4,0
90722,3,1,317677,317678,317679,1,2,0
90723,1,2,317678,317679,317681,1,3,0
90724,3,3,317681,317681,317684,0,3,0
90725,2,3,317683,317684,317687,1,4,0
90726,5,2,317688,317688,317690,0,2,1
90727,4,3,317692,317692,317695,0,3,2
90728,1,1,317693,317695,317696,2,3,0
90729,5,1,317698,317698,317699,0,1,2
90730,2,1,317700,317700,317701,0,1,1
90731,1,3,317701,317701,317704,0,3,0
90732,4,2,317705,317705,317707,0,2,1
90733,3,1,317708,317708,317709,0,1,1
90734,5,2,317713,317713,317715,0,2,4
90735,2,2,317715,317715,317717,0,2,0
90736,4,3,317719,317719,317722,0,3,2
90737,4,2,317723,317723,317725,0,2,1
90738,3,3,317726,317726,317729,0,3,1
90739,6,2,317732,317732,317734,0,2,3
90740,3,3,317735,317735,317738,0,3,1
90741,1,3,317736,317738,317741,2,5,0
90742,5,1,317741,317741,317742,0,1,0
90743,2,2,317743,317743,317745,0,2,1
90744,4,3,317747,317747,317750,0,3,2
90745,5,2,317752,317752,317754,0,2,2
90746,2,1,317754,317754,317755,0,1,0
90747,4,2,317758,317758,317760,0,2,3
90748,2,1,317760,317760,317761,0,1,0
90749,4,1,317764,317764,317765,0,1,3
90750,6,3,317770,317770,317773,0,3,5
90751,4,2,317774,317774,317776,0,2,1
90752,1,2,317775,317776,317778,1,3,0
90753,2,1,317777,317778,317779,1,2,0
90754,5,3,317782,317782,317785,0,3,3
90755,5,3,317787,317787,317790,0,3,2
90756,3,2,317790,317790,317792,0,2,0
90757,4,1,317794,317794,317795,0,1,2
90758,4,1,317798,317798,317799,0,1,3
90759,4,3,317802,317802,317805,0,3,3
90760,4,2,317806,317806,317808,0,2,1
90761,4,2,317810,317810,317812,0,2,2
90762,1,3,317811,317812,317815,1,4,0
90763,4,2,317815,317815,317817,0,2,0
90764,3,3,317818,317818,317821,0,3,1
90765,5,2,317823,317823,317825,0,2,2
90766,2,2,317825,317825,317827,0,2,0
90767,4,3,317829,317829,317832,0,3,2
90768,2,2,317831,317832,317834,1,3,0
90769,3,3,317834,317834,317837,0,3,0
90770,1,2,317835,317837,317839,2,4,0
90771,1,2,317836,317839,317841,3,5,0
90772,2,3,317838,317841,317844,3,6,0
90773,2,2,317840,317844,317846,4,6,0
90774,2,3,317842,317846,317849,4,7,0
90775,1,3,317843,317849,317852,6,9,0
90776,5,3,317848,317852,317855,4,7,0
90777,6,3,317854,317855,317858,1,4,0
90778,3,1,317857,317858,317859,1,2,0
90779,2,2,317859,317859,317861,0,2,0
90780,1,3,317860,317861,317864,1,4,0
90781,1,2,317861,317864,317866,3,5,0
90782,1,1,317862,317866,317867,4,5,0
90783,5,2,317867,317867,317869,0,2,0
90784,3,1,317870,317870,317871,0,1,1
90785,3,1,317873,317873,317874,0,1,2
90786,4,2,317877,317877,317879,0,2,3
90787,2,1,317879,317879,317880,0,1,0
90788,5,3,317884,317884,317887,0,3,4
90789,1,1,317885,317887,317888,2,3,0
90790,5,1,317890,317890,317891,0,1,2
90791,6,1,317896,317896,317897,0,1,5
90792,1,3,317897,317897,317900,0,3,0
90793,6,1,317903,317903,317904,0,1,3
90794,1,3,317904,317904,317907,0,3,0
90795,2,1,317906,317907,317908,1,2,0
90796,4,3,317910,317910,317913,0,3,2
90797,4,3,317914,317914,317917,0,3,1
90798,1,1,317915,317917,317918,2,3,0
90799,3,1,317918,317918,317919,0,1,0
90800,5,3,317923,317923,317926,0,3,4
90801,1,2,317924,317926,317928,2,4,0
90802,3,3,317927,317928,317931,1,4,0
90803,3,1,317930,317931,317932,1,2,0
90804,4,3,317934,317934,317937,0,3,2
90805,2,1,317936,317937,317938,1,2,0
90806,6,3,317942,317942,317945,0,3,4
90807,4,2,317946,317946,317948,0,2,1
90808,5,1,317951,317951,317952,0,1,3
90809,4,3,317955,317955,317958,0,3,3
90810,4,2,317959,317959,317961,0,2,1
90811,4,1,317963,317963,317964,0,1,2
90812,4,3,317967,317967,317970,0,3,3
90813,4,2,317971,317971,317973,0,2,1
90814,4,3,317975,317975,317978,0,3,2
90815,1,3,317976,317978,317981,2,5,0
90816,4,3,317980,317981,317984,1,4,0
90817,3,1,317983,317984,317985,1,2,0
90818,6,2,317989,317989,317991,0,2,4
90819,4,3,317993,317993,317996,0,3,2
90820,4,1,317997,317997,317998,0,1,1
90821,5,3,318002,318002,318005,0,3,4
90822,1,1,318003,318005,318006,2,3,0
90823,1,2,318004,318006,318008,2,4,0
90824,5,3,318009,318009,318012,0,3,1
90825,3,1,318012,318012,318013,0,1,0
90826,3,1,318015,318015,318016,0,1,2
90827,1,1,318016,318016,318017,0,1,0
90828,3,2,318019,318019,318021,0,2,2
90829,6,2,318025,318025,318027,0,2,4
90830,1,1,318026,318027,318028,1,2,0
90831,1,2,318027,318028,318030,1,3,0
90832,4,1,318031,318031,318032,0,1,1
90833,1,1,318032,318032,318033,0,1,0
90834,5,1,318037,318037,318038,0,1,4
90835,5,2,318042,318042,318044,0,2,4
90836,1,1,318043,318044,318045,1,2,0
90837,6,1,318049,318049,318050,0,1,4
90838,2,2,318051,318051,318053,0,2,1
90839,4,1,318055,318055,318056,0,1,2
90840,6,1,318061,318061,318062,0,1,5
90841,1,2,318062,318062,318064,0,2,0
90842,2,2,318064,318064,318066,0,2,0
90843,4,1,318068,318068,318069,0,1,2
90844,1,3,318069,318069,318072,0,3,0
90845,1,2,318070,318072,318074,2,4,0
90846,4,1,318074,318074,318075,0,1,0
90847,4,2,318078,318078,318080,0,2,3
90848,5,2,318083,318083,318085,0,2,3
90849,4,2,318087,318087,318089,0,2,2
90850,3,1,318090,318090,318091,0,1,1
90851,3,1,318093,318093,318094,0,1,2
90852,4,2,318097,318097,318099,0,2,3
90853,3,3,318100,318100,318103,0,3,1
90854,2,2,318102,318103,318105,1,3,0
90855,6,2,318108,318108,318110,0,2,3
90856,4,2,318112,318112,318114,0,2,2
90857,5,3,318117,318117,318120,0,3,3
90858,3,3,318120,318120,318123,0,3,0
90859,6,3,318126,318126,318129,0,3,3
90860,6,3,318132,318132,318135,0,3,3
90861,1,2,318133,318135,318137,2,4,0
90862,2,1,318135,318137,318138,2,3,0
90863,3,3,318138,318138,318141,0,3,0
90864,1,3,318139,318141,318144,2,5,0
90865,3,3,318142,318144,318147,2,5,0
90866,4,2,318146,318147,318149,1,3,0
90867,4,1,318150,318150,318151,0,1,1
90868,1,3,318151,318151,318154,0,3,0
90869,2,1,318153,318154,318155,1,2,0
90870,3,3,318156,318156,318159,0,3,1
90871,1,1,318157,318159,318160,2,3,0
90872,4,1,318161,318161,318162,0,1,1
90873,2,3,318163,318163,318166,0,3,1
90874,6,1,318169,318169,318170,0,1,3
90875,5,3,318174,318174,318177,0,3,4
90876,4,1,318178,318178,318179,0,1,1
90877,4,3,318182,318182,318185,0,3,3
90878,6,1,318188,318188,318189,0,1,3
90879,6,2,318194,318194,318196,0,2,5
90880,5,1,318199,318199,318200,0,1,3
90881,6,2,318205,318205,318207,0,2,5
90882,3,3,318208,318208,318211,0,3,1
90883,1,3,318209,318211,318214,2,5,0
90884,1,1,318210,318214,318215,4,5,0
90885,3,3,318213,318215,318218,2,5,0
90886,3,2,318216,318218,318220,2,4,0
90887,1,3,318217,318220,318223,3,6,0
90888,6,1,318223,318223,318224,0,1,0
90889,6,3,318229,318229,318232,0,3,5
90890,3,1,318232,318232,318233,0,1,0
90891,1,3,318233,318233,318236,0,3,0
90892,6,3,318239,318239,318242,0,3,3
90893,6,2,318245,318245,318247,0,2,3
90894,6,2,318251,318251,318253,0,2,4
90895,4,1,318255,318255,318256,0,1,2
90896,4,3,318259,318259,318262,0,3,3
90897,6,3,318265,318265,318268,0,3,3
90898,2,3,318267,318268,318271,1,4,0
90899,2,2,318269,318271,318273,2,4,0
90900,2,3,318271,318273,318276,2,5,0
90901,2,1,318273,318276,318277,3,4,0
90902,5,3,318278,318278,318281,0,3,1
90903,4,3,318282,318282,318285,0,3,1
90904,6,1,318288,318288,318289,0,1,3
90905,6,1,318294,318294,318295,0,1,5
90906,5,1,318299,318299,318300,0,1,4
90907,3,3,318302,318302,318305,0,3,2
90908,4,2,318306,318306,318308,0,2,1
90909,2,3,318308,318308,318311,0,3,0
90910,1,1,318309,318311,318312,2,3,0
90911,4,2,318313,318313,318315,0,2,1
90912,2,1,318315,318315,318316,0,1,0
90913,6,3,318321,318321,318324,0,3,5
90914,5,1,318326,318326,318327,0,1,2
90915,4,1,318330,318330,318331,0,1,3
90916,1,3,318331,318331,318334,0,3,0
90917,1,3,318332,318334,318337,2,5,0
90918,5,2,318337,318337,318339,0,2,0
90919,5,2,318342,318342,318344,0,2,3
90920,6,2,318348,318348,318350,0,2,4
90921,1,1,318349,318350,318351,1,2,0
90922,5,3,318354,318354,318357,0,3,3
90923,5,2,318359,318359,318361,0,2,2
90924,4,3,318363,318363,318366,0,3,2
90925,4,1,318367,318367,318368,0,1,1
90926,2,2,318369,318369,318371,0,2,1
90927,5,3,318374,318374,318377,0,3,3
90928,6,1,318380,318380,318381,0,1,3
90929,2,2,318382,318382,318384,0,2,1
90930,4,1,318386,318386,318387,0,1,2
90931,2,3,318388,318388,318391,0,3,1
90932,4,1,318392,318392,318393,0,1,1
90933,5,2,318397,318397,318399,0,2,4
90934,3,1,318400,318400,318401,0,1,1
90935,3,1,318403,318403,318404,0,1,2
90936,2,2,318405,318405,318407,0,2,1
90937,4,3,318409,318409,318412,0,3,2
90938,6,3,318415,318415,318418,0,3,3
90939,3,2,318418,318418,318420,0,2,0
90940,5,3,318423,318423,318426,0,3,3
90941,4,1,318427,318427,318428,0,1,1
90942,6,2,318433,318433,318435,0,2,5
90943,2,1,318435,318435,318436,0,1,0
90944,5,3,318440,318440,318443,0,3,4
90945,6,1,318446,318446,318447,0,1,3
90946,6,1,318452,318452,318453,0,1,5
90947,6,1,318458,318458,318459,0,1,5
90948,6,3,318464,318464,318467,0,3,5
90949,3,2,318467,318467,318469,0,2,0
90950,5,1,318472,318472,318473,0,1,3
90951,3,2,318475,318475,318477,0,2,2
90952,2,2,318477,318477,318479,0,2,0
90953,5,2,318482,318482,318484,0,2,3
90954,2,2,318484,318484,318486,0,2,0
90955,5,1,318489,318489,318490,0,1,3
90956,4,1,318493,318493,318494,0,1,3
90957,4,2,318497,318497,318499,0,2,3
90958,2,1,318499,318499,318500,0,1,0
90959,5,1,318504,318504,318505,0,1,4
90960,2,1,318506,318506,318507,0,1,1
90961,3,2,318509,318509,318511,0,2,2
90962,6,3,318515,318515,318518,0,3,4
90963,5,1,318520,318520,318521,0,1,2
90964,1,3,318521,318521,318524,0,3,0
90965,3,2,318524,318524,318526,0,2,0
90966,4,3,318528,318528,318531,0,3,2
90967,4,2,318532,318532,318534,0,2,1
90968,3,1,318535,318535,318536,0,1,1
90969,1,2,318536,318536,318538,0,2,0
90970,5,1,318541,318541,318542,0,1,3
90971,1,2,318542,318542,318544,0,2,0
90972,5,1,318547,318547,318548,0,1,3
90973,2,3,318549,318549,318552,0,3,1
90974,3,2,318552,318552,318554,0,2,0
90975,6,3,318558,318558,318561,0,3,4
90976,6,2,318564,318564,318566,0,2,3
90977,1,2,318565,318566,318568,1,3,0
90978,1,1,318566,318568,318569,2,3,0
90979,6,2,318572,318572,318574,0,2,3
90980,3,2,318575,318575,318577,0,2,1
90981,5,2,318580,318580,318582,0,2,3
90982,3,3,318583,318583,318586,0,3,1
90983,5,3,318588,318588,318591,0,3,2
90984,6,1,318594,318594,318595,0,1,3
90985,1,3,318595,318595,318598,0,3,0
90986,5,2,318600,318600,318602,0,2,2
90987,4,3,318604,318604,318607,0,3,2
90988,3,1,318607,318607,318608,0,1,0
90989,6,3,318613,318613,318616,0,3,5
90990,5,3,318618,318618,318621,0,3,2
90991,4,2,318622,318622,318624,0,2,1
90992,4,1,318626,318626,318627,0,1,2
90993,6,1,318632,318632,318633,0,1,5
90994,5,2,318637,318637,318639,0,2,4
90995,5,3,318642,318642,318645,0,3,3
90996,1,3,318643,318645,318648,2,5,0
90997,5,1,318648,318648,318649,0,1,0
90998,2,1,318650,318650,318651,0,1,1
90999,6,2,318656,318656,318658,0,2,5
91000,2,1,318658,318658,318659,0,1,0
91001,4,2,318662,318662,318664,0,2,3
91002,6,3,318668,318668,318671,0,3,4
91003,5,1,318673,318673,318674,0,1,2
91004,5,3,318678,318678,318681,0,3,4
91005,4,3,318682,318682,318685,0,3,1
91006,4,3,318686,318686,318689,0,3,1
91007,4,2,318690,318690,318692,0,2,1
91008,2,1,318692,318692,318693,0,1,0
91009,5,3,318697,318697,318700,0,3,4
91010,6,2,318703,318703,318705,0,2,3
91011,2,3,318705,318705,318708,0,3,0
91012,5,1,318710,318710,318711,0,1,2
91013,4,2,318714,318714,318716,0,2,3
91014,3,3,318717,318717,318720,0,3,1
91015,3,3,318720,318720,318723,0,3,0
91016,4,2,318724,318724,318726,0,2,1
91017,6,3,318730,318730,318733,0,3,4
91018,3,1,318733,318733,318734,0,1,0
91019,3,3,318736,318736,318739,0,3,2
91020,4,1,318740,318740,318741,0,1,1
91021,6,3,318746,318746,318749,0,3,5
91022,3,1,318749,318749,318750,0,1,0
91023,4,2,318753,318753,318755,0,2,3
91024,3,3,318756,318756,318759,0,3,1
91025,2,2,318758,318759,318761,1,3,0
91026,2,3,318760,318761,318764,1,4,0
91027,5,2,318765,318765,318767,0,2,1
91028,2,1,318767,318767,318768,0,1,0
91029,2,1,318769,318769,318770,0,1,1
91030,2,3,318771,318771,318774,0,3,1
91031,4,1,318775,318775,318776,0,1,1
91032,1,3,318776,318776,318779,0,3,0
91033,6,1,318782,318782,318783,0,1,3
91034,5,3,318787,318787,318790,0,3,4
91035,1,3,318788,318790,318793,2,5,0
91036,6,1,318794,318794,318795,0,1,1
91037,1,2,318795,318795,318797,0,2,0
91038,5,3,318800,318800,318803,0,3,3
91039,5,1,318805,318805,318806,0,1,2
91040,3,1,318808,318808,318809,0,1,2
91041,4,3,318812,318812,318815,0,3,3
91042,6,3,318818,318818,318821,0,3,3
91043,4,3,318822,318822,318825,0,3,1
91044,5,1,318827,318827,318828,0,1,2
91045,6,2,318833,318833,318835,0,2,5
91046,4,3,318837,318837,318840,0,3,2
91047,6,3,318843,318843,318846,0,3,3
91048,5,1,318848,318848,318849,0,1,2
91049,6,3,318854,318854,318857,0,3,5
91050,1,1,318855,318857,318858,2,3,0
91051,3,2,318858,318858,318860,0,2,0
91052,5,1,318863,318863,318864,0,1,3
91053,5,3,318868,318868,318871,0,3,4
91054,3,3,318871,318871,318874,0,3,0
91055,3,3,318874,318874,318877,0,3,0
91056,1,1,318875,318877,318878,2,3,0
91057,2,1,318877,318878,318879,1,2,0
91058,5,2,318882,318882,318884,0,2,3
91059,4,3,318886,318886,318889,0,3,2
91060,5,1,318891,318891,318892,0,1,2
91061,1,1,318892,318892,318893,0,1,0
91062,2,3,318894,318894,318897,0,3,1
91063,2,3,318896,318897,318900,1,4,0
91064,4,3,318900,318900,318903,0,3,0
91065,5,1,318905,318905,318906,0,1,2
91066,6,2,318911,318911,318913,0,2,5
91067,6,1,318917,318917,318918,0,1,4
91068,4,2,318921,318921,318923,0,2,3
91069,4,2,318925,318925,318927,0,2,2
91070,4,3,318929,318929,318932,0,3,2
91071,4,2,318933,318933,318935,0,2,1
91072,1,1,318934,318935,318936,1,2,0
91073,1,3,318935,318936,318939,1,4,0
91074,6,2,318941,318941,318943,0,2,2
91075,3,1,318944,318944,318945,0,1,1
91076,4,1,318948,318948,318949,0,1,3
91077,2,1,318950,318950,318951,0,1,1
91078,1,3,318951,318951,318954,0,3,0
91079,6,2,318957,318957,318959,0,2,3
91080,6,2,318963,318963,318965,0,2,4
91081,2,1,318965,318965,318966,0,1,0
91082,3,3,318968,318968,318971,0,3,2
91083,4,2,318972,318972,318974,0,2,1
91084,3,1,318975,318975,318976,0,1,1
91085,2,1,318977,318977,318978,0,1,1
91086,1,1,318978,318978,318979,0,1,0
91087,6,2,318984,318984,318986,0,2,5
91088,5,1,318989,318989,318990,0,1,3
91089,1,1,318990,318990,318991,0,1,0
91090,2,1,318992,318992,318993,0,1,1
91091,3,3,318995,318995,318998,0,3,2
91092,1,2,318996,318998,319000,2,4,0
91093,5,2,319001,319001,319003,0,2,1
91094,2,1,319003,319003,319004,0,1,0
91095,4,1,319007,319007,319008,0,1,3
91096,6,2,319013,319013,319015,0,2,5
91097,1,2,319014,319015,319017,1,3,0
91098,5,2,319019,319019,319021,0,2,2
91099,3,1,319022,319022,319023,0,1,1
91100,1,2,319023,319023,319025,0,2,0
91101,4,3,319027,319027,319030,0,3,2
91102,2,3,319029,319030,319033,1,4,0
91103,6,3,319035,319035,319038,0,3,2
91104,1,2,319036,319038,319040,2,4,0
91105,3,3,319039,319040,319043,1,4,0
91106,1,2,319040,319043,319045,3,5,0
91107,3,1,319043,319045,319046,2,3,0
91108,4,3,319047,319047,319050,0,3,1
91109,4,1,319051,319051,319052,0,1,1
91110,3,2,319054,319054,319056,0,2,2
91111,4,1,319058,319058,319059,0,1,2
91112,2,2,319060,319060,319062,0,2,1
91113,2,3,319062,319062,319065,0,3,0
91114,4,1,319066,319066,319067,0,1,1
91115,4,3,319070,319070,319073,0,3,3
91116,5,2,319075,319075,319077,0,2,2
91117,5,2,319080,319080,319082,0,2,3
91118,1,1,319081,319082,319083,1,2,0
91119,1,2,319082,319083,319085,1,3,0
91120,2,1,319084,319085,319086,1,2,0
91121,3,2,319087,319087,319089,0,2,1
91122,6,3,319093,319093,319096,0,3,4
91123,5,2,319098,319098,319100,0,2,2
91124,5,2,319103,319103,319105,0,2,3
91125,3,3,319106,319106,319109,0,3,1
91126,3,3,319109,319109,319112,0,3,0
91127,4,2,319113,319113,319115,0,2,1
91128,1,2,319114,319115,319117,1,3,0
91129,5,1,319119,319119,319120,0,1,2
91130,1,2,319120,319120,319122,0,2,0
91131,1,2,319121,319122,319124,1,3,0
91132,4,1,319125,319125,319126,0,1,1
91133,4,2,319129,319129,319131,0,2,3
91134,4,2,319133,319133,319135,0,2,2
91135,4,1,319137,319137,319138,0,1,2
91136,5,2,319142,319142,319144,0,2,4
91137,2,2,319144,319144,319146,0,2,0
91138,2,1,319146,319146,319147,0,1,0
91139,5,3,319151,319151,319154,0,3,4
91140,1,1,319152,319154,319155,2,3,0
91141,2,2,319154,319155,319157,1,3,0
91142,1,2,319155,319157,319159,2,4,0
91143,1,1,319156,319159,319160,3,4,0
91144,6,1,319162,319162,319163,0,1,2
91145,5,1,319167,319167,319168,0,1,4
91146,6,2,319173,319173,319175,0,2,5
91147,1,3,319174,319175,319178,1,4,0
91148,1,3,319175,319178,319181,3,6,0
91149,1,1,319176,319181,319182,5,6,0
91150,6,2,319182,319182,319184,0,2,0
91151,1,3,319183,319184,319187,1,4,0
91152,6,2,319189,319189,319191,0,2,2
91153,1,2,319190,319191,319193,1,3,0
91154,5,2,319195,319195,319197,0,2,2
91155,2,2,319197,319197,319199,0,2,0
91156,6,2,319203,319203,319205,0,2,4
91157,5,3,319208,319208,319211,0,3,3
91158,1,1,319209,319211,319212,2,3,0
91159,4,1,319213,319213,319214,0,1,1
91160,1,3,319214,319214,319217,0,3,0
91161,4,2,319218,319218,319220,0,2,1
91162,5,2,319223,319223,319225,0,2,3
91163,1,3,319224,319225,319228,1,4,0
91164,1,1,319225,319228,319229,3,4,0
91165,1,2,319226,319229,319231,3,5,0
91166,4,3,319230,319231,319234,1,4,0
91167,1,1,319231,319234,319235,3,4,0
91168,3,2,319234,319235,319237,1,3,0
91169,3,1,319237,319237,319238,0,1,0
91170,3,2,319240,319240,319242,0,2,2
91171,4,2,319244,319244,319246,0,2,2
91172,4,2,319248,319248,319250,0,2,2
91173,1,1,319249,319250,319251,1,2,0
91174,5,1,319254,319254,319255,0,1,3
91175,4,1,319258,319258,319259,0,1,3
91176,5,3,319263,319263,319266,0,3,4
91177,2,3,319265,319266,319269,1,4,0
91178,1,3,319266,319269,319272,3,6,0
91179,3,3,319269,319272,319275,3,6,0
91180,2,2,319271,319275,319277,4,6,0
91181,2,2,319273,319277,319279,4,6,0
91182,6,1,319279,319279,319280,0,1,0
91183,3,2,319282,319282,319284,0,2,2
91184,5,3,319287,319287,319290,0,3,3
91185,4,1,319291,319291,319292,0,1,1
91186,4,1,319295,319295,319296,0,1,3
91187,1,1,319296,319296,319297,0,1,0
91188,5,3,319301,319301,319304,0,3,4
91189,1,3,319302,319304,319307,2,5,0
91190,4,2,319306,319307,319309,1,3,0
91191,4,1,319310,319310,319311,0,1,1
91192,6,1,319316,319316,319317,0,1,5
91193,5,1,319321,319321,319322,0,1,4
91194,6,2,319327,319327,319329,0,2,5
91195,2,2,319329,319329,319331,0,2,0
91196,2,2,319331,319331,319333,0,2,0
91197,5,2,319336,319336,319338,0,2,3
91198,4,2,319340,319340,319342,0,2,2
91199,5,3,319345,319345,319348,0,3,3
91200,3,3,319348,319348,319351,0,3,0
91201,1,3,319349,319351,319354,2,5,0
91202,5,1,319354,319354,319355,0,1,0
91203,5,2,319359,319359,319361,0,2,4
91204,3,2,319362,319362,319364,0,2,1
91205,1,1,319363,319364,319365,1,2,0
91206,2,3,319365,319365,319368,0,3,0
91207,2,2,319367,319368,319370,1,3,0
91208,1,3,319368,319370,319373,2,5,0
91209,4,1,319372,319373,319374,1,2,0
91210,4,3,319376,319376,319379,0,3,2
91211,4,2,319380,319380,319382,0,2,1
91212,4,1,319384,319384,319385,0,1,2
91213,2,3,319386,319386,319389,0,3,1
91214,4,3,319390,319390,319393,0,3,1
91215,3,1,319393,319393,319394,0,1,0
91216,1,1,319394,319394,319395,0,1,0
91217,3,2,319397,319397,319399,0,2,2
91218,4,1,319401,319401,319402,0,1,2
91219,5,2,319406,319406,319408,0,2,4
91220,1,2,319407,319408,319410,1,3,0
91221,4,1,319411,319411,319412,0,1,1
91222,1,2,319412,319412,319414,0,2,0
91223,2,1,319414,319414,319415,0,1,0
91224,2,1,319416,319416,319417,0,1,1
91225,6,2,319422,319422,319424,0,2,5
91226,3,2,319425,319425,319427,0,2,1
91227,6,1,319431,319431,319432,0,1,4
91228,2,1,319433,319433,319434,0,1,1
91229,4,3,319437,319437,319440,0,3,3
91230,1,3,319438,319440,319443,2,5,0
91231,5,1,319443,319443,319444,0,1,0
91232,4,1,319447,319447,319448,0,1,3
91233,2,1,319449,319449,319450,0,1,1
91234,2,1,319451,319451,319452,0,1,1
91235,6,1,319457,319457,319458,0,1,5
91236,2,3,319459,319459,319462,0,3,1
91237,3,2,319462,319462,319464,0,2,0
91238,4,1,319466,319466,319467,0,1,2
91239,6,3,319472,319472,319475,0,3,5
91240,3,1,319475,319475,319476,0,1,0
91241,2,3,319477,319477,319480,0,3,1
91242,2,1,319479,319480,319481,1,2,0
91243,1,3,319480,319481,319484,1,4,0
91244,6,2,319486,319486,319488,0,2,2
91245,4,3,319490,319490,319493,0,3,2
91246,4,1,319494,319494,319495,0,1,1
91247,4,3,319498,319498,319501,0,3,3
91248,1,2,319499,319501,319503,2,4,0
91249,3,1,319502,319503,319504,1,2,0
91250,3,2,319505,319505,319507,0,2,1
91251,2,3,319507,319507,319510,0,3,0
91252,3,3,319510,319510,319513,0,3,0
91253,4,2,319514,319514,319516,0,2,1
91254,4,1,319518,319518,319519,0,1,2
91255,4,2,319522,319522,319524,0,2,3
91256,6,1,319528,319528,319529,0,1,4
91257,3,3,319531,319531,319534,0,3,2
91258,3,1,319534,319534,319535,0,1,0
91259,3,3,319537,319537,319540,0,3,2
91260,5,2,319542,319542,319544,0,2,2
91261,6,1,319548,319548,319549,0,1,4
91262,5,3,319553,319553,319556,0,3,4
91263,5,1,319558,319558,319559,0,1,2
91264,5,1,319563,319563,319564,0,1,4
91265,1,3,319564,319564,319567,0,3,0
91266,2,1,319566,319567,319568,1,2,0
91267,6,3,319572,319572,319575,0,3,4
91268,1,2,319573,319575,319577,2,4,0
91269,6,1,319579,319579,319580,0,1,2
91270,5,2,319584,319584,319586,0,2,4
91271,2,1,319586,319586,319587,0,1,0
91272,3,2,319589,319589,319591,0,2,2
91273,4,2,319593,319593,319595,0,2,2
91274,1,3,319594,319595,319598,1,4,0
91275,2,3,319596,319598,319601,2,5,0
91276,2,1,319598,319601,319602,3,4,0
91277,3,2,319601,319602,319604,1,3,0
91278,2,2,319603,319604,319606,1,3,0
91279,5,3,319608,319608,319611,0,3,2
91280,6,3,319614,319614,319617,0,3,3
91281,1,2,319615,319617,319619,2,4,0
91282,2,3,319617,319619,319622,2,5,0
91283,5,2,319622,319622,319624,0,2,0
91284,3,1,319625,319625,319626,0,1,1
91285,5,3,319630,319630,319633,0,3,4
91286,4,1,319634,319634,319635,0,1,1
91287,6,1,319640,319640,319641,0,1,5
91288,2,3,319642,319642,319645,0,3,1
91289,3,1,319645,319645,319646,0,1,0
91290,6,3,319651,319651,319654,0,3,5
91291,3,1,319654,319654,319655,0,1,0
91292,3,2,319657,319657,319659,0,2,2
91293,2,1,319659,319659,319660,0,1,0
91294,2,1,319661,319661,319662,0,1,1
91295,4,3,319665,319665,319668,0,3,3
91296,5,2,319670,319670,319672,0,2,2
91297,5,1,319675,319675,319676,0,1,3
91298,5,3,319680,319680,319683,0,3,4
91299,6,2,319686,319686,319688,0,2,3
91300,1,2,319687,319688,319690,1,3,0
91301,1,2,319688,319690,319692,2,4,0
91302,2,2,319690,319692,319694,2,4,0
91303,4,2,319694,319694,319696,0,2,0
91304,5,1,319699,319699,319700,0,1,3
91305,1,1,319700,319700,319701,0,1,0
91306,6,2,319706,319706,319708,0,2,5
91307,6,1,319712,319712,319713,0,1,4
91308,1,3,319713,319713,319716,0,3,0
91309,6,2,319719,319719,319721,0,2,3
91310,2,3,319721,319721,319724,0,3,0
91311,6,2,319727,319727,319729,0,2,3
91312,5,2,319732,319732,319734,0,2,3
91313,1,3,319733,319734,319737,1,4,0
91314,5,2,319738,319738,319740,0,2,1
91315,6,1,319744,319744,319745,0,1,4
91316,1,2,319745,319745,319747,0,2,0
91317,2,1,319747,319747,319748,0,1,0
91318,6,1,319753,319753,319754,0,1,5
91319,5,1,319758,319758,319759,0,1,4
91320,2,1,319760,319760,319761,0,1,1
91321,5,2,319765,319765,319767,0,2,4
91322,3,3,319768,319768,319771,0,3,1
91323,3,3,319771,319771,319774,0,3,0
91324,4,2,319775,319775,319777,0,2,1
91325,5,3,319780,319780,319783,0,3,3
91326,3,2,319783,319783,319785,0,2,0
91327,4,1,319787,319787,319788,0,1,2
91328,6,3,319793,319793,319796,0,3,5
91329,3,3,319796,319796,319799,0,3,0
91330,3,1,319799,319799,319800,0,1,0
91331,3,2,319802,319802,319804,0,2,2
91332,3,2,319805,319805,319807,0,2,1
91333,6,3,319811,319811,319814,0,3,4
91334,3,3,319814,319814,319817,0,3,0
91335,2,3,319816,319817,319820,1,4,0
91336,6,1,319822,319822,319823,0,1,2
91337,3,2,319825,319825,319827,0,2,2
91338,3,2,319828,319828,319830,0,2,1
91339,3,3,319831,319831,319834,0,3,1
91340,4,1,319835,319835,319836,0,1,1
91341,5,2,319840,319840,319842,0,2,4
91342,3,3,319843,319843,319846,0,3,1
91343,5,2,319848,319848,319850,0,2,2
91344,1,3,319849,319850,319853,1,4,0
91345,6,1,319855,319855,319856,0,1,2
91346,3,3,319858,319858,319861,0,3,2
91347,6,3,319864,319864,319867,0,3,3
91348,3,2,319867,319867,319869,0,2,0
91349,4,1,319871,319871,319872,0,1,2
91350,2,2,319873,319873,319875,0,2,1
91351,6,2,319879,319879,319881,0,2,4
91352,3,1,319882,319882,319883,0,1,1
91353,5,3,319887,319887,319890,0,3,4
91354,3,2,319890,319890,319892,0,2,0
91355,2,1,319892,319892,319893,0,1,0
91356,5,3,319897,319897,319900,0,3,4
91357,5,2,319902,319902,319904,0,2,2
91358,6,1,319908,319908,319909,0,1,4
91359,1,1,319909,319909,319910,0,1,0
91360,6,1,319915,319915,319916,0,1,5
91361,1,2,319916,319916,319918,0,2,0
91362,3,2,319919,319919,319921,0,2,1
91363,1,3,319920,319921,319924,1,4,0
91364,5,1,319925,319925,319926,0,1,1
91365,4,1,319929,319929,319930,0,1,3
91366,1,3,319930,319930,319933,0,3,0
91367,5,3,319935,319935,319938,0,3,2
91368,3,1,319938,319938,319939,0,1,0
91369,2,1,319940,319940,319941,0,1,1
91370,2,2,319942,319942,319944,0,2,1
91371,2,3,319944,319944,319947,0,3,0
91372,3,2,319947,319947,319949,0,2,0
91373,5,3,319952,319952,319955,0,3,3
91374,5,3,319957,319957,319960,0,3,2
91375,5,1,319962,319962,319963,0,1,2
91376,6,1,319968,319968,319969,0,1,5
91377,6,2,319974,319974,319976,0,2,5
91378,4,1,319978,319978,319979,0,1,2
91379,4,2,319982,319982,319984,0,2,3
91380,1,3,319983,319984,319987,1,4,0
91381,4,1,319987,319987,319988,0,1,0
91382,5,3,319992,319992,319995,0,3,4
91383,4,1,319996,319996,319997,0,1,1
91384,4,3,320000,320000,320003,0,3,3
91385,5,1,320005,320005,320006,0,1,2
91386,6,3,320011,320011,320014,0,3,5
91387,2,3,320013,320014,320017,1,4,0
91388,2,2,320015,320017,320019,2,4,0
91389,1,2,320016,320019,320021,3,5,0
91390,5,1,320021,320021,320022,0,1,0
91391,6,1,320027,320027,320028,0,1,5
91392,6,2,320033,320033,320035,0,2,5
91393,2,1,320035,320035,320036,0,1,0
91394,2,2,320037,320037,320039,0,2,1
91395,5,1,320042,320042,320043,0,1,3
91396,1,1,320043,320043,320044,0,1,0
91397,3,1,320046,320046,320047,0,1,2
91398,4,1,320050,320050,320051,0,1,3
91399,4,1,320054,320054,320055,0,1,3
91400,5,2,320059,320059,320061,0,2,4
91401,1,2,320060,320061,320063,1,3,0
91402,3,1,320063,320063,320064,0,1,0
91403,4,3,320067,320067,320070,0,3,3
91404,6,1,320073,320073,320074,0,1,3
91405,1,2,320074,320074,320076,0,2,0
91406,6,2,320080,320080,320082,0,2,4
91407,6,1,320086,320086,320087,0,1,4
91408,6,2,320092,320092,320094,0,2,5
91409,4,1,320096,320096,320097,0,1,2
91410,2,1,320098,320098,320099,0,1,1
91411,3,1,320101,320101,320102,0,1,2
91412,3,2,320104,320104,320106,0,2,2
91413,5,1,320109,320109,320110,0,1,3
91414,4,1,320113,320113,320114,0,1,3
91415,6,3,320119,320119,320122,0,3,5
91416,2,2,320121,320122,320124,1,3,0
91417,2,2,320123,320124,320126,1,3,0
91418,1,3,320124,320126,320129,2,5,0
91419,3,3,320127,320129,320132,2,5,0
91420,2,2,320129,320132,320134,3,5,0
91421,6,1,320135,320135,320136,0,1,1
91422,6,1,320141,320141,320142,0,1,5
91423,5,2,320146,320146,320148,0,2,4
91424,5,1,320151,320151,320152,0,1,3
91425,5,1,320156,320156,320157,0,1,4
91426,4,1,320160,320160,320161,0,1,3
91427,6,2,320166,320166,320168,0,2,5
91428,4,2,320170,320170,320172,0,2,2
91429,3,2,320173,320173,320175,0,2,1
91430,6,3,320179,320179,320182,0,3,4
91431,3,3,320182,320182,320185,0,3,0
91432,3,2,320185,320185,320187,0,2,0
91433,1,1,320186,320187,320188,1,2,0
91434,4,3,320190,320190,320193,0,3,2
91435,3,2,320193,320193,320195,0,2,0
91436,2,3,320195,320195,320198,0,3,0
91437,2,3,320197,320198,320201,1,4,0
91438,2,3,320199,320201,320204,2,5,0
91439,1,3,320200,320204,320207,4,7,0
91440,4,2,320204,320207,320209,3,5,0
91441,3,1,320207,320209,320210,2,3,0
91442,6,2,320213,320213,320215,0,2,3
91443,2,2,320215,320215,320217,0,2,0
91444,1,3,320216,320217,320220,1,4,0
91445,1,3,320217,320220,320223,3,6,0
91446,1,3,320218,320223,320226,5,8,0
91447,1,2,320219,320226,320228,7,9,0
91448,3,3,320222,320228,320231,6,9,0
91449,4,1,320226,320231,320232,5,6,0
91450,2,2,320228,320232,320234,4,6,0
91451,4,2,320232,320234,320236,2,4,0
91452,6,2,320238,320238,320240,0,2,2
91453,3,3,320241,320241,320244,0,3,1
91454,4,3,320245,320245,320248,0,3,1
91455,4,1,320249,320249,320250,0,1,1
91456,6,1,320255,320255,320256,0,1,5
91457,1,1,320256,320256,320257,0,1,0
91458,3,2,320259,320259,320261,0,2,2
91459,6,1,320265,320265,320266,0,1,4
91460,1,2,320266,320266,320268,0,2,0
91461,3,2,320269,320269,320271,0,2,1
91462,1,2,320270,320271,320273,1,3,0
91463,1,1,320271,320273,320274,2,3,0
91464,4,3,320275,320275,320278,0,3,1
91465,3,3,320278,320278,320281,0,3,0
91466,6,2,320284,320284,320286,0,2,3
91467,2,2,320286,320286,320288,0,2,0
91468,5,2,320291,320291,320293,0,2,3
91469,5,2,320296,320296,320298,0,2,3
91470,4,1,320300,320300,320301,0,1,2
91471,5,1,320305,320305,320306,0,1,4
91472,2,2,320307,320307,320309,0,2,1
91473,4,1,320311,320311,320312,0,1,2
91474,6,3,320317,320317,320320,0,3,5
91475,4,2,320321,320321,320323,0,2,1
91476,4,2,320325,320325,320327,0,2,2
91477,1,2,320326,320327,320329,1,3,0
91478,3,3,320329,320329,320332,0,3,0
91479,1,2,320330,320332,320334,2,4,0
91480,2,2,320332,320334,320336,2,4,0
91481,6,3,320338,320338,320341,0,3,2
91482,5,3,320343,320343,320346,0,3,2
91483,2,3,320345,320346,320349,1,4,0
91484,6,2,320351,320351,320353,0,2,2
91485,2,3,320353,320353,320356,0,3,0
91486,4,1,320357,320357,320358,0,1,1
91487,5,2,320362,320362,320364,0,2,4
91488,3,1,320365,320365,320366,0,1,1
91489,6,2,320371,320371,320373,0,2,5
91490,6,1,320377,320377,320378,0,1,4
91491,6,3,320383,320383,320386,0,3,5
91492,3,3,320386,320386,320389,0,3,0
91493,2,2,320388,320389,320391,1,3,0
91494,3,2,320391,320391,320393,0,2,0
91495,3,1,320394,320394,320395,0,1,1
91496,4,1,320398,320398,320399,0,1,3
91497,4,3,320402,320402,320405,0,3,3
91498,5,1,320407,320407,320408,0,1,2
91499,4,2,320411,320411,320413,0,2,3
91500,6,1,320417,320417,320418,0,1,4
91501,4,2,320421,320421,320423,0,2,3
91502,4,3,320425,320425,320428,0,3,2
91503,1,3,320426,320428,320431,2,5,0
91504,5,3,320431,320431,320434,0,3,0
91505,4,3,320435,320435,320438,0,3,1
91506,1,1,320436,320438,320439,2,3,0
91507,5,3,320441,320441,320444,0,3,2
91508,1,3,320442,320444,320447,2,5,0
91509,3,3,320445,320447,320450,2,5,0
91510,6,3,320451,320451,320454,0,3,1
91511,2,2,320453,320454,320456,1,3,0
91512,3,3,320456,320456,320459,0,3,0
91513,3,3,320459,320459,320462,0,3,0
91514,1,3,320460,320462,320465,2,5,0
91515,5,2,320465,320465,320467,0,2,0
91516,6,3,320471,320471,320474,0,3,4
91517,3,1,320474,320474,320475,0,1,0
91518,4,3,320478,320478,320481,0,3,3
91519,3,2,320481,320481,320483,0,2,0
91520,4,2,320485,320485,320487,0,2,2
91521,4,1,320489,320489,320490,0,1,2
91522,6,3,320495,320495,320498,0,3,5
91523,3,1,320498,320498,320499,0,1,0
91524,4,3,320502,320502,320505,0,3,3
91525,2,2,320504,320505,320507,1,3,0
91526,5,2,320509,320509,320511,0,2,2
91527,2,1,320511,320511,320512,0,1,0
91528,3,2,320514,320514,320516,0,2,2
91529,1,2,320515,320516,320518,1,3,0
91530,3,2,320518,320518,320520,0,2,0
91531,6,1,320524,320524,320525,0,1,4
91532,5,2,320529,320529,320531,0,2,4
91533,6,2,320535,320535,320537,0,2,4
91534,5,1,320540,320540,320541,0,1,3
91535,6,2,320546,320546,320548,0,2,5
91536,1,1,320547,320548,320549,1,2,0
91537,6,3,320553,320553,320556,0,3,4
91538,4,1,320557,320557,320558,0,1,1
91539,3,3,320560,320560,320563,0,3,2
91540,6,3,320566,320566,320569,0,3,3
91541,6,3,320572,320572,320575,0,3,3
91542,4,2,320576,320576,320578,0,2,1
91543,5,3,320581,320581,320584,0,3,3
91544,2,2,320583,320584,320586,1,3,0
91545,4,1,320587,320587,320588,0,1,1
91546,6,1,320593,320593,320594,0,1,5
91547,5,3,320598,320598,320601,0,3,4
91548,1,2,320599,320601,320603,2,4,0
91549,6,2,320605,320605,320607,0,2,2
91550,4,2,320609,320609,320611,0,2,2
91551,1,3,320610,320611,320614,1,4,0
91552,2,3,320612,320614,320617,2,5,0
91553,4,2,320616,320617,320619,1,3,0
91554,3,3,320619,320619,320622,0,3,0
91555,6,2,320625,320625,320627,0,2,3
91556,5,3,320630,320630,320633,0,3,3
91557,2,3,320632,320633,320636,1,4,0
91558,4,1,320636,320636,320637,0,1,0
91559,6,3,320642,320642,320645,0,3,5
91560,2,2,320644,320645,320647,1,3,0
91561,2,1,320646,320647,320648,1,2,0
91562,5,1,320651,320651,320652,0,1,3
91563,5,2,320656,320656,320658,0,2,4
91564,6,2,320662,320662,320664,0,2,4
91565,3,3,320665,320665,320668,0,3,1
91566,3,2,320668,320668,320670,0,2,0
91567,1,3,320669,320670,320673,1,4,0
91568,3,3,320672,320673,320676,1,4,0
91569,2,3,320674,320676,320679,2,5,0
91570,3,1,320677,320679,320680,2,3,0
91571,4,3,320681,320681,320684,0,3,1
91572,1,3,320682,320684,320687,2,5,0
91573,2,1,320684,320687,320688,3,4,0
91574,2,2,320686,320688,320690,2,4,0
91575,1,2,320687,320690,320692,3,5,0
91576,4,2,320691,320692,320694,1,3,0
91577,4,2,320695,320695,320697,0,2,1
91578,1,1,320696,320697,320698,1,2,0
91579,1,1,320697,320698,320699,1,2,0
91580,2,2,320699,320699,320701,0,2,0
91581,2,1,320701,320701,320702,0,1,0
91582,6,3,320707,320707,320710,0,3,5
91583,4,2,320711,320711,320713,0,2,1
91584,3,3,320714,320714,320717,0,3,1
91585,3,2,320717,320717,320719,0,2,0
91586,6,1,320723,320723,320724,0,1,4
91587,4,1,320727,320727,320728,0,1,3
91588,1,3,320728,320728,320731,0,3,0
91589,1,2,320729,320731,320733,2,4,0
91590,6,2,320735,320735,320737,0,2,2
91591,3,3,320738,320738,320741,0,3,1
91592,6,2,320744,320744,320746,0,2,3
91593,2,1,320746,320746,320747,0,1,0
91594,1,1,320747,320747,320748,0,1,0
91595,1,2,320748,320748,320750,0,2,0
91596,6,1,320754,320754,320755,0,1,4
91597,2,2,320756,320756,320758,0,2,1
91598,5,2,320761,320761,320763,0,2,3
91599,4,1,320765,320765,320766,0,1,2
91600,2,1,320767,320767,320768,0,1,1
91601,2,2,320769,320769,320771,0,2,1
91602,2,3,320771,320771,320774,0,3,0
91603,3,1,320774,320774,320775,0,1,0
91604,1,1,320775,320775,320776,0,1,0
91605,6,3,320781,320781,320784,0,3,5
91606,5,2,320786,320786,320788,0,2,2
91607,1,3,320787,320788,320791,1,4,0
91608,5,3,320792,320792,320795,0,3,1
91609,5,2,320797,320797,320799,0,2,2
91610,2,1,320799,320799,320800,0,1,0
91611,1,3,320800,320800,320803,0,3,0
91612,3,2,320803,320803,320805,0,2,0
91613,1,1,320804,320805,320806,1,2,0
91614,2,1,320806,320806,320807,0,1,0
91615,4,1,320810,320810,320811,0,1,3
91616,6,3,320816,320816,320819,0,3,5
91617,3,1,320819,320819,320820,0,1,0
91618,2,3,320821,320821,320824,0,3,1
91619,2,3,320823,320824,320827,1,4,0
91620,3,3,320826,320827,320830,1,4,0
91621,5,3,320831,320831,320834,0,3,1
91622,2,2,320833,320834,320836,1,3,0
91623,3,3,320836,320836,320839,0,3,0
91624,1,1,320837,320839,320840,2,3,0
91625,3,3,320840,320840,320843,0,3,0
91626,3,1,320843,320843,320844,0,1,0
91627,3,2,320846,320846,320848,0,2,2
91628,2,3,320848,320848,320851,0,3,0
91629,1,2,320849,320851,320853,2,4,0
91630,4,1,320853,320853,320854,0,1,0
91631,3,1,320856,320856,320857,0,1,2
91632,4,3,320860,320860,320863,0,3,3
91633,1,2,320861,320863,320865,2,4,0
91634,3,1,320864,320865,320866,1,2,0
91635,5,2,320869,320869,320871,0,2,3
91636,2,2,320871,320871,320873,0,2,0
91637,4,2,320875,320875,320877,0,2,2
91638,6,2,320881,320881,320883,0,2,4
91639,3,3,320884,320884,320887,0,3,1
91640,1,3,320885,320887,320890,2,5,0
91641,5,3,320890,320890,320893,0,3,0
91642,2,3,320892,320893,320896,1,4,0
91643,6,2,320898,320898,320900,0,2,2
91644,5,3,320903,320903,320906,0,3,3
91645,1,3,320904,320906,320909,2,5,0
91646,6,1,320910,320910,320911,0,1,1
91647,3,2,320913,320913,320915,0,2,2
91648,4,2,320917,320917,320919,0,2,2
91649,2,3,320919,320919,320922,0,3,0
91650,2,2,320921,320922,320924,1,3,0
91651,6,1,320927,320927,320928,0,1,3
91652,4,1,320931,320931,320932,0,1,3
91653,4,3,320935,320935,320938,0,3,3
91654,1,1,320936,320938,320939,2,3,0
91655,3,3,320939,320939,320942,0,3,0
91656,2,1,320941,320942,320943,1,2,0
91657,3,1,320944,320944,320945,0,1,1
91658,5,2,320949,320949,320951,0,2,4
91659,6,3,320955,320955,320958,0,3,4
91660,1,1,320956,320958,320959,2,3,0
91661,4,3,320960,320960,320963,0,3,1
91662,4,3,320964,320964,320967,0,3,1
91663,6,1,320970,320970,320971,0,1,3
91664,6,2,320976,320976,320978,0,2,5
91665,1,2,320977,320978,320980,1,3,0
91666,4,3,320981,320981,320984,0,3,1
91667,4,1,320985,320985,320986,0,1,1
91668,5,2,320990,320990,320992,0,2,4
91669,5,3,320995,320995,320998,0,3,3
91670,6,1,321001,321001,321002,0,1,3
91671,4,2,321005,321005,321007,0,2,3
91672,6,1,321011,321011,321012,0,1,4
91673,4,1,321015,321015,321016,0,1,3
91674,1,2,321016,321016,321018,0,2,0
91675,5,1,321021,321021,321022,0,1,3
91676,2,1,321023,321023,321024,0,1,1
91677,2,3,321025,321025,321028,0,3,1
91678,2,1,321027,321028,321029,1,2,0
91679,3,1,321030,321030,321031,0,1,1
91680,5,2,321035,321035,321037,0,2,4
91681,6,1,321041,321041,321042,0,1,4
91682,6,3,321047,321047,321050,0,3,5
91683,1,2,321048,321050,321052,2,4,0
91684,3,1,321051,321052,321053,1,2,0
91685,3,3,321054,321054,321057,0,3,1
91686,2,1,321056,321057,321058,1,2,0
91687,5,1,321061,321061,321062,0,1,3
91688,4,2,321065,321065,321067,0,2,3
91689,4,3,321069,321069,321072,0,3,2
91690,3,3,321072,321072,321075,0,3,0
91691,6,3,321078,321078,321081,0,3,3
91692,1,3,321079,321081,321084,2,5,0
91693,3,1,321082,321084,321085,2,3,0
91694,3,2,321085,321085,321087,0,2,0
91695,1,2,321086,321087,321089,1,3,0
91696,3,3,321089,321089,321092,0,3,0
91697,2,2,321091,321092,321094,1,3,0
91698,5,3,321096,321096,321099,0,3,2
91699,5,1,321101,321101,321102,0,1,2
91700,3,1,321104,321104,321105,0,1,2
91701,3,2,321107,321107,321109,0,2,2
91702,6,2,321113,321113,321115,0,2,4
91703,1,2,321114,321115,321117,1,3,0
91704,2,1,321116,321117,321118,1,2,0
91705,1,2,321117,321118,321120,1,3,0
91706,1,2,321118,321120,321122,2,4,0
91707,3,2,321121,321122,321124,1,3,0
91708,6,1,321127,321127,321128,0,1,3
91709,3,3,321130,321130,321133,0,3,2
91710,3,2,321133,321133,321135,0,2,0
91711,6,3,321139,321139,321142,0,3,4
91712,6,3,321145,321145,321148,0,3,3
91713,2,3,321147,321148,321151,1,4,0
91714,2,3,321149,321151,321154,2,5,0
91715,3,2,321152,321154,321156,2,4,0
91716,4,1,321156,321156,321157,0,1,0
91717,3,3,321159,321159,321162,0,3,2
91718,4,2,321163,321163,321165,0,2,1
91719,5,2,321168,321168,321170,0,2,3
91720,6,1,321174,321174,321175,0,1,4
91721,6,2,321180,321180,321182,0,2,5
91722,4,1,321184,321184,321185,0,1,2
91723,3,3,321187,321187,321190,0,3,2
91724,6,2,321193,321193,321195,0,2,3
91725,3,1,321196,321196,321197,0,1,1
91726,2,3,321198,321198,321201,0,3,1
91727,1,2,321199,321201,321203,2,4,0
91728,5,2,321204,321204,321206,0,2,1
91729,2,3,321206,321206,321209,0,3,0
91730,4,1,321210,321210,321211,0,1,1
91731,5,1,321215,321215,321216,0,1,4
91732,4,3,321219,321219,321222,0,3,3
91733,6,1,321225,321225,321226,0,1,3
91734,3,3,321228,321228,321231,0,3,2
91735,5,3,321233,321233,321236,0,3,2
91736,1,1,321234,321236,321237,2,3,0
91737,6,3,321240,321240,321243,0,3,3
91738,5,3,321245,321245,321248,0,3,2
91739,2,1,321247,321248,321249,1,2,0
91740,4,2,321251,321251,321253,0,2,2
91741,2,3,321253,321253,321256,0,3,0
91742,3,3,321256,321256,321259,0,3,0
91743,4,3,321260,321260,321263,0,3,1
91744,4,3,321264,321264,321267,0,3,1
91745,2,3,321266,321267,321270,1,4,0
91746,1,2,321267,321270,321272,3,5,0
91747,5,1,321272,321272,321273,0,1,0
91748,3,3,321275,321275,321278,0,3,2
91749,5,3,321280,321280,321283,0,3,2
91750,2,1,321282,321283,321284,1,2,0
91751,4,3,321286,321286,321289,0,3,2
91752,1,3,321287,321289,321292,2,5,0
91753,3,3,321290,321292,321295,2,5,0
91754,4,1,321294,321295,321296,1,2,0
91755,2,1,321296,321296,321297,0,1,0
91756,5,2,321301,321301,321303,0,2,4
91757,1,2,321302,321303,321305,1,3,0
91758,5,3,321307,321307,321310,0,3,2
91759,2,2,321309,321310,321312,1,3,0
91760,2,2,321311,321312,321314,1,3,0
91761,3,3,321314,321314,321317,0,3,0
91762,4,1,321318,321318,321319,0,1,1
91763,5,3,321323,321323,321326,0,3,4
91764,1,2,321324,321326,321328,2,4,0
91765,6,1,321330,321330,321331,0,1,2
91766,6,3,321336,321336,321339,0,3,5
91767,4,3,321340,321340,321343,0,3,1
91768,1,1,321341,321343,321344,2,3,0
91769,1,2,321342,321344,321346,2,4,0
91770,5,1,321347,321347,321348,0,1,1
91771,5,1,321352,321352,321353,0,1,4
91772,6,2,321358,321358,321360,0,2,5
91773,1,1,321359,321360,321361,1,2,0
91774,4,1,321363,321363,321364,0,1,2
91775,5,1,321368,321368,321369,0,1,4
91776,1,3,321369,321369,321372,0,3,0
91777,6,1,321375,321375,321376,0,1,3
91778,4,1,321379,321379,321380,0,1,3
91779,2,3,321381,321381,321384,0,3,1
91780,3,3,321384,321384,321387,0,3,0
91781,3,1,321387,321387,321388,0,1,0
91782,2,2,321389,321389,321391,0,2,1
91783,1,1,321390,321391,321392,1,2,0
91784,5,1,321395,321395,321396,0,1,3
91785,6,3,321401,321401,321404,0,3,5
91786,2,2,321403,321404,321406,1,3,0
91787,2,2,321405,321406,321408,1,3,0
91788,5,2,321410,321410,321412,0,2,2
91789,4,1,321414,321414,321415,0,1,2
91790,1,1,321415,321415,321416,0,1,0
91791,4,2,321419,321419,321421,0,2,3
91792,1,2,321420,321421,321423,1,3,0
91793,3,1,321423,321423,321424,0,1,0
91794,2,3,321425,321425,321428,0,3,1
91795,2,2,321427,321428,321430,1,3,0
91796,5,1,321432,321432,321433,0,1,2
91797,2,3,321434,321434,321437,0,3,1
91798,4,1,321438,321438,321439,0,1,1
91799,6,3,321444,321444,321447,0,3,5
91800,3,1,321447,321447,321448,0,1,0
91801,5,1,321452,321452,321453,0,1,4
91802,2,2,321454,321454,321456,0,2,1
91803,1,3,321455,321456,321459,1,4,0
91804,3,1,321458,321459,321460,1,2,0
91805,6,2,321464,321464,321466,0,2,4
91806,4,2,321468,321468,321470,0,2,2
91807,5,2,321473,321473,321475,0,2,3
91808,3,3,321476,321476,321479,0,3,1
91809,1,1,321477,321479,321480,2,3,0
91810,1,3,321478,321480,321483,2,5,0
91811,5,2,321483,321483,321485,0,2,0
91812,1,3,321484,321485,321488,1,4,0
91813,1,3,321485,321488,321491,3,6,0
91814,6,2,321491,321491,321493,0,2,0
91815,6,2,321497,321497,321499,0,2,4
91816,3,1,321500,321500,321501,0,1,1
91817,6,2,321506,321506,321508,0,2,5
91818,4,2,321510,321510,321512,0,2,2
91819,4,3,321514,321514,321517,0,3,2
91820,5,3,321519,321519,321522,0,3,2
91821,5,3,321524,321524,321527,0,3,2
91822,1,1,321525,321527,321528,2,3,0
91823,3,2,321528,321528,321530,0,2,0
91824,1,1,321529,321530,321531,1,2,0
91825,4,1,321533,321533,321534,0,1,2
91826,1,3,321534,321534,321537,0,3,0
91827,3,3,321537,321537,321540,0,3,0
91828,1,3,321538,321540,321543,2,5,0
91829,2,3,321540,321543,321546,3,6,0
91830,1,1,321541,321546,321547,5,6,0
91831,2,3,321543,321547,321550,4,7,0
91832,4,2,321547,321550,321552,3,5,0
91833,3,3,321550,321552,321555,2,5,0
91834,1,3,321551,321555,321558,4,7,0
91835,5,2,321556,321558,321560,2,4,0
91836,3,1,321559,321560,321561,1,2,0
91837,6,1,321565,321565,321566,0,1,4
91838,1,2,321566,321566,321568,0,2,0
91839,6,2,321572,321572,321574,0,2,4
91840,1,3,321573,321574,321577,1,4,0
91841,2,2,321575,321577,321579,2,4,0
91842,4,3,321579,321579,321582,0,3,0
91843,4,2,321583,321583,321585,0,2,1
91844,6,3,321589,321589,321592,0,3,4
91845,5,1,321594,321594,321595,0,1,2
91846,4,2,321598,321598,321600,0,2,3
91847,6,3,321604,321604,321607,0,3,4
91848,5,1,321609,321609,321610,0,1,2
91849,5,3,321614,321614,321617,0,3,4
91850,4,1,321618,321618,321619,0,1,1
91851,4,3,321622,321622,321625,0,3,3
91852,6,2,321628,321628,321630,0,2,3
91853,1,2,321629,321630,321632,1,3,0
91854,6,1,321635,321635,321636,0,1,3
91855,4,2,321639,321639,321641,0,2,3
91856,5,1,321644,321644,321645,0,1,3
91857,5,3,321649,321649,321652,0,3,4
91858,6,1,321655,321655,321656,0,1,3
91859,6,1,321661,321661,321662,0,1,5
91860,6,2,321667,321667,321669,0,2,5
91861,6,3,321673,321673,321676,0,3,4
91862,2,3,321675,321676,321679,1,4,0
91863,4,1,321679,321679,321680,0,1,0
91864,6,3,321685,321685,321688,0,3,5
91865,3,2,321688,321688,321690,0,2,0
91866,2,3,321690,321690,321693,0,3,0
91867,2,2,321692,321693,321695,1,3,0
91868,5,1,321697,321697,321698,0,1,2
91869,6,3,321703,321703,321706,0,3,5
91870,3,2,321706,321706,321708,0,2,0
91871,2,2,321708,321708,321710,0,2,0
91872,2,2,321710,321710,321712,0,2,0
91873,6,3,321716,321716,321719,0,3,4
91874,2,3,321718,321719,321722,1,4,0
91875,5,3,321723,321723,321726,0,3,1
91876,3,1,321726,321726,321727,0,1,0
91877,1,1,321727,321727,321728,0,1,0
91878,2,2,321729,321729,321731,0,2,1
91879,6,1,321735,321735,321736,0,1,4
91880,4,3,321739,321739,321742,0,3,3
91881,4,3,321743,321743,321746,0,3,1
91882,6,2,321749,321749,321751,0,2,3
91883,4,3,321753,321753,321756,0,3,2
91884,2,2,321755,321756,321758,1,3,0
91885,1,3,321756,321758,321761,2,5,0
91886,2,2,321758,321761,321763,3,5,0
91887,5,3,321763,321763,321766,0,3,0
91888,6,1,321769,321769,321770,0,1,3
91889,6,2,321775,321775,321777,0,2,5
91890,3,3,321778,321778,321781,0,3,1
91891,3,2,321781,321781,321783,0,2,0
91892,6,3,321787,321787,321790,0,3,4
91893,3,2,321790,321790,321792,0,2,0
91894,1,2,321791,321792,321794,1,3,0
91895,3,2,321794,321794,321796,0,2,0
91896,6,1,321800,321800,321801,0,1,4
91897,2,1,321802,321802,321803,0,1,1
91898,4,2,321806,321806,321808,0,2,3
91899,2,1,321808,321808,321809,0,1,0
91900,4,2,321812,321812,321814,0,2,3
91901,4,1,321816,321816,321817,0,1,2
91902,3,3,321819,321819,321822,0,3,2
91903,6,2,321825,321825,321827,0,2,3
91904,6,1,321831,321831,321832,0,1,4
91905,5,1,321836,321836,321837,0,1,4
91906,5,1,321841,321841,321842,0,1,4
91907,2,3,321843,321843,321846,0,3,1
91908,1,3,321844,321846,321849,2,5,0
91909,1,2,321845,321849,321851,4,6,0
91910,5,3,321850,321851,321854,1,4,0
91911,5,2,321855,321855,321857,0,2,1
91912,6,2,321861,321861,321863,0,2,4
91913,4,2,321865,321865,321867,0,2,2
91914,3,2,321868,321868,321870,0,2,1
91915,1,1,321869,321870,321871,1,2,0
91916,2,2,321871,321871,321873,0,2,0
91917,5,2,321876,321876,321878,0,2,3
91918,3,1,321879,321879,321880,0,1,1
91919,1,3,321880,321880,321883,0,3,0
91920,4,2,321884,321884,321886,0,2,1
91921,3,2,321887,321887,321889,0,2,1
91922,3,3,321890,321890,321893,0,3,1
91923,1,3,321891,321893,321896,2,5,0
91924,3,3,321894,321896,321899,2,5,0
91925,1,3,321895,321899,321902,4,7,0
91926,6,1,321901,321902,321903,1,2,0
91927,2,1,321903,321903,321904,0,1,0
91928,6,3,321909,321909,321912,0,3,5
91929,4,1,321913,321913,321914,0,1,1
91930,2,2,321915,321915,321917,0,2,1
91931,6,2,321921,321921,321923,0,2,4
91932,5,1,321926,321926,321927,0,1,3
91933,6,1,321932,321932,321933,0,1,5
91934,3,2,321935,321935,321937,0,2,2
91935,2,3,321937,321937,321940,0,3,0
91936,2,2,321939,321940,321942,1,3,0
91937,5,2,321944,321944,321946,0,2,2
91938,4,3,321948,321948,321951,0,3,2
91939,4,2,321952,321952,321954,0,2,1
91940,1,3,321953,321954,321957,1,4,0
91941,6,2,321959,321959,321961,0,2,2
91942,2,3,321961,321961,321964,0,3,0
91943,2,1,321963,321964,321965,1,2,0
91944,2,3,321965,321965,321968,0,3,0
91945,3,3,321968,321968,321971,0,3,0
91946,3,2,321971,321971,321973,0,2,0
91947,5,3,321976,321976,321979,0,3,3
91948,1,1,321977,321979,321980,2,3,0
91949,1,3,321978,321980,321983,2,5,0
91950,1,3,321979,321983,321986,4,7,0
91951,4,3,321983,321986,321989,3,6,0
91952,1,1,321984,321989,321990,5,6,0
91953,6,1,321990,321990,321991,0,1,0
91954,3,3,321993,321993,321996,0,3,2
91955,6,1,321999,321999,322000,0,1,3
91956,5,1,322004,322004,322005,0,1,4
91957,5,1,322009,322009,322010,0,1,4
91958,4,2,322013,322013,322015,0,2,3
91959,2,1,322015,322015,322016,0,1,0
91960,3,3,322018,322018,322021,0,3,2
91961,5,1,322023,322023,322024,0,1,2
91962,5,1,322028,322028,322029,0,1,4
91963,1,3,322029,322029,322032,0,3,0
91964,6,1,322035,322035,322036,0,1,3
91965,4,3,322039,322039,322042,0,3,3
91966,5,1,322044,322044,322045,0,1,2
91967,1,1,322045,322045,322046,0,1,0
91968,4,1,322049,322049,322050,0,1,3
91969,2,1,322051,322051,322052,0,1,1
91970,6,1,322057,322057,322058,0,1,5
91971,3,2,322060,322060,322062,0,2,2
91972,6,1,322066,322066,322067,0,1,4
91973,2,2,322068,322068,322070,0,2,1
91974,3,3,322071,322071,322074,0,3,1
91975,2,2,322073,322074,322076,1,3,0
91976,4,1,322077,322077,322078,0,1,1
91977,5,1,322082,322082,322083,0,1,4
91978,2,3,322084,322084,322087,0,3,1
91979,1,3,322085,322087,322090,2,5,0
91980,2,3,322087,322090,322093,3,6,0
91981,2,1,322089,322093,322094,4,5,0
91982,5,3,322094,322094,322097,0,3,0
91983,5,1,322099,322099,322100,0,1,2
91984,3,1,322102,322102,322103,0,1,2
91985,2,3,322104,322104,322107,0,3,1
91986,4,1,322108,322108,322109,0,1,1
91987,5,2,322113,322113,322115,0,2,4
91988,5,1,322118,322118,322119,0,1,3
91989,1,2,322119,322119,322121,0,2,0
91990,1,3,322120,322121,322124,1,4,0
91991,4,2,322124,322124,322126,0,2,0
91992,3,1,322127,322127,322128,0,1,1
91993,1,3,322128,322128,322131,0,3,0
91994,4,3,322132,322132,322135,0,3,1
91995,6,1,322138,322138,322139,0,1,3
91996,1,3,322139,322139,322142,0,3,0
91997,2,1,322141,322142,322143,1,2,0
91998,6,2,322147,322147,322149,0,2,4
91999,5,3,322152,322152,322155,0,3,3
92000,3,2,322155,322155,322157,0,2,0
92001,5,2,322160,322160,322162,0,2,3
92002,5,3,322165,322165,322168,0,3,3
92003,5,2,322170,322170,322172,0,2,2
92004,1,1,322171,322172,322173,1,2,0
92005,1,3,322172,322173,322176,1,4,0
92006,3,1,322175,322176,322177,1,2,0
92007,1,2,322176,322177,322179,1,3,0
92008,3,3,322179,322179,322182,0,3,0
92009,2,2,322181,322182,322184,1,3,0
92010,1,3,322182,322184,322187,2,5,0
92011,5,2,322187,322187,322189,0,2,0
92012,6,2,322193,322193,322195,0,2,4
92013,3,2,322196,322196,322198,0,2,1
92014,6,3,322202,322202,322205,0,3,4
92015,3,1,322205,322205,322206,0,1,0
92016,3,2,322208,322208,322210,0,2,2
92017,2,1,322210,322210,322211,0,1,0
92018,3,2,322213,322213,322215,0,2,2
92019,1,1,322214,322215,322216,1,2,0
92020,1,3,322215,322216,322219,1,4,0
92021,5,2,322220,322220,322222,0,2,1
92022,1,1,322221,322222,322223,1,2,0
92023,4,2,322225,322225,322227,0,2,2
92024,6,1,322231,322231,322232,0,1,4
92025,5,2,322236,322236,322238,0,2,4
92026,1,3,322237,322238,322241,1,4,0
92027,3,1,322240,322241,322242,1,2,0
92028,5,3,322245,322245,322248,0,3,3
92029,3,2,322248,322248,322250,0,2,0
92030,2,1,322250,322250,322251,0,1,0
92031,4,2,322254,322254,322256,0,2,3
92032,6,1,322260,322260,322261,0,1,4
92033,1,1,322261,322261,322262,0,1,0
92034,5,3,322266,322266,322269,0,3,4
92035,2,2,322268,322269,322271,1,3,0
92036,1,2,322269,322271,322273,2,4,0
92037,5,1,322274,322274,322275,0,1,1
92038,6,1,322280,322280,322281,0,1,5
92039,6,2,322286,322286,322288,0,2,5
92040,1,3,322287,322288,322291,1,4,0
92041,4,3,322291,322291,322294,0,3,0
92042,5,2,322296,322296,322298,0,2,2
92043,6,3,322302,322302,322305,0,3,4
92044,6,1,322308,322308,322309,0,1,3
92045,3,2,322311,322311,322313,0,2,2
92046,2,3,322313,322313,322316,0,3,0
92047,6,2,322319,322319,322321,0,2,3
92048,1,1,322320,322321,322322,1,2,0
92049,6,1,322326,322326,322327,0,1,4
92050,3,3,322329,322329,322332,0,3,2
92051,2,2,322331,322332,322334,1,3,0
92052,4,3,322335,322335,322338,0,3,1
92053,6,1,322341,322341,322342,0,1,3
92054,4,1,322345,322345,322346,0,1,3
92055,3,2,322348,322348,322350,0,2,2
92056,5,2,322353,322353,322355,0,2,3
92057,1,1,322354,322355,322356,1,2,0
92058,6,2,322360,322360,322362,0,2,4
92059,5,3,322365,322365,322368,0,3,3
92060,3,1,322368,322368,322369,0,1,0
92061,3,2,322371,322371,322373,0,2,2
92062,3,3,322374,322374,322377,0,3,1
92063,3,1,322377,322377,322378,0,1,0
92064,6,2,322383,322383,322385,0,2,5
92065,5,1,322388,322388,322389,0,1,3
92066,4,2,322392,322392,322394,0,2,3
92067,3,3,322395,322395,322398,0,3,1
92068,1,3,322396,322398,322401,2,5,0
92069,1,3,322397,322401,322404,4,7,0
92070,1,1,322398,322404,322405,6,7,0
92071,2,3,322400,322405,322408,5,8,0
92072,4,2,322404,322408,322410,4,6,0
92073,1,2,322405,322410,322412,5,7,0
92074,3,3,322408,322412,322415,4,7,0
92075,2,1,322410,322415,322416,5,6,0
92076,2,1,322412,322416,322417,4,5,0
92077,3,3,322415,322417,322420,2,5,0
92078,5,2,322420,322420,322422,0,2,0
92079,1,1,322421,322422,322423,1,2,0
92080,6,3,322427,322427,322430,0,3,4
92081,4,3,322431,322431,322434,0,3,1
92082,2,3,322433,322434,322437,1,4,0
92083,3,1,322436,322437,322438,1,2,0
92084,3,3,322439,322439,322442,0,3,1
92085,2,2,322441,322442,322444,1,3,0
92086,3,2,322444,322444,322446,0,2,0
92087,3,1,322447,322447,322448,0,1,1
92088,1,3,322448,322448,322451,0,3,0
92089,4,3,322452,322452,322455,0,3,1
92090,1,1,322453,322455,322456,2,3,0
92091,4,2,322457,322457,322459,0,2,1
92092,4,2,322461,322461,322463,0,2,2
92093,4,2,322465,322465,322467,0,2,2
92094,2,1,322467,322467,322468,0,1,0
92095,2,3,322469,322469,322472,0,3,1
92096,2,3,322471,322472,322475,1,4,0
92097,2,2,322473,322475,322477,2,4,0
92098,3,2,322476,322477,322479,1,3,0
92099,3,2,322479,322479,322481,0,2,0
92100,2,1,322481,322481,322482,0,1,0
92101,6,3,322487,322487,322490,0,3,5
92102,6,1,322493,322493,322494,0,1,3
92103,2,2,322495,322495,322497,0,2,1
92104,4,3,322499,322499,322502,0,3,2
92105,1,1,322500,322502,322503,2,3,0
92106,6,1,322506,322506,322507,0,1,3
92107,6,3,322512,322512,322515,0,3,5
92108,5,1,322517,322517,322518,0,1,2
92109,4,3,322521,322521,322524,0,3,3
92110,1,3,322522,322524,322527,2,5,0
92111,4,1,322526,322527,322528,1,2,0
92112,5,1,322531,322531,322532,0,1,3
92113,3,2,322534,322534,322536,0,2,2
92114,1,2,322535,322536,322538,1,3,0
92115,4,1,322539,322539,322540,0,1,1
92116,5,1,322544,322544,322545,0,1,4
92117,3,3,322547,322547,322550,0,3,2
92118,5,1,322552,322552,322553,0,1,2
92119,4,1,322556,322556,322557,0,1,3
92120,6,3,322562,322562,322565,0,3,5
92121,3,3,322565,322565,322568,0,3,0
92122,5,2,322570,322570,322572,0,2,2
92123,6,2,322576,322576,322578,0,2,4
92124,1,2,322577,322578,322580,1,3,0
92125,2,1,322579,322580,322581,1,2,0
92126,3,1,322582,322582,322583,0,1,1
92127,3,1,322585,322585,322586,0,1,2
92128,3,3,322588,322588,322591,0,3,2
92129,6,1,322594,322594,322595,0,1,3
92130,2,2,322596,322596,322598,0,2,1
92131,5,3,322601,322601,322604,0,3,3
92132,5,3,322606,322606,322609,0,3,2
92133,6,1,322612,322612,322613,0,1,3
92134,5,3,322617,322617,322620,0,3,4
92135,1,2,322618,322620,322622,2,4,0
92136,2,3,322620,322622,322625,2,5,0
92137,5,3,322625,322625,322628,0,3,0
92138,4,1,322629,322629,322630,0,1,1
92139,6,3,322635,322635,322638,0,3,5
92140,4,3,322639,322639,322642,0,3,1
92141,6,1,322645,322645,322646,0,1,3
92142,6,3,322651,322651,322654,0,3,5
92143,1,1,322652,322654,322655,2,3,0
92144,5,2,322657,322657,322659,0,2,2
92145,2,3,322659,322659,322662,0,3,0
92146,6,2,322665,322665,322667,0,2,3
92147,3,3,322668,322668,322671,0,3,1
92148,6,3,322674,322674,322677,0,3,3
92149,5,2,322679,322679,322681,0,2,2
92150,5,3,322684,322684,322687,0,3,3
92151,5,1,322689,322689,322690,0,1,2
92152,4,3,322693,322693,322696,0,3,3
92153,4,3,322697,322697,322700,0,3,1
92154,2,1,322699,322700,322701,1,2,0
92155,3,2,322702,322702,322704,0,2,1
92156,4,2,322706,322706,322708,0,2,2
92157,5,2,322711,322711,322713,0,2,3
92158,4,1,322715,322715,322716,0,1,2
92159,3,2,322718,322718,322720,0,2,2
92160,5,1,322723,322723,322724,0,1,3
92161,5,1,322728,322728,322729,0,1,4
92162,1,3,322729,322729,322732,0,3,0
92163,1,3,322730,322732,322735,2,5,0
92164,2,1,322732,322735,322736,3,4,0
92165,6,1,322738,322738,322739,0,1,2
92166,1,1,322739,322739,322740,0,1,0
92167,5,3,322744,322744,322747,0,3,4
92168,5,2,322749,322749,322751,0,2,2
92169,1,3,322750,322751,322754,1,4,0
92170,2,3,322752,322754,322757,2,5,0
92171,6,3,322758,322758,322761,0,3,1
92172,2,1,322760,322761,322762,1,2,0
92173,1,1,322761,322762,322763,1,2,0
92174,5,1,322766,322766,322767,0,1,3
92175,5,3,322771,322771,322774,0,3,4
92176,5,2,322776,322776,322778,0,2,2
92177,5,2,322781,322781,322783,0,2,3
92178,1,2,322782,322783,322785,1,3,0
92179,6,3,322788,322788,322791,0,3,3
92180,6,3,322794,322794,322797,0,3,3
92181,1,2,322795,322797,322799,2,4,0
92182,2,2,322797,322799,322801,2,4,0
92183,3,3,322800,322801,322804,1,4,0
92184,5,3,322805,322805,322808,0,3,1
92185,6,2,322811,322811,322813,0,2,3
92186,2,2,322813,322813,322815,0,2,0
92187,5,2,322818,322818,322820,0,2,3
92188,3,3,322821,322821,322824,0,3,1
92189,6,3,322827,322827,322830,0,3,3
92190,2,2,322829,322830,322832,1,3,0
92191,2,2,322831,322832,322834,1,3,0
92192,5,3,322836,322836,322839,0,3,2
92193,2,1,322838,322839,322840,1,2,0
92194,6,3,322844,322844,322847,0,3,4
92195,6,1,322850,322850,322851,0,1,3
92196,3,1,322853,322853,322854,0,1,2
92197,4,1,322857,322857,322858,0,1,3
92198,5,3,322862,322862,322865,0,3,4
92199,3,3,322865,322865,322868,0,3,0
92200,2,2,322867,322868,322870,1,3,0
92201,2,1,322869,322870,322871,1,2,0
92202,1,2,322870,322871,322873,1,3,0
92203,6,3,322876,322876,322879,0,3,3
92204,3,3,322879,322879,322882,0,3,0
92205,1,1,322880,322882,322883,2,3,0
92206,1,2,322881,322883,322885,2,4,0
92207,3,2,322884,322885,322887,1,3,0
92208,2,2,322886,322887,322889,1,3,0
92209,3,2,322889,322889,322891,0,2,0
92210,5,1,322894,322894,322895,0,1,3
92211,2,2,322896,322896,322898,0,2,1
92212,4,3,322900,322900,322903,0,3,2
92213,2,2,322902,322903,322905,1,3,0
92214,4,2,322906,322906,322908,0,2,1
92215,3,3,322909,322909,322912,0,3,1
92216,5,3,322914,322914,322917,0,3,2
92217,1,3,322915,322917,322920,2,5,0
92218,2,3,322917,322920,322923,3,6,0
92219,6,1,322923,322923,322924,0,1,0
92220,6,2,322929,322929,322931,0,2,5
92221,4,1,322933,322933,322934,0,1,2
92222,6,3,322939,322939,322942,0,3,5
92223,2,1,322941,322942,322943,1,2,0
92224,2,3,322943,322943,322946,0,3,0
92225,2,3,322945,322946,322949,1,4,0
92226,2,2,322947,322949,322951,2,4,0
92227,1,1,322948,322951,322952,3,4,0
92228,3,1,322951,322952,322953,1,2,0
92229,1,2,322952,322953,322955,1,3,0
92230,1,3,322953,322955,322958,2,5,0
92231,3,2,322956,322958,322960,2,4,0
92232,5,1,322961,322961,322962,0,1,1
92233,4,1,322965,322965,322966,0,1,3
92234,3,3,322968,322968,322971,0,3,2
92235,1,1,322969,322971,322972,2,3,0
92236,1,3,322970,322972,322975,2,5,0
92237,3,3,322973,322975,322978,2,5,0
92238,6,1,322979,322979,322980,0,1,1
92239,5,1,322984,322984,322985,0,1,4
92240,1,3,322985,322985,322988,0,3,0
92241,4,2,322989,322989,322991,0,2,1
92242,3,1,322992,322992,322993,0,1,1
92243,6,2,322998,322998,323000,0,2,5
92244,4,1,323002,323002,323003,0,1,2
92245,2,3,323004,323004,323007,0,3,1
92246,1,1,323005,323007,323008,2,3,0
92247,1,3,323006,323008,323011,2,5,0
92248,4,3,323010,323011,323014,1,4,0
92249,5,2,323015,323015,323017,0,2,1
92250,1,1,323016,323017,323018,1,2,0
92251,6,3,323022,323022,323025,0,3,4
92252,2,3,323024,323025,323028,1,4,0
92253,5,1,323029,323029,323030,0,1,1
92254,3,2,323032,323032,323034,0,2,2
92255,5,2,323037,323037,323039,0,2,3
92256,5,3,323042,323042,323045,0,3,3
92257,4,2,323046,323046,323048,0,2,1
92258,5,1,323051,323051,323052,0,1,3
92259,2,1,323053,323053,323054,0,1,1
92260,6,1,323059,323059,323060,0,1,5
92261,1,2,323060,323060,323062,0,2,0
92262,6,2,323066,323066,323068,0,2,4
92263,1,1,323067,323068,323069,1,2,0
92264,3,1,323070,323070,323071,0,1,1
92265,1,1,323071,323071,323072,0,1,0
92266,1,3,323072,323072,323075,0,3,0
92267,4,2,323076,323076,323078,0,2,1
92268,1,1,323077,323078,323079,1,2,0
92269,2,1,323079,323079,323080,0,1,0
92270,2,3,323081,323081,323084,0,3,1
92271,2,1,323083,323084,323085,1,2,0
92272,2,2,323085,323085,323087,0,2,0
92273,6,2,323091,323091,323093,0,2,4
92274,3,1,323094,323094,323095,0,1,1
92275,2,3,323096,323096,323099,0,3,1
92276,3,2,323099,323099,323101,0,2,0
92277,6,1,323105,323105,323106,0,1,4
92278,1,2,323106,323106,323108,0,2,0
92279,5,1,323111,323111,323112,0,1,3
92280,6,3,323117,323117,323120,0,3,5
92281,6,1,323123,323123,323124,0,1,3
92282,2,2,323125,323125,323127,0,2,1
92283,1,3,323126,323127,323130,1,4,0
92284,6,1,323132,323132,323133,0,1,2
92285,3,3,323135,323135,323138,0,3,2
92286,6,1,323141,323141,323142,0,1,3
92287,5,1,323146,323146,323147,0,1,4
92288,6,3,323152,323152,323155,0,3,5
92289,3,2,323155,323155,323157,0,2,0
92290,5,3,323160,323160,323163,0,3,3
92291,4,1,323164,323164,323165,0,1,1
92292,4,3,323168,323168,323171,0,3,3
92293,6,2,323174,323174,323176,0,2,3
92294,3,3,323177,323177,323180,0,3,1
92295,6,2,323183,323183,323185,0,2,3
92296,4,3,323187,323187,323190,0,3,2
92297,6,2,323193,323193,323195,0,2,3
92298,4,2,323197,323197,323199,0,2,2
92299,5,2,323202,323202,323204,0,2,3
92300,2,3,323204,323204,323207,0,3,0
92301,1,1,323205,323207,323208,2,3,0
92302,6,2,323211,323211,323213,0,2,3
92303,4,3,323215,323215,323218,0,3,2
92304,6,3,323221,323221,323224,0,3,3
92305,1,3,323222,323224,323227,2,5,0
92306,5,3,323227,323227,323230,0,3,0
92307,6,2,323233,323233,323235,0,2,3
92308,1,3,323234,323235,323238,1,4,0
92309,5,2,323239,323239,323241,0,2,1
92310,1,2,323240,323241,323243,1,3,0
92311,4,3,323244,323244,323247,0,3,1
92312,2,1,323246,323247,323248,1,2,0
92313,4,1,323250,323250,323251,0,1,2
92314,5,3,323255,323255,323258,0,3,4
92315,4,2,323259,323259,323261,0,2,1
92316,4,1,323263,323263,323264,0,1,2
92317,4,2,323267,323267,323269,0,2,3
92318,2,3,323269,323269,323272,0,3,0
92319,3,3,323272,323272,323275,0,3,0
92320,5,3,323277,323277,323280,0,3,2
92321,1,3,323278,323280,323283,2,5,0
92322,6,2,323284,323284,323286,0,2,1
92323,6,3,323290,323290,323293,0,3,4
92324,2,1,323292,323293,323294,1,2,0
92325,3,3,323295,323295,323298,0,3,1
92326,2,2,323297,323298,323300,1,3,0
92327,5,1,323302,323302,323303,0,1,2
92328,6,2,323308,323308,323310,0,2,5
92329,4,2,323312,323312,323314,0,2,2
92330,2,3,323314,323314,323317,0,3,0
92331,3,3,323317,323317,323320,0,3,0
92332,2,2,323319,323320,323322,1,3,0
92333,6,3,323325,323325,323328,0,3,3
92334,4,1,323329,323329,323330,0,1,1
92335,4,3,323333,323333,323336,0,3,3
92336,6,1,323339,323339,323340,0,1,3
92337,5,2,323344,323344,323346,0,2,4
92338,6,2,323350,323350,323352,0,2,4
92339,1,2,323351,323352,323354,1,3,0
92340,6,3,323357,323357,323360,0,3,3
92341,6,3,323363,323363,323366,0,3,3
92342,5,1,323368,323368,323369,0,1,2
92343,6,3,323374,323374,323377,0,3,5
92344,1,1,323375,323377,323378,2,3,0
92345,1,3,323376,323378,323381,2,5,0
92346,6,2,323382,323382,323384,0,2,1
92347,2,1,323384,323384,323385,0,1,0
92348,5,2,323389,323389,323391,0,2,4
92349,1,2,323390,323391,323393,1,3,0
92350,2,1,323392,323393,323394,1,2,0
92351,6,1,323398,323398,323399,0,1,4
92352,1,2,323399,323399,323401,0,2,0
92353,3,3,323402,323402,323405,0,3,1
92354,6,2,323408,323408,323410,0,2,3
92355,4,1,323412,323412,323413,0,1,2
92356,5,3,323417,323417,323420,0,3,4
92357,3,3,323420,323420,323423,0,3,0
92358,5,3,323425,323425,323428,0,3,2
92359,2,2,323427,323428,323430,1,3,0
92360,1,2,323428,323430,323432,2,4,0
92361,2,3,323430,323432,323435,2,5,0
92362,6,1,323436,323436,323437,0,1,1
92363,1,3,323437,323437,323440,0,3,0
92364,6,3,323443,323443,323446,0,3,3
92365,1,1,323444,323446,323447,2,3,0
92366,5,2,323449,323449,323451,0,2,2
92367,2,1,323451,323451,323452,0,1,0
92368,1,3,323452,323452,323455,0,3,0
92369,6,3,323458,323458,323461,0,3,3
92370,6,2,323464,323464,323466,0,2,3
92371,2,1,323466,323466,323467,0,1,0
92372,6,2,323472,323472,323474,0,2,5
92373,4,3,323476,323476,323479,0,3,2
92374,3,2,323479,323479,323481,0,2,0
92375,2,1,323481,323481,323482,0,1,0
92376,2,2,323483,323483,323485,0,2,1
92377,3,3,323486,323486,323489,0,3,1
92378,3,3,323489,323489,323492,0,3,0
92379,2,1,323491,323492,323493,1,2,0
92380,3,2,323494,323494,323496,0,2,1
92381,3,2,323497,323497,323499,0,2,1
92382,1,3,323498,323499,323502,1,4,0
92383,5,1,323503,323503,323504,0,1,1
92384,2,2,323505,323505,323507,0,2,1
92385,1,1,323506,323507,323508,1,2,0
92386,1,3,323507,323508,323511,1,4,0
92387,5,2,323512,323512,323514,0,2,1
92388,4,2,323516,323516,323518,0,2,2
92389,2,3,323518,323518,323521,0,3,0
92390,3,1,323521,323521,323522,0,1,0
92391,4,1,323525,323525,323526,0,1,3
92392,6,1,323531,323531,323532,0,1,5
92393,3,2,323534,323534,323536,0,2,2
92394,1,3,323535,323536,323539,1,4,0
92395,3,2,323538,323539,323541,1,3,0
92396,6,1,323544,323544,323545,0,1,3
92397,3,2,323547,323547,323549,0,2,2
92398,3,3,323550,323550,323553,0,3,1
92399,3,3,323553,323553,323556,0,3,0
92400,5,1,323558,323558,323559,0,1,2
92401,6,1,323564,323564,323565,0,1,5
92402,2,1,323566,323566,323567,0,1,1
92403,1,3,323567,323567,323570,0,3,0
92404,2,1,323569,323570,323571,1,2,0
92405,2,1,323571,323571,323572,0,1,0
92406,1,1,323572,323572,323573,0,1,0
92407,5,3,323577,323577,323580,0,3,4
92408,2,2,323579,323580,323582,1,3,0
92409,1,3,323580,323582,323585,2,5,0
92410,4,3,323584,323585,323588,1,4,0
92411,6,2,323590,323590,323592,0,2,2
92412,5,1,323595,323595,323596,0,1,3
92413,1,1,323596,323596,323597,0,1,0
92414,1,3,323597,323597,323600,0,3,0
92415,6,3,323603,323603,323606,0,3,3
92416,5,1,323608,323608,323609,0,1,2
92417,1,1,323609,323609,323610,0,1,0
92418,5,2,323614,323614,323616,0,2,4
92419,1,2,323615,323616,323618,1,3,0
92420,6,3,323621,323621,323624,0,3,3
92421,4,1,323625,323625,323626,0,1,1
92422,5,2,323630,323630,323632,0,2,4
92423,2,2,323632,323632,323634,0,2,0
92424,6,2,323638,323638,323640,0,2,4
92425,2,1,323640,323640,323641,0,1,0
92426,4,3,323644,323644,323647,0,3,3
92427,5,2,323649,323649,323651,0,2,2
92428,3,1,323652,323652,323653,0,1,1
92429,1,3,323653,323653,323656,0,3,0
92430,1,2,323654,323656,323658,2,4,0
92431,6,2,323660,323660,323662,0,2,2
92432,5,1,323665,323665,323666,0,1,3
92433,2,3,323667,323667,323670,0,3,1
92434,4,1,323671,323671,323672,0,1,1
92435,3,2,323674,323674,323676,0,2,2
92436,6,2,323680,323680,323682,0,2,4
92437,6,2,323686,323686,323688,0,2,4
92438,6,2,323692,323692,323694,0,2,4
92439,5,1,323697,323697,323698,0,1,3
92440,5,3,323702,323702,323705,0,3,4
92441,6,3,323708,323708,323711,0,3,3
92442,2,2,323710,323711,323713,1,3,0
92443,1,3,323711,323713,323716,2,5,0
92444,1,1,323712,323716,323717,4,5,0
92445,5,2,323717,323717,323719,0,2,0
92446,4,2,323721,323721,323723,0,2,2
92447,5,2,323726,323726,323728,0,2,3
92448,6,1,323732,323732,323733,0,1,4
92449,1,2,323733,323733,323735,0,2,0
92450,1,2,323734,323735,323737,1,3,0
92451,6,3,323740,323740,323743,0,3,3
92452,5,1,323745,323745,323746,0,1,2
92453,6,2,323751,323751,323753,0,2,5
92454,6,2,323757,323757,323759,0,2,4
92455,6,2,323763,323763,323765,0,2,4
92456,5,2,323768,323768,323770,0,2,3
92457,4,3,323772,323772,323775,0,3,2
92458,2,1,323774,323775,323776,1,2,0
92459,1,2,323775,323776,323778,1,3,0
92460,6,1,323781,323781,323782,0,1,3
92461,5,2,323786,323786,323788,0,2,4
92462,6,3,323792,323792,323795,0,3,4
92463,5,2,323797,323797,323799,0,2,2
92464,3,3,323800,323800,323803,0,3,1
92465,5,1,323805,323805,323806,0,1,2
92466,4,1,323809,323809,323810,0,1,3
92467,6,1,323815,323815,323816,0,1,5
92468,6,3,323821,323821,323824,0,3,5
92469,1,1,323822,323824,323825,2,3,0
92470,4,1,323826,323826,323827,0,1,1
92471,1,3,323827,323827,323830,0,3,0
92472,1,3,323828,323830,323833,2,5,0
92473,3,1,323831,323833,323834,2,3,0
92474,3,2,323834,323834,323836,0,2,0
92475,2,2,323836,323836,323838,0,2,0
92476,4,2,323840,323840,323842,0,2,2
92477,5,1,323845,323845,323846,0,1,3
92478,2,1,323847,323847,323848,0,1,1
92479,4,3,323851,323851,323854,0,3,3
92480,5,1,323856,323856,323857,0,1,2
92481,6,2,323862,323862,323864,0,2,5
92482,6,2,323868,323868,323870,0,2,4
92483,2,2,323870,323870,323872,0,2,0
92484,5,2,323875,323875,323877,0,2,3
92485,5,1,323880,323880,323881,0,1,3
92486,2,1,323882,323882,323883,0,1,1
92487,3,3,323885,323885,323888,0,3,2
92488,4,3,323889,323889,323892,0,3,1
92489,1,2,323890,323892,323894,2,4,0
92490,2,2,323892,323894,323896,2,4,0
92491,6,3,323898,323898,323901,0,3,2
92492,5,1,323903,323903,323904,0,1,2
92493,6,2,323909,323909,323911,0,2,5
92494,4,1,323913,323913,323914,0,1,2
92495,1,3,323914,323914,323917,0,3,0
92496,6,2,323920,323920,323922,0,2,3
92497,1,2,323921,323922,323924,1,3,0
92498,4,2,323925,323925,323927,0,2,1
92499,4,2,323929,323929,323931,0,2,2
92500,3,3,323932,323932,323935,0,3,1
92501,1,1,323933,323935,323936,2,3,0
92502,1,2,323934,323936,323938,2,4,0
92503,4,1,323938,323938,323939,0,1,0
92504,5,3,323943,323943,323946,0,3,4
92505,5,2,323948,323948,323950,0,2,2
92506,6,2,323954,323954,323956,0,2,4
92507,5,3,323959,323959,323962,0,3,3
92508,1,2,323960,323962,323964,2,4,0
92509,1,2,323961,323964,323966,3,5,0
92510,1,3,323962,323966,323969,4,7,0
92511,5,2,323967,323969,323971,2,4,0
92512,4,1,323971,323971,323972,0,1,0
92513,6,3,323977,323977,323980,0,3,5
92514,6,1,323983,323983,323984,0,1,3
92515,5,1,323988,323988,323989,0,1,4
92516,4,3,323992,323992,323995,0,3,3
92517,4,2,323996,323996,323998,0,2,1
92518,3,1,323999,323999,324000,0,1,1
92519,4,3,324003,324003,324006,0,3,3
92520,6,3,324009,324009,324012,0,3,3
92521,5,3,324014,324014,324017,0,3,2
92522,4,1,324018,324018,324019,0,1,1
92523,2,1,324020,324020,324021,0,1,1
92524,4,2,324024,324024,324026,0,2,3
92525,2,2,324026,324026,324028,0,2,0
92526,3,3,324029,324029,324032,0,3,1
92527,4,3,324033,324033,324036,0,3,1
92528,5,1,324038,324038,324039,0,1,2
92529,4,3,324042,324042,324045,0,3,3
92530,6,3,324048,324048,324051,0,3,3
92531,2,3,324050,324051,324054,1,4,0
92532,1,1,324051,324054,324055,3,4,0
92533,2,2,324053,324055,324057,2,4,0
92534,4,1,324057,324057,324058,0,1,0
92535,1,3,324058,324058,324061,0,3,0
92536,5,1,324063,324063,324064,0,1,2
92537,3,2,324066,324066,324068,0,2,2
92538,3,3,324069,324069,324072,0,3,1
92539,5,2,324074,324074,324076,0,2,2
92540,1,3,324075,324076,324079,1,4,0
92541,4,1,324079,324079,324080,0,1,0
92542,5,3,324084,324084,324087,0,3,4
92543,3,3,324087,324087,324090,0,3,0
92544,5,1,324092,324092,324093,0,1,2
92545,6,3,324098,324098,324101,0,3,5
92546,6,3,324104,324104,324107,0,3,3
92547,1,3,324105,324107,324110,2,5,0
92548,5,1,324110,324110,324111,0,1,0
92549,5,1,324115,324115,324116,0,1,4
92550,3,3,324118,324118,324121,0,3,2
92551,1,2,324119,324121,324123,2,4,0
92552,3,2,324122,324123,324125,1,3,0
92553,4,3,324126,324126,324129,0,3,1
92554,6,3,324132,324132,324135,0,3,3
92555,3,3,324135,324135,324138,0,3,0
92556,5,1,324140,324140,324141,0,1,2
92557,6,1,324146,324146,324147,0,1,5
92558,6,3,324152,324152,324155,0,3,5
92559,1,2,324153,324155,324157,2,4,0
92560,5,3,324158,324158,324161,0,3,1
92561,1,1,324159,324161,324162,2,3,0
92562,3,3,324162,324162,324165,0,3,0
92563,6,1,324168,324168,324169,0,1,3
92564,5,1,324173,324173,324174,0,1,4
92565,6,3,324179,324179,324182,0,3,5
92566,2,1,324181,324182,324183,1,2,0
92567,2,2,324183,324183,324185,0,2,0
92568,4,3,324187,324187,324190,0,3,2
92569,1,2,324188,324190,324192,2,4,0
92570,5,1,324193,324193,324194,0,1,1
92571,2,2,324195,324195,324197,0,2,1
92572,4,1,324199,324199,324200,0,1,2
92573,3,3,324202,324202,324205,0,3,2
92574,1,2,324203,324205,324207,2,4,0
92575,4,3,324207,324207,324210,0,3,0
92576,2,2,324209,324210,324212,1,3,0
92577,4,3,324213,324213,324216,0,3,1
92578,4,1,324217,324217,324218,0,1,1
92579,2,3,324219,324219,324222,0,3,1
92580,1,1,324220,324222,324223,2,3,0
92581,5,1,324225,324225,324226,0,1,2
92582,4,1,324229,324229,324230,0,1,3
92583,3,3,324232,324232,324235,0,3,2
92584,4,1,324236,324236,324237,0,1,1
92585,4,1,324240,324240,324241,0,1,3
92586,2,2,324242,324242,324244,0,2,1
92587,4,3,324246,324246,324249,0,3,2
92588,5,3,324251,324251,324254,0,3,2
92589,6,1,324257,324257,324258,0,1,3
92590,6,3,324263,324263,324266,0,3,5
92591,2,1,324265,324266,324267,1,2,0
92592,3,3,324268,324268,324271,0,3,1
92593,6,3,324274,324274,324277,0,3,3
92594,5,2,324279,324279,324281,0,2,2
92595,4,3,324283,324283,324286,0,3,2
92596,5,1,324288,324288,324289,0,1,2
92597,5,1,324293,324293,324294,0,1,4
92598,2,3,324295,324295,324298,0,3,1
92599,5,1,324300,324300,324301,0,1,2
92600,5,1,324305,324305,324306,0,1,4
92601,6,1,324311,324311,324312,0,1,5
92602,3,3,324314,324314,324317,0,3,2
92603,4,1,324318,324318,324319,0,1,1
92604,4,2,324322,324322,324324,0,2,3
92605,5,2,324327,324327,324329,0,2,3
92606,3,2,324330,324330,324332,0,2,1
92607,5,1,324335,324335,324336,0,1,3
92608,1,3,324336,324336,324339,0,3,0
92609,3,1,324339,324339,324340,0,1,0
92610,4,3,324343,324343,324346,0,3,3
92611,3,3,324346,324346,324349,0,3,0
92612,4,2,324350,324350,324352,0,2,1
92613,5,1,324355,324355,324356,0,1,3
92614,6,3,324361,324361,324364,0,3,5
92615,2,3,324363,324364,324367,1,4,0
92616,5,3,324368,324368,324371,0,3,1
92617,2,3,324370,324371,324374,1,4,0
92618,4,1,324374,324374,324375,0,1,0
92619,6,1,324380,324380,324381,0,1,5
92620,4,3,324384,324384,324387,0,3,3
92621,1,1,324385,324387,324388,2,3,0
92622,1,3,324386,324388,324391,2,5,0
92623,5,2,324391,324391,324393,0,2,0
92624,3,3,324394,324394,324397,0,3,1
92625,4,2,324398,324398,324400,0,2,1
92626,5,3,324403,324403,324406,0,3,3
92627,1,2,324404,324406,324408,2,4,0
92628,6,2,324410,324410,324412,0,2,2
92629,3,3,324413,324413,324416,0,3,1
92630,6,3,324419,324419,324422,0,3,3
92631,1,1,324420,324422,324423,2,3,0
92632,1,1,324421,324423,324424,2,3,0
92633,1,1,324422,324424,324425,2,3,0
92634,3,3,324425,324425,324428,0,3,0
92635,3,2,324428,324428,324430,0,2,0
92636,1,2,324429,324430,324432,1,3,0
92637,1,2,324430,324432,324434,2,4,0
92638,6,3,324436,324436,324439,0,3,2
92639,4,1,324440,324440,324441,0,1,1
92640,4,3,324444,324444,324447,0,3,3
92641,3,2,324447,324447,324449,0,2,0
92642,2,1,324449,324449,324450,0,1,0
92643,6,2,324455,324455,324457,0,2,5
92644,4,3,324459,324459,324462,0,3,2
92645,6,3,324465,324465,324468,0,3,3
92646,2,3,324467,324468,324471,1,4,0
92647,3,2,324470,324471,324473,1,3,0
92648,1,2,324471,324473,324475,2,4,0
92649,3,3,324474,324475,324478,1,4,0
92650,5,1,324479,324479,324480,0,1,1
92651,6,2,324485,324485,324487,0,2,5
92652,2,2,324487,324487,324489,0,2,0
92653,3,1,324490,324490,324491,0,1,1
92654,5,1,324495,324495,324496,0,1,4
92655,5,1,324500,324500,324501,0,1,4
92656,3,3,324503,324503,324506,0,3,2
92657,2,3,324505,324506,324509,1,4,0
92658,4,3,324509,324509,324512,0,3,0
92659,2,2,324511,324512,324514,1,3,0
92660,6,3,324517,324517,324520,0,3,3
92661,4,3,324521,324521,324524,0,3,1
92662,3,1,324524,324524,324525,0,1,0
92663,6,1,324530,324530,324531,0,1,5
92664,6,1,324536,324536,324537,0,1,5
92665,3,1,324539,324539,324540,0,1,2
92666,3,3,324542,324542,324545,0,3,2
92667,4,3,324546,324546,324549,0,3,1
92668,6,2,324552,324552,324554,0,2,3
92669,5,1,324557,324557,324558,0,1,3
92670,1,1,324558,324558,324559,0,1,0
92671,2,1,324560,324560,324561,0,1,1
92672,4,3,324564,324564,324567,0,3,3
92673,5,3,324569,324569,324572,0,3,2
92674,1,3,324570,324572,324575,2,5,0
92675,2,2,324572,324575,324577,3,5,0
92676,3,3,324575,324577,324580,2,5,0
92677,6,1,324581,324581,324582,0,1,1
92678,6,3,324587,324587,324590,0,3,5
92679,6,1,324593,324593,324594,0,1,3
92680,5,3,324598,324598,324601,0,3,4
92681,3,3,324601,324601,324604,0,3,0
92682,4,1,324605,324605,324606,0,1,1
92683,5,2,324610,324610,324612,0,2,4
92684,5,3,324615,324615,324618,0,3,3
92685,5,1,324620,324620,324621,0,1,2
92686,3,2,324623,324623,324625,0,2,2
92687,6,2,324629,324629,324631,0,2,4
92688,2,3,324631,324631,324634,0,3,0
92689,5,2,324636,324636,324638,0,2,2
92690,4,1,324640,324640,324641,0,1,2
92691,4,2,324644,324644,324646,0,2,3
92692,4,2,324648,324648,324650,0,2,2
92693,6,3,324654,324654,324657,0,3,4
92694,3,3,324657,324657,324660,0,3,0
92695,3,1,324660,324660,324661,0,1,0
92696,1,2,324661,324661,324663,0,2,0
92697,2,1,324663,324663,324664,0,1,0
92698,5,3,324668,324668,324671,0,3,4
92699,1,2,324669,324671,324673,2,4,0
92700,4,2,324673,324673,324675,0,2,0
92701,1,2,324674,324675,324677,1,3,0
92702,1,3,324675,324677,324680,2,5,0
92703,5,1,324680,324680,324681,0,1,0
92704,4,2,324684,324684,324686,0,2,3
92705,2,1,324686,324686,324687,0,1,0
92706,2,1,324688,324688,324689,0,1,1
92707,1,1,324689,324689,324690,0,1,0
92708,2,1,324691,324691,324692,0,1,1
92709,5,2,324696,324696,324698,0,2,4
92710,5,2,324701,324701,324703,0,2,3
92711,6,1,324707,324707,324708,0,1,4
92712,4,1,324711,324711,324712,0,1,3
92713,1,2,324712,324712,324714,0,2,0
92714,6,1,324718,324718,324719,0,1,4
92715,4,1,324722,324722,324723,0,1,3
92716,3,2,324725,324725,324727,0,2,2
92717,3,3,324728,324728,324731,0,3,1
92718,5,2,324733,324733,324735,0,2,2
92719,5,1,324738,324738,324739,0,1,3
92720,6,1,324744,324744,324745,0,1,5
92721,4,2,324748,324748,324750,0,2,3
92722,3,1,324751,324751,324752,0,1,1
92723,5,2,324756,324756,324758,0,2,4
92724,4,3,324760,324760,324763,0,3,2
92725,3,3,324763,324763,324766,0,3,0
92726,3,2,324766,324766,324768,0,2,0
92727,3,3,324769,324769,324772,0,3,1
92728,5,1,324774,324774,324775,0,1,2
92729,1,2,324775,324775,324777,0,2,0
92730,6,2,324781,324781,324783,0,2,4
92731,6,1,324787,324787,324788,0,1,4
92732,3,3,324790,324790,324793,0,3,2
92733,1,2,324791,324793,324795,2,4,0
92734,2,2,324793,324795,324797,2,4,0
92735,3,1,324796,324797,324798,1,2,0
92736,6,1,324802,324802,324803,0,1,4
92737,3,1,324805,324805,324806,0,1,2
92738,5,2,324810,324810,324812,0,2,4
92739,6,1,324816,324816,324817,0,1,4
92740,6,1,324822,324822,324823,0,1,5
92741,4,1,324826,324826,324827,0,1,3
92742,5,1,324831,324831,324832,0,1,4
92743,3,2,324834,324834,324836,0,2,2
92744,1,3,324835,324836,324839,1,4,0
92745,4,2,324839,324839,324841,0,2,0
92746,1,1,324840,324841,324842,1,2,0
92747,6,2,324846,324846,324848,0,2,4
92748,5,3,324851,324851,324854,0,3,3
92749,4,3,324855,324855,324858,0,3,1
92750,3,3,324858,324858,324861,0,3,0
92751,2,3,324860,324861,324864,1,4,0
92752,4,2,324864,324864,324866,0,2,0
92753,4,3,324868,324868,324871,0,3,2
92754,2,3,324870,324871,324874,1,4,0
92755,6,3,324876,324876,324879,0,3,2
92756,1,1,324877,324879,324880,2,3,0
92757,4,2,324881,324881,324883,0,2,1
92758,5,1,324886,324886,324887,0,1,3
92759,3,3,324889,324889,324892,0,3,2
92760,4,3,324893,324893,324896,0,3,1
92761,3,3,324896,324896,324899,0,3,0
92762,1,1,324897,324899,324900,2,3,0
92763,1,2,324898,324900,324902,2,4,0
92764,5,1,324903,324903,324904,0,1,1
92765,5,2,324908,324908,324910,0,2,4
92766,4,3,324912,324912,324915,0,3,2
92767,5,2,324917,324917,324919,0,2,2
92768,6,1,324923,324923,324924,0,1,4
92769,2,2,324925,324925,324927,0,2,1
92770,3,3,324928,324928,324931,0,3,1
92771,6,2,324934,324934,324936,0,2,3
92772,4,1,324938,324938,324939,0,1,2
92773,6,1,324944,324944,324945,0,1,5
92774,5,1,324949,324949,324950,0,1,4
92775,6,3,324955,324955,324958,0,3,5
92776,5,3,324960,324960,324963,0,3,2
92777,5,1,324965,324965,324966,0,1,2
92778,6,1,324971,324971,324972,0,1,5
92779,3,2,324974,324974,324976,0,2,2
92780,1,3,324975,324976,324979,1,4,0
92781,1,3,324976,324979,324982,3,6,0
92782,1,1,324977,324982,324983,5,6,0
92783,6,3,324983,324983,324986,0,3,0
92784,6,3,324989,324989,324992,0,3,3
92785,4,1,324993,324993,324994,0,1,1
92786,4,3,324997,324997,325000,0,3,3
92787,5,3,325002,325002,325005,0,3,2
92788,1,3,325003,325005,325008,2,5,0
92789,6,1,325009,325009,325010,0,1,1
92790,5,2,325014,325014,325016,0,2,4
92791,4,3,325018,325018,325021,0,3,2
92792,5,1,325023,325023,325024,0,1,2
92793,3,1,325026,325026,325027,0,1,2
92794,3,1,325029,325029,325030,0,1,2
92795,1,1,325030,325030,325031,0,1,0
92796,3,1,325033,325033,325034,0,1,2
92797,1,2,325034,325034,325036,0,2,0
92798,6,3,325040,325040,325043,0,3,4
92799,1,3,325041,325043,325046,2,5,0
92800,6,3,325047,325047,325050,0,3,1
92801,6,3,325053,325053,325056,0,3,3
92802,2,1,325055,325056,325057,1,2,0
92803,4,2,325059,325059,325061,0,2,2
92804,6,3,325065,325065,325068,0,3,4
92805,6,1,325071,325071,325072,0,1,3
92806,1,2,325072,325072,325074,0,2,0
92807,2,2,325074,325074,325076,0,2,0
92808,3,1,325077,325077,325078,0,1,1
92809,1,1,325078,325078,325079,0,1,0
92810,6,1,325084,325084,325085,0,1,5
92811,1,2,325085,325085,325087,0,2,0
92812,2,1,325087,325087,325088,0,1,0
92813,5,2,325092,325092,325094,0,2,4
92814,5,2,325097,325097,325099,0,2,3
92815,2,3,325099,325099,325102,0,3,0
92816,2,2,325101,325102,325104,1,3,0
92817,5,1,325106,325106,325107,0,1,2
92818,4,2,325110,325110,325112,0,2,3
92819,2,3,325112,325112,325115,0,3,0
92820,4,2,325116,325116,325118,0,2,1
92821,6,1,325122,325122,325123,0,1,4
92822,4,1,325126,325126,325127,0,1,3
92823,4,2,325130,325130,325132,0,2,3
92824,2,3,325132,325132,325135,0,3,0
92825,2,1,325134,325135,325136,1,2,0
92826,5,1,325139,325139,325140,0,1,3
92827,3,2,325142,325142,325144,0,2,2
92828,2,2,325144,325144,325146,0,2,0
92829,4,1,325148,325148,325149,0,1,2
92830,6,3,325154,325154,325157,0,3,5
92831,1,1,325155,325157,325158,2,3,0
92832,4,3,325159,325159,325162,0,3,1
92833,6,2,325165,325165,325167,0,2,3
92834,2,1,325167,325167,325168,0,1,0
92835,5,1,325172,325172,325173,0,1,4
92836,4,3,325176,325176,325179,0,3,3
92837,1,3,325177,325179,325182,2,5,0
92838,1,2,325178,325182,325184,4,6,0
92839,2,3,325180,325184,325187,4,7,0
92840,2,2,325182,325187,325189,5,7,0
92841,3,3,325185,325189,325192,4,7,0
92842,4,1,325189,325192,325193,3,4,0
92843,5,3,325194,325194,325197,0,3,1
92844,6,1,325200,325200,325201,0,1,3
92845,1,1,325201,325201,325202,0,1,0
92846,2,3,325203,325203,325206,0,3,1
92847,1,2,325204,325206,325208,2,4,0
92848,5,2,325209,325209,325211,0,2,1
92849,6,2,325215,325215,325217,0,2,4
92850,2,3,325217,325217,325220,0,3,0
92851,4,1,325221,325221,325222,0,1,1
92852,3,1,325224,325224,325225,0,1,2
92853,4,3,325228,325228,325231,0,3,3
92854,6,2,325234,325234,325236,0,2,3
92855,3,1,325237,325237,325238,0,1,1
92856,3,3,325240,325240,325243,0,3,2
92857,5,1,325245,325245,325246,0,1,2
92858,2,3,325247,325247,325250,0,3,1
92859,6,2,325253,325253,325255,0,2,3
92860,3,3,325256,325256,325259,0,3,1
92861,6,3,325262,325262,325265,0,3,3
92862,4,3,325266,325266,325269,0,3,1
92863,3,3,325269,325269,325272,0,3,0
92864,2,3,325271,325272,325275,1,4,0
92865,2,2,325273,325275,325277,2,4,0
92866,6,1,325279,325279,325280,0,1,2
92867,6,3,325285,325285,325288,0,3,5
92868,4,3,325289,325289,325292,0,3,1
92869,6,1,325295,325295,325296,0,1,3
92870,4,2,325299,325299,325301,0,2,3
92871,6,1,325305,325305,325306,0,1,4
92872,4,3,325309,325309,325312,0,3,3
92873,2,3,325311,325312,325315,1,4,0
92874,5,2,325316,325316,325318,0,2,1
92875,1,3,325317,325318,325321,1,4,0
92876,1,1,325318,325321,325322,3,4,0
92877,5,1,325323,325323,325324,0,1,1
92878,3,3,325326,325326,325329,0,3,2
92879,4,3,325330,325330,325333,0,3,1
92880,2,2,325332,325333,325335,1,3,0
92881,1,1,325333,325335,325336,2,3,0
92882,4,2,325337,325337,325339,0,2,1
92883,5,2,325342,325342,325344,0,2,3
92884,4,2,325346,325346,325348,0,2,2
92885,4,3,325350,325350,325353,0,3,2
92886,1,1,325351,325353,325354,2,3,0
92887,2,2,325353,325354,325356,1,3,0
92888,3,2,325356,325356,325358,0,2,0
92889,2,2,325358,325358,325360,0,2,0
92890,5,1,325363,325363,325364,0,1,3
92891,5,3,325368,325368,325371,0,3,4
92892,4,3,325372,325372,325375,0,3,1
92893,6,1,325378,325378,325379,0,1,3
92894,6,2,325384,325384,325386,0,2,5
92895,2,2,325386,325386,325388,0,2,0
92896,4,1,325390,325390,325391,0,1,2
92897,4,3,325394,325394,325397,0,3,3
92898,5,3,325399,325399,325402,0,3,2
92899,1,3,325400,325402,325405,2,5,0
92900,4,3,325404,325405,325408,1,4,0
92901,6,1,325410,325410,325411,0,1,2
92902,3,1,325413,325413,325414,0,1,2
92903,6,2,325419,325419,325421,0,2,5
92904,6,1,325425,325425,325426,0,1,4
92905,4,2,325429,325429,325431,0,2,3
92906,4,1,325433,325433,325434,0,1,2
92907,1,3,325434,325434,325437,0,3,0
92908,1,1,325435,325437,325438,2,3,0
92909,4,2,325439,325439,325441,0,2,1
92910,2,2,325441,325441,325443,0,2,0
92911,1,3,325442,325443,325446,1,4,0
92912,5,2,325447,325447,325449,0,2,1
92913,3,3,325450,325450,325453,0,3,1
92914,4,3,325454,325454,325457,0,3,1
92915,2,3,325456,325457,325460,1,4,0
92916,4,1,325460,325460,325461,0,1,0
92917,3,1,325463,325463,325464,0,1,2
92918,4,2,325467,325467,325469,0,2,3
92919,5,2,325472,325472,325474,0,2,3
92920,1,2,325473,325474,325476,1,3,0
92921,4,2,325477,325477,325479,0,2,1
92922,5,1,325482,325482,325483,0,1,3
92923,3,1,325485,325485,325486,0,1,2
92924,5,2,325490,325490,325492,0,2,4
92925,4,3,325494,325494,325497,0,3,2
92926,1,1,325495,325497,325498,2,3,0
92927,2,1,325497,325498,325499,1,2,0
92928,3,2,325500,325500,325502,0,2,1
92929,6,2,325506,325506,325508,0,2,4
92930,5,2,325511,325511,325513,0,2,3
92931,3,3,325514,325514,325517,0,3,1
92932,2,2,325516,325517,325519,1,3,0
92933,6,2,325522,325522,325524,0,2,3
92934,1,2,325523,325524,325526,1,3,0
92935,5,3,325528,325528,325531,0,3,2
92936,6,3,325534,325534,325537,0,3,3
92937,5,1,325539,325539,325540,0,1,2
92938,2,1,325541,325541,325542,0,1,1
92939,4,2,325545,325545,325547,0,2,3
92940,1,3,325546,325547,325550,1,4,0
92941,4,2,325550,325550,325552,0,2,0
92942,2,3,325552,325552,325555,0,3,0
92943,5,2,325557,325557,325559,0,2,2
92944,4,1,325561,325561,325562,0,1,2
92945,6,3,325567,325567,325570,0,3,5
92946,3,2,325570,325570,325572,0,2,0
92947,1,1,325571,325572,325573,1,2,0
92948,1,2,325572,325573,325575,1,3,0
92949,4,3,325576,325576,325579,0,3,1
92950,3,2,325579,325579,325581,0,2,0
92951,2,3,325581,325581,325584,0,3,0
92952,6,3,325587,325587,325590,0,3,3
92953,5,1,325592,325592,325593,0,1,2
92954,1,3,325593,325593,325596,0,3,0
92955,4,2,325597,325597,325599,0,2,1
92956,5,2,325602,325602,325604,0,2,3
92957,2,3,325604,325604,325607,0,3,0
92958,1,3,325605,325607,325610,2,5,0
92959,1,2,325606,325610,325612,4,6,0
92960,1,3,325607,325612,325615,5,8,0
92961,6,3,325613,325615,325618,2,5,0
92962,4,3,325617,325618,325621,1,4,0
92963,4,3,325621,325621,325624,0,3,0
92964,3,1,325624,325624,325625,0,1,0
92965,4,1,325628,325628,325629,0,1,3
92966,4,1,325632,325632,325633,0,1,3
92967,2,3,325634,325634,325637,0,3,1
92968,1,2,325635,325637,325639,2,4,0
92969,5,3,325640,325640,325643,0,3,1
92970,1,1,325641,325643,325644,2,3,0
92971,5,1,325646,325646,325647,0,1,2
92972,3,2,325649,325649,325651,0,2,2
92973,4,1,325653,325653,325654,0,1,2
92974,2,3,325655,325655,325658,0,3,1
92975,3,3,325658,325658,325661,0,3,0
92976,4,1,325662,325662,325663,0,1,1
92977,6,3,325668,325668,325671,0,3,5
92978,6,3,325674,325674,325677,0,3,3
92979,3,1,325677,325677,325678,0,1,0
92980,5,2,325682,325682,325684,0,2,4
92981,3,3,325685,325685,325688,0,3,1
92982,6,1,325691,325691,325692,0,1,3
92983,6,2,325697,325697,325699,0,2,5
92984,4,3,325701,325701,325704,0,3,2
92985,4,3,325705,325705,325708,0,3,1
92986,1,1,325706,325708,325709,2,3,0
92987,5,2,325711,325711,325713,0,2,2
92988,6,2,325717,325717,325719,0,2,4
92989,6,2,325723,325723,325725,0,2,4
92990,1,2,325724,325725,325727,1,3,0
92991,3,3,325727,325727,325730,0,3,0
92992,5,3,325732,325732,325735,0,3,2
92993,3,2,325735,325735,325737,0,2,0
92994,1,1,325736,325737,325738,1,2,0
92995,4,1,325740,325740,325741,0,1,2
92996,5,1,325745,325745,325746,0,1,4
92997,1,3,325746,325746,325749,0,3,0
92998,4,1,325750,325750,325751,0,1,1
92999,6,3,325756,325756,325759,0,3,5
93000,4,1,325760,325760,325761,0,1,1
93001,2,1,325762,325762,325763,0,1,1
93002,4,1,325766,325766,325767,0,1,3
93003,4,2,325770,325770,325772,0,2,3
93004,3,2,325773,325773,325775,0,2,1
93005,1,2,325774,325775,325777,1,3,0
93006,6,3,325780,325780,325783,0,3,3
93007,1,2,325781,325783,325785,2,4,0
93008,6,1,325787,325787,325788,0,1,2
93009,3,3,325790,325790,325793,0,3,2
93010,4,3,325794,325794,325797,0,3,1
93011,3,3,325797,325797,325800,0,3,0
93012,5,1,325802,325802,325803,0,1,2
93013,6,1,325808,325808,325809,0,1,5
93014,5,1,325813,325813,325814,0,1,4
93015,3,1,325816,325816,325817,0,1,2
93016,6,3,325822,325822,325825,0,3,5
93017,4,1,325826,325826,325827,0,1,1
93018,5,2,325831,325831,325833,0,2,4
93019,2,2,325833,325833,325835,0,2,0
93020,1,1,325834,325835,325836,1,2,0
93021,3,2,325837,325837,325839,0,2,1
93022,1,2,325838,325839,325841,1,3,0
93023,1,3,325839,325841,325844,2,5,0
93024,3,3,325842,325844,325847,2,5,0
93025,2,3,325844,325847,325850,3,6,0
93026,1,3,325845,325850,325853,5,8,0
93027,1,1,325846,325853,325854,7,8,0
93028,3,2,325849,325854,325856,5,7,0
93029,5,3,325854,325856,325859,2,5,0
93030,5,2,325859,325859,325861,0,2,0
93031,1,3,325860,325861,325864,1,4,0
93032,1,2,325861,325864,325866,3,5,0
93033,5,2,325866,325866,325868,0,2,0
93034,2,1,325868,325868,325869,0,1,0
93035,3,3,325871,325871,325874,0,3,2
93036,2,2,325873,325874,325876,1,3,0
93037,1,1,325874,325876,325877,2,3,0
93038,1,2,325875,325877,325879,2,4,0
93039,2,3,325877,325879,325882,2,5,0
93040,4,2,325881,325882,325884,1,3,0
93041,2,1,325883,325884,325885,1,2,0
93042,6,1,325889,325889,325890,0,1,4
93043,4,2,325893,325893,325895,0,2,3
93044,6,1,325899,325899,325900,0,1,4
93045,5,1,325904,325904,325905,0,1,4
93046,6,2,325910,325910,325912,0,2,5
93047,6,3,325916,325916,325919,0,3,4
93048,2,1,325918,325919,325920,1,2,0
93049,5,3,325923,325923,325926,0,3,3
93050,5,1,325928,325928,325929,0,1,2
93051,1,1,325929,325929,325930,0,1,0
93052,6,2,325935,325935,325937,0,2,5
93053,1,1,325936,325937,325938,1,2,0
93054,3,1,325939,325939,325940,0,1,1
93055,3,2,325942,325942,325944,0,2,2
93056,3,3,325945,325945,325948,0,3,1
93057,6,3,325951,325951,325954,0,3,3
93058,2,3,325953,325954,325957,1,4,0
93059,2,2,325955,325957,325959,2,4,0
93060,5,1,325960,325960,325961,0,1,1
93061,5,3,325965,325965,325968,0,3,4
93062,3,2,325968,325968,325970,0,2,0
93063,6,2,325974,325974,325976,0,2,4
93064,2,1,325976,325976,325977,0,1,0
93065,3,2,325979,325979,325981,0,2,2
93066,6,3,325985,325985,325988,0,3,4
93067,4,1,325989,325989,325990,0,1,1
93068,4,1,325993,325993,325994,0,1,3
93069,2,2,325995,325995,325997,0,2,1
93070,3,1,325998,325998,325999,0,1,1
93071,3,2,326001,326001,326003,0,2,2
93072,5,2,326006,326006,326008,0,2,3
93073,1,2,326007,326008,326010,1,3,0
93074,5,2,326012,326012,326014,0,2,2
93075,1,1,326013,326014,326015,1,2,0
93076,2,1,326015,326015,326016,0,1,0
93077,5,2,326020,326020,326022,0,2,4
93078,2,1,326022,326022,326023,0,1,0
93079,6,1,326028,326028,326029,0,1,5
93080,6,1,326034,326034,326035,0,1,5
93081,3,2,326037,326037,326039,0,2,2
93082,3,1,326040,326040,326041,0,1,1
93083,3,1,326043,326043,326044,0,1,2
93084,1,1,326044,326044,326045,0,1,0
93085,5,2,326049,326049,326051,0,2,4
93086,5,3,326054,326054,326057,0,3,3
93087,1,1,326055,326057,326058,2,3,0
93088,6,2,326061,326061,326063,0,2,3
93089,6,1,326067,326067,326068,0,1,4
93090,2,2,326069,326069,326071,0,2,1
93091,2,1,326071,326071,326072,0,1,0
93092,2,1,326073,326073,326074,0,1,1
93093,1,1,326074,326074,326075,0,1,0
93094,6,3,326080,326080,326083,0,3,5
93095,1,3,326081,326083,326086,2,5,0
93096,1,1,326082,326086,326087,4,5,0
93097,3,1,326085,326087,326088,2,3,0
93098,1,2,326086,326088,326090,2,4,0
93099,3,1,326089,326090,326091,1,2,0
93100,3,1,326092,326092,326093,0,1,1
93101,6,3,326098,326098,326101,0,3,5
93102,4,1,326102,326102,326103,0,1,1
93103,4,1,326106,326106,326107,0,1,3
93104,3,3,326109,326109,326112,0,3,2
93105,2,2,326111,326112,326114,1,3,0
93106,1,3,326112,326114,326117,2,5,0
93107,1,3,326113,326117,326120,4,7,0
93108,4,1,326117,326120,326121,3,4,0
93109,6,1,326123,326123,326124,0,1,2
93110,2,1,326125,326125,326126,0,1,1
93111,5,3,326130,326130,326133,0,3,4
93112,2,2,326132,326133,326135,1,3,0
93113,4,2,326136,326136,326138,0,2,1
93114,4,2,326140,326140,326142,0,2,2
93115,6,2,326146,326146,326148,0,2,4
93116,1,2,326147,326148,326150,1,3,0
93117,1,1,326148,326150,326151,2,3,0
93118,5,2,326153,326153,326155,0,2,2
93119,1,2,326154,326155,326157,1,3,0
93120,4,1,326158,326158,326159,0,1,1
93121,1,2,326159,326159,326161,0,2,0
93122,1,2,326160,326161,326163,1,3,0
93123,6,3,326166,326166,326169,0,3,3
93124,2,1,326168,326169,326170,1,2,0
93125,2,2,326170,326170,326172,0,2,0
93126,6,1,326176,326176,326177,0,1,4
93127,6,3,326182,326182,326185,0,3,5
93128,2,3,326184,326185,326188,1,4,0
93129,1,3,326185,326188,326191,3,6,0
93130,3,3,326188,326191,326194,3,6,0
93131,2,3,326190,326194,326197,4,7,0
93132,3,1,326193,326197,326198,4,5,0
93133,6,1,326199,326199,326200,0,1,1
93134,4,1,326203,326203,326204,0,1,3
93135,3,1,326206,326206,326207,0,1,2
93136,2,3,326208,326208,326211,0,3,1
93137,3,1,326211,326211,326212,0,1,0
93138,1,1,326212,326212,326213,0,1,0
93139,4,2,326216,326216,326218,0,2,3
93140,2,1,326218,326218,326219,0,1,0
93141,1,2,326219,326219,326221,0,2,0
93142,5,1,326224,326224,326225,0,1,3
93143,2,3,326226,326226,326229,0,3,1
93144,3,1,326229,326229,326230,0,1,0
93145,3,2,326232,326232,326234,0,2,2
93146,3,3,326235,326235,326238,0,3,1
93147,6,2,326241,326241,326243,0,2,3
93148,5,1,326246,326246,326247,0,1,3
93149,6,1,326252,326252,326253,0,1,5
93150,1,3,326253,326253,326256,0,3,0
93151,2,2,326255,326256,326258,1,3,0
93152,4,3,326259,326259,326262,0,3,1
93153,2,2,326261,326262,326264,1,3,0
93154,1,1,326262,326264,326265,2,3,0
93155,6,1,326268,326268,326269,0,1,3
93156,1,3,326269,326269,326272,0,3,0
93157,5,3,326274,326274,326277,0,3,2
93158,2,2,326276,326277,326279,1,3,0
93159,3,2,326279,326279,326281,0,2,0
93160,4,1,326283,326283,326284,0,1,2
93161,4,3,326287,326287,326290,0,3,3
93162,5,2,326292,326292,326294,0,2,2
93163,3,3,326295,326295,326298,0,3,1
93164,2,2,326297,326298,326300,1,3,0
93165,1,1,326298,326300,326301,2,3,0
93166,6,1,326304,326304,326305,0,1,3
93167,1,2,326305,326305,326307,0,2,0
93168,6,1,326311,326311,326312,0,1,4
93169,6,3,326317,326317,326320,0,3,5
93170,6,3,326323,326323,326326,0,3,3
93171,3,1,326326,326326,326327,0,1,0
93172,4,3,326330,326330,326333,0,3,3
93173,3,3,326333,326333,326336,0,3,0
93174,4,2,326337,326337,326339,0,2,1
93175,2,1,326339,326339,326340,0,1,0
93176,2,3,326341,326341,326344,0,3,1
93177,3,2,326344,326344,326346,0,2,0
93178,4,1,326348,326348,326349,0,1,2
93179,2,3,326350,326350,326353,0,3,1
93180,2,1,326352,326353,326354,1,2,0
93181,1,2,326353,326354,326356,1,3,0
93182,4,2,326357,326357,326359,0,2,1
93183,6,2,326363,326363,326365,0,2,4
93184,5,1,326368,326368,326369,0,1,3
93185,3,3,326371,326371,326374,0,3,2
93186,2,1,326373,326374,326375,1,2,0
93187,4,2,326377,326377,326379,0,2,2
93188,2,1,326379,326379,326380,0,1,0
93189,1,1,326380,326380,326381,0,1,0
93190,2,3,326382,326382,326385,0,3,1
93191,4,1,326386,326386,326387,0,1,1
93192,3,2,326389,326389,326391,0,2,2
93193,6,3,326395,326395,326398,0,3,4
93194,6,1,326401,326401,326402,0,1,3
93195,5,2,326406,326406,326408,0,2,4
93196,2,3,326408,326408,326411,0,3,0
93197,4,2,326412,326412,326414,0,2,1
93198,4,3,326416,326416,326419,0,3,2
93199,6,2,326422,326422,326424,0,2,3
93200,3,2,326425,326425,326427,0,2,1
93201,2,2,326427,326427,326429,0,2,0
93202,5,2,326432,326432,326434,0,2,3
93203,2,3,326434,326434,326437,0,3,0
93204,4,3,326438,326438,326441,0,3,1
93205,1,3,326439,326441,326444,2,5,0
93206,2,2,326441,326444,326446,3,5,0
93207,6,3,326447,326447,326450,0,3,1
93208,6,2,326453,326453,326455,0,2,3
93209,5,1,326458,326458,326459,0,1,3
93210,3,2,326461,326461,326463,0,2,2
93211,3,2,326464,326464,326466,0,2,1
93212,6,1,326470,326470,326471,0,1,4
93213,1,3,326471,326471,326474,0,3,0
93214,2,1,326473,326474,326475,1,2,0
93215,3,1,326476,326476,326477,0,1,1
93216,6,3,326482,326482,326485,0,3,5
93217,2,2,326484,326485,326487,1,3,0
93218,5,3,326489,326489,326492,0,3,2
93219,2,2,326491,326492,326494,1,3,0
93220,6,3,326497,326497,326500,0,3,3
93221,2,3,326499,326500,326503,1,4,0
93222,2,3,326501,326503,326506,2,5,0
93223,4,3,326505,326506,326509,1,4,0
93224,1,2,326506,326509,326511,3,5,0
93225,2,1,326508,326511,326512,3,4,0
93226,2,1,326510,326512,326513,2,3,0
93227,4,2,326514,326514,326516,0,2,1
93228,6,1,326520,326520,326521,0,1,4
93229,5,3,326525,326525,326528,0,3,4
93230,2,1,326527,326528,326529,1,2,0
93231,6,1,326533,326533,326534,0,1,4
93232,6,3,326539,326539,326542,0,3,5
93233,2,3,326541,326542,326545,1,4,0
93234,6,1,326547,326547,326548,0,1,2
93235,6,2,326553,326553,326555,0,2,5
93236,4,3,326557,326557,326560,0,3,2
93237,2,2,326559,326560,326562,1,3,0
93238,1,2,326560,326562,326564,2,4,0
93239,4,1,326564,326564,326565,0,1,0
93240,5,1,326569,326569,326570,0,1,4
93241,3,2,326572,326572,326574,0,2,2
93242,2,2,326574,326574,326576,0,2,0
93243,2,2,326576,326576,326578,0,2,0
93244,5,2,326581,326581,326583,0,2,3
93245,3,2,326584,326584,326586,0,2,1
93246,6,3,326590,326590,326593,0,3,4
93247,4,3,326594,326594,326597,0,3,1
93248,4,2,326598,326598,326600,0,2,1
93249,2,2,326600,326600,326602,0,2,0
93250,3,1,326603,326603,326604,0,1,1
93251,3,1,326606,326606,326607,0,1,2
93252,3,2,326609,326609,326611,0,2,2
93253,3,2,326612,326612,326614,0,2,1
93254,1,3,326613,326614,326617,1,4,0
93255,4,3,326617,326617,326620,0,3,0
93256,2,3,326619,326620,326623,1,4,0
93257,1,2,326620,326623,326625,3,5,0
93258,4,2,326624,326625,326627,1,3,0
93259,5,3,326629,326629,326632,0,3,2
93260,3,1,326632,326632,326633,0,1,0
93261,1,3,326633,326633,326636,0,3,0
93262,2,3,326635,326636,326639,1,4,0
93263,4,3,326639,326639,326642,0,3,0
93264,2,3,326641,326642,326645,1,4,0
93265,6,1,326647,326647,326648,0,1,2
93266,2,3,326649,326649,326652,0,3,1
93267,1,1,326650,326652,326653,2,3,0
93268,6,1,326656,326656,326657,0,1,3
93269,3,1,326659,326659,326660,0,1,2
93270,3,3,326662,326662,326665,0,3,2
93271,3,1,326665,326665,326666,0,1,0
93272,6,3,326671,326671,326674,0,3,5
93273,6,3,326677,326677,326680,0,3,3
93274,2,2,326679,326680,326682,1,3,0
93275,4,1,326683,326683,326684,0,1,1
93276,6,1,326689,326689,326690,0,1,5
93277,1,3,326690,326690,326693,0,3,0
93278,5,3,326695,326695,326698,0,3,2
93279,1,3,326696,326698,326701,2,5,0
93280,5,1,326701,326701,326702,0,1,0
93281,2,2,326703,326703,326705,0,2,1
93282,1,3,326704,326705,326708,1,4,0
93283,2,2,326706,326708,326710,2,4,0
93284,2,1,326708,326710,326711,2,3,0
93285,1,2,326709,326711,326713,2,4,0
93286,1,1,326710,326713,326714,3,4,0
93287,2,3,326712,326714,326717,2,5,0
93288,3,3,326715,326717,326720,2,5,0
93289,2,3,326717,326720,326723,3,6,0
93290,2,1,326719,326723,326724,4,5,0
93291,1,2,326720,326724,326726,4,6,0
93292,2,1,326722,326726,326727,4,5,0
93293,5,1,326727,326727,326728,0,1,0
93294,5,2,326732,326732,326734,0,2,4
93295,4,3,326736,326736,326739,0,3,2
93296,4,2,326740,326740,326742,0,2,1
93297,4,3,326744,326744,326747,0,3,2
93298,5,3,326749,326749,326752,0,3,2
93299,3,2,326752,326752,326754,0,2,0
93300,4,1,326756,326756,326757,0,1,2
93301,1,1,326757,326757,326758,0,1,0
93302,2,1,326759,326759,326760,0,1,1
93303,2,1,326761,326761,326762,0,1,1
93304,2,2,326763,326763,326765,0,2,1
93305,2,2,326765,326765,326767,0,2,0
93306,2,2,326767,326767,326769,0,2,0
93307,6,1,326773,326773,326774,0,1,4
93308,3,3,326776,326776,326779,0,3,2
93309,5,2,326781,326781,326783,0,2,2
93310,2,2,326783,326783,326785,0,2,0
93311,5,1,326788,326788,326789,0,1,3
93312,6,2,326794,326794,326796,0,2,5
93313,2,3,326796,326796,326799,0,3,0
93314,1,1,326797,326799,326800,2,3,0
93315,6,3,326803,326803,326806,0,3,3
93316,6,2,326809,326809,326811,0,2,3
93317,6,2,326815,326815,326817,0,2,4
93318,6,2,326821,326821,326823,0,2,4
93319,6,1,326827,326827,326828,0,1,4
93320,2,1,326829,326829,326830,0,1,1
93321,5,3,326834,326834,326837,0,3,4
93322,2,2,326836,326837,326839,1,3,0
93323,1,2,326837,326839,326841,2,4,0
93324,1,1,326838,326841,326842,3,4,0
93325,6,1,326844,326844,326845,0,1,2
93326,1,1,326845,326845,326846,0,1,0
93327,4,3,326849,326849,326852,0,3,3
93328,2,1,326851,326852,326853,1,2,0
93329,5,3,326856,326856,326859,0,3,3
93330,1,1,326857,326859,326860,2,3,0
93331,5,3,326862,326862,326865,0,3,2
93332,4,1,326866,326866,326867,0,1,1
93333,4,1,326870,326870,326871,0,1,3
93334,5,3,326875,326875,326878,0,3,4
93335,3,2,326878,326878,326880,0,2,0
93336,1,3,326879,326880,326883,1,4,0
93337,6,2,326885,326885,326887,0,2,2
93338,1,1,326886,326887,326888,1,2,0
93339,1,2,326887,326888,326890,1,3,0
93340,4,3,326891,326891,326894,0,3,1
93341,5,3,326896,326896,326899,0,3,2
93342,6,1,326902,326902,326903,0,1,3
93343,5,1,326907,326907,326908,0,1,4
93344,2,3,326909,326909,326912,0,3,1
93345,1,2,326910,326912,326914,2,4,0
93346,5,2,326915,326915,326917,0,2,1
93347,6,2,326921,326921,326923,0,2,4
93348,6,2,326927,326927,326929,0,2,4
93349,6,1,326933,326933,326934,0,1,4
93350,4,1,326937,326937,326938,0,1,3
93351,2,1,326939,326939,326940,0,1,1
93352,4,1,326943,326943,326944,0,1,3
93353,3,1,326946,326946,326947,0,1,2
93354,4,1,326950,326950,326951,0,1,3
93355,6,3,326956,326956,326959,0,3,5
93356,4,2,326960,326960,326962,0,2,1
93357,5,2,326965,326965,326967,0,2,3
93358,3,2,326968,326968,326970,0,2,1
93359,6,1,326974,326974,326975,0,1,4
93360,1,2,326975,326975,326977,0,2,0
93361,4,1,326979,326979,326980,0,1,2
93362,3,3,326982,326982,326985,0,3,2
93363,3,3,326985,326985,326988,0,3,0
93364,6,3,326991,326991,326994,0,3,3
93365,1,3,326992,326994,326997,2,5,0
93366,1,2,326993,326997,326999,4,6,0
93367,1,3,326994,326999,327002,5,8,0
93368,4,3,326998,327002,327005,4,7,0
93369,5,2,327003,327005,327007,2,4,0
93370,3,2,327006,327007,327009,1,3,0
93371,6,2,327012,327012,327014,0,2,3
93372,3,2,327015,327015,327017,0,2,1
93373,3,3,327018,327018,327021,0,3,1
93374,2,2,327020,327021,327023,1,3,0
93375,2,1,327022,327023,327024,1,2,0
93376,1,3,327023,327024,327027,1,4,0
93377,3,2,327026,327027,327029,1,3,0
93378,1,1,327027,327029,327030,2,3,0
93379,2,3,327029,327030,327033,1,4,0
93380,4,2,327033,327033,327035,0,2,0
93381,6,2,327039,327039,327041,0,2,4
93382,3,1,327042,327042,327043,0,1,1
93383,5,1,327047,327047,327048,0,1,4
93384,4,2,327051,327051,327053,0,2,3
93385,1,3,327052,327053,327056,1,4,0
93386,4,2,327056,327056,327058,0,2,0
93387,5,2,327061,327061,327063,0,2,3
93388,4,1,327065,327065,327066,0,1,2
93389,4,3,327069,327069,327072,0,3,3
93390,6,2,327075,327075,327077,0,2,3
93391,1,3,327076,327077,327080,1,4,0
93392,4,1,327080,327080,327081,0,1,0
93393,4,2,327084,327084,327086,0,2,3
93394,1,2,327085,327086,327088,1,3,0
93395,6,2,327091,327091,327093,0,2,3
93396,2,3,327093,327093,327096,0,3,0
93397,3,1,327096,327096,327097,0,1,0
93398,1,2,327097,327097,327099,0,2,0
93399,4,1,327101,327101,327102,0,1,2
93400,4,1,327105,327105,327106,0,1,3
93401,3,2,327108,327108,327110,0,2,2
93402,3,2,327111,327111,327113,0,2,1
93403,6,2,327117,327117,327119,0,2,4
93404,5,1,327122,327122,327123,0,1,3
93405,5,1,327127,327127,327128,0,1,4
93406,6,3,327133,327133,327136,0,3,5
93407,6,2,327139,327139,327141,0,2,3
93408,4,1,327143,327143,327144,0,1,2
93409,3,3,327146,327146,327149,0,3,2
93410,6,1,327152,327152,327153,0,1,3
93411,6,1,327158,327158,327159,0,1,5
93412,3,2,327161,327161,327163,0,2,2
93413,5,3,327166,327166,327169,0,3,3
93414,6,3,327172,327172,327175,0,3,3
93415,6,1,327178,327178,327179,0,1,3
93416,1,1,327179,327179,327180,0,1,0
93417,5,1,327184,327184,327185,0,1,4
93418,3,2,327187,327187,327189,0,2,2
93419,6,2,327193,327193,327195,0,2,4
93420,6,3,327199,327199,327202,0,3,4
93421,5,3,327204,327204,327207,0,3,2
93422,5,2,327209,327209,327211,0,2,2
93423,4,2,327213,327213,327215,0,2,2
93424,1,2,327214,327215,327217,1,3,0
93425,4,2,327218,327218,327220,0,2,1
93426,6,1,327224,327224,327225,0,1,4
93427,6,3,327230,327230,327233,0,3,5
93428,3,1,327233,327233,327234,0,1,0
93429,2,3,327235,327235,327238,0,3,1
93430,3,3,327238,327238,327241,0,3,0
93431,3,2,327241,327241,327243,0,2,0
93432,6,2,327247,327247,327249,0,2,4
93433,6,3,327253,327253,327256,0,3,4
93434,6,2,327259,327259,327261,0,2,3
93435,5,3,327264,327264,327267,0,3,3
93436,4,3,327268,327268,327271,0,3,1
93437,3,1,327271,327271,327272,0,1,0
93438,1,2,327272,327272,327274,0,2,0
93439,5,3,327277,327277,327280,0,3,3
93440,3,1,327280,327280,327281,0,1,0
93441,1,2,327281,327281,327283,0,2,0
93442,1,2,327282,327283,327285,1,3,0
93443,2,2,327284,327285,327287,1,3,0
93444,3,1,327287,327287,327288,0,1,0
93445,3,2,327290,327290,327292,0,2,2
93446,6,2,327296,327296,327298,0,2,4
93447,2,1,327298,327298,327299,0,1,0
93448,3,2,327301,327301,327303,0,2,2
93449,6,2,327307,327307,327309,0,2,4
93450,1,3,327308,327309,327312,1,4,0
93451,4,2,327312,327312,327314,0,2,0
93452,4,3,327316,327316,327319,0,3,2
93453,1,3,327317,327319,327322,2,5,0
93454,4,2,327321,327322,327324,1,3,0
93455,1,3,327322,327324,327327,2,5,0
93456,5,1,327327,327327,327328,0,1,0
93457,3,2,327330,327330,327332,0,2,2
93458,5,1,327335,327335,327336,0,1,3
93459,3,1,327338,327338,327339,0,1,2
93460,4,3,327342,327342,327345,0,3,3
93461,2,3,327344,327345,327348,1,4,0
93462,3,3,327347,327348,327351,1,4,0
93463,1,1,327348,327351,327352,3,4,0
93464,2,1,327350,327352,327353,2,3,0
93465,5,1,327355,327355,327356,0,1,2
93466,4,2,327359,327359,327361,0,2,3
93467,3,2,327362,327362,327364,0,2,1
93468,6,3,327368,327368,327371,0,3,4
93469,2,2,327370,327371,327373,1,3,0
93470,1,2,327371,327373,327375,2,4,0
93471,3,2,327374,327375,327377,1,3,0
93472,2,2,327376,327377,327379,1,3,0
93473,6,2,327382,327382,327384,0,2,3
93474,5,2,327387,327387,327389,0,2,3
93475,4,1,327391,327391,327392,0,1,2
93476,1,2,327392,327392,327394,0,2,0
93477,2,1,327394,327394,327395,0,1,0
93478,6,2,327400,327400,327402,0,2,5
93479,6,2,327406,327406,327408,0,2,4
93480,5,3,327411,327411,327414,0,3,3
93481,2,2,327413,327414,327416,1,3,0
93482,6,3,327419,327419,327422,0,3,3
93483,6,2,327425,327425,327427,0,2,3
93484,1,2,327426,327427,327429,1,3,0
93485,5,2,327431,327431,327433,0,2,2
93486,4,1,327435,327435,327436,0,1,2
93487,3,3,327438,327438,327441,0,3,2
93488,3,2,327441,327441,327443,0,2,0
93489,6,2,327447,327447,327449,0,2,4
93490,6,3,327453,327453,327456,0,3,4
93491,1,2,327454,327456,327458,2,4,0
93492,6,1,327460,327460,327461,0,1,2
93493,6,1,327466,327466,327467,0,1,5
93494,5,1,327471,327471,327472,0,1,4
93495,4,1,327475,327475,327476,0,1,3
93496,6,3,327481,327481,327484,0,3,5
93497,5,2,327486,327486,327488,0,2,2
93498,6,2,327492,327492,327494,0,2,4
93499,4,3,327496,327496,327499,0,3,2
93500,5,3,327501,327501,327504,0,3,2
93501,5,3,327506,327506,327509,0,3,2
93502,1,2,327507,327509,327511,2,4,0
93503,1,3,327508,327511,327514,3,6,0
93504,4,2,327512,327514,327516,2,4,0
93505,4,2,327516,327516,327518,0,2,0
93506,6,3,327522,327522,327525,0,3,4
93507,1,2,327523,327525,327527,2,4,0
93508,6,2,327529,327529,327531,0,2,2
93509,2,1,327531,327531,327532,0,1,0
93510,5,1,327536,327536,327537,0,1,4
93511,1,3,327537,327537,327540,0,3,0
93512,5,1,327542,327542,327543,0,1,2
93513,4,1,327546,327546,327547,0,1,3
93514,1,1,327547,327547,327548,0,1,0
93515,3,3,327550,327550,327553,0,3,2
93516,1,1,327551,327553,327554,2,3,0
93517,5,1,327556,327556,327557,0,1,2
93518,5,3,327561,327561,327564,0,3,4
93519,3,1,327564,327564,327565,0,1,0
93520,2,2,327566,327566,327568,0,2,1
93521,4,3,327570,327570,327573,0,3,2
93522,3,1,327573,327573,327574,0,1,0
93523,6,3,327579,327579,327582,0,3,5
93524,4,2,327583,327583,327585,0,2,1
93525,4,1,327587,327587,327588,0,1,2
93526,3,1,327590,327590,327591,0,1,2
93527,1,2,327591,327591,327593,0,2,0
93528,3,2,327594,327594,327596,0,2,1
93529,1,1,327595,327596,327597,1,2,0
93530,3,1,327598,327598,327599,0,1,1
93531,1,3,327599,327599,327602,0,3,0
93532,6,1,327605,327605,327606,0,1,3
93533,2,2,327607,327607,327609,0,2,1
93534,1,3,327608,327609,327612,1,4,0
93535,5,3,327613,327613,327616,0,3,1
93536,4,2,327617,327617,327619,0,2,1
93537,4,2,327621,327621,327623,0,2,2
93538,5,3,327626,327626,327629,0,3,3
93539,5,1,327631,327631,327632,0,1,2
93540,1,1,327632,327632,327633,0,1,0
93541,6,2,327638,327638,327640,0,2,5
93542,3,3,327641,327641,327644,0,3,1
93543,2,2,327643,327644,327646,1,3,0
93544,2,1,327645,327646,327647,1,2,0
93545,1,1,327646,327647,327648,1,2,0
93546,5,3,327651,327651,327654,0,3,3
93547,5,3,327656,327656,327659,0,3,2
93548,5,2,327661,327661,327663,0,2,2
93549,5,3,327666,327666,327669,0,3,3
93550,6,2,327672,327672,327674,0,2,3
93551,5,3,327677,327677,327680,0,3,3
93552,2,2,327679,327680,327682,1,3,0
93553,3,1,327682,327682,327683,0,1,0
93554,6,1,327688,327688,327689,0,1,5
93555,4,3,327692,327692,327695,0,3,3
93556,4,2,327696,327696,327698,0,2,1
93557,5,2,327701,327701,327703,0,2,3
93558,4,2,327705,327705,327707,0,2,2
93559,3,1,327708,327708,327709,0,1,1
93560,1,2,327709,327709,327711,0,2,0
93561,3,1,327712,327712,327713,0,1,1
93562,6,2,327718,327718,327720,0,2,5
93563,3,3,327721,327721,327724,0,3,1
93564,6,1,327727,327727,327728,0,1,3
93565,5,3,327732,327732,327735,0,3,4
93566,6,3,327738,327738,327741,0,3,3
93567,3,3,327741,327741,327744,0,3,0
93568,5,3,327746,327746,327749,0,3,2
93569,1,2,327747,327749,327751,2,4,0
93570,5,1,327752,327752,327753,0,1,1
93571,3,3,327755,327755,327758,0,3,2
93572,2,1,327757,327758,327759,1,2,0
93573,1,2,327758,327759,327761,1,3,0
93574,3,2,327761,327761,327763,0,2,0
93575,1,1,327762,327763,327764,1,2,0
93576,5,1,327767,327767,327768,0,1,3
93577,5,2,327772,327772,327774,0,2,4
93578,6,1,327778,327778,327779,0,1,4
93579,2,2,327780,327780,327782,0,2,1
93580,3,3,327783,327783,327786,0,3,1
93581,4,3,327787,327787,327790,0,3,1
93582,4,2,327791,327791,327793,0,2,1
93583,1,2,327792,327793,327795,1,3,0
93584,4,1,327796,327796,327797,0,1,1
93585,1,1,327797,327797,327798,0,1,0
93586,1,2,327798,327798,327800,0,2,0
93587,5,1,327803,327803,327804,0,1,3
93588,5,2,327808,327808,327810,0,2,4
93589,6,2,327814,327814,327816,0,2,4
93590,4,2,327818,327818,327820,0,2,2
93591,1,2,327819,327820,327822,1,3,0
93592,1,3,327820,327822,327825,2,5,0
93593,2,3,327822,327825,327828,3,6,0
93594,4,1,327826,327828,327829,2,3,0
93595,3,3,327829,327829,327832,0,3,0
93596,5,1,327834,327834,327835,0,1,2
93597,1,2,327835,327835,327837,0,2,0
93598,6,3,327841,327841,327844,0,3,4
93599,6,2,327847,327847,327849,0,2,3
93600,1,2,327848,327849,327851,1,3,0
93601,3,3,327851,327851,327854,0,3,0
93602,5,3,327856,327856,327859,0,3,2
93603,4,3,327860,327860,327863,0,3,1
93604,6,2,327866,327866,327868,0,2,3
93605,4,1,327870,327870,327871,0,1,2
93606,4,3,327874,327874,327877,0,3,3
93607,2,2,327876,327877,327879,1,3,0
93608,6,2,327882,327882,327884,0,2,3
93609,6,2,327888,327888,327890,0,2,4
93610,3,2,327891,327891,327893,0,2,1
93611,5,3,327896,327896,327899,0,3,3
93612,3,2,327899,327899,327901,0,2,0
93613,3,3,327902,327902,327905,0,3,1
93614,5,1,327907,327907,327908,0,1,2
93615,4,1,327911,327911,327912,0,1,3
93616,1,3,327912,327912,327915,0,3,0
93617,5,2,327917,327917,327919,0,2,2
93618,2,3,327919,327919,327922,0,3,0
93619,2,3,327921,327922,327925,1,4,0
93620,4,1,327925,327925,327926,0,1,0
93621,6,2,327931,327931,327933,0,2,5
93622,6,1,327937,327937,327938,0,1,4
93623,4,2,327941,327941,327943,0,2,3
93624,4,2,327945,327945,327947,0,2,2
93625,6,1,327951,327951,327952,0,1,4
93626,1,1,327952,327952,327953,0,1,0
93627,5,3,327957,327957,327960,0,3,4
93628,2,3,327959,327960,327963,1,4,0
93629,4,3,327963,327963,327966,0,3,0
93630,1,2,327964,327966,327968,2,4,0
93631,4,1,327968,327968,327969,0,1,0
93632,3,2,327971,327971,327973,0,2,2
93633,2,3,327973,327973,327976,0,3,0
93634,5,2,327978,327978,327980,0,2,2
93635,3,3,327981,327981,327984,0,3,1
93636,3,2,327984,327984,327986,0,2,0
93637,4,3,327988,327988,327991,0,3,2
93638,6,3,327994,327994,327997,0,3,3
93639,1,1,327995,327997,327998,2,3,0
93640,2,3,327997,327998,328001,1,4,0
93641,6,2,328003,328003,328005,0,2,2
93642,1,1,328004,328005,328006,1,2,0
93643,4,2,328008,328008,328010,0,2,2
93644,5,1,328013,328013,328014,0,1,3
93645,1,1,328014,328014,328015,0,1,0
93646,3,3,328017,328017,328020,0,3,2
93647,2,2,328019,328020,328022,1,3,0
93648,6,2,328025,328025,328027,0,2,3
93649,2,3,328027,328027,328030,0,3,0
93650,3,3,328030,328030,328033,0,3,0
93651,2,3,328032,328033,328036,1,4,0
93652,6,2,328038,328038,328040,0,2,2
93653,5,3,328043,328043,328046,0,3,3
93654,3,1,328046,328046,328047,0,1,0
93655,3,3,328049,328049,328052,0,3,2
93656,2,3,328051,328052,328055,1,4,0
93657,2,2,328053,328055,328057,2,4,0
93658,2,1,328055,328057,328058,2,3,0
93659,5,2,328060,328060,328062,0,2,2
93660,5,2,328065,328065,328067,0,2,3
93661,2,1,328067,328067,328068,0,1,0
93662,1,2,328068,328068,328070,0,2,0
93663,1,1,328069,328070,328071,1,2,0
93664,3,1,328072,328072,328073,0,1,1
93665,1,3,328073,328073,328076,0,3,0
93666,1,1,328074,328076,328077,2,3,0
93667,4,2,328078,328078,328080,0,2,1
93668,1,3,328079,328080,328083,1,4,0
93669,4,1,328083,328083,328084,0,1,0
93670,3,3,328086,328086,328089,0,3,2
93671,1,3,328087,328089,328092,2,5,0
93672,6,3,328093,328093,328096,0,3,1
93673,1,3,328094,328096,328099,2,5,0
93674,6,3,328100,328100,328103,0,3,1
93675,3,3,328103,328103,328106,0,3,0
93676,5,3,328108,328108,328111,0,3,2
93677,1,2,328109,328111,328113,2,4,0
93678,1,1,328110,328113,328114,3,4,0
93679,5,2,328115,328115,328117,0,2,1
93680,5,2,328120,328120,328122,0,2,3
93681,4,1,328124,328124,328125,0,1,2
93682,6,3,328130,328130,328133,0,3,5
93683,4,1,328134,328134,328135,0,1,1
93684,3,3,328137,328137,328140,0,3,2
93685,2,2,328139,328140,328142,1,3,0
93686,2,1,328141,328142,328143,1,2,0
93687,6,2,328147,328147,328149,0,2,4
93688,5,2,328152,328152,328154,0,2,3
93689,4,3,328156,328156,328159,0,3,2
93690,2,3,328158,328159,328162,1,4,0
93691,4,3,328162,328162,328165,0,3,0
93692,5,3,328167,328167,328170,0,3,2
93693,3,1,328170,328170,328171,0,1,0
93694,4,2,328174,328174,328176,0,2,3
93695,2,2,328176,328176,328178,0,2,0
93696,4,3,328180,328180,328183,0,3,2
93697,1,2,328181,328183,328185,2,4,0
93698,6,1,328187,328187,328188,0,1,2
93699,2,1,328189,328189,328190,0,1,1
93700,1,3,328190,328190,328193,0,3,0
93701,3,1,328193,328193,328194,0,1,0
93702,6,1,328199,328199,328200,0,1,5
93703,6,3,328205,328205,328208,0,3,5
93704,1,2,328206,328208,328210,2,4,0
93705,4,1,328210,328210,328211,0,1,0
93706,6,1,328216,328216,328217,0,1,5
93707,5,1,328221,328221,328222,0,1,4
93708,6,1,328227,328227,328228,0,1,5
93709,2,1,328229,328229,328230,0,1,1
93710,4,3,328233,328233,328236,0,3,3
93711,1,1,328234,328236,328237,2,3,0
93712,2,2,328236,328237,328239,1,3,0
93713,1,2,328237,328239,328241,2,4,0
93714,6,3,328243,328243,328246,0,3,2
93715,2,3,328245,328246,328249,1,4,0
93716,1,3,328246,328249,328252,3,6,0
93717,5,3,328251,328252,328255,1,4,0
93718,1,2,328252,328255,328257,3,5,0
93719,1,2,328253,328257,328259,4,6,0
93720,2,3,328255,328259,328262,4,7,0
93721,5,2,328260,328262,328264,2,4,0
93722,6,1,328266,328266,328267,0,1,2
93723,3,3,328269,328269,328272,0,3,2
93724,5,2,328274,328274,328276,0,2,2
93725,2,1,328276,328276,328277,0,1,0
93726,1,3,328277,328277,328280,0,3,0
93727,1,1,328278,328280,328281,2,3,0
93728,3,3,328281,328281,328284,0,3,0
93729,5,1,328286,328286,328287,0,1,2
93730,6,3,328292,328292,328295,0,3,5
93731,2,3,328294,328295,328298,1,4,0
93732,4,1,328298,328298,328299,0,1,0
93733,5,1,328303,328303,328304,0,1,4
93734,2,3,328305,328305,328308,0,3,1
93735,1,2,328306,328308,328310,2,4,0
93736,1,2,328307,328310,328312,3,5,0
93737,5,3,328312,328312,328315,0,3,0
93738,4,2,328316,328316,328318,0,2,1
93739,5,2,328321,328321,328323,0,2,3
93740,3,2,328324,328324,328326,0,2,1
93741,3,1,328327,328327,328328,0,1,1
93742,6,2,328333,328333,328335,0,2,5
93743,3,3,328336,328336,328339,0,3,1
93744,6,1,328342,328342,328343,0,1,3
93745,5,1,328347,328347,328348,0,1,4
93746,6,1,328353,328353,328354,0,1,5
93747,6,2,328359,328359,328361,0,2,5
93748,1,2,328360,328361,328363,1,3,0
93749,3,2,328363,328363,328365,0,2,0
93750,5,1,328368,328368,328369,0,1,3
93751,2,2,328370,328370,328372,0,2,1
93752,6,2,328376,328376,328378,0,2,4
93753,1,2,328377,328378,328380,1,3,0
93754,5,3,328382,328382,328385,0,3,2
93755,1,2,328383,328385,328387,2,4,0
93756,6,3,328389,328389,328392,0,3,2
93757,5,1,328394,328394,328395,0,1,2
93758,2,3,328396,328396,328399,0,3,1
93759,5,1,328401,328401,328402,0,1,2
93760,6,1,328407,328407,328408,0,1,5
93761,4,3,328411,328411,328414,0,3,3
93762,6,3,328417,328417,328420,0,3,3
93763,3,1,328420,328420,328421,0,1,0
93764,2,3,328422,328422,328425,0,3,1
93765,4,3,328426,328426,328429,0,3,1
93766,3,2,328429,328429,328431,0,2,0
93767,5,3,328434,328434,328437,0,3,3
93768,4,1,328438,328438,328439,0,1,1
93769,6,1,328444,328444,328445,0,1,5
93770,2,1,328446,328446,328447,0,1,1
93771,2,1,328448,328448,328449,0,1,1
93772,5,1,328453,328453,328454,0,1,4
93773,5,3,328458,328458,328461,0,3,4
93774,6,2,328464,328464,328466,0,2,3
93775,2,2,328466,328466,328468,0,2,0
93776,4,3,328470,328470,328473,0,3,2
93777,4,2,328474,328474,328476,0,2,1
93778,3,2,328477,328477,328479,0,2,1
93779,2,3,328479,328479,328482,0,3,0
93780,3,3,328482,328482,328485,0,3,0
93781,2,1,328484,328485,328486,1,2,0
93782,2,1,328486,328486,328487,0,1,0
93783,4,3,328490,328490,328493,0,3,3
93784,2,3,328492,328493,328496,1,4,0
93785,5,1,328497,328497,328498,0,1,1
93786,6,2,328503,328503,328505,0,2,5
93787,1,2,328504,328505,328507,1,3,0
93788,5,3,328509,328509,328512,0,3,2
93789,5,1,328514,328514,328515,0,1,2
93790,5,1,328519,328519,328520,0,1,4
93791,4,1,328523,328523,328524,0,1,3
93792,2,2,328525,328525,328527,0,2,1
93793,3,1,328528,328528,328529,0,1,1
93794,3,3,328531,328531,328534,0,3,2
93795,5,2,328536,328536,328538,0,2,2
93796,1,1,328537,328538,328539,1,2,0
93797,3,2,328540,328540,328542,0,2,1
93798,3,1,328543,328543,328544,0,1,1
93799,3,1,328546,328546,328547,0,1,2
93800,1,1,328547,328547,328548,0,1,0
93801,1,2,328548,328548,328550,0,2,0
93802,6,3,328554,328554,328557,0,3,4
93803,4,2,328558,328558,328560,0,2,1
93804,2,1,328560,328560,328561,0,1,0
93805,6,3,328566,328566,328569,0,3,5
93806,4,3,328570,328570,328573,0,3,1
93807,3,3,328573,328573,328576,0,3,0
93808,3,1,328576,328576,328577,0,1,0
93809,4,3,328580,328580,328583,0,3,3
93810,4,3,328584,328584,328587,0,3,1
93811,3,2,328587,328587,328589,0,2,0
93812,1,2,328588,328589,328591,1,3,0
93813,6,1,328594,328594,328595,0,1,3
93814,2,2,328596,328596,328598,0,2,1
93815,5,2,328601,328601,328603,0,2,3
93816,2,2,328603,328603,328605,0,2,0
93817,6,3,328609,328609,328612,0,3,4
93818,5,1,328614,328614,328615,0,1,2
93819,6,3,328620,328620,328623,0,3,5
93820,1,2,328621,328623,328625,2,4,0
93821,2,3,328623,328625,328628,2,5,0
93822,2,2,328625,328628,328630,3,5,0
93823,5,2,328630,328630,328632,0,2,0
93824,6,2,328636,328636,328638,0,2,4
93825,5,1,328641,328641,328642,0,1,3
93826,6,1,328647,328647,328648,0,1,5
93827,1,2,328648,328648,328650,0,2,0
93828,2,1,328650,328650,328651,0,1,0
93829,2,2,328652,328652,328654,0,2,1
93830,3,3,328655,328655,328658,0,3,1
93831,4,1,328659,328659,328660,0,1,1
93832,6,1,328665,328665,328666,0,1,5
93833,3,2,328668,328668,328670,0,2,2
93834,2,2,328670,328670,328672,0,2,0
93835,6,1,328676,328676,328677,0,1,4
93836,4,1,328680,328680,328681,0,1,3
93837,5,2,328685,328685,328687,0,2,4
93838,3,3,328688,328688,328691,0,3,1
93839,4,1,328692,328692,328693,0,1,1
93840,4,3,328696,328696,328699,0,3,3
93841,6,1,328702,328702,328703,0,1,3
93842,5,2,328707,328707,328709,0,2,4
93843,1,2,328708,328709,328711,1,3,0
93844,1,1,328709,328711,328712,2,3,0
93845,4,3,328713,328713,328716,0,3,1
93846,3,1,328716,328716,328717,0,1,0
93847,5,3,328721,328721,328724,0,3,4
93848,6,1,328727,328727,328728,0,1,3
93849,2,2,328729,328729,328731,0,2,1
93850,2,1,328731,328731,328732,0,1,0
93851,1,1,328732,328732,328733,0,1,0
93852,6,2,328738,328738,328740,0,2,5
93853,5,3,328743,328743,328746,0,3,3
93854,6,1,328749,328749,328750,0,1,3
93855,4,2,328753,328753,328755,0,2,3
93856,4,2,328757,328757,328759,0,2,2
93857,5,1,328762,328762,328763,0,1,3
93858,3,2,328765,328765,328767,0,2,2
93859,5,1,328770,328770,328771,0,1,3
93860,3,3,328773,328773,328776,0,3,2
93861,3,3,328776,328776,328779,0,3,0
93862,5,3,328781,328781,328784,0,3,2
93863,3,1,328784,328784,328785,0,1,0
93864,6,2,328790,328790,328792,0,2,5
93865,5,2,328795,328795,328797,0,2,3
93866,2,3,328797,328797,328800,0,3,0
93867,3,3,328800,328800,328803,0,3,0
93868,2,2,328802,328803,328805,1,3,0
93869,1,3,328803,328805,328808,2,5,0
93870,5,2,328808,328808,328810,0,2,0
93871,6,2,328814,328814,328816,0,2,4
93872,2,3,328816,328816,328819,0,3,0
93873,3,1,328819,328819,328820,0,1,0
93874,6,2,328825,328825,328827,0,2,5
93875,6,3,328831,328831,328834,0,3,4
93876,2,2,328833,328834,328836,1,3,0
93877,6,1,328839,328839,328840,0,1,3
93878,1,2,328840,328840,328842,0,2,0
93879,5,3,328845,328845,328848,0,3,3
93880,2,1,328847,328848,328849,1,2,0
93881,4,2,328851,328851,328853,0,2,2
93882,1,3,328852,328853,328856,1,4,0
93883,3,1,328855,328856,328857,1,2,0
93884,1,3,328856,328857,328860,1,4,0
93885,3,2,328859,328860,328862,1,3,0
93886,2,2,328861,328862,328864,1,3,0
93887,3,2,328864,328864,328866,0,2,0
93888,5,3,328869,328869,328872,0,3,3
93889,2,3,328871,328872,328875,1,4,0
93890,5,2,328876,328876,328878,0,2,1
93891,1,1,328877,328878,328879,1,2,0
93892,3,2,328880,328880,328882,0,2,1
93893,5,1,328885,328885,328886,0,1,3
93894,2,3,328887,328887,328890,0,3,1
93895,3,3,328890,328890,328893,0,3,0
93896,1,2,328891,328893,328895,2,4,0
93897,4,1,328895,328895,328896,0,1,0
93898,1,2,328896,328896,328898,0,2,0
93899,3,2,328899,328899,328901,0,2,1
93900,6,2,328905,328905,328907,0,2,4
93901,3,1,328908,328908,328909,0,1,1
93902,6,1,328914,328914,328915,0,1,5
93903,4,3,328918,328918,328921,0,3,3
93904,3,3,328921,328921,328924,0,3,0
93905,4,3,328925,328925,328928,0,3,1
93906,6,1,328931,328931,328932,0,1,3
93907,2,1,328933,328933,328934,0,1,1
93908,4,1,328937,328937,328938,0,1,3
93909,6,1,328943,328943,328944,0,1,5
93910,3,3,328946,328946,328949,0,3,2
93911,4,2,328950,328950,328952,0,2,1
93912,2,3,328952,328952,328955,0,3,0
93913,2,1,328954,328955,328956,1,2,0
93914,6,2,328960,328960,328962,0,2,4
93915,5,1,328965,328965,328966,0,1,3
93916,2,2,328967,328967,328969,0,2,1
93917,6,2,328973,328973,328975,0,2,4
93918,1,3,328974,328975,328978,1,4,0
93919,5,1,328979,328979,328980,0,1,1
93920,6,1,328985,328985,328986,0,1,5
93921,2,1,328987,328987,328988,0,1,1
93922,2,3,328989,328989,328992,0,3,1
93923,1,3,328990,328992,328995,2,5,0
93924,5,1,328995,328995,328996,0,1,0
93925,5,3,329000,329000,329003,0,3,4
93926,1,2,329001,329003,329005,2,4,0
93927,5,2,329006,329006,329008,0,2,1
93928,2,1,329008,329008,329009,0,1,0
93929,5,2,329013,329013,329015,0,2,4
93930,2,2,329015,329015,329017,0,2,0
93931,1,2,329016,329017,329019,1,3,0
93932,1,1,329017,329019,329020,2,3,0
93933,6,2,329023,329023,329025,0,2,3
93934,3,3,329026,329026,329029,0,3,1
93935,6,3,329032,329032,329035,0,3,3
93936,1,2,329033,329035,329037,2,4,0
93937,1,2,329034,329037,329039,3,5,0
93938,4,1,329038,329039,329040,1,2,0
93939,4,2,329042,329042,329044,0,2,2
93940,3,1,329045,329045,329046,0,1,1
93941,2,2,329047,329047,329049,0,2,1
93942,6,1,329053,329053,329054,0,1,4
93943,1,2,329054,329054,329056,0,2,0
93944,6,1,329060,329060,329061,0,1,4
93945,4,3,329064,329064,329067,0,3,3
93946,5,1,329069,329069,329070,0,1,2
93947,2,1,329071,329071,329072,0,1,1
93948,2,3,329073,329073,329076,0,3,1
93949,3,3,329076,329076,329079,0,3,0
93950,4,2,329080,329080,329082,0,2,1
93951,1,1,329081,329082,329083,1,2,0
93952,3,3,329084,329084,329087,0,3,1
93953,2,1,329086,329087,329088,1,2,0
93954,2,1,329088,329088,329089,0,1,0
93955,4,2,329092,329092,329094,0,2,3
93956,2,1,329094,329094,329095,0,1,0
93957,3,1,329097,329097,329098,0,1,2
93958,5,2,329102,329102,329104,0,2,4
93959,5,2,329107,329107,329109,0,2,3
93960,3,3,329110,329110,329113,0,3,1
93961,2,3,329112,329113,329116,1,4,0
93962,6,3,329118,329118,329121,0,3,2
93963,2,2,329120,329121,329123,1,3,0
93964,5,3,329125,329125,329128,0,3,2
93965,4,3,329129,329129,329132,0,3,1
93966,4,2,329133,329133,329135,0,2,1
93967,2,1,329135,329135,329136,0,1,0
93968,1,3,329136,329136,329139,0,3,0
93969,6,3,329142,329142,329145,0,3,3
93970,6,1,329148,329148,329149,0,1,3
93971,5,1,329153,329153,329154,0,1,4
93972,3,2,329156,329156,329158,0,2,2
93973,2,2,329158,329158,329160,0,2,0
93974,5,1,329163,329163,329164,0,1,3
93975,6,2,329169,329169,329171,0,2,5
93976,3,3,329172,329172,329175,0,3,1
93977,4,1,329176,329176,329177,0,1,1
93978,6,2,329182,329182,329184,0,2,5
93979,3,3,329185,329185,329188,0,3,1
93980,4,1,329189,329189,329190,0,1,1
93981,6,1,329195,329195,329196,0,1,5
93982,2,1,329197,329197,329198,0,1,1
93983,2,1,329199,329199,329200,0,1,1
93984,6,2,329205,329205,329207,0,2,5
93985,1,3,329206,329207,329210,1,4,0
93986,3,2,329209,329210,329212,1,3,0
93987,6,2,329215,329215,329217,0,2,3
93988,2,2,329217,329217,329219,0,2,0
93989,6,3,329223,329223,329226,0,3,4
93990,3,3,329226,329226,329229,0,3,0
93991,4,3,329230,329230,329233,0,3,1
93992,3,2,329233,329233,329235,0,2,0
93993,1,2,329234,329235,329237,1,3,0
93994,4,1,329238,329238,329239,0,1,1
93995,5,3,329243,329243,329246,0,3,4
93996,3,3,329246,329246,329249,0,3,0
93997,3,1,329249,329249,329250,0,1,0
93998,6,3,329255,329255,329258,0,3,5
93999,1,3,329256,329258,329261,2,5,0
94000,3,1,329259,329261,329262,2,3,0
94001,1,2,329260,329262,329264,2,4,0
94002,5,1,329265,329265,329266,0,1,1
94003,6,2,329271,329271,329273,0,2,5
94004,4,3,329275,329275,329278,0,3,2
94005,4,2,329279,329279,329281,0,2,1
94006,4,1,329283,329283,329284,0,1,2
94007,2,3,329285,329285,329288,0,3,1
94008,4,1,329289,329289,329290,0,1,1
94009,2,3,329291,329291,329294,0,3,1
94010,4,3,329295,329295,329298,0,3,1
94011,4,2,329299,329299,329301,0,2,1
94012,3,3,329302,329302,329305,0,3,1
94013,1,3,329303,329305,329308,2,5,0
94014,2,3,329305,329308,329311,3,6,0
94015,3,3,329308,329311,329314,3,6,0
94016,1,2,329309,329314,329316,5,7,0
94017,4,3,329313,329316,329319,3,6,0
94018,5,2,329318,329319,329321,1,3,0
94019,5,1,329323,329323,329324,0,1,2
94020,6,1,329329,329329,329330,0,1,5
94021,6,1,329335,329335,329336,0,1,5
94022,1,2,329336,329336,329338,0,2,0
94023,5,1,329341,329341,329342,0,1,3
94024,6,3,329347,329347,329350,0,3,5
94025,3,3,329350,329350,329353,0,3,0
94026,1,1,329351,329353,329354,2,3,0
94027,2,3,329353,329354,329357,1,4,0
94028,5,2,329358,329358,329360,0,2,1
94029,2,2,329360,329360,329362,0,2,0
94030,5,2,329365,329365,329367,0,2,3
94031,4,2,329369,329369,329371,0,2,2
94032,2,3,329371,329371,329374,0,3,0
94033,3,3,329374,329374,329377,0,3,0
94034,5,1,329379,329379,329380,0,1,2
94035,6,2,329385,329385,329387,0,2,5
94036,6,3,329391,329391,329394,0,3,4
94037,2,3,329393,329394,329397,1,4,0
94038,4,1,329397,329397,329398,0,1,0
94039,3,1,329400,329400,329401,0,1,2
94040,6,2,329406,329406,329408,0,2,5
94041,4,1,329410,329410,329411,0,1,2
94042,4,2,329414,329414,329416,0,2,3
94043,2,3,329416,329416,329419,0,3,0
94044,2,3,329418,329419,329422,1,4,0
94045,4,1,329422,329422,329423,0,1,0
94046,4,1,329426,329426,329427,0,1,3
94047,5,1,329431,329431,329432,0,1,4
94048,1,3,329432,329432,329435,0,3,0
94049,2,2,329434,329435,329437,1,3,0
94050,1,1,329435,329437,329438,2,3,0
94051,3,2,329438,329438,329440,0,2,0
94052,1,1,329439,329440,329441,1,2,0
94053,5,1,329444,329444,329445,0,1,3
94054,1,3,329445,329445,329448,0,3,0
94055,3,2,329448,329448,329450,0,2,0
94056,6,3,329454,329454,329457,0,3,4
94057,4,3,329458,329458,329461,0,3,1
94058,2,1,329460,329461,329462,1,2,0
94059,2,2,329462,329462,329464,0,2,0
94060,2,1,329464,329464,329465,0,1,0
94061,2,2,329466,329466,329468,0,2,1
94062,5,3,329471,329471,329474,0,3,3
94063,3,1,329474,329474,329475,0,1,0
94064,5,2,329479,329479,329481,0,2,4
94065,3,3,329482,329482,329485,0,3,1
94066,1,3,329483,329485,329488,2,5,0
94067,1,3,329484,329488,329491,4,7,0
94068,4,2,329488,329491,329493,3,5,0
94069,6,1,329494,329494,329495,0,1,1
94070,6,1,329500,329500,329501,0,1,5
94071,2,1,329502,329502,329503,0,1,1
94072,6,3,329508,329508,329511,0,3,5
94073,3,1,329511,329511,329512,0,1,0
94074,3,2,329514,329514,329516,0,2,2
94075,4,2,329518,329518,329520,0,2,2
94076,2,3,329520,329520,329523,0,3,0
94077,4,3,329524,329524,329527,0,3,1
94078,3,2,329527,329527,329529,0,2,0
94079,4,3,329531,329531,329534,0,3,2
94080,6,1,329537,329537,329538,0,1,3
94081,2,2,329539,329539,329541,0,2,1
94082,3,3,329542,329542,329545,0,3,1
94083,6,1,329548,329548,329549,0,1,3
94084,5,1,329553,329553,329554,0,1,4
94085,3,3,329556,329556,329559,0,3,2
94086,4,1,329560,329560,329561,0,1,1
94087,3,1,329563,329563,329564,0,1,2
94088,1,1,329564,329564,329565,0,1,0
94089,3,3,329567,329567,329570,0,3,2
94090,5,3,329572,329572,329575,0,3,2
94091,3,2,329575,329575,329577,0,2,0
94092,1,2,329576,329577,329579,1,3,0
94093,5,2,329581,329581,329583,0,2,2
94094,4,3,329585,329585,329588,0,3,2
94095,2,3,329587,329588,329591,1,4,0
94096,6,1,329593,329593,329594,0,1,2
94097,4,3,329597,329597,329600,0,3,3
94098,3,2,329600,329600,329602,0,2,0
94099,6,1,329606,329606,329607,0,1,4
94100,4,3,329610,329610,329613,0,3,3
94101,3,3,329613,329613,329616,0,3,0
94102,5,3,329618,329618,329621,0,3,2
94103,4,3,329622,329622,329625,0,3,1
94104,6,3,329628,329628,329631,0,3,3
94105,2,3,329630,329631,329634,1,4,0
94106,4,2,329634,329634,329636,0,2,0
94107,4,1,329638,329638,329639,0,1,2
94108,1,2,329639,329639,329641,0,2,0
94109,5,3,329644,329644,329647,0,3,3
94110,3,1,329647,329647,329648,0,1,0
94111,4,1,329651,329651,329652,0,1,3
94112,1,3,329652,329652,329655,0,3,0
94113,3,2,329655,329655,329657,0,2,0
94114,6,1,329661,329661,329662,0,1,4
94115,4,2,329665,329665,329667,0,2,3
94116,1,1,329666,329667,329668,1,2,0
94117,4,1,329670,329670,329671,0,1,2
94118,5,2,329675,329675,329677,0,2,4
94119,2,2,329677,329677,329679,0,2,0
94120,1,2,329678,329679,329681,1,3,0
94121,5,2,329683,329683,329685,0,2,2
94122,6,1,329689,329689,329690,0,1,4
94123,3,1,329692,329692,329693,0,1,2
94124,1,2,329693,329693,329695,0,2,0
94125,1,2,329694,329695,329697,1,3,0
94126,3,1,329697,329697,329698,0,1,0
94127,5,1,329702,329702,329703,0,1,4
94128,1,1,329703,329703,329704,0,1,0
94129,6,3,329709,329709,329712,0,3,5
94130,1,1,329710,329712,329713,2,3,0
94131,3,3,329713,329713,329716,0,3,0
94132,3,2,329716,329716,329718,0,2,0
94133,4,3,329720,329720,329723,0,3,2
94134,6,3,329726,329726,329729,0,3,3
94135,6,3,329732,329732,329735,0,3,3
94136,1,1,329733,329735,329736,2,3,0
94137,5,2,329738,329738,329740,0,2,2
94138,6,1,329744,329744,329745,0,1,4
94139,4,1,329748,329748,329749,0,1,3
94140,6,1,329754,329754,329755,0,1,5
94141,5,3,329759,329759,329762,0,3,4
94142,3,1,329762,329762,329763,0,1,0
94143,6,2,329768,329768,329770,0,2,5
94144,5,1,329773,329773,329774,0,1,3
94145,6,2,329779,329779,329781,0,2,5
94146,3,2,329782,329782,329784,0,2,1
94147,3,3,329785,329785,329788,0,3,1
94148,5,1,329790,329790,329791,0,1,2
94149,2,3,329792,329792,329795,0,3,1
94150,6,3,329798,329798,329801,0,3,3
94151,5,3,329803,329803,329806,0,3,2
94152,2,1,329805,329806,329807,1,2,0
94153,4,2,329809,329809,329811,0,2,2
94154,5,2,329814,329814,329816,0,2,3
94155,2,1,329816,329816,329817,0,1,0
94156,2,3,329818,329818,329821,0,3,1
94157,5,2,329823,329823,329825,0,2,2
94158,4,3,329827,329827,329830,0,3,2
94159,6,1,329833,329833,329834,0,1,3
94160,3,3,329836,329836,329839,0,3,2
94161,1,2,329837,329839,329841,2,4,0
94162,5,3,329842,329842,329845,0,3,1
94163,3,3,329845,329845,329848,0,3,0
94164,6,1,329851,329851,329852,0,1,3
94165,5,3,329856,329856,329859,0,3,4
94166,5,1,329861,329861,329862,0,1,2
94167,3,2,329864,329864,329866,0,2,2
94168,4,3,329868,329868,329871,0,3,2
94169,2,1,329870,329871,329872,1,2,0
94170,6,2,329876,329876,329878,0,2,4
94171,4,2,329880,329880,329882,0,2,2
94172,1,1,329881,329882,329883,1,2,0
94173,3,2,329884,329884,329886,0,2,1
94174,5,2,329889,329889,329891,0,2,3
94175,1,1,329890,329891,329892,1,2,0
94176,1,1,329891,329892,329893,1,2,0
94177,2,3,329893,329893,329896,0,3,0
94178,1,2,329894,329896,329898,2,4,0
94179,1,1,329895,329898,329899,3,4,0
94180,1,3,329896,329899,329902,3,6,0
94181,2,1,329898,329902,329903,4,5,0
94182,1,2,329899,329903,329905,4,6,0
94183,3,3,329902,329905,329908,3,6,0
94184,2,2,329904,329908,329910,4,6,0
94185,1,1,329905,329910,329911,5,6,0
94186,4,2,329909,329911,329913,2,4,0
94187,4,2,329913,329913,329915,0,2,0
94188,4,1,329917,329917,329918,0,1,2
94189,5,2,329922,329922,329924,0,2,4
94190,5,2,329927,329927,329929,0,2,3
94191,4,1,329931,329931,329932,0,1,2
94192,5,3,329936,329936,329939,0,3,4
94193,2,3,329938,329939,329942,1,4,0
94194,2,2,329940,329942,329944,2,4,0
94195,1,1,329941,329944,329945,3,4,0
94196,4,3,329945,329945,329948,0,3,0
94197,4,3,329949,329949,329952,0,3,1
94198,1,2,329950,329952,329954,2,4,0
94199,4,2,329954,329954,329956,0,2,0
94200,1,1,329955,329956,329957,1,2,0
94201,5,2,329960,329960,329962,0,2,3
94202,5,1,329965,329965,329966,0,1,3
94203,6,2,329971,329971,329973,0,2,5
94204,5,2,329976,329976,329978,0,2,3
94205,4,2,329980,329980,329982,0,2,2
94206,1,2,329981,329982,329984,1,3,0
94207,6,3,329987,329987,329990,0,3,3
94208,3,2,329990,329990,329992,0,2,0
94209,3,1,329993,329993,329994,0,1,1
94210,5,1,329998,329998,329999,0,1,4
94211,2,3,330000,330000,330003,0,3,1
94212,5,3,330005,330005,330008,0,3,2
94213,4,1,330009,330009,330010,0,1,1
94214,3,1,330012,330012,330013,0,1,2
94215,6,1,330018,330018,330019,0,1,5
94216,5,3,330023,330023,330026,0,3,4
94217,5,2,330028,330028,330030,0,2,2
94218,6,3,330034,330034,330037,0,3,4
94219,3,2,330037,330037,330039,0,2,0
94220,6,3,330043,330043,330046,0,3,4
94221,5,2,330048,330048,330050,0,2,2
94222,6,1,330054,330054,330055,0,1,4
94223,1,3,330055,330055,330058,0,3,0
94224,5,3,330060,330060,330063,0,3,2
94225,3,1,330063,330063,330064,0,1,0
94226,5,1,330068,330068,330069,0,1,4
94227,5,1,330073,330073,330074,0,1,4
94228,1,2,330074,330074,330076,0,2,0
94229,4,2,330078,330078,330080,0,2,2
94230,4,2,330082,330082,330084,0,2,2
94231,3,1,330085,330085,330086,0,1,1
94232,4,1,330089,330089,330090,0,1,3
94233,6,2,330095,330095,330097,0,2,5
94234,6,1,330101,330101,330102,0,1,4
94235,5,3,330106,330106,330109,0,3,4
94236,2,1,330108,330109,330110,1,2,0
94237,1,2,330109,330110,330112,1,3,0
94238,1,2,330110,330112,330114,2,4,0
94239,4,1,330114,330114,330115,0,1,0
94240,5,3,330119,330119,330122,0,3,4
94241,4,3,330123,330123,330126,0,3,1
94242,4,1,330127,330127,330128,0,1,1
94243,1,2,330128,330128,330130,0,2,0
94244,3,1,330131,330131,330132,0,1,1
94245,6,3,330137,330137,330140,0,3,5
94246,3,3,330140,330140,330143,0,3,0
94247,1,1,330141,330143,330144,2,3,0
94248,6,3,330147,330147,330150,0,3,3
94249,6,3,330153,330153,330156,0,3,3
94250,6,2,330159,330159,330161,0,2,3
94251,3,1,330162,330162,330163,0,1,1
94252,3,1,330165,330165,330166,0,1,2
94253,2,1,330167,330167,330168,0,1,1
94254,4,3,330171,330171,330174,0,3,3
94255,2,1,330173,330174,330175,1,2,0
94256,1,1,330174,330175,330176,1,2,0
94257,5,2,330179,330179,330181,0,2,3
94258,3,3,330182,330182,330185,0,3,1
94259,1,1,330183,330185,330186,2,3,0
94260,6,3,330189,330189,330192,0,3,3
94261,6,1,330195,330195,330196,0,1,3
94262,6,1,330201,330201,330202,0,1,5
94263,3,2,330204,330204,330206,0,2,2
94264,5,1,330209,330209,330210,0,1,3
94265,5,2,330214,330214,330216,0,2,4
94266,6,3,330220,330220,330223,0,3,4
94267,2,3,330222,330223,330226,1,4,0
94268,5,1,330227,330227,330228,0,1,1
94269,3,3,330230,330230,330233,0,3,2
94270,6,3,330236,330236,330239,0,3,3
94271,5,1,330241,330241,330242,0,1,2
94272,6,3,330247,330247,330250,0,3,5
94273,1,2,330248,330250,330252,2,4,0
94274,5,1,330253,330253,330254,0,1,1
94275,3,2,330256,330256,330258,0,2,2
94276,4,3,330260,330260,330263,0,3,2
94277,4,2,330264,330264,330266,0,2,1
94278,6,1,330270,330270,330271,0,1,4
94279,4,2,330274,330274,330276,0,2,3
94280,1,2,330275,330276,330278,1,3,0
94281,4,3,330279,330279,330282,0,3,1
94282,4,1,330283,330283,330284,0,1,1
94283,3,2,330286,330286,330288,0,2,2
94284,4,3,330290,330290,330293,0,3,2
94285,1,1,330291,330293,330294,2,3,0
94286,6,1,330297,330297,330298,0,1,3
94287,2,3,330299,330299,330302,0,3,1
94288,4,1,330303,330303,330304,0,1,1
94289,4,2,330307,330307,330309,0,2,3
94290,3,3,330310,330310,330313,0,3,1
94291,4,3,330314,330314,330317,0,3,1
94292,4,2,330318,330318,330320,0,2,1
94293,2,1,330320,330320,330321,0,1,0
94294,4,3,330324,330324,330327,0,3,3
94295,1,3,330325,330327,330330,2,5,0
94296,6,1,330331,330331,330332,0,1,1
94297,4,3,330335,330335,330338,0,3,3
94298,6,2,330341,330341,330343,0,2,3
94299,2,1,330343,330343,330344,0,1,0
94300,2,3,330345,330345,330348,0,3,1
94301,3,2,330348,330348,330350,0,2,0
94302,4,1,330352,330352,330353,0,1,2
94303,6,2,330358,330358,330360,0,2,5
94304,2,3,330360,330360,330363,0,3,0
94305,2,2,330362,330363,330365,1,3,0
94306,5,3,330367,330367,330370,0,3,2
94307,1,1,330368,330370,330371,2,3,0
94308,3,3,330371,330371,330374,0,3,0
94309,6,2,330377,330377,330379,0,2,3
94310,3,3,330380,330380,330383,0,3,1
94311,2,2,330382,330383,330385,1,3,0
94312,6,1,330388,330388,330389,0,1,3
94313,5,2,330393,330393,330395,0,2,4
94314,3,2,330396,330396,330398,0,2,1
94315,4,1,330400,330400,330401,0,1,2
94316,1,3,330401,330401,330404,0,3,0
94317,2,2,330403,330404,330406,1,3,0
94318,1,2,330404,330406,330408,2,4,0
94319,5,3,330409,330409,330412,0,3,1
94320,1,3,330410,330412,330415,2,5,0
94321,1,3,330411,330415,330418,4,7,0
94322,3,2,330414,330418,330420,4,6,0
94323,5,3,330419,330420,330423,1,4,0
94324,6,2,330425,330425,330427,0,2,2
94325,1,1,330426,330427,330428,1,2,0
94326,4,3,330430,330430,330433,0,3,2
94327,4,1,330434,330434,330435,0,1,1
94328,2,3,330436,330436,330439,0,3,1
94329,4,3,330440,330440,330443,0,3,1
94330,2,3,330442,330443,330446,1,4,0
94331,1,2,330443,330446,330448,3,5,0
94332,4,2,330447,330448,330450,1,3,0
94333,4,2,330451,330451,330453,0,2,1
94334,2,2,330453,330453,330455,0,2,0
94335,4,3,330457,330457,330460,0,3,2
94336,3,3,330460,330460,330463,0,3,0
94337,5,1,330465,330465,330466,0,1,2
94338,3,1,330468,330468,330469,0,1,2
94339,1,3,330469,330469,330472,0,3,0
94340,6,3,330475,330475,330478,0,3,3
94341,2,2,330477,330478,330480,1,3,0
94342,5,3,330482,330482,330485,0,3,2
94343,1,2,330483,330485,330487,2,4,0
94344,6,3,330489,330489,330492,0,3,2
94345,2,1,330491,330492,330493,1,2,0
94346,5,1,330496,330496,330497,0,1,3
94347,5,3,330501,330501,330504,0,3,4
94348,4,1,330505,330505,330506,0,1,1
94349,6,3,330511,330511,330514,0,3,5
94350,4,1,330515,330515,330516,0,1,1
94351,3,1,330518,330518,330519,0,1,2
94352,4,2,330522,330522,330524,0,2,3
94353,5,3,330527,330527,330530,0,3,3
94354,3,3,330530,330530,330533,0,3,0
94355,5,1,330535,330535,330536,0,1,2
94356,6,2,330541,330541,330543,0,2,5
94357,4,1,330545,330545,330546,0,1,2
94358,3,1,330548,330548,330549,0,1,2
94359,4,1,330552,330552,330553,0,1,3
94360,6,3,330558,330558,330561,0,3,5
94361,4,1,330562,330562,330563,0,1,1
94362,4,3,330566,330566,330569,0,3,3
94363,5,1,330571,330571,330572,0,1,2
94364,2,2,330573,330573,330575,0,2,1
94365,4,3,330577,330577,330580,0,3,2
94366,6,2,330583,330583,330585,0,2,3
94367,1,3,330584,330585,330588,1,4,0
94368,6,3,330590,330590,330593,0,3,2
94369,2,2,330592,330593,330595,1,3,0
94370,5,3,330597,330597,330600,0,3,2
94371,2,2,330599,330600,330602,1,3,0
94372,2,3,330601,330602,330605,1,4,0
94373,6,1,330607,330607,330608,0,1,2
94374,5,2,330612,330612,330614,0,2,4
94375,1,2,330613,330614,330616,1,3,0
94376,3,2,330616,330616,330618,0,2,0
94377,5,1,330621,330621,330622,0,1,3
94378,4,1,330625,330625,330626,0,1,3
94379,5,3,330630,330630,330633,0,3,4
94380,1,3,330631,330633,330636,2,5,0
94381,2,1,330633,330636,330637,3,4,0
94382,3,2,330636,330637,330639,1,3,0
94383,5,3,330641,330641,330644,0,3,2
94384,3,3,330644,330644,330647,0,3,0
94385,3,3,330647,330647,330650,0,3,0
94386,5,1,330652,330652,330653,0,1,2
94387,2,1,330654,330654,330655,0,1,1
94388,4,3,330658,330658,330661,0,3,3
94389,3,3,330661,330661,330664,0,3,0
94390,1,3,330662,330664,330667,2,5,0
94391,3,3,330665,330667,330670,2,5,0
94392,3,3,330668,330670,330673,2,5,0
94393,2,1,330670,330673,330674,3,4,0
94394,5,1,330675,330675,330676,0,1,1
94395,6,3,330681,330681,330684,0,3,5
94396,3,2,330684,330684,330686,0,2,0
94397,6,1,330690,330690,330691,0,1,4
94398,5,3,330695,330695,330698,0,3,4
94399,3,3,330698,330698,330701,0,3,0
94400,2,2,330700,330701,330703,1,3,0
94401,5,2,330705,330705,330707,0,2,2
94402,3,2,330708,330708,330710,0,2,1
94403,1,2,330709,330710,330712,1,3,0
94404,2,2,330711,330712,330714,1,3,0
94405,4,2,330715,330715,330717,0,2,1
94406,2,2,330717,330717,330719,0,2,0
94407,6,1,330723,330723,330724,0,1,4
94408,6,2,330729,330729,330731,0,2,5
94409,5,3,330734,330734,330737,0,3,3
94410,4,3,330738,330738,330741,0,3,1
94411,6,1,330744,330744,330745,0,1,3
94412,2,3,330746,330746,330749,0,3,1
94413,3,3,330749,330749,330752,0,3,0
94414,6,3,330755,330755,330758,0,3,3
94415,5,1,330760,330760,330761,0,1,2
94416,5,3,330765,330765,330768,0,3,4
94417,2,2,330767,330768,330770,1,3,0
94418,1,1,330768,330770,330771,2,3,0
94419,6,1,330774,330774,330775,0,1,3
94420,3,1,330777,330777,330778,0,1,2
94421,2,2,330779,330779,330781,0,2,1
94422,3,3,330782,330782,330785,0,3,1
94423,5,1,330787,330787,330788,0,1,2
94424,3,2,330790,330790,330792,0,2,2
94425,6,2,330796,330796,330798,0,2,4
94426,5,1,330801,330801,330802,0,1,3
94427,1,1,330802,330802,330803,0,1,0
94428,4,2,330806,330806,330808,0,2,3
94429,6,3,330812,330812,330815,0,3,4
94430,5,3,330817,330817,330820,0,3,2
94431,2,1,330819,330820,330821,1,2,0
94432,6,2,330825,330825,330827,0,2,4
94433,5,2,330830,330830,330832,0,2,3
94434,1,3,330831,330832,330835,1,4,0
94435,2,1,330833,330835,330836,2,3,0
94436,1,1,330834,330836,330837,2,3,0
94437,2,2,330836,330837,330839,1,3,0
94438,4,3,330840,330840,330843,0,3,1
94439,3,3,330843,330843,330846,0,3,0
94440,6,2,330849,330849,330851,0,2,3
94441,6,2,330855,330855,330857,0,2,4
94442,6,2,330861,330861,330863,0,2,4
94443,3,3,330864,330864,330867,0,3,1
94444,4,1,330868,330868,330869,0,1,1
94445,6,1,330874,330874,330875,0,1,5
94446,2,1,330876,330876,330877,0,1,1
94447,3,3,330879,330879,330882,0,3,2
94448,2,2,330881,330882,330884,1,3,0
94449,3,3,330884,330884,330887,0,3,0
94450,4,3,330888,330888,330891,0,3,1
94451,4,1,330892,330892,330893,0,1,1
94452,5,3,330897,330897,330900,0,3,4
94453,2,3,330899,330900,330903,1,4,0
94454,6,3,330905,330905,330908,0,3,2
94455,5,1,330910,330910,330911,0,1,2
94456,6,3,330916,330916,330919,0,3,5
94457,1,3,330917,330919,330922,2,5,0
94458,6,1,330923,330923,330924,0,1,1
94459,5,2,330928,330928,330930,0,2,4
94460,1,1,330929,330930,330931,1,2,0
94461,3,3,330932,330932,330935,0,3,1
94462,6,1,330938,330938,330939,0,1,3
94463,5,3,330943,330943,330946,0,3,4
94464,3,2,330946,330946,330948,0,2,0
94465,2,3,330948,330948,330951,0,3,0
94466,2,3,330950,330951,330954,1,4,0
94467,3,1,330953,330954,330955,1,2,0
94468,6,3,330959,330959,330962,0,3,4
94469,6,1,330965,330965,330966,0,1,3
94470,4,1,330969,330969,330970,0,1,3
94471,2,2,330971,330971,330973,0,2,1
94472,5,3,330976,330976,330979,0,3,3
94473,5,1,330981,330981,330982,0,1,2
94474,3,1,330984,330984,330985,0,1,2
94475,2,1,330986,330986,330987,0,1,1
94476,2,1,330988,330988,330989,0,1,1
94477,4,1,330992,330992,330993,0,1,3
94478,6,2,330998,330998,331000,0,2,5
94479,3,2,331001,331001,331003,0,2,1
94480,5,3,331006,331006,331009,0,3,3
94481,1,3,331007,331009,331012,2,5,0
94482,3,3,331010,331012,331015,2,5,0
94483,4,2,331014,331015,331017,1,3,0
94484,6,1,331020,331020,331021,0,1,3
94485,5,3,331025,331025,331028,0,3,4
94486,6,3,331031,331031,331034,0,3,3
94487,2,1,331033,331034,331035,1,2,0
94488,6,2,331039,331039,331041,0,2,4
94489,3,2,331042,331042,331044,0,2,1
94490,5,2,331047,331047,331049,0,2,3
94491,2,1,331049,331049,331050,0,1,0
94492,2,1,331051,331051,331052,0,1,1
94493,2,3,331053,331053,331056,0,3,1
94494,1,1,331054,331056,331057,2,3,0
94495,5,1,331059,331059,331060,0,1,2
94496,2,3,331061,331061,331064,0,3,1
94497,3,2,331064,331064,331066,0,2,0
94498,2,1,331066,331066,331067,0,1,0
94499,6,3,331072,331072,331075,0,3,5
94500,1,2,331073,331075,331077,2,4,0
94501,1,1,331074,331077,331078,3,4,0
94502,5,1,331079,331079,331080,0,1,1
94503,5,3,331084,331084,331087,0,3,4
94504,2,3,331086,331087,331090,1,4,0
94505,3,1,331089,331090,331091,1,2,0
94506,4,1,331093,331093,331094,0,1,2
94507,6,1,331099,331099,331100,0,1,5
94508,2,3,331101,331101,331104,0,3,1
94509,5,3,331106,331106,331109,0,3,2
94510,6,2,331112,331112,331114,0,2,3
94511,6,3,331118,331118,331121,0,3,4
94512,2,2,331120,331121,331123,1,3,0
94513,5,3,331125,331125,331128,0,3,2
94514,3,1,331128,331128,331129,0,1,0
94515,2,1,331130,331130,331131,0,1,1
94516,4,1,331134,331134,331135,0,1,3
94517,5,3,331139,331139,331142,0,3,4
94518,2,2,331141,331142,331144,1,3,0
94519,3,3,331144,331144,331147,0,3,0
94520,2,2,331146,331147,331149,1,3,0
94521,2,2,331148,331149,331151,1,3,0
94522,6,3,331154,331154,331157,0,3,3
94523,1,3,331155,331157,331160,2,5,0
94524,6,2,331161,331161,331163,0,2,1
94525,1,1,331162,331163,331164,1,2,0
94526,1,1,331163,331164,331165,1,2,0
94527,3,1,331166,331166,331167,0,1,1
94528,1,2,331167,331167,331169,0,2,0
94529,6,1,331173,331173,331174,0,1,4
94530,5,1,331178,331178,331179,0,1,4
94531,4,1,331182,331182,331183,0,1,3
94532,4,2,331186,331186,331188,0,2,3
94533,5,1,331191,331191,331192,0,1,3
94534,2,2,331193,331193,331195,0,2,1
94535,6,1,331199,331199,331200,0,1,4
94536,2,2,331201,331201,331203,0,2,1
94537,1,1,331202,331203,331204,1,2,0
94538,6,1,331208,331208,331209,0,1,4
94539,6,1,331214,331214,331215,0,1,5
94540,1,2,331215,331215,331217,0,2,0
94541,3,2,331218,331218,331220,0,2,1
94542,5,2,331223,331223,331225,0,2,3
94543,1,1,331224,331225,331226,1,2,0
94544,5,1,331229,331229,331230,0,1,3
94545,4,1,331233,331233,331234,0,1,3
94546,6,1,331239,331239,331240,0,1,5
94547,1,3,331240,331240,331243,0,3,0
94548,6,2,331246,331246,331248,0,2,3
94549,6,3,331252,331252,331255,0,3,4
94550,3,2,331255,331255,331257,0,2,0
94551,5,1,331260,331260,331261,0,1,3
94552,1,2,331261,331261,331263,0,2,0
94553,6,3,331267,331267,331270,0,3,4
94554,2,1,331269,331270,331271,1,2,0
94555,2,3,331271,331271,331274,0,3,0
94556,3,3,331274,331274,331277,0,3,0
94557,5,3,331279,331279,331282,0,3,2
94558,2,1,331281,331282,331283,1,2,0
94559,4,3,331285,331285,331288,0,3,2
94560,4,1,331289,331289,331290,0,1,1
94561,2,2,331291,331291,331293,0,2,1
94562,4,1,331295,331295,331296,0,1,2
94563,5,3,331300,331300,331303,0,3,4
94564,1,1,331301,331303,331304,2,3,0
94565,6,1,331307,331307,331308,0,1,3
94566,2,3,331309,331309,331312,0,3,1
94567,6,3,331315,331315,331318,0,3,3
94568,6,1,331321,331321,331322,0,1,3
94569,1,2,331322,331322,331324,0,2,0
94570,4,1,331326,331326,331327,0,1,2
94571,1,3,331327,331327,331330,0,3,0
94572,6,3,331333,331333,331336,0,3,3
94573,5,3,331338,331338,331341,0,3,2
94574,6,2,331344,331344,331346,0,2,3
94575,6,1,331350,331350,331351,0,1,4
94576,4,2,331354,331354,331356,0,2,3
94577,4,3,331358,331358,331361,0,3,2
94578,3,3,331361,331361,331364,0,3,0
94579,6,2,331367,331367,331369,0,2,3
94580,5,3,331372,331372,331375,0,3,3
94581,4,1,331376,331376,331377,0,1,1
94582,1,3,331377,331377,331380,0,3,0
94583,5,3,331382,331382,331385,0,3,2
94584,1,3,331383,331385,331388,2,5,0
94585,2,2,331385,331388,331390,3,5,0
94586,6,2,331391,331391,331393,0,2,1
94587,1,2,331392,331393,331395,1,3,0
94588,1,3,331393,331395,331398,2,5,0
94589,5,1,331398,331398,331399,0,1,0
94590,6,1,331404,331404,331405,0,1,5
94591,6,2,331410,331410,331412,0,2,5
94592,3,1,331413,331413,331414,0,1,1
94593,5,1,331418,331418,331419,0,1,4
94594,5,3,331423,331423,331426,0,3,4
94595,1,3,331424,331426,331429,2,5,0
94596,4,2,331428,331429,331431,1,3,0
94597,1,1,331429,331431,331432,2,3,0
94598,4,1,331433,331433,331434,0,1,1
94599,3,2,331436,331436,331438,0,2,2
94600,2,2,331438,331438,331440,0,2,0
94601,2,3,331440,331440,331443,0,3,0
94602,3,3,331443,331443,331446,0,3,0
94603,3,1,331446,331446,331447,0,1,0
94604,2,2,331448,331448,331450,0,2,1
94605,3,3,331451,331451,331454,0,3,1
94606,4,3,331455,331455,331458,0,3,1
94607,5,3,331460,331460,331463,0,3,2
94608,5,1,331465,331465,331466,0,1,2
94609,1,1,331466,331466,331467,0,1,0
94610,1,2,331467,331467,331469,0,2,0
94611,4,1,331471,331471,331472,0,1,2
94612,3,1,331474,331474,331475,0,1,2
94613,4,2,331478,331478,331480,0,2,3
94614,1,3,331479,331480,331483,1,4,0
94615,3,2,331482,331483,331485,1,3,0
94616,1,3,331483,331485,331488,2,5,0
94617,6,1,331489,331489,331490,0,1,1
94618,1,3,331490,331490,331493,0,3,0
94619,6,3,331496,331496,331499,0,3,3
94620,3,2,331499,331499,331501,0,2,0
94621,4,3,331503,331503,331506,0,3,2
94622,1,3,331504,331506,331509,2,5,0
94623,2,1,331506,331509,331510,3,4,0
94624,2,1,331508,331510,331511,2,3,0
94625,2,2,331510,331511,331513,1,3,0
94626,5,2,331515,331515,331517,0,2,2
94627,6,1,331521,331521,331522,0,1,4
94628,1,3,331522,331522,331525,0,3,0
94629,6,1,331528,331528,331529,0,1,3
94630,1,3,331529,331529,331532,0,3,0
94631,6,1,331535,331535,331536,0,1,3
94632,4,1,331539,331539,331540,0,1,3
94633,1,1,331540,331540,331541,0,1,0
94634,4,2,331544,331544,331546,0,2,3
94635,5,1,331549,331549,331550,0,1,3
94636,1,1,331550,331550,331551,0,1,0
94637,3,3,331553,331553,331556,0,3,2
94638,6,2,331559,331559,331561,0,2,3
94639,6,1,331565,331565,331566,0,1,4
94640,1,1,331566,331566,331567,0,1,0
94641,4,1,331570,331570,331571,0,1,3
94642,2,2,331572,331572,331574,0,2,1
94643,1,1,331573,331574,331575,1,2,0
94644,2,1,331575,331575,331576,0,1,0
94645,1,3,331576,331576,331579,0,3,0
94646,6,3,331582,331582,331585,0,3,3
94647,2,1,331584,331585,331586,1,2,0
94648,5,2,331589,331589,331591,0,2,3
94649,2,2,331591,331591,331593,0,2,0
94650,4,1,331595,331595,331596,0,1,2
94651,2,1,331597,331597,331598,0,1,1
94652,2,3,331599,331599,331602,0,3,1
94653,6,2,331605,331605,331607,0,2,3
94654,4,3,331609,331609,331612,0,3,2
94655,5,3,331614,331614,331617,0,3,2
94656,2,1,331616,331617,331618,1,2,0
94657,3,1,331619,331619,331620,0,1,1
94658,5,1,331624,331624,331625,0,1,4
94659,5,1,331629,331629,331630,0,1,4
94660,4,3,331633,331633,331636,0,3,3
94661,4,1,331637,331637,331638,0,1,1
94662,6,1,331643,331643,331644,0,1,5
94663,3,1,331646,331646,331647,0,1,2
94664,3,1,331649,331649,331650,0,1,2
94665,6,3,331655,331655,331658,0,3,5
94666,2,2,331657,331658,331660,1,3,0
94667,1,1,331658,331660,331661,2,3,0
94668,6,3,331664,331664,331667,0,3,3
94669,2,3,331666,331667,331670,1,4,0
94670,2,1,331668,331670,331671,2,3,0
94671,4,3,331672,331672,331675,0,3,1
94672,1,2,331673,331675,331677,2,4,0
94673,1,1,331674,331677,331678,3,4,0
94674,5,3,331679,331679,331682,0,3,1
94675,3,1,331682,331682,331683,0,1,0
94676,2,3,331684,331684,331687,0,3,1
94677,2,1,331686,331687,331688,1,2,0
94678,3,1,331689,331689,331690,0,1,1
94679,3,2,331692,331692,331694,0,2,2
94680,4,3,331696,331696,331699,0,3,2
94681,3,1,331699,331699,331700,0,1,0
94682,1,2,331700,331700,331702,0,2,0
94683,1,1,331701,331702,331703,1,2,0
94684,6,2,331707,331707,331709,0,2,4
94685,3,2,331710,331710,331712,0,2,1
94686,1,2,331711,331712,331714,1,3,0
94687,6,3,331717,331717,331720,0,3,3
94688,6,2,331723,331723,331725,0,2,3
94689,4,3,331727,331727,331730,0,3,2
94690,2,1,331729,331730,331731,1,2,0
94691,2,2,331731,331731,331733,0,2,0
94692,6,3,331737,331737,331740,0,3,4
94693,3,3,331740,331740,331743,0,3,0
94694,1,2,331741,331743,331745,2,4,0
94695,4,1,331745,331745,331746,0,1,0
94696,2,3,331747,331747,331750,0,3,1
94697,2,1,331749,331750,331751,1,2,0
94698,5,3,331754,331754,331757,0,3,3
94699,4,3,331758,331758,331761,0,3,1
94700,1,2,331759,331761,331763,2,4,0
94701,4,1,331763,331763,331764,0,1,0
94702,2,1,331765,331765,331766,0,1,1
94703,1,1,331766,331766,331767,0,1,0
94704,4,1,331770,331770,331771,0,1,3
94705,5,1,331775,331775,331776,0,1,4
94706,4,2,331779,331779,331781,0,2,3
94707,3,2,331782,331782,331784,0,2,1
94708,3,1,331785,331785,331786,0,1,1
94709,2,3,331787,331787,331790,0,3,1
94710,6,2,331793,331793,331795,0,2,3
94711,2,3,331795,331795,331798,0,3,0
94712,4,3,331799,331799,331802,0,3,1
94713,2,1,331801,331802,331803,1,2,0
94714,4,1,331805,331805,331806,0,1,2
94715,3,2,331808,331808,331810,0,2,2
94716,1,3,331809,331810,331813,1,4,0
94717,2,2,331811,331813,331815,2,4,0
94718,1,3,331812,331815,331818,3,6,0
94719,2,1,331814,331818,331819,4,5,0
94720,3,2,331817,331819,331821,2,4,0
94721,5,2,331822,331822,331824,0,2,1
94722,6,2,331828,331828,331830,0,2,4
94723,6,3,331834,331834,331837,0,3,4
94724,2,1,331836,331837,331838,1,2,0
94725,2,1,331838,331838,331839,0,1,0
94726,1,3,331839,331839,331842,0,3,0
94727,1,3,331840,331842,331845,2,5,0
94728,3,1,331843,331845,331846,2,3,0
94729,2,3,331845,331846,331849,1,4,0
94730,5,3,331850,331850,331853,0,3,1
94731,5,1,331855,331855,331856,0,1,2
94732,1,1,331856,331856,331857,0,1,0
94733,1,2,331857,331857,331859,0,2,0
94734,6,2,331863,331863,331865,0,2,4
94735,2,2,331865,331865,331867,0,2,0
94736,4,2,331869,331869,331871,0,2,2
94737,6,3,331875,331875,331878,0,3,4
94738,4,3,331879,331879,331882,0,3,1
94739,2,1,331881,331882,331883,1,2,0
94740,1,3,331882,331883,331886,1,4,0
94741,3,3,331885,331886,331889,1,4,0
94742,5,1,331890,331890,331891,0,1,1
94743,4,1,331894,331894,331895,0,1,3
94744,6,3,331900,331900,331903,0,3,5
94745,4,3,331904,331904,331907,0,3,1
94746,5,1,331909,331909,331910,0,1,2
94747,5,2,331914,331914,331916,0,2,4
94748,3,2,331917,331917,331919,0,2,1
94749,3,2,331920,331920,331922,0,2,1
94750,1,2,331921,331922,331924,1,3,0
94751,4,2,331925,331925,331927,0,2,1
94752,3,3,331928,331928,331931,0,3,1
94753,6,3,331934,331934,331937,0,3,3
94754,3,3,331937,331937,331940,0,3,0
94755,4,3,331941,331941,331944,0,3,1
94756,6,2,331947,331947,331949,0,2,3
94757,4,3,331951,331951,331954,0,3,2
94758,3,3,331954,331954,331957,0,3,0
94759,1,1,331955,331957,331958,2,3,0
94760,2,1,331957,331958,331959,1,2,0
94761,6,2,331963,331963,331965,0,2,4
94762,1,1,331964,331965,331966,1,2,0
94763,3,2,331967,331967,331969,0,2,1
94764,6,2,331973,331973,331975,0,2,4
94765,3,1,331976,331976,331977,0,1,1
94766,5,1,331981,331981,331982,0,1,4
94767,6,2,331987,331987,331989,0,2,5
94768,5,2,331992,331992,331994,0,2,3
94769,4,2,331996,331996,331998,0,2,2
94770,2,3,331998,331998,332001,0,3,0
94771,2,2,332000,332001,332003,1,3,0
94772,3,1,332003,332003,332004,0,1,0
94773,2,3,332005,332005,332008,0,3,1
94774,5,2,332010,332010,332012,0,2,2
94775,1,2,332011,332012,332014,1,3,0
94776,3,2,332014,332014,332016,0,2,0
94777,3,3,332017,332017,332020,0,3,1
94778,6,3,332023,332023,332026,0,3,3
94779,3,2,332026,332026,332028,0,2,0
94780,4,1,332030,332030,332031,0,1,2
94781,5,2,332035,332035,332037,0,2,4
94782,2,2,332037,332037,332039,0,2,0
94783,3,3,332040,332040,332043,0,3,1
94784,1,3,332041,332043,332046,2,5,0
94785,4,2,332045,332046,332048,1,3,0
94786,4,2,332049,332049,332051,0,2,1
94787,3,1,332052,332052,332053,0,1,1
94788,5,3,332057,332057,332060,0,3,4
94789,2,3,332059,332060,332063,1,4,0
94790,2,1,332061,332063,332064,2,3,0
94791,6,3,332067,332067,332070,0,3,3
94792,2,3,332069,332070,332073,1,4,0
94793,5,3,332074,332074,332077,0,3,1
94794,4,3,332078,332078,332081,0,3,1
94795,2,3,332080,332081,332084,1,4,0
94796,4,1,332084,332084,332085,0,1,0
94797,5,1,332089,332089,332090,0,1,4
94798,2,2,332091,332091,332093,0,2,1
94799,3,2,332094,332094,332096,0,2,1
94800,2,2,332096,332096,332098,0,2,0
94801,1,3,332097,332098,332101,1,4,0
94802,4,1,332101,332101,332102,0,1,0
94803,4,1,332105,332105,332106,0,1,3
94804,4,1,332109,332109,332110,0,1,3
94805,1,3,332110,332110,332113,0,3,0
94806,2,2,332112,332113,332115,1,3,0
94807,4,2,332116,332116,332118,0,2,1
94808,2,1,332118,332118,332119,0,1,0
94809,3,3,332121,332121,332124,0,3,2
94810,4,3,332125,332125,332128,0,3,1
94811,5,3,332130,332130,332133,0,3,2
94812,1,1,332131,332133,332134,2,3,0
94813,6,1,332137,332137,332138,0,1,3
94814,1,3,332138,332138,332141,0,3,0
94815,2,1,332140,332141,332142,1,2,0
94816,3,2,332143,332143,332145,0,2,1
94817,1,2,332144,332145,332147,1,3,0
94818,1,3,332145,332147,332150,2,5,0
94819,5,1,332150,332150,332151,0,1,0
94820,1,1,332151,332151,332152,0,1,0
94821,6,3,332157,332157,332160,0,3,5
94822,6,3,332163,332163,332166,0,3,3
94823,6,2,332169,332169,332171,0,2,3
94824,1,3,332170,332171,332174,1,4,0
94825,6,3,332176,332176,332179,0,3,2
94826,3,3,332179,332179,332182,0,3,0
94827,4,2,332183,332183,332185,0,2,1
94828,4,2,332187,332187,332189,0,2,2
94829,1,3,332188,332189,332192,1,4,0
94830,4,3,332192,332192,332195,0,3,0
94831,5,2,332197,332197,332199,0,2,2
94832,4,3,332201,332201,332204,0,3,2
94833,2,3,332203,332204,332207,1,4,0
94834,1,1,332204,332207,332208,3,4,0
94835,3,1,332207,332208,332209,1,2,0
94836,1,3,332208,332209,332212,1,4,0
94837,5,1,332213,332213,332214,0,1,1
94838,2,3,332215,332215,332218,0,3,1
94839,2,3,332217,332218,332221,1,4,0
94840,6,2,332223,332223,332225,0,2,2
94841,6,1,332229,332229,332230,0,1,4
94842,6,2,332235,332235,332237,0,2,5
94843,3,1,332238,332238,332239,0,1,1
94844,5,3,332243,332243,332246,0,3,4
94845,1,3,332244,332246,332249,2,5,0
94846,6,2,332250,332250,332252,0,2,1
94847,4,2,332254,332254,332256,0,2,2
94848,6,2,332260,332260,332262,0,2,4
94849,2,2,332262,332262,332264,0,2,0
94850,4,1,332266,332266,332267,0,1,2
94851,2,3,332268,332268,332271,0,3,1
94852,1,1,332269,332271,332272,2,3,0
94853,5,2,332274,332274,332276,0,2,2
94854,4,2,332278,332278,332280,0,2,2
94855,6,3,332284,332284,332287,0,3,4
94856,3,2,332287,332287,332289,0,2,0
94857,2,1,332289,332289,332290,0,1,0
94858,6,1,332295,332295,332296,0,1,5
94859,2,2,332297,332297,332299,0,2,1
94860,3,2,332300,332300,332302,0,2,1
94861,1,2,332301,332302,332304,1,3,0
94862,6,3,332307,332307,332310,0,3,3
94863,2,1,332309,332310,332311,1,2,0
94864,3,1,332312,332312,332313,0,1,1
94865,6,3,332318,332318,332321,0,3,5
94866,3,3,332321,332321,332324,0,3,0
94867,1,1,332322,332324,332325,2,3,0
94868,5,3,332327,332327,332330,0,3,2
94869,4,2,332331,332331,332333,0,2,1
94870,3,2,332334,332334,332336,0,2,1
94871,2,1,332336,332336,332337,0,1,0
94872,2,3,332338,332338,332341,0,3,1
94873,5,2,332343,332343,332345,0,2,2
94874,2,2,332345,332345,332347,0,2,0
94875,5,2,332350,332350,332352,0,2,3
94876,5,1,332355,332355,332356,0,1,3
94877,4,1,332359,332359,332360,0,1,3
94878,2,1,332361,332361,332362,0,1,1
94879,4,1,332365,332365,332366,0,1,3
94880,3,2,332368,332368,332370,0,2,2
94881,6,1,332374,332374,332375,0,1,4
94882,4,2,332378,332378,332380,0,2,3
94883,3,1,332381,332381,332382,0,1,1
94884,3,2,332384,332384,332386,0,2,2
94885,2,1,332386,332386,332387,0,1,0
94886,2,1,332388,332388,332389,0,1,1
94887,1,1,332389,332389,332390,0,1,0
94888,2,1,332391,332391,332392,0,1,1
94889,5,1,332396,332396,332397,0,1,4
94890,5,2,332401,332401,332403,0,2,4
94891,1,3,332402,332403,332406,1,4,0
94892,5,1,332407,332407,332408,0,1,1
94893,6,1,332413,332413,332414,0,1,5
94894,3,2,332416,332416,332418,0,2,2
94895,1,1,332417,332418,332419,1,2,0
94896,5,2,332422,332422,332424,0,2,3
94897,2,3,332424,332424,332427,0,3,0
94898,6,3,332430,332430,332433,0,3,3
94899,2,1,332432,332433,332434,1,2,0
94900,3,2,332435,332435,332437,0,2,1
94901,5,2,332440,332440,332442,0,2,3
94902,5,1,332445,332445,332446,0,1,3
94903,4,2,332449,332449,332451,0,2,3
94904,4,3,332453,332453,332456,0,3,2
94905,4,2,332457,332457,332459,0,2,1
94906,3,2,332460,332460,332462,0,2,1
94907,3,1,332463,332463,332464,0,1,1
94908,1,3,332464,332464,332467,0,3,0
94909,3,1,332467,332467,332468,0,1,0
94910,1,1,332468,332468,332469,0,1,0
94911,4,1,332472,332472,332473,0,1,3
94912,2,3,332474,332474,332477,0,3,1
94913,3,3,332477,332477,332480,0,3,0
94914,2,2,332479,332480,332482,1,3,0
94915,4,1,332483,332483,332484,0,1,1
94916,1,1,332484,332484,332485,0,1,0
94917,1,1,332485,332485,332486,0,1,0
94918,2,1,332487,332487,332488,0,1,1
94919,1,1,332488,332488,332489,0,1,0
94920,1,2,332489,332489,332491,0,2,0
94921,3,1,332492,332492,332493,0,1,1
94922,5,2,332497,332497,332499,0,2,4
94923,6,2,332503,332503,332505,0,2,4
94924,2,3,332505,332505,332508,0,3,0
94925,2,2,332507,332508,332510,1,3,0
94926,5,2,332512,332512,332514,0,2,2
94927,4,2,332516,332516,332518,0,2,2
94928,1,2,332517,332518,332520,1,3,0
94929,1,1,332518,332520,332521,2,3,0
94930,6,2,332524,332524,332526,0,2,3
94931,4,2,332528,332528,332530,0,2,2
94932,1,2,332529,332530,332532,1,3,0
94933,1,1,332530,332532,332533,2,3,0
94934,6,3,332536,332536,332539,0,3,3
94935,2,3,332538,332539,332542,1,4,0
94936,6,2,332544,332544,332546,0,2,2
94937,2,2,332546,332546,332548,0,2,0
94938,6,2,332552,332552,332554,0,2,4
94939,1,2,332553,332554,332556,1,3,0
94940,3,3,332556,332556,332559,0,3,0
94941,3,3,332559,332559,332562,0,3,0
94942,4,2,332563,332563,332565,0,2,1
94943,6,1,332569,332569,332570,0,1,4
94944,4,2,332573,332573,332575,0,2,3
94945,1,1,332574,332575,332576,1,2,0
94946,1,2,332575,332576,332578,1,3,0
94947,1,1,332576,332578,332579,2,3,0
94948,5,2,332581,332581,332583,0,2,2
94949,5,3,332586,332586,332589,0,3,3
94950,6,3,332592,332592,332595,0,3,3
94951,3,1,332595,332595,332596,0,1,0
94952,1,3,332596,332596,332599,0,3,0
94953,4,1,332600,332600,332601,0,1,1
94954,5,2,332605,332605,332607,0,2,4
94955,1,1,332606,332607,332608,1,2,0
94956,5,3,332611,332611,332614,0,3,3
94957,5,1,332616,332616,332617,0,1,2
94958,3,3,332619,332619,332622,0,3,2
94959,1,3,332620,332622,332625,2,5,0
94960,6,2,332626,332626,332628,0,2,1
94961,5,1,332631,332631,332632,0,1,3
94962,3,2,332634,332634,332636,0,2,2
94963,2,1,332636,332636,332637,0,1,0
94964,1,2,332637,332637,332639,0,2,0
94965,2,1,332639,332639,332640,0,1,0
94966,1,2,332640,332640,332642,0,2,0
94967,2,2,332642,332642,332644,0,2,0
94968,4,1,332646,332646,332647,0,1,2
94969,6,3,332652,332652,332655,0,3,5
94970,2,3,332654,332655,332658,1,4,0
94971,5,2,332659,332659,332661,0,2,1
94972,2,1,332661,332661,332662,0,1,0
94973,5,1,332666,332666,332667,0,1,4
94974,3,1,332669,332669,332670,0,1,2
94975,5,3,332674,332674,332677,0,3,4
94976,1,3,332675,332677,332680,2,5,0
94977,5,2,332680,332680,332682,0,2,0
94978,2,2,332682,332682,332684,0,2,0
94979,5,1,332687,332687,332688,0,1,3
94980,4,2,332691,332691,332693,0,2,3
94981,1,3,332692,332693,332696,1,4,0
94982,1,1,332693,332696,332697,3,4,0
94983,5,3,332698,332698,332701,0,3,1
94984,4,1,332702,332702,332703,0,1,1
94985,1,1,332703,332703,332704,0,1,0
94986,6,1,332709,332709,332710,0,1,5
94987,2,2,332711,332711,332713,0,2,1
94988,4,2,332715,332715,332717,0,2,2
94989,3,2,332718,332718,332720,0,2,1
94990,3,2,332721,332721,332723,0,2,1
94991,5,3,332726,332726,332729,0,3,3
94992,4,3,332730,332730,332733,0,3,1
94993,4,1,332734,332734,332735,0,1,1
94994,2,1,332736,332736,332737,0,1,1
94995,1,2,332737,332737,332739,0,2,0
94996,3,3,332740,332740,332743,0,3,1
94997,2,2,332742,332743,332745,1,3,0
94998,5,1,332747,332747,332748,0,1,2
94999,5,2,332752,332752,332754,0,2,4
95000,2,3,332754,332754,332757,0,3,0
95001,2,1,332756,332757,332758,1,2,0
95002,2,2,332758,332758,332760,0,2,0
95003,6,3,332764,332764,332767,0,3,4
95004,4,1,332768,332768,332769,0,1,1
95005,6,1,332774,332774,332775,0,1,5
95006,5,3,332779,332779,332782,0,3,4
95007,4,1,332783,332783,332784,0,1,1
95008,5,1,332788,332788,332789,0,1,4
95009,1,2,332789,332789,332791,0,2,0
95010,4,2,332793,332793,332795,0,2,2
95011,2,3,332795,332795,332798,0,3,0
95012,6,1,332801,332801,332802,0,1,3
95013,6,2,332807,332807,332809,0,2,5
95014,3,2,332810,332810,332812,0,2,1
95015,2,3,332812,332812,332815,0,3,0
95016,5,2,332817,332817,332819,0,2,2
95017,2,2,332819,332819,332821,0,2,0
95018,4,1,332823,332823,332824,0,1,2
95019,6,1,332829,332829,332830,0,1,5
95020,5,3,332834,332834,332837,0,3,4
95021,2,2,332836,332837,332839,1,3,0
95022,6,1,332842,332842,332843,0,1,3
95023,4,1,332846,332846,332847,0,1,3
95024,6,3,332852,332852,332855,0,3,5
95025,6,2,332858,332858,332860,0,2,3
95026,1,3,332859,332860,332863,1,4,0
95027,4,2,332863,332863,332865,0,2,0
95028,6,1,332869,332869,332870,0,1,4
95029,5,1,332874,332874,332875,0,1,4
95030,4,3,332878,332878,332881,0,3,3
95031,2,2,332880,332881,332883,1,3,0
95032,2,3,332882,332883,332886,1,4,0
95033,6,2,332888,332888,332890,0,2,2
95034,4,1,332892,332892,332893,0,1,2
95035,3,2,332895,332895,332897,0,2,2
95036,1,1,332896,332897,332898,1,2,0
95037,6,2,332902,332902,332904,0,2,4
95038,5,2,332907,332907,332909,0,2,3
95039,6,2,332913,332913,332915,0,2,4
95040,4,3,332917,332917,332920,0,3,2
95041,1,1,332918,332920,332921,2,3,0
95042,6,3,332924,332924,332927,0,3,3
95043,5,3,332929,332929,332932,0,3,2
95044,2,2,332931,332932,332934,1,3,0
95045,5,2,332936,332936,332938,0,2,2
95046,6,3,332942,332942,332945,0,3,4
95047,3,1,332945,332945,332946,0,1,0
95048,2,3,332947,332947,332950,0,3,1
95049,5,2,332952,332952,332954,0,2,2
95050,4,2,332956,332956,332958,0,2,2
95051,6,3,332962,332962,332965,0,3,4
95052,2,3,332964,332965,332968,1,4,0
95053,6,3,332970,332970,332973,0,3,2
95054,4,3,332974,332974,332977,0,3,1
95055,1,3,332975,332977,332980,2,5,0
95056,6,2,332981,332981,332983,0,2,1
95057,2,1,332983,332983,332984,0,1,0
95058,3,1,332986,332986,332987,0,1,2
95059,4,3,332990,332990,332993,0,3,3
95060,4,2,332994,332994,332996,0,2,1
95061,1,1,332995,332996,332997,1,2,0
95062,4,1,332999,332999,333000,0,1,2
95063,1,3,333000,333000,333003,0,3,0
95064,1,3,333001,333003,333006,2,5,0
95065,4,2,333005,333006,333008,1,3,0
95066,5,2,333010,333010,333012,0,2,2
95067,3,2,333013,333013,333015,0,2,1
95068,6,3,333019,333019,333022,0,3,4
95069,2,1,333021,333022,333023,1,2,0
95070,6,3,333027,333027,333030,0,3,4
95071,4,1,333031,333031,333032,0,1,1
95072,6,1,333037,333037,333038,0,1,5
95073,2,3,333039,333039,333042,0,3,1
95074,1,3,333040,333042,333045,2,5,0
95075,2,2,333042,333045,333047,3,5,0
95076,2,2,333044,333047,333049,3,5,0
95077,2,3,333046,333049,333052,3,6,0
95078,2,1,333048,333052,333053,4,5,0
95079,1,2,333049,333053,333055,4,6,0
95080,1,1,333050,333055,333056,5,6,0
95081,5,3,333055,333056,333059,1,4,0
95082,6,3,333061,333061,333064,0,3,2
95083,4,1,333065,333065,333066,0,1,1
95084,2,2,333067,333067,333069,0,2,1
95085,1,2,333068,333069,333071,1,3,0
95086,6,3,333074,333074,333077,0,3,3
95087,3,2,333077,333077,333079,0,2,0
95088,5,1,333082,333082,333083,0,1,3
95089,5,3,333087,333087,333090,0,3,4
95090,2,2,333089,333090,333092,1,3,0
95091,1,3,333090,333092,333095,2,5,0
95092,6,3,333096,333096,333099,0,3,1
95093,6,2,333102,333102,333104,0,2,3
95094,4,2,333106,333106,333108,0,2,2
95095,6,3,333112,333112,333115,0,3,4
95096,6,1,333118,333118,333119,0,1,3
95097,5,1,333123,333123,333124,0,1,4
95098,6,1,333129,333129,333130,0,1,5
95099,2,3,333131,333131,333134,0,3,1
95100,3,1,333134,333134,333135,0,1,0
95101,1,1,333135,333135,333136,0,1,0
95102,6,2,333141,333141,333143,0,2,5
95103,6,1,333147,333147,333148,0,1,4
95104,3,1,333150,333150,333151,0,1,2
95105,6,2,333156,333156,333158,0,2,5
95106,2,2,333158,333158,333160,0,2,0
95107,4,3,333162,333162,333165,0,3,2
95108,2,1,333164,333165,333166,1,2,0
95109,3,3,333167,333167,333170,0,3,1
95110,6,3,333173,333173,333176,0,3,3
95111,5,2,333178,333178,333180,0,2,2
95112,4,3,333182,333182,333185,0,3,2
95113,1,3,333183,333185,333188,2,5,0
95114,3,2,333186,333188,333190,2,4,0
95115,4,2,333190,333190,333192,0,2,0
95116,4,2,333194,333194,333196,0,2,2
95117,6,1,333200,333200,333201,0,1,4
95118,6,2,333206,333206,333208,0,2,5
95119,2,2,333208,333208,333210,0,2,0
95120,4,3,333212,333212,333215,0,3,2
95121,2,3,333214,333215,333218,1,4,0
95122,3,1,333217,333218,333219,1,2,0
95123,5,3,333222,333222,333225,0,3,3
95124,1,3,333223,333225,333228,2,5,0
95125,5,1,333228,333228,333229,0,1,0
95126,5,1,333233,333233,333234,0,1,4
95127,1,2,333234,333234,333236,0,2,0
95128,5,2,333239,333239,333241,0,2,3
95129,4,1,333243,333243,333244,0,1,2
95130,4,1,333247,333247,333248,0,1,3
95131,1,2,333248,333248,333250,0,2,0
95132,5,3,333253,333253,333256,0,3,3
95133,4,3,333257,333257,333260,0,3,1
95134,4,1,333261,333261,333262,0,1,1
95135,6,3,333267,333267,333270,0,3,5
95136,2,3,333269,333270,333273,1,4,0
95137,6,2,333275,333275,333277,0,2,2
95138,2,2,333277,333277,333279,0,2,0
95139,2,2,333279,333279,333281,0,2,0
95140,1,3,333280,333281,333284,1,4,0
95141,2,2,333282,333284,333286,2,4,0
95142,4,2,333286,333286,333288,0,2,0
95143,6,3,333292,333292,333295,0,3,4
95144,1,1,333293,333295,333296,2,3,0
95145,5,2,333298,333298,333300,0,2,2
95146,6,3,333304,333304,333307,0,3,4
95147,1,1,333305,333307,333308,2,3,0
95148,1,2,333306,333308,333310,2,4,0
95149,2,2,333308,333310,333312,2,4,0
95150,6,1,333314,333314,333315,0,1,2
95151,3,3,333317,333317,333320,0,3,2
95152,6,3,333323,333323,333326,0,3,3
95153,6,2,333329,333329,333331,0,2,3
95154,5,3,333334,333334,333337,0,3,3
95155,6,2,333340,333340,333342,0,2,3
95156,5,1,333345,333345,333346,0,1,3
95157,4,1,333349,333349,333350,0,1,3
95158,1,3,333350,333350,333353,0,3,0
95159,2,3,333352,333353,333356,1,4,0
95160,4,1,333356,333356,333357,0,1,0
95161,5,3,333361,333361,333364,0,3,4
95162,2,1,333363,333364,333365,1,2,0
95163,4,1,333367,333367,333368,0,1,2
95164,6,3,333373,333373,333376,0,3,5
95165,2,3,333375,333376,333379,1,4,0
95166,5,2,333380,333380,333382,0,2,1
95167,6,2,333386,333386,333388,0,2,4
95168,2,1,333388,333388,333389,0,1,0
95169,4,1,333392,333392,333393,0,1,3
95170,1,1,333393,333393,333394,0,1,0
95171,1,1,333394,333394,333395,0,1,0
95172,6,1,333400,333400,333401,0,1,5
95173,6,1,333406,333406,333407,0,1,5
95174,3,1,333409,333409,333410,0,1,2
95175,5,3,333414,333414,333417,0,3,4
95176,4,2,333418,333418,333420,0,2,1
95177,4,3,333422,333422,333425,0,3,2
95178,2,1,333424,333425,333426,1,2,0
95179,1,3,333425,333426,333429,1,4,0
95180,6,3,333431,333431,333434,0,3,2
95181,3,1,333434,333434,333435,0,1,0
95182,6,1,333440,333440,333441,0,1,5
95183,5,2,333445,333445,333447,0,2,4
95184,2,3,333447,333447,333450,0,3,0
95185,1,3,333448,333450,333453,2,5,0
95186,5,1,333453,333453,333454,0,1,0
95187,3,2,333456,333456,333458,0,2,2
95188,2,1,333458,333458,333459,0,1,0
95189,5,1,333463,333463,333464,0,1,4
95190,5,1,333468,333468,333469,0,1,4
95191,3,3,333471,333471,333474,0,3,2
95192,1,2,333472,333474,333476,2,4,0
95193,6,3,333478,333478,333481,0,3,2
95194,3,3,333481,333481,333484,0,3,0
95195,4,2,333485,333485,333487,0,2,1
95196,1,3,333486,333487,333490,1,4,0
95197,2,3,333488,333490,333493,2,5,0
95198,2,1,333490,333493,333494,3,4,0
95199,4,2,333494,333494,333496,0,2,0
95200,3,2,333497,333497,333499,0,2,1
95201,1,3,333498,333499,333502,1,4,0
95202,1,1,333499,333502,333503,3,4,0
95203,1,2,333500,333503,333505,3,5,0
95204,1,3,333501,333505,333508,4,7,0
95205,4,1,333505,333508,333509,3,4,0
95206,6,2,333511,333511,333513,0,2,2
95207,4,3,333515,333515,333518,0,3,2
95208,5,2,333520,333520,333522,0,2,2
95209,3,3,333523,333523,333526,0,3,1
95210,4,3,333527,333527,333530,0,3,1
95211,1,3,333528,333530,333533,2,5,0
95212,3,1,333531,333533,333534,2,3,0
95213,3,2,333534,333534,333536,0,2,0
95214,3,2,333537,333537,333539,0,2,1
95215,4,2,333541,333541,333543,0,2,2
95216,4,3,333545,333545,333548,0,3,2
95217,6,1,333551,333551,333552,0,1,3
95218,6,2,333557,333557,333559,0,2,5
95219,5,3,333562,333562,333565,0,3,3
95220,3,3,333565,333565,333568,0,3,0
95221,3,1,333568,333568,333569,0,1,0
95222,4,3,333572,333572,333575,0,3,3
95223,6,1,333578,333578,333579,0,1,3
95224,6,3,333584,333584,333587,0,3,5
95225,3,2,333587,333587,333589,0,2,0
95226,1,1,333588,333589,333590,1,2,0
95227,5,1,333593,333593,333594,0,1,3
95228,2,1,333595,333595,333596,0,1,1
95229,3,1,333598,333598,333599,0,1,2
95230,6,2,333604,333604,333606,0,2,5
95231,4,2,333608,333608,333610,0,2,2
95232,1,2,333609,333610,333612,1,3,0
95233,2,3,333611,333612,333615,1,4,0
95234,6,3,333617,333617,333620,0,3,2
95235,2,1,333619,333620,333621,1,2,0
95236,3,2,333622,333622,333624,0,2,1
95237,4,1,333626,333626,333627,0,1,2
95238,2,3,333628,333628,333631,0,3,1
95239,5,3,333633,333633,333636,0,3,2
95240,3,3,333636,333636,333639,0,3,0
95241,5,2,333641,333641,333643,0,2,2
95242,6,1,333647,333647,333648,0,1,4
95243,4,1,333651,333651,333652,0,1,3
95244,3,3,333654,333654,333657,0,3,2
95245,1,2,333655,333657,333659,2,4,0
95246,1,1,333656,333659,333660,3,4,0
95247,5,2,333661,333661,333663,0,2,1
95248,5,3,333666,333666,333669,0,3,3
95249,3,2,333669,333669,333671,0,2,0
95250,1,2,333670,333671,333673,1,3,0
95251,2,1,333672,333673,333674,1,2,0
95252,1,1,333673,333674,333675,1,2,0
95253,4,1,333677,333677,333678,0,1,2
95254,3,2,333680,333680,333682,0,2,2
95255,6,3,333686,333686,333689,0,3,4
95256,4,1,333690,333690,333691,0,1,1
95257,6,1,333696,333696,333697,0,1,5
95258,3,2,333699,333699,333701,0,2,2
95259,4,2,333703,333703,333705,0,2,2
95260,4,1,333707,333707,333708,0,1,2
95261,6,1,333713,333713,333714,0,1,5
95262,3,2,333716,333716,333718,0,2,2
95263,6,2,333722,333722,333724,0,2,4
95264,6,2,333728,333728,333730,0,2,4
95265,3,3,333731,333731,333734,0,3,1
95266,3,3,333734,333734,333737,0,3,0
95267,5,2,333739,333739,333741,0,2,2
95268,4,1,333743,333743,333744,0,1,2
95269,6,2,333749,333749,333751,0,2,5
95270,2,1,333751,333751,333752,0,1,0
95271,5,3,333756,333756,333759,0,3,4
95272,2,3,333758,333759,333762,1,4,0
95273,5,3,333763,333763,333766,0,3,1
95274,2,3,333765,333766,333769,1,4,0
95275,3,1,333768,333769,333770,1,2,0
95276,1,3,333769,333770,333773,1,4,0
95277,1,3,333770,333773,333776,3,6,0
95278,5,1,333775,333776,333777,1,2,0
95279,5,2,333780,333780,333782,0,2,3
95280,6,1,333786,333786,333787,0,1,4
95281,4,2,333790,333790,333792,0,2,3
95282,4,3,333794,333794,333797,0,3,2
95283,6,3,333800,333800,333803,0,3,3
95284,4,3,333804,333804,333807,0,3,1
95285,5,3,333809,333809,333812,0,3,2
95286,4,2,333813,333813,333815,0,2,1
95287,2,1,333815,333815,333816,0,1,0
95288,5,1,333820,333820,333821,0,1,4
95289,6,1,333826,333826,333827,0,1,5
95290,3,1,333829,333829,333830,0,1,2
95291,3,2,333832,333832,333834,0,2,2
95292,4,2,333836,333836,333838,0,2,2
95293,2,3,333838,333838,333841,0,3,0
95294,3,3,333841,333841,333844,0,3,0
95295,6,1,333847,333847,333848,0,1,3
95296,3,1,333850,333850,333851,0,1,2
95297,4,3,333854,333854,333857,0,3,3
95298,6,2,333860,333860,333862,0,2,3
95299,1,1,333861,333862,333863,1,2,0
95300,5,2,333866,333866,333868,0,2,3
95301,3,3,333869,333869,333872,0,3,1
95302,4,2,333873,333873,333875,0,2,1
95303,2,3,333875,333875,333878,0,3,0
95304,3,3,333878,333878,333881,0,3,0
95305,3,3,333881,333881,333884,0,3,0
95306,6,3,333887,333887,333890,0,3,3
95307,1,2,333888,333890,333892,2,4,0
95308,2,1,333890,333892,333893,2,3,0
95309,5,1,333895,333895,333896,0,1,2
95310,3,2,333898,333898,333900,0,2,2
95311,1,1,333899,333900,333901,1,2,0
95312,2,1,333901,333901,333902,0,1,0
95313,4,3,333905,333905,333908,0,3,3
95314,5,2,333910,333910,333912,0,2,2
95315,4,2,333914,333914,333916,0,2,2
95316,3,1,333917,333917,333918,0,1,1
95317,6,2,333923,333923,333925,0,2,5
95318,5,3,333928,333928,333931,0,3,3
95319,1,1,333929,333931,333932,2,3,0
95320,3,3,333932,333932,333935,0,3,0
95321,3,1,333935,333935,333936,0,1,0
95322,6,3,333941,333941,333944,0,3,5
95323,4,1,333945,333945,333946,0,1,1
95324,5,2,333950,333950,333952,0,2,4
95325,3,3,333953,333953,333956,0,3,1
95326,2,1,333955,333956,333957,1,2,0
95327,1,2,333956,333957,333959,1,3,0
95328,2,2,333958,333959,333961,1,3,0
95329,1,1,333959,333961,333962,2,3,0
95330,3,2,333962,333962,333964,0,2,0
95331,1,1,333963,333964,333965,1,2,0
95332,1,3,333964,333965,333968,1,4,0
95333,2,3,333966,333968,333971,2,5,0
95334,5,1,333971,333971,333972,0,1,0
95335,3,2,333974,333974,333976,0,2,2
95336,1,1,333975,333976,333977,1,2,0
95337,4,3,333979,333979,333982,0,3,2
95338,2,2,333981,333982,333984,1,3,0
95339,5,1,333986,333986,333987,0,1,2
95340,3,3,333989,333989,333992,0,3,2
95341,3,1,333992,333992,333993,0,1,0
95342,4,1,333996,333996,333997,0,1,3
95343,1,2,333997,333997,333999,0,2,0
95344,2,1,333999,333999,334000,0,1,0
95345,4,2,334003,334003,334005,0,2,3
95346,2,3,334005,334005,334008,0,3,0
95347,6,2,334011,334011,334013,0,2,3
95348,5,3,334016,334016,334019,0,3,3
95349,1,2,334017,334019,334021,2,4,0
95350,5,1,334022,334022,334023,0,1,1
95351,3,2,334025,334025,334027,0,2,2
95352,2,2,334027,334027,334029,0,2,0
95353,1,3,334028,334029,334032,1,4,0
95354,3,3,334031,334032,334035,1,4,0
95355,5,3,334036,334036,334039,0,3,1
95356,4,1,334040,334040,334041,0,1,1
95357,1,2,334041,334041,334043,0,2,0
95358,6,3,334047,334047,334050,0,3,4
95359,1,2,334048,334050,334052,2,4,0
95360,5,3,334053,334053,334056,0,3,1
95361,3,2,334056,334056,334058,0,2,0
95362,3,1,334059,334059,334060,0,1,1
95363,5,3,334064,334064,334067,0,3,4
95364,5,2,334069,334069,334071,0,2,2
95365,2,1,334071,334071,334072,0,1,0
95366,5,2,334076,334076,334078,0,2,4
95367,1,1,334077,334078,334079,1,2,0
95368,3,3,334080,334080,334083,0,3,1
95369,6,1,334086,334086,334087,0,1,3
95370,5,2,334091,334091,334093,0,2,4
95371,3,3,334094,334094,334097,0,3,1
95372,1,1,334095,334097,334098,2,3,0
95373,3,3,334098,334098,334101,0,3,0
95374,5,2,334103,334103,334105,0,2,2
95375,4,1,334107,334107,334108,0,1,2
95376,4,2,334111,334111,334113,0,2,3
95377,6,2,334117,334117,334119,0,2,4
95378,3,1,334120,334120,334121,0,1,1
95379,3,2,334123,334123,334125,0,2,2
95380,2,3,334125,334125,334128,0,3,0
95381,6,2,334131,334131,334133,0,2,3
95382,2,3,334133,334133,334136,0,3,0
95383,1,3,334134,334136,334139,2,5,0
95384,1,3,334135,334139,334142,4,7,0
95385,6,2,334141,334142,334144,1,3,0
95386,5,2,334146,334146,334148,0,2,2
95387,3,2,334149,334149,334151,0,2,1
95388,1,2,334150,334151,334153,1,3,0
95389,1,3,334151,334153,334156,2,5,0
95390,6,3,334157,334157,334160,0,3,1
95391,5,3,334162,334162,334165,0,3,2
95392,5,2,334167,334167,334169,0,2,2
95393,6,1,334173,334173,334174,0,1,4
95394,5,2,334178,334178,334180,0,2,4
95395,6,1,334184,334184,334185,0,1,4
95396,3,1,334187,334187,334188,0,1,2
95397,5,2,334192,334192,334194,0,2,4
95398,6,2,334198,334198,334200,0,2,4
95399,5,1,334203,334203,334204,0,1,3
95400,6,1,334209,334209,334210,0,1,5
95401,3,1,334212,334212,334213,0,1,2
95402,2,2,334214,334214,334216,0,2,1
95403,1,1,334215,334216,334217,1,2,0
95404,2,1,334217,334217,334218,0,1,0
95405,5,1,334222,334222,334223,0,1,4
95406,3,3,334225,334225,334228,0,3,2
95407,2,2,334227,334228,334230,1,3,0
95408,6,3,334233,334233,334236,0,3,3
95409,3,1,334236,334236,334237,0,1,0
95410,3,3,334239,334239,334242,0,3,2
95411,5,2,334244,334244,334246,0,2,2
95412,5,1,334249,334249,334250,0,1,3
95413,4,1,334253,334253,334254,0,1,3
95414,2,2,334255,334255,334257,0,2,1
95415,2,2,334257,334257,334259,0,2,0
95416,5,3,334262,334262,334265,0,3,3
95417,2,3,334264,334265,334268,1,4,0
95418,1,1,334265,334268,334269,3,4,0
95419,5,1,334270,334270,334271,0,1,1
95420,5,1,334275,334275,334276,0,1,4
95421,4,1,334279,334279,334280,0,1,3
95422,6,2,334285,334285,334287,0,2,5
95423,2,2,334287,334287,334289,0,2,0
95424,5,3,334292,334292,334295,0,3,3
95425,4,1,334296,334296,334297,0,1,1
95426,2,2,334298,334298,334300,0,2,1
95427,4,1,334302,334302,334303,0,1,2
95428,3,3,334305,334305,334308,0,3,2
95429,6,1,334311,334311,334312,0,1,3
95430,4,1,334315,334315,334316,0,1,3
95431,4,1,334319,334319,334320,0,1,3
95432,5,2,334324,334324,334326,0,2,4
95433,2,3,334326,334326,334329,0,3,0
95434,1,3,334327,334329,334332,2,5,0
95435,6,1,334333,334333,334334,0,1,1
95436,2,2,334335,334335,334337,0,2,1
95437,3,2,334338,334338,334340,0,2,1
95438,5,1,334343,334343,334344,0,1,3
95439,4,1,334347,334347,334348,0,1,3
95440,4,1,334351,334351,334352,0,1,3
95441,4,1,334355,334355,334356,0,1,3
95442,5,1,334360,334360,334361,0,1,4
95443,4,1,334364,334364,334365,0,1,3
95444,4,1,334368,334368,334369,0,1,3
95445,3,2,334371,334371,334373,0,2,2
95446,2,2,334373,334373,334375,0,2,0
95447,5,2,334378,334378,334380,0,2,3
95448,3,1,334381,334381,334382,0,1,1
95449,2,1,334383,334383,334384,0,1,1
95450,3,3,334386,334386,334389,0,3,2
95451,1,1,334387,334389,334390,2,3,0
95452,6,1,334393,334393,334394,0,1,3
95453,6,2,334399,334399,334401,0,2,5
95454,2,2,334401,334401,334403,0,2,0
95455,1,3,334402,334403,334406,1,4,0
95456,1,2,334403,334406,334408,3,5,0
95457,4,3,334407,334408,334411,1,4,0
95458,5,2,334412,334412,334414,0,2,1
95459,5,3,334417,334417,334420,0,3,3
95460,2,3,334419,334420,334423,1,4,0
95461,5,3,334424,334424,334427,0,3,1
95462,5,2,334429,334429,334431,0,2,2
95463,2,3,334431,334431,334434,0,3,0
95464,3,3,334434,334434,334437,0,3,0
95465,4,1,334438,334438,334439,0,1,1
95466,3,2,334441,334441,334443,0,2,2
95467,1,3,334442,334443,334446,1,4,0
95468,2,2,334444,334446,334448,2,4,0
95469,5,2,334449,334449,334451,0,2,1
95470,3,3,334452,334452,334455,0,3,1
95471,3,3,334455,334455,334458,0,3,0
95472,4,2,334459,334459,334461,0,2,1
95473,5,3,334464,334464,334467,0,3,3
95474,2,1,334466,334467,334468,1,2,0
95475,2,2,334468,334468,334470,0,2,0
95476,3,3,334471,334471,334474,0,3,1
95477,2,2,334473,334474,334476,1,3,0
95478,1,2,334474,334476,334478,2,4,0
95479,5,2,334479,334479,334481,0,2,1
95480,4,1,334483,334483,334484,0,1,2
95481,5,2,334488,334488,334490,0,2,4
95482,3,2,334491,334491,334493,0,2,1
95483,3,3,334494,334494,334497,0,3,1
95484,1,1,334495,334497,334498,2,3,0
95485,1,3,334496,334498,334501,2,5,0
95486,1,2,334497,334501,334503,4,6,0
95487,4,2,334501,334503,334505,2,4,0
95488,1,3,334502,334505,334508,3,6,0
95489,4,2,334506,334508,334510,2,4,0
95490,4,2,334510,334510,334512,0,2,0
95491,5,2,334515,334515,334517,0,2,3
95492,2,2,334517,334517,334519,0,2,0
95493,1,2,334518,334519,334521,1,3,0
95494,2,1,334520,334521,334522,1,2,0
95495,4,1,334524,334524,334525,0,1,2
95496,6,3,334530,334530,334533,0,3,5
95497,3,3,334533,334533,334536,0,3,0
95498,4,3,334537,334537,334540,0,3,1
95499,2,3,334539,334540,334543,1,4,0
95500,1,1,334540,334543,334544,3,4,0
95501,3,2,334543,334544,334546,1,3,0
95502,6,1,334549,334549,334550,0,1,3
95503,5,2,334554,334554,334556,0,2,4
95504,6,1,334560,334560,334561,0,1,4
95505,1,1,334561,334561,334562,0,1,0
95506,6,1,334567,334567,334568,0,1,5
95507,2,1,334569,334569,334570,0,1,1
95508,6,3,334575,334575,334578,0,3,5
95509,4,3,334579,334579,334582,0,3,1
95510,2,2,334581,334582,334584,1,3,0
95511,6,2,334587,334587,334589,0,2,3
95512,4,3,334591,334591,334594,0,3,2
95513,4,1,334595,334595,334596,0,1,1
95514,4,3,334599,334599,334602,0,3,3
95515,1,2,334600,334602,334604,2,4,0
95516,2,3,334602,334604,334607,2,5,0
95517,1,3,334603,334607,334610,4,7,0
95518,1,3,334604,334610,334613,6,9,0
95519,2,3,334606,334613,334616,7,10,0
95520,3,2,334609,334616,334618,7,9,0
95521,3,1,334612,334618,334619,6,7,0
95522,3,3,334615,334619,334622,4,7,0
95523,5,3,334620,334622,334625,2,5,0
95524,1,2,334621,334625,334627,4,6,0
95525,1,3,334622,334627,334630,5,8,0
95526,6,3,334628,334630,334633,2,5,0
95527,1,3,334629,334633,334636,4,7,0
95528,4,3,334633,334636,334639,3,6,0
95529,4,2,334637,334639,334641,2,4,0
95530,1,2,334638,334641,334643,3,5,0
95531,4,2,334642,334643,334645,1,3,0
95532,5,2,334647,334647,334649,0,2,2
95533,1,1,334648,334649,334650,1,2,0
95534,6,1,334654,334654,334655,0,1,4
95535,2,1,334656,334656,334657,0,1,1
95536,6,1,334662,334662,334663,0,1,5
95537,4,3,334666,334666,334669,0,3,3
95538,1,1,334667,334669,334670,2,3,0
95539,1,3,334668,334670,334673,2,5,0
95540,3,1,334671,334673,334674,2,3,0
95541,6,3,334677,334677,334680,0,3,3
95542,4,2,334681,334681,334683,0,2,1
95543,1,1,334682,334683,334684,1,2,0
95544,5,1,334687,334687,334688,0,1,3
95545,1,2,334688,334688,334690,0,2,0
95546,5,3,334693,334693,334696,0,3,3
95547,1,3,334694,334696,334699,2,5,0
95548,5,1,334699,334699,334700,0,1,0
95549,3,2,334702,334702,334704,0,2,2
95550,4,2,334706,334706,334708,0,2,2
95551,5,1,334711,334711,334712,0,1,3
95552,3,2,334714,334714,334716,0,2,2
95553,1,3,334715,334716,334719,1,4,0
95554,1,2,334716,334719,334721,3,5,0
95555,2,2,334718,334721,334723,3,5,0
95556,3,2,334721,334723,334725,2,4,0
95557,3,2,334724,334725,334727,1,3,0
95558,4,2,334728,334728,334730,0,2,1
95559,2,3,334730,334730,334733,0,3,0
95560,5,1,334735,334735,334736,0,1,2
95561,2,3,334737,334737,334740,0,3,1
95562,3,2,334740,334740,334742,0,2,0
95563,1,3,334741,334742,334745,1,4,0
95564,1,1,334742,334745,334746,3,4,0
95565,2,2,334744,334746,334748,2,4,0
95566,3,1,334747,334748,334749,1,2,0
95567,1,2,334748,334749,334751,1,3,0
95568,6,1,334754,334754,334755,0,1,3
95569,3,1,334757,334757,334758,0,1,2
95570,4,2,334761,334761,334763,0,2,3
95571,3,2,334764,334764,334766,0,2,1
95572,6,1,334770,334770,334771,0,1,4
95573,2,1,334772,334772,334773,0,1,1
95574,3,1,334775,334775,334776,0,1,2
95575,3,2,334778,334778,334780,0,2,2
95576,2,2,334780,334780,334782,0,2,0
95577,3,2,334783,334783,334785,0,2,1
95578,4,2,334787,334787,334789,0,2,2
95579,3,2,334790,334790,334792,0,2,1
95580,6,2,334796,334796,334798,0,2,4
95581,5,2,334801,334801,334803,0,2,3
95582,3,1,334804,334804,334805,0,1,1
95583,6,2,334810,334810,334812,0,2,5
95584,5,3,334815,334815,334818,0,3,3
95585,6,3,334821,334821,334824,0,3,3
95586,2,1,334823,334824,334825,1,2,0
95587,1,3,334824,334825,334828,1,4,0
95588,4,2,334828,334828,334830,0,2,0
95589,4,3,334832,334832,334835,0,3,2
95590,4,1,334836,334836,334837,0,1,1
95591,6,3,334842,334842,334845,0,3,5
95592,1,1,334843,334845,334846,2,3,0
95593,2,3,334845,334846,334849,1,4,0
95594,2,2,334847,334849,334851,2,4,0
95595,3,1,334850,334851,334852,1,2,0
95596,2,3,334852,334852,334855,0,3,0
95597,4,2,334856,334856,334858,0,2,1
95598,6,2,334862,334862,334864,0,2,4
95599,2,1,334864,334864,334865,0,1,0
95600,1,2,334865,334865,334867,0,2,0
95601,4,3,334869,334869,334872,0,3,2
95602,2,1,334871,334872,334873,1,2,0
95603,4,3,334875,334875,334878,0,3,2
95604,6,1,334881,334881,334882,0,1,3
95605,6,2,334887,334887,334889,0,2,5
95606,2,2,334889,334889,334891,0,2,0
95607,1,1,334890,334891,334892,1,2,0
95608,5,1,334895,334895,334896,0,1,3
95609,5,2,334900,334900,334902,0,2,4
95610,2,1,334902,334902,334903,0,1,0
95611,1,2,334903,334903,334905,0,2,0
95612,6,1,334909,334909,334910,0,1,4
95613,3,1,334912,334912,334913,0,1,2
95614,4,1,334916,334916,334917,0,1,3
95615,2,2,334918,334918,334920,0,2,1
95616,3,1,334921,334921,334922,0,1,1
95617,2,3,334923,334923,334926,0,3,1
95618,6,3,334929,334929,334932,0,3,3
95619,1,1,334930,334932,334933,2,3,0
95620,2,3,334932,334933,334936,1,4,0
95621,3,3,334935,334936,334939,1,4,0
95622,4,1,334939,334939,334940,0,1,0
95623,1,1,334940,334940,334941,0,1,0
95624,4,3,334944,334944,334947,0,3,3
95625,1,3,334945,334947,334950,2,5,0
95626,2,3,334947,334950,334953,3,6,0
95627,2,2,334949,334953,334955,4,6,0
95628,4,3,334953,334955,334958,2,5,0
95629,4,1,334957,334958,334959,1,2,0
95630,3,2,334960,334960,334962,0,2,1
95631,3,1,334963,334963,334964,0,1,1
95632,6,2,334969,334969,334971,0,2,5
95633,1,2,334970,334971,334973,1,3,0
95634,3,1,334973,334973,334974,0,1,0
95635,1,3,334974,334974,334977,0,3,0
95636,4,2,334978,334978,334980,0,2,1
95637,4,2,334982,334982,334984,0,2,2
95638,5,2,334987,334987,334989,0,2,3
95639,5,1,334992,334992,334993,0,1,3
95640,4,3,334996,334996,334999,0,3,3
95641,4,1,335000,335000,335001,0,1,1
95642,1,2,335001,335001,335003,0,2,0
95643,4,3,335005,335005,335008,0,3,2
95644,1,1,335006,335008,335009,2,3,0
95645,2,1,335008,335009,335010,1,2,0
95646,5,3,335013,335013,335016,0,3,3
95647,2,3,335015,335016,335019,1,4,0
95648,1,1,335016,335019,335020,3,4,0
95649,6,2,335022,335022,335024,0,2,2
95650,5,3,335027,335027,335030,0,3,3
95651,3,2,335030,335030,335032,0,2,0
95652,3,1,335033,335033,335034,0,1,1
95653,1,3,335034,335034,335037,0,3,0
95654,2,3,335036,335037,335040,1,4,0
95655,5,2,335041,335041,335043,0,2,1
95656,6,3,335047,335047,335050,0,3,4
95657,6,3,335053,335053,335056,0,3,3
95658,3,3,335056,335056,335059,0,3,0
95659,1,3,335057,335059,335062,2,5,0
95660,5,3,335062,335062,335065,0,3,0
95661,4,1,335066,335066,335067,0,1,1
95662,5,1,335071,335071,335072,0,1,4
95663,3,2,335074,335074,335076,0,2,2
95664,6,2,335080,335080,335082,0,2,4
95665,3,2,335083,335083,335085,0,2,1
95666,1,1,335084,335085,335086,1,2,0
95667,4,1,335088,335088,335089,0,1,2
95668,6,2,335094,335094,335096,0,2,5
95669,4,2,335098,335098,335100,0,2,2
95670,6,1,335104,335104,335105,0,1,4
95671,6,2,335110,335110,335112,0,2,5
95672,1,3,335111,335112,335115,1,4,0
95673,5,1,335116,335116,335117,0,1,1
95674,1,2,335117,335117,335119,0,2,0
95675,4,2,335121,335121,335123,0,2,2
95676,5,1,335126,335126,335127,0,1,3
95677,5,1,335131,335131,335132,0,1,4
95678,1,1,335132,335132,335133,0,1,0
95679,1,1,335133,335133,335134,0,1,0
95680,3,1,335136,335136,335137,0,1,2
95681,1,3,335137,335137,335140,0,3,0
95682,3,2,335140,335140,335142,0,2,0
95683,1,3,335141,335142,335145,1,4,0
95684,5,3,335146,335146,335149,0,3,1
95685,3,1,335149,335149,335150,0,1,0
95686,1,3,335150,335150,335153,0,3,0
95687,6,3,335156,335156,335159,0,3,3
95688,1,2,335157,335159,335161,2,4,0
95689,6,2,335163,335163,335165,0,2,2
95690,1,1,335164,335165,335166,1,2,0
95691,4,1,335168,335168,335169,0,1,2
95692,2,3,335170,335170,335173,0,3,1
95693,1,2,335171,335173,335175,2,4,0
95694,2,3,335173,335175,335178,2,5,0
95695,4,3,335177,335178,335181,1,4,0
95696,1,2,335178,335181,335183,3,5,0
95697,6,2,335184,335184,335186,0,2,1
95698,4,3,335188,335188,335191,0,3,2
95699,2,3,335190,335191,335194,1,4,0
95700,4,3,335194,335194,335197,0,3,0
95701,1,3,335195,335197,335200,2,5,0
95702,1,1,335196,335200,335201,4,5,0
95703,2,3,335198,335201,335204,3,6,0
95704,1,1,335199,335204,335205,5,6,0
95705,3,3,335202,335205,335208,3,6,0
95706,5,2,335207,335208,335210,1,3,0
95707,1,1,335208,335210,335211,2,3,0
95708,1,2,335209,335211,335213,2,4,0
95709,3,3,335212,335213,335216,1,4,0
95710,6,1,335218,335218,335219,0,1,2
95711,1,3,335219,335219,335222,0,3,0
95712,3,2,335222,335222,335224,0,2,0
95713,1,3,335223,335224,335227,1,4,0
95714,2,3,335225,335227,335230,2,5,0
95715,5,3,335230,335230,335233,0,3,0
95716,1,2,335231,335233,335235,2,4,0
95717,5,3,335236,335236,335239,0,3,1
95718,4,1,335240,335240,335241,0,1,1
95719,2,1,335242,335242,335243,0,1,1
95720,1,1,335243,335243,335244,0,1,0
95721,5,3,335248,335248,335251,0,3,4
95722,5,1,335253,335253,335254,0,1,2
95723,1,3,335254,335254,335257,0,3,0
95724,3,2,335257,335257,335259,0,2,0
95725,2,1,335259,335259,335260,0,1,0
95726,5,2,335264,335264,335266,0,2,4
95727,2,1,335266,335266,335267,0,1,0
95728,4,2,335270,335270,335272,0,2,3
95729,2,2,335272,335272,335274,0,2,0
95730,1,2,335273,335274,335276,1,3,0
95731,4,1,335277,335277,335278,0,1,1
95732,3,3,335280,335280,335283,0,3,2
95733,5,1,335285,335285,335286,0,1,2
95734,5,2,335290,335290,335292,0,2,4
95735,1,1,335291,335292,335293,1,2,0
95736,6,2,335297,335297,335299,0,2,4
95737,4,3,335301,335301,335304,0,3,2
95738,5,3,335306,335306,335309,0,3,2
95739,2,1,335308,335309,335310,1,2,0
95740,3,3,335311,335311,335314,0,3,1
95741,4,2,335315,335315,335317,0,2,1
95742,4,3,335319,335319,335322,0,3,2
95743,1,2,335320,335322,335324,2,4,0
95744,5,1,335325,335325,335326,0,1,1
95745,4,2,335329,335329,335331,0,2,3
95746,4,2,335333,335333,335335,0,2,2
95747,6,2,335339,335339,335341,0,2,4
95748,3,3,335342,335342,335345,0,3,1
95749,2,3,335344,335345,335348,1,4,0
95750,4,3,335348,335348,335351,0,3,0
95751,2,1,335350,335351,335352,1,2,0
95752,3,1,335353,335353,335354,0,1,1
95753,3,3,335356,335356,335359,0,3,2
95754,3,2,335359,335359,335361,0,2,0
95755,1,2,335360,335361,335363,1,3,0
95756,2,3,335362,335363,335366,1,4,0
95757,2,3,335364,335366,335369,2,5,0
95758,5,3,335369,335369,335372,0,3,0
95759,2,2,335371,335372,335374,1,3,0
95760,2,3,335373,335374,335377,1,4,0
95761,6,1,335379,335379,335380,0,1,2
95762,5,3,335384,335384,335387,0,3,4
95763,1,1,335385,335387,335388,2,3,0
95764,6,3,335391,335391,335394,0,3,3
95765,2,3,335393,335394,335397,1,4,0
95766,3,1,335396,335397,335398,1,2,0
95767,3,3,335399,335399,335402,0,3,1
95768,3,1,335402,335402,335403,0,1,0
95769,5,2,335407,335407,335409,0,2,4
95770,1,1,335408,335409,335410,1,2,0
95771,1,1,335409,335410,335411,1,2,0
95772,2,2,335411,335411,335413,0,2,0
95773,5,3,335416,335416,335419,0,3,3
95774,2,3,335418,335419,335422,1,4,0
95775,3,2,335421,335422,335424,1,3,0
95776,4,2,335425,335425,335427,0,2,1
95777,4,2,335429,335429,335431,0,2,2
95778,2,2,335431,335431,335433,0,2,0
95779,4,1,335435,335435,335436,0,1,2
95780,3,3,335438,335438,335441,0,3,2
95781,4,2,335442,335442,335444,0,2,1
95782,4,1,335446,335446,335447,0,1,2
95783,5,3,335451,335451,335454,0,3,4
95784,4,1,335455,335455,335456,0,1,1
95785,3,2,335458,335458,335460,0,2,2
95786,4,3,335462,335462,335465,0,3,2
95787,6,1,335468,335468,335469,0,1,3
95788,4,2,335472,335472,335474,0,2,3
95789,1,2,335473,335474,335476,1,3,0
95790,6,3,335479,335479,335482,0,3,3
95791,2,3,335481,335482,335485,1,4,0
95792,1,1,335482,335485,335486,3,4,0
95793,4,3,335486,335486,335489,0,3,0
95794,5,3,335491,335491,335494,0,3,2
95795,3,3,335494,335494,335497,0,3,0
95796,3,2,335497,335497,335499,0,2,0
95797,2,2,335499,335499,335501,0,2,0
95798,4,1,335503,335503,335504,0,1,2
95799,6,3,335509,335509,335512,0,3,5
95800,3,2,335512,335512,335514,0,2,0
95801,6,1,335518,335518,335519,0,1,4
95802,3,2,335521,335521,335523,0,2,2
95803,5,2,335526,335526,335528,0,2,3
95804,3,2,335529,335529,335531,0,2,1
95805,2,3,335531,335531,335534,0,3,0
95806,1,3,335532,335534,335537,2,5,0
95807,3,3,335535,335537,335540,2,5,0
95808,1,2,335536,335540,335542,4,6,0
95809,3,2,335539,335542,335544,3,5,0
95810,2,1,335541,335544,335545,3,4,0
95811,1,1,335542,335545,335546,3,4,0
95812,5,1,335547,335547,335548,0,1,1
95813,2,3,335549,335549,335552,0,3,1
95814,3,2,335552,335552,335554,0,2,0
95815,6,3,335558,335558,335561,0,3,4
95816,5,3,335563,335563,335566,0,3,2
95817,6,2,335569,335569,335571,0,2,3
95818,6,3,335575,335575,335578,0,3,4
95819,2,1,335577,335578,335579,1,2,0
95820,2,3,335579,335579,335582,0,3,0
95821,5,3,335584,335584,335587,0,3,2
95822,6,1,335590,335590,335591,0,1,3
95823,3,2,335593,335593,335595,0,2,2
95824,3,1,335596,335596,335597,0,1,1
95825,5,1,335601,335601,335602,0,1,4
95826,1,2,335602,335602,335604,0,2,0
95827,5,2,335607,335607,335609,0,2,3
95828,2,3,335609,335609,335612,0,3,0
95829,2,2,335611,335612,335614,1,3,0
95830,1,1,335612,335614,335615,2,3,0
95831,2,1,335614,335615,335616,1,2,0
95832,5,3,335619,335619,335622,0,3,3
95833,1,1,335620,335622,335623,2,3,0
95834,4,3,335624,335624,335627,0,3,1
95835,2,2,335626,335627,335629,1,3,0
95836,2,3,335628,335629,335632,1,4,0
95837,3,2,335631,335632,335634,1,3,0
95838,3,2,335634,335634,335636,0,2,0
95839,1,3,335635,335636,335639,1,4,0
95840,5,2,335640,335640,335642,0,2,1
95841,5,3,335645,335645,335648,0,3,3
95842,2,3,335647,335648,335651,1,4,0
95843,1,1,335648,335651,335652,3,4,0
95844,4,1,335652,335652,335653,0,1,0
95845,3,1,335655,335655,335656,0,1,2
95846,1,2,335656,335656,335658,0,2,0
95847,6,1,335662,335662,335663,0,1,4
95848,5,1,335667,335667,335668,0,1,4
95849,3,3,335670,335670,335673,0,3,2
95850,3,3,335673,335673,335676,0,3,0
95851,3,3,335676,335676,335679,0,3,0
95852,2,2,335678,335679,335681,1,3,0
95853,1,3,335679,335681,335684,2,5,0
95854,5,2,335684,335684,335686,0,2,0
95855,2,1,335686,335686,335687,0,1,0
95856,1,3,335687,335687,335690,0,3,0
95857,2,3,335689,335690,335693,1,4,0
95858,1,1,335690,335693,335694,3,4,0
95859,6,2,335696,335696,335698,0,2,2
95860,6,3,335702,335702,335705,0,3,4
95861,1,2,335703,335705,335707,2,4,0
95862,1,2,335704,335707,335709,3,5,0
95863,4,2,335708,335709,335711,1,3,0
95864,2,3,335710,335711,335714,1,4,0
95865,1,3,335711,335714,335717,3,6,0
95866,2,1,335713,335717,335718,4,5,0
95867,2,1,335715,335718,335719,3,4,0
95868,6,2,335721,335721,335723,0,2,2
95869,4,2,335725,335725,335727,0,2,2
95870,6,3,335731,335731,335734,0,3,4
95871,2,2,335733,335734,335736,1,3,0
95872,1,3,335734,335736,335739,2,5,0
95873,3,2,335737,335739,335741,2,4,0
95874,4,1,335741,335741,335742,0,1,0
95875,3,1,335744,335744,335745,0,1,2
95876,5,2,335749,335749,335751,0,2,4
95877,4,3,335753,335753,335756,0,3,2
95878,5,1,335758,335758,335759,0,1,2
95879,3,1,335761,335761,335762,0,1,2
95880,6,3,335767,335767,335770,0,3,5
95881,2,2,335769,335770,335772,1,3,0
95882,1,3,335770,335772,335775,2,5,0
95883,5,1,335775,335775,335776,0,1,0
95884,6,1,335781,335781,335782,0,1,5
95885,3,1,335784,335784,335785,0,1,2
95886,6,3,335790,335790,335793,0,3,5
95887,6,3,335796,335796,335799,0,3,3
95888,6,3,335802,335802,335805,0,3,3
95889,3,2,335805,335805,335807,0,2,0
95890,5,3,335810,335810,335813,0,3,3
95891,5,1,335815,335815,335816,0,1,2
95892,3,1,335818,335818,335819,0,1,2
95893,6,3,335824,335824,335827,0,3,5
95894,1,1,335825,335827,335828,2,3,0
95895,5,3,335830,335830,335833,0,3,2
95896,1,2,335831,335833,335835,2,4,0
95897,5,1,335836,335836,335837,0,1,1
95898,3,3,335839,335839,335842,0,3,2
95899,3,1,335842,335842,335843,0,1,0
95900,6,2,335848,335848,335850,0,2,5
95901,2,1,335850,335850,335851,0,1,0
95902,6,2,335856,335856,335858,0,2,5
95903,4,1,335860,335860,335861,0,1,2
95904,5,1,335865,335865,335866,0,1,4
95905,3,2,335868,335868,335870,0,2,2
95906,1,3,335869,335870,335873,1,4,0
95907,5,2,335874,335874,335876,0,2,1
95908,1,1,335875,335876,335877,1,2,0
95909,1,2,335876,335877,335879,1,3,0
95910,1,1,335877,335879,335880,2,3,0
95911,3,2,335880,335880,335882,0,2,0
95912,6,3,335886,335886,335889,0,3,4
95913,3,2,335889,335889,335891,0,2,0
95914,6,2,335895,335895,335897,0,2,4
95915,6,1,335901,335901,335902,0,1,4
95916,6,1,335907,335907,335908,0,1,5
95917,5,1,335912,335912,335913,0,1,4
95918,1,3,335913,335913,335916,0,3,0
95919,2,2,335915,335916,335918,1,3,0
95920,3,1,335918,335918,335919,0,1,0
95921,1,2,335919,335919,335921,0,2,0
95922,2,1,335921,335921,335922,0,1,0
95923,4,2,335925,335925,335927,0,2,3
95924,2,2,335927,335927,335929,0,2,0
95925,1,2,335928,335929,335931,1,3,0
95926,1,1,335929,335931,335932,2,3,0
95927,6,3,335935,335935,335938,0,3,3
95928,3,1,335938,335938,335939,0,1,0
95929,2,3,335940,335940,335943,0,3,1
95930,1,2,335941,335943,335945,2,4,0
95931,3,1,335944,335945,335946,1,2,0
95932,3,3,335947,335947,335950,0,3,1
95933,2,2,335949,335950,335952,1,3,0
95934,6,3,335955,335955,335958,0,3,3
95935,3,2,335958,335958,335960,0,2,0
95936,3,2,335961,335961,335963,0,2,1
95937,6,3,335967,335967,335970,0,3,4
95938,6,2,335973,335973,335975,0,2,3
95939,6,3,335979,335979,335982,0,3,4
95940,4,2,335983,335983,335985,0,2,1
95941,4,2,335987,335987,335989,0,2,2
95942,5,2,335992,335992,335994,0,2,3
95943,4,3,335996,335996,335999,0,3,2
95944,3,1,335999,335999,336000,0,1,0
95945,1,1,336000,336000,336001,0,1,0
95946,6,3,336006,336006,336009,0,3,5
95947,4,2,336010,336010,336012,0,2,1
95948,1,1,336011,336012,336013,1,2,0
95949,2,2,336013,336013,336015,0,2,0
95950,1,3,336014,336015,336018,1,4,0
95951,3,1,336017,336018,336019,1,2,0
95952,3,3,336020,336020,336023,0,3,1
95953,1,2,336021,336023,336025,2,4,0
95954,3,1,336024,336025,336026,1,2,0
95955,4,3,336028,336028,336031,0,3,2
95956,4,1,336032,336032,336033,0,1,1
95957,5,2,336037,336037,336039,0,2,4
95958,5,1,336042,336042,336043,0,1,3
95959,6,3,336048,336048,336051,0,3,5
95960,5,3,336053,336053,336056,0,3,2
95961,4,1,336057,336057,336058,0,1,1
95962,4,3,336061,336061,336064,0,3,3
95963,2,2,336063,336064,336066,1,3,0
95964,3,1,336066,336066,336067,0,1,0
95965,4,3,336070,336070,336073,0,3,3
95966,1,3,336071,336073,336076,2,5,0
95967,2,1,336073,336076,336077,3,4,0
95968,2,3,336075,336077,336080,2,5,0
95969,4,3,336079,336080,336083,1,4,0
95970,6,3,336085,336085,336088,0,3,2
95971,4,3,336089,336089,336092,0,3,1
95972,4,3,336093,336093,336096,0,3,1
95973,6,1,336099,336099,336100,0,1,3
95974,2,2,336101,336101,336103,0,2,1
95975,6,2,336107,336107,336109,0,2,4
95976,5,2,336112,336112,336114,0,2,3
95977,3,2,336115,336115,336117,0,2,1
95978,3,3,336118,336118,336121,0,3,1
95979,1,2,336119,336121,336123,2,4,0
95980,6,2,336125,336125,336127,0,2,2
95981,3,3,336128,336128,336131,0,3,1
95982,2,1,336130,336131,336132,1,2,0
95983,6,3,336136,336136,336139,0,3,4
95984,2,2,336138,336139,336141,1,3,0
95985,1,1,336139,336141,336142,2,3,0
95986,4,1,336143,336143,336144,0,1,1
95987,4,2,336147,336147,336149,0,2,3
95988,6,3,336153,336153,336156,0,3,4
95989,5,3,336158,336158,336161,0,3,2
95990,4,3,336162,336162,336165,0,3,1
95991,1,3,336163,336165,336168,2,5,0
95992,6,1,336169,336169,336170,0,1,1
95993,3,3,336172,336172,336175,0,3,2
95994,3,2,336175,336175,336177,0,2,0
95995,4,2,336179,336179,336181,0,2,2
95996,6,3,336185,336185,336188,0,3,4
95997,5,1,336190,336190,336191,0,1,2
95998,2,3,336192,336192,336195,0,3,1
95999,6,3,336198,336198,336201,0,3,3
96000,4,3,336202,336202,336205,0,3,1
96001,1,3,336203,336205,336208,2,5,0
96002,2,1,336205,336208,336209,3,4,0
96003,5,1,336210,336210,336211,0,1,1
96004,1,1,336211,336211,336212,0,1,0
96005,2,1,336213,336213,336214,0,1,1
96006,5,2,336218,336218,336220,0,2,4
96007,4,1,336222,336222,336223,0,1,2
96008,4,3,336226,336226,336229,0,3,3
96009,1,2,336227,336229,336231,2,4,0
96010,2,1,336229,336231,336232,2,3,0
96011,3,2,336232,336232,336234,0,2,0
96012,1,1,336233,336234,336235,1,2,0
96013,6,1,336239,336239,336240,0,1,4
96014,4,1,336243,336243,336244,0,1,3
96015,1,2,336244,336244,336246,0,2,0
96016,5,1,336249,336249,336250,0,1,3
96017,6,1,336255,336255,336256,0,1,5
96018,4,1,336259,336259,336260,0,1,3
96019,1,3,336260,336260,336263,0,3,0
96020,1,3,336261,336263,336266,2,5,0
96021,2,2,336263,336266,336268,3,5,0
96022,6,3,336269,336269,336272,0,3,1
96023,6,2,336275,336275,336277,0,2,3
96024,2,3,336277,336277,336280,0,3,0
96025,6,1,336283,336283,336284,0,1,3
96026,6,1,336289,336289,336290,0,1,5
96027,2,1,336291,336291,336292,0,1,1
96028,5,3,336296,336296,336299,0,3,4
96029,4,1,336300,336300,336301,0,1,1
96030,1,3,336301,336301,336304,0,3,0
96031,3,2,336304,336304,336306,0,2,0
96032,3,3,336307,336307,336310,0,3,1
96033,6,1,336313,336313,336314,0,1,3
96034,6,2,336319,336319,336321,0,2,5
96035,3,1,336322,336322,336323,0,1,1
96036,4,2,336326,336326,336328,0,2,3
96037,1,1,336327,336328,336329,1,2,0
96038,5,1,336332,336332,336333,0,1,3
96039,6,2,336338,336338,336340,0,2,5
96040,5,2,336343,336343,336345,0,2,3
96041,1,1,336344,336345,336346,1,2,0
96042,1,3,336345,336346,336349,1,4,0
96043,1,2,336346,336349,336351,3,5,0
96044,2,2,336348,336351,336353,3,5,0
96045,1,3,336349,336353,336356,4,7,0
96046,5,3,336354,336356,336359,2,5,0
96047,1,2,336355,336359,336361,4,6,0
96048,5,3,336360,336361,336364,1,4,0
96049,5,3,336365,336365,336368,0,3,1
96050,6,1,336371,336371,336372,0,1,3
96051,6,2,336377,336377,336379,0,2,5
96052,5,3,336382,336382,336385,0,3,3
96053,2,3,336384,336385,336388,1,4,0
96054,5,2,336389,336389,336391,0,2,1
96055,6,1,336395,336395,336396,0,1,4
96056,2,2,336397,336397,336399,0,2,1
96057,4,2,336401,336401,336403,0,2,2
96058,6,1,336407,336407,336408,0,1,4
96059,1,3,336408,336408,336411,0,3,0
96060,2,1,336410,336411,336412,1,2,0
96061,5,1,336415,336415,336416,0,1,3
96062,3,3,336418,336418,336421,0,3,2
96063,1,3,336419,336421,336424,2,5,0
96064,4,2,336423,336424,336426,1,3,0
96065,6,1,336429,336429,336430,0,1,3
96066,2,2,336431,336431,336433,0,2,1
96067,5,1,336436,336436,336437,0,1,3
96068,2,3,336438,336438,336441,0,3,1
96069,1,1,336439,336441,336442,2,3,0
96070,6,1,336445,336445,336446,0,1,3
96071,1,2,336446,336446,336448,0,2,0
96072,2,2,336448,336448,336450,0,2,0
96073,6,1,336454,336454,336455,0,1,4
96074,1,2,336455,336455,336457,0,2,0
96075,2,2,336457,336457,336459,0,2,0
96076,2,2,336459,336459,336461,0,2,0
96077,3,3,336462,336462,336465,0,3,1
96078,4,1,336466,336466,336467,0,1,1
96079,5,2,336471,336471,336473,0,2,4
96080,3,3,336474,336474,336477,0,3,1
96081,5,1,336479,336479,336480,0,1,2
96082,4,1,336483,336483,336484,0,1,3
96083,4,2,336487,336487,336489,0,2,3
96084,6,3,336493,336493,336496,0,3,4
96085,5,2,336498,336498,336500,0,2,2
96086,1,2,336499,336500,336502,1,3,0
96087,5,2,336504,336504,336506,0,2,2
96088,1,2,336505,336506,336508,1,3,0
96089,1,3,336506,336508,336511,2,5,0
96090,3,1,336509,336511,336512,2,3,0
96091,5,1,336514,336514,336515,0,1,2
96092,6,3,336520,336520,336523,0,3,5
96093,4,2,336524,336524,336526,0,2,1
96094,6,2,336530,336530,336532,0,2,4
96095,2,1,336532,336532,336533,0,1,0
96096,6,3,336538,336538,336541,0,3,5
96097,2,3,336540,336541,336544,1,4,0
96098,3,2,336543,336544,336546,1,3,0
96099,5,1,336548,336548,336549,0,1,2
96100,1,3,336549,336549,336552,0,3,0
96101,2,3,336551,336552,336555,1,4,0
96102,4,3,336555,336555,336558,0,3,0
96103,4,2,336559,336559,336561,0,2,1
96104,5,3,336564,336564,336567,0,3,3
96105,5,1,336569,336569,336570,0,1,2
96106,4,3,336573,336573,336576,0,3,3
96107,6,2,336579,336579,336581,0,2,3
96108,5,2,336584,336584,336586,0,2,3
96109,5,1,336589,336589,336590,0,1,3
96110,2,2,336591,336591,336593,0,2,1
96111,2,2,336593,336593,336595,0,2,0
96112,5,2,336598,336598,336600,0,2,3
96113,5,2,336603,336603,336605,0,2,3
96114,2,1,336605,336605,336606,0,1,0
96115,2,1,336607,336607,336608,0,1,1
96116,3,3,336610,336610,336613,0,3,2
96117,1,3,336611,336613,336616,2,5,0
96118,3,1,336614,336616,336617,2,3,0
96119,3,3,336617,336617,336620,0,3,0
96120,6,1,336623,336623,336624,0,1,3
96121,6,2,336629,336629,336631,0,2,5
96122,4,1,336633,336633,336634,0,1,2
96123,3,1,336636,336636,336637,0,1,2
96124,1,1,336637,336637,336638,0,1,0
96125,6,1,336643,336643,336644,0,1,5
96126,6,3,336649,336649,336652,0,3,5
96127,5,1,336654,336654,336655,0,1,2
96128,6,2,336660,336660,336662,0,2,5
96129,6,2,336666,336666,336668,0,2,4
96130,5,2,336671,336671,336673,0,2,3
96131,6,2,336677,336677,336679,0,2,4
96132,4,1,336681,336681,336682,0,1,2
96133,3,1,336684,336684,336685,0,1,2
96134,3,2,336687,336687,336689,0,2,2
96135,1,1,336688,336689,336690,1,2,0
96136,4,3,336692,336692,336695,0,3,2
96137,2,2,336694,336695,336697,1,3,0
96138,5,3,336699,336699,336702,0,3,2
96139,5,2,336704,336704,336706,0,2,2
96140,3,3,336707,336707,336710,0,3,1
96141,3,1,336710,336710,336711,0,1,0
96142,2,2,336712,336712,336714,0,2,1
96143,4,3,336716,336716,336719,0,3,2
96144,1,1,336717,336719,336720,2,3,0
96145,5,2,336722,336722,336724,0,2,2
96146,2,2,336724,336724,336726,0,2,0
96147,2,1,336726,336726,336727,0,1,0
96148,2,3,336728,336728,336731,0,3,1
96149,6,1,336734,336734,336735,0,1,3
96150,3,2,336737,336737,336739,0,2,2
96151,1,1,336738,336739,336740,1,2,0
96152,1,2,336739,336740,336742,1,3,0
96153,1,2,336740,336742,336744,2,4,0
96154,1,1,336741,336744,336745,3,4,0
96155,1,3,336742,336745,336748,3,6,0
96156,6,2,336748,336748,336750,0,2,0
96157,4,1,336752,336752,336753,0,1,2
96158,1,2,336753,336753,336755,0,2,0
96159,5,2,336758,336758,336760,0,2,3
96160,2,2,336760,336760,336762,0,2,0
96161,4,2,336764,336764,336766,0,2,2
96162,4,2,336768,336768,336770,0,2,2
96163,1,2,336769,336770,336772,1,3,0
96164,4,3,336773,336773,336776,0,3,1
96165,3,3,336776,336776,336779,0,3,0
96166,2,2,336778,336779,336781,1,3,0
96167,2,1,336780,336781,336782,1,2,0
96168,6,2,336786,336786,336788,0,2,4
96169,6,3,336792,336792,336795,0,3,4
96170,5,2,336797,336797,336799,0,2,2
96171,3,3,336800,336800,336803,0,3,1
96172,6,3,336806,336806,336809,0,3,3
96173,1,3,336807,336809,336812,2,5,0
96174,1,3,336808,336812,336815,4,7,0
96175,4,1,336812,336815,336816,3,4,0
96176,6,2,336818,336818,336820,0,2,2
96177,1,2,336819,336820,336822,1,3,0
96178,6,2,336825,336825,336827,0,2,3
96179,6,3,336831,336831,336834,0,3,4
96180,6,1,336837,336837,336838,0,1,3
96181,2,2,336839,336839,336841,0,2,1
96182,3,2,336842,336842,336844,0,2,1
96183,6,3,336848,336848,336851,0,3,4
96184,4,3,336852,336852,336855,0,3,1
96185,2,3,336854,336855,336858,1,4,0
96186,3,2,336857,336858,336860,1,3,0
96187,3,1,336860,336860,336861,0,1,0
96188,4,2,336864,336864,336866,0,2,3
96189,1,1,336865,336866,336867,1,2,0
96190,6,3,336871,336871,336874,0,3,4
96191,4,3,336875,336875,336878,0,3,1
96192,6,1,336881,336881,336882,0,1,3
96193,6,3,336887,336887,336890,0,3,5
96194,6,1,336893,336893,336894,0,1,3
96195,1,2,336894,336894,336896,0,2,0
96196,6,2,336900,336900,336902,0,2,4
96197,3,2,336903,336903,336905,0,2,1
96198,5,1,336908,336908,336909,0,1,3
96199,5,3,336913,336913,336916,0,3,4
96200,2,3,336915,336916,336919,1,4,0
96201,4,3,336919,336919,336922,0,3,0
96202,1,1,336920,336922,336923,2,3,0
96203,5,2,336925,336925,336927,0,2,2
96204,6,3,336931,336931,336934,0,3,4
96205,1,3,336932,336934,336937,2,5,0
96206,6,2,336938,336938,336940,0,2,1
96207,4,3,336942,336942,336945,0,3,2
96208,3,1,336945,336945,336946,0,1,0
96209,6,3,336951,336951,336954,0,3,5
96210,2,2,336953,336954,336956,1,3,0
96211,1,1,336954,336956,336957,2,3,0
96212,1,2,336955,336957,336959,2,4,0
96213,6,2,336961,336961,336963,0,2,2
96214,1,3,336962,336963,336966,1,4,0
96215,3,2,336965,336966,336968,1,3,0
96216,6,1,336971,336971,336972,0,1,3
96217,5,1,336976,336976,336977,0,1,4
96218,2,2,336978,336978,336980,0,2,1
96219,6,1,336984,336984,336985,0,1,4
96220,1,1,336985,336985,336986,0,1,0
96221,4,3,336989,336989,336992,0,3,3
96222,6,2,336995,336995,336997,0,2,3
96223,6,3,337001,337001,337004,0,3,4
96224,5,2,337006,337006,337008,0,2,2
96225,6,2,337012,337012,337014,0,2,4
96226,4,3,337016,337016,337019,0,3,2
96227,2,1,337018,337019,337020,1,2,0
96228,5,3,337023,337023,337026,0,3,3
96229,3,2,337026,337026,337028,0,2,0
96230,3,2,337029,337029,337031,0,2,1
96231,4,2,337033,337033,337035,0,2,2
96232,6,3,337039,337039,337042,0,3,4
96233,6,3,337045,337045,337048,0,3,3
96234,3,2,337048,337048,337050,0,2,0
96235,2,2,337050,337050,337052,0,2,0
96236,2,1,337052,337052,337053,0,1,0
96237,1,2,337053,337053,337055,0,2,0
96238,3,2,337056,337056,337058,0,2,1
96239,2,3,337058,337058,337061,0,3,0
96240,6,1,337064,337064,337065,0,1,3
96241,2,3,337066,337066,337069,0,3,1
96242,6,1,337072,337072,337073,0,1,3
96243,6,1,337078,337078,337079,0,1,5
96244,5,1,337083,337083,337084,0,1,4
96245,3,1,337086,337086,337087,0,1,2
96246,3,1,337089,337089,337090,0,1,2
96247,4,2,337093,337093,337095,0,2,3
96248,5,3,337098,337098,337101,0,3,3
96249,6,3,337104,337104,337107,0,3,3
96250,3,3,337107,337107,337110,0,3,0
96251,5,1,337112,337112,337113,0,1,2
96252,6,3,337118,337118,337121,0,3,5
96253,4,1,337122,337122,337123,0,1,1
96254,2,1,337124,337124,337125,0,1,1
96255,1,3,337125,337125,337128,0,3,0
96256,6,2,337131,337131,337133,0,2,3
96257,3,2,337134,337134,337136,0,2,1
96258,6,2,337140,337140,337142,0,2,4
96259,6,2,337146,337146,337148,0,2,4
96260,6,1,337152,337152,337153,0,1,4
96261,1,2,337153,337153,337155,0,2,0
96262,1,2,337154,337155,337157,1,3,0
96263,1,1,337155,337157,337158,2,3,0
96264,6,2,337161,337161,337163,0,2,3
96265,4,1,337165,337165,337166,0,1,2
96266,4,1,337169,337169,337170,0,1,3
96267,1,3,337170,337170,337173,0,3,0
96268,4,2,337174,337174,337176,0,2,1
96269,4,1,337178,337178,337179,0,1,2
96270,5,3,337183,337183,337186,0,3,4
96271,4,3,337187,337187,337190,0,3,1
96272,2,3,337189,337190,337193,1,4,0
96273,1,1,337190,337193,337194,3,4,0
96274,3,3,337193,337194,337197,1,4,0
96275,4,2,337197,337197,337199,0,2,0
96276,5,3,337202,337202,337205,0,3,3
96277,3,1,337205,337205,337206,0,1,0
96278,5,1,337210,337210,337211,0,1,4
96279,2,2,337212,337212,337214,0,2,1
96280,3,1,337215,337215,337216,0,1,1
96281,2,2,337217,337217,337219,0,2,1
96282,6,3,337223,337223,337226,0,3,4
96283,2,3,337225,337226,337229,1,4,0
96284,2,2,337227,337229,337231,2,4,0
96285,4,3,337231,337231,337234,0,3,0
96286,4,2,337235,337235,337237,0,2,1
96287,5,1,337240,337240,337241,0,1,3
96288,3,2,337243,337243,337245,0,2,2
96289,2,1,337245,337245,337246,0,1,0
96290,2,1,337247,337247,337248,0,1,1
96291,2,2,337249,337249,337251,0,2,1
96292,3,1,337252,337252,337253,0,1,1
96293,6,2,337258,337258,337260,0,2,5
96294,5,2,337263,337263,337265,0,2,3
96295,6,2,337269,337269,337271,0,2,4
96296,2,2,337271,337271,337273,0,2,0
96297,3,3,337274,337274,337277,0,3,1
96298,5,3,337279,337279,337282,0,3,2
96299,4,2,337283,337283,337285,0,2,1
96300,6,2,337289,337289,337291,0,2,4
96301,6,3,337295,337295,337298,0,3,4
96302,4,2,337299,337299,337301,0,2,1
96303,1,2,337300,337301,337303,1,3,0
96304,6,1,337306,337306,337307,0,1,3
96305,5,2,337311,337311,337313,0,2,4
96306,2,3,337313,337313,337316,0,3,0
96307,1,2,337314,337316,337318,2,4,0
96308,5,2,337319,337319,337321,0,2,1
96309,3,3,337322,337322,337325,0,3,1
96310,2,1,337324,337325,337326,1,2,0
96311,5,2,337329,337329,337331,0,2,3
96312,6,3,337335,337335,337338,0,3,4
96313,4,2,337339,337339,337341,0,2,1
96314,2,2,337341,337341,337343,0,2,0
96315,2,3,337343,337343,337346,0,3,0
96316,1,1,337344,337346,337347,2,3,0
96317,5,3,337349,337349,337352,0,3,2
96318,6,1,337355,337355,337356,0,1,3
96319,6,2,337361,337361,337363,0,2,5
96320,4,3,337365,337365,337368,0,3,2
96321,4,3,337369,337369,337372,0,3,1
96322,2,1,337371,337372,337373,1,2,0
96323,2,3,337373,337373,337376,0,3,0
96324,1,2,337374,337376,337378,2,4,0
96325,3,2,337377,337378,337380,1,3,0
96326,6,1,337383,337383,337384,0,1,3
96327,1,2,337384,337384,337386,0,2,0
96328,4,3,337388,337388,337391,0,3,2
96329,1,2,337389,337391,337393,2,4,0
96330,2,3,337391,337393,337396,2,5,0
96331,3,3,337394,337396,337399,2,5,0
96332,3,1,337397,337399,337400,2,3,0
96333,4,3,337401,337401,337404,0,3,1
96334,2,2,337403,337404,337406,1,3,0
96335,5,2,337408,337408,337410,0,2,2
96336,3,3,337411,337411,337414,0,3,1
96337,4,3,337415,337415,337418,0,3,1
96338,3,1,337418,337418,337419,0,1,0
96339,6,3,337424,337424,337427,0,3,5
96340,5,3,337429,337429,337432,0,3,2
96341,6,3,337435,337435,337438,0,3,3
96342,6,2,337441,337441,337443,0,2,3
96343,4,2,337445,337445,337447,0,2,2
96344,3,3,337448,337448,337451,0,3,1
96345,4,3,337452,337452,337455,0,3,1
96346,2,3,337454,337455,337458,1,4,0
96347,4,1,337458,337458,337459,0,1,0
96348,3,1,337461,337461,337462,0,1,2
96349,4,2,337465,337465,337467,0,2,3
96350,5,2,337470,337470,337472,0,2,3
96351,3,2,337473,337473,337475,0,2,1
96352,1,3,337474,337475,337478,1,4,0
96353,4,2,337478,337478,337480,0,2,0
96354,1,3,337479,337480,337483,1,4,0
96355,6,1,337485,337485,337486,0,1,2
96356,3,3,337488,337488,337491,0,3,2
96357,3,2,337491,337491,337493,0,2,0
96358,3,3,337494,337494,337497,0,3,1
96359,2,1,337496,337497,337498,1,2,0
96360,1,3,337497,337498,337501,1,4,0
96361,2,2,337499,337501,337503,2,4,0
96362,2,3,337501,337503,337506,2,5,0
96363,4,3,337505,337506,337509,1,4,0
96364,5,3,337510,337510,337513,0,3,1
96365,1,2,337511,337513,337515,2,4,0
96366,1,1,337512,337515,337516,3,4,0
96367,1,3,337513,337516,337519,3,6,0
96368,3,3,337516,337519,337522,3,6,0
96369,4,1,337520,337522,337523,2,3,0
96370,5,3,337525,337525,337528,0,3,2
96371,5,2,337530,337530,337532,0,2,2
96372,5,1,337535,337535,337536,0,1,3
96373,1,3,337536,337536,337539,0,3,0
96374,1,2,337537,337539,337541,2,4,0
96375,2,1,337539,337541,337542,2,3,0
96376,4,2,337543,337543,337545,0,2,1
96377,4,1,337547,337547,337548,0,1,2
96378,1,3,337548,337548,337551,0,3,0
96379,1,1,337549,337551,337552,2,3,0
96380,3,3,337552,337552,337555,0,3,0
96381,2,1,337554,337555,337556,1,2,0
96382,2,1,337556,337556,337557,0,1,0
96383,6,3,337562,337562,337565,0,3,5
96384,5,2,337567,337567,337569,0,2,2
96385,4,2,337571,337571,337573,0,2,2
96386,6,3,337577,337577,337580,0,3,4
96387,3,3,337580,337580,337583,0,3,0
96388,5,1,337585,337585,337586,0,1,2
96389,1,2,337586,337586,337588,0,2,0
96390,1,2,337587,337588,337590,1,3,0
96391,1,1,337588,337590,337591,2,3,0
96392,6,3,337594,337594,337597,0,3,3
96393,5,1,337599,337599,337600,0,1,2
96394,4,2,337603,337603,337605,0,2,3
96395,2,1,337605,337605,337606,0,1,0
96396,5,1,337610,337610,337611,0,1,4
96397,2,3,337612,337612,337615,0,3,1
96398,5,1,337617,337617,337618,0,1,2
96399,3,1,337620,337620,337621,0,1,2
96400,2,1,337622,337622,337623,0,1,1
96401,6,1,337628,337628,337629,0,1,5
96402,5,2,337633,337633,337635,0,2,4
96403,1,2,337634,337635,337637,1,3,0
96404,3,2,337637,337637,337639,0,2,0
96405,3,3,337640,337640,337643,0,3,1
96406,3,1,337643,337643,337644,0,1,0
96407,5,2,337648,337648,337650,0,2,4
96408,2,3,337650,337650,337653,0,3,0
96409,3,1,337653,337653,337654,0,1,0
96410,6,2,337659,337659,337661,0,2,5
96411,1,2,337660,337661,337663,1,3,0
96412,6,3,337666,337666,337669,0,3,3
96413,5,1,337671,337671,337672,0,1,2
96414,3,2,337674,337674,337676,0,2,2
96415,3,3,337677,337677,337680,0,3,1
96416,5,1,337682,337682,337683,0,1,2
96417,1,2,337683,337683,337685,0,2,0
96418,2,2,337685,337685,337687,0,2,0
96419,6,3,337691,337691,337694,0,3,4
96420,3,1,337694,337694,337695,0,1,0
96421,5,2,337699,337699,337701,0,2,4
96422,5,3,337704,337704,337707,0,3,3
96423,4,3,337708,337708,337711,0,3,1
96424,4,3,337712,337712,337715,0,3,1
96425,2,2,337714,337715,337717,1,3,0
96426,4,3,337718,337718,337721,0,3,1
96427,2,2,337720,337721,337723,1,3,0
96428,1,2,337721,337723,337725,2,4,0
96429,1,1,337722,337725,337726,3,4,0
96430,1,2,337723,337726,337728,3,5,0
96431,5,2,337728,337728,337730,0,2,0
96432,6,2,337734,337734,337736,0,2,4
96433,1,1,337735,337736,337737,1,2,0
96434,4,3,337739,337739,337742,0,3,2
96435,4,3,337743,337743,337746,0,3,1
96436,2,3,337745,337746,337749,1,4,0
96437,5,3,337750,337750,337753,0,3,1
96438,4,3,337754,337754,337757,0,3,1
96439,4,3,337758,337758,337761,0,3,1
96440,5,3,337763,337763,337766,0,3,2
96441,1,2,337764,337766,337768,2,4,0
96442,1,2,337765,337768,337770,3,5,0
96443,6,2,337771,337771,337773,0,2,1
96444,4,3,337775,337775,337778,0,3,2
96445,3,1,337778,337778,337779,0,1,0
96446,5,1,337783,337783,337784,0,1,4
96447,5,2,337788,337788,337790,0,2,4
96448,4,3,337792,337792,337795,0,3,2
96449,5,1,337797,337797,337798,0,1,2
96450,1,1,337798,337798,337799,0,1,0
96451,3,2,337801,337801,337803,0,2,2
96452,6,2,337807,337807,337809,0,2,4
96453,4,3,337811,337811,337814,0,3,2
96454,3,3,337814,337814,337817,0,3,0
96455,3,3,337817,337817,337820,0,3,0
96456,5,3,337822,337822,337825,0,3,2
96457,2,1,337824,337825,337826,1,2,0
96458,6,2,337830,337830,337832,0,2,4
96459,3,3,337833,337833,337836,0,3,1
96460,4,1,337837,337837,337838,0,1,1
96461,3,3,337840,337840,337843,0,3,2
96462,5,1,337845,337845,337846,0,1,2
96463,5,1,337850,337850,337851,0,1,4
96464,3,1,337853,337853,337854,0,1,2
96465,1,2,337854,337854,337856,0,2,0
96466,5,2,337859,337859,337861,0,2,3
96467,1,2,337860,337861,337863,1,3,0
96468,5,1,337865,337865,337866,0,1,2
96469,1,3,337866,337866,337869,0,3,0
96470,1,3,337867,337869,337872,2,5,0
96471,5,3,337872,337872,337875,0,3,0
96472,1,3,337873,337875,337878,2,5,0
96473,2,3,337875,337878,337881,3,6,0
96474,3,1,337878,337881,337882,3,4,0
96475,2,1,337880,337882,337883,2,3,0
96476,2,1,337882,337883,337884,1,2,0
96477,5,1,337887,337887,337888,0,1,3
96478,3,3,337890,337890,337893,0,3,2
96479,6,3,337896,337896,337899,0,3,3
96480,5,3,337901,337901,337904,0,3,2
96481,2,2,337903,337904,337906,1,3,0
96482,6,1,337909,337909,337910,0,1,3
96483,1,1,337910,337910,337911,0,1,0
96484,1,1,337911,337911,337912,0,1,0
96485,2,2,337913,337913,337915,0,2,1
96486,2,3,337915,337915,337918,0,3,0
96487,2,2,337917,337918,337920,1,3,0
96488,3,3,337920,337920,337923,0,3,0
96489,4,2,337924,337924,337926,0,2,1
96490,1,1,337925,337926,337927,1,2,0
96491,1,3,337926,337927,337930,1,4,0
96492,4,1,337930,337930,337931,0,1,0
96493,5,1,337935,337935,337936,0,1,4
96494,5,1,337940,337940,337941,0,1,4
96495,4,3,337944,337944,337947,0,3,3
96496,1,3,337945,337947,337950,2,5,0
96497,4,2,337949,337950,337952,1,3,0
96498,4,2,337953,337953,337955,0,2,1
96499,3,3,337956,337956,337959,0,3,1
96500,4,2,337960,337960,337962,0,2,1
96501,1,1,337961,337962,337963,1,2,0
96502,4,3,337965,337965,337968,0,3,2
96503,4,1,337969,337969,337970,0,1,1
96504,5,2,337974,337974,337976,0,2,4
96505,4,3,337978,337978,337981,0,3,2
96506,6,1,337984,337984,337985,0,1,3
96507,6,1,337990,337990,337991,0,1,5
96508,6,2,337996,337996,337998,0,2,5
96509,3,2,337999,337999,338001,0,2,1
96510,4,2,338003,338003,338005,0,2,2
96511,1,1,338004,338005,338006,1,2,0
96512,4,2,338008,338008,338010,0,2,2
96513,5,2,338013,338013,338015,0,2,3
96514,3,3,338016,338016,338019,0,3,1
96515,4,3,338020,338020,338023,0,3,1
96516,3,2,338023,338023,338025,0,2,0
96517,6,1,338029,338029,338030,0,1,4
96518,5,3,338034,338034,338037,0,3,4
96519,5,3,338039,338039,338042,0,3,2
96520,6,1,338045,338045,338046,0,1,3
96521,4,3,338049,338049,338052,0,3,3
96522,3,2,338052,338052,338054,0,2,0
96523,3,3,338055,338055,338058,0,3,1
96524,4,1,338059,338059,338060,0,1,1
96525,1,1,338060,338060,338061,0,1,0
96526,3,1,338063,338063,338064,0,1,2
96527,5,3,338068,338068,338071,0,3,4
96528,3,1,338071,338071,338072,0,1,0
96529,2,3,338073,338073,338076,0,3,1
96530,2,2,338075,338076,338078,1,3,0
96531,4,3,338079,338079,338082,0,3,1
96532,2,1,338081,338082,338083,1,2,0
96533,2,3,338083,338083,338086,0,3,0
96534,2,3,338085,338086,338089,1,4,0
96535,2,3,338087,338089,338092,2,5,0
96536,3,1,338090,338092,338093,2,3,0
96537,3,2,338093,338093,338095,0,2,0
96538,2,2,338095,338095,338097,0,2,0
96539,3,2,338098,338098,338100,0,2,1
96540,3,2,338101,338101,338103,0,2,1
96541,2,2,338103,338103,338105,0,2,0
96542,3,1,338106,338106,338107,0,1,1
96543,4,2,338110,338110,338112,0,2,3
96544,6,3,338116,338116,338119,0,3,4
96545,2,3,338118,338119,338122,1,4,0
96546,2,1,338120,338122,338123,2,3,0
96547,2,2,338122,338123,338125,1,3,0
96548,2,1,338124,338125,338126,1,2,0
96549,4,1,338128,338128,338129,0,1,2
96550,6,1,338134,338134,338135,0,1,5
96551,5,3,338139,338139,338142,0,3,4
96552,1,2,338140,338142,338144,2,4,0
96553,5,3,338145,338145,338148,0,3,1
96554,2,3,338147,338148,338151,1,4,0
96555,2,2,338149,338151,338153,2,4,0
96556,6,2,338155,338155,338157,0,2,2
96557,3,2,338158,338158,338160,0,2,1
96558,3,1,338161,338161,338162,0,1,1
96559,3,3,338164,338164,338167,0,3,2
96560,1,2,338165,338167,338169,2,4,0
96561,6,3,338171,338171,338174,0,3,2
96562,2,2,338173,338174,338176,1,3,0
96563,5,2,338178,338178,338180,0,2,2
96564,4,2,338182,338182,338184,0,2,2
96565,1,1,338183,338184,338185,1,2,0
96566,3,2,338186,338186,338188,0,2,1
96567,6,1,338192,338192,338193,0,1,4
96568,1,3,338193,338193,338196,0,3,0
96569,1,1,338194,338196,338197,2,3,0
96570,3,2,338197,338197,338199,0,2,0
96571,5,3,338202,338202,338205,0,3,3
96572,6,3,338208,338208,338211,0,3,3
96573,1,3,338209,338211,338214,2,5,0
96574,1,1,338210,338214,338215,4,5,0
96575,4,3,338214,338215,338218,1,4,0
96576,5,2,338219,338219,338221,0,2,1
96577,1,3,338220,338221,338224,1,4,0
96578,1,2,338221,338224,338226,3,5,0
96579,4,1,338225,338226,338227,1,2,0
96580,1,1,338226,338227,338228,1,2,0
96581,2,1,338228,338228,338229,0,1,0
96582,6,2,338234,338234,338236,0,2,5
96583,2,3,338236,338236,338239,0,3,0
96584,1,3,338237,338239,338242,2,5,0
96585,1,3,338238,338242,338245,4,7,0
96586,5,2,338243,338245,338247,2,4,0
96587,6,2,338249,338249,338251,0,2,2
96588,1,1,338250,338251,338252,1,2,0
96589,2,1,338252,338252,338253,0,1,0
96590,1,3,338253,338253,338256,0,3,0
96591,5,3,338258,338258,338261,0,3,2
96592,2,2,338260,338261,338263,1,3,0
96593,3,2,338263,338263,338265,0,2,0
96594,1,3,338264,338265,338268,1,4,0
96595,6,3,338270,338270,338273,0,3,2
96596,2,3,338272,338273,338276,1,4,0
96597,1,2,338273,338276,338278,3,5,0
96598,2,2,338275,338278,338280,3,5,0
96599,2,1,338277,338280,338281,3,4,0
96600,5,3,338282,338282,338285,0,3,1
96601,2,1,338284,338285,338286,1,2,0
96602,1,3,338285,338286,338289,1,4,0
96603,3,2,338288,338289,338291,1,3,0
96604,2,3,338290,338291,338294,1,4,0
96605,6,1,338296,338296,338297,0,1,2
96606,5,2,338301,338301,338303,0,2,4
96607,5,2,338306,338306,338308,0,2,3
96608,5,3,338311,338311,338314,0,3,3
96609,1,2,338312,338314,338316,2,4,0
96610,4,1,338316,338316,338317,0,1,0
96611,2,3,338318,338318,338321,0,3,1
96612,3,3,338321,338321,338324,0,3,0
96613,3,1,338324,338324,338325,0,1,0
96614,3,1,338327,338327,338328,0,1,2
96615,4,2,338331,338331,338333,0,2,3
96616,2,2,338333,338333,338335,0,2,0
96617,4,3,338337,338337,338340,0,3,2
96618,4,2,338341,338341,338343,0,2,1
96619,2,2,338343,338343,338345,0,2,0
96620,1,2,338344,338345,338347,1,3,0
96621,5,3,338349,338349,338352,0,3,2
96622,3,3,338352,338352,338355,0,3,0
96623,5,3,338357,338357,338360,0,3,2
96624,2,1,338359,338360,338361,1,2,0
96625,2,1,338361,338361,338362,0,1,0
96626,1,1,338362,338362,338363,0,1,0
96627,4,1,338366,338366,338367,0,1,3
96628,5,1,338371,338371,338372,0,1,4
96629,6,3,338377,338377,338380,0,3,5
96630,6,2,338383,338383,338385,0,2,3
96631,1,3,338384,338385,338388,1,4,0
96632,4,3,338388,338388,338391,0,3,0
96633,2,3,338390,338391,338394,1,4,0
96634,5,2,338395,338395,338397,0,2,1
96635,6,1,338401,338401,338402,0,1,4
96636,6,1,338407,338407,338408,0,1,5
96637,5,3,338412,338412,338415,0,3,4
96638,2,2,338414,338415,338417,1,3,0
96639,5,2,338419,338419,338421,0,2,2
96640,4,1,338423,338423,338424,0,1,2
96641,4,2,338427,338427,338429,0,2,3
96642,3,3,338430,338430,338433,0,3,1
96643,3,1,338433,338433,338434,0,1,0
96644,5,1,338438,338438,338439,0,1,4
96645,6,1,338444,338444,338445,0,1,5
96646,3,1,338447,338447,338448,0,1,2
96647,4,3,338451,338451,338454,0,3,3
96648,6,2,338457,338457,338459,0,2,3
96649,1,3,338458,338459,338462,1,4,0
96650,6,2,338464,338464,338466,0,2,2
96651,4,3,338468,338468,338471,0,3,2
96652,2,1,338470,338471,338472,1,2,0
96653,4,1,338474,338474,338475,0,1,2
96654,2,3,338476,338476,338479,0,3,1
96655,3,2,338479,338479,338481,0,2,0
96656,6,3,338485,338485,338488,0,3,4
96657,5,3,338490,338490,338493,0,3,2
96658,6,2,338496,338496,338498,0,2,3
96659,6,2,338502,338502,338504,0,2,4
96660,5,3,338507,338507,338510,0,3,3
96661,6,1,338513,338513,338514,0,1,3
96662,5,1,338518,338518,338519,0,1,4
96663,3,3,338521,338521,338524,0,3,2
96664,6,3,338527,338527,338530,0,3,3
96665,5,1,338532,338532,338533,0,1,2
96666,4,3,338536,338536,338539,0,3,3
96667,6,3,338542,338542,338545,0,3,3
96668,2,3,338544,338545,338548,1,4,0
96669,5,3,338549,338549,338552,0,3,1
96670,4,2,338553,338553,338555,0,2,1
96671,5,1,338558,338558,338559,0,1,3
96672,2,1,338560,338560,338561,0,1,1
96673,5,2,338565,338565,338567,0,2,4
96674,4,2,338569,338569,338571,0,2,2
96675,5,2,338574,338574,338576,0,2,3
96676,1,2,338575,338576,338578,1,3,0
96677,6,2,338581,338581,338583,0,2,3
96678,6,2,338587,338587,338589,0,2,4
96679,2,1,338589,338589,338590,0,1,0
96680,1,1,338590,338590,338591,0,1,0
96681,4,1,338594,338594,338595,0,1,3
96682,3,2,338597,338597,338599,0,2,2
96683,6,3,338603,338603,338606,0,3,4
96684,3,3,338606,338606,338609,0,3,0
96685,2,2,338608,338609,338611,1,3,0
96686,1,2,338609,338611,338613,2,4,0
96687,1,2,338610,338613,338615,3,5,0
96688,2,3,338612,338615,338618,3,6,0
96689,5,2,338617,338618,338620,1,3,0
96690,3,3,338620,338620,338623,0,3,0
96691,3,1,338623,338623,338624,0,1,0
96692,1,2,338624,338624,338626,0,2,0
96693,2,3,338626,338626,338629,0,3,0
96694,3,2,338629,338629,338631,0,2,0
96695,6,2,338635,338635,338637,0,2,4
96696,5,3,338640,338640,338643,0,3,3
96697,6,3,338646,338646,338649,0,3,3
96698,2,1,338648,338649,338650,1,2,0
96699,5,1,338653,338653,338654,0,1,3
96700,4,1,338657,338657,338658,0,1,3
96701,6,3,338663,338663,338666,0,3,5
96702,4,3,338667,338667,338670,0,3,1
96703,2,1,338669,338670,338671,1,2,0
96704,2,3,338671,338671,338674,0,3,0
96705,2,3,338673,338674,338677,1,4,0
96706,5,3,338678,338678,338681,0,3,1
96707,5,3,338683,338683,338686,0,3,2
96708,6,1,338689,338689,338690,0,1,3
96709,1,3,338690,338690,338693,0,3,0
96710,5,1,338695,338695,338696,0,1,2
96711,1,3,338696,338696,338699,0,3,0
96712,1,2,338697,338699,338701,2,4,0
96713,3,1,338700,338701,338702,1,2,0
96714,3,3,338703,338703,338706,0,3,1
96715,6,1,338709,338709,338710,0,1,3
96716,5,1,338714,338714,338715,0,1,4
96717,2,2,338716,338716,338718,0,2,1
96718,2,2,338718,338718,338720,0,2,0
96719,4,3,338722,338722,338725,0,3,2
96720,1,1,338723,338725,338726,2,3,0
96721,2,2,338725,338726,338728,1,3,0
96722,1,2,338726,338728,338730,2,4,0
96723,5,3,338731,338731,338734,0,3,1
96724,1,1,338732,338734,338735,2,3,0
96725,2,3,338734,338735,338738,1,4,0
96726,5,2,338739,338739,338741,0,2,1
96727,4,3,338743,338743,338746,0,3,2
96728,6,2,338749,338749,338751,0,2,3
96729,6,3,338755,338755,338758,0,3,4
96730,3,1,338758,338758,338759,0,1,0
96731,1,2,338759,338759,338761,0,2,0
96732,3,1,338762,338762,338763,0,1,1
96733,3,3,338765,338765,338768,0,3,2
96734,6,1,338771,338771,338772,0,1,3
96735,4,1,338775,338775,338776,0,1,3
96736,4,3,338779,338779,338782,0,3,3
96737,6,2,338785,338785,338787,0,2,3
96738,6,1,338791,338791,338792,0,1,4
96739,5,3,338796,338796,338799,0,3,4
96740,5,1,338801,338801,338802,0,1,2
96741,1,2,338802,338802,338804,0,2,0
96742,2,2,338804,338804,338806,0,2,0
96743,2,3,338806,338806,338809,0,3,0
96744,6,3,338812,338812,338815,0,3,3
96745,5,3,338817,338817,338820,0,3,2
96746,6,2,338823,338823,338825,0,2,3
96747,2,3,338825,338825,338828,0,3,0
96748,2,1,338827,338828,338829,1,2,0
96749,5,3,338832,338832,338835,0,3,3
96750,2,1,338834,338835,338836,1,2,0
96751,6,3,338840,338840,338843,0,3,4
96752,1,1,338841,338843,338844,2,3,0
96753,2,1,338843,338844,338845,1,2,0
96754,1,3,338844,338845,338848,1,4,0
96755,2,1,338846,338848,338849,2,3,0
96756,3,1,338849,338849,338850,0,1,0
96757,1,3,338850,338850,338853,0,3,0
96758,5,3,338855,338855,338858,0,3,2
96759,6,2,338861,338861,338863,0,2,3
96760,3,2,338864,338864,338866,0,2,1
96761,2,2,338866,338866,338868,0,2,0
96762,5,1,338871,338871,338872,0,1,3
96763,1,2,338872,338872,338874,0,2,0
96764,6,1,338878,338878,338879,0,1,4
96765,5,3,338883,338883,338886,0,3,4
96766,2,2,338885,338886,338888,1,3,0
96767,5,2,338890,338890,338892,0,2,2
96768,1,2,338891,338892,338894,1,3,0
96769,4,2,338895,338895,338897,0,2,1
96770,5,3,338900,338900,338903,0,3,3
96771,4,2,338904,338904,338906,0,2,1
96772,4,3,338908,338908,338911,0,3,2
96773,3,2,338911,338911,338913,0,2,0
96774,1,1,338912,338913,338914,1,2,0
96775,2,3,338914,338914,338917,0,3,0
96776,1,1,338915,338917,338918,2,3,0
96777,6,3,338921,338921,338924,0,3,3
96778,4,3,338925,338925,338928,0,3,1
96779,2,1,338927,338928,338929,1,2,0
96780,2,3,338929,338929,338932,0,3,0
96781,3,3,338932,338932,338935,0,3,0
96782,2,1,338934,338935,338936,1,2,0
96783,4,2,338938,338938,338940,0,2,2
96784,2,3,338940,338940,338943,0,3,0
96785,5,1,338945,338945,338946,0,1,2
96786,1,3,338946,338946,338949,0,3,0
96787,5,1,338951,338951,338952,0,1,2
96788,2,1,338953,338953,338954,0,1,1
96789,5,2,338958,338958,338960,0,2,4
96790,4,2,338962,338962,338964,0,2,2
96791,4,2,338966,338966,338968,0,2,2
96792,3,3,338969,338969,338972,0,3,1
96793,4,3,338973,338973,338976,0,3,1
96794,5,3,338978,338978,338981,0,3,2
96795,5,3,338983,338983,338986,0,3,2
96796,2,3,338985,338986,338989,1,4,0
96797,4,3,338989,338989,338992,0,3,0
96798,1,3,338990,338992,338995,2,5,0
96799,4,1,338994,338995,338996,1,2,0
96800,5,2,338999,338999,339001,0,2,3
96801,6,3,339005,339005,339008,0,3,4
96802,5,3,339010,339010,339013,0,3,2
96803,1,3,339011,339013,339016,2,5,0
96804,5,3,339016,339016,339019,0,3,0
96805,3,2,339019,339019,339021,0,2,0
96806,6,1,339025,339025,339026,0,1,4
96807,4,1,339029,339029,339030,0,1,3
96808,2,2,339031,339031,339033,0,2,1
96809,5,1,339036,339036,339037,0,1,3
96810,1,2,339037,339037,339039,0,2,0
96811,2,2,339039,339039,339041,0,2,0
96812,6,3,339045,339045,339048,0,3,4
96813,4,3,339049,339049,339052,0,3,1
96814,3,1,339052,339052,339053,0,1,0
96815,5,3,339057,339057,339060,0,3,4
96816,1,1,339058,339060,339061,2,3,0
96817,2,3,339060,339061,339064,1,4,0
96818,2,3,339062,339064,339067,2,5,0
96819,2,3,339064,339067,339070,3,6,0
96820,6,1,339070,339070,339071,0,1,0
96821,2,1,339072,339072,339073,0,1,1
96822,3,1,339075,339075,339076,0,1,2
96823,3,1,339078,339078,339079,0,1,2
96824,5,2,339083,339083,339085,0,2,4
96825,5,3,339088,339088,339091,0,3,3
96826,4,3,339092,339092,339095,0,3,1
96827,6,2,339098,339098,339100,0,2,3
96828,2,3,339100,339100,339103,0,3,0
96829,1,2,339101,339103,339105,2,4,0
96830,5,1,339106,339106,339107,0,1,1
96831,5,2,339111,339111,339113,0,2,4
96832,2,3,339113,339113,339116,0,3,0
96833,1,1,339114,339116,339117,2,3,0
96834,2,2,339116,339117,339119,1,3,0
96835,2,3,339118,339119,339122,1,4,0
96836,4,2,339122,339122,339124,0,2,0
96837,2,2,339124,339124,339126,0,2,0
96838,4,2,339128,339128,339130,0,2,2
96839,1,2,339129,339130,339132,1,3,0
96840,2,3,339131,339132,339135,1,4,0
96841,4,1,339135,339135,339136,0,1,0
96842,1,2,339136,339136,339138,0,2,0
96843,5,2,339141,339141,339143,0,2,3
96844,2,1,339143,339143,339144,0,1,0
96845,1,1,339144,339144,339145,0,1,0
96846,3,3,339147,339147,339150,0,3,2
96847,4,3,339151,339151,339154,0,3,1
96848,3,3,339154,339154,339157,0,3,0
96849,1,3,339155,339157,339160,2,5,0
96850,6,1,339161,339161,339162,0,1,1
96851,2,1,339163,339163,339164,0,1,1
96852,5,3,339168,339168,339171,0,3,4
96853,5,2,339173,339173,339175,0,2,2
96854,4,1,339177,339177,339178,0,1,2
96855,2,1,339179,339179,339180,0,1,1
96856,3,2,339182,339182,339184,0,2,2
96857,2,2,339184,339184,339186,0,2,0
96858,5,3,339189,339189,339192,0,3,3
96859,4,3,339193,339193,339196,0,3,1
96860,3,2,339196,339196,339198,0,2,0
96861,5,2,339201,339201,339203,0,2,3
96862,1,2,339202,339203,339205,1,3,0
96863,3,2,339205,339205,339207,0,2,0
96864,1,1,339206,339207,339208,1,2,0
96865,1,3,339207,339208,339211,1,4,0
96866,1,3,339208,339211,339214,3,6,0
96867,5,3,339213,339214,339217,1,4,0
96868,3,2,339216,339217,339219,1,3,0
96869,1,2,339217,339219,339221,2,4,0
96870,3,3,339220,339221,339224,1,4,0
96871,4,3,339224,339224,339227,0,3,0
96872,2,2,339226,339227,339229,1,3,0
96873,5,3,339231,339231,339234,0,3,2
96874,5,3,339236,339236,339239,0,3,2
96875,3,1,339239,339239,339240,0,1,0
96876,3,2,339242,339242,339244,0,2,2
96877,3,3,339245,339245,339248,0,3,1
96878,3,2,339248,339248,339250,0,2,0
96879,2,2,339250,339250,339252,0,2,0
96880,2,1,339252,339252,339253,0,1,0
96881,5,3,339257,339257,339260,0,3,4
96882,5,2,339262,339262,339264,0,2,2
96883,4,2,339266,339266,339268,0,2,2
96884,4,3,339270,339270,339273,0,3,2
96885,2,1,339272,339273,339274,1,2,0
96886,3,3,339275,339275,339278,0,3,1
96887,2,1,339277,339278,339279,1,2,0
96888,1,1,339278,339279,339280,1,2,0
96889,2,2,339280,339280,339282,0,2,0
96890,4,1,339284,339284,339285,0,1,2
96891,4,2,339288,339288,339290,0,2,3
96892,3,3,339291,339291,339294,0,3,1
96893,6,1,339297,339297,339298,0,1,3
96894,2,2,339299,339299,339301,0,2,1
96895,6,1,339305,339305,339306,0,1,4
96896,1,2,339306,339306,339308,0,2,0
96897,6,1,339312,339312,339313,0,1,4
96898,3,3,339315,339315,339318,0,3,2
96899,4,2,339319,339319,339321,0,2,1
96900,1,3,339320,339321,339324,1,4,0
96901,2,3,339322,339324,339327,2,5,0
96902,5,3,339327,339327,339330,0,3,0
96903,5,1,339332,339332,339333,0,1,2
96904,4,2,339336,339336,339338,0,2,3
96905,5,3,339341,339341,339344,0,3,3
96906,1,1,339342,339344,339345,2,3,0
96907,4,3,339346,339346,339349,0,3,1
96908,1,3,339347,339349,339352,2,5,0
96909,5,3,339352,339352,339355,0,3,0
96910,4,1,339356,339356,339357,0,1,1
96911,2,1,339358,339358,339359,0,1,1
96912,3,2,339361,339361,339363,0,2,2
96913,4,3,339365,339365,339368,0,3,2
96914,2,3,339367,339368,339371,1,4,0
96915,2,3,339369,339371,339374,2,5,0
96916,5,2,339374,339374,339376,0,2,0
96917,3,1,339377,339377,339378,0,1,1
96918,4,2,339381,339381,339383,0,2,3
96919,6,2,339387,339387,339389,0,2,4
96920,1,3,339388,339389,339392,1,4,0
96921,4,3,339392,339392,339395,0,3,0
96922,3,1,339395,339395,339396,0,1,0
96923,5,1,339400,339400,339401,0,1,4
96924,6,1,339406,339406,339407,0,1,5
96925,1,2,339407,339407,339409,0,2,0
96926,6,3,339413,339413,339416,0,3,4
96927,4,1,339417,339417,339418,0,1,1
96928,5,3,339422,339422,339425,0,3,4
96929,3,2,339425,339425,339427,0,2,0
96930,4,3,339429,339429,339432,0,3,2
96931,2,2,339431,339432,339434,1,3,0
96932,4,2,339435,339435,339437,0,2,1
96933,2,1,339437,339437,339438,0,1,0
96934,5,1,339442,339442,339443,0,1,4
96935,2,3,339444,339444,339447,0,3,1
96936,6,2,339450,339450,339452,0,2,3
96937,3,3,339453,339453,339456,0,3,1
96938,6,1,339459,339459,339460,0,1,3
96939,2,2,339461,339461,339463,0,2,1
96940,4,3,339465,339465,339468,0,3,2
96941,6,3,339471,339471,339474,0,3,3
96942,1,3,339472,339474,339477,2,5,0
96943,6,2,339478,339478,339480,0,2,1
96944,5,1,339483,339483,339484,0,1,3
96945,1,2,339484,339484,339486,0,2,0
96946,4,3,339488,339488,339491,0,3,2
96947,3,2,339491,339491,339493,0,2,0
96948,3,3,339494,339494,339497,0,3,1
96949,6,1,339500,339500,339501,0,1,3
96950,5,1,339505,339505,339506,0,1,4
96951,1,3,339506,339506,339509,0,3,0
96952,5,2,339511,339511,339513,0,2,2
96953,1,3,339512,339513,339516,1,4,0
96954,2,3,339514,339516,339519,2,5,0
96955,4,2,339518,339519,339521,1,3,0
96956,3,1,339521,339521,339522,0,1,0
96957,3,2,339524,339524,339526,0,2,2
96958,3,3,339527,339527,339530,0,3,1
96959,2,3,339529,339530,339533,1,4,0
96960,5,1,339534,339534,339535,0,1,1
96961,6,1,339540,339540,339541,0,1,5
96962,1,3,339541,339541,339544,0,3,0
96963,1,1,339542,339544,339545,2,3,0
96964,5,3,339547,339547,339550,0,3,2
96965,3,1,339550,339550,339551,0,1,0
96966,4,1,339554,339554,339555,0,1,3
96967,4,1,339558,339558,339559,0,1,3
96968,1,2,339559,339559,339561,0,2,0
96969,2,1,339561,339561,339562,0,1,0
96970,5,2,339566,339566,339568,0,2,4
96971,2,3,339568,339568,339571,0,3,0
96972,3,2,339571,339571,339573,0,2,0
96973,6,3,339577,339577,339580,0,3,4
96974,3,3,339580,339580,339583,0,3,0
96975,1,2,339581,339583,339585,2,4,0
96976,4,1,339585,339585,339586,0,1,0
96977,4,2,339589,339589,339591,0,2,3
96978,5,3,339594,339594,339597,0,3,3
96979,3,1,339597,339597,339598,0,1,0
96980,4,3,339601,339601,339604,0,3,3
96981,5,2,339606,339606,339608,0,2,2
96982,3,1,339609,339609,339610,0,1,1
96983,3,1,339612,339612,339613,0,1,2
96984,5,2,339617,339617,339619,0,2,4
96985,3,2,339620,339620,339622,0,2,1
96986,5,1,339625,339625,339626,0,1,3
96987,2,1,339627,339627,339628,0,1,1
96988,5,3,339632,339632,339635,0,3,4
96989,6,2,339638,339638,339640,0,2,3
96990,5,2,339643,339643,339645,0,2,3
96991,1,1,339644,339645,339646,1,2,0
96992,3,2,339647,339647,339649,0,2,1
96993,5,1,339652,339652,339653,0,1,3
96994,5,1,339657,339657,339658,0,1,4
96995,4,3,339661,339661,339664,0,3,3
96996,6,2,339667,339667,339669,0,2,3
96997,5,2,339672,339672,339674,0,2,3
96998,4,3,339676,339676,339679,0,3,2
96999,2,3,339678,339679,339682,1,4,0
97000,4,3,339682,339682,339685,0,3,0
97001,1,2,339683,339685,339687,2,4,0
97002,4,2,339687,339687,339689,0,2,0
97003,4,3,339691,339691,339694,0,3,2
97004,1,1,339692,339694,339695,2,3,0
97005,5,3,339697,339697,339700,0,3,2
97006,4,3,339701,339701,339704,0,3,1
97007,1,1,339702,339704,339705,2,3,0
97008,6,1,339708,339708,339709,0,1,3
97009,6,2,339714,339714,339716,0,2,5
97010,4,1,339718,339718,339719,0,1,2
97011,6,2,339724,339724,339726,0,2,5
97012,5,2,339729,339729,339731,0,2,3
97013,3,2,339732,339732,339734,0,2,1
97014,6,3,339738,339738,339741,0,3,4
97015,2,2,339740,339741,339743,1,3,0
97016,2,1,339742,339743,339744,1,2,0
97017,4,3,339746,339746,339749,0,3,2
97018,6,1,339752,339752,339753,0,1,3
97019,6,3,339758,339758,339761,0,3,5
97020,1,1,339759,339761,339762,2,3,0
97021,5,3,339764,339764,339767,0,3,2
97022,6,3,339770,339770,339773,0,3,3
97023,4,1,339774,339774,339775,0,1,1
97024,5,2,339779,339779,339781,0,2,4
97025,1,2,339780,339781,339783,1,3,0
97026,2,2,339782,339783,339785,1,3,0
97027,5,3,339787,339787,339790,0,3,2
97028,2,3,339789,339790,339793,1,4,0
97029,3,2,339792,339793,339795,1,3,0
97030,1,1,339793,339795,339796,2,3,0
97031,3,3,339796,339796,339799,0,3,0
97032,5,2,339801,339801,339803,0,2,2
97033,3,3,339804,339804,339807,0,3,1
97034,5,2,339809,339809,339811,0,2,2
97035,1,1,339810,339811,339812,1,2,0
97036,5,2,339815,339815,339817,0,2,3
97037,1,3,339816,339817,339820,1,4,0
97038,1,1,339817,339820,339821,3,4,0
97039,6,1,339823,339823,339824,0,1,2
97040,3,2,339826,339826,339828,0,2,2
97041,4,2,339830,339830,339832,0,2,2
97042,3,2,339833,339833,339835,0,2,1
97043,4,1,339837,339837,339838,0,1,2
97044,4,1,339841,339841,339842,0,1,3
97045,1,1,339842,339842,339843,0,1,0
97046,1,1,339843,339843,339844,0,1,0
97047,5,1,339848,339848,339849,0,1,4
97048,4,3,339852,339852,339855,0,3,3
97049,6,1,339858,339858,339859,0,1,3
97050,1,1,339859,339859,339860,0,1,0
97051,6,1,339865,339865,339866,0,1,5
97052,5,2,339870,339870,339872,0,2,4
97053,1,3,339871,339872,339875,1,4,0
97054,1,1,339872,339875,339876,3,4,0
97055,2,2,339874,339876,339878,2,4,0
97056,6,2,339880,339880,339882,0,2,2
97057,5,3,339885,339885,339888,0,3,3
97058,4,2,339889,339889,339891,0,2,1
97059,4,3,339893,339893,339896,0,3,2
97060,2,3,339895,339896,339899,1,4,0
97061,2,1,339897,339899,339900,2,3,0
97062,3,1,339900,339900,339901,0,1,0
97063,6,2,339906,339906,339908,0,2,5
97064,3,2,339909,339909,339911,0,2,1
97065,2,2,339911,339911,339913,0,2,0
97066,6,3,339917,339917,339920,0,3,4
97067,5,1,339922,339922,339923,0,1,2
97068,4,1,339926,339926,339927,0,1,3
97069,3,1,339929,339929,339930,0,1,2
97070,1,3,339930,339930,339933,0,3,0
97071,5,2,339935,339935,339937,0,2,2
97072,2,3,339937,339937,339940,0,3,0
97073,2,3,339939,339940,339943,1,4,0
97074,4,1,339943,339943,339944,0,1,0
97075,4,1,339947,339947,339948,0,1,3
97076,4,1,339951,339951,339952,0,1,3
97077,5,2,339956,339956,339958,0,2,4
97078,5,2,339961,339961,339963,0,2,3
97079,6,2,339967,339967,339969,0,2,4
97080,6,1,339973,339973,339974,0,1,4
97081,4,1,339977,339977,339978,0,1,3
97082,4,1,339981,339981,339982,0,1,3
97083,1,1,339982,339982,339983,0,1,0
97084,3,3,339985,339985,339988,0,3,2
97085,1,3,339986,339988,339991,2,5,0
97086,3,3,339989,339991,339994,2,5,0
97087,6,1,339995,339995,339996,0,1,1
97088,6,2,340001,340001,340003,0,2,5
97089,4,1,340005,340005,340006,0,1,2
97090,3,3,340008,340008,340011,0,3,2
97091,2,2,340010,340011,340013,1,3,0
97092,4,3,340014,340014,340017,0,3,1
97093,2,3,340016,340017,340020,1,4,0
97094,4,3,340020,340020,340023,0,3,0
97095,1,3,340021,340023,340026,2,5,0
97096,5,3,340026,340026,340029,0,3,0
97097,3,2,340029,340029,340031,0,2,0
97098,1,1,340030,340031,340032,1,2,0
97099,2,3,340032,340032,340035,0,3,0
97100,2,1,340034,340035,340036,1,2,0
97101,2,3,340036,340036,340039,0,3,0
97102,3,3,340039,340039,340042,0,3,0
97103,4,3,340043,340043,340046,0,3,1
97104,6,3,340049,340049,340052,0,3,3
97105,1,1,340050,340052,340053,2,3,0
97106,5,1,340055,340055,340056,0,1,2
97107,5,2,340060,340060,340062,0,2,4
97108,4,1,340064,340064,340065,0,1,2
97109,2,3,340066,340066,340069,0,3,1
97110,5,2,340071,340071,340073,0,2,2
97111,6,2,340077,340077,340079,0,2,4
97112,4,1,340081,340081,340082,0,1,2
97113,2,1,340083,340083,340084,0,1,1
97114,2,3,340085,340085,340088,0,3,1
97115,2,3,340087,340088,340091,1,4,0
97116,5,1,340092,340092,340093,0,1,1
97117,2,1,340094,340094,340095,0,1,1
97118,6,1,340100,340100,340101,0,1,5
97119,1,3,340101,340101,340104,0,3,0
97120,4,3,340105,340105,340108,0,3,1
97121,4,2,340109,340109,340111,0,2,1
97122,1,2,340110,340111,340113,1,3,0
97123,4,2,340114,340114,340116,0,2,1
97124,1,2,340115,340116,340118,1,3,0
97125,6,1,340121,340121,340122,0,1,3
97126,3,2,340124,340124,340126,0,2,2
97127,6,3,340130,340130,340133,0,3,4
97128,1,2,340131,340133,340135,2,4,0
97129,1,3,340132,340135,340138,3,6,0
97130,5,3,340137,340138,340141,1,4,0
97131,5,1,340142,340142,340143,0,1,1
97132,5,1,340147,340147,340148,0,1,4
97133,3,1,340150,340150,340151,0,1,2
97134,2,1,340152,340152,340153,0,1,1
97135,3,3,340155,340155,340158,0,3,2
97136,1,2,340156,340158,340160,2,4,0
97137,6,1,340162,340162,340163,0,1,2
97138,4,1,340166,340166,340167,0,1,3
97139,2,1,340168,340168,340169,0,1,1
97140,1,2,340169,340169,340171,0,2,0
97141,2,2,340171,340171,340173,0,2,0
97142,5,1,340176,340176,340177,0,1,3
97143,1,1,340177,340177,340178,0,1,0
97144,3,3,340180,340180,340183,0,3,2
97145,3,3,340183,340183,340186,0,3,0
97146,4,3,340187,340187,340190,0,3,1
97147,6,3,340193,340193,340196,0,3,3
97148,6,2,340199,340199,340201,0,2,3
97149,2,3,340201,340201,340204,0,3,0
97150,1,2,340202,340204,340206,2,4,0
97151,6,3,340208,340208,340211,0,3,2
97152,3,2,340211,340211,340213,0,2,0
97153,1,1,340212,340213,340214,1,2,0
97154,3,2,340215,340215,340217,0,2,1
97155,1,2,340216,340217,340219,1,3,0
97156,5,3,340221,340221,340224,0,3,2
97157,1,3,340222,340224,340227,2,5,0
97158,3,2,340225,340227,340229,2,4,0
97159,3,3,340228,340229,340232,1,4,0
97160,3,3,340231,340232,340235,1,4,0
97161,3,2,340234,340235,340237,1,3,0
97162,2,1,340236,340237,340238,1,2,0
97163,6,3,340242,340242,340245,0,3,4
97164,5,2,340247,340247,340249,0,2,2
97165,5,1,340252,340252,340253,0,1,3
97166,4,1,340256,340256,340257,0,1,3
97167,1,3,340257,340257,340260,0,3,0
97168,4,3,340261,340261,340264,0,3,1
97169,5,1,340266,340266,340267,0,1,2
97170,3,1,340269,340269,340270,0,1,2
97171,5,2,340274,340274,340276,0,2,4
97172,6,2,340280,340280,340282,0,2,4
97173,3,1,340283,340283,340284,0,1,1
97174,3,2,340286,340286,340288,0,2,2
97175,1,3,340287,340288,340291,1,4,0
97176,5,3,340292,340292,340295,0,3,1
97177,4,2,340296,340296,340298,0,2,1
97178,4,1,340300,340300,340301,0,1,2
97179,5,1,340305,340305,340306,0,1,4
97180,6,2,340311,340311,340313,0,2,5
97181,1,2,340312,340313,340315,1,3,0
97182,5,1,340317,340317,340318,0,1,2
97183,6,2,340323,340323,340325,0,2,5
97184,1,3,340324,340325,340328,1,4,0
97185,2,2,340326,340328,340330,2,4,0
97186,3,3,340329,340330,340333,1,4,0
97187,6,2,340335,340335,340337,0,2,2
97188,1,3,340336,340337,340340,1,4,0
97189,4,2,340340,340340,340342,0,2,0
97190,1,1,340341,340342,340343,1,2,0
97191,2,2,340343,340343,340345,0,2,0
97192,4,3,340347,340347,340350,0,3,2
97193,4,2,340351,340351,340353,0,2,1
97194,6,2,340357,340357,340359,0,2,4
97195,4,1,340361,340361,340362,0,1,2
97196,1,3,340362,340362,340365,0,3,0
97197,3,2,340365,340365,340367,0,2,0
97198,2,2,340367,340367,340369,0,2,0
97199,4,1,340371,340371,340372,0,1,2
97200,3,1,340374,340374,340375,0,1,2
97201,1,1,340375,340375,340376,0,1,0
97202,2,3,340377,340377,340380,0,3,1
97203,5,2,340382,340382,340384,0,2,2
97204,4,3,340386,340386,340389,0,3,2
97205,4,1,340390,340390,340391,0,1,1
97206,4,2,340394,340394,340396,0,2,3
97207,6,1,340400,340400,340401,0,1,4
97208,2,3,340402,340402,340405,0,3,1
97209,2,1,340404,340405,340406,1,2,0
97210,2,3,340406,340406,340409,0,3,0
97211,5,2,340411,340411,340413,0,2,2
97212,6,1,340417,340417,340418,0,1,4
97213,4,3,340421,340421,340424,0,3,3
97214,3,2,340424,340424,340426,0,2,0
97215,4,2,340428,340428,340430,0,2,2
97216,3,1,340431,340431,340432,0,1,1
97217,5,2,340436,340436,340438,0,2,4
97218,6,2,340442,340442,340444,0,2,4
97219,6,2,340448,340448,340450,0,2,4
97220,4,1,340452,340452,340453,0,1,2
97221,5,3,340457,340457,340460,0,3,4
97222,5,2,340462,340462,340464,0,2,2
97223,1,1,340463,340464,340465,1,2,0
97224,5,1,340468,340468,340469,0,1,3
97225,2,3,340470,340470,340473,0,3,1
97226,5,2,340475,340475,340477,0,2,2
97227,6,1,340481,340481,340482,0,1,4
97228,2,2,340483,340483,340485,0,2,1
97229,3,3,340486,340486,340489,0,3,1
97230,5,2,340491,340491,340493,0,2,2
97231,6,1,340497,340497,340498,0,1,4
97232,1,1,340498,340498,340499,0,1,0
97233,1,2,340499,340499,340501,0,2,0
97234,1,3,340500,340501,340504,1,4,0
97235,1,2,340501,340504,340506,3,5,0
97236,2,2,340503,340506,340508,3,5,0
97237,4,1,340507,340508,340509,1,2,0
97238,2,2,340509,340509,340511,0,2,0
97239,3,3,340512,340512,340515,0,3,1
97240,4,1,340516,340516,340517,0,1,1
97241,3,3,340519,340519,340522,0,3,2
97242,3,3,340522,340522,340525,0,3,0
97243,1,1,340523,340525,340526,2,3,0
97244,5,3,340528,340528,340531,0,3,2
97245,4,1,340532,340532,340533,0,1,1
97246,3,1,340535,340535,340536,0,1,2
97247,5,2,340540,340540,340542,0,2,4
97248,5,2,340545,340545,340547,0,2,3
97249,4,1,340549,340549,340550,0,1,2
97250,6,3,340555,340555,340558,0,3,5
97251,4,2,340559,340559,340561,0,2,1
97252,1,2,340560,340561,340563,1,3,0
97253,4,1,340564,340564,340565,0,1,1
97254,4,3,340568,340568,340571,0,3,3
97255,2,3,340570,340571,340574,1,4,0
97256,3,3,340573,340574,340577,1,4,0
97257,2,3,340575,340577,340580,2,5,0
97258,3,3,340578,340580,340583,2,5,0
97259,5,2,340583,340583,340585,0,2,0
97260,3,3,340586,340586,340589,0,3,1
97261,1,3,340587,340589,340592,2,5,0
97262,3,2,340590,340592,340594,2,4,0
97263,2,1,340592,340594,340595,2,3,0
97264,1,2,340593,340595,340597,2,4,0
97265,5,3,340598,340598,340601,0,3,1
97266,5,2,340603,340603,340605,0,2,2
97267,1,1,340604,340605,340606,1,2,0
97268,1,3,340605,340606,340609,1,4,0
97269,4,1,340609,340609,340610,0,1,0
97270,1,3,340610,340610,340613,0,3,0
97271,5,3,340615,340615,340618,0,3,2
97272,3,3,340618,340618,340621,0,3,0
97273,2,1,340620,340621,340622,1,2,0
97274,1,2,340621,340622,340624,1,3,0
97275,2,1,340623,340624,340625,1,2,0
97276,5,1,340628,340628,340629,0,1,3
97277,5,2,340633,340633,340635,0,2,4
97278,2,3,340635,340635,340638,0,3,0
97279,6,3,340641,340641,340644,0,3,3
97280,6,2,340647,340647,340649,0,2,3
97281,3,2,340650,340650,340652,0,2,1
97282,5,1,340655,340655,340656,0,1,3
97283,1,1,340656,340656,340657,0,1,0
97284,5,2,340661,340661,340663,0,2,4
97285,4,3,340665,340665,340668,0,3,2
97286,6,2,340671,340671,340673,0,2,3
97287,5,1,340676,340676,340677,0,1,3
97288,3,1,340679,340679,340680,0,1,2
97289,1,1,340680,340680,340681,0,1,0
97290,3,1,340683,340683,340684,0,1,2
97291,1,1,340684,340684,340685,0,1,0
97292,3,2,340687,340687,340689,0,2,2
97293,4,3,340691,340691,340694,0,3,2
97294,1,3,340692,340694,340697,2,5,0
97295,4,1,340696,340697,340698,1,2,0
97296,5,3,340701,340701,340704,0,3,3
97297,5,1,340706,340706,340707,0,1,2
97298,4,2,340710,340710,340712,0,2,3
97299,3,1,340713,340713,340714,0,1,1
97300,3,3,340716,340716,340719,0,3,2
97301,6,3,340722,340722,340725,0,3,3
97302,6,3,340728,340728,340731,0,3,3
97303,4,3,340732,340732,340735,0,3,1
97304,3,2,340735,340735,340737,0,2,0
97305,5,2,340740,340740,340742,0,2,3
97306,6,3,340746,340746,340749,0,3,4
97307,5,3,340751,340751,340754,0,3,2
97308,5,3,340756,340756,340759,0,3,2
97309,6,3,340762,340762,340765,0,3,3
97310,2,3,340764,340765,340768,1,4,0
97311,3,2,340767,340768,340770,1,3,0
97312,4,1,340771,340771,340772,0,1,1
97313,5,1,340776,340776,340777,0,1,4
97314,3,1,340779,340779,340780,0,1,2
97315,2,2,340781,340781,340783,0,2,1
97316,2,3,340783,340783,340786,0,3,0
97317,5,2,340788,340788,340790,0,2,2
97318,1,2,340789,340790,340792,1,3,0
97319,4,2,340793,340793,340795,0,2,1
97320,3,2,340796,340796,340798,0,2,1
97321,1,3,340797,340798,340801,1,4,0
97322,6,3,340803,340803,340806,0,3,2
97323,1,3,340804,340806,340809,2,5,0
97324,1,1,340805,340809,340810,4,5,0
97325,5,3,340810,340810,340813,0,3,0
97326,2,3,340812,340813,340816,1,4,0
97327,5,2,340817,340817,340819,0,2,1
97328,2,3,340819,340819,340822,0,3,0
97329,5,2,340824,340824,340826,0,2,2
97330,4,2,340828,340828,340830,0,2,2
97331,1,2,340829,340830,340832,1,3,0
97332,5,1,340834,340834,340835,0,1,2
97333,3,2,340837,340837,340839,0,2,2
97334,3,2,340840,340840,340842,0,2,1
97335,2,2,340842,340842,340844,0,2,0
97336,6,1,340848,340848,340849,0,1,4
97337,4,2,340852,340852,340854,0,2,3
97338,5,2,340857,340857,340859,0,2,3
97339,5,3,340862,340862,340865,0,3,3
97340,1,1,340863,340865,340866,2,3,0
97341,4,1,340867,340867,340868,0,1,1
97342,5,3,340872,340872,340875,0,3,4
97343,2,3,340874,340875,340878,1,4,0
97344,6,2,340880,340880,340882,0,2,2
97345,2,3,340882,340882,340885,0,3,0
97346,4,3,340886,340886,340889,0,3,1
97347,2,2,340888,340889,340891,1,3,0
97348,6,2,340894,340894,340896,0,2,3
97349,6,3,340900,340900,340903,0,3,4
97350,5,3,340905,340905,340908,0,3,2
97351,2,2,340907,340908,340910,1,3,0
97352,1,2,340908,340910,340912,2,4,0
97353,1,3,340909,340912,340915,3,6,0
97354,5,1,340914,340915,340916,1,2,0
97355,6,1,340920,340920,340921,0,1,4
97356,6,2,340926,340926,340928,0,2,5
97357,6,2,340932,340932,340934,0,2,4
97358,4,3,340936,340936,340939,0,3,2
97359,1,3,340937,340939,340942,2,5,0
97360,2,3,340939,340942,340945,3,6,0
97361,1,2,340940,340945,340947,5,7,0
97362,2,3,340942,340947,340950,5,8,0
97363,4,3,340946,340950,340953,4,7,0
97364,5,2,340951,340953,340955,2,4,0
97365,1,1,340952,340955,340956,3,4,0
97366,6,3,340958,340958,340961,0,3,2
97367,1,1,340959,340961,340962,2,3,0
97368,2,1,340961,340962,340963,1,2,0
97369,3,2,340964,340964,340966,0,2,1
97370,4,3,340968,340968,340971,0,3,2
97371,6,3,340974,340974,340977,0,3,3
97372,6,3,340980,340980,340983,0,3,3
97373,3,3,340983,340983,340986,0,3,0
97374,3,2,340986,340986,340988,0,2,0
97375,3,2,340989,340989,340991,0,2,1
97376,3,1,340992,340992,340993,0,1,1
97377,1,2,340993,340993,340995,0,2,0
97378,2,3,340995,340995,340998,0,3,0
97379,3,2,340998,340998,341000,0,2,0
97380,4,3,341002,341002,341005,0,3,2
97381,4,2,341006,341006,341008,0,2,1
97382,5,2,341011,341011,341013,0,2,3
97383,3,3,341014,341014,341017,0,3,1
97384,4,3,341018,341018,341021,0,3,1
97385,1,1,341019,341021,341022,2,3,0
97386,4,2,341023,341023,341025,0,2,1
97387,3,3,341026,341026,341029,0,3,1
97388,5,3,341031,341031,341034,0,3,2
97389,5,1,341036,341036,341037,0,1,2
97390,3,2,341039,341039,341041,0,2,2
97391,2,1,341041,341041,341042,0,1,0
97392,6,2,341047,341047,341049,0,2,5
97393,6,1,341053,341053,341054,0,1,4
97394,1,2,341054,341054,341056,0,2,0
97395,6,1,341060,341060,341061,0,1,4
97396,4,2,341064,341064,341066,0,2,3
97397,5,2,341069,341069,341071,0,2,3
97398,2,3,341071,341071,341074,0,3,0
97399,4,2,341075,341075,341077,0,2,1
97400,4,2,341079,341079,341081,0,2,2
97401,3,1,341082,341082,341083,0,1,1
97402,4,2,341086,341086,341088,0,2,3
97403,3,1,341089,341089,341090,0,1,1
97404,3,1,341092,341092,341093,0,1,2
97405,6,3,341098,341098,341101,0,3,5
97406,1,3,341099,341101,341104,2,5,0
97407,2,2,341101,341104,341106,3,5,0
97408,3,2,341104,341106,341108,2,4,0
97409,5,1,341109,341109,341110,0,1,1
97410,2,3,341111,341111,341114,0,3,1
97411,2,3,341113,341114,341117,1,4,0
97412,2,1,341115,341117,341118,2,3,0
97413,4,2,341119,341119,341121,0,2,1
97414,2,1,341121,341121,341122,0,1,0
97415,2,1,341123,341123,341124,0,1,1
97416,2,2,341125,341125,341127,0,2,1
97417,1,1,341126,341127,341128,1,2,0
97418,1,2,341127,341128,341130,1,3,0
97419,5,3,341132,341132,341135,0,3,2
97420,2,1,341134,341135,341136,1,2,0
97421,4,1,341138,341138,341139,0,1,2
97422,6,3,341144,341144,341147,0,3,5
97423,1,2,341145,341147,341149,2,4,0
97424,3,3,341148,341149,341152,1,4,0
97425,4,1,341152,341152,341153,0,1,0
97426,6,1,341158,341158,341159,0,1,5
97427,5,3,341163,341163,341166,0,3,4
97428,5,2,341168,341168,341170,0,2,2
97429,5,2,341173,341173,341175,0,2,3
97430,6,3,341179,341179,341182,0,3,4
97431,2,3,341181,341182,341185,1,4,0
97432,2,3,341183,341185,341188,2,5,0
97433,2,3,341185,341188,341191,3,6,0
97434,6,1,341191,341191,341192,0,1,0
97435,1,3,341192,341192,341195,0,3,0
97436,4,1,341196,341196,341197,0,1,1
97437,1,3,341197,341197,341200,0,3,0
97438,6,3,341203,341203,341206,0,3,3
97439,2,3,341205,341206,341209,1,4,0
97440,3,1,341208,341209,341210,1,2,0
97441,1,1,341209,341210,341211,1,2,0
97442,2,2,341211,341211,341213,0,2,0
97443,4,1,341215,341215,341216,0,1,2
97444,5,3,341220,341220,341223,0,3,4
97445,3,1,341223,341223,341224,0,1,0
97446,2,3,341225,341225,341228,0,3,1
97447,2,3,341227,341228,341231,1,4,0
97448,1,2,341228,341231,341233,3,5,0
97449,3,1,341231,341233,341234,2,3,0
97450,5,2,341236,341236,341238,0,2,2
97451,4,1,341240,341240,341241,0,1,2
97452,1,3,341241,341241,341244,0,3,0
97453,6,1,341247,341247,341248,0,1,3
97454,2,3,341249,341249,341252,0,3,1
97455,4,2,341253,341253,341255,0,2,1
97456,6,2,341259,341259,341261,0,2,4
97457,6,1,341265,341265,341266,0,1,4
97458,3,3,341268,341268,341271,0,3,2
97459,4,2,341272,341272,341274,0,2,1
97460,3,1,341275,341275,341276,0,1,1
97461,5,1,341280,341280,341281,0,1,4
97462,1,2,341281,341281,341283,0,2,0
97463,3,3,341284,341284,341287,0,3,1
97464,3,1,341287,341287,341288,0,1,0
97465,2,2,341289,341289,341291,0,2,1
97466,6,3,341295,341295,341298,0,3,4
97467,6,2,341301,341301,341303,0,2,3
97468,2,3,341303,341303,341306,0,3,0
97469,2,2,341305,341306,341308,1,3,0
97470,2,3,341307,341308,341311,1,4,0
97471,1,1,341308,341311,341312,3,4,0
97472,1,3,341309,341312,341315,3,6,0
97473,4,2,341313,341315,341317,2,4,0
97474,1,3,341314,341317,341320,3,6,0
97475,2,3,341316,341320,341323,4,7,0
97476,3,2,341319,341323,341325,4,6,0
97477,1,3,341320,341325,341328,5,8,0
97478,4,1,341324,341328,341329,4,5,0
97479,5,1,341329,341329,341330,0,1,0
97480,4,2,341333,341333,341335,0,2,3
97481,3,1,341336,341336,341337,0,1,1
97482,1,1,341337,341337,341338,0,1,0
97483,5,3,341342,341342,341345,0,3,4
97484,4,2,341346,341346,341348,0,2,1
97485,2,3,341348,341348,341351,0,3,0
97486,6,2,341354,341354,341356,0,2,3
97487,3,1,341357,341357,341358,0,1,1
97488,1,1,341358,341358,341359,0,1,0
97489,4,1,341362,341362,341363,0,1,3
97490,5,3,341367,341367,341370,0,3,4
97491,3,2,341370,341370,341372,0,2,0
97492,6,1,341376,341376,341377,0,1,4
97493,6,1,341382,341382,341383,0,1,5
97494,2,3,341384,341384,341387,0,3,1
97495,5,1,341389,341389,341390,0,1,2
97496,1,1,341390,341390,341391,0,1,0
97497,1,1,341391,341391,341392,0,1,0
97498,4,2,341395,341395,341397,0,2,3
97499,6,3,341401,341401,341404,0,3,4
97500,3,2,341404,341404,341406,0,2,0
97501,6,2,341410,341410,341412,0,2,4
97502,4,1,341414,341414,341415,0,1,2
97503,1,1,341415,341415,341416,0,1,0
97504,4,3,341419,341419,341422,0,3,3
97505,2,2,341421,341422,341424,1,3,0
97506,3,1,341424,341424,341425,0,1,0
97507,6,3,341430,341430,341433,0,3,5
97508,6,1,341436,341436,341437,0,1,3
97509,1,3,341437,341437,341440,0,3,0
97510,4,2,341441,341441,341443,0,2,1
97511,5,3,341446,341446,341449,0,3,3
97512,3,1,341449,341449,341450,0,1,0
97513,1,1,341450,341450,341451,0,1,0
97514,4,2,341454,341454,341456,0,2,3
97515,6,3,341460,341460,341463,0,3,4
97516,6,3,341466,341466,341469,0,3,3
97517,3,1,341469,341469,341470,0,1,0
97518,4,2,341473,341473,341475,0,2,3
97519,1,1,341474,341475,341476,1,2,0
97520,1,3,341475,341476,341479,1,4,0
97521,6,2,341481,341481,341483,0,2,2
97522,1,2,341482,341483,341485,1,3,0
97523,1,2,341483,341485,341487,2,4,0
97524,1,3,341484,341487,341490,3,6,0
97525,6,1,341490,341490,341491,0,1,0
97526,4,3,341494,341494,341497,0,3,3
97527,6,1,341500,341500,341501,0,1,3
97528,2,2,341502,341502,341504,0,2,1
97529,5,1,341507,341507,341508,0,1,3
97530,1,1,341508,341508,341509,0,1,0
97531,2,3,341510,341510,341513,0,3,1
97532,1,3,341511,341513,341516,2,5,0
97533,2,1,341513,341516,341517,3,4,0
97534,1,2,341514,341517,341519,3,5,0
97535,5,2,341519,341519,341521,0,2,0
97536,4,3,341523,341523,341526,0,3,2
97537,5,1,341528,341528,341529,0,1,2
97538,6,1,341534,341534,341535,0,1,5
97539,4,3,341538,341538,341541,0,3,3
97540,6,3,341544,341544,341547,0,3,3
97541,2,3,341546,341547,341550,1,4,0
97542,2,3,341548,341550,341553,2,5,0
97543,3,2,341551,341553,341555,2,4,0
97544,4,1,341555,341555,341556,0,1,0
97545,4,1,341559,341559,341560,0,1,3
97546,3,3,341562,341562,341565,0,3,2
97547,3,3,341565,341565,341568,0,3,0
97548,4,1,341569,341569,341570,0,1,1
97549,2,3,341571,341571,341574,0,3,1
97550,5,1,341576,341576,341577,0,1,2
97551,3,2,341579,341579,341581,0,2,2
97552,1,2,341580,341581,341583,1,3,0
97553,2,2,341582,341583,341585,1,3,0
97554,6,1,341588,341588,341589,0,1,3
97555,3,2,341591,341591,341593,0,2,2
97556,6,1,341597,341597,341598,0,1,4
97557,6,1,341603,341603,341604,0,1,5
97558,2,3,341605,341605,341608,0,3,1
97559,2,2,341607,341608,341610,1,3,0
97560,5,2,341612,341612,341614,0,2,2
97561,1,2,341613,341614,341616,1,3,0
97562,5,1,341618,341618,341619,0,1,2
97563,1,1,341619,341619,341620,0,1,0
97564,5,3,341624,341624,341627,0,3,4
97565,6,2,341630,341630,341632,0,2,3
97566,2,3,341632,341632,341635,0,3,0
97567,4,3,341636,341636,341639,0,3,1
97568,5,3,341641,341641,341644,0,3,2
97569,3,2,341644,341644,341646,0,2,0
97570,2,1,341646,341646,341647,0,1,0
97571,2,2,341648,341648,341650,0,2,1
97572,6,3,341654,341654,341657,0,3,4
97573,4,3,341658,341658,341661,0,3,1
97574,1,1,341659,341661,341662,2,3,0
97575,3,3,341662,341662,341665,0,3,0
97576,6,3,341668,341668,341671,0,3,3
97577,4,1,341672,341672,341673,0,1,1
97578,1,2,341673,341673,341675,0,2,0
97579,6,2,341679,341679,341681,0,2,4
97580,6,3,341685,341685,341688,0,3,4
97581,2,1,341687,341688,341689,1,2,0
97582,5,2,341692,341692,341694,0,2,3
97583,3,1,341695,341695,341696,0,1,1
97584,3,1,341698,341698,341699,0,1,2
97585,5,3,341703,341703,341706,0,3,4
97586,6,2,341709,341709,341711,0,2,3
97587,3,3,341712,341712,341715,0,3,1
97588,6,2,341718,341718,341720,0,2,3
97589,3,3,341721,341721,341724,0,3,1
97590,4,2,341725,341725,341727,0,2,1
97591,1,1,341726,341727,341728,1,2,0
97592,6,2,341732,341732,341734,0,2,4
97593,2,3,341734,341734,341737,0,3,0
97594,2,3,341736,341737,341740,1,4,0
97595,2,3,341738,341740,341743,2,5,0
97596,4,3,341742,341743,341746,1,4,0
97597,1,1,341743,341746,341747,3,4,0
97598,4,3,341747,341747,341750,0,3,0
97599,2,2,341749,341750,341752,1,3,0
97600,2,1,341751,341752,341753,1,2,0
97601,3,3,341754,341754,341757,0,3,1
97602,2,1,341756,341757,341758,1,2,0
97603,5,2,341761,341761,341763,0,2,3
97604,3,2,341764,341764,341766,0,2,1
97605,1,1,341765,341766,341767,1,2,0
97606,5,2,341770,341770,341772,0,2,3
97607,6,1,341776,341776,341777,0,1,4
97608,5,3,341781,341781,341784,0,3,4
97609,3,2,341784,341784,341786,0,2,0
97610,2,1,341786,341786,341787,0,1,0
97611,2,3,341788,341788,341791,0,3,1
97612,2,3,341790,341791,341794,1,4,0
97613,5,2,341795,341795,341797,0,2,1
97614,6,3,341801,341801,341804,0,3,4
97615,3,1,341804,341804,341805,0,1,0
97616,4,1,341808,341808,341809,0,1,3
97617,3,2,341811,341811,341813,0,2,2
97618,2,1,341813,341813,341814,0,1,0
97619,1,1,341814,341814,341815,0,1,0
97620,3,3,341817,341817,341820,0,3,2
97621,2,3,341819,341820,341823,1,4,0
97622,4,2,341823,341823,341825,0,2,0
97623,2,2,341825,341825,341827,0,2,0
97624,1,2,341826,341827,341829,1,3,0
97625,4,1,341830,341830,341831,0,1,1
97626,1,1,341831,341831,341832,0,1,0
97627,4,2,341835,341835,341837,0,2,3
97628,5,3,341840,341840,341843,0,3,3
97629,5,2,341845,341845,341847,0,2,2
97630,3,1,341848,341848,341849,0,1,1
97631,1,1,341849,341849,341850,0,1,0
97632,1,1,341850,341850,341851,0,1,0
97633,2,3,341852,341852,341855,0,3,1
97634,2,1,341854,341855,341856,1,2,0
97635,3,1,341857,341857,341858,0,1,1
97636,4,2,341861,341861,341863,0,2,3
97637,5,3,341866,341866,341869,0,3,3
97638,6,2,341872,341872,341874,0,2,3
97639,5,2,341877,341877,341879,0,2,3
97640,1,1,341878,341879,341880,1,2,0
97641,2,1,341880,341880,341881,0,1,0
97642,2,1,341882,341882,341883,0,1,1
97643,4,2,341886,341886,341888,0,2,3
97644,1,3,341887,341888,341891,1,4,0
97645,3,3,341890,341891,341894,1,4,0
97646,3,3,341893,341894,341897,1,4,0
97647,3,2,341896,341897,341899,1,3,0
97648,6,3,341902,341902,341905,0,3,3
97649,6,1,341908,341908,341909,0,1,3
97650,5,1,341913,341913,341914,0,1,4
97651,6,1,341919,341919,341920,0,1,5
97652,4,1,341923,341923,341924,0,1,3
97653,2,2,341925,341925,341927,0,2,1
97654,4,3,341929,341929,341932,0,3,2
97655,2,3,341931,341932,341935,1,4,0
97656,5,1,341936,341936,341937,0,1,1
97657,2,3,341938,341938,341941,0,3,1
97658,1,1,341939,341941,341942,2,3,0
97659,2,3,341941,341942,341945,1,4,0
97660,4,1,341945,341945,341946,0,1,0
97661,4,3,341949,341949,341952,0,3,3
97662,2,1,341951,341952,341953,1,2,0
97663,4,3,341955,341955,341958,0,3,2
97664,1,3,341956,341958,341961,2,5,0
97665,2,2,341958,341961,341963,3,5,0
97666,1,1,341959,341963,341964,4,5,0
97667,2,2,341961,341964,341966,3,5,0
97668,1,3,341962,341966,341969,4,7,0
97669,4,3,341966,341969,341972,3,6,0
97670,2,3,341968,341972,341975,4,7,0
97671,6,2,341974,341975,341977,1,3,0
97672,2,1,341976,341977,341978,1,2,0
97673,5,1,341981,341981,341982,0,1,3
97674,4,2,341985,341985,341987,0,2,3
97675,3,2,341988,341988,341990,0,2,1
97676,4,3,341992,341992,341995,0,3,2
97677,4,1,341996,341996,341997,0,1,1
97678,6,2,342002,342002,342004,0,2,5
97679,4,1,342006,342006,342007,0,1,2
97680,5,2,342011,342011,342013,0,2,4
97681,6,3,342017,342017,342020,0,3,4
97682,3,3,342020,342020,342023,0,3,0
97683,5,3,342025,342025,342028,0,3,2
97684,6,1,342031,342031,342032,0,1,3
97685,1,1,342032,342032,342033,0,1,0
97686,6,2,342038,342038,342040,0,2,5
97687,5,3,342043,342043,342046,0,3,3
97688,5,1,342048,342048,342049,0,1,2
97689,2,3,342050,342050,342053,0,3,1
97690,1,1,342051,342053,342054,2,3,0
97691,5,1,342056,342056,342057,0,1,2
97692,3,1,342059,342059,342060,0,1,2
97693,2,2,342061,342061,342063,0,2,1
97694,3,2,342064,342064,342066,0,2,1
97695,2,2,342066,342066,342068,0,2,0
97696,3,1,342069,342069,342070,0,1,1
97697,3,3,342072,342072,342075,0,3,2
97698,4,3,342076,342076,342079,0,3,1
97699,5,2,342081,342081,342083,0,2,2
97700,5,2,342086,342086,342088,0,2,3
97701,4,2,342090,342090,342092,0,2,2
97702,5,2,342095,342095,342097,0,2,3
97703,2,1,342097,342097,342098,0,1,0
97704,2,1,342099,342099,342100,0,1,1
97705,6,3,342105,342105,342108,0,3,5
97706,1,2,342106,342108,342110,2,4,0
97707,4,2,342110,342110,342112,0,2,0
97708,5,1,342115,342115,342116,0,1,3
97709,3,2,342118,342118,342120,0,2,2
97710,2,3,342120,342120,342123,0,3,0
97711,6,2,342126,342126,342128,0,2,3
97712,4,2,342130,342130,342132,0,2,2
97713,1,2,342131,342132,342134,1,3,0
97714,4,2,342135,342135,342137,0,2,1
97715,4,1,342139,342139,342140,0,1,2
97716,4,1,342143,342143,342144,0,1,3
97717,6,1,342149,342149,342150,0,1,5
97718,6,1,342155,342155,342156,0,1,5
97719,2,1,342157,342157,342158,0,1,1
97720,5,3,342162,342162,342165,0,3,4
97721,4,3,342166,342166,342169,0,3,1
97722,1,1,342167,342169,342170,2,3,0
97723,1,3,342168,342170,342173,2,5,0
97724,5,3,342173,342173,342176,0,3,0
97725,3,2,342176,342176,342178,0,2,0
97726,2,3,342178,342178,342181,0,3,0
97727,1,2,342179,342181,342183,2,4,0
97728,5,1,342184,342184,342185,0,1,1
97729,3,2,342187,342187,342189,0,2,2
97730,2,1,342189,342189,342190,0,1,0
97731,3,2,342192,342192,342194,0,2,2
97732,3,1,342195,342195,342196,0,1,1
97733,4,2,342199,342199,342201,0,2,3
97734,1,1,342200,342201,342202,1,2,0
97735,1,3,342201,342202,342205,1,4,0
97736,6,3,342207,342207,342210,0,3,2
97737,5,3,342212,342212,342215,0,3,2
97738,1,2,342213,342215,342217,2,4,0
97739,1,1,342214,342217,342218,3,4,0
97740,4,3,342218,342218,342221,0,3,0
97741,6,3,342224,342224,342227,0,3,3
97742,1,1,342225,342227,342228,2,3,0
97743,5,1,342230,342230,342231,0,1,2
97744,3,1,342233,342233,342234,0,1,2
97745,5,2,342238,342238,342240,0,2,4
97746,1,2,342239,342240,342242,1,3,0
97747,4,2,342243,342243,342245,0,2,1
97748,2,2,342245,342245,342247,0,2,0
97749,3,2,342248,342248,342250,0,2,1
97750,1,2,342249,342250,342252,1,3,0
97751,4,3,342253,342253,342256,0,3,1
97752,1,3,342254,342256,342259,2,5,0
97753,4,3,342258,342259,342262,1,4,0
97754,3,1,342261,342262,342263,1,2,0
97755,1,3,342262,342263,342266,1,4,0
97756,1,1,342263,342266,342267,3,4,0
97757,6,3,342269,342269,342272,0,3,2
97758,6,2,342275,342275,342277,0,2,3
97759,5,1,342280,342280,342281,0,1,3
97760,3,1,342283,342283,342284,0,1,2
97761,2,1,342285,342285,342286,0,1,1
97762,6,2,342291,342291,342293,0,2,5
97763,5,3,342296,342296,342299,0,3,3
97764,5,3,342301,342301,342304,0,3,2
97765,5,1,342306,342306,342307,0,1,2
97766,2,2,342308,342308,342310,0,2,1
97767,3,1,342311,342311,342312,0,1,1
97768,4,1,342315,342315,342316,0,1,3
97769,1,3,342316,342316,342319,0,3,0
97770,2,3,342318,342319,342322,1,4,0
97771,4,1,342322,342322,342323,0,1,0
97772,5,2,342327,342327,342329,0,2,4
97773,5,3,342332,342332,342335,0,3,3
97774,2,1,342334,342335,342336,1,2,0
97775,4,1,342338,342338,342339,0,1,2
97776,4,1,342342,342342,342343,0,1,3
97777,4,3,342346,342346,342349,0,3,3
97778,6,2,342352,342352,342354,0,2,3
97779,4,1,342356,342356,342357,0,1,2
97780,2,2,342358,342358,342360,0,2,1
97781,2,3,342360,342360,342363,0,3,0
97782,2,3,342362,342363,342366,1,4,0
97783,2,1,342364,342366,342367,2,3,0
97784,4,3,342368,342368,342371,0,3,1
97785,2,1,342370,342371,342372,1,2,0
97786,1,2,342371,342372,342374,1,3,0
97787,6,1,342377,342377,342378,0,1,3
97788,6,1,342383,342383,342384,0,1,5
97789,3,2,342386,342386,342388,0,2,2
97790,6,1,342392,342392,342393,0,1,4
97791,5,1,342397,342397,342398,0,1,4
97792,2,1,342399,342399,342400,0,1,1
97793,1,3,342400,342400,342403,0,3,0
97794,1,2,342401,342403,342405,2,4,0
97795,5,3,342406,342406,342409,0,3,1
97796,6,2,342412,342412,342414,0,2,3
97797,6,3,342418,342418,342421,0,3,4
97798,5,3,342423,342423,342426,0,3,2
97799,2,3,342425,342426,342429,1,4,0
97800,6,1,342431,342431,342432,0,1,2
97801,6,2,342437,342437,342439,0,2,5
97802,4,2,342441,342441,342443,0,2,2
97803,2,1,342443,342443,342444,0,1,0
97804,5,3,342448,342448,342451,0,3,4
97805,2,1,342450,342451,342452,1,2,0
97806,6,1,342456,342456,342457,0,1,4
97807,3,2,342459,342459,342461,0,2,2
97808,1,2,342460,342461,342463,1,3,0
97809,4,3,342464,342464,342467,0,3,1
97810,3,2,342467,342467,342469,0,2,0
97811,4,2,342471,342471,342473,0,2,2
97812,4,3,342475,342475,342478,0,3,2
97813,1,3,342476,342478,342481,2,5,0
97814,6,2,342482,342482,342484,0,2,1
97815,3,2,342485,342485,342487,0,2,1
97816,1,1,342486,342487,342488,1,2,0
97817,2,1,342488,342488,342489,0,1,0
97818,6,3,342494,342494,342497,0,3,5
97819,3,2,342497,342497,342499,0,2,0
97820,3,2,342500,342500,342502,0,2,1
97821,4,2,342504,342504,342506,0,2,2
97822,3,2,342507,342507,342509,0,2,1
97823,2,2,342509,342509,342511,0,2,0
97824,2,1,342511,342511,342512,0,1,0
97825,2,2,342513,342513,342515,0,2,1
97826,1,1,342514,342515,342516,1,2,0
97827,6,2,342520,342520,342522,0,2,4
97828,1,1,342521,342522,342523,1,2,0
97829,3,1,342524,342524,342525,0,1,1
97830,6,2,342530,342530,342532,0,2,5
97831,5,2,342535,342535,342537,0,2,3
97832,6,1,342541,342541,342542,0,1,4
97833,5,2,342546,342546,342548,0,2,4
97834,6,2,342552,342552,342554,0,2,4
97835,3,2,342555,342555,342557,0,2,1
97836,3,1,342558,342558,342559,0,1,1
97837,4,2,342562,342562,342564,0,2,3
97838,2,1,342564,342564,342565,0,1,0
97839,3,1,342567,342567,342568,0,1,2
97840,3,1,342570,342570,342571,0,1,2
97841,1,2,342571,342571,342573,0,2,0
97842,6,3,342577,342577,342580,0,3,4
97843,2,1,342579,342580,342581,1,2,0
97844,4,1,342583,342583,342584,0,1,2
97845,1,2,342584,342584,342586,0,2,0
97846,1,2,342585,342586,342588,1,3,0
97847,4,3,342589,342589,342592,0,3,1
97848,1,2,342590,342592,342594,2,4,0
97849,1,2,342591,342594,342596,3,5,0
97850,3,2,342594,342596,342598,2,4,0
97851,4,3,342598,342598,342601,0,3,0
97852,4,2,342602,342602,342604,0,2,1
97853,5,2,342607,342607,342609,0,2,3
97854,5,1,342612,342612,342613,0,1,3
97855,4,1,342616,342616,342617,0,1,3
97856,6,3,342622,342622,342625,0,3,5
97857,5,3,342627,342627,342630,0,3,2
97858,3,2,342630,342630,342632,0,2,0
97859,5,2,342635,342635,342637,0,2,3
97860,5,3,342640,342640,342643,0,3,3
97861,3,2,342643,342643,342645,0,2,0
97862,4,3,342647,342647,342650,0,3,2
97863,5,1,342652,342652,342653,0,1,2
97864,6,2,342658,342658,342660,0,2,5
97865,1,2,342659,342660,342662,1,3,0
97866,4,1,342663,342663,342664,0,1,1
97867,4,3,342667,342667,342670,0,3,3
97868,4,3,342671,342671,342674,0,3,1
97869,3,1,342674,342674,342675,0,1,0
97870,4,1,342678,342678,342679,0,1,3
97871,4,1,342682,342682,342683,0,1,3
97872,2,2,342684,342684,342686,0,2,1
97873,2,3,342686,342686,342689,0,3,0
97874,4,2,342690,342690,342692,0,2,1
97875,2,3,342692,342692,342695,0,3,0
97876,5,2,342697,342697,342699,0,2,2
97877,3,1,342700,342700,342701,0,1,1
97878,2,2,342702,342702,342704,0,2,1
97879,4,2,342706,342706,342708,0,2,2
97880,4,1,342710,342710,342711,0,1,2
97881,3,1,342713,342713,342714,0,1,2
97882,1,2,342714,342714,342716,0,2,0
97883,2,1,342716,342716,342717,0,1,0
97884,3,2,342719,342719,342721,0,2,2
97885,3,3,342722,342722,342725,0,3,1
97886,4,2,342726,342726,342728,0,2,1
97887,3,1,342729,342729,342730,0,1,1
97888,2,1,342731,342731,342732,0,1,1
97889,5,3,342736,342736,342739,0,3,4
97890,1,3,342737,342739,342742,2,5,0
97891,2,1,342739,342742,342743,3,4,0
97892,1,1,342740,342743,342744,3,4,0
97893,4,1,342744,342744,342745,0,1,0
97894,2,1,342746,342746,342747,0,1,1
97895,4,3,342750,342750,342753,0,3,3
97896,1,1,342751,342753,342754,2,3,0
97897,3,2,342754,342754,342756,0,2,0
97898,3,1,342757,342757,342758,0,1,1
97899,1,3,342758,342758,342761,0,3,0
97900,1,3,342759,342761,342764,2,5,0
97901,6,3,342765,342765,342768,0,3,1
97902,6,2,342771,342771,342773,0,2,3
97903,1,1,342772,342773,342774,1,2,0
97904,3,2,342775,342775,342777,0,2,1
97905,3,1,342778,342778,342779,0,1,1
97906,1,2,342779,342779,342781,0,2,0
97907,3,1,342782,342782,342783,0,1,1
97908,1,3,342783,342783,342786,0,3,0
97909,6,3,342789,342789,342792,0,3,3
97910,2,1,342791,342792,342793,1,2,0
97911,6,2,342797,342797,342799,0,2,4
97912,1,3,342798,342799,342802,1,4,0
97913,3,3,342801,342802,342805,1,4,0
97914,6,2,342807,342807,342809,0,2,2
97915,4,3,342811,342811,342814,0,3,2
97916,6,2,342817,342817,342819,0,2,3
97917,2,2,342819,342819,342821,0,2,0
97918,6,3,342825,342825,342828,0,3,4
97919,5,3,342830,342830,342833,0,3,2
97920,6,3,342836,342836,342839,0,3,3
97921,6,1,342842,342842,342843,0,1,3
97922,6,2,342848,342848,342850,0,2,5
97923,6,3,342854,342854,342857,0,3,4
97924,3,3,342857,342857,342860,0,3,0
97925,6,1,342863,342863,342864,0,1,3
97926,6,3,342869,342869,342872,0,3,5
97927,4,1,342873,342873,342874,0,1,1
97928,5,1,342878,342878,342879,0,1,4
97929,2,3,342880,342880,342883,0,3,1
97930,5,1,342885,342885,342886,0,1,2
97931,5,3,342890,342890,342893,0,3,4
97932,2,2,342892,342893,342895,1,3,0
97933,2,3,342894,342895,342898,1,4,0
97934,4,1,342898,342898,342899,0,1,0
97935,4,3,342902,342902,342905,0,3,3
97936,2,1,342904,342905,342906,1,2,0
97937,5,1,342909,342909,342910,0,1,3
97938,3,2,342912,342912,342914,0,2,2
97939,3,1,342915,342915,342916,0,1,1
97940,6,2,342921,342921,342923,0,2,5
97941,4,3,342925,342925,342928,0,3,2
97942,1,2,342926,342928,342930,2,4,0
97943,5,2,342931,342931,342933,0,2,1
97944,4,1,342935,342935,342936,0,1,2
97945,4,1,342939,342939,342940,0,1,3
97946,3,2,342942,342942,342944,0,2,2
97947,6,1,342948,342948,342949,0,1,4
97948,4,3,342952,342952,342955,0,3,3
97949,3,2,342955,342955,342957,0,2,0
97950,1,3,342956,342957,342960,1,4,0
97951,2,1,342958,342960,342961,2,3,0
97952,3,3,342961,342961,342964,0,3,0
97953,3,1,342964,342964,342965,0,1,0
97954,2,1,342966,342966,342967,0,1,1
97955,5,2,342971,342971,342973,0,2,4
97956,5,2,342976,342976,342978,0,2,3
97957,3,1,342979,342979,342980,0,1,1
97958,1,1,342980,342980,342981,0,1,0
97959,3,3,342983,342983,342986,0,3,2
97960,2,3,342985,342986,342989,1,4,0
97961,6,2,342991,342991,342993,0,2,2
97962,4,2,342995,342995,342997,0,2,2
97963,3,3,342998,342998,343001,0,3,1
97964,3,3,343001,343001,343004,0,3,0
97965,1,3,343002,343004,343007,2,5,0
97966,1,3,343003,343007,343010,4,7,0
97967,2,1,343005,343010,343011,5,6,0
97968,2,1,343007,343011,343012,4,5,0
97969,3,3,343010,343012,343015,2,5,0
97970,6,3,343016,343016,343019,0,3,1
97971,5,2,343021,343021,343023,0,2,2
97972,3,1,343024,343024,343025,0,1,1
97973,2,2,343026,343026,343028,0,2,1
97974,5,3,343031,343031,343034,0,3,3
97975,3,2,343034,343034,343036,0,2,0
97976,5,3,343039,343039,343042,0,3,3
97977,5,1,343044,343044,343045,0,1,2
97978,2,1,343046,343046,343047,0,1,1
97979,4,1,343050,343050,343051,0,1,3
97980,6,1,343056,343056,343057,0,1,5
97981,5,1,343061,343061,343062,0,1,4
97982,5,1,343066,343066,343067,0,1,4
97983,4,3,343070,343070,343073,0,3,3
97984,4,1,343074,343074,343075,0,1,1
97985,1,2,343075,343075,343077,0,2,0
97986,4,1,343079,343079,343080,0,1,2
97987,1,2,343080,343080,343082,0,2,0
97988,1,3,343081,343082,343085,1,4,0
97989,6,3,343087,343087,343090,0,3,2
97990,3,1,343090,343090,343091,0,1,0
97991,4,3,343094,343094,343097,0,3,3
97992,4,3,343098,343098,343101,0,3,1
97993,6,3,343104,343104,343107,0,3,3
97994,4,1,343108,343108,343109,0,1,1
97995,1,1,343109,343109,343110,0,1,0
97996,5,1,343114,343114,343115,0,1,4
97997,3,2,343117,343117,343119,0,2,2
97998,4,1,343121,343121,343122,0,1,2
97999,6,2,343127,343127,343129,0,2,5
98000,4,3,343131,343131,343134,0,3,2
98001,2,3,343133,343134,343137,1,4,0
98002,1,2,343134,343137,343139,3,5,0
98003,1,2,343135,343139,343141,4,6,0
98004,5,2,343140,343141,343143,1,3,0
98005,5,2,343145,343145,343147,0,2,2
98006,3,1,343148,343148,343149,0,1,1
98007,3,3,343151,343151,343154,0,3,2
98008,1,3,343152,343154,343157,2,5,0
98009,4,3,343156,343157,343160,1,4,0
98010,2,2,343158,343160,343162,2,4,0
98011,5,1,343163,343163,343164,0,1,1
98012,2,2,343165,343165,343167,0,2,1
98013,4,1,343169,343169,343170,0,1,2
98014,1,2,343170,343170,343172,0,2,0
98015,2,1,343172,343172,343173,0,1,0
98016,6,3,343178,343178,343181,0,3,5
98017,1,2,343179,343181,343183,2,4,0
98018,2,3,343181,343183,343186,2,5,0
98019,3,3,343184,343186,343189,2,5,0
98020,4,3,343188,343189,343192,1,4,0
98021,2,2,343190,343192,343194,2,4,0
98022,3,1,343193,343194,343195,1,2,0
98023,1,3,343194,343195,343198,1,4,0
98024,2,2,343196,343198,343200,2,4,0
98025,6,3,343202,343202,343205,0,3,2
98026,4,2,343206,343206,343208,0,2,1
98027,5,2,343211,343211,343213,0,2,3
98028,4,2,343215,343215,343217,0,2,2
98029,1,3,343216,343217,343220,1,4,0
98030,1,2,343217,343220,343222,3,5,0
98031,3,3,343220,343222,343225,2,5,0
98032,6,1,343226,343226,343227,0,1,1
98033,5,2,343231,343231,343233,0,2,4
98034,1,1,343232,343233,343234,1,2,0
98035,5,3,343237,343237,343240,0,3,3
98036,3,1,343240,343240,343241,0,1,0
98037,2,3,343242,343242,343245,0,3,1
98038,3,3,343245,343245,343248,0,3,0
98039,5,2,343250,343250,343252,0,2,2
98040,3,3,343253,343253,343256,0,3,1
98041,1,3,343254,343256,343259,2,5,0
98042,4,2,343258,343259,343261,1,3,0
98043,3,2,343261,343261,343263,0,2,0
98044,2,2,343263,343263,343265,0,2,0
98045,4,3,343267,343267,343270,0,3,2
98046,1,3,343268,343270,343273,2,5,0
98047,3,3,343271,343273,343276,2,5,0
98048,3,3,343274,343276,343279,2,5,0
98049,1,2,343275,343279,343281,4,6,0
98050,5,3,343280,343281,343284,1,4,0
98051,4,1,343284,343284,343285,0,1,0
98052,1,2,343285,343285,343287,0,2,0
98053,1,3,343286,343287,343290,1,4,0
98054,6,3,343292,343292,343295,0,3,2
98055,3,1,343295,343295,343296,0,1,0
98056,6,2,343301,343301,343303,0,2,5
98057,6,3,343307,343307,343310,0,3,4
98058,1,1,343308,343310,343311,2,3,0
98059,5,1,343313,343313,343314,0,1,2
98060,1,3,343314,343314,343317,0,3,0
98061,2,2,343316,343317,343319,1,3,0
98062,1,3,343317,343319,343322,2,5,0
98063,6,3,343323,343323,343326,0,3,1
98064,3,1,343326,343326,343327,0,1,0
98065,5,1,343331,343331,343332,0,1,4
98066,6,2,343337,343337,343339,0,2,5
98067,6,1,343343,343343,343344,0,1,4
98068,5,2,343348,343348,343350,0,2,4
98069,5,3,343353,343353,343356,0,3,3
98070,1,3,343354,343356,343359,2,5,0
98071,5,3,343359,343359,343362,0,3,0
98072,5,1,343364,343364,343365,0,1,2
98073,2,1,343366,343366,343367,0,1,1
98074,3,2,343369,343369,343371,0,2,2
98075,6,2,343375,343375,343377,0,2,4
98076,3,2,343378,343378,343380,0,2,1
98077,2,3,343380,343380,343383,0,3,0
98078,1,2,343381,343383,343385,2,4,0
98079,1,3,343382,343385,343388,3,6,0
98080,3,1,343385,343388,343389,3,4,0
98081,1,2,343386,343389,343391,3,5,0
98082,3,3,343389,343391,343394,2,5,0
98083,6,2,343395,343395,343397,0,2,1
98084,3,3,343398,343398,343401,0,3,1
98085,2,3,343400,343401,343404,1,4,0
98086,2,1,343402,343404,343405,2,3,0
98087,2,2,343404,343405,343407,1,3,0
98088,5,3,343409,343409,343412,0,3,2
98089,3,2,343412,343412,343414,0,2,0
98090,3,1,343415,343415,343416,0,1,1
98091,6,2,343421,343421,343423,0,2,5
98092,6,1,343427,343427,343428,0,1,4
98093,2,3,343429,343429,343432,0,3,1
98094,2,3,343431,343432,343435,1,4,0
98095,2,3,343433,343435,343438,2,5,0
98096,4,3,343437,343438,343441,1,4,0
98097,5,1,343442,343442,343443,0,1,1
98098,6,1,343448,343448,343449,0,1,5
98099,3,3,343451,343451,343454,0,3,2
98100,1,3,343452,343454,343457,2,5,0
98101,2,2,343454,343457,343459,3,5,0
98102,6,1,343460,343460,343461,0,1,1
98103,1,2,343461,343461,343463,0,2,0
98104,2,3,343463,343463,343466,0,3,0
98105,3,1,343466,343466,343467,0,1,0
98106,5,3,343471,343471,343474,0,3,4
98107,4,2,343475,343475,343477,0,2,1
98108,2,2,343477,343477,343479,0,2,0
98109,3,2,343480,343480,343482,0,2,1
98110,4,1,343484,343484,343485,0,1,2
98111,2,1,343486,343486,343487,0,1,1
98112,4,1,343490,343490,343491,0,1,3
98113,3,2,343493,343493,343495,0,2,2
98114,1,3,343494,343495,343498,1,4,0
98115,2,1,343496,343498,343499,2,3,0
98116,6,1,343502,343502,343503,0,1,3
98117,3,1,343505,343505,343506,0,1,2
98118,5,2,343510,343510,343512,0,2,4
98119,2,2,343512,343512,343514,0,2,0
98120,2,1,343514,343514,343515,0,1,0
98121,2,2,343516,343516,343518,0,2,1
98122,2,3,343518,343518,343521,0,3,0
98123,1,1,343519,343521,343522,2,3,0
98124,6,1,343525,343525,343526,0,1,3
98125,2,1,343527,343527,343528,0,1,1
98126,4,2,343531,343531,343533,0,2,3
98127,4,3,343535,343535,343538,0,3,2
98128,5,2,343540,343540,343542,0,2,2
98129,3,1,343543,343543,343544,0,1,1
98130,5,1,343548,343548,343549,0,1,4
98131,3,2,343551,343551,343553,0,2,2
98132,5,3,343556,343556,343559,0,3,3
98133,6,1,343562,343562,343563,0,1,3
98134,4,1,343566,343566,343567,0,1,3
98135,5,3,343571,343571,343574,0,3,4
98136,1,2,343572,343574,343576,2,4,0
98137,4,1,343576,343576,343577,0,1,0
98138,6,1,343582,343582,343583,0,1,5
98139,2,2,343584,343584,343586,0,2,1
98140,1,2,343585,343586,343588,1,3,0
98141,3,3,343588,343588,343591,0,3,0
98142,5,3,343593,343593,343596,0,3,2
98143,4,2,343597,343597,343599,0,2,1
98144,3,1,343600,343600,343601,0,1,1
98145,1,2,343601,343601,343603,0,2,0
98146,6,1,343607,343607,343608,0,1,4
98147,6,3,343613,343613,343616,0,3,5
98148,1,1,343614,343616,343617,2,3,0
98149,6,1,343620,343620,343621,0,1,3
98150,5,2,343625,343625,343627,0,2,4
98151,2,1,343627,343627,343628,0,1,0
98152,2,2,343629,343629,343631,0,2,1
98153,1,3,343630,343631,343634,1,4,0
98154,2,3,343632,343634,343637,2,5,0
98155,6,2,343638,343638,343640,0,2,1
98156,1,3,343639,343640,343643,1,4,0
98157,2,2,343641,343643,343645,2,4,0
98158,5,3,343646,343646,343649,0,3,1
98159,5,1,343651,343651,343652,0,1,2
98160,5,2,343656,343656,343658,0,2,4
98161,2,1,343658,343658,343659,0,1,0
98162,4,3,343662,343662,343665,0,3,3
98163,5,2,343667,343667,343669,0,2,2
98164,2,1,343669,343669,343670,0,1,0
98165,6,1,343675,343675,343676,0,1,5
98166,5,3,343680,343680,343683,0,3,4
98167,3,1,343683,343683,343684,0,1,0
98168,4,1,343687,343687,343688,0,1,3
98169,5,2,343692,343692,343694,0,2,4
98170,5,1,343697,343697,343698,0,1,3
98171,2,3,343699,343699,343702,0,3,1
98172,4,1,343703,343703,343704,0,1,1
98173,3,1,343706,343706,343707,0,1,2
98174,6,2,343712,343712,343714,0,2,5
98175,6,3,343718,343718,343721,0,3,4
98176,6,2,343724,343724,343726,0,2,3
98177,3,3,343727,343727,343730,0,3,1
98178,5,1,343732,343732,343733,0,1,2
98179,3,2,343735,343735,343737,0,2,2
98180,6,1,343741,343741,343742,0,1,4
98181,3,2,343744,343744,343746,0,2,2
98182,3,1,343747,343747,343748,0,1,1
98183,6,2,343753,343753,343755,0,2,5
98184,1,3,343754,343755,343758,1,4,0
98185,3,2,343757,343758,343760,1,3,0
98186,3,1,343760,343760,343761,0,1,0
98187,2,3,343762,343762,343765,0,3,1
98188,1,3,343763,343765,343768,2,5,0
98189,3,2,343766,343768,343770,2,4,0
98190,4,1,343770,343770,343771,0,1,0
98191,1,1,343771,343771,343772,0,1,0
98192,3,3,343774,343774,343777,0,3,2
98193,1,1,343775,343777,343778,2,3,0
98194,3,3,343778,343778,343781,0,3,0
98195,2,2,343780,343781,343783,1,3,0
98196,2,1,343782,343783,343784,1,2,0
98197,5,1,343787,343787,343788,0,1,3
98198,1,2,343788,343788,343790,0,2,0
98199,1,2,343789,343790,343792,1,3,0
98200,1,3,343790,343792,343795,2,5,0
98201,3,3,343793,343795,343798,2,5,0
98202,1,3,343794,343798,343801,4,7,0
98203,2,3,343796,343801,343804,5,8,0
98204,4,2,343800,343804,343806,4,6,0
98205,1,1,343801,343806,343807,5,6,0
98206,4,3,343805,343807,343810,2,5,0
98207,2,3,343807,343810,343813,3,6,0
98208,2,1,343809,343813,343814,4,5,0
98209,2,2,343811,343814,343816,3,5,0
98210,4,3,343815,343816,343819,1,4,0
98211,5,2,343820,343820,343822,0,2,1
98212,2,3,343822,343822,343825,0,3,0
98213,2,1,343824,343825,343826,1,2,0
98214,2,1,343826,343826,343827,0,1,0
98215,6,1,343832,343832,343833,0,1,5
98216,3,2,343835,343835,343837,0,2,2
98217,5,1,343840,343840,343841,0,1,3
98218,2,3,343842,343842,343845,0,3,1
98219,1,2,343843,343845,343847,2,4,0
98220,4,2,343847,343847,343849,0,2,0
98221,1,1,343848,343849,343850,1,2,0
98222,1,3,343849,343850,343853,1,4,0
98223,5,3,343854,343854,343857,0,3,1
98224,5,1,343859,343859,343860,0,1,2
98225,2,3,343861,343861,343864,0,3,1
98226,5,3,343866,343866,343869,0,3,2
98227,3,2,343869,343869,343871,0,2,0
98228,6,2,343875,343875,343877,0,2,4
98229,3,1,343878,343878,343879,0,1,1
98230,5,3,343883,343883,343886,0,3,4
98231,3,3,343886,343886,343889,0,3,0
98232,4,2,343890,343890,343892,0,2,1
98233,6,3,343896,343896,343899,0,3,4
98234,5,1,343901,343901,343902,0,1,2
98235,6,1,343907,343907,343908,0,1,5
98236,5,3,343912,343912,343915,0,3,4
98237,6,3,343918,343918,343921,0,3,3
98238,2,2,343920,343921,343923,1,3,0
98239,6,3,343926,343926,343929,0,3,3
98240,3,1,343929,343929,343930,0,1,0
98241,5,1,343934,343934,343935,0,1,4
98242,4,1,343938,343938,343939,0,1,3
98243,6,1,343944,343944,343945,0,1,5
98244,5,3,343949,343949,343952,0,3,4
98245,5,3,343954,343954,343957,0,3,2
98246,1,3,343955,343957,343960,2,5,0
98247,1,1,343956,343960,343961,4,5,0
98248,3,3,343959,343961,343964,2,5,0
98249,4,3,343963,343964,343967,1,4,0
98250,5,2,343968,343968,343970,0,2,1
98251,1,1,343969,343970,343971,1,2,0
98252,4,3,343973,343973,343976,0,3,2
98253,4,3,343977,343977,343980,0,3,1
98254,2,2,343979,343980,343982,1,3,0
98255,3,3,343982,343982,343985,0,3,0
98256,2,3,343984,343985,343988,1,4,0
98257,3,1,343987,343988,343989,1,2,0
98258,5,1,343992,343992,343993,0,1,3
98259,3,3,343995,343995,343998,0,3,2
98260,6,2,344001,344001,344003,0,2,3
98261,5,2,344006,344006,344008,0,2,3
98262,4,3,344010,344010,344013,0,3,2
98263,2,3,344012,344013,344016,1,4,0
98264,3,1,344015,344016,344017,1,2,0
98265,3,2,344018,344018,344020,0,2,1
98266,6,1,344024,344024,344025,0,1,4
98267,6,1,344030,344030,344031,0,1,5
98268,2,3,344032,344032,344035,0,3,1
98269,1,3,344033,344035,344038,2,5,0
98270,6,3,344039,344039,344042,0,3,1
98271,2,1,344041,344042,344043,1,2,0
98272,5,1,344046,344046,344047,0,1,3
98273,6,3,344052,344052,344055,0,3,5
98274,3,2,344055,344055,344057,0,2,0
98275,2,3,344057,344057,344060,0,3,0
98276,3,1,344060,344060,344061,0,1,0
98277,4,1,344064,344064,344065,0,1,3
98278,5,2,344069,344069,344071,0,2,4
98279,6,3,344075,344075,344078,0,3,4
98280,2,2,344077,344078,344080,1,3,0
98281,2,1,344079,344080,344081,1,2,0
98282,3,3,344082,344082,344085,0,3,1
98283,1,2,344083,344085,344087,2,4,0
98284,2,1,344085,344087,344088,2,3,0
98285,4,3,344089,344089,344092,0,3,1
98286,6,1,344095,344095,344096,0,1,3
98287,1,1,344096,344096,344097,0,1,0
98288,2,2,344098,344098,344100,0,2,1
98289,6,1,344104,344104,344105,0,1,4
98290,3,1,344107,344107,344108,0,1,2
98291,1,2,344108,344108,344110,0,2,0
98292,6,1,344114,344114,344115,0,1,4
98293,5,1,344119,344119,344120,0,1,4
98294,2,2,344121,344121,344123,0,2,1
98295,1,1,344122,344123,344124,1,2,0
98296,2,3,344124,344124,344127,0,3,0
98297,1,3,344125,344127,344130,2,5,0
98298,1,3,344126,344130,344133,4,7,0
98299,5,3,344131,344133,344136,2,5,0
98300,3,3,344134,344136,344139,2,5,0
98301,6,3,344140,344140,344143,0,3,1
98302,5,2,344145,344145,344147,0,2,2
98303,5,2,344150,344150,344152,0,2,3
98304,6,2,344156,344156,344158,0,2,4
98305,2,2,344158,344158,344160,0,2,0
98306,5,2,344163,344163,344165,0,2,3
98307,2,1,344165,344165,344166,0,1,0
98308,5,3,344170,344170,344173,0,3,4
98309,3,1,344173,344173,344174,0,1,0
98310,3,1,344176,344176,344177,0,1,2
98311,1,3,344177,344177,344180,0,3,0
98312,4,2,344181,344181,344183,0,2,1
98313,3,3,344184,344184,344187,0,3,1
98314,6,1,344190,344190,344191,0,1,3
98315,5,3,344195,344195,344198,0,3,4
98316,5,1,344200,344200,344201,0,1,2
98317,2,3,344202,344202,344205,0,3,1
98318,1,1,344203,344205,344206,2,3,0
98319,5,2,344208,344208,344210,0,2,2
98320,3,2,344211,344211,344213,0,2,1
98321,2,2,344213,344213,344215,0,2,0
98322,6,1,344219,344219,344220,0,1,4
98323,1,3,344220,344220,344223,0,3,0
98324,2,3,344222,344223,344226,1,4,0
98325,5,3,344227,344227,344230,0,3,1
98326,1,2,344228,344230,344232,2,4,0
98327,3,3,344231,344232,344235,1,4,0
98328,3,1,344234,344235,344236,1,2,0
98329,4,2,344238,344238,344240,0,2,2
98330,6,2,344244,344244,344246,0,2,4
98331,4,3,344248,344248,344251,0,3,2
98332,1,3,344249,344251,344254,2,5,0
98333,4,2,344253,344254,344256,1,3,0
98334,5,2,344258,344258,344260,0,2,2
98335,3,1,344261,344261,344262,0,1,1
98336,3,1,344264,344264,344265,0,1,2
98337,1,2,344265,344265,344267,0,2,0
98338,2,1,344267,344267,344268,0,1,0
98339,4,1,344271,344271,344272,0,1,3
98340,1,1,344272,344272,344273,0,1,0
98341,6,3,344278,344278,344281,0,3,5
98342,3,2,344281,344281,344283,0,2,0
98343,6,1,344287,344287,344288,0,1,4
98344,5,3,344292,344292,344295,0,3,4
98345,4,3,344296,344296,344299,0,3,1
98346,4,3,344300,344300,344303,0,3,1
98347,3,1,344303,344303,344304,0,1,0
98348,5,1,344308,344308,344309,0,1,4
98349,2,1,344310,344310,344311,0,1,1
98350,5,2,344315,344315,344317,0,2,4
98351,2,2,344317,344317,344319,0,2,0
98352,3,2,344320,344320,344322,0,2,1
98353,1,3,344321,344322,344325,1,4,0
98354,5,3,344326,344326,344329,0,3,1
98355,3,3,344329,344329,344332,0,3,0
98356,5,2,344334,344334,344336,0,2,2
98357,2,1,344336,344336,344337,0,1,0
98358,1,3,344337,344337,344340,0,3,0
98359,5,3,344342,344342,344345,0,3,2
98360,1,2,344343,344345,344347,2,4,0
98361,2,1,344345,344347,344348,2,3,0
98362,4,3,344349,344349,344352,0,3,1
98363,6,1,344355,344355,344356,0,1,3
98364,6,2,344361,344361,344363,0,2,5
98365,2,3,344363,344363,344366,0,3,0
98366,1,3,344364,344366,344369,2,5,0
98367,5,2,344369,344369,344371,0,2,0
98368,3,3,344372,344372,344375,0,3,1
98369,1,2,344373,344375,344377,2,4,0
98370,1,2,344374,344377,344379,3,5,0
98371,4,2,344378,344379,344381,1,3,0
98372,3,3,344381,344381,344384,0,3,0
98373,6,1,344387,344387,344388,0,1,3
98374,4,3,344391,344391,344394,0,3,3
98375,3,3,344394,344394,344397,0,3,0
98376,6,3,344400,344400,344403,0,3,3
98377,6,2,344406,344406,344408,0,2,3
98378,5,2,344411,344411,344413,0,2,3
98379,1,2,344412,344413,344415,1,3,0
98380,5,2,344417,344417,344419,0,2,2
98381,2,2,344419,344419,344421,0,2,0
98382,2,3,344421,344421,344424,0,3,0
98383,5,2,344426,344426,344428,0,2,2
98384,1,1,344427,344428,344429,1,2,0
98385,3,1,344430,344430,344431,0,1,1
98386,1,2,344431,344431,344433,0,2,0
98387,2,1,344433,344433,344434,0,1,0
98388,2,3,344435,344435,344438,0,3,1
98389,3,1,344438,344438,344439,0,1,0
98390,4,1,344442,344442,344443,0,1,3
98391,6,3,344448,344448,344451,0,3,5
98392,1,2,344449,344451,344453,2,4,0
98393,1,3,344450,344453,344456,3,6,0
98394,3,2,344453,344456,344458,3,5,0
98395,3,3,344456,344458,344461,2,5,0
98396,4,1,344460,344461,344462,1,2,0
98397,4,1,344464,344464,344465,0,1,2
98398,6,3,344470,344470,344473,0,3,5
98399,3,2,344473,344473,344475,0,2,0
98400,6,2,344479,344479,344481,0,2,4
98401,6,1,344485,344485,344486,0,1,4
98402,5,2,344490,344490,344492,0,2,4
98403,2,3,344492,344492,344495,0,3,0
98404,1,3,344493,344495,344498,2,5,0
98405,2,1,344495,344498,344499,3,4,0
98406,1,3,344496,344499,344502,3,6,0
98407,4,2,344500,344502,344504,2,4,0
98408,5,3,344505,344505,344508,0,3,1
98409,3,2,344508,344508,344510,0,2,0
98410,3,3,344511,344511,344514,0,3,1
98411,4,1,344515,344515,344516,0,1,1
98412,3,2,344518,344518,344520,0,2,2
98413,6,2,344524,344524,344526,0,2,4
98414,2,2,344526,344526,344528,0,2,0
98415,2,2,344528,344528,344530,0,2,0
98416,5,2,344533,344533,344535,0,2,3
98417,6,1,344539,344539,344540,0,1,4
98418,5,1,344544,344544,344545,0,1,4
98419,5,3,344549,344549,344552,0,3,4
98420,6,3,344555,344555,344558,0,3,3
98421,5,1,344560,344560,344561,0,1,2
98422,4,1,344564,344564,344565,0,1,3
98423,5,2,344569,344569,344571,0,2,4
98424,1,1,344570,344571,344572,1,2,0
98425,4,1,344574,344574,344575,0,1,2
98426,5,1,344579,344579,344580,0,1,4
98427,6,2,344585,344585,344587,0,2,5
98428,2,1,344587,344587,344588,0,1,0
98429,3,2,344590,344590,344592,0,2,2
98430,2,2,344592,344592,344594,0,2,0
98431,5,2,344597,344597,344599,0,2,3
98432,6,1,344603,344603,344604,0,1,4
98433,5,1,344608,344608,344609,0,1,4
98434,3,1,344611,344611,344612,0,1,2
98435,4,1,344615,344615,344616,0,1,3
98436,1,1,344616,344616,344617,0,1,0
98437,1,2,344617,344617,344619,0,2,0
98438,6,2,344623,344623,344625,0,2,4
98439,5,2,344628,344628,344630,0,2,3
98440,2,2,344630,344630,344632,0,2,0
98441,6,2,344636,344636,344638,0,2,4
98442,3,1,344639,344639,344640,0,1,1
98443,5,1,344644,344644,344645,0,1,4
98444,5,1,344649,344649,344650,0,1,4
98445,4,3,344653,344653,344656,0,3,3
98446,1,3,344654,344656,344659,2,5,0
98447,2,3,344656,344659,344662,3,6,0
98448,4,2,344660,344662,344664,2,4,0
98449,2,2,344662,344664,344666,2,4,0
98450,2,3,344664,344666,344669,2,5,0
98451,4,3,344668,344669,344672,1,4,0
98452,2,1,344670,344672,344673,2,3,0
98453,4,1,344674,344674,344675,0,1,1
98454,2,2,344676,344676,344678,0,2,1
98455,4,3,344680,344680,344683,0,3,2
98456,1,2,344681,344683,344685,2,4,0
98457,2,3,344683,344685,344688,2,5,0
98458,4,1,344687,344688,344689,1,2,0
98459,5,1,344692,344692,344693,0,1,3
98460,1,1,344693,344693,344694,0,1,0
98461,4,3,344697,344697,344700,0,3,3
98462,6,2,344703,344703,344705,0,2,3
98463,4,2,344707,344707,344709,0,2,2
98464,6,1,344713,344713,344714,0,1,4
98465,4,2,344717,344717,344719,0,2,3
98466,4,1,344721,344721,344722,0,1,2
98467,2,1,344723,344723,344724,0,1,1
98468,4,1,344727,344727,344728,0,1,3
98469,1,1,344728,344728,344729,0,1,0
98470,6,3,344734,344734,344737,0,3,5
98471,2,2,344736,344737,344739,1,3,0
98472,6,1,344742,344742,344743,0,1,3
98473,2,2,344744,344744,344746,0,2,1
98474,5,2,344749,344749,344751,0,2,3
98475,2,3,344751,344751,344754,0,3,0
98476,6,1,344757,344757,344758,0,1,3
98477,3,3,344760,344760,344763,0,3,2
98478,6,3,344766,344766,344769,0,3,3
98479,2,2,344768,344769,344771,1,3,0
98480,3,3,344771,344771,344774,0,3,0
98481,5,3,344776,344776,344779,0,3,2
98482,1,1,344777,344779,344780,2,3,0
98483,5,1,344782,344782,344783,0,1,2
98484,1,3,344783,344783,344786,0,3,0
98485,5,2,344788,344788,344790,0,2,2
98486,4,1,344792,344792,344793,0,1,2
98487,4,3,344796,344796,344799,0,3,3
98488,4,1,344800,344800,344801,0,1,1
98489,3,3,344803,344803,344806,0,3,2
98490,6,1,344809,344809,344810,0,1,3
98491,6,3,344815,344815,344818,0,3,5
98492,5,3,344820,344820,344823,0,3,2
98493,3,2,344823,344823,344825,0,2,0
98494,3,1,344826,344826,344827,0,1,1
98495,2,2,344828,344828,344830,0,2,1
98496,6,1,344834,344834,344835,0,1,4
98497,4,1,344838,344838,344839,0,1,3
98498,2,2,344840,344840,344842,0,2,1
98499,5,1,344845,344845,344846,0,1,3
98500,4,1,344849,344849,344850,0,1,3
98501,5,1,344854,344854,344855,0,1,4
98502,3,1,344857,344857,344858,0,1,2
98503,5,2,344862,344862,344864,0,2,4
98504,1,1,344863,344864,344865,1,2,0
98505,6,3,344869,344869,344872,0,3,4
98506,5,2,344874,344874,344876,0,2,2
98507,5,1,344879,344879,344880,0,1,3
98508,1,1,344880,344880,344881,0,1,0
98509,2,1,344882,344882,344883,0,1,1
98510,3,1,344885,344885,344886,0,1,2
98511,2,2,344887,344887,344889,0,2,1
98512,5,3,344892,344892,344895,0,3,3
98513,6,2,344898,344898,344900,0,2,3
98514,1,1,344899,344900,344901,1,2,0
98515,6,3,344905,344905,344908,0,3,4
98516,2,2,344907,344908,344910,1,3,0
98517,6,3,344913,344913,344916,0,3,3
98518,2,1,344915,344916,344917,1,2,0
98519,3,1,344918,344918,344919,0,1,1
98520,3,2,344921,344921,344923,0,2,2
98521,6,3,344927,344927,344930,0,3,4
98522,5,3,344932,344932,344935,0,3,2
98523,6,3,344938,344938,344941,0,3,3
98524,2,2,344940,344941,344943,1,3,0
98525,5,1,344945,344945,344946,0,1,2
98526,4,1,344949,344949,344950,0,1,3
98527,1,2,344950,344950,344952,0,2,0
98528,4,2,344954,344954,344956,0,2,2
98529,6,3,344960,344960,344963,0,3,4
98530,1,2,344961,344963,344965,2,4,0
98531,1,3,344962,344965,344968,3,6,0
98532,6,3,344968,344968,344971,0,3,0
98533,4,1,344972,344972,344973,0,1,1
98534,6,3,344978,344978,344981,0,3,5
98535,4,1,344982,344982,344983,0,1,1
98536,3,3,344985,344985,344988,0,3,2
98537,6,2,344991,344991,344993,0,2,3
98538,3,1,344994,344994,344995,0,1,1
98539,1,2,344995,344995,344997,0,2,0
98540,6,3,345001,345001,345004,0,3,4
98541,3,1,345004,345004,345005,0,1,0
98542,6,1,345010,345010,345011,0,1,5
98543,1,3,345011,345011,345014,0,3,0
98544,4,1,345015,345015,345016,0,1,1
98545,6,1,345021,345021,345022,0,1,5
98546,1,2,345022,345022,345024,0,2,0
98547,2,3,345024,345024,345027,0,3,0
98548,1,3,345025,345027,345030,2,5,0
98549,6,3,345031,345031,345034,0,3,1
98550,1,3,345032,345034,345037,2,5,0
98551,2,1,345034,345037,345038,3,4,0
98552,1,1,345035,345038,345039,3,4,0
98553,2,3,345037,345039,345042,2,5,0
98554,2,3,345039,345042,345045,3,6,0
98555,2,3,345041,345045,345048,4,7,0
98556,5,1,345046,345048,345049,2,3,0
98557,2,1,345048,345049,345050,1,2,0
98558,1,2,345049,345050,345052,1,3,0
98559,4,2,345053,345053,345055,0,2,1
98560,2,2,345055,345055,345057,0,2,0
98561,1,1,345056,345057,345058,1,2,0
98562,1,3,345057,345058,345061,1,4,0
98563,1,1,345058,345061,345062,3,4,0
98564,4,2,345062,345062,345064,0,2,0
98565,6,1,345068,345068,345069,0,1,4
98566,1,1,345069,345069,345070,0,1,0
98567,5,3,345074,345074,345077,0,3,4
98568,3,1,345077,345077,345078,0,1,0
98569,5,3,345082,345082,345085,0,3,4
98570,1,1,345083,345085,345086,2,3,0
98571,1,2,345084,345086,345088,2,4,0
98572,1,2,345085,345088,345090,3,5,0
98573,6,3,345091,345091,345094,0,3,1
98574,5,1,345096,345096,345097,0,1,2
98575,1,1,345097,345097,345098,0,1,0
98576,6,1,345103,345103,345104,0,1,5
98577,1,3,345104,345104,345107,0,3,0
98578,3,2,345107,345107,345109,0,2,0
98579,2,1,345109,345109,345110,0,1,0
98580,2,2,345111,345111,345113,0,2,1
98581,3,3,345114,345114,345117,0,3,1
98582,2,1,345116,345117,345118,1,2,0
98583,1,2,345117,345118,345120,1,3,0
98584,4,2,345121,345121,345123,0,2,1
98585,5,1,345126,345126,345127,0,1,3
98586,6,3,345132,345132,345135,0,3,5
98587,1,3,345133,345135,345138,2,5,0
98588,5,1,345138,345138,345139,0,1,0
98589,3,2,345141,345141,345143,0,2,2
98590,2,3,345143,345143,345146,0,3,0
98591,2,2,345145,345146,345148,1,3,0
98592,2,2,345147,345148,345150,1,3,0
98593,1,1,345148,345150,345151,2,3,0
98594,2,1,345150,345151,345152,1,2,0
98595,1,3,345151,345152,345155,1,4,0
98596,4,3,345155,345155,345158,0,3,0
98597,2,3,345157,345158,345161,1,4,0
98598,4,2,345161,345161,345163,0,2,0
98599,3,3,345164,345164,345167,0,3,1
98600,4,2,345168,345168,345170,0,2,1
98601,2,1,345170,345170,345171,0,1,0
98602,3,1,345173,345173,345174,0,1,2
98603,2,1,345175,345175,345176,0,1,1
98604,4,2,345179,345179,345181,0,2,3
98605,2,2,345181,345181,345183,0,2,0
98606,3,2,345184,345184,345186,0,2,1
98607,5,3,345189,345189,345192,0,3,3
98608,3,2,345192,345192,345194,0,2,0
98609,1,2,345193,345194,345196,1,3,0
98610,2,3,345195,345196,345199,1,4,0
98611,1,2,345196,345199,345201,3,5,0
98612,2,1,345198,345201,345202,3,4,0
98613,5,2,345203,345203,345205,0,2,1
98614,4,2,345207,345207,345209,0,2,2
98615,5,2,345212,345212,345214,0,2,3
98616,1,3,345213,345214,345217,1,4,0
98617,2,3,345215,345217,345220,2,5,0
98618,2,3,345217,345220,345223,3,6,0
98619,2,1,345219,345223,345224,4,5,0
98620,4,1,345223,345224,345225,1,2,0
98621,5,2,345228,345228,345230,0,2,3
98622,2,1,345230,345230,345231,0,1,0
98623,1,3,345231,345231,345234,0,3,0
98624,1,1,345232,345234,345235,2,3,0
98625,1,1,345233,345235,345236,2,3,0
98626,1,1,345234,345236,345237,2,3,0
98627,6,2,345240,345240,345242,0,2,3
98628,3,2,345243,345243,345245,0,2,1
98629,1,2,345244,345245,345247,1,3,0
98630,1,2,345245,345247,345249,2,4,0
98631,5,3,345250,345250,345253,0,3,1
98632,1,1,345251,345253,345254,2,3,0
98633,4,1,345255,345255,345256,0,1,1
98634,2,3,345257,345257,345260,0,3,1
98635,1,2,345258,345260,345262,2,4,0
98636,1,2,345259,345262,345264,3,5,0
98637,1,2,345260,345264,345266,4,6,0
98638,4,1,345264,345266,345267,2,3,0
98639,5,1,345269,345269,345270,0,1,2
98640,3,3,345272,345272,345275,0,3,2
98641,3,2,345275,345275,345277,0,2,0
98642,6,2,345281,345281,345283,0,2,4
98643,5,2,345286,345286,345288,0,2,3
98644,5,1,345291,345291,345292,0,1,3
98645,3,3,345294,345294,345297,0,3,2
98646,1,3,345295,345297,345300,2,5,0
98647,6,1,345301,345301,345302,0,1,1
98648,2,1,345303,345303,345304,0,1,1
98649,2,1,345305,345305,345306,0,1,1
98650,4,2,345309,345309,345311,0,2,3
98651,2,2,345311,345311,345313,0,2,0
98652,1,1,345312,345313,345314,1,2,0
98653,2,1,345314,345314,345315,0,1,0
98654,2,2,345316,345316,345318,0,2,1
98655,4,3,345320,345320,345323,0,3,2
98656,3,3,345323,345323,345326,0,3,0
98657,2,1,345325,345326,345327,1,2,0
98658,4,1,345329,345329,345330,0,1,2
98659,1,1,345330,345330,345331,0,1,0
98660,4,1,345334,345334,345335,0,1,3
98661,3,2,345337,345337,345339,0,2,2
98662,6,1,345343,345343,345344,0,1,4
98663,3,2,345346,345346,345348,0,2,2
98664,6,2,345352,345352,345354,0,2,4
98665,3,2,345355,345355,345357,0,2,1
98666,6,2,345361,345361,345363,0,2,4
98667,4,3,345365,345365,345368,0,3,2
98668,5,1,345370,345370,345371,0,1,2
98669,1,1,345371,345371,345372,0,1,0
98670,5,3,345376,345376,345379,0,3,4
98671,2,3,345378,345379,345382,1,4,0
98672,5,3,345383,345383,345386,0,3,1
98673,1,1,345384,345386,345387,2,3,0
98674,3,3,345387,345387,345390,0,3,0
98675,1,3,345388,345390,345393,2,5,0
98676,2,1,345390,345393,345394,3,4,0
98677,4,1,345394,345394,345395,0,1,0
98678,6,3,345400,345400,345403,0,3,5
98679,5,1,345405,345405,345406,0,1,2
98680,2,1,345407,345407,345408,0,1,1
98681,4,2,345411,345411,345413,0,2,3
98682,6,3,345417,345417,345420,0,3,4
98683,1,3,345418,345420,345423,2,5,0
98684,1,2,345419,345423,345425,4,6,0
98685,1,2,345420,345425,345427,5,7,0
98686,2,2,345422,345427,345429,5,7,0
98687,4,1,345426,345429,345430,3,4,0
98688,4,2,345430,345430,345432,0,2,0
98689,3,2,345433,345433,345435,0,2,1
98690,4,2,345437,345437,345439,0,2,2
98691,2,3,345439,345439,345442,0,3,0
98692,5,2,345444,345444,345446,0,2,2
98693,6,2,345450,345450,345452,0,2,4
98694,3,3,345453,345453,345456,0,3,1
98695,6,2,345459,345459,345461,0,2,3
98696,3,1,345462,345462,345463,0,1,1
98697,3,2,345465,345465,345467,0,2,2
98698,4,2,345469,345469,345471,0,2,2
98699,4,1,345473,345473,345474,0,1,2
98700,5,2,345478,345478,345480,0,2,4
98701,2,3,345480,345480,345483,0,3,0
98702,5,1,345485,345485,345486,0,1,2
98703,1,1,345486,345486,345487,0,1,0
98704,4,3,345490,345490,345493,0,3,3
98705,5,1,345495,345495,345496,0,1,2
98706,1,1,345496,345496,345497,0,1,0
98707,5,1,345501,345501,345502,0,1,4
98708,1,3,345502,345502,345505,0,3,0
98709,3,1,345505,345505,345506,0,1,0
98710,6,3,345511,345511,345514,0,3,5
98711,5,1,345516,345516,345517,0,1,2
98712,3,1,345519,345519,345520,0,1,2
98713,6,3,345525,345525,345528,0,3,5
98714,4,1,345529,345529,345530,0,1,1
98715,3,1,345532,345532,345533,0,1,2
98716,6,1,345538,345538,345539,0,1,5
98717,2,3,345540,345540,345543,0,3,1
98718,6,3,345546,345546,345549,0,3,3
98719,3,2,345549,345549,345551,0,2,0
98720,4,1,345553,345553,345554,0,1,2
98721,6,2,345559,345559,345561,0,2,5
98722,5,1,345564,345564,345565,0,1,3
98723,6,3,345570,345570,345573,0,3,5
98724,4,2,345574,345574,345576,0,2,1
98725,4,1,345578,345578,345579,0,1,2
98726,5,1,345583,345583,345584,0,1,4
98727,2,1,345585,345585,345586,0,1,1
98728,2,2,345587,345587,345589,0,2,1
98729,1,2,345588,345589,345591,1,3,0
98730,1,2,345589,345591,345593,2,4,0
98731,2,3,345591,345593,345596,2,5,0
98732,2,2,345593,345596,345598,3,5,0
98733,2,2,345595,345598,345600,3,5,0
98734,3,3,345598,345600,345603,2,5,0
98735,2,2,345600,345603,345605,3,5,0
98736,2,3,345602,345605,345608,3,6,0
98737,5,2,345607,345608,345610,1,3,0
98738,6,3,345613,345613,345616,0,3,3
98739,2,2,345615,345616,345618,1,3,0
98740,3,1,345618,345618,345619,0,1,0
98741,5,2,345623,345623,345625,0,2,4
98742,4,2,345627,345627,345629,0,2,2
98743,2,3,345629,345629,345632,0,3,0
98744,5,2,345634,345634,345636,0,2,2
98745,1,2,345635,345636,345638,1,3,0
98746,2,1,345637,345638,345639,1,2,0
98747,5,2,345642,345642,345644,0,2,3
98748,4,2,345646,345646,345648,0,2,2
98749,5,3,345651,345651,345654,0,3,3
98750,3,1,345654,345654,345655,0,1,0
98751,4,1,345658,345658,345659,0,1,3
98752,2,2,345660,345660,345662,0,2,1
98753,2,1,345662,345662,345663,0,1,0
98754,5,3,345667,345667,345670,0,3,4
98755,6,2,345673,345673,345675,0,2,3
98756,2,2,345675,345675,345677,0,2,0
98757,5,2,345680,345680,345682,0,2,3
98758,6,3,345686,345686,345689,0,3,4
98759,3,1,345689,345689,345690,0,1,0
98760,5,1,345694,345694,345695,0,1,4
98761,3,3,345697,345697,345700,0,3,2
98762,2,2,345699,345700,345702,1,3,0
98763,5,2,345704,345704,345706,0,2,2
98764,3,2,345707,345707,345709,0,2,1
98765,4,2,345711,345711,345713,0,2,2
98766,5,3,345716,345716,345719,0,3,3
98767,2,1,345718,345719,345720,1,2,0
98768,1,1,345719,345720,345721,1,2,0
98769,6,3,345725,345725,345728,0,3,4
98770,4,2,345729,345729,345731,0,2,1
98771,5,1,345734,345734,345735,0,1,3
98772,4,2,345738,345738,345740,0,2,3
98773,1,3,345739,345740,345743,1,4,0
98774,2,1,345741,345743,345744,2,3,0
98775,1,1,345742,345744,345745,2,3,0
98776,5,1,345747,345747,345748,0,1,2
98777,2,2,345749,345749,345751,0,2,1
98778,5,1,345754,345754,345755,0,1,3
98779,5,2,345759,345759,345761,0,2,4
98780,2,1,345761,345761,345762,0,1,0
98781,6,2,345767,345767,345769,0,2,5
98782,1,1,345768,345769,345770,1,2,0
98783,3,3,345771,345771,345774,0,3,1
98784,5,3,345776,345776,345779,0,3,2
98785,3,1,345779,345779,345780,0,1,0
98786,4,1,345783,345783,345784,0,1,3
98787,6,1,345789,345789,345790,0,1,5
98788,4,3,345793,345793,345796,0,3,3
98789,6,3,345799,345799,345802,0,3,3
98790,5,1,345804,345804,345805,0,1,2
98791,6,1,345810,345810,345811,0,1,5
98792,6,3,345816,345816,345819,0,3,5
98793,2,2,345818,345819,345821,1,3,0
98794,5,3,345823,345823,345826,0,3,2
98795,4,3,345827,345827,345830,0,3,1
98796,3,2,345830,345830,345832,0,2,0
98797,4,1,345834,345834,345835,0,1,2
98798,5,3,345839,345839,345842,0,3,4
98799,3,3,345842,345842,345845,0,3,0
98800,3,2,345845,345845,345847,0,2,0
98801,5,2,345850,345850,345852,0,2,3
98802,4,3,345854,345854,345857,0,3,2
98803,6,1,345860,345860,345861,0,1,3
98804,3,3,345863,345863,345866,0,3,2
98805,5,3,345868,345868,345871,0,3,2
98806,3,3,345871,345871,345874,0,3,0
98807,3,2,345874,345874,345876,0,2,0
98808,6,2,345880,345880,345882,0,2,4
98809,4,3,345884,345884,345887,0,3,2
98810,5,2,345889,345889,345891,0,2,2
98811,5,1,345894,345894,345895,0,1,3
98812,4,1,345898,345898,345899,0,1,3
98813,2,2,345900,345900,345902,0,2,1
98814,4,3,345904,345904,345907,0,3,2
98815,1,3,345905,345907,345910,2,5,0
98816,1,1,345906,345910,345911,4,5,0
98817,1,1,345907,345911,345912,4,5,0
98818,4,1,345911,345912,345913,1,2,0
98819,5,1,345916,345916,345917,0,1,3
98820,6,3,345922,345922,345925,0,3,5
98821,1,1,345923,345925,345926,2,3,0
98822,1,3,345924,345926,345929,2,5,0
98823,3,3,345927,345929,345932,2,5,0
98824,5,3,345932,345932,345935,0,3,0
98825,4,3,345936,345936,345939,0,3,1
98826,2,2,345938,345939,345941,1,3,0
98827,6,1,345944,345944,345945,0,1,3
98828,1,1,345945,345945,345946,0,1,0
98829,5,2,345950,345950,345952,0,2,4
98830,3,2,345953,345953,345955,0,2,1
98831,5,2,345958,345958,345960,0,2,3
98832,6,1,345964,345964,345965,0,1,4
98833,1,3,345965,345965,345968,0,3,0
98834,4,2,345969,345969,345971,0,2,1
98835,5,1,345974,345974,345975,0,1,3
98836,1,2,345975,345975,345977,0,2,0
98837,6,3,345981,345981,345984,0,3,4
98838,1,1,345982,345984,345985,2,3,0
98839,1,3,345983,345985,345988,2,5,0
98840,3,3,345986,345988,345991,2,5,0
98841,1,2,345987,345991,345993,4,6,0
98842,1,3,345988,345993,345996,5,8,0
98843,3,3,345991,345996,345999,5,8,0
98844,3,1,345994,345999,346000,5,6,0
98845,1,3,345995,346000,346003,5,8,0
98846,4,2,345999,346003,346005,4,6,0
98847,6,1,346005,346005,346006,0,1,0
98848,6,2,346011,346011,346013,0,2,5
98849,6,3,346017,346017,346020,0,3,4
98850,5,2,346022,346022,346024,0,2,2
98851,1,2,346023,346024,346026,1,3,0
98852,4,1,346027,346027,346028,0,1,1
98853,4,2,346031,346031,346033,0,2,3
98854,3,1,346034,346034,346035,0,1,1
98855,4,3,346038,346038,346041,0,3,3
98856,6,1,346044,346044,346045,0,1,3
98857,5,3,346049,346049,346052,0,3,4
98858,2,2,346051,346052,346054,1,3,0
98859,4,1,346055,346055,346056,0,1,1
98860,5,2,346060,346060,346062,0,2,4
98861,2,1,346062,346062,346063,0,1,0
98862,3,1,346065,346065,346066,0,1,2
98863,3,3,346068,346068,346071,0,3,2
98864,3,3,346071,346071,346074,0,3,0
98865,4,1,346075,346075,346076,0,1,1
98866,4,1,346079,346079,346080,0,1,3
98867,6,2,346085,346085,346087,0,2,5
98868,1,2,346086,346087,346089,1,3,0
98869,4,2,346090,346090,346092,0,2,1
98870,6,3,346096,346096,346099,0,3,4
98871,3,2,346099,346099,346101,0,2,0
98872,5,1,346104,346104,346105,0,1,3
98873,1,3,346105,346105,346108,0,3,0
98874,3,2,346108,346108,346110,0,2,0
98875,1,2,346109,346110,346112,1,3,0
98876,1,3,346110,346112,346115,2,5,0
98877,4,2,346114,346115,346117,1,3,0
98878,1,1,346115,346117,346118,2,3,0
98879,1,2,346116,346118,346120,2,4,0
98880,5,1,346121,346121,346122,0,1,1
98881,3,1,346124,346124,346125,0,1,2
98882,1,1,346125,346125,346126,0,1,0
98883,6,3,346131,346131,346134,0,3,5
98884,5,3,346136,346136,346139,0,3,2
98885,5,1,346141,346141,346142,0,1,2
98886,3,1,346144,346144,346145,0,1,2
98887,5,3,346149,346149,346152,0,3,4
98888,4,3,346153,346153,346156,0,3,1
98889,5,3,346158,346158,346161,0,3,2
98890,6,3,346164,346164,346167,0,3,3
98891,6,1,346170,346170,346171,0,1,3
98892,3,1,346173,346173,346174,0,1,2
98893,6,1,346179,346179,346180,0,1,5
98894,3,3,346182,346182,346185,0,3,2
98895,2,2,346184,346185,346187,1,3,0
98896,2,3,346186,346187,346190,1,4,0
98897,4,1,346190,346190,346191,0,1,0
98898,6,3,346196,346196,346199,0,3,5
98899,6,2,346202,346202,346204,0,2,3
98900,2,3,346204,346204,346207,0,3,0
98901,5,3,346209,346209,346212,0,3,2
98902,3,2,346212,346212,346214,0,2,0
98903,1,2,346213,346214,346216,1,3,0
98904,6,3,346219,346219,346222,0,3,3
98905,2,1,346221,346222,346223,1,2,0
98906,3,1,346224,346224,346225,0,1,1
98907,2,1,346226,346226,346227,0,1,1
98908,1,1,346227,346227,346228,0,1,0
98909,2,3,346229,346229,346232,0,3,1
98910,6,2,346235,346235,346237,0,2,3
98911,1,2,346236,346237,346239,1,3,0
98912,2,3,346238,346239,346242,1,4,0
98913,2,2,346240,346242,346244,2,4,0
98914,1,3,346241,346244,346247,3,6,0
98915,6,2,346247,346247,346249,0,2,0
98916,6,1,346253,346253,346254,0,1,4
98917,2,2,346255,346255,346257,0,2,1
98918,6,1,346261,346261,346262,0,1,4
98919,5,2,346266,346266,346268,0,2,4
98920,5,1,346271,346271,346272,0,1,3
98921,2,2,346273,346273,346275,0,2,1
98922,1,3,346274,346275,346278,1,4,0
98923,4,2,346278,346278,346280,0,2,0
98924,1,1,346279,346280,346281,1,2,0
98925,2,3,346281,346281,346284,0,3,0
98926,6,3,346287,346287,346290,0,3,3
98927,2,3,346289,346290,346293,1,4,0
98928,3,3,346292,346293,346296,1,4,0
98929,4,3,346296,346296,346299,0,3,0
98930,6,2,346302,346302,346304,0,2,3
98931,6,2,346308,346308,346310,0,2,4
98932,4,2,346312,346312,346314,0,2,2
98933,6,2,346318,346318,346320,0,2,4
98934,3,3,346321,346321,346324,0,3,1
98935,6,1,346327,346327,346328,0,1,3
98936,6,1,346333,346333,346334,0,1,5
98937,3,2,346336,346336,346338,0,2,2
98938,2,1,346338,346338,346339,0,1,0
98939,3,1,346341,346341,346342,0,1,2
98940,5,1,346346,346346,346347,0,1,4
98941,2,3,346348,346348,346351,0,3,1
98942,4,2,346352,346352,346354,0,2,1
98943,2,1,346354,346354,346355,0,1,0
98944,1,2,346355,346355,346357,0,2,0
98945,4,2,346359,346359,346361,0,2,2
98946,1,2,346360,346361,346363,1,3,0
98947,5,2,346365,346365,346367,0,2,2
98948,5,2,346370,346370,346372,0,2,3
98949,2,1,346372,346372,346373,0,1,0
98950,3,3,346375,346375,346378,0,3,2
98951,1,3,346376,346378,346381,2,5,0
98952,1,1,346377,346381,346382,4,5,0
98953,4,2,346381,346382,346384,1,3,0
98954,4,1,346385,346385,346386,0,1,1
98955,4,1,346389,346389,346390,0,1,3
98956,2,2,346391,346391,346393,0,2,1
98957,2,3,346393,346393,346396,0,3,0
98958,1,2,346394,346396,346398,2,4,0
98959,3,2,346397,346398,346400,1,3,0
98960,6,2,346403,346403,346405,0,2,3
98961,6,2,346409,346409,346411,0,2,4
98962,1,1,346410,346411,346412,1,2,0
98963,5,1,346415,346415,346416,0,1,3
98964,1,3,346416,346416,346419,0,3,0
98965,6,2,346422,346422,346424,0,2,3
98966,5,3,346427,346427,346430,0,3,3
98967,5,2,346432,346432,346434,0,2,2
98968,4,1,346436,346436,346437,0,1,2
98969,2,3,346438,346438,346441,0,3,1
98970,1,1,346439,346441,346442,2,3,0
98971,3,1,346442,346442,346443,0,1,0
98972,3,2,346445,346445,346447,0,2,2
98973,2,2,346447,346447,346449,0,2,0
98974,3,1,346450,346450,346451,0,1,1
98975,6,1,346456,346456,346457,0,1,5
98976,1,2,346457,346457,346459,0,2,0
98977,4,2,346461,346461,346463,0,2,2
98978,2,2,346463,346463,346465,0,2,0
98979,1,1,346464,346465,346466,1,2,0
98980,4,3,346468,346468,346471,0,3,2
98981,5,1,346473,346473,346474,0,1,2
98982,2,1,346475,346475,346476,0,1,1
98983,3,2,346478,346478,346480,0,2,2
98984,6,1,346484,346484,346485,0,1,4
98985,6,2,346490,346490,346492,0,2,5
98986,6,1,346496,346496,346497,0,1,4
98987,2,2,346498,346498,346500,0,2,1
98988,3,2,346501,346501,346503,0,2,1
98989,5,1,346506,346506,346507,0,1,3
98990,6,1,346512,346512,346513,0,1,5
98991,5,1,346517,346517,346518,0,1,4
98992,6,3,346523,346523,346526,0,3,5
98993,3,2,346526,346526,346528,0,2,0
98994,1,2,346527,346528,346530,1,3,0
98995,6,1,346533,346533,346534,0,1,3
98996,1,3,346534,346534,346537,0,3,0
98997,4,3,346538,346538,346541,0,3,1
98998,5,2,346543,346543,346545,0,2,2
98999,6,3,346549,346549,346552,0,3,4
99000,3,1,346552,346552,346553,0,1,0
99001,2,1,346554,346554,346555,0,1,1
99002,4,2,346558,346558,346560,0,2,3
99003,2,2,346560,346560,346562,0,2,0
99004,4,2,346564,346564,346566,0,2,2
99005,3,1,346567,346567,346568,0,1,1
99006,1,2,346568,346568,346570,0,2,0
99007,6,3,346574,346574,346577,0,3,4
99008,3,2,346577,346577,346579,0,2,0
99009,4,2,346581,346581,346583,0,2,2
99010,3,3,346584,346584,346587,0,3,1
99011,2,3,346586,346587,346590,1,4,0
99012,4,2,346590,346590,346592,0,2,0
99013,3,3,346593,346593,346596,0,3,1
99014,1,3,346594,346596,346599,2,5,0
99015,5,1,346599,346599,346600,0,1,0
99016,4,2,346603,346603,346605,0,2,3
99017,3,1,346606,346606,346607,0,1,1
99018,2,1,346608,346608,346609,0,1,1
99019,5,1,346613,346613,346614,0,1,4
99020,2,3,346615,346615,346618,0,3,1
99021,2,1,346617,346618,346619,1,2,0
99022,3,1,346620,346620,346621,0,1,1
99023,2,2,346622,346622,346624,0,2,1
99024,3,1,346625,346625,346626,0,1,1
99025,5,3,346630,346630,346633,0,3,4
99026,5,1,346635,346635,346636,0,1,2
99027,5,3,346640,346640,346643,0,3,4
99028,1,2,346641,346643,346645,2,4,0
99029,5,1,346646,346646,346647,0,1,1
99030,6,3,346652,346652,346655,0,3,5
99031,2,2,346654,346655,346657,1,3,0
99032,2,3,346656,346657,346660,1,4,0
99033,3,3,346659,346660,346663,1,4,0
99034,5,3,346664,346664,346667,0,3,1
99035,4,2,346668,346668,346670,0,2,1
99036,2,2,346670,346670,346672,0,2,0
99037,2,2,346672,346672,346674,0,2,0
99038,1,2,346673,346674,346676,1,3,0
99039,1,3,346674,346676,346679,2,5,0
99040,6,3,346680,346680,346683,0,3,1
99041,6,2,346686,346686,346688,0,2,3
99042,1,1,346687,346688,346689,1,2,0
99043,2,1,346689,346689,346690,0,1,0
99044,3,2,346692,346692,346694,0,2,2
99045,1,2,346693,346694,346696,1,3,0
99046,3,3,346696,346696,346699,0,3,0
99047,5,1,346701,346701,346702,0,1,2
99048,4,2,346705,346705,346707,0,2,3
99049,3,3,346708,346708,346711,0,3,1
99050,4,2,346712,346712,346714,0,2,1
99051,1,2,346713,346714,346716,1,3,0
99052,6,2,346719,346719,346721,0,2,3
99053,2,2,346721,346721,346723,0,2,0
99054,6,1,346727,346727,346728,0,1,4
99055,4,3,346731,346731,346734,0,3,3
99056,3,2,346734,346734,346736,0,2,0
99057,4,1,346738,346738,346739,0,1,2
99058,5,2,346743,346743,346745,0,2,4
99059,6,3,346749,346749,346752,0,3,4
99060,3,1,346752,346752,346753,0,1,0
99061,5,2,346757,346757,346759,0,2,4
99062,2,2,346759,346759,346761,0,2,0
99063,3,2,346762,346762,346764,0,2,1
99064,4,2,346766,346766,346768,0,2,2
99065,4,1,346770,346770,346771,0,1,2
99066,3,2,346773,346773,346775,0,2,2
99067,3,2,346776,346776,346778,0,2,1
99068,5,1,346781,346781,346782,0,1,3
99069,5,2,346786,346786,346788,0,2,4
99070,3,2,346789,346789,346791,0,2,1
99071,6,2,346795,346795,346797,0,2,4
99072,4,2,346799,346799,346801,0,2,2
99073,6,3,346805,346805,346808,0,3,4
99074,1,1,346806,346808,346809,2,3,0
99075,3,1,346809,346809,346810,0,1,0
99076,2,3,346811,346811,346814,0,3,1
99077,4,3,346815,346815,346818,0,3,1
99078,3,1,346818,346818,346819,0,1,0
99079,4,3,346822,346822,346825,0,3,3
99080,4,2,346826,346826,346828,0,2,1
99081,3,2,346829,346829,346831,0,2,1
99082,1,2,346830,346831,346833,1,3,0
99083,4,2,346834,346834,346836,0,2,1
99084,4,2,346838,346838,346840,0,2,2
99085,3,1,346841,346841,346842,0,1,1
99086,5,2,346846,346846,346848,0,2,4
99087,4,3,346850,346850,346853,0,3,2
99088,3,1,346853,346853,346854,0,1,0
99089,4,2,346857,346857,346859,0,2,3
99090,5,2,346862,346862,346864,0,2,3
99091,1,2,346863,346864,346866,1,3,0
99092,3,1,346866,346866,346867,0,1,0
99093,3,1,346869,346869,346870,0,1,2
99094,6,3,346875,346875,346878,0,3,5
99095,5,3,346880,346880,346883,0,3,2
99096,4,2,346884,346884,346886,0,2,1
99097,6,1,346890,346890,346891,0,1,4
99098,5,3,346895,346895,346898,0,3,4
99099,1,3,346896,346898,346901,2,5,0
99100,2,2,346898,346901,346903,3,5,0
99101,5,3,346903,346903,346906,0,3,0
99102,1,2,346904,346906,346908,2,4,0
99103,2,2,346906,346908,346910,2,4,0
99104,3,1,346909,346910,346911,1,2,0
99105,5,2,346914,346914,346916,0,2,3
99106,2,2,346916,346916,346918,0,2,0
99107,1,2,346917,346918,346920,1,3,0
99108,1,2,346918,346920,346922,2,4,0
99109,3,1,346921,346922,346923,1,2,0
99110,2,3,346923,346923,346926,0,3,0
99111,6,2,346929,346929,346931,0,2,3
99112,3,2,346932,346932,346934,0,2,1
99113,6,2,346938,346938,346940,0,2,4
99114,3,1,346941,346941,346942,0,1,1
99115,3,1,346944,346944,346945,0,1,2
99116,4,2,346948,346948,346950,0,2,3
99117,5,3,346953,346953,346956,0,3,3
99118,2,2,346955,346956,346958,1,3,0
99119,2,2,346957,346958,346960,1,3,0
99120,1,3,346958,346960,346963,2,5,0
99121,4,2,346962,346963,346965,1,3,0
99122,2,2,346964,346965,346967,1,3,0
99123,5,2,346969,346969,346971,0,2,2
99124,2,3,346971,346971,346974,0,3,0
99125,4,2,346975,346975,346977,0,2,1
99126,1,3,346976,346977,346980,1,4,0
99127,6,2,346982,346982,346984,0,2,2
99128,6,1,346988,346988,346989,0,1,4
99129,3,2,346991,346991,346993,0,2,2
99130,1,3,346992,346993,346996,1,4,0
99131,1,2,346993,346996,346998,3,5,0
99132,5,1,346998,346998,346999,0,1,0
99133,3,1,347001,347001,347002,0,1,2
99134,2,1,347003,347003,347004,0,1,1
99135,3,2,347006,347006,347008,0,2,2
99136,6,1,347012,347012,347013,0,1,4
99137,4,1,347016,347016,347017,0,1,3
99138,3,3,347019,347019,347022,0,3,2
99139,2,3,347021,347022,347025,1,4,0
99140,5,1,347026,347026,347027,0,1,1
99141,6,1,347032,347032,347033,0,1,5
99142,2,2,347034,347034,347036,0,2,1
99143,4,2,347038,347038,347040,0,2,2
99144,6,2,347044,347044,347046,0,2,4
99145,4,2,347048,347048,347050,0,2,2
99146,3,3,347051,347051,347054,0,3,1
99147,6,3,347057,347057,347060,0,3,3
99148,5,1,347062,347062,347063,0,1,2
99149,1,3,347063,347063,347066,0,3,0
99150,2,3,347065,347066,347069,1,4,0
99151,3,3,347068,347069,347072,1,4,0
99152,1,1,347069,347072,347073,3,4,0
99153,4,1,347073,347073,347074,0,1,0
99154,6,3,347079,347079,347082,0,3,5
99155,2,3,347081,347082,347085,1,4,0
99156,3,3,347084,347085,347088,1,4,0
99157,4,1,347088,347088,347089,0,1,0
99158,3,2,347091,347091,347093,0,2,2
99159,5,1,347096,347096,347097,0,1,3
99160,1,2,347097,347097,347099,0,2,0
99161,3,3,347100,347100,347103,0,3,1
99162,3,1,347103,347103,347104,0,1,0
99163,6,3,347109,347109,347112,0,3,5
99164,2,3,347111,347112,347115,1,4,0
99165,5,1,347116,347116,347117,0,1,1
99166,6,1,347122,347122,347123,0,1,5
99167,2,1,347124,347124,347125,0,1,1
99168,4,2,347128,347128,347130,0,2,3
99169,4,1,347132,347132,347133,0,1,2
99170,2,3,347134,347134,347137,0,3,1
99171,3,2,347137,347137,347139,0,2,0
99172,6,2,347143,347143,347145,0,2,4
99173,6,1,347149,347149,347150,0,1,4
99174,4,3,347153,347153,347156,0,3,3
99175,5,3,347158,347158,347161,0,3,2
99176,1,1,347159,347161,347162,2,3,0
99177,1,1,347160,347162,347163,2,3,0
99178,4,3,347164,347164,347167,0,3,1
99179,6,2,347170,347170,347172,0,2,3
99180,3,3,347173,347173,347176,0,3,1
99181,4,2,347177,347177,347179,0,2,1
99182,3,1,347180,347180,347181,0,1,1
99183,3,1,347183,347183,347184,0,1,2
99184,2,3,347185,347185,347188,0,3,1
99185,4,3,347189,347189,347192,0,3,1
99186,1,3,347190,347192,347195,2,5,0
99187,4,2,347194,347195,347197,1,3,0
99188,2,2,347196,347197,347199,1,3,0
99189,3,2,347199,347199,347201,0,2,0
99190,5,2,347204,347204,347206,0,2,3
99191,5,1,347209,347209,347210,0,1,3
99192,6,2,347215,347215,347217,0,2,5
99193,1,3,347216,347217,347220,1,4,0
99194,5,1,347221,347221,347222,0,1,1
99195,5,3,347226,347226,347229,0,3,4
99196,6,2,347232,347232,347234,0,2,3
99197,3,3,347235,347235,347238,0,3,1
99198,6,3,347241,347241,347244,0,3,3
99199,3,3,347244,347244,347247,0,3,0
99200,6,2,347250,347250,347252,0,2,3
99201,4,1,347254,347254,347255,0,1,2
99202,4,1,347258,347258,347259,0,1,3
99203,3,3,347261,347261,347264,0,3,2
99204,4,3,347265,347265,347268,0,3,1
99205,6,1,347271,347271,347272,0,1,3
99206,4,2,347275,347275,347277,0,2,3
99207,1,2,347276,347277,347279,1,3,0
99208,2,2,347278,347279,347281,1,3,0
99209,1,2,347279,347281,347283,2,4,0
99210,1,1,347280,347283,347284,3,4,0
99211,6,2,347286,347286,347288,0,2,2
99212,1,1,347287,347288,347289,1,2,0
99213,2,1,347289,347289,347290,0,1,0
99214,5,1,347294,347294,347295,0,1,4
99215,5,1,347299,347299,347300,0,1,4
99216,1,2,347300,347300,347302,0,2,0
99217,2,3,347302,347302,347305,0,3,0
99218,4,2,347306,347306,347308,0,2,1
99219,5,3,347311,347311,347314,0,3,3
99220,2,1,347313,347314,347315,1,2,0
99221,3,3,347316,347316,347319,0,3,1
99222,1,1,347317,347319,347320,2,3,0
99223,3,2,347320,347320,347322,0,2,0
99224,6,2,347326,347326,347328,0,2,4
99225,4,3,347330,347330,347333,0,3,2
99226,1,1,347331,347333,347334,2,3,0
99227,6,1,347337,347337,347338,0,1,3
99228,4,1,347341,347341,347342,0,1,3
99229,3,3,347344,347344,347347,0,3,2
99230,2,3,347346,347347,347350,1,4,0
99231,5,2,347351,347351,347353,0,2,1
99232,5,2,347356,347356,347358,0,2,3
99233,6,2,347362,347362,347364,0,2,4
99234,4,3,347366,347366,347369,0,3,2
99235,1,3,347367,347369,347372,2,5,0
99236,2,3,347369,347372,347375,3,6,0
99237,5,3,347374,347375,347378,1,4,0
99238,6,3,347380,347380,347383,0,3,2
99239,5,2,347385,347385,347387,0,2,2
99240,5,3,347390,347390,347393,0,3,3
99241,3,2,347393,347393,347395,0,2,0
99242,1,2,347394,347395,347397,1,3,0
99243,1,3,347395,347397,347400,2,5,0
99244,2,1,347397,347400,347401,3,4,0
99245,4,2,347401,347401,347403,0,2,0
99246,3,2,347404,347404,347406,0,2,1
99247,1,3,347405,347406,347409,1,4,0
99248,5,3,347410,347410,347413,0,3,1
99249,1,1,347411,347413,347414,2,3,0
99250,1,1,347412,347414,347415,2,3,0
99251,6,1,347418,347418,347419,0,1,3
99252,4,2,347422,347422,347424,0,2,3
99253,1,1,347423,347424,347425,1,2,0
99254,2,1,347425,347425,347426,0,1,0
99255,4,3,347429,347429,347432,0,3,3
99256,2,1,347431,347432,347433,1,2,0
99257,2,1,347433,347433,347434,0,1,0
99258,3,3,347436,347436,347439,0,3,2
99259,4,1,347440,347440,347441,0,1,1
99260,6,1,347446,347446,347447,0,1,5
99261,1,2,347447,347447,347449,0,2,0
99262,6,3,347453,347453,347456,0,3,4
99263,2,3,347455,347456,347459,1,4,0
99264,1,2,347456,347459,347461,3,5,0
99265,3,3,347459,347461,347464,2,5,0
99266,1,1,347460,347464,347465,4,5,0
99267,2,1,347462,347465,347466,3,4,0
99268,1,1,347463,347466,347467,3,4,0
99269,1,1,347464,347467,347468,3,4,0
99270,6,2,347470,347470,347472,0,2,2
99271,5,1,347475,347475,347476,0,1,3
99272,2,1,347477,347477,347478,0,1,1
99273,3,1,347480,347480,347481,0,1,2
99274,2,1,347482,347482,347483,0,1,1
99275,1,2,347483,347483,347485,0,2,0
99276,3,1,347486,347486,347487,0,1,1
99277,4,1,347490,347490,347491,0,1,3
99278,4,1,347494,347494,347495,0,1,3
99279,5,3,347499,347499,347502,0,3,4
99280,6,3,347505,347505,347508,0,3,3
99281,4,1,347509,347509,347510,0,1,1
99282,2,3,347511,347511,347514,0,3,1
99283,1,2,347512,347514,347516,2,4,0
99284,3,1,347515,347516,347517,1,2,0
99285,6,1,347521,347521,347522,0,1,4
99286,5,1,347526,347526,347527,0,1,4
99287,4,1,347530,347530,347531,0,1,3
99288,6,1,347536,347536,347537,0,1,5
99289,1,1,347537,347537,347538,0,1,0
99290,6,3,347543,347543,347546,0,3,5
99291,2,2,347545,347546,347548,1,3,0
99292,1,1,347546,347548,347549,2,3,0
99293,1,3,347547,347549,347552,2,5,0
99294,6,1,347553,347553,347554,0,1,1
99295,6,1,347559,347559,347560,0,1,5
99296,4,1,347563,347563,347564,0,1,3
99297,6,1,347569,347569,347570,0,1,5
99298,6,2,347575,347575,347577,0,2,5
99299,1,1,347576,347577,347578,1,2,0
99300,1,3,347577,347578,347581,1,4,0
99301,6,3,347583,347583,347586,0,3,2
99302,1,1,347584,347586,347587,2,3,0
99303,4,3,347588,347588,347591,0,3,1
99304,3,2,347591,347591,347593,0,2,0
99305,5,3,347596,347596,347599,0,3,3
99306,1,3,347597,347599,347602,2,5,0
99307,1,1,347598,347602,347603,4,5,0
99308,6,1,347604,347604,347605,0,1,1
99309,5,1,347609,347609,347610,0,1,4
99310,4,2,347613,347613,347615,0,2,3
99311,2,3,347615,347615,347618,0,3,0
99312,4,3,347619,347619,347622,0,3,1
99313,2,3,347621,347622,347625,1,4,0
99314,5,1,347626,347626,347627,0,1,1
99315,3,3,347629,347629,347632,0,3,2
99316,1,2,347630,347632,347634,2,4,0
99317,2,3,347632,347634,347637,2,5,0
99318,5,2,347637,347637,347639,0,2,0
99319,3,2,347640,347640,347642,0,2,1
99320,5,2,347645,347645,347647,0,2,3
99321,1,2,347646,347647,347649,1,3,0
99322,5,1,347651,347651,347652,0,1,2
99323,2,3,347653,347653,347656,0,3,1
99324,3,1,347656,347656,347657,0,1,0
99325,4,2,347660,347660,347662,0,2,3
99326,4,1,347664,347664,347665,0,1,2
99327,2,3,347666,347666,347669,0,3,1
99328,3,1,347669,347669,347670,0,1,0
99329,2,2,347671,347671,347673,0,2,1
99330,1,2,347672,347673,347675,1,3,0
99331,1,3,347673,347675,347678,2,5,0
99332,2,1,347675,347678,347679,3,4,0
99333,5,3,347680,347680,347683,0,3,1
99334,1,2,347681,347683,347685,2,4,0
99335,4,3,347685,347685,347688,0,3,0
99336,3,1,347688,347688,347689,0,1,0
99337,5,1,347693,347693,347694,0,1,4
99338,1,2,347694,347694,347696,0,2,0
99339,6,3,347700,347700,347703,0,3,4
99340,3,2,347703,347703,347705,0,2,0
99341,5,1,347708,347708,347709,0,1,3
99342,2,2,347710,347710,347712,0,2,1
99343,3,2,347713,347713,347715,0,2,1
99344,4,1,347717,347717,347718,0,1,2
99345,3,1,347720,347720,347721,0,1,2
99346,2,2,347722,347722,347724,0,2,1
99347,4,3,347726,347726,347729,0,3,2
99348,5,2,347731,347731,347733,0,2,2
99349,5,1,347736,347736,347737,0,1,3
99350,2,2,347738,347738,347740,0,2,1
99351,3,2,347741,347741,347743,0,2,1
99352,5,1,347746,347746,347747,0,1,3
99353,3,3,347749,347749,347752,0,3,2
99354,2,3,347751,347752,347755,1,4,0
99355,2,2,347753,347755,347757,2,4,0
99356,2,3,347755,347757,347760,2,5,0
99357,2,2,347757,347760,347762,3,5,0
99358,2,2,347759,347762,347764,3,5,0
99359,2,3,347761,347764,347767,3,6,0
99360,6,2,347767,347767,347769,0,2,0
99361,2,3,347769,347769,347772,0,3,0
99362,6,2,347775,347775,347777,0,2,3
99363,1,1,347776,347777,347778,1,2,0
99364,5,1,347781,347781,347782,0,1,3
99365,2,3,347783,347783,347786,0,3,1
99366,3,3,347786,347786,347789,0,3,0
99367,3,2,347789,347789,347791,0,2,0
99368,6,1,347795,347795,347796,0,1,4
99369,5,3,347800,347800,347803,0,3,4
99370,2,1,347802,347803,347804,1,2,0
99371,6,2,347808,347808,347810,0,2,4
99372,6,3,347814,347814,347817,0,3,4
99373,3,1,347817,347817,347818,0,1,0
99374,5,2,347822,347822,347824,0,2,4
99375,1,1,347823,347824,347825,1,2,0
99376,5,2,347828,347828,347830,0,2,3
99377,2,1,347830,347830,347831,0,1,0
99378,5,1,347835,347835,347836,0,1,4
99379,3,3,347838,347838,347841,0,3,2
99380,6,3,347844,347844,347847,0,3,3
99381,3,2,347847,347847,347849,0,2,0
99382,5,3,347852,347852,347855,0,3,3
99383,4,2,347856,347856,347858,0,2,1
99384,4,2,347860,347860,347862,0,2,2
99385,5,1,347865,347865,347866,0,1,3
99386,3,3,347868,347868,347871,0,3,2
99387,3,3,347871,347871,347874,0,3,0
99388,4,3,347875,347875,347878,0,3,1
99389,3,1,347878,347878,347879,0,1,0
99390,4,2,347882,347882,347884,0,2,3
99391,5,1,347887,347887,347888,0,1,3
99392,3,2,347890,347890,347892,0,2,2
99393,4,3,347894,347894,347897,0,3,2
99394,1,1,347895,347897,347898,2,3,0
99395,6,2,347901,347901,347903,0,2,3
99396,5,2,347906,347906,347908,0,2,3
99397,3,2,347909,347909,347911,0,2,1
99398,5,2,347914,347914,347916,0,2,3
99399,1,1,347915,347916,347917,1,2,0
99400,1,2,347916,347917,347919,1,3,0
99401,4,2,347920,347920,347922,0,2,1
99402,6,2,347926,347926,347928,0,2,4
99403,6,2,347932,347932,347934,0,2,4
99404,3,3,347935,347935,347938,0,3,1
99405,2,3,347937,347938,347941,1,4,0
99406,3,1,347940,347941,347942,1,2,0
99407,5,3,347945,347945,347948,0,3,3
99408,6,1,347951,347951,347952,0,1,3
99409,5,2,347956,347956,347958,0,2,4
99410,5,1,347961,347961,347962,0,1,3
99411,3,1,347964,347964,347965,0,1,2
99412,2,2,347966,347966,347968,0,2,1
99413,1,3,347967,347968,347971,1,4,0
99414,5,3,347972,347972,347975,0,3,1
99415,2,1,347974,347975,347976,1,2,0
99416,6,2,347980,347980,347982,0,2,4
99417,3,2,347983,347983,347985,0,2,1
99418,4,3,347987,347987,347990,0,3,2
99419,3,2,347990,347990,347992,0,2,0
99420,5,2,347995,347995,347997,0,2,3
99421,1,2,347996,347997,347999,1,3,0
99422,4,3,348000,348000,348003,0,3,1
99423,2,3,348002,348003,348006,1,4,0
99424,2,3,348004,348006,348009,2,5,0
99425,2,2,348006,348009,348011,3,5,0
99426,6,3,348012,348012,348015,0,3,1
99427,3,3,348015,348015,348018,0,3,0
99428,3,2,348018,348018,348020,0,2,0
99429,2,2,348020,348020,348022,0,2,0
99430,5,1,348025,348025,348026,0,1,3
99431,5,2,348030,348030,348032,0,2,4
99432,6,3,348036,348036,348039,0,3,4
99433,1,3,348037,348039,348042,2,5,0
99434,2,2,348039,348042,348044,3,5,0
99435,1,2,348040,348044,348046,4,6,0
99436,3,1,348043,348046,348047,3,4,0
99437,4,3,348047,348047,348050,0,3,0
99438,4,1,348051,348051,348052,0,1,1
99439,5,3,348056,348056,348059,0,3,4
99440,3,2,348059,348059,348061,0,2,0
99441,2,2,348061,348061,348063,0,2,0
99442,6,1,348067,348067,348068,0,1,4
99443,4,3,348071,348071,348074,0,3,3
99444,3,1,348074,348074,348075,0,1,0
99445,2,3,348076,348076,348079,0,3,1
99446,6,2,348082,348082,348084,0,2,3
99447,2,2,348084,348084,348086,0,2,0
99448,3,1,348087,348087,348088,0,1,1
99449,6,2,348093,348093,348095,0,2,5
99450,1,3,348094,348095,348098,1,4,0
99451,5,2,348099,348099,348101,0,2,1
99452,5,3,348104,348104,348107,0,3,3
99453,5,3,348109,348109,348112,0,3,2
99454,5,3,348114,348114,348117,0,3,2
99455,6,3,348120,348120,348123,0,3,3
99456,3,3,348123,348123,348126,0,3,0
99457,1,3,348124,348126,348129,2,5,0
99458,1,2,348125,348129,348131,4,6,0
99459,6,3,348131,348131,348134,0,3,0
99460,1,3,348132,348134,348137,2,5,0
99461,5,2,348137,348137,348139,0,2,0
99462,3,1,348140,348140,348141,0,1,1
99463,1,3,348141,348141,348144,0,3,0
99464,3,3,348144,348144,348147,0,3,0
99465,2,3,348146,348147,348150,1,4,0
99466,5,3,348151,348151,348154,0,3,1
99467,4,1,348155,348155,348156,0,1,1
99468,1,3,348156,348156,348159,0,3,0
99469,2,3,348158,348159,348162,1,4,0
99470,4,1,348162,348162,348163,0,1,0
99471,6,1,348168,348168,348169,0,1,5
99472,6,1,348174,348174,348175,0,1,5
99473,4,3,348178,348178,348181,0,3,3
99474,1,3,348179,348181,348184,2,5,0
99475,2,3,348181,348184,348187,3,6,0
99476,5,2,348186,348187,348189,1,3,0
99477,3,2,348189,348189,348191,0,2,0
99478,4,1,348193,348193,348194,0,1,2
99479,2,2,348195,348195,348197,0,2,1
99480,2,3,348197,348197,348200,0,3,0
99481,4,3,348201,348201,348204,0,3,1
99482,6,1,348207,348207,348208,0,1,3
99483,6,2,348213,348213,348215,0,2,5
99484,2,2,348215,348215,348217,0,2,0
99485,5,2,348220,348220,348222,0,2,3
99486,5,3,348225,348225,348228,0,3,3
99487,6,1,348231,348231,348232,0,1,3
99488,3,2,348234,348234,348236,0,2,2
99489,1,3,348235,348236,348239,1,4,0
99490,4,2,348239,348239,348241,0,2,0
99491,5,1,348244,348244,348245,0,1,3
99492,2,3,348246,348246,348249,0,3,1
99493,2,1,348248,348249,348250,1,2,0
99494,5,1,348253,348253,348254,0,1,3
99495,2,1,348255,348255,348256,0,1,1
99496,2,1,348257,348257,348258,0,1,1
99497,1,3,348258,348258,348261,0,3,0
99498,3,1,348261,348261,348262,0,1,0
99499,6,2,348267,348267,348269,0,2,5
99500,3,3,348270,348270,348273,0,3,1
99501,2,1,348272,348273,348274,1,2,0
99502,4,3,348276,348276,348279,0,3,2
99503,6,1,348282,348282,348283,0,1,3
99504,6,1,348288,348288,348289,0,1,5
99505,3,3,348291,348291,348294,0,3,2
99506,5,3,348296,348296,348299,0,3,2
99507,5,3,348301,348301,348304,0,3,2
99508,6,1,348307,348307,348308,0,1,3
99509,1,1,348308,348308,348309,0,1,0
99510,4,2,348312,348312,348314,0,2,3
99511,3,2,348315,348315,348317,0,2,1
99512,1,2,348316,348317,348319,1,3,0
99513,2,2,348318,348319,348321,1,3,0
99514,4,1,348322,348322,348323,0,1,1
99515,3,2,348325,348325,348327,0,2,2
99516,2,2,348327,348327,348329,0,2,0
99517,1,1,348328,348329,348330,1,2,0
99518,3,1,348331,348331,348332,0,1,1
99519,6,2,348337,348337,348339,0,2,5
99520,4,2,348341,348341,348343,0,2,2
99521,6,3,348347,348347,348350,0,3,4
99522,6,3,348353,348353,348356,0,3,3
99523,1,3,348354,348356,348359,2,5,0
99524,6,2,348360,348360,348362,0,2,1
99525,3,1,348363,348363,348364,0,1,1
99526,3,1,348366,348366,348367,0,1,2
99527,1,1,348367,348367,348368,0,1,0
99528,2,1,348369,348369,348370,0,1,1
99529,5,3,348374,348374,348377,0,3,4
99530,3,3,348377,348377,348380,0,3,0
99531,5,3,348382,348382,348385,0,3,2
99532,6,2,348388,348388,348390,0,2,3
99533,2,2,348390,348390,348392,0,2,0
99534,6,1,348396,348396,348397,0,1,4
99535,1,3,348397,348397,348400,0,3,0
99536,6,2,348403,348403,348405,0,2,3
99537,1,3,348404,348405,348408,1,4,0
99538,3,1,348407,348408,348409,1,2,0
99539,3,1,348410,348410,348411,0,1,1
99540,2,3,348412,348412,348415,0,3,1
99541,4,2,348416,348416,348418,0,2,1
99542,6,2,348422,348422,348424,0,2,4
99543,3,2,348425,348425,348427,0,2,1
99544,1,3,348426,348427,348430,1,4,0
99545,5,1,348431,348431,348432,0,1,1
99546,3,3,348434,348434,348437,0,3,2
99547,1,3,348435,348437,348440,2,5,0
99548,1,3,348436,348440,348443,4,7,0
99549,3,3,348439,348443,348446,4,7,0
99550,2,2,348441,348446,348448,5,7,0
99551,6,1,348447,348448,348449,1,2,0
99552,5,2,348452,348452,348454,0,2,3
99553,5,2,348457,348457,348459,0,2,3
99554,4,1,348461,348461,348462,0,1,2
99555,4,1,348465,348465,348466,0,1,3
99556,5,3,348470,348470,348473,0,3,4
99557,6,3,348476,348476,348479,0,3,3
99558,5,3,348481,348481,348484,0,3,2
99559,4,2,348485,348485,348487,0,2,1
99560,1,2,348486,348487,348489,1,3,0
99561,1,2,348487,348489,348491,2,4,0
99562,4,2,348491,348491,348493,0,2,0
99563,2,1,348493,348493,348494,0,1,0
99564,3,3,348496,348496,348499,0,3,2
99565,1,3,348497,348499,348502,2,5,0
99566,3,3,348500,348502,348505,2,5,0
99567,3,3,348503,348505,348508,2,5,0
99568,4,2,348507,348508,348510,1,3,0
99569,4,1,348511,348511,348512,0,1,1
99570,5,3,348516,348516,348519,0,3,4
99571,2,3,348518,348519,348522,1,4,0
99572,4,2,348522,348522,348524,0,2,0
99573,4,1,348526,348526,348527,0,1,2
99574,2,3,348528,348528,348531,0,3,1
99575,3,3,348531,348531,348534,0,3,0
99576,2,2,348533,348534,348536,1,3,0
99577,6,2,348539,348539,348541,0,2,3
99578,5,3,348544,348544,348547,0,3,3
99579,1,1,348545,348547,348548,2,3,0
99580,5,1,348550,348550,348551,0,1,2
99581,3,1,348553,348553,348554,0,1,2
99582,6,2,348559,348559,348561,0,2,5
99583,4,3,348563,348563,348566,0,3,2
99584,3,3,348566,348566,348569,0,3,0
99585,3,2,348569,348569,348571,0,2,0
99586,6,3,348575,348575,348578,0,3,4
99587,4,1,348579,348579,348580,0,1,1
99588,5,2,348584,348584,348586,0,2,4
99589,4,2,348588,348588,348590,0,2,2
99590,5,3,348593,348593,348596,0,3,3
99591,3,2,348596,348596,348598,0,2,0
99592,2,1,348598,348598,348599,0,1,0
99593,1,3,348599,348599,348602,0,3,0
99594,5,2,348604,348604,348606,0,2,2
99595,3,3,348607,348607,348610,0,3,1
99596,4,2,348611,348611,348613,0,2,1
99597,2,3,348613,348613,348616,0,3,0
99598,1,2,348614,348616,348618,2,4,0
99599,5,3,348619,348619,348622,0,3,1
99600,5,1,348624,348624,348625,0,1,2
99601,1,1,348625,348625,348626,0,1,0
99602,6,3,348631,348631,348634,0,3,5
99603,6,1,348637,348637,348638,0,1,3
99604,4,2,348641,348641,348643,0,2,3
99605,4,2,348645,348645,348647,0,2,2
99606,2,3,348647,348647,348650,0,3,0
99607,2,1,348649,348650,348651,1,2,0
99608,3,2,348652,348652,348654,0,2,1
99609,3,1,348655,348655,348656,0,1,1
99610,6,1,348661,348661,348662,0,1,5
99611,2,2,348663,348663,348665,0,2,1
99612,1,3,348664,348665,348668,1,4,0
99613,1,1,348665,348668,348669,3,4,0
99614,2,2,348667,348669,348671,2,4,0
99615,6,2,348673,348673,348675,0,2,2
99616,1,2,348674,348675,348677,1,3,0
99617,6,3,348680,348680,348683,0,3,3
99618,6,3,348686,348686,348689,0,3,3
99619,2,1,348688,348689,348690,1,2,0
99620,1,3,348689,348690,348693,1,4,0
99621,1,2,348690,348693,348695,3,5,0
99622,2,1,348692,348695,348696,3,4,0
99623,3,1,348695,348696,348697,1,2,0
99624,2,2,348697,348697,348699,0,2,0
99625,6,3,348703,348703,348706,0,3,4
99626,2,1,348705,348706,348707,1,2,0
99627,3,3,348708,348708,348711,0,3,1
99628,2,3,348710,348711,348714,1,4,0
99629,1,1,348711,348714,348715,3,4,0
99630,6,2,348717,348717,348719,0,2,2
99631,5,2,348722,348722,348724,0,2,3
99632,1,3,348723,348724,348727,1,4,0
99633,2,3,348725,348727,348730,2,5,0
99634,2,1,348727,348730,348731,3,4,0
99635,1,3,348728,348731,348734,3,6,0
99636,2,3,348730,348734,348737,4,7,0
99637,6,2,348736,348737,348739,1,3,0
99638,5,2,348741,348741,348743,0,2,2
99639,1,1,348742,348743,348744,1,2,0
99640,4,3,348746,348746,348749,0,3,2
99641,6,2,348752,348752,348754,0,2,3
99642,6,2,348758,348758,348760,0,2,4
99643,4,3,348762,348762,348765,0,3,2
99644,2,3,348764,348765,348768,1,4,0
99645,6,2,348770,348770,348772,0,2,2
99646,1,1,348771,348772,348773,1,2,0
99647,2,3,348773,348773,348776,0,3,0
99648,6,2,348779,348779,348781,0,2,3
99649,4,2,348783,348783,348785,0,2,2
99650,1,1,348784,348785,348786,1,2,0
99651,5,1,348789,348789,348790,0,1,3
99652,1,2,348790,348790,348792,0,2,0
99653,4,3,348794,348794,348797,0,3,2
99654,3,1,348797,348797,348798,0,1,0
99655,5,2,348802,348802,348804,0,2,4
99656,6,2,348808,348808,348810,0,2,4
99657,5,2,348813,348813,348815,0,2,3
99658,1,2,348814,348815,348817,1,3,0
99659,6,3,348820,348820,348823,0,3,3
99660,2,2,348822,348823,348825,1,3,0
99661,3,3,348825,348825,348828,0,3,0
99662,3,1,348828,348828,348829,0,1,0
99663,2,3,348830,348830,348833,0,3,1
99664,1,1,348831,348833,348834,2,3,0
99665,6,1,348837,348837,348838,0,1,3
99666,1,3,348838,348838,348841,0,3,0
99667,2,3,348840,348841,348844,1,4,0
99668,4,2,348844,348844,348846,0,2,0
99669,6,2,348850,348850,348852,0,2,4
99670,6,3,348856,348856,348859,0,3,4
99671,2,3,348858,348859,348862,1,4,0
99672,1,2,348859,348862,348864,3,5,0
99673,6,1,348865,348865,348866,0,1,1
99674,6,3,348871,348871,348874,0,3,5
99675,1,3,348872,348874,348877,2,5,0
99676,2,3,348874,348877,348880,3,6,0
99677,5,1,348879,348880,348881,1,2,0
99678,1,1,348880,348881,348882,1,2,0
99679,6,1,348886,348886,348887,0,1,4
99680,2,2,348888,348888,348890,0,2,1
99681,1,3,348889,348890,348893,1,4,0
99682,4,2,348893,348893,348895,0,2,0
99683,1,3,348894,348895,348898,1,4,0
99684,3,2,348897,348898,348900,1,3,0
99685,2,1,348899,348900,348901,1,2,0
99686,2,1,348901,348901,348902,0,1,0
99687,5,2,348906,348906,348908,0,2,4
99688,5,1,348911,348911,348912,0,1,3
99689,3,2,348914,348914,348916,0,2,2
99690,3,1,348917,348917,348918,0,1,1
99691,4,1,348921,348921,348922,0,1,3
99692,2,1,348923,348923,348924,0,1,1
99693,5,2,348928,348928,348930,0,2,4
99694,2,1,348930,348930,348931,0,1,0
99695,6,2,348936,348936,348938,0,2,5
99696,2,1,348938,348938,348939,0,1,0
99697,4,2,348942,348942,348944,0,2,3
99698,3,3,348945,348945,348948,0,3,1
99699,2,2,348947,348948,348950,1,3,0
99700,4,3,348951,348951,348954,0,3,1
99701,5,3,348956,348956,348959,0,3,2
99702,2,2,348958,348959,348961,1,3,0
99703,1,1,348959,348961,348962,2,3,0
99704,1,1,348960,348962,348963,2,3,0
99705,5,2,348965,348965,348967,0,2,2
99706,3,1,348968,348968,348969,0,1,1
99707,5,2,348973,348973,348975,0,2,4
99708,6,1,348979,348979,348980,0,1,4
99709,4,1,348983,348983,348984,0,1,3
99710,6,2,348989,348989,348991,0,2,5
99711,3,3,348992,348992,348995,0,3,1
99712,5,2,348997,348997,348999,0,2,2
99713,2,2,348999,348999,349001,0,2,0
99714,4,3,349003,349003,349006,0,3,2
99715,2,2,349005,349006,349008,1,3,0
99716,3,1,349008,349008,349009,0,1,0
99717,6,3,349014,349014,349017,0,3,5
99718,4,3,349018,349018,349021,0,3,1
99719,4,2,349022,349022,349024,0,2,1
99720,2,3,349024,349024,349027,0,3,0
99721,1,2,349025,349027,349029,2,4,0
99722,3,2,349028,349029,349031,1,3,0
99723,6,3,349034,349034,349037,0,3,3
99724,3,3,349037,349037,349040,0,3,0
99725,3,3,349040,349040,349043,0,3,0
99726,5,3,349045,349045,349048,0,3,2
99727,1,1,349046,349048,349049,2,3,0
99728,1,2,349047,349049,349051,2,4,0
99729,1,3,349048,349051,349054,3,6,0
99730,6,1,349054,349054,349055,0,1,0
99731,5,3,349059,349059,349062,0,3,4
99732,1,3,349060,349062,349065,2,5,0
99733,5,3,349065,349065,349068,0,3,0
99734,6,1,349071,349071,349072,0,1,3
99735,5,1,349076,349076,349077,0,1,4
99736,6,2,349082,349082,349084,0,2,5
99737,5,2,349087,349087,349089,0,2,3
99738,1,2,349088,349089,349091,1,3,0
99739,2,2,349090,349091,349093,1,3,0
99740,5,2,349095,349095,349097,0,2,2
99741,1,1,349096,349097,349098,1,2,0
99742,6,3,349102,349102,349105,0,3,4
99743,5,2,349107,349107,349109,0,2,2
99744,2,3,349109,349109,349112,0,3,0
99745,5,3,349114,349114,349117,0,3,2
99746,4,3,349118,349118,349121,0,3,1
99747,4,3,349122,349122,349125,0,3,1
99748,4,3,349126,349126,349129,0,3,1
99749,5,3,349131,349131,349134,0,3,2
99750,3,3,349134,349134,349137,0,3,0
99751,2,2,349136,349137,349139,1,3,0
99752,6,3,349142,349142,349145,0,3,3
99753,3,1,349145,349145,349146,0,1,0
99754,5,3,349150,349150,349153,0,3,4
99755,5,1,349155,349155,349156,0,1,2
99756,2,2,349157,349157,349159,0,2,1
99757,4,2,349161,349161,349163,0,2,2
99758,5,2,349166,349166,349168,0,2,3
99759,6,2,349172,349172,349174,0,2,4
99760,2,2,349174,349174,349176,0,2,0
99761,3,2,349177,349177,349179,0,2,1
99762,4,3,349181,349181,349184,0,3,2
99763,3,3,349184,349184,349187,0,3,0
99764,2,3,349186,349187,349190,1,4,0
99765,2,3,349188,349190,349193,2,5,0
99766,5,1,349193,349193,349194,0,1,0
99767,3,3,349196,349196,349199,0,3,2
99768,5,3,349201,349201,349204,0,3,2
99769,4,2,349205,349205,349207,0,2,1
99770,2,2,349207,349207,349209,0,2,0
99771,2,3,349209,349209,349212,0,3,0
99772,3,2,349212,349212,349214,0,2,0
99773,2,1,349214,349214,349215,0,1,0
99774,5,1,349219,349219,349220,0,1,4
99775,5,1,349224,349224,349225,0,1,4
99776,3,1,349227,349227,349228,0,1,2
99777,5,1,349232,349232,349233,0,1,4
99778,5,2,349237,349237,349239,0,2,4
99779,5,1,349242,349242,349243,0,1,3
99780,5,1,349247,349247,349248,0,1,4
99781,5,3,349252,349252,349255,0,3,4
99782,5,1,349257,349257,349258,0,1,2
99783,4,1,349261,349261,349262,0,1,3
99784,3,2,349264,349264,349266,0,2,2
99785,6,3,349270,349270,349273,0,3,4
99786,4,2,349274,349274,349276,0,2,1
99787,4,3,349278,349278,349281,0,3,2
99788,1,2,349279,349281,349283,2,4,0
99789,2,3,349281,349283,349286,2,5,0
99790,1,2,349282,349286,349288,4,6,0
99791,5,2,349287,349288,349290,1,3,0
99792,4,3,349291,349291,349294,0,3,1
99793,2,3,349293,349294,349297,1,4,0
99794,5,3,349298,349298,349301,0,3,1
99795,3,2,349301,349301,349303,0,2,0
99796,5,3,349306,349306,349309,0,3,3
99797,3,1,349309,349309,349310,0,1,0
99798,5,1,349314,349314,349315,0,1,4
99799,3,3,349317,349317,349320,0,3,2
99800,6,2,349323,349323,349325,0,2,3
99801,6,1,349329,349329,349330,0,1,4
99802,4,3,349333,349333,349336,0,3,3
99803,3,2,349336,349336,349338,0,2,0
99804,4,2,349340,349340,349342,0,2,2
99805,3,3,349343,349343,349346,0,3,1
99806,4,2,349347,349347,349349,0,2,1
99807,2,2,349349,349349,349351,0,2,0
99808,3,3,349352,349352,349355,0,3,1
99809,2,3,349354,349355,349358,1,4,0
99810,3,2,349357,349358,349360,1,3,0
99811,3,3,349360,349360,349363,0,3,0
99812,3,2,349363,349363,349365,0,2,0
99813,1,2,349364,349365,349367,1,3,0
99814,6,1,349370,349370,349371,0,1,3
99815,1,2,349371,349371,349373,0,2,0
99816,6,1,349377,349377,349378,0,1,4
99817,6,2,349383,349383,349385,0,2,5
99818,4,2,349387,349387,349389,0,2,2
99819,2,3,349389,349389,349392,0,3,0
99820,1,1,349390,349392,349393,2,3,0
99821,2,3,349392,349393,349396,1,4,0
99822,4,2,349396,349396,349398,0,2,0
99823,1,2,349397,349398,349400,1,3,0
99824,6,1,349403,349403,349404,0,1,3
99825,1,3,349404,349404,349407,0,3,0
99826,6,3,349410,349410,349413,0,3,3
99827,5,2,349415,349415,349417,0,2,2
99828,6,1,349421,349421,349422,0,1,4
99829,3,3,349424,349424,349427,0,3,2
99830,6,2,349430,349430,349432,0,2,3
99831,4,1,349434,349434,349435,0,1,2
99832,1,1,349435,349435,349436,0,1,0
99833,6,3,349441,349441,349444,0,3,5
99834,1,1,349442,349444,349445,2,3,0
99835,1,2,349443,349445,349447,2,4,0
99836,1,2,349444,349447,349449,3,5,0
99837,4,3,349448,349449,349452,1,4,0
99838,4,2,349452,349452,349454,0,2,0
99839,6,3,349458,349458,349461,0,3,4
99840,6,1,349464,349464,349465,0,1,3
99841,5,3,349469,349469,349472,0,3,4
99842,3,1,349472,349472,349473,0,1,0
99843,6,1,349478,349478,349479,0,1,5
99844,3,2,349481,349481,349483,0,2,2
99845,2,2,349483,349483,349485,0,2,0
99846,4,3,349487,349487,349490,0,3,2
99847,4,3,349491,349491,349494,0,3,1
99848,2,3,349493,349494,349497,1,4,0
99849,4,3,349497,349497,349500,0,3,0
99850,3,1,349500,349500,349501,0,1,0
99851,2,3,349502,349502,349505,0,3,1
99852,5,1,349507,349507,349508,0,1,2
99853,3,2,349510,349510,349512,0,2,2
99854,3,3,349513,349513,349516,0,3,1
99855,3,1,349516,349516,349517,0,1,0
99856,2,3,349518,349518,349521,0,3,1
99857,4,2,349522,349522,349524,0,2,1
99858,2,3,349524,349524,349527,0,3,0
99859,5,2,349529,349529,349531,0,2,2
99860,5,2,349534,349534,349536,0,2,3
99861,1,3,349535,349536,349539,1,4,0
99862,4,2,349539,349539,349541,0,2,0
99863,6,1,349545,349545,349546,0,1,4
99864,3,1,349548,349548,349549,0,1,2
99865,4,3,349552,349552,349555,0,3,3
99866,5,2,349557,349557,349559,0,2,2
99867,6,3,349563,349563,349566,0,3,4
99868,3,2,349566,349566,349568,0,2,0
99869,6,2,349572,349572,349574,0,2,4
99870,3,2,349575,349575,349577,0,2,1
99871,3,3,349578,349578,349581,0,3,1
99872,3,1,349581,349581,349582,0,1,0
99873,3,2,349584,349584,349586,0,2,2
99874,5,1,349589,349589,349590,0,1,3
99875,5,2,349594,349594,349596,0,2,4
99876,2,1,349596,349596,349597,0,1,0
99877,3,1,349599,349599,349600,0,1,2
99878,1,2,349600,349600,349602,0,2,0
99879,1,3,349601,349602,349605,1,4,0
99880,4,1,349605,349605,349606,0,1,0
99881,6,1,349611,349611,349612,0,1,5
99882,2,2,349613,349613,349615,0,2,1
99883,3,1,349616,349616,349617,0,1,1
99884,4,3,349620,349620,349623,0,3,3
99885,3,2,349623,349623,349625,0,2,0
99886,2,2,349625,349625,349627,0,2,0
99887,6,1,349631,349631,349632,0,1,4
99888,3,1,349634,349634,349635,0,1,2
99889,2,2,349636,349636,349638,0,2,1
99890,2,1,349638,349638,349639,0,1,0
99891,4,1,349642,349642,349643,0,1,3
99892,2,1,349644,349644,349645,0,1,1
99893,6,2,349650,349650,349652,0,2,5
99894,2,1,349652,349652,349653,0,1,0
99895,2,2,349654,349654,349656,0,2,1
99896,1,3,349655,349656,349659,1,4,0
99897,1,2,349656,349659,349661,3,5,0
99898,2,2,349658,349661,349663,3,5,0
99899,4,2,349662,349663,349665,1,3,0
99900,3,3,349665,349665,349668,0,3,0
99901,5,3,349670,349670,349673,0,3,2
99902,5,3,349675,349675,349678,0,3,2
99903,4,2,349679,349679,349681,0,2,1
99904,6,1,349685,349685,349686,0,1,4
99905,3,3,349688,349688,349691,0,3,2
99906,6,3,349694,349694,349697,0,3,3
99907,2,1,349696,349697,349698,1,2,0
99908,6,3,349702,349702,349705,0,3,4
99909,4,1,349706,349706,349707,0,1,1
99910,5,1,349711,349711,349712,0,1,4
99911,1,2,349712,349712,349714,0,2,0
99912,5,2,349717,349717,349719,0,2,3
99913,3,3,349720,349720,349723,0,3,1
99914,5,3,349725,349725,349728,0,3,2
99915,3,3,349728,349728,349731,0,3,0
99916,6,1,349734,349734,349735,0,1,3
99917,4,1,349738,349738,349739,0,1,3
99918,3,1,349741,349741,349742,0,1,2
99919,6,1,349747,349747,349748,0,1,5
99920,1,1,349748,349748,349749,0,1,0
99921,3,2,349751,349751,349753,0,2,2
99922,2,3,349753,349753,349756,0,3,0
99923,5,2,349758,349758,349760,0,2,2
99924,1,2,349759,349760,349762,1,3,0
99925,6,2,349765,349765,349767,0,2,3
99926,6,3,349771,349771,349774,0,3,4
99927,1,1,349772,349774,349775,2,3,0
99928,3,2,349775,349775,349777,0,2,0
99929,5,1,349780,349780,349781,0,1,3
99930,5,3,349785,349785,349788,0,3,4
99931,3,1,349788,349788,349789,0,1,0
99932,5,3,349793,349793,349796,0,3,4
99933,3,1,349796,349796,349797,0,1,0
99934,5,1,349801,349801,349802,0,1,4
99935,5,2,349806,349806,349808,0,2,4
99936,6,1,349812,349812,349813,0,1,4
99937,4,3,349816,349816,349819,0,3,3
99938,3,2,349819,349819,349821,0,2,0
99939,3,1,349822,349822,349823,0,1,1
99940,5,2,349827,349827,349829,0,2,4
99941,2,2,349829,349829,349831,0,2,0
99942,6,2,349835,349835,349837,0,2,4
99943,4,3,349839,349839,349842,0,3,2
99944,6,1,349845,349845,349846,0,1,3
99945,2,1,349847,349847,349848,0,1,1
99946,6,3,349853,349853,349856,0,3,5
99947,6,2,349859,349859,349861,0,2,3
99948,1,2,349860,349861,349863,1,3,0
99949,5,3,349865,349865,349868,0,3,2
99950,5,2,349870,349870,349872,0,2,2
99951,3,1,349873,349873,349874,0,1,1
99952,2,2,349875,349875,349877,0,2,1
99953,5,1,349880,349880,349881,0,1,3
99954,4,3,349884,349884,349887,0,3,3
99955,1,1,349885,349887,349888,2,3,0
99956,6,1,349891,349891,349892,0,1,3
99957,1,1,349892,349892,349893,0,1,0
99958,5,2,349897,349897,349899,0,2,4
99959,3,3,349900,349900,349903,0,3,1
99960,6,3,349906,349906,349909,0,3,3
99961,2,2,349908,349909,349911,1,3,0
99962,5,1,349913,349913,349914,0,1,2
99963,4,1,349917,349917,349918,0,1,3
99964,2,3,349919,349919,349922,0,3,1
99965,5,2,349924,349924,349926,0,2,2
99966,1,2,349925,349926,349928,1,3,0
99967,1,3,349926,349928,349931,2,5,0
99968,2,2,349928,349931,349933,3,5,0
99969,3,1,349931,349933,349934,2,3,0
99970,1,1,349932,349934,349935,2,3,0
99971,4,1,349936,349936,349937,0,1,1
99972,4,2,349940,349940,349942,0,2,3
99973,3,3,349943,349943,349946,0,3,1
99974,6,1,349949,349949,349950,0,1,3
99975,1,3,349950,349950,349953,0,3,0
99976,5,3,349955,349955,349958,0,3,2
99977,5,3,349960,349960,349963,0,3,2
99978,5,2,349965,349965,349967,0,2,2
99979,2,2,349967,349967,349969,0,2,0
99980,1,3,349968,349969,349972,1,4,0
99981,1,2,349969,349972,349974,3,5,0
99982,5,3,349974,349974,349977,0,3,0
99983,3,3,349977,349977,349980,0,3,0
99984,5,3,349982,349982,349985,0,3,2
99985,3,1,349985,349985,349986,0,1,0
99986,4,3,349989,349989,349992,0,3,3
99987,5,1,349994,349994,349995,0,1,2
99988,1,3,349995,349995,349998,0,3,0
99989,4,2,349999,349999,350001,0,2,1
99990,4,3,350003,350003,350006,0,3,2
99991,5,1,350008,350008,350009,0,1,2
99992,2,1,350010,350010,350011,0,1,1
99993,2,3,350012,350012,350015,0,3,1
99994,6,1,350018,350018,350019,0,1,3
99995,2,3,350020,350020,350023,0,3,1
99996,1,3,350021,350023,350026,2,5,0
99997,4,1,350025,350026,350027,1,2,0
99998,6,3,350031,350031,350034,0,3,4
99999,6,3,350037,350037,350040,0,3,3
